RequestID,ArrivalTime,DelayTime,FinishTime,InitiatorID,TargetID,IOType,Size,VolumeID,Offset
0,0,144724,144724,0,0,0,47104,10,8401124933
1,1,16376,16377,3,0,1,31232,3,5093586536
2,2,23395,23397,5,0,1,23040,11,3866887059
3,3,481751,481754,6,0,0,93696,7,6706759926
4,4,23752,23756,2,0,1,9728,4,4264801587
5,5,233369,233374,7,0,0,11776,16,7710536242
6,6,26004,26010,8,0,1,15360,2,2162243584
7,7,116697,116704,1,0,0,512,5,4081847668
8,8,145059,145067,9,0,0,1024,17,8617594201
9,9,546925,546934,4,0,0,57344,2,8539431437
10,4909,40816,45725,1,0,1,34304,5,10099108589
11,15189,32124,47313,0,0,1,15872,10,9510383086
12,19670,173602,193272,4,0,0,3072,2,7186447113
13,49000,343284,392284,4,0,0,154112,2,2864548933
14,65320,208890,274210,3,0,0,7168,3,4576794252
15,77429,7230,84659,0,0,1,7680,10,8341307280
16,84670,221034,305704,3,0,0,1024,3,3158178645
17,101780,446105,547885,7,0,0,3072,16,8552335995
18,125289,815378,940667,8,0,0,28160,2,7783848778
19,130660,559252,689912,0,0,0,142336,10,6311298750
20,134390,15010,149400,3,0,1,4608,3,10228996622
21,149870,14545,164415,5,0,1,28160,11,5884613806
22,159249,7752,167001,0,0,1,4096,10,8337814065
23,178030,585281,763311,3,0,0,6144,3,4075577942
24,190110,25962,216072,3,0,1,47104,3,6099497507
25,211229,11533,222762,0,0,1,18944,10,56994442
26,217580,5848,223428,3,0,1,11264,3,255555906
27,219500,406463,625963,9,0,0,1024,17,3323929050
28,227240,785374,1012614,4,0,0,236032,2,2653706431
29,229951,9644,239595,6,0,1,15360,7,682862644
30,238790,693258,932048,4,0,0,268288,2,2385619723
31,246959,20882,267841,0,0,1,33792,10,6078397987
32,256450,14617,271067,5,0,1,5120,11,7576647905
33,271890,2470,274360,3,0,1,2560,3,2569730308
34,273089,458879,731968,8,0,0,103936,2,4590582861
35,273270,24594,297864,2,0,1,42496,4,9096131470
36,285480,287637,573117,7,0,0,3072,16,1527120110
37,293250,5485,298735,2,0,1,12288,4,4479991955
38,302720,3645,306365,3,0,1,10240,3,6789990155
39,313081,289212,602293,6,0,1,473088,7,9917791194
40,313660,291219,604879,3,0,1,4096,3,6946340329
41,317360,304403,621763,5,0,1,64512,11,6960972948
42,343211,346724,689935,6,0,1,166400,7,10361250707
43,390380,299578,689958,3,0,1,6656,3,2255874907
44,390790,420796,811586,6,0,0,3072,7,5456255727
45,400940,672643,1073583,9,0,0,4608,17,7071280979
46,415559,274414,689973,0,0,1,19456,10,10142322933
47,426449,263539,689988,1,0,1,9216,5,9928034798
48,469110,220893,690003,5,0,1,9728,11,352648714
49,503769,186249,690018,1,0,1,9216,5,9057448035
50,519500,170533,690033,5,0,1,14848,11,3443724523
51,523811,208172,731983,6,0,1,61440,7,6119703549
52,555580,255055,810635,3,0,0,5120,3,5752110722
53,562121,169885,732006,6,0,1,42496,7,5585492746
54,576350,260623,836973,9,0,0,7168,17,4874731764
55,595080,136949,732029,2,0,1,14336,4,8287803414
56,601520,557068,1158588,7,0,0,3072,16,4425306694
57,603299,128745,732044,0,0,1,28672,10,4586340263
58,608730,1533393,2142123,0,0,0,488448,10,531432867
59,673361,67400,740761,6,0,1,74240,7,10390831923
60,673740,402084,1075824,9,0,0,2560,17,6622790967
61,700069,1073070,1773139,8,0,0,361984,2,6411465172
62,713769,27146,740915,1,0,1,8704,5,2045702664
63,730420,85423,815843,1,0,0,2048,5,6222009477
64,735499,6082,741581,0,0,1,1024,10,2654340163
65,782629,26221,808850,0,0,1,47616,10,4250230145
66,791079,21957,813036,0,0,1,6656,10,6604835755
67,793070,25458,818528,3,0,1,26112,3,8641772588
68,820390,1031310,1851700,9,0,0,512,17,8375191353
69,828040,646630,1474670,7,0,0,1536,16,9338750003
70,832480,1433762,2266242,6,0,0,213504,7,132898905
71,858250,154387,1012637,3,0,1,3584,3,6954543908
72,868520,982969,1851489,0,0,0,256512,10,7262775677
73,882530,1410739,2293269,4,0,0,88576,2,9824648979
74,895501,272163,1167664,6,0,1,251904,7,6459703768
75,944979,226551,1171530,1,0,1,6144,5,8808900030
76,947649,1231336,2178985,8,0,0,37376,2,3889188434
77,971079,205636,1176715,1,0,1,16384,5,228457833
78,979740,872295,1852035,9,0,0,1024,17,9050277579
79,989089,899381,1888470,8,0,0,10752,2,9364141234
80,1018179,159842,1178021,1,0,1,2048,5,10517414248
81,1034980,400471,1435451,1,0,0,2048,5,3468523384
82,1044850,1438968,2483818,4,0,0,94720,2,215970423
83,1050650,895289,1945939,7,0,0,1024,16,4998144178
84,1096800,450248,1547048,3,0,0,1024,3,3290067746
85,1107329,71358,1178687,1,0,1,1024,5,4320890737
86,1121280,78810,1200090,3,0,1,69632,3,10702883393
87,1142140,841979,1984119,6,0,0,25088,7,4786995256
88,1148319,1306601,2454920,8,0,0,386560,2,4029078729
89,1161850,735527,1897377,3,0,0,1536,3,188876058
90,1175490,31116,1206606,2,0,1,23040,4,9948226642
91,1184400,22552,1206952,2,0,1,512,4,1444998177
92,1241750,745847,1987597,3,0,0,512,3,6442304937
93,1285789,1047336,2333125,8,0,0,121344,2,7365269491
94,1314380,458930,1773310,7,0,0,512,16,9763845269
95,1323680,5802,1329482,2,0,1,6144,4,6706942861
96,1338430,22691,1361121,3,0,1,37376,3,5383355332
97,1341470,994805,2336275,9,0,0,7168,17,10628077463
98,1372060,221199,1593259,3,0,0,512,3,8805235205
99,1386099,781483,2167582,8,0,0,83456,2,10530554003
100,1427349,1088050,2515399,8,0,0,97792,2,3080710603
101,1457710,1098444,2556154,4,0,0,133632,2,10336703773
102,1473990,1162784,2636774,0,0,0,264192,10,5590693276
103,1547300,789154,2336454,1,0,0,512,5,3509399740
104,1558611,34367,1592978,9,0,1,56832,17,7647069371
105,1567909,1157356,2725265,8,0,0,77312,2,602710094
106,1569581,28543,1598124,9,0,1,8192,17,6049383859
107,1587771,15845,1603616,9,0,1,26112,17,7710719500
108,1592340,701108,2293448,3,0,0,512,3,3626800885
109,1618330,715746,2334076,3,0,0,3072,3,7802731258
110,1629220,571955,2201175,4,0,0,69120,2,5376711601
111,1648420,645823,2294243,1,0,0,2560,5,1019589175
112,1694860,1190815,2885675,9,0,0,512,17,43257043
113,1713140,948514,2661654,0,0,0,76288,10,5472804009
114,1738430,441662,2180092,1,0,0,3584,5,10099944579
115,1741720,1484915,3226635,6,0,0,216576,7,10067327203
116,1742301,112213,1854514,9,0,1,2560,17,3232500440
117,1765020,1233288,2998308,4,0,0,115712,2,9414922229
118,1810930,526187,2337117,1,0,0,2048,5,8892333151
119,1831260,654328,2485588,9,0,0,5632,17,7365223109
120,1841490,1043531,2885021,4,0,0,149504,2,6763286175
121,1895000,1150294,3045294,6,0,0,91136,7,4134009543
122,1907860,388270,2296130,3,0,0,6144,3,8673111779
123,1928870,1009079,2937949,1,0,0,3072,5,467972118
124,1987810,1172011,3159821,6,0,0,375808,7,180622387
125,2014910,933791,2948701,7,0,0,3072,16,6365302785
126,2021371,433564,2454935,9,0,1,2560,17,2394472592
127,2060160,681968,2742128,6,0,0,55296,7,6302701052
128,2082100,1229060,3311160,6,0,0,176640,7,5552446089
129,2086980,1169862,3256842,0,0,0,11776,10,8627952591
130,2089240,549147,2638387,3,0,0,5120,3,2997450643
131,2106759,377098,2483857,0,0,1,8704,10,4320518665
132,2175591,380594,2556185,9,0,1,13312,17,5710019520
133,2266419,289789,2556208,0,0,1,23040,10,436189894
134,2273090,1065275,3338365,4,0,0,82944,2,10663453908
135,2284230,645291,2929521,1,0,0,5632,5,5441706386
136,2310821,245442,2556263,9,0,1,23552,17,104062555
137,2337300,497760,2835060,9,0,0,1024,17,8877220421
138,2417061,219736,2636797,9,0,1,15360,17,8939496214
139,2417369,219443,2636812,0,0,1,13824,10,10410901619
140,2477980,522514,3000494,1,0,0,3584,5,10581186197
141,2479200,182477,2661677,3,0,1,22528,3,204696903
142,2485190,400314,2885504,7,0,0,1536,16,2483814047
143,2511020,376238,2887258,9,0,0,5120,17,2317630821
144,2517110,794689,3311799,7,0,0,2048,16,4689644051
145,2526520,725604,3252124,6,0,0,79872,7,131258589
146,2618941,47092,2666033,9,0,1,11776,17,468627259
147,2749620,563450,3313070,9,0,0,4096,17,779569386
148,2758941,11274,2770215,9,0,1,18432,17,1569387496
149,2855360,371914,3227274,7,0,0,2048,16,3445268157
150,2861310,391921,3253231,9,0,0,3584,17,4490472055
151,2877899,12263,2890162,0,0,1,8704,10,10409053591
152,2878799,36591,2915390,0,0,1,46080,10,6598752526
153,2901370,443110,3344480,4,0,0,19968,2,1063155607
154,2937570,319755,3257325,7,0,0,1536,16,10207368479
155,2951620,276145,3227765,3,0,0,1536,3,5986108791
156,2953700,206932,3160632,1,0,0,2560,5,9780240776
157,2969200,418094,3387294,6,0,0,140288,7,10728301721
158,3025620,565036,3590656,4,0,0,132096,2,1428562908
159,3042221,302282,3344503,9,0,1,61440,17,10201392294
160,3045200,505154,3550354,4,0,0,250880,2,5101708281
161,3097030,731584,3828614,9,0,0,63488,17,5146948593
162,3123590,751637,3875227,6,0,0,150016,7,7326754265
163,3175610,1006313,4181923,6,0,0,98816,7,4258197282
164,3201810,389953,3591763,7,0,0,3584,16,4597370706
165,3212439,180641,3393080,0,0,1,6144,10,8831577098
166,3233060,1134693,4367753,6,0,0,77312,7,806176138
167,3248070,903044,4151114,4,0,0,350720,2,3684030110
168,3296729,100537,3397266,4,0,1,6656,2,745954412
169,3298270,333309,3631579,1,0,0,5632,5,2198167107
170,3318680,1350435,4669115,4,0,0,355840,2,7327413777
171,3323791,75741,3399532,9,0,1,3584,17,7091618324
172,3325579,80253,3405832,4,0,1,26112,2,9040208578
173,3343599,79110,3422709,4,0,1,36864,2,2973769268
174,3371030,368640,3739670,3,0,0,1536,3,282052661
175,3400730,883627,4284357,9,0,0,91136,17,5446780017
176,3410601,15974,3426575,9,0,1,6144,17,4824169667
177,3413790,775324,4189114,9,0,0,23552,17,6272700657
178,3459229,3898,3463127,4,0,1,4096,2,2125937632
179,3465859,84518,3550377,0,0,1,24064,10,3885395326
180,3474060,870122,4344182,9,0,0,127488,17,6754345724
181,3480051,147783,3627834,9,0,1,63488,17,8024797897
182,3491270,814053,4305323,9,0,0,37888,17,1327314598
183,3528639,105506,3634145,4,0,1,30208,2,1783046879
184,3560220,1197784,4758004,0,0,0,118272,10,2958268117
185,3592670,1129275,4721945,0,0,0,84480,10,1238234551
186,3616379,19712,3636091,0,0,1,3072,10,3130334465
187,3621650,20547,3642197,8,0,1,29184,2,159218473
188,3673810,736382,4410192,7,0,0,512,16,9706859154
189,3705220,1104814,4810034,4,0,0,71680,2,1013381708
190,3727030,566,3727596,8,0,1,512,2,2224676303
191,3767180,1129902,4897082,4,0,0,221184,2,1707682754
192,3775370,1553045,5328415,4,0,0,241152,2,5230063763
193,3778090,1278145,5056235,0,0,0,223232,10,5327178725
194,3785380,1518,3786898,8,0,1,1536,2,6445775246
195,3791370,360422,4151792,7,0,0,2048,16,1274890090
196,3796170,572386,4368556,3,0,0,2560,3,1024323233
197,3798930,1135060,4933990,3,0,0,512,3,9249586803
198,3806860,486880,4293740,4,0,0,30720,2,2085045660
199,3827020,48222,3875242,8,0,1,12800,2,812078225
200,3841149,88769,3929918,4,0,1,89600,2,8405726479
201,3844670,525149,4369819,3,0,0,4096,3,9323796422
202,3860429,73995,3934424,4,0,1,7168,2,3588373436
203,3874399,61408,3935807,4,0,1,14848,2,5968787027
204,3878120,61233,3939353,8,0,1,5632,2,9377029788
205,3896420,1994629,5891049,4,0,0,104960,2,5044489275
206,3906869,35390,3942259,4,0,1,4608,2,5663783952
207,3924310,747472,4671782,9,0,0,8704,17,2216404033
208,3942560,605098,4547658,6,0,0,57344,7,4210507566
209,3945210,835640,4780850,9,0,0,1024,17,4846583896
210,3947370,2946,3950316,8,0,1,3072,2,10376669957
211,3983919,14287,3998206,0,0,1,27648,10,9374069372
212,4011961,15837,4027798,9,0,1,30720,17,10020300461
213,4013179,15490,4028669,0,0,1,12288,10,6764784318
214,4018781,132348,4151129,9,0,1,45568,17,8308958530
215,4053989,138471,4192460,0,0,1,9728,10,7336742961
216,4055060,758923,4813983,7,0,0,6144,16,8022687743
217,4058450,421364,4479814,1,0,0,1536,5,2569491581
218,4070020,601949,4671969,7,0,0,512,16,2333780127
219,4175960,1904431,6080391,0,0,0,185856,10,8325432667
220,4176239,21700,4197939,1,0,1,6144,5,8957938581
221,4180030,965470,5145500,9,0,0,158208,17,7493960402
222,4180252,2590096,6770348,4,0,0,748032,2,3402404110
223,4193730,1467578,5661308,1,0,0,1536,5,6858893884
224,4202750,854132,5056882,7,0,0,2048,16,6114643099
225,4214629,4679,4219308,4,0,1,12288,2,3763959014
226,4250370,2138187,6388557,6,0,0,318976,7,7494520827
227,4260540,1646560,5907100,1,0,0,1024,5,708217068
228,4265510,657335,4922845,9,0,0,84480,17,5477917333
229,4265960,797801,5063761,9,0,0,22528,17,7759708931
230,4271650,1206653,5478303,6,0,0,155136,7,9222543594
231,4314350,76852,4391202,8,0,1,34816,2,6829504575
232,4365360,1231690,5597050,4,0,0,29696,2,2735555410
233,4431290,2368182,6799472,4,0,0,84480,2,3555218874
234,4494451,12308,4506759,9,0,1,20480,17,9439404465
235,4498039,9693,4507732,4,0,1,12800,2,10624287089
236,4498670,1106348,5605018,7,0,0,4608,16,6957621176
237,4504700,1701356,6206056,6,0,0,54784,7,4830892278
238,4506270,973467,5479737,1,0,0,4608,5,4620976256
239,4513250,1186767,5700017,1,0,0,1536,5,1442724361
240,4516279,3898,4520177,4,0,1,4096,2,5113185923
241,4518340,1974923,6493263,6,0,0,316416,7,6497097536
242,4588940,838294,5427234,1,0,0,1536,5,4165939173
243,4608299,77070,4685369,4,0,1,22528,2,10664616885
244,4614860,1300752,5915612,0,0,0,7168,10,1943010907
245,4626060,1275612,5901672,9,0,0,34816,17,1226521253
246,4631720,56875,4688595,2,0,1,5120,4,1893707616
247,4671070,1870201,6541271,4,0,0,73216,2,2964679354
248,4680919,8342,4689261,4,0,1,11264,2,9376405370
249,4696330,2553378,7249708,4,0,0,397824,2,8337540843
250,4748860,13510,4762370,8,0,1,4608,2,1844355303
251,4776800,2042830,6819630,3,0,0,512,3,1846641910
252,4815999,10499,4826498,4,0,1,16896,2,7448618019
253,4858700,3195136,8053836,6,0,0,170496,7,10684703235
254,4903350,1867512,6770862,7,0,0,512,16,10452731969
255,4927820,2552254,7480074,0,0,0,276992,10,3234688483
256,4945750,2412463,7358213,3,0,0,2560,3,8849242457
257,4972999,4420,4977419,4,0,1,11776,2,4600717697
258,4983430,1934190,6917620,1,0,0,11264,5,10736208980
259,4993410,73757,5067167,8,0,1,3584,2,4352591627
260,5031530,2759266,7790796,9,0,0,96256,17,9896327226
261,5056890,2297821,7354711,9,0,0,344576,17,9106654769
262,5137710,1381011,6518721,9,0,0,78336,17,5547804217
263,5149990,3049158,8199148,9,0,0,159232,17,2595399181
264,5153000,1341838,6494838,1,0,0,5120,5,7135053760
265,5175050,726801,5901851,1,0,0,512,5,121000758
266,5208500,3366145,8574645,9,0,0,100352,17,4878682496
267,5234750,12308,5247058,8,0,1,20480,2,10640587675
268,5239410,3539744,8779154,0,0,0,235520,10,5720218100
269,5243240,2907323,8150563,9,0,0,189952,17,4772829644
270,5279810,1239098,6518908,1,0,0,512,5,4178870906
271,5296950,1522445,6819395,0,0,0,65024,10,5106875411
272,5299980,3687632,8987612,6,0,0,101888,7,5758450417
273,5338510,2481824,7820334,9,0,0,95232,17,5332591013
274,5360750,2352767,7713517,7,0,0,1024,16,9152083414
275,5386620,519436,5906056,1,0,0,7680,5,8456383454
276,5391030,3002409,8393439,6,0,0,182272,7,9852102466
277,5408550,2226155,7634705,6,0,0,209408,7,8966823320
278,5427730,50588,5478318,8,0,1,36352,2,7029955216
279,5479060,4056,5483116,8,0,1,9728,2,8124775949
280,5480960,1292749,6773709,0,0,0,9216,10,9187319779
281,5491310,905530,6396840,0,0,0,27136,10,3154146405
282,5515760,25187,5540947,7,0,1,45568,16,792826747
283,5525220,2954274,8479494,6,0,0,134656,7,8170386496
284,5576680,964770,6541450,3,0,0,512,3,7822882490
285,5576965,965444,6542409,7,0,0,3072,16,9332089645
286,5582000,4162201,9744201,0,0,0,364544,10,1869849284
287,5596190,1223619,6819809,1,0,0,512,5,4975427897
288,5625980,3555450,9181430,9,0,0,187392,17,3426852373
289,5633090,1137601,6770691,3,0,0,1024,3,6771392829
290,5636310,1998566,7634876,1,0,0,512,5,8879072973
291,5640060,440970,6081030,7,0,0,2048,16,578760554
292,5656850,35054,5691904,3,0,1,61440,3,6662604785
293,5740020,3592892,9332912,9,0,0,219648,17,4641259962
294,5760020,3659322,9419342,9,0,0,38400,17,4630102896
295,5820790,1675227,7496017,6,0,0,52224,7,1655745420
296,5882270,2317065,8199335,3,0,0,512,3,9541604252
297,5902300,4129001,10031301,6,0,0,518144,7,4380715191
298,5926901,21141,5948042,6,0,1,34304,7,4116626472
299,5945050,4336003,10281053,0,0,0,600064,10,10071361714
300,5966690,1390704,7357394,7,0,0,8704,16,5123348849
301,5971360,2464556,8435916,6,0,0,135680,7,9221568256
302,6004210,1355430,7359640,7,0,0,4608,16,9948214001
303,6036770,2748694,8785464,3,0,0,9728,3,4739318080
304,6059470,4993214,11052684,0,0,0,372224,10,3423809138
305,6075030,2871648,8946678,6,0,0,9216,7,5548417662
306,6079340,4697665,10777005,6,0,0,647680,7,7197228860
307,6100210,2896557,8996767,4,0,0,18432,2,2771109095
308,6127940,1519446,7647386,1,0,0,5120,5,4854465702
309,6212870,2448833,8661703,0,0,0,19968,10,459964171
310,6214220,2610413,8824633,3,0,0,4096,3,5073007102
311,6237680,1553615,7791295,7,0,0,1536,16,7226823083
312,6249580,691295,6940875,7,0,0,1536,16,5477757755
313,6263640,1944158,8207798,3,0,0,3584,3,9115118567
314,6268690,1441476,7710166,3,0,0,512,3,5258451008
315,6338730,2446905,8785635,7,0,0,512,16,82129280
316,6350110,2832427,9182537,1,0,0,3584,5,4872929787
317,6384590,3671062,10055652,0,0,0,79872,10,5556369289
318,6385830,2558017,8943847,0,0,0,66560,10,4913432586
319,6393320,4701917,11095237,0,0,0,46080,10,5960736257
320,6401630,1992931,8394561,7,0,0,512,16,10296951982
321,6407410,1255443,7662853,1,0,0,6144,5,4326442698
322,6438670,1999781,8438451,9,0,0,8192,17,8090797343
323,6461090,4399405,10860495,9,0,0,273408,17,3317255679
324,6474080,1160975,7635055,7,0,0,512,16,3377232301
325,6483200,5093463,11576663,6,0,0,1147392,7,2274373516
326,6539710,3205652,9745362,0,0,0,3584,10,1852830464
327,6563800,1949960,8513760,3,0,0,512,3,8424554417
328,6570080,4009554,10579634,0,0,0,229888,10,2847705750
329,6582940,1811450,8394390,3,0,0,3072,3,9288154781
330,6630320,1652264,8282584,3,0,0,512,3,3515093846
331,6641769,181022,6822791,1,0,1,9728,5,8707115288
332,6642170,2691397,9333567,3,0,0,2048,3,3151572031
333,6669790,3396500,10066290,9,0,0,34304,17,1435488518
334,6689300,166918,6856218,3,0,1,55808,3,10356276575
335,6700630,2648723,9349353,4,0,0,45568,2,10170389894
336,6707179,150319,6857498,1,0,1,14336,5,1210100995
337,6718399,161170,6879569,1,0,1,62976,5,4523531459
338,6719821,267565,6987386,6,0,1,202240,7,3403760125
339,6727100,4212141,10939241,0,0,0,82944,10,8309022027
340,6738110,2786390,9524500,1,0,0,1536,5,4783912766
341,6748270,2869185,9617455,9,0,0,189952,17,10464698160
342,6759050,232202,6991252,3,0,1,6144,3,302066025
343,6784690,1271087,8055777,7,0,0,6144,16,6857708348
344,6784770,2565066,9349836,7,0,0,1536,16,6230893809
345,6815360,1142897,7958257,7,0,0,512,16,5445057540
346,6890489,102709,6993198,1,0,1,3072,5,7660523165
347,6914550,2591348,9505898,6,0,0,47616,7,4000694887
348,6932030,3136201,10068231,7,0,0,6144,16,7007733329
349,6938769,55095,6993864,1,0,1,1024,5,4918210266
350,6947059,63075,7010134,1,0,1,53248,5,7122032630
351,7018350,3272126,10290476,0,0,0,30720,10,1249095653
352,7028449,4160127,11188576,5,0,0,267776,11,5300218439
353,7047550,4056165,11103715,7,0,0,3584,16,1129513340
354,7053149,4937,7058086,1,0,1,12800,5,6161492098
355,7053941,4491,7058432,9,0,1,512,17,7664699757
356,7061190,2449555,9510745,3,0,0,3072,3,10587530009
357,7064810,2734544,9799354,6,0,0,40448,7,2409643057
358,7132960,3969632,11102592,0,0,0,24064,10,5128632197
359,7154170,3310323,10464493,9,0,0,103424,17,5623302652
360,7181289,191185,7372474,1,0,1,21504,5,3179211863
361,7197700,1875256,9072956,9,0,0,16384,17,9266696033
362,7255420,3115731,10371151,9,0,0,264704,17,2284487421
363,7276000,3203826,10479826,9,0,0,45056,17,6188136431
364,7290050,3127526,10417576,0,0,0,36864,10,5874396809
365,7293150,1489311,8782461,4,0,0,10752,2,6087471203
366,7410690,3021737,10432427,6,0,0,48640,7,9361078045
367,7415070,1606543,9021613,1,0,0,3072,5,6130697229
368,7543520,3370099,10913619,6,0,0,169472,7,8829576089
369,7544020,6278,7550298,3,0,1,6656,3,2624346820
370,7560440,5454,7565894,3,0,1,13824,3,5037371820
371,7592860,2778938,10371798,3,0,0,2048,3,7340235763
372,7639580,1252752,8892332,3,0,0,512,3,3102698125
373,7653331,2946,7656277,9,0,1,3072,17,7468077478
374,7663360,816773,8480133,1,0,0,2048,5,8771763447
375,7665250,1686949,9352199,6,0,0,7680,7,5423224373
376,7731600,1295607,9027207,3,0,0,3584,3,1934534593
377,7738550,2470,7741020,3,0,1,2560,3,1933414161
378,7763170,3950342,11713512,9,0,0,357376,17,2190996142
379,7764560,2333646,10098206,0,0,0,98304,10,6182583717
380,7783239,43332,7826571,1,0,1,6656,5,7089566521
381,7820309,17624,7837933,1,0,1,30208,5,7280761510
382,7843501,155003,7998504,6,0,1,254976,7,3429252054
383,7860400,2649175,10509575,4,0,0,95232,2,10494400402
384,7881500,1900806,9782306,3,0,0,6144,3,5214287260
385,7890829,163022,8053851,1,0,1,23040,5,5154916250
386,7925590,1409864,9335454,7,0,0,6144,16,10687619957
387,7958750,95116,8053866,3,0,1,13312,3,3118008831
388,8009770,1737190,9746960,1,0,0,1024,5,6109904896
389,8024220,2837694,10861914,7,0,0,4608,16,133210909
390,8027090,2028733,10055823,1,0,0,512,5,8478866089
391,8055100,1376208,9431308,7,0,0,5632,16,9107003323
392,8060500,2345813,10406313,6,0,0,113152,7,6410669338
393,8076389,74213,8150602,0,0,1,36352,10,1360290822
394,8076460,1483104,9559564,1,0,0,10752,5,2285209415
395,8087760,62857,8150617,3,0,1,15360,3,132776701
396,8093250,2961218,11054468,1,0,0,1024,5,2655127806
397,8093389,1650835,9744224,1,0,1,15872,5,2132142372
398,8097430,1338444,9435874,7,0,0,9216,16,8662934105
399,8125339,1618916,9744255,0,0,1,2560,10,3112356855
400,8166610,1899695,10066305,3,0,1,10240,3,9282279255
401,8204139,1862181,10066320,0,0,1,4096,10,8383124159
402,8254130,2935085,11189215,1,0,0,2048,5,2540636428
403,8260770,3343831,11604601,7,0,0,1024,16,1455083899
404,8260810,2820372,11081182,9,0,0,83968,17,6620577264
405,8262720,2203363,10466083,3,0,1,25088,3,4270059154
406,8287100,3777865,12064965,0,0,0,367616,10,5320822211
407,8337439,2143081,10480520,0,0,1,19456,10,6746641822
408,8350179,2511758,10861937,0,0,1,45568,10,4177343883
409,8352989,2508963,10861952,1,0,1,3584,5,9533367094
410,8369840,2682859,11052699,3,0,1,26112,3,1743769843
411,8412020,3436271,11848291,6,0,0,403968,7,6210557917
412,8475080,2577634,11052714,3,0,1,10752,3,1704465642
413,8504329,2602621,11106950,1,0,1,28672,5,5307605408
414,8514250,2592723,11106973,3,0,1,9728,3,6385571050
415,8521910,3368695,11890605,0,0,0,129024,10,6726559260
416,8608490,3343938,11952428,6,0,0,202752,7,675045077
417,8638770,2467822,11106592,7,0,0,2048,16,7355975953
418,8652920,1813148,10466068,1,0,0,5120,5,1227373218
419,8678630,1801843,10480473,7,0,0,2048,16,3719226190
420,8697210,2879468,11576678,3,0,1,49152,3,4382319522
421,8726000,3423903,12149903,6,0,0,41984,7,5256879566
422,8726310,2877925,11604235,2,0,1,37376,4,2565859748
423,8745500,2858750,11604250,2,0,1,6144,4,5591308877
424,8753000,2960527,11713527,2,0,1,15872,4,5822815095
425,8761029,2952513,11713542,1,0,1,6144,5,1043455948
426,8776989,2948173,11725162,0,0,1,13824,10,1689844602
427,8785380,2939797,11725177,2,0,1,5120,4,9519419216
428,8868480,2856712,11725192,2,0,1,2560,4,4654390128
429,8882699,3069760,11952459,0,0,1,24576,10,10366798254
430,8905200,3047742,11952942,3,0,0,1536,3,4554422110
431,8932570,3138228,12070798,3,0,1,31232,3,5571756486
432,8946639,3124174,12070813,0,0,1,32768,10,6723094618
433,8958320,2757748,11716068,3,0,0,512,3,7599917221
434,8982780,2072795,11055575,7,0,0,3584,16,1307864885
435,8991559,3080275,12071834,1,0,1,19968,5,4536679684
436,9000940,3185824,12186764,2,0,1,53760,4,8062065285
437,9003119,3189150,12192269,0,0,1,45568,10,10012238683
438,9041639,3215096,12256735,0,0,1,15360,10,3115339530
439,9098191,3328417,12426608,9,0,1,95232,17,707424229
440,9112041,3400466,12512507,9,0,1,17408,17,6473298970
441,9140581,3371949,12512530,9,0,1,8192,17,2232284852
442,9155741,3356804,12512545,9,0,1,1536,17,24228290
443,9165260,3347300,12512560,2,0,1,20480,4,10127833967
444,9167800,2059228,11227028,7,0,0,14336,16,628362737
445,9186340,2538791,11725131,9,0,0,29696,17,3289546798
446,9186909,3325666,12512575,1,0,1,8192,5,2649746163
447,9204010,3219534,12423544,9,0,0,542720,17,1952786182
448,9267660,3293983,12561643,3,0,1,26112,3,2250846522
449,9268280,1164686,10432966,3,0,0,1536,3,7290618343
450,9302119,3592095,12894214,0,0,1,36864,10,8970725506
451,9313949,3580280,12894229,0,0,1,2560,10,195340541
452,9336021,3558231,12894252,9,0,1,12800,17,8811392080
453,9400729,3493538,12894267,1,0,1,15360,5,4126440486
454,9406901,3543545,12950446,9,0,1,4096,17,7902234346
455,9416819,3757455,13174274,0,0,1,16896,10,3065016011
456,9424350,3754750,13179100,3,0,1,7680,3,7050284820
457,9432389,3758980,13191369,0,0,1,12800,10,7263433267
458,9434831,3760724,13195555,9,0,1,6656,17,7816521038
459,9455809,3804461,13260270,1,0,1,14848,5,5433453490
460,9482950,2654138,12137088,9,0,0,179200,17,1836076401
461,9495689,3883583,13379272,0,0,1,8192,10,673139013
462,9501970,244663,9746633,1,0,0,4096,5,10449216959
463,9535520,4035015,13570535,3,0,1,76288,3,4168058277
464,9564330,2506453,12070783,3,0,0,1536,3,9336308562
465,9568570,2008755,11577325,1,0,0,2048,5,1766339057
466,9606120,1604958,11211078,9,0,0,71680,17,4998877894
467,9606309,3964241,13570550,0,0,1,2560,10,6165976311
468,9623840,1598805,11222645,0,0,0,37888,10,1425003094
469,9628480,2558269,12186749,3,0,0,1536,3,3685408431
470,9661420,1115756,10777176,1,0,0,512,5,9608887018
471,9685519,3944848,13630367,0,0,1,37888,10,4760764817
472,9686431,4197506,13883937,9,0,1,44032,17,2859029484
473,9696890,4829511,14526401,3,0,1,44032,3,6343034632
474,9727160,1379767,11106927,7,0,0,1024,16,8561436337
475,9787590,2469122,12256712,6,0,0,211456,7,2550876750
476,9796270,2699031,12495301,0,0,0,78848,10,738636803
477,9814759,4711657,14526416,1,0,1,6656,5,3005113272
478,9837290,2348976,12186266,0,0,0,119296,10,4255610001
479,9853530,4768085,14621615,2,0,1,15360,4,8023720692
480,9854810,4850980,14705790,3,0,1,32768,3,5200699821
481,9864950,2692428,12557378,9,0,0,146944,17,3475756597
482,9872770,2552076,12424846,1,0,0,1536,5,3255910482
483,9927310,4810445,14737755,3,0,1,11264,3,2487262477
484,9931490,2580994,12512484,0,0,0,56320,10,7337240043
485,9938260,4799510,14737770,7,0,1,4608,16,7917069108
486,9970510,4844846,14815356,2,0,1,5120,4,5287621541
487,10041700,4773671,14815371,2,0,1,14336,4,10602607509
488,10045980,4788765,14834745,2,0,1,25600,4,2390880158
489,10082530,4769576,14852106,2,0,1,20480,4,1645647855
490,10086840,1017670,11104510,7,0,0,2560,16,6302097865
491,10091160,1014769,11105929,1,0,0,4608,5,352016998
492,10106229,5161149,15267378,0,0,1,24064,10,10150031915
493,10130259,5284097,15414356,0,0,1,6656,10,2797298285
494,10141610,772344,10913954,1,0,0,1024,5,10006588790
495,10164550,889591,11054141,1,0,0,4608,5,8434757726
496,10169259,6528873,16698132,1,0,1,512,5,2307708710
497,10209639,6488839,16698478,0,0,1,512,10,9907228166
498,10224250,6528366,16752616,3,0,1,22528,3,6289029863
499,10256109,6751989,17008098,0,0,1,15360,10,5999861089
500,10260180,2464795,12724975,6,0,0,372736,7,4563925809
501,10274530,6733583,17008113,2,0,1,17408,4,3664212432
502,10295480,2168271,12463751,0,0,0,121856,10,1422011009
503,10343440,1727724,12071164,7,0,0,1024,16,10105620033
504,10357860,2251793,12609653,9,0,0,118272,17,5458514309
505,10361230,1242982,11604212,6,0,0,88064,7,669348971
506,10489959,6852428,17342387,1,0,1,10752,5,5013379508
507,10512290,1203607,11715897,0,0,0,7680,10,7654266523
508,10516590,1334688,11851278,7,0,0,9728,16,10059534219
509,10553310,1529155,12082465,6,0,0,34816,7,9257209350
510,10610490,1459802,12070292,1,0,0,17408,5,3854449117
511,10626220,2190648,12816868,6,0,0,296960,7,8729214641
512,10678790,1578740,12257530,1,0,0,2560,5,8388981261
513,10727771,7456788,18184559,9,0,1,52736,17,8250735715
514,10817350,1374904,12192254,7,0,0,15360,16,4052022307
515,10861500,1609754,12471254,9,0,0,24576,17,8999741773
516,10919971,7264603,18184574,9,0,1,8192,17,7150460208
517,10925930,2166551,13092481,9,0,0,50176,17,7101148310
518,10942480,1129323,12071803,6,0,0,2048,7,2059260287
519,10989179,7195410,18184589,1,0,1,6144,5,4612355341
520,11001199,7183405,18184604,1,0,1,14848,5,3986362349
521,11018470,1875681,12894151,0,0,0,253440,10,5073865591
522,11080161,7154393,18234554,9,0,1,19968,17,1736347082
523,11174770,2048773,13223543,1,0,0,1024,5,7280866047
524,11202460,1221903,12424363,7,0,0,2560,16,10010798585
525,11214170,1212423,12426593,3,0,0,5632,3,3340687314
526,11218939,2249775,13468714,8,0,0,77824,2,907109161
527,11234780,1023389,12258169,7,0,0,2048,16,294440577
528,11243250,944309,12187559,6,0,0,2560,7,8103143635
529,11276510,2294010,13570520,9,0,0,140800,17,5720281772
530,11276791,6957778,18234569,9,0,1,512,17,5014060798
531,11279450,2099807,13379257,1,0,0,364032,5,4408727469
532,11324730,6959804,18284534,7,0,1,15360,16,6698607114
533,11387250,1337984,12725234,6,0,0,512,7,6409868063
534,11391080,2338998,13730078,9,0,0,159232,17,9868035494
535,11398330,1213054,12611384,7,0,0,5632,16,2216630369
536,11434380,6851120,18285500,7,0,1,2560,16,10259999044
537,11449890,3073985,14523875,1,0,0,1332224,5,9853587915
538,11473560,1252781,12726341,7,0,0,3584,16,2547484413
539,11477049,1083620,12560669,8,0,0,10752,2,10070855088
540,11511250,1050370,12561620,3,0,0,3072,3,8499462795
541,11520610,1052992,12573602,0,0,0,38912,10,1605183108
542,11547670,6746908,18294578,7,0,1,6656,16,9899209666
543,11569710,1813945,13383655,9,0,0,14336,17,1919743461
544,11611460,1802021,13413481,3,0,0,2048,3,3597090341
545,11636069,6971533,18607602,1,0,1,26112,5,45856837
546,11637140,1775702,13412842,9,0,0,95744,17,4717474805
547,11638050,2179420,13817470,1,0,0,512,5,5711209990
548,11652790,1515135,13167925,9,0,0,13312,17,5189404210
549,11676371,6950231,18626602,9,0,1,17920,17,7154263595
550,11810889,2206028,14016917,8,0,0,134144,2,2191621306
551,11874700,1278723,13153423,3,0,0,2048,3,10075312539
552,11911761,6746243,18658004,9,0,1,2560,17,9924335077
553,11972130,1839374,13811504,9,0,0,185344,17,4557249490
554,11992740,6873034,18865774,7,0,1,27136,16,9930355474
555,12097240,6804303,18901543,7,0,1,1024,16,9009196673
556,12108320,929105,13037425,1,0,0,35840,5,2058600872
557,12196760,2424720,14621480,0,0,0,185344,10,7569477439
558,12223030,6751777,18974807,7,0,1,64000,16,909963324
559,12229869,6765452,18995321,1,0,1,9728,5,9939274158
560,12258550,1211427,13469977,7,0,0,4096,16,10345303098
561,12259420,6738598,18998018,8,0,1,37376,2,4220806209
562,12301600,7170238,19471838,7,0,1,24064,16,9922431652
563,12315679,2237599,14553278,8,0,0,83456,2,8367038345
564,12329800,1267564,13597364,0,0,0,67584,10,3855584095
565,12333610,1483689,13817299,7,0,0,18944,16,2519400128
566,12334480,649543,12984023,3,0,0,1024,3,10274832528
567,12354690,7117334,19472024,7,0,1,2560,16,10155348535
568,12466130,1038449,13504579,0,0,0,15872,10,1065241886
569,12482471,6989568,19472039,9,0,1,23552,17,3655031754
570,12485109,6986969,19472078,4,0,1,30208,2,2760540079
571,12528160,7025254,19553414,7,0,1,17920,16,956416399
572,12552900,1562352,14115252,3,0,0,512,3,9557385651
573,12556649,6996780,19553429,4,0,1,5632,2,601966873
574,12571799,1510756,14082555,8,0,0,111104,2,2864338683
575,12608020,1146941,13754961,1,0,0,81408,5,4401032222
576,12611580,2096473,14708053,0,0,0,7168,10,10264026364
577,12626300,2021070,14647370,0,0,0,84480,10,1248583490
578,12658729,6967617,19626346,4,0,1,57344,2,3397155368
579,12667781,6958596,19626377,9,0,1,11264,17,6238688741
580,12787079,689621,13476700,8,0,0,22016,2,269058229
581,12789719,1295503,14085222,8,0,0,8704,2,5587496078
582,12801549,6849406,19650955,4,0,1,47104,2,3793306128
583,12802309,6848661,19650970,4,0,1,6144,2,5949384373
584,12824600,6826385,19650985,7,0,1,12288,16,1244761725
585,12870740,380949,13251689,7,0,0,1536,16,8755263244
586,12876849,1827749,14704598,8,0,0,47104,2,5383601244
587,12880101,29116935,41997036,6,0,1,602112,7,733126586
588,12957890,1857451,14815341,0,0,0,254464,10,1027781766
589,12994040,889882,13883922,6,0,0,7680,7,3672600423
590,13010790,641921,13652711,7,0,0,1536,16,6070817434
591,13014441,29675203,42689644,6,0,1,42496,7,5381427466
592,13020700,30129560,43150260,7,0,1,5632,16,3039642980
593,13047260,1642931,14690191,9,0,0,138240,17,1382879649
594,13072800,843266,13916066,0,0,0,2048,10,2221093605
595,13073811,32039499,45113310,6,0,1,807424,7,6929628736
596,13078839,1773252,14852091,8,0,0,27648,2,7055435522
597,13090690,1474303,14564993,1,0,0,38400,5,9566231853
598,13090860,513752,13604612,6,0,0,1536,7,6071733232
599,13098920,1606831,14705751,3,0,0,512,3,7549235575
600,13104119,32009214,45113333,4,0,1,3584,2,9662033729
601,13113859,1881755,14995614,8,0,0,240128,2,1675286923
602,13118929,31994427,45113356,4,0,1,8192,2,4945058862
603,13149250,31964129,45113379,7,0,1,9216,16,7695385825
604,13152111,32367676,45519787,6,0,1,395264,7,2924840285
605,13199580,1722855,14922435,9,0,0,200704,17,4092637135
606,13207490,1818882,15026372,7,0,0,1536,16,1632265508
607,13212109,2254847,15466956,8,0,0,115200,2,3644122337
608,13247189,1964173,15211362,8,0,0,229888,2,4893456026
609,13268840,32250970,45519810,7,0,1,5120,16,8134846030
610,13281440,1562212,14843652,0,0,0,29184,10,4114165793
611,13294290,2320880,15615170,0,0,0,317440,10,6356402919
612,13303680,2918330,16222010,9,0,0,103424,17,9527804238
613,13305131,32214702,45519833,6,0,1,15872,7,1348194926
614,13308270,2686474,15994744,9,0,0,215040,17,2294349388
615,13316391,32203489,45519880,6,0,1,70656,7,1230776361
616,13319150,32200753,45519903,7,0,1,5120,16,5824418341
617,13343849,32229616,45573465,4,0,1,37888,2,7435697836
618,13386210,1869381,15255591,9,0,0,129024,17,9154128025
619,13409119,32201364,45610483,4,0,1,68096,2,3002050162
620,13418600,424963,13843563,7,0,0,2048,16,227092446
621,13428569,32181945,45610514,4,0,1,20480,2,2751759399
622,13436750,1581046,15017796,3,0,0,4096,3,4944962252
623,13467980,1269744,14737724,1,0,0,97280,5,10223245660
624,13485740,1040646,14526386,6,0,0,8192,7,2835474745
625,13499321,32505739,46005060,6,0,1,235520,7,10215716878
626,13518171,32601736,46119907,6,0,1,81408,7,107473811
627,13524829,2203115,15727944,8,0,0,72192,2,6288697012
628,13581680,1066376,14648056,6,0,0,512,7,6850972821
629,13652370,1182360,14834730,0,0,0,63488,10,2243914726
630,13654300,32793799,46448099,5,0,1,44544,11,5815355457
631,13659180,32788942,46448122,7,0,1,39936,16,5911522092
632,13675209,33124811,46800020,4,0,1,609792,2,328503748
633,13677060,1535709,15212769,3,0,0,4096,3,2204015177
634,13688960,838875,14527835,6,0,0,4608,7,6886700238
635,13691310,33111106,46802416,5,0,1,36864,11,5327736234
636,13697690,33120694,46818384,7,0,1,12800,16,4531870409
637,13712220,1602951,15315171,0,0,0,116224,10,4492398666
638,13723351,33219219,46942570,6,0,1,148992,7,1408623153
639,13763350,884511,14647861,7,0,0,1536,16,5776326219
640,13773529,932051,14705580,8,0,0,2048,2,6773773777
641,13810440,2864112,16674552,1,0,0,593408,5,10369542376
642,13853701,34081024,47934725,6,0,1,851456,7,719705667
643,13910020,34028571,47938591,7,0,1,6144,16,3391742403
644,13911990,2278158,16190148,1,0,0,160256,5,8092285799
645,13943240,761685,14704925,3,0,0,1024,3,4505330139
646,13952220,33996370,47948590,7,0,1,37376,16,2541591957
647,13983890,34042164,48026054,7,0,1,34304,16,4044104475
648,14007970,34018107,48026077,7,0,1,24064,16,2631858116
649,14043209,2709376,16752585,8,0,0,138240,2,5714380096
650,14043810,1003727,15047537,3,0,0,15360,3,8862375895
651,14050530,3291483,17342013,9,0,0,197632,17,2092244054
652,14080150,1035520,15115670,7,0,0,6144,16,4364101922
653,14129180,2258436,16387616,0,0,0,180224,10,3438650087
654,14143540,2078969,16222509,1,0,0,1536,5,6409556566
655,14157840,1457689,15615529,6,0,0,1024,7,6880864157
656,14171220,1202254,15373474,6,0,0,1024,7,6619672023
657,14213259,1788052,16001311,8,0,0,21504,2,4378917589
658,14214220,3186126,17400346,1,0,0,101376,5,4986603216
659,14219439,797094,15016533,8,0,0,68608,2,3448144981
660,14219940,996284,15216224,3,0,0,11264,3,8686488966
661,14265499,33830044,48095543,4,0,1,56320,2,4176169921
662,14269099,33826467,48095566,4,0,1,6656,2,9055330938
663,14283970,2538606,16822576,0,0,0,38912,10,350754216
664,14380950,1406409,15787359,9,0,0,105984,17,9434801209
665,14409839,33685750,48095589,4,0,1,30720,2,5322031556
666,14426370,1596919,16023289,7,0,0,1536,16,3134430280
667,14426999,33783000,48209999,4,0,1,349184,2,5324911622
668,14451139,33796109,48247248,1,0,1,50176,5,5158661906
669,14454019,2680180,17134199,8,0,0,246784,2,2107405903
670,14461389,33983812,48445201,4,0,1,280576,2,3894282582
671,14483300,2524612,17007912,9,0,0,424960,17,10502502484
672,14485450,1245676,15731126,6,0,0,5120,7,10552076575
673,14525579,33993689,48519268,1,0,1,56832,5,4360393643
674,14558160,2500824,17058984,9,0,0,166912,17,3449368735
675,14592259,33927032,48519291,1,0,1,17408,5,7672321747
676,14598870,1410100,16008970,1,0,0,25088,5,9489789875
677,14605589,34307068,48912657,4,0,1,321536,2,9510129839
678,14649169,34336700,48985869,4,0,1,135680,2,1573834994
679,14656289,34468358,49124647,4,0,1,258048,2,1184779915
680,14670119,34455808,49125927,1,0,1,14336,5,4462958739
681,14670470,1520005,16190475,3,0,0,1024,3,4473199374
682,14683910,2886830,17570740,9,0,0,104960,17,2697341353
683,14684869,34444007,49128876,1,0,1,14336,5,2555637245
684,14720800,901137,15621937,6,0,0,4608,7,488971999
685,14733920,2475415,17209335,1,0,0,37888,5,6901679276
686,14740320,2976394,17716714,0,0,0,43520,10,950326381
687,14755560,3800240,18555800,1,0,0,361472,5,5373302252
688,14780699,3403845,18184544,8,0,0,254464,2,965232425
689,14791160,3654441,18445601,0,0,0,495616,10,7280293012
690,14861100,2336668,17197768,7,0,0,5120,16,6854663065
691,14864989,34268395,49133384,1,0,1,8704,5,6716522016
692,14874720,2320506,17195226,9,0,0,200192,17,1877207736
693,14877780,2468537,17346317,7,0,0,6656,16,10309623210
694,14885239,34248401,49133640,1,0,1,9216,5,3251877290
695,14890339,34258071,49148410,4,0,1,35328,2,4929375822
696,14892000,3368948,18260948,0,0,0,86528,10,10705536144
697,14902700,2379034,17281734,9,0,0,237568,17,7122805011
698,14915309,34383790,49299099,4,0,1,306688,2,8124329381
699,14949949,1851338,16801287,8,0,0,19968,2,2953130187
700,14988880,3082571,18071451,0,0,0,220672,10,10271866636
701,14998950,2874015,17872965,9,0,0,345600,17,8594578895
702,15126770,1172179,16298949,3,0,0,7168,3,4504578674
703,15135399,34194616,49330015,1,0,1,20480,5,5388675042
704,15146949,2856844,18003793,8,0,0,135680,2,7799323365
705,15159500,488046,15647546,9,0,0,6144,17,7130744423
706,15172289,2348763,17521052,8,0,0,17408,2,6017042785
707,15189050,1128100,16317150,9,0,0,7168,17,1272151408
708,15210060,2371147,17581207,1,0,0,34304,5,8230701924
709,15269810,3356777,18626587,0,0,0,58880,10,193473722
710,15299559,2661108,17960667,8,0,0,177664,2,10352742992
711,15358370,1316369,16674739,3,0,0,512,3,9629748594
712,15433419,3224554,18657973,8,0,0,102912,2,2162892863
713,15494839,33841129,49335968,1,0,1,28160,5,4471355706
714,15517980,2716559,18234539,1,0,0,163840,5,9232662957
715,15530919,3443873,18974792,8,0,0,153088,2,1526748383
716,15532560,1177890,16710450,0,0,0,10240,10,4802150266
717,15541569,513696,16055265,8,0,0,6144,2,1769203080
718,15549329,558247,16107576,8,0,0,1024,2,7568470895
719,15579680,1428403,17008083,3,0,0,512,3,5390046207
720,15592221,33862312,49454533,6,0,1,226816,7,3246242511
721,15608180,33846376,49454556,8,0,1,18432,2,996732058
722,15644240,3185864,18830104,1,0,0,324608,5,10038315338
723,15661630,3333676,18995306,0,0,0,67072,10,7750715129
724,15710210,33771785,49481995,3,0,1,33792,3,8560277619
725,15739600,2166920,17906520,0,0,0,110080,10,5418927669
726,15764849,33718772,49483621,1,0,1,2560,5,4710679854
727,15774110,1570164,17344274,1,0,0,6144,5,3718049324
728,15782021,33704826,49486847,9,0,1,5120,17,8044815237
729,15835290,33671376,49506666,7,0,1,61440,16,3360909401
730,15849249,1019073,16868322,8,0,0,4096,2,2666115188
731,15860681,34278102,50138783,6,0,1,414720,7,5997961294
732,15927551,34242323,50169874,6,0,1,90112,7,8079359559
733,15957690,1397862,17355552,0,0,0,30208,10,5499815817
734,15998100,2731538,18729638,9,0,0,225280,17,5378861676
735,15998800,1723749,17722549,7,0,0,1536,16,4924678492
736,16019351,34178665,50198016,6,0,1,61952,7,1566112529
737,16029700,2077257,18106957,9,0,0,115712,17,7682994633
738,16051550,2556029,18607579,0,0,0,169472,10,10503183870
739,16144561,34157504,50302065,6,0,1,205312,7,3236022197
740,16182611,34128532,50311143,9,0,1,15872,17,9587016851
741,16205379,34113473,50318852,1,0,1,14848,5,9456629382
742,16209031,34119285,50328316,9,0,1,10240,17,2587170097
743,16243330,1478736,17722066,3,0,0,5632,3,7457199294
744,16303350,2427723,18731073,7,0,0,4608,16,8055485994
745,16351191,33979711,50330902,9,0,1,4096,17,7693205413
746,16407150,959501,17366651,9,0,0,36352,17,1739860695
747,16422081,33911695,50333776,9,0,1,13824,17,3511230479
748,16424009,33915552,50339561,1,0,1,10752,5,6528747756
749,16500470,2638929,19139399,1,0,0,150016,5,3543912715
750,16504429,33846494,50350923,1,0,1,43008,5,1686934307
751,16549880,279712,16829592,3,0,0,1024,3,9296886526
752,16573820,846482,17420302,3,0,0,512,3,3044091846
753,16594890,747474,17342364,7,0,0,1024,16,1644560458
754,16611820,2533405,19145225,9,0,0,18432,17,9164847069
755,16688690,2380947,19069637,9,0,0,235008,17,661852451
756,16701381,33654048,50355429,9,0,1,7168,17,6024011432
757,16711021,33656022,50367043,9,0,1,21504,17,6034435611
758,16721831,33701454,50423285,9,0,1,17920,17,7907629126
759,16740299,33683188,50423487,1,0,1,53248,5,783642375
760,16745199,1258953,18004152,8,0,0,1024,2,7892686761
761,16759610,1524909,18284519,1,0,0,77312,5,1882999599
762,16792259,2110095,18902354,8,0,0,2560,2,203529762
763,16793280,2134837,18928117,1,0,0,84480,5,8703859986
764,16822519,33645040,50467559,1,0,1,73216,5,3331992273
765,16858600,1749805,18608405,3,0,0,2560,3,8871938665
766,16860370,2285650,19146020,7,0,0,2560,16,8223947384
767,16862279,1100159,17962438,8,0,0,5632,2,3081757540
768,16866760,329425,17196185,3,0,0,3072,3,7575952163
769,16872019,33598792,50470811,1,0,1,5120,5,319982136
770,17022971,33455534,50478505,9,0,1,36864,17,2489987830
771,17033360,1832343,18865703,0,0,0,116736,10,569638466
772,17054210,2207361,19261571,1,0,0,378880,5,592300300
773,17076890,2219001,19295891,9,0,0,104960,17,6452879590
774,17114129,33369880,50484009,1,0,1,2048,5,2292798578
775,17178790,1115773,18294563,1,0,0,29696,5,1463042978
776,17186159,33368354,50554513,1,0,1,109568,5,10301449164
777,17193730,33375371,50569101,7,0,1,15872,16,4519765699
778,17206789,1454194,18660983,8,0,0,9728,2,3094447867
779,17213530,1687998,18901528,0,0,0,112640,10,1927434335
780,17244319,33326408,50570727,1,0,1,2560,5,9142522708
781,17251410,2169185,19420595,0,0,0,356864,10,253010594
782,17254599,817023,18071622,8,0,0,512,2,7353888407
783,17263489,33319739,50583228,1,0,1,28672,5,6931154433
784,17316199,33281584,50597783,0,0,1,25600,10,10237753464
785,17329249,1279383,18608632,8,0,0,512,2,8587993006
786,17336959,33262130,50599089,0,0,1,2048,10,7466473073
787,17337920,33273022,50610942,7,0,1,22528,16,7290281157
788,17340131,33287109,50627240,9,0,1,16384,17,7503251393
789,17343570,1919747,19263317,3,0,0,1024,3,9507806403
790,17346579,400721,17747300,8,0,0,1536,2,7076317034
791,17371700,2099328,19471028,0,0,0,57344,10,4779767857
792,17394439,33236364,50630803,0,0,1,11264,10,5462594546
793,17469539,1670055,19139594,8,0,0,512,2,8700180395
794,17469979,33164050,50634029,0,0,1,5120,10,6431973499
795,17477499,33157196,50634695,0,0,1,1024,10,5271238934
796,17536669,33100280,50636949,0,0,1,16896,10,3862268160
797,17577950,1917075,19495025,9,0,0,75264,17,9355536962
798,17588831,33093232,50682063,9,0,1,35840,17,7984399044
799,17589239,1674625,19263864,8,0,0,1536,2,4697686433
800,17596839,33183538,50780377,1,0,1,10752,5,288729563
801,17600880,1266313,18867193,7,0,0,4608,16,5695173839
802,17624700,1928900,19553600,3,0,0,512,3,337934973
803,17625250,1670812,19296062,7,0,0,512,16,10671177380
804,17639909,33283207,50923116,4,0,1,30720,2,7838742802
805,17640609,33777497,51418106,4,0,1,171520,2,1010753035
806,17648630,1445046,19093676,0,0,0,78848,10,10270093268
807,17652829,33901373,51554202,4,0,1,197632,2,5849251917
808,17723199,34086122,51809321,4,0,1,229376,2,8148971389
809,17730351,34109316,51839667,9,0,1,32256,17,7798860483
810,17763269,522216,18285485,8,0,0,3072,2,9801587797
811,17793990,1832173,19626163,1,0,0,238080,5,5527465820
812,17833999,34005691,51839690,1,0,1,2048,5,8896739917
813,17844601,33995112,51839713,9,0,1,8192,17,9219621466
814,17849689,34211551,52061240,4,0,1,266240,2,7620086645
815,17899459,34161804,52061263,0,0,1,25600,10,281987070
816,17906221,34155065,52061286,9,0,1,19456,17,3876015632
817,17922099,34152875,52074974,0,0,1,66048,10,2280377895
818,17934280,1516126,19450406,1,0,0,97792,5,1998261522
819,17949509,34300629,52250138,4,0,1,118272,2,2248138940
820,17956461,34484207,52440668,6,0,1,413696,7,58162586
821,17982559,34493667,52476226,4,0,1,54272,2,3907352860
822,17994300,34491812,52486112,8,0,1,31744,2,3805013965
823,17998150,1555249,19553399,1,0,0,190976,5,964346786
824,18001141,34509461,52510602,6,0,1,72192,7,455876638
825,18008361,34582444,52590805,6,0,1,138752,7,6328343686
826,18045761,34555561,52601322,9,0,1,4096,17,2580150648
827,18072640,1578260,19650900,0,0,0,80384,10,7694900541
828,18083100,34527258,52610358,8,0,1,23040,2,3904759483
829,18087390,910613,18998003,3,0,0,3072,3,91788595
830,18090151,34731338,52821489,6,0,1,120320,7,9882591915
831,18130229,34943667,53073896,4,0,1,320000,2,3103414736
832,18178299,34895620,53073919,0,0,1,512,10,391501249
833,18201130,1110718,19311848,0,0,0,16384,10,1403574082
834,18209440,787612,18997052,7,0,0,5632,16,8053454581
835,18221619,34852323,53073942,0,0,1,12800,10,42216835
836,18235259,34838706,53073965,0,0,1,22528,10,2137931878
837,18255659,34823485,53079144,0,0,1,22016,10,10264070438
838,18259210,34861036,53120246,8,0,1,78336,2,2756902898
839,18262570,1550576,19813146,9,0,0,382464,17,4023868242
840,18286381,34867718,53154099,6,0,1,55296,7,2300177058
841,18301239,34857520,53158759,1,0,1,15872,5,4562186061
842,18320849,34840816,53161665,0,0,1,4608,10,5234431249
843,18337030,1956131,20293161,0,0,0,217600,10,8148563893
844,18359420,1094121,19453541,3,0,0,10240,3,1063234531
845,18364060,1287125,19651185,7,0,0,512,16,5821096064
846,18383471,1512868,19896339,2,0,0,223744,4,4644351497
847,18408681,34784184,53192865,9,0,1,70656,17,1469355515
848,18423881,34774156,53198037,9,0,1,8192,17,7856465649
849,18433771,34816032,53249803,6,0,1,146944,7,5413372715
850,18434009,34819555,53253564,0,0,1,5120,10,10014884422
851,18434590,34820920,53255510,8,0,1,3072,2,3630485497
852,18437099,825891,19262990,8,0,0,4608,2,10186261492
853,18440630,34820167,53260797,8,0,1,16896,2,8306220793
854,18456821,1368040,19824861,2,0,0,38400,4,10647685741
855,18476250,1566644,20042894,0,0,0,206848,10,235209622
856,18517399,34748263,53265662,0,0,1,16896,10,7217639722
857,18529740,1415910,19945650,1,0,0,161792,5,724618746
858,18540220,931789,19472009,3,0,0,512,3,6365818434
859,18550651,756190,19306841,2,0,0,35328,4,8202634708
860,18553050,34717118,53270168,8,0,1,7168,2,7185656039
861,18555021,34721714,53276735,6,0,1,39424,7,5064165642
862,18571900,34718318,53290218,8,0,1,21504,2,1238542031
863,18574281,2144522,20718803,2,0,0,96768,4,9520122713
864,18576160,1386665,19962825,9,0,0,56320,17,2702837493
865,18592039,35363408,53955447,4,0,1,768000,2,2441078693
866,18613409,35355990,53969399,0,0,1,36864,10,4520270
867,18614719,35553201,54167920,4,0,1,429056,2,2710551832
868,18654230,1468412,20122642,1,0,0,44544,5,3288609564
869,18678009,35541614,54219623,0,0,1,19968,10,339981957
870,18689509,971737,19661246,8,0,0,3072,2,4306928205
871,18710810,761013,19471823,7,0,0,2560,16,184321784
872,18715630,1393425,20109055,1,0,0,27136,5,6049913762
873,18727809,35491837,54219646,4,0,1,46592,2,9973605465
874,18830650,664546,19495196,7,0,0,512,16,2495528507
875,18867629,1322300,20189929,8,0,0,4096,2,759944398
876,18867969,35358919,54226888,4,0,1,57344,2,9612522618
877,18879429,35382057,54261486,4,0,1,94208,2,1348356536
878,18892490,1608041,20500531,1,0,0,324608,5,10341643725
879,18925049,35367448,54292497,4,0,1,68096,2,9146399961
880,18974311,2018132,20992443,2,0,0,238080,4,8706108112
881,18989571,1412041,20401612,2,0,0,155648,4,7953324152
882,18989850,1512927,20502777,7,0,0,5120,16,5821719945
883,19025749,35523375,54549124,4,0,1,425472,2,10322444173
884,19025971,2081867,21107838,2,0,0,378368,4,574698663
885,19049469,35558116,54607585,4,0,1,101888,2,694607554
886,19049911,35597319,54647230,6,0,1,95744,7,436581346
887,19059910,1068059,20127969,7,0,0,5632,16,9826783568
888,19064660,35610992,54675652,8,0,1,68096,2,7619676243
889,19065430,2122590,21188020,9,0,0,56320,17,5250423848
890,19100201,1589103,20689304,2,0,0,231936,4,9657457043
891,19106980,721172,19828152,7,0,0,10752,16,10722553816
892,19121519,1204030,20325549,8,0,0,1536,2,5815402305
893,19124301,35862239,54986540,6,0,1,548864,7,5546511989
894,19128251,1791581,20919832,2,0,0,123392,4,10143808904
895,19140769,35903153,55043922,4,0,1,74752,2,4785996869
896,19159179,1341991,20501170,8,0,0,2048,2,6080246965
897,19160880,35883065,55043945,8,0,1,2560,2,1650561381
898,19175310,35868658,55043968,8,0,1,12288,2,1307907400
899,19194761,35890225,55084986,6,0,1,24064,7,845094491
900,19225230,1656991,20882221,1,0,0,206336,5,7956179245
901,19236299,35874691,55110990,0,0,1,3584,10,7932232429
902,19244829,35887005,55131834,4,0,1,43520,2,10390322941
903,19294690,35838796,55133486,8,0,1,2560,2,9519293977
904,19359190,1361876,20721066,7,0,0,7168,16,4219051794
905,19399490,2332103,21731593,0,0,0,285696,10,4167730578
906,19399550,1322015,20721565,7,0,0,1536,16,7517676262
907,19417331,2680370,22097701,2,0,0,287232,4,10112019302
908,19436889,35696853,55133742,0,0,1,9216,10,2764760194
909,19440701,2568830,22009531,2,0,0,491008,4,5749241245
910,19453960,2278244,21732204,3,0,0,1536,3,3476005667
911,19495320,2832551,22327871,0,0,0,121344,10,10356310008
912,19505520,1602669,21108189,7,0,0,1024,16,20608270
913,19595640,1986187,21581827,1,0,0,568320,5,1169873119
914,19598560,2032727,21631287,7,0,0,2560,16,3359946143
915,19647400,35516336,55163736,3,0,1,45056,3,2104440418
916,19691420,1890758,21582178,3,0,0,1024,3,5180883281
917,19740700,552672,20293372,7,0,0,512,16,9348296759
918,19752791,35474399,55227190,6,0,1,121856,7,1332272558
919,19769720,35537840,55307560,8,0,1,31232,2,5085876643
920,19771540,35536043,55307583,2,0,1,43520,4,5307733424
921,19801451,35529600,55331051,6,0,1,94208,7,101879468
922,19827830,35537897,55365727,3,0,1,42496,3,4633241128
923,19850759,35547599,55398358,4,0,1,75264,2,3158345251
924,19921520,1703023,21624543,9,0,0,5632,17,6255256244
925,19965799,35646479,55612278,4,0,1,51712,2,7107548212
926,19980510,1190335,21170845,0,0,0,128000,10,8267331317
927,19984741,2189579,22174320,2,0,0,251392,4,1103336852
928,19985640,35654360,55640000,7,0,1,5632,16,2150921540
929,19992240,2017930,22010170,7,0,0,2048,16,337672534
930,20004619,35640770,55645389,4,0,1,17408,2,3053552312
931,20052420,2321556,22373976,9,0,0,108544,17,5424641642
932,20097200,35635369,55732569,7,0,1,37888,16,10222040096
933,20115969,1473972,21589941,8,0,0,4096,2,5495961780
934,20116430,2174446,22290876,9,0,0,157184,17,1043267734
935,20132260,35608345,55740605,3,0,1,25088,3,3932892447
936,20146460,2086119,22232579,1,0,0,190976,5,5533800288
937,20181880,2158814,22340694,1,0,0,41984,5,9105952269
938,20200610,35784012,55984622,7,0,1,23552,16,8633808923
939,20209430,2760001,22969431,0,0,0,570368,10,4829216192
940,20235179,2362636,22597815,8,0,0,512,2,7753836913
941,20245910,35742198,55988108,8,0,1,7168,2,7364125808
942,20260810,35727321,55988131,8,0,1,12288,2,3796739689
943,20263271,35724883,55988154,6,0,1,88576,7,7138328433
944,20270970,35717207,55988177,7,0,1,14848,16,835155372
945,20292841,2171790,22464631,2,0,0,111616,4,81502135
946,20298321,35689879,55988200,6,0,1,30720,7,5048013964
947,20343081,2254555,22597636,2,0,0,362496,4,2840760753
948,20403059,35598227,56001286,4,0,1,184320,2,9511169596
949,20417039,2287032,22704071,8,0,0,8704,2,435301688
950,20442681,35689486,56132167,6,0,1,226816,7,423174630
951,20457600,2513421,22971021,3,0,0,3072,3,472439487
952,20476290,1906805,22383095,1,0,0,29696,5,5798331576
953,20486750,35645440,56132190,7,0,1,23552,16,8082432959
954,20523449,1709785,22233234,8,0,0,2048,2,8527824306
955,20552340,2046456,22598796,7,0,0,1024,16,7470754131
956,20561940,2413338,22975278,3,0,0,512,3,8035484952
957,20563130,35577533,56140663,8,0,1,16384,2,10707973145
958,20572900,2034047,22606947,1,0,0,26624,5,5550127243
959,20575830,35565819,56141649,3,0,1,1536,3,2174547574
960,20603701,35578810,56182511,6,0,1,91136,7,6420277730
961,20608489,35677342,56285831,4,0,1,196608,2,9970666435
962,20650220,612083,21262303,3,0,0,3584,3,7082686742
963,20661530,35625684,56287214,2,0,1,14848,4,7889857624
964,20698739,35627515,56326254,4,0,1,52736,2,10176807775
965,20711221,35643984,56355205,6,0,1,76288,7,7112363992
966,20713791,35649544,56363335,6,0,1,30208,7,365655320
967,20716021,1526948,22242969,2,0,0,31744,4,9448095608
968,20726219,35909110,56635329,4,0,1,187392,2,10506658582
969,20735260,35919696,56654956,8,0,1,51712,2,6674775316
970,20769900,35885415,56655315,3,0,1,9728,3,1042739336
971,20785309,1005891,21791200,8,0,0,2048,2,6979430110
972,20787979,36071922,56859901,4,0,1,289280,2,1761785243
973,20818780,36041152,56859932,8,0,1,24064,2,1626399546
974,20829241,36105223,56934464,6,0,1,182272,7,5450300225
975,20878550,36073199,56951749,8,0,1,36352,2,2480016768
976,20880701,36175878,57056579,6,0,1,225792,7,10464226445
977,20901480,1439393,22340873,3,0,0,512,3,6300432860
978,20901940,1502311,22404251,7,0,0,1024,16,4407447213
979,20935850,2377285,23313135,9,0,0,249344,17,483271608
980,20950250,2026759,22977009,9,0,0,5632,17,4324753109
981,20984719,1680387,22665106,8,0,0,3072,2,2987430437
982,21006150,36061343,57067493,3,0,1,7168,3,2679679287
983,21013931,36247862,57261793,6,0,1,446976,7,3160876743
984,21055910,2888709,23944619,0,0,0,587264,10,8949467114
985,21110179,36164299,57274478,4,0,1,22528,2,8148522748
986,21111590,2005496,23117086,1,0,0,203776,5,8157521328
987,21126599,1991750,23118349,8,0,0,4096,2,6088417720
988,21141689,36138709,57280398,4,0,1,5120,2,4377084983
989,21145090,2459957,23605047,9,0,0,348160,17,7477039573
990,21159449,1438849,22598298,8,0,0,1536,2,12097254
991,21171359,36560005,57731364,4,0,1,758784,2,6264117916
992,21178980,2224335,23403315,1,0,0,8704,5,3921007611
993,21185790,36545597,57731387,7,0,1,47616,16,6147726489
994,21232159,2081771,23313930,8,0,0,2560,2,1743681901
995,21254681,36476729,57731410,9,0,1,14336,17,2413807926
996,21260630,1714477,22975107,7,0,0,7168,16,4351482507
997,21263341,36468092,57731433,9,0,1,1536,17,8613440887
998,21265959,36653241,57919200,4,0,1,407040,2,2629294986
999,21285019,1455028,22740047,8,0,0,4096,2,6947022541
1000,21291890,2905031,24196921,9,0,0,256512,17,3440209213
1001,21315920,3353275,24669195,1,0,0,158720,5,1261511939
1002,21363180,1606890,22970070,7,0,0,2048,16,4346376203
1003,21375620,1222849,22598469,3,0,0,512,3,10585083601
1004,21381291,3753639,25134930,2,0,0,53248,4,3834308201
1005,21409700,5588413,26998113,9,0,0,279552,17,5320307116
1006,21422120,2184226,23606346,3,0,0,3584,3,3134738918
1007,21422770,2611575,24034345,9,0,0,45568,17,3273500648
1008,21431930,36492538,57924468,3,0,1,22016,3,5370282600
1009,21461910,3052689,24514599,0,0,0,44544,10,8687990465
1010,21465250,2808750,24274000,0,0,0,252928,10,1113368011
1011,21488039,2456947,23944986,8,0,0,1024,2,125619862
1012,21488380,4472725,25961105,0,0,0,6656,10,8612668669
1013,21492851,3509416,25002267,2,0,0,453120,4,1534540526
1014,21516000,2599356,24115356,0,0,0,217600,10,2873107542
1015,21527189,2110239,23637428,8,0,0,1536,2,7388031460
1016,21569030,1403878,22972908,7,0,0,6144,16,3482414796
1017,21596021,5130700,26726721,2,0,0,385536,4,5136228937
1018,21597900,36335972,57933872,3,0,1,15360,3,5504269488
1019,21605891,3692040,25297931,2,0,0,467456,4,6554139290
1020,21617209,36516943,58134152,4,0,1,195072,2,7115718386
1021,21639659,1414134,23053793,8,0,0,2048,2,2712296409
1022,21687999,2031319,23719318,8,0,0,3072,2,3398455100
1023,21689640,3986004,25675644,3,0,0,1536,3,3345367678
1024,21711499,1772403,23483902,8,0,0,512,2,6293770603
1025,21727119,36576089,58303208,4,0,1,87040,2,3195595372
1026,21781169,36522062,58303231,4,0,1,81920,2,293200097
1027,21790750,4686390,26477140,1,0,0,437760,5,3041106968
1028,21808150,4231750,26039900,9,0,0,258560,17,10662107372
1029,21818619,36492154,58310773,4,0,1,49664,2,3826634113
1030,21823829,1294691,23118520,8,0,0,512,2,9022498680
1031,21845430,3564049,25409479,1,0,0,2048,5,5062931159
1032,21851380,5461649,27313029,3,0,0,669184,3,2157524674
1033,21889890,3453928,25343818,3,0,0,150528,3,7221187690
1034,21908569,36509168,58417737,4,0,1,302592,2,8899307471
1035,21986909,36523580,58510489,4,0,1,223744,2,3546908788
1036,21992320,5492557,27484877,9,0,0,492544,17,5522369241
1037,21999730,3376038,25375768,3,0,0,88064,3,2932897521
1038,22009200,2742260,24751460,7,0,0,1024,16,221627123
1039,22014890,3364013,25378903,9,0,0,10240,17,1081420559
1040,22039901,3579003,25618904,2,0,0,59392,4,4462233711
1041,22043600,5818632,27862232,3,0,0,569856,3,1149730256
1042,22053509,36488918,58542427,4,0,1,69632,2,4436806916
1043,22062069,36553605,58615674,4,0,1,129536,2,9407187273
1044,22086320,2239225,24325545,0,0,0,7680,10,9567471435
1045,22089339,2028034,24117373,8,0,0,1536,2,3639051472
1046,22143919,36711972,58855891,4,0,1,361984,2,7202460378
1047,22214740,4698182,26912922,9,0,0,64512,17,588645885
1048,22259130,4232958,26492088,3,0,0,7680,3,3883988835
1049,22266140,4077605,26343745,9,0,0,225792,17,8190995186
1050,22283529,36673134,58956663,4,0,1,81920,2,3147957245
1051,22285820,5765043,28050863,1,0,0,77312,5,9818088795
1052,22288620,36668066,58956686,3,0,1,10240,3,4842633670
1053,22323810,3351351,25675161,9,0,0,112640,17,7579201137
1054,22338300,4995047,27333347,1,0,0,44544,5,671592767
1055,22352319,4209186,26561505,8,0,0,4608,2,2260607255
1056,22408531,6166372,28574903,2,0,0,153600,4,7811926787
1057,22410420,2595918,25006338,0,0,0,13312,10,1596886891
1058,22421830,6297235,28719065,3,0,0,66048,3,3735814597
1059,22425439,36817146,59242585,4,0,1,660992,2,7687266963
1060,22493830,4399421,26893251,0,0,0,220160,10,10366534568
1061,22512740,3128086,25640826,3,0,0,33280,3,9919700560
1062,22525320,5745915,28271235,9,0,0,299520,17,4758130219
1063,22537920,36704688,59242608,3,0,1,5632,3,2790937591
1064,22542500,4777252,27319752,1,0,0,22016,5,7451980895
1065,22552020,36690611,59242631,3,0,1,3072,3,8266830274
1066,22565129,36787349,59352478,4,0,1,289792,2,6660858582
1067,22566490,36788254,59354744,3,0,1,3584,3,9707792004
1068,22576380,36785917,59362297,3,0,1,20480,3,54585535
1069,22588040,4443068,27031108,9,0,0,108032,17,4653728013
1070,22622030,5249657,27871687,9,0,0,30720,17,399127850
1071,22630320,4106712,26737032,1,0,0,33792,5,6255620060
1072,22704791,6971624,29676415,2,0,0,265216,4,1725585513
1073,22713210,6703125,29416335,9,0,0,143872,17,4179537675
1074,22743589,36665493,59409082,4,0,1,114688,2,1368216172
1075,22758120,6408511,29166631,1,0,0,300544,5,8614766266
1076,22759009,36799307,59558316,4,0,1,364032,2,2342472246
1077,22777110,6164258,28941368,7,0,0,3584,16,1059705104
1078,22811729,36758899,59570628,4,0,1,57856,2,3145412999
1079,22877060,4795563,27672623,1,0,0,191488,5,6502372954
1080,22898949,36772239,59671188,4,0,1,188416,2,5994762267
1081,22899940,7480379,30380319,0,0,0,422400,10,4659653753
1082,22907849,2827713,25735562,8,0,0,2560,2,2572167293
1083,22934090,3225699,26159789,0,0,0,9728,10,3733288909
1084,23001329,36677246,59678575,4,0,1,25088,2,2771336400
1085,23022010,6743533,29765543,1,0,0,46592,5,10100625875
1086,23057200,4537471,27594671,1,0,0,207872,5,5357448213
1087,23059940,3419027,26478967,7,0,0,5632,16,10468168754
1088,23062830,6821756,29884586,0,0,0,390656,10,2261472737
1089,23084600,4799925,27884525,9,0,0,19968,17,3346637825
1090,23141290,2990983,26132273,7,0,0,1536,16,3182205265
1091,23154159,37205854,60360013,4,0,1,1072128,2,2870619787
1092,23157351,37204928,60362279,9,0,1,3584,17,2868891859
1093,23184831,37205664,60390495,9,0,1,46080,17,9770123633
1094,23219330,7318159,30537489,3,0,0,179712,3,8809329899
1095,23251890,8030021,31281911,3,0,0,547840,3,1556474921
1096,23256289,37188676,60444965,4,0,1,144384,2,1214906767
1097,23265101,37180018,60445119,9,0,1,8704,17,10522674975
1098,23300231,37148562,60448793,9,0,1,16384,17,10008854212
1099,23320689,37133570,60454259,4,0,1,20992,2,2225194755
1100,23323060,37133043,60456103,2,0,1,25088,4,3752448451
1101,23354560,3715745,27070305,9,0,0,12800,17,8133072783
1102,23359459,3721320,27080779,8,0,0,2560,2,7481688662
1103,23360240,952150,24312390,3,0,0,14848,3,7281357661
1104,23374130,8354863,31728993,3,0,0,316928,3,8407478177
1105,23391160,5942700,29333860,0,0,0,195072,10,10470735464
1106,23404159,3930607,27334766,8,0,0,4608,2,3628939627
1107,23428680,6467465,29896145,9,0,0,37888,17,1302781088
1108,23456821,37023382,60480203,9,0,1,23040,17,7081189053
1109,23475791,37009238,60485029,9,0,1,7680,17,1969741223
1110,23485300,8865457,32350757,1,0,0,556032,5,1530658405
1111,23506740,8496134,32002874,9,0,0,28672,17,8122085603
1112,23507381,36984113,60491494,9,0,1,20480,17,6550885943
1113,23510161,36982959,60493120,9,0,1,2560,17,36384419
1114,23544011,36955523,60499534,9,0,1,23552,17,5153236911
1115,23547551,7208488,30756039,2,0,0,181248,4,992568536
1116,23555270,5384927,28940197,1,0,0,138240,5,5419923646
1117,23570180,4116030,27686210,9,0,0,44544,17,4039786812
1118,23587740,7871017,31458757,1,0,0,254976,5,4842330522
1119,23595860,4791375,28387235,9,0,0,61952,17,5408488633
1120,23612190,4290502,27902692,1,0,0,59392,5,1744596709
1121,23628580,6383189,30011769,1,0,0,108032,5,8757671838
1122,23640710,5234778,28875488,0,0,0,88576,10,738357695
1123,23666240,6897652,30563892,9,0,0,86528,17,6981040757
1124,23676869,839279,24516148,8,0,0,3584,2,5614566711
1125,23702100,8292015,31994115,0,0,0,475136,10,1359508510
1126,23762861,36739899,60502760,9,0,1,5120,17,7346938392
1127,23769770,4890095,28659865,3,0,0,50176,3,414070610
1128,23782800,5035999,28818799,7,0,0,1024,16,7677050431
1129,23865400,6047664,29913064,3,0,0,55296,3,4174153681
1130,23899791,5126224,29026015,2,0,0,39424,4,3297232329
1131,23921289,4540183,28461472,8,0,0,9216,2,2919603517
1132,24036850,4725237,28762087,0,0,0,26112,10,9906116536
1133,24037890,8468545,32506435,0,0,0,163840,10,8005984290
1134,24047751,8823634,32871385,2,0,0,483328,4,3195286297
1135,24062651,3815767,27878418,2,0,0,22016,4,6416574738
1136,24073441,36442876,60516317,9,0,1,40960,17,4190914005
1137,24096549,36843769,60940318,4,0,1,839168,2,3441716677
1138,24123570,5977274,30100844,9,0,0,14848,17,2217144047
1139,24173450,5839582,30013032,7,0,0,4096,16,277330308
1140,24181869,36790107,60971976,4,0,1,83968,2,35608905
1141,24208821,6879181,31088002,2,0,0,177152,4,6204274149
1142,24217140,4536976,28754116,0,0,0,34816,10,9843514927
1143,24220809,9578894,33799703,8,0,0,2560,2,7506127882
1144,24233430,9981611,34215041,9,0,0,22528,17,1196433727
1145,24234530,5442680,29677210,7,0,0,2560,16,3230818460
1146,24236110,9083067,33319177,1,0,0,78336,5,7672974228
1147,24267321,9312540,33579861,2,0,0,337920,4,9184412441
1148,24349550,4924859,29274409,1,0,0,50176,5,2309396589
1149,24364710,8848137,33212847,9,0,0,167936,17,3172399481
1150,24402570,9396330,33798900,9,0,0,111616,17,6357148604
1151,24456120,9546371,34002491,9,0,0,36864,17,4742250307
1152,24513750,10221082,34734832,9,0,0,77824,17,7763913803
1153,24578221,3999485,28577706,2,0,0,8704,4,5958964523
1154,24578350,1991739,26570089,7,0,0,2048,16,8663447251
1155,24589310,9905037,34494347,9,0,0,257536,17,950046907
1156,24602669,36593223,61195892,4,0,1,556544,2,10607688397
1157,24629350,4806289,29435639,1,0,0,32768,5,1555237640
1158,24712509,36694997,61407506,4,0,1,533504,2,6355211112
1159,24734549,4337147,29071696,8,0,0,3072,2,8545802382
1160,24760410,4498696,29259106,9,0,0,97792,17,4288133388
1161,24765450,10188751,34954201,9,0,0,295424,17,994952265
1162,24773010,7310447,32083457,7,0,0,32256,16,7717741264
1163,24801579,36636729,61438308,4,0,1,67584,2,1650307121
1164,24831149,36609425,61440574,4,0,1,3584,2,4847628172
1165,24843410,6952879,31796289,1,0,0,126464,5,4412000679
1166,24898800,10274597,35173397,9,0,0,434688,17,218344790
1167,24912509,1568345,26480854,8,0,0,6144,2,8473637390
1168,24961919,36585414,61547333,4,0,1,270848,2,9723544911
1169,24965080,5517638,30482718,0,0,0,71680,10,407109178
1170,25045120,4933718,29978838,0,0,0,59904,10,477677632
1171,25171570,7254975,32426545,9,0,0,71168,17,6451321592
1172,25259320,6281874,31541194,7,0,0,151552,16,4142577631
1173,25267660,10204620,35472280,0,0,0,158720,10,6283943898
1174,25301101,36264681,61565782,9,0,1,41984,17,2688505683
1175,25342900,9897224,35240124,7,0,0,70144,16,9668458684
1176,25363790,3002259,28366049,3,0,0,36864,3,6395536673
1177,25376430,10258955,35635385,9,0,0,266752,17,9224788976
1178,25393259,4316537,29709796,8,0,0,1024,2,8644895518
1179,25453530,5180793,30634323,9,0,0,78336,17,6168294946
1180,25454049,36124650,61578699,0,0,1,28672,10,8306197780
1181,25457879,2230686,27688565,8,0,0,7680,2,1268205584
1182,25496929,7375259,32872188,8,0,0,2560,2,1854766106
1183,25498400,10690238,36188638,0,0,0,355328,10,415491312
1184,25508270,2973722,28481992,3,0,0,10752,3,6687485312
1185,25515650,8604606,34120256,3,0,0,132096,3,8345681245
1186,25538290,4644462,30182752,9,0,0,154624,17,1803364876
1187,25593650,10300114,35893764,3,0,0,285184,3,4837301062
1188,25614159,36285781,61899940,4,0,1,788480,2,3088573204
1189,25627130,5695544,31322674,7,0,0,133632,16,6493337874
1190,25643060,8121809,33764869,0,0,0,111104,10,1513460702
1191,25697070,8382915,34079985,3,0,0,244736,3,4128269468
1192,25724680,11203472,36928152,1,0,0,416256,5,2792612314
1193,25746490,10791524,36538014,7,0,0,99328,16,4650765975
1194,25759189,6621254,32380443,8,0,0,2560,2,4465601422
1195,25777980,10543864,36321844,0,0,0,80896,10,2782588399
1196,25789650,7365293,33154943,0,0,0,39424,10,280395724
1197,25830500,4585075,30415575,3,0,0,13824,3,3500349527
1198,25841950,5192053,31034003,9,0,0,56832,17,3845741870
1199,25911819,35995507,61907326,4,0,1,35328,2,6283331537
1200,25914360,8795622,34709982,1,0,0,377344,5,3781720219
1201,25923869,36090134,62014003,4,0,1,261632,2,2879218816
1202,26018060,10934607,36952667,9,0,0,80384,17,5332373321
1203,26064880,35950403,62015283,2,0,1,14336,4,7727731647
1204,26085759,35931150,62016909,0,0,1,2560,10,4197929756
1205,26091300,10554238,36645538,1,0,0,7680,5,5814304597
1206,26108070,11425418,37533488,9,0,0,844800,17,28799972
1207,26111480,8197807,34309287,0,0,0,199680,10,6985082376
1208,26111780,7024419,33136199,7,0,0,36352,16,5459551805
1209,26118320,5707944,31826264,0,0,0,98304,10,6519137419
1210,26123739,35893990,62017729,0,0,1,19968,10,4994349964
1211,26124410,35893665,62018075,8,0,1,512,2,1852876970
1212,26165109,35975464,62140573,4,0,1,299520,2,522106101
1213,26187450,5993868,32181318,1,0,0,95232,5,4298813478
1214,26194019,6254116,32448135,8,0,0,512,2,2803159767
1215,26206380,11527527,37733907,3,0,0,267776,3,8878683005
1216,26216479,36161946,62378425,4,0,1,329216,2,3401469898
1217,26238499,36216848,62455347,4,0,1,63488,2,7804975734
1218,26244290,36242128,62486418,7,0,1,25600,16,2832436472
1219,26246950,36259582,62506532,2,0,1,37376,4,185219869
1220,26263001,11581127,37844128,2,0,0,195072,4,6954788782
1221,26276610,7018676,33295286,1,0,0,253952,5,10629878493
1222,26310590,36196928,62507518,2,0,1,1536,4,5949859783
1223,26341799,731456,27073255,8,0,0,3072,2,6706180415
1224,26349330,9074567,35423897,3,0,0,181248,3,6976743064
1225,26353460,6026180,32379640,9,0,0,94720,17,5416528172
1226,26354410,36161975,62516385,2,0,1,11776,4,3615392153
1227,26357149,36250578,62607727,4,0,1,131072,2,3641648300
1228,26359010,36253543,62612553,2,0,1,7680,4,6581391388
1229,26406390,36208749,62615139,2,0,1,4096,4,7482886797
1230,26412071,6122646,32534717,2,0,0,85504,4,1767183179
1231,26413580,9793645,36207225,0,0,0,60928,10,7146570743
1232,26463830,9280341,35744171,9,0,0,355840,17,323984161
1233,26477130,36149754,62626884,7,0,1,30720,16,5197072173
1234,26482430,36147706,62630136,7,0,1,5120,16,1709048057
1235,26509980,36131499,62641479,7,0,1,53760,16,4068037963
1236,26519880,36121855,62641735,2,0,1,9216,4,9419784636
1237,26521890,36156645,62678535,7,0,1,47616,16,938663106
1238,26556490,36133234,62689724,7,0,1,39936,16,2548982958
1239,26576181,6856862,33433043,2,0,0,115200,4,9439245027
1240,26665920,36046467,62712387,7,0,1,47104,16,10238394059
1241,26682691,10064081,36746772,2,0,0,72704,4,3604217446
1242,26689569,7829316,34518885,8,0,0,8192,2,3958640283
1243,26718969,5789673,32508642,8,0,0,7168,2,8110703056
1244,26737690,35977603,62715293,2,0,1,4608,4,5996919455
1245,26760269,8875459,35635728,8,0,0,1024,2,5041306124
1246,26763430,2714585,29478015,9,0,0,5632,17,5183148704
1247,26770210,35951189,62721399,2,0,1,20992,4,8016966692
1248,26784409,4211895,30996304,8,0,0,11776,2,4518442108
1249,26808710,35915275,62723985,7,0,1,4096,16,645449730
1250,26814061,36380113,63194174,6,0,1,363008,7,6868203386
1251,26831220,11602203,38433423,3,0,0,185856,3,3987158394
1252,26837120,9243231,36080351,0,0,0,53760,10,4269698480
1253,26839420,11220962,38060382,3,0,0,423936,3,8715076573
1254,26847950,36489232,63337182,7,0,1,31232,16,4737773595
1255,26871180,6141803,33012983,9,0,0,163328,17,9426975244
1256,26886450,6039564,32926014,7,0,0,31232,16,259800849
1257,26932271,5958816,32891087,2,0,0,61952,4,9906618118
1258,26960009,36423898,63383907,0,0,1,37376,10,9216910218
1259,26994709,5697347,32692056,8,0,0,66048,2,2515589038
1260,27023180,36364273,63387453,7,0,1,5632,16,8101212439
1261,27032820,36364285,63397105,2,0,1,26624,4,1992222967
1262,27062400,6859536,33921936,7,0,0,245248,16,9820535570
1263,27106400,36339250,63445650,2,0,1,57344,4,1209688796
1264,27217160,36353313,63570473,7,0,1,61952,16,805370248
1265,27258560,11419906,38678466,0,0,0,221696,10,10104729899
1266,27267890,36302606,63570496,7,0,1,16896,16,6881077029
1267,27343890,5091408,32435298,7,0,0,20992,16,1809599038
1268,27371380,11615317,38986697,9,0,0,459264,17,3912216365
1269,27396530,9246645,36643175,0,0,0,209920,10,2964281267
1270,27418050,10366603,37784653,1,0,0,108544,5,2688963197
1271,27439811,36130708,63570519,9,0,1,1536,17,8568311490
1272,27468801,10615496,38084297,2,0,0,78336,4,1261279588
1273,27472230,7307187,34779417,3,0,0,69632,3,1400705086
1274,27479681,36090861,63570542,9,0,1,512,17,10327733654
1275,27485500,11971947,39457447,0,0,0,175104,10,9478153258
1276,27486801,11853444,39340245,2,0,0,384000,4,6106778626
1277,27494870,36088539,63583409,7,0,1,48640,16,9542066571
1278,27505550,36078525,63584075,2,0,1,1024,4,2183925285
1279,27550770,6296411,33847181,1,0,0,48128,5,4050678018
1280,27554611,5570489,33125100,2,0,0,93696,4,10417277803
1281,27562290,7426098,34988388,0,0,0,112128,10,2264771577
1282,27568359,36020222,63588581,0,0,1,7168,10,1596735488
1283,27568500,36022027,63590527,8,0,1,3072,2,2971917918
1284,27660569,35930522,63591091,0,0,1,10752,10,588074643
1285,27661941,35936604,63598545,9,0,1,20480,17,9567563149
1286,27668491,11488362,39156853,2,0,0,121856,4,1535263090
1287,27687039,35914816,63601855,0,0,1,13312,10,983298274
1288,27689410,35924028,63613438,8,0,1,10752,2,9843308575
1289,27706540,5652759,33359299,9,0,0,6144,17,7608682996
1290,27720889,36747004,64467893,4,0,1,390656,2,2444614880
1291,27747849,36795850,64543699,4,0,1,84480,2,25342990
1292,27759951,11842357,39602308,2,0,0,321536,4,9511004013
1293,27787530,6558284,34345814,1,0,0,119808,5,6981504390
1294,27792649,37272685,65065334,4,0,1,675328,2,8487837767
1295,27811100,37305693,65116793,7,0,1,26112,16,3188933390
1296,27826821,12063578,39890399,2,0,0,460800,4,2100684160
1297,27860640,7693430,35554070,7,0,0,166912,16,1146941112
1298,27883820,8762989,36646809,9,0,0,4096,17,1253609717
1299,27886650,9179590,37066240,3,0,0,28160,3,10015851136
1300,27899349,37326696,65226045,4,0,1,105984,2,2674314444
1301,27922819,37702439,65625258,4,0,1,621056,2,8155584333
1302,27926180,12130561,40056741,0,0,0,456704,10,4689641287
1303,27926189,37699583,65625772,0,0,1,36352,10,1359903062
1304,27942551,37683244,65625795,9,0,1,21504,17,2719712752
1305,27944400,37681426,65625826,7,0,1,7680,16,428445522
1306,27947731,37678118,65625849,9,0,1,9728,17,1522133682
1307,27948230,9301060,37249290,0,0,0,67072,10,8438403974
1308,27989980,37635892,65625872,8,0,1,8704,2,7260870600
1309,28080471,37545424,65625895,9,0,1,1536,17,10389252146
1310,28116560,12033858,40150418,0,0,0,168960,10,5597221691
1311,28143041,37482877,65625918,9,0,1,30208,17,6399084233
1312,28146450,37479491,65625941,8,0,1,512,2,7515326263
1313,28172080,9480216,37652296,1,0,0,73728,5,10356870366
1314,28237680,37388284,65625964,8,0,1,1536,2,2767080050
1315,28262091,37365839,65627930,9,0,1,52736,17,5606524960
1316,28285839,37834834,66120673,4,0,1,735232,2,168068499
1317,28326500,6019501,34346001,9,0,0,512,17,6980516144
1318,28343861,9997734,38341595,2,0,0,803328,4,10436541051
1319,28348061,10209303,38557364,2,0,0,166912,4,10672037226
1320,28350371,37970504,66320875,6,0,1,309760,7,2949868532
1321,28352789,37968109,66320898,0,0,1,4096,10,4044419604
1322,28368190,5464304,33832494,0,0,0,107520,10,1264848436
1323,28371610,7891486,36263096,7,0,0,183296,16,7651710062
1324,28375031,7370887,35745918,2,0,0,5632,4,1817186396
1325,28402740,37918181,66320921,8,0,1,25088,2,9400614568
1326,28416570,5706829,34123399,9,0,0,10240,17,2370914168
1327,28447511,37873433,66320944,6,0,1,2560,7,786130031
1328,28454881,37866086,66320967,9,0,1,1536,17,1764379170
1329,28491170,37829820,66320990,7,0,1,5632,16,4978109455
1330,28501340,37819673,66321013,8,0,1,1024,2,9964051124
1331,28505801,9400640,37906441,2,0,0,115712,4,6808210112
1332,28520450,7824661,36345111,0,0,0,76288,10,8703940403
1333,28598700,8453809,37052509,9,0,0,1536,17,108614053
1334,28614291,37771848,66386139,6,0,1,246272,7,7738386016
1335,28670710,6040387,34711097,9,0,0,3584,17,8483608100
1336,28723890,37662403,66386293,8,0,1,8704,2,1197958383
1337,28733931,37712419,66446350,6,0,1,146432,7,9849088749
1338,28865061,37685673,66550734,6,0,1,233984,7,3960852376
1339,28890160,11369706,40259866,3,0,0,162816,3,6575593247
1340,28898540,11442710,40341250,9,0,0,6144,17,4357979994
1341,28916420,9460352,38376772,1,0,0,28672,5,8322143454
1342,28916950,5235689,34152639,9,0,0,8192,17,9895250693
1343,28946890,11421315,40368205,9,0,0,2048,17,2477370970
1344,28957399,37609337,66566736,1,0,1,45568,5,6705391922
1345,29021721,37545886,66567607,6,0,1,12288,7,8844982007
1346,29022041,37620563,66642604,6,0,1,176128,7,7018268302
1347,29027030,6013900,35040930,0,0,0,54784,10,6333023669
1348,29038041,37650171,66688212,6,0,1,83968,7,4972905166
1349,29054100,9042700,38096800,0,0,0,40960,10,8979173340
1350,29077069,37629868,66706937,0,0,1,36864,10,2691448920
1351,29126790,8099990,37226780,1,0,0,85504,5,2156271656
1352,29198030,5318336,34516366,7,0,0,72192,16,1564550830
1353,29212890,9885573,39098463,1,0,0,99840,5,9753198766
1354,29261050,6242141,35503191,0,0,0,101376,10,3431020418
1355,29298200,10105872,39404072,1,0,0,209408,5,3616954582
1356,29298850,11109181,40408031,0,0,0,84480,10,3011805785
1357,29356900,7150827,36507727,0,0,0,293888,10,1899875725
1358,29365510,8554526,37920036,7,0,0,44544,16,6045354894
1359,29367151,37648082,67015233,6,0,1,588800,7,3109745099
1360,29367660,37648879,67016539,3,0,1,2048,3,8983555648
1361,29372130,7411105,36783235,9,0,0,6144,17,681708457
1362,29445720,37602623,67048343,2,0,1,15360,4,9337085599
1363,29522991,9087904,38610895,2,0,0,175616,4,3115804753
1364,29555500,5434791,34990291,9,0,0,6144,17,2782547848
1365,29562821,37652623,67215444,6,0,1,344064,7,3559337950
1366,29579890,37641497,67221387,3,0,1,11776,3,10141411195
1367,29581701,37793624,67375325,6,0,1,348160,7,8983049162
1368,29594470,37792376,67386846,2,0,1,19968,4,833871070
1369,29606530,37783222,67389752,3,0,1,4608,3,1068155721
1370,29608220,37794695,67402915,2,0,1,21504,4,3763975295
1371,29621620,8008189,37629809,0,0,0,28160,10,39945092
1372,29637821,38099438,67737259,6,0,1,119808,7,10618825254
1373,29659121,7389392,37048513,2,0,0,164864,4,6128556423
1374,29702011,10894090,40596101,2,0,0,370688,4,2203386910
1375,29719960,10569257,40289217,3,0,0,96256,3,3149242746
1376,29761440,6145139,35906579,7,0,0,41984,16,7431956804
1377,29769090,9895040,39664130,9,0,0,1024,17,1794260265
1378,29770430,37996246,67766676,3,0,1,51200,3,4024180430
1379,29824280,38003261,67827541,3,0,1,26624,3,7681307259
1380,29879199,37966412,67845611,0,0,1,30208,10,648357768
1381,29884259,37963298,67847557,0,0,1,3072,10,2385571396
1382,29947611,38258181,68205792,6,0,1,175104,7,8885437196
1383,29955310,8854281,38809591,7,0,0,394240,16,115356042
1384,29957109,38277745,68234854,0,0,1,46080,10,9690620119
1385,29977110,5278642,35255752,0,0,0,35840,10,894471766
1386,30014820,10987190,41002010,7,0,0,193024,16,3331462546
1387,30020581,38336291,68356872,6,0,1,329728,7,9241317678
1388,30023481,7597725,37621206,2,0,0,196608,4,5110739188
1389,30036180,1579353,31615533,9,0,0,1024,17,1735182279
1390,30052710,9015302,39068012,7,0,0,266752,16,5290224635
1391,30089210,7170912,37260122,1,0,0,11776,5,5800099506
1392,30094129,38286599,68380728,0,0,1,56320,10,2563674178
1393,30095671,38298556,68394227,6,0,1,15872,7,4742457260
1394,30121789,38280025,68401814,0,0,1,22528,10,9153195340
1395,30148319,38265013,68413332,0,0,1,15360,10,5913570390
1396,30154209,38264269,68418478,0,0,1,8192,10,2149612134
1397,30154700,38269616,68424316,2,0,1,18432,4,7077643418
1398,30157670,38424969,68582639,2,0,1,22016,4,5895675196
1399,30161250,10636283,40797533,1,0,0,238080,5,6308084664
1400,30161329,38421333,68582662,0,0,1,10240,10,9933021447
1401,30212789,38369896,68582685,0,0,1,18432,10,1104331833
1402,30220840,6072855,36293695,1,0,0,100352,5,3113831316
1403,30254790,8864912,39119702,0,0,0,69632,10,9985783760
1404,30283850,38298858,68582708,2,0,1,13312,4,6652159726
1405,30292920,11122217,41415137,1,0,0,841216,5,4677961620
1406,30372110,5925063,36297173,9,0,0,5120,17,10622166033
1407,30385010,5975346,36360356,3,0,0,39936,3,5449427170
1408,30431731,38151000,68582731,6,0,1,49664,7,7171126031
1409,30486230,38096524,68582754,3,0,1,16384,3,9141945127
1410,30516789,38066020,68582809,0,0,1,88064,10,4577186878
1411,30525700,9835720,40361420,0,0,0,10752,10,5509792525
1412,30529440,9210841,39740281,3,0,0,249856,3,7621087652
1413,30531480,5814286,36345766,9,0,0,2048,17,6773855790
1414,30603279,37979553,68582832,0,0,1,38912,10,9333582796
1415,30617340,11207193,41824533,0,0,0,832512,10,4574777091
1416,30646530,7211037,37857567,0,0,0,44032,10,4735046143
1417,30647070,37957609,68604679,7,0,1,11776,16,61671619
1418,30651640,37956265,68607905,3,0,1,5120,3,6829012435
1419,30705760,7215235,37920995,9,0,0,3072,17,2024185566
1420,30762670,37864971,68627641,7,0,1,23552,16,5342444209
1421,30820940,8025802,38846742,0,0,0,121856,10,3091382262
1422,30823701,38046663,68870364,6,0,1,239104,7,1629899580
1423,30834490,9083076,39917566,0,0,0,89088,10,10595034231
1424,30883159,37988055,68871214,0,0,1,19968,10,1784504640
1425,30909360,8298863,39208223,1,0,0,58880,5,10086290808
1426,30962020,37909217,68871237,7,0,1,20992,16,1148043907
1427,30987050,37884210,68871260,3,0,1,4608,3,898156641
1428,30988340,37882951,68871291,8,0,1,26624,2,2415429673
1429,31027090,37867313,68894403,7,0,1,48128,16,4795584504
1430,31063080,8127180,39190260,3,0,0,109568,3,5188385038
1431,31077260,10863391,41940651,7,0,0,379904,16,7960497731
1432,31112580,10021429,41134009,0,0,0,32256,10,6863228014
1433,31142240,10428590,41570830,1,0,0,20992,5,3707093524
1434,31157000,9881381,41038381,0,0,0,119296,10,4497996347
1435,31161390,8937525,40098915,1,0,0,110080,5,5696292292
1436,31168210,37740876,68909086,3,0,1,22528,3,479423142
1437,31188510,10817909,42006419,4,0,0,30720,2,6523575322
1438,31219329,37690116,68909445,0,0,1,9728,10,7580742604
1439,31220730,37699492,68920222,3,0,1,10240,3,7197207797
1440,31224450,8985785,40210235,1,0,0,150016,5,8669687562
1441,31282410,10964482,42246892,1,0,0,132608,5,6588897321
1442,31298171,37660890,68959061,6,0,1,93696,7,4971786686
1443,31323950,4448965,35772915,9,0,0,13312,17,2448303273
1444,31347870,9010251,40358121,1,0,0,55296,5,6074761904
1445,31361730,37617956,68979686,7,0,1,28672,16,5531570941
1446,31379260,7305017,38684277,1,0,0,18944,5,2885590317
1447,31436220,37548326,68984546,3,0,1,11264,3,212996091
1448,31442360,37545092,68987452,7,0,1,4608,16,5514928357
1449,31506170,10812552,42318722,0,0,0,187904,10,8920880117
1450,31527790,10733649,42261439,4,0,0,47616,2,4894034655
1451,31546030,5588706,37134736,0,0,0,91648,10,3379346179
1452,31554941,37444649,68999590,9,0,1,35840,17,8306242950
1453,31560040,10773564,42333604,1,0,0,40448,5,4213219060
1454,31562571,37440549,69003120,9,0,1,25088,17,10311354307
1455,31567250,37458993,69026243,3,0,1,49664,3,3316400442
1456,31575190,5986089,37561279,7,0,0,91136,16,5495025736
1457,31577700,37471023,69048723,7,0,1,9216,16,5437378704
1458,31581460,8887933,40469393,3,0,0,67584,3,4072596935
1459,31627600,37434361,69061961,3,0,1,22528,3,7747614086
1460,31646360,37430318,69076678,7,0,1,36352,16,1546963535
1461,31662601,37416983,69079584,9,0,1,4608,17,8958613087
1462,31666530,9268019,40934549,3,0,0,326656,3,1099665003
1463,31728859,37351865,69080724,0,0,1,10240,10,872353021
1464,31738379,37351048,69089427,0,0,1,8192,10,1269313560
1465,31793050,9260486,41053536,4,0,0,49664,2,7862556350
1466,31798721,37307413,69106134,9,0,1,22528,17,5450471424
1467,31812760,37294360,69107120,7,0,1,1536,16,6739541275
1468,31847810,6023352,37871162,7,0,0,44544,16,9061829188
1469,31862530,37245870,69108400,7,0,1,14336,16,4806539096
1470,31922079,37186475,69108554,0,0,1,8704,10,5296710249
1471,31974509,37140084,69114593,0,0,1,8704,10,10102034220
1472,31998790,10573257,42572047,3,0,0,135168,3,2282926610
1473,32015900,6478386,38494286,1,0,0,199680,5,4648394736
1474,32100630,37014424,69115054,7,0,1,10240,16,10284249570
1475,32126971,36998197,69125168,9,0,1,39424,17,449653546
1476,32160170,4135420,36295590,9,0,0,6144,17,1108676458
1477,32173580,7490215,39663795,7,0,0,201728,16,4118446260
1478,32186270,8153085,40339355,7,0,0,1024,16,5737310962
1479,32258770,5492788,37751558,3,0,0,57856,3,7870682560
1480,32321900,36831504,69153404,8,0,1,5632,2,6566565977
1481,32334930,4893901,37228831,9,0,0,6656,17,9328533203
1482,32410649,36746621,69157270,0,0,1,6144,10,4430397063
1483,32441681,36746571,69188252,9,0,1,100864,17,6141251536
1484,32477171,36720463,69197634,9,0,1,15872,17,10463565145
1485,32485850,5882163,38368013,0,0,0,81408,10,1050533497
1486,32487860,6201588,38689448,0,0,0,16896,10,9936066174
1487,32491040,6015437,38506477,7,0,0,39936,16,6567860632
1488,32528330,7839049,40367379,7,0,0,19456,16,5686269629
1489,32538900,8966474,41505374,1,0,0,209408,5,739967595
1490,32539540,36684860,69224400,7,0,1,41472,16,8249048628
1491,32639249,36586999,69226248,0,0,1,15360,10,8386112126
1492,32644349,36591808,69236157,0,0,1,35840,10,2281608084
1493,32659709,36607099,69266808,0,0,1,12800,10,5536397768
1494,32708499,36562175,69270674,0,0,1,6144,10,6407304236
1495,32721221,37345167,70066388,6,0,1,1133568,7,2214547134
1496,32733540,6489682,39223222,7,0,0,49152,16,412820968
1497,32733870,9848519,42582389,9,0,0,1024,17,9747828008
1498,32735570,9470887,42206457,0,0,0,427520,10,9029670250
1499,32806659,37263103,70069762,0,0,1,4096,10,8866698010
1500,32839370,3705687,36545057,1,0,0,23040,5,4766781834
1501,32846961,37227986,70074947,9,0,1,16384,17,822332561
1502,32848759,37272484,70121243,0,0,1,22528,10,7541271860
1503,32878380,37254010,70132390,7,0,1,28160,16,1237348803
1504,32907330,37259817,70167147,8,0,1,5120,2,3118327801
1505,32907469,37265989,70173458,0,0,1,22016,10,3396757230
1506,32985170,9919350,42904520,7,0,0,93696,16,9414132921
1507,32992550,6504084,39496634,3,0,0,128512,3,4485412987
1508,33015531,37196773,70212304,6,0,1,16384,7,6280471977
1509,33037010,7563638,40600648,0,0,0,14848,10,5277719973
1510,33048930,7378632,40427562,7,0,0,64000,16,495290201
1511,33068280,8756588,41824868,9,0,0,1024,17,4636879374
1512,33076450,10033360,43109810,4,0,0,201728,2,6177252067
1513,33091710,8984464,42076174,1,0,0,228864,5,8546210642
1514,33124301,37662851,70787152,6,0,1,370176,7,4765223814
1515,33134971,37747855,70882826,6,0,1,45056,7,10218758944
1516,33148001,37734864,70882865,6,0,1,54784,7,6650561568
1517,33159609,37723279,70882888,0,0,1,6144,10,3106117021
1518,33164630,10368861,43533491,1,0,0,473600,5,2890713613
1519,33166580,10010088,43176668,4,0,0,54784,2,2587447760
1520,33184250,6881094,40065344,7,0,0,28160,16,10609029486
1521,33236851,37646060,70882911,9,0,1,32256,17,6225001041
1522,33292060,37590874,70882934,7,0,1,50688,16,7514645870
1523,33316180,37566777,70882957,7,0,1,41472,16,8818650305
1524,33338009,37557634,70895643,0,0,1,47104,10,7805722417
1525,33374140,37533700,70907840,7,0,1,3072,16,622952435
1526,33375301,37576068,70951369,6,0,1,157184,7,2345553129
1527,33447750,7171508,40619258,0,0,0,60416,10,1138367285
1528,33461140,10234075,43695215,0,0,0,243712,10,5347601811
1529,33511181,37468024,70979205,6,0,1,56320,7,3326600589
1530,33524270,7911482,41435752,7,0,0,67584,16,6861876078
1531,33529120,8007812,41536932,9,0,0,2560,17,6078738415
1532,33531500,10287477,43818977,7,0,0,371200,16,3152401738
1533,33543339,37440487,70983826,0,0,1,3072,10,5322546036
1534,33560300,37425152,70985452,7,0,1,2560,16,4624018602
1535,33567449,37421229,70988678,0,0,1,5120,10,959049929
1536,33641261,37360284,71001545,9,0,1,47616,17,7638087768
1537,33660060,9181506,42841566,0,0,0,387584,10,1609477567
1538,33703879,37299612,71003491,0,0,1,3072,10,8709385242
1539,33714040,8812844,42526884,1,0,0,11264,5,3248547073
1540,33760840,6402393,40163233,1,0,0,41984,5,7504886996
1541,33767900,9226874,42994774,3,0,0,169984,3,2612861981
1542,33813070,4530108,38343178,9,0,0,5120,17,9002210832
1543,33839631,37194648,71034279,9,0,1,17408,17,1483671613
1544,33853301,37568691,71421992,6,0,1,564224,7,3089150055
1545,33882690,6456330,40339020,3,0,0,163328,3,5314102259
1546,33902390,8094623,41997013,3,0,0,48640,3,5331280526
1547,33939110,5810866,39749976,7,0,0,31744,16,6569611732
1548,33962051,37464355,71426406,9,0,1,2048,17,6114520808
1549,33973680,9415488,43389168,3,0,0,205312,3,7115997688
1550,34003759,37513255,71517014,4,0,1,56320,2,1388961127
1551,34008639,37612391,71621030,4,0,1,130048,2,9778588890
1552,34029270,7952900,41982170,0,0,0,136192,10,1209202377
1553,34034260,9970895,44005155,1,0,0,474112,5,6796608105
1554,34057981,37566516,71624497,9,0,1,40960,17,453773647
1555,34109371,37707050,71816421,6,0,1,223232,7,10606461070
1556,34131700,7404429,41536129,0,0,0,100864,10,3227873935
1557,34132020,6296829,40428849,9,0,0,4096,17,6593922456
1558,34142159,37937894,72080053,4,0,1,557056,2,5264747780
1559,34162650,9948631,44111281,0,0,0,190464,10,5981846196
1560,34166210,5998294,40164504,9,0,0,4096,17,1112078425
1561,34167140,5337169,39504309,1,0,0,25088,5,8659261247
1562,34192631,37987278,72179909,6,0,1,173568,7,2472101403
1563,34194881,37997652,72192533,6,0,1,49664,7,2872689376
1564,34229961,38001140,72231101,6,0,1,98816,7,8821265596
1565,34235331,37996538,72231869,6,0,1,11776,7,1180603241
1566,34257230,9900764,44157994,0,0,0,46592,10,1699767494
1567,34266239,38000015,72266254,4,0,1,68608,2,6412251678
1568,34275960,9344976,43620936,0,0,0,139776,10,5269267801
1569,34278040,6089518,40367558,9,0,0,512,17,6203068965
1570,34298620,8051771,42350391,4,0,0,18432,2,6674155200
1571,34300679,6081589,40382268,8,0,0,46080,2,2537323430
1572,34311069,37960011,72271080,4,0,1,7680,2,10394112011
1573,34311720,6631276,40942996,0,0,0,27648,10,6865110568
1574,34312820,37965425,72278245,2,0,1,19968,4,5343584220
1575,34338380,10022850,44361230,7,0,0,471040,16,1010405988
1576,34357841,38149844,72507685,6,0,1,261632,7,8707765206
1577,34459280,9593946,44053226,0,0,0,157696,10,5234146583
1578,34484560,10162555,44647115,0,0,0,669696,10,7979931844
1579,34508380,6092447,40600827,9,0,0,512,17,4528689102
1580,34546500,9651944,44198444,0,0,0,131584,10,5928036701
1581,34548060,9610269,44158329,3,0,0,1024,3,9011655028
1582,34558330,7006081,41564411,4,0,0,90112,2,9385573863
1583,34578710,10398468,44977178,7,0,0,136192,16,3143870755
1584,34600329,38142687,72743016,4,0,1,201216,2,7788234208
1585,34605620,8972705,43578325,0,0,0,141824,10,1755121334
1586,34618510,10073119,44691629,9,0,0,5632,17,1884937592
1587,34622760,10202896,44825656,1,0,0,439808,5,4230353450
1588,34647070,8599659,43246729,0,0,0,33280,10,2127517100
1589,34673791,38114582,72788373,9,0,1,30720,17,6324501463
1590,34680211,38414849,73095060,6,0,1,203264,7,2080790997
1591,34685471,38505330,73190801,6,0,1,75776,7,3948016570
1592,34700470,7620779,42321249,3,0,0,8192,3,5898593946
1593,34713590,10399697,45113287,4,0,0,229376,2,4389234296
1594,34774110,9915780,44689890,0,0,0,140288,10,10095637701
1595,34784420,6158755,40943175,9,0,0,512,17,325311077
1596,34788070,8538129,43326199,9,0,0,5632,17,225725672
1597,34828410,10107249,44935659,1,0,0,360960,5,4520545217
1598,34849580,7615868,42465448,1,0,0,70656,5,2773923474
1599,34852809,38452209,73305018,4,0,1,215040,2,3806508583
1600,34888260,10258284,45146544,7,0,0,104960,16,172004369
1601,34926219,38394173,73320392,4,0,1,97792,2,4888729923
1602,34952310,10247008,45199318,0,0,0,162816,10,3008100638
1603,34975500,10376128,45351628,3,0,0,396800,3,10435617140
1604,34977170,5822882,40800052,0,0,0,8192,10,2282231944
1605,34988810,9122806,44111616,9,0,0,1024,17,1699374351
1606,34997940,10521816,45519756,9,0,0,512,17,106731881
1607,35017810,7564244,42582054,3,0,0,32768,3,6837913439
1608,35031160,38305553,73336713,5,0,1,10752,11,9917242580
1609,35078639,38338307,73416946,4,0,1,109056,2,3071494968
1610,35193760,10276326,45470086,3,0,0,345088,3,1970980591
1611,35202100,6239447,41441547,3,0,0,18944,3,1234511448
1612,35227030,9216014,44443044,7,0,0,56320,16,1120686214
1613,35235671,38182802,73418473,9,0,1,12800,17,6469999599
1614,35247010,7800587,43047597,0,0,0,151040,10,10380507787
1615,35289581,38129763,73419344,9,0,1,12288,17,8819909397
1616,35295820,9130033,44425853,0,0,0,211968,10,3689800511
1617,35315850,10294610,45610460,3,0,0,121344,3,8448024687
1618,35322700,9907997,45230697,3,0,0,102912,3,6405566140
1619,35323290,10196287,45519577,1,0,0,162304,5,5127783887
1620,35337520,10235922,45573442,7,0,0,175616,16,1506635633
1621,35414030,10333015,45747045,7,0,0,448000,16,5549388640
1622,35469330,6996453,42465783,9,0,0,1024,17,8582444849
1623,35508559,38182527,73691086,4,0,1,133120,2,10627021877
1624,35521621,38189210,73710831,6,0,1,134656,7,7571066097
1625,35530250,9834661,45364911,0,0,0,43520,10,640591768
1626,35549199,39226684,74775883,4,0,1,662528,2,5630128107
1627,35561220,7381739,42942959,7,0,0,49152,16,9757668818
1628,35587821,39229475,74817296,6,0,1,48640,7,8461170944
1629,35617571,39237380,74854951,6,0,1,64000,7,4831445438
1630,35641430,10210368,45851798,3,0,0,332288,3,10517290564
1631,35663911,39217639,74881550,9,0,1,5120,17,10539560051
1632,35721880,7428357,43150237,7,0,0,132608,16,8802130575
1633,35738420,10266593,46005013,4,0,0,502784,2,4447755763
1634,35757840,10292483,46050323,7,0,0,148480,16,2945190221
1635,35776330,9373357,45149687,9,0,0,10240,17,8336917752
1636,35785380,39396473,75181853,8,0,1,44544,2,6513700469
1637,35785481,39396395,75181876,6,0,1,36864,7,713820629
1638,35789270,10600400,46389670,1,0,0,885248,5,1330971732
1639,35819589,39389789,75209378,4,0,1,139776,2,1479256736
1640,35841099,39480834,75321933,4,0,1,465920,2,9338143630
1641,35863620,10226249,46089869,1,0,0,127488,5,5767136668
1642,35864751,39463460,75328211,9,0,1,36352,17,8973679783
1643,35929561,39439063,75368624,9,0,1,88064,17,6076199886
1644,35943200,9807323,45750523,9,0,0,9216,17,3961652414
1645,35949070,10655928,46604998,1,0,0,183808,5,10555513429
1646,35956899,39416466,75373365,4,0,1,6656,2,4282152926
1647,35978460,10535080,46513540,0,0,0,211456,10,9999633809
1648,36004490,7856178,43860668,0,0,0,136704,10,2010462021
1649,36015439,39361792,75377231,4,0,1,6144,2,7798711807
1650,36028470,9014906,45043376,7,0,0,214528,16,2130158379
1651,36029581,39361233,75390814,6,0,1,38912,7,7575008378
1652,36037540,10410536,46448076,9,0,0,7680,17,2200019492
1653,36078001,39434527,75512528,6,0,1,251392,7,2686296390
1654,36084091,39663252,75747343,6,0,1,199168,7,4984109639
1655,36090700,10600461,46691161,4,0,0,141824,2,1140756788
1656,36105751,39672940,75778691,6,0,1,43520,7,1983321262
1657,36125071,39654926,75779997,9,0,1,2048,17,7768977820
1658,36163830,7542016,43705846,0,0,0,34816,10,2866996295
1659,36181040,7962735,44143775,4,0,0,105472,2,3064856510
1660,36218100,8895622,45113722,9,0,0,1024,17,2074178743
1661,36279370,39538227,75817597,5,0,1,28672,11,1823458844
1662,36307751,39615585,75923336,9,0,1,31744,17,169473706
1663,36323569,39599790,75923359,4,0,1,5120,2,907911449
1664,36326200,7891487,44217687,4,0,0,62976,2,7317275107
1665,36327681,39595701,75923382,9,0,1,26112,17,9831132417
1666,36339370,7195712,43535082,9,0,0,5120,17,5808158831
1667,36341380,39593592,75934972,8,0,1,72704,2,2848801141
1668,36372591,39996570,76369161,6,0,1,263680,7,6355300671
1669,36430560,10369437,46799997,7,0,0,97280,16,8736357588
1670,36467090,8647435,45114525,9,0,0,2560,17,10227521956
1671,36517121,39926906,76444027,6,0,1,121856,7,6992356592
1672,36532821,40071895,76604716,6,0,1,173056,7,3866481765
1673,36632311,40313071,76945382,6,0,1,754176,7,8201751850
1674,36691549,40262091,76953640,1,0,1,42496,5,2227497543
1675,36712531,40241468,76953999,9,0,1,9728,17,10164509989
1676,36795160,9324724,46119884,7,0,0,98304,16,3647482048
1677,36930451,40045208,76975659,9,0,1,62976,17,10567651858
1678,36971729,40007476,76979205,1,0,1,5632,5,3086254242
1679,36977999,40024232,77002231,4,0,1,53760,2,4209350375
1680,36999690,9875229,46874919,4,0,0,115200,2,4164107936
1681,37016731,40145872,77162603,6,0,1,389120,7,10436568954
1682,37016910,40167589,77184499,7,0,1,13824,16,1273019336
1683,37027361,40307244,77334605,6,0,1,353280,7,8439155405
1684,37042539,40292630,77335169,4,0,1,10752,2,8668576564
1685,37048010,7929971,44977981,9,0,0,2560,17,5311105638
1686,37055509,40303330,77358839,0,0,1,58880,10,5773984563
1687,37063910,9381795,46445705,4,0,0,183808,2,8544867241
1688,37114400,40248305,77362705,8,0,1,6144,2,470709981
1689,37134511,40232380,77366891,9,0,1,6656,17,4046692670
1690,37187010,40205243,77392253,8,0,1,84480,2,7276130307
1691,37188471,40208288,77396759,9,0,1,7168,17,5562288957
1692,37192949,40210377,77403326,4,0,1,31232,2,7048508537
1693,37201429,40221227,77422656,4,0,1,7680,2,10446785499
1694,37251620,40173968,77425588,8,0,1,4608,2,642923576
1695,37258220,40172194,77430414,7,0,1,7680,16,5168785337
1696,37263300,8787686,46050986,9,0,0,2048,17,4663640093
1697,37268910,40173051,77441961,7,0,1,31744,16,6169151374
1698,37269680,40172742,77442422,7,0,1,10240,16,5387136254
1699,37271080,8476612,45747692,9,0,0,2048,17,9051045980
1700,37275650,10013747,47289397,1,0,0,194560,5,7611272977
1701,37289509,40161670,77451179,1,0,1,22016,5,9314222482
1702,37303370,9926724,47230094,7,0,0,310784,16,1083977720
1703,37315591,40146879,77462470,9,0,1,37376,17,1548432567
1704,37317940,9975068,47293008,1,0,0,11776,5,7692601448
1705,37328730,40144297,77473027,8,0,1,13312,2,7287089470
1706,37342011,40135202,77477213,9,0,1,18944,17,8257626835
1707,37358280,10184479,47542759,7,0,0,452608,16,4781645860
1708,37370180,40108518,77478698,7,0,1,15360,16,2286588849
1709,37380240,10327613,47707853,4,0,0,346112,2,9625198813
1710,37384400,40095604,77480004,8,0,1,2048,2,10716782039
1711,37420850,40060025,77480875,7,0,1,12288,16,9075324851
1712,37452460,9490087,46942547,4,0,0,220160,2,2322854988
1713,37481480,40006167,77487647,7,0,1,32256,16,5610675197
1714,37554020,10244174,47798194,7,0,0,194560,16,5720990352
1715,37581210,39934726,77515936,7,0,1,27648,16,4640011191
1716,37582380,39934542,77516922,8,0,1,1536,2,3133894883
1717,37588351,39944549,77532900,9,0,1,44544,17,4421261656
1718,37594149,39940425,77534574,1,0,1,4096,5,10275955038
1719,37600220,39947924,77548144,8,0,1,39936,2,8489935062
1720,37621081,39927831,77548912,9,0,1,11776,17,9507625250
1721,37624220,39925665,77549885,8,0,1,12800,2,3343799174
1722,37624890,8894329,46519219,1,0,0,18432,5,7973206711
1723,37650790,10279710,47930500,4,0,0,395776,2,6869697977
1724,37663189,39900020,77563209,1,0,1,4096,5,8042345644
1725,37705639,39858236,77563875,1,0,1,1024,5,5230159680
1726,37715780,8733301,46449081,4,0,0,3072,2,5699268708
1727,37769639,39795824,77565463,1,0,1,15872,5,8316868054
1728,37791880,39774249,77566129,7,0,1,1024,16,5519652517
1729,37804200,10291320,48095520,4,0,0,227840,2,6683932652
1730,37842910,39731220,77574130,8,0,1,38400,2,6587325838
1731,37854060,39724529,77578589,7,0,1,3072,16,9113812824
1732,37894530,9420216,47314746,9,0,0,5632,17,5783974626
1733,37906611,40431779,78338390,6,0,1,197120,7,904464197
1734,37941321,40631773,78573094,9,0,1,45568,17,6354884597
1735,37942080,40631037,78573117,7,0,1,8704,16,4717855092
1736,37952531,40620609,78573140,6,0,1,15872,7,1301158813
1737,37974301,40899593,78873894,6,0,1,400384,7,10600443250
1738,37979699,40894218,78873917,1,0,1,4096,5,9486744843
1739,37993201,40880739,78873940,9,0,1,3584,17,7483674392
1740,37997560,9137819,47135379,7,0,0,237056,16,6392927604
1741,38004471,40869983,78874454,6,0,1,101888,7,7992913123
1742,38005869,40868608,78874477,1,0,1,11776,5,9726335767
1743,38067799,40806701,78874500,1,0,1,32768,5,5086299359
1744,38071891,40802632,78874523,9,0,1,2048,17,3347293712
1745,38080690,9305017,47385707,7,0,0,20992,16,3509317499
1746,38087820,9225179,47312999,1,0,0,65536,5,9515739718
1747,38091260,9253009,47344269,1,0,0,96768,5,5735000466
1748,38093140,9932891,48026031,4,0,0,246272,2,2724054107
1749,38122850,9479524,47602374,4,0,0,195584,2,6988817985
1750,38162470,10025651,48188121,4,0,0,291840,2,5948965218
1751,38278841,40595705,78874546,9,0,1,13312,17,2051316502
1752,38287201,40853299,79140500,6,0,1,215552,7,7048444828
1753,38321760,40818763,79140523,7,0,1,20992,16,248795937
1754,38382021,40758525,79140546,9,0,1,8704,17,7354690087
1755,38410480,40730089,79140569,5,0,1,1536,11,2586985911
1756,38454490,9278666,47733156,4,0,0,82944,2,9882528130
1757,38472589,40668003,79140592,1,0,1,9728,5,3330373248
1758,38484610,9705094,48189704,1,0,0,5120,5,10316868198
1759,38498690,40641925,79140615,7,0,1,22016,16,8285507208
1760,38520130,40658283,79178413,5,0,1,5632,11,1972719469
1761,38571290,40607146,79178436,7,0,1,23040,16,7229898768
1762,38583271,40595188,79178459,9,0,1,10752,17,841873256
1763,38589350,9929895,48519245,1,0,0,179712,5,8558274781
1764,38622620,9645005,48267625,1,0,0,45056,5,6789618672
1765,38633530,9701428,48334958,7,0,0,12800,16,5361642350
1766,38645750,9679557,48325307,9,0,0,3072,17,9598763237
1767,38661330,40517152,79178482,7,0,1,16384,16,8428896413
1768,38748520,40431280,79179800,8,0,1,57856,2,8084572486
1769,38759450,9596966,48356416,9,0,0,4608,17,3669702309
1770,38766270,9621372,48387642,4,0,0,24064,2,1436578752
1771,38855900,9678390,48534290,1,0,0,49152,5,7663952483
1772,38881010,40407858,79288868,7,0,1,61952,16,5915955792
1773,38947640,9809847,48757487,1,0,0,65024,5,7807648909
1774,38967670,40321864,79289534,7,0,1,1024,16,5485992012
1775,38970251,40324570,79294821,6,0,1,16896,7,6012288590
1776,38980680,40314624,79295304,7,0,1,512,16,5747235554
1777,38986450,9925202,48911652,7,0,0,444928,16,4640817219
1778,39000359,40326809,79327168,1,0,1,30720,5,580800797
1779,39005370,40698664,79704034,7,0,1,151552,16,5960461651
1780,39020800,40683257,79704057,8,0,1,9216,2,2859832337
1781,39122320,40581760,79704080,8,0,1,2048,2,1437697024
1782,39150301,40918777,80069078,6,0,1,275968,7,9583292038
1783,39189330,9750398,48939728,4,0,0,15872,2,8356122839
1784,39208480,9703507,48911987,9,0,0,1024,17,9032668881
1785,39225970,9730652,48956622,7,0,0,49152,16,5247070478
1786,39248980,9692643,48941623,9,0,0,6144,17,3525358993
1787,39353621,40715488,80069109,6,0,1,38912,7,2205389351
1788,39386720,9525914,48912634,9,0,0,2048,17,1661523834
1789,39444350,40712497,80156847,7,0,1,4096,16,9125065138
1790,39444961,40777553,80222514,6,0,1,13824,7,8201942326
1791,39452740,9728894,49181634,9,0,0,2560,17,8546553839
1792,39456270,40886515,80342785,2,0,1,84992,4,1054179260
1793,39496910,40857568,80354478,7,0,1,13312,16,10499302929
1794,39497201,41386234,80883435,6,0,1,476672,7,1909221324
1795,39526170,41363464,80889634,8,0,1,8704,2,2426242045
1796,39536590,9917920,49454510,7,0,0,79872,16,4272812938
1797,39589511,41331257,80920768,6,0,1,62464,7,5790134340
1798,39594350,9760265,49354615,1,0,0,1024,5,7690719670
1799,39606070,41315684,80921754,5,0,1,1536,11,7553700334
1800,39622761,41395670,81018431,6,0,1,53760,7,9834208258
1801,39686940,41331514,81018454,2,0,1,20992,4,5222863463
1802,39709080,9815169,49524249,4,0,0,29696,2,9728020475
1803,39710890,10212366,49923256,1,0,0,415744,5,8927805746
1804,39741461,41398793,81140254,6,0,1,240128,7,4823937374
1805,39754320,10328813,50083133,4,0,0,193536,2,1446783363
1806,39779480,41360797,81140277,2,0,1,19456,4,4964270204
1807,39789800,10512242,50302042,4,0,0,332800,2,8830856566
1808,39805500,41372027,81177527,8,0,1,69632,2,1496857751
1809,39807380,41379770,81187150,5,0,1,7168,11,6800061172
1810,39808330,10614932,50423262,7,0,0,177664,16,3172041177
1811,39839030,10584434,50423464,1,0,0,512,5,5568054849
1812,39872879,41322825,81195704,4,0,1,15872,2,7607556978
1813,39891450,41304920,81196370,8,0,1,1024,2,1316341838
1814,39917420,41282664,81200084,5,0,1,5120,11,1332892802
1815,39924119,41281969,81206088,4,0,1,20480,2,168540565
1816,39965350,41244788,81210138,5,0,1,2048,11,9699777508
1817,39994970,41264361,81259331,2,0,1,95744,4,3065334759
1818,39996050,41268107,81264157,7,0,1,7680,16,6161292730
1819,40004300,10748162,50752462,7,0,0,154112,16,10487166686
1820,40007840,10539256,50547096,4,0,0,31232,2,8200630499
1821,40021471,41317163,81338634,6,0,1,130560,7,6118921287
1822,40079150,41265283,81344433,5,0,1,19456,11,4114748662
1823,40138640,10762971,50901611,4,0,0,132608,2,9549797149
1824,40218299,41226254,81444553,4,0,1,15872,2,2161597292
1825,40224290,10402927,50627217,7,0,0,28160,16,4589276480
1826,40228500,11325679,51554179,7,0,0,179200,16,8771720711
1827,40237720,10314547,50552267,7,0,0,16896,16,5658896008
1828,40267360,41220167,81487527,5,0,1,26624,11,7331208625
1829,40289341,41473554,81762895,6,0,1,179200,7,7159945674
1830,40328760,41448170,81776930,5,0,1,10240,11,489207196
1831,40342069,41471902,81813971,4,0,1,15360,2,5657353935
1832,40352580,10978112,51330692,9,0,0,4608,17,1716664447
1833,40361840,11056235,51418075,1,0,0,286720,5,9326368111
1834,40362970,10935852,51298822,1,0,0,285696,5,2123062204
1835,40374460,10691964,51066424,4,0,0,26624,2,9552890131
1836,40375740,41674986,82050726,8,0,1,55296,2,8088979262
1837,40380200,11101779,51481979,1,0,0,205312,5,4708514031
1838,40402020,41648729,82050749,8,0,1,512,2,2710941917
1839,40433260,41669639,82102899,5,0,1,44544,11,1848025149
1840,40434100,10895165,51329265,1,0,0,99840,5,519596337
1841,40493289,41609633,82102922,4,0,1,13824,2,1951433169
1842,40528250,11147649,51675899,1,0,0,141824,5,4597505384
1843,40537950,10944364,51482314,9,0,0,1024,17,6322138005
1844,40539110,41610722,82149832,8,0,1,92672,2,1904776392
1845,40563410,10927687,51491097,7,0,0,28672,16,6574337905
1846,40622381,41977585,82599966,6,0,1,368640,7,7021965326
1847,40644231,42166880,82811111,6,0,1,465920,7,8657228322
1848,40687920,11151724,51839644,4,0,0,97792,2,8317059756
1849,40753850,11168518,51922368,1,0,0,125952,5,7917922801
1850,40761771,42054729,82816500,6,0,1,17408,7,5921821066
1851,40764120,10655280,51419400,9,0,0,2048,17,6769579577
1852,40780569,42042705,82823274,4,0,1,4608,2,5764615065
1853,40807180,10908345,51715525,4,0,0,5120,2,864883573
1854,40856910,41971856,82828766,8,0,1,17920,2,10248203948
1855,40896560,10724617,51621177,1,0,0,157696,5,6576015260
1856,40901350,41933522,82834872,5,0,1,20992,11,7642019057
1857,41044339,41805205,82849544,4,0,1,51200,2,994119750
1858,41053401,41865014,82918415,6,0,1,51200,7,2664552723
1859,41071540,10347213,51418753,9,0,0,2048,17,3528964807
1860,41086450,41831988,82918438,5,0,1,35840,11,5113314122
1861,41103010,10958207,52061217,4,0,0,299008,2,1735063003
1862,41108280,10578635,51686915,9,0,0,1536,17,10293869396
1863,41198979,41719482,82918461,4,0,1,16896,2,9227048898
1864,41202889,41715595,82918484,4,0,1,11776,2,5598366978
1865,41210210,10635766,51845976,4,0,0,20480,2,2767508848
1866,41245430,41673077,82918507,8,0,1,5120,2,4456844001
1867,41263571,41654959,82918530,9,0,1,14848,17,10234963266
1868,41288699,41638786,82927485,0,0,1,25088,10,5172729974
1869,41302329,41627742,82930071,4,0,1,4096,2,8015811416
1870,41328239,41609884,82938123,0,0,1,12800,10,2448308144
1871,41378680,10505289,51883969,1,0,0,46080,5,8834078134
1872,41424721,41538186,82962907,6,0,1,55808,7,6347893045
1873,41424811,41543997,82968808,9,0,1,19968,17,10372972008
1874,41428470,10513653,51942123,9,0,0,1024,17,6878195646
1875,41455529,41519229,82974758,4,0,1,27648,2,10669821371
1876,41459541,41573423,83032964,6,0,1,99840,7,5863915630
1877,41520650,10865971,52386621,1,0,0,226816,5,4963301254
1878,41523190,10949801,52472991,1,0,0,70656,5,7060551450
1879,41615570,10543370,52158940,1,0,0,83968,5,10416748484
1880,41634379,41423819,83058198,1,0,1,86016,5,7185615732
1881,41634860,41430944,83065804,5,0,1,6144,11,2685448718
1882,41653640,41434406,83088046,8,0,1,22528,2,3178773086
1883,41682270,41453945,83136215,2,0,1,76288,4,554215009
1884,41686779,41453743,83140522,0,0,1,9216,10,29755006
1885,41741080,41408647,83149727,5,0,1,31232,11,1131943636
1886,41748661,41559123,83307784,6,0,1,110592,7,4856492357
1887,41764270,10633285,52397555,9,0,0,10752,17,611569838
1888,41767780,41555550,83323330,8,0,1,8704,2,1776298260
1889,41783160,41563661,83346821,2,0,1,9216,4,6164184182
1890,41796270,41558727,83354997,5,0,1,19456,11,945508190
1891,41814240,41663303,83477543,5,0,1,51200,11,2778497141
1892,41895881,41581685,83477566,9,0,1,15872,17,6688809006
1893,41911210,11157492,53068702,1,0,0,184320,5,8562922080
1894,41949010,11046460,52995470,4,0,0,451584,2,2445985386
1895,41991821,41485768,83477589,9,0,1,1536,17,251684404
1896,41993379,41484233,83477612,4,0,1,2048,2,8803904826
1897,42010751,41568999,83579750,6,0,1,268800,7,3139862191
1898,42011000,41575279,83586279,8,0,1,23040,2,9536091948
1899,42011540,11062333,53073873,4,0,0,16896,2,2973661324
1900,42053290,41546402,83599692,2,0,1,19456,4,3303964146
1901,42089180,10610229,52699409,9,0,0,2560,17,397231665
1902,42112840,41500882,83613722,8,0,1,10240,2,9226657157
1903,42176930,41437048,83613978,2,0,1,9216,4,941790347
1904,42179201,41579924,83759125,6,0,1,272384,7,7331963897
1905,42240421,41766589,84007010,6,0,1,442880,7,3406535531
1906,42258490,11613637,53872127,4,0,0,63488,2,1655451215
1907,42274620,11345063,53619683,4,0,0,132096,2,7221972623
1908,42300599,41706565,84007164,4,0,1,8704,2,9394218626
1909,42307870,11103425,53411295,4,0,0,46080,2,5803846582
1910,42311250,41704483,84015733,2,0,1,5120,4,2590234138
1911,42372870,41684246,84057116,5,0,1,69120,11,3972167443
1912,42382039,41685815,84067854,4,0,1,15360,2,5481558197
1913,42388311,42153554,84541865,6,0,1,443392,7,6351045667
1914,42394610,11646627,54041237,4,0,0,114176,2,5388614214
1915,42403481,42399195,84802676,6,0,1,253952,7,385713951
1916,42433599,42369100,84802699,4,0,1,22528,2,4212740378
1917,42495881,42306841,84802722,6,0,1,80384,7,3266171747
1918,42506630,11015265,53521895,9,0,0,6144,17,7404776292
1919,42536680,11160674,53697354,4,0,0,30208,2,3333100886
1920,42544710,11308050,53852760,1,0,0,110080,5,9690824861
1921,42565910,11101084,53666994,4,0,0,23040,2,8010807222
1922,42596740,10942861,53539601,9,0,0,3584,17,292057389
1923,42598611,42228203,84826814,6,0,1,92160,7,4139840467
1924,42615460,11604140,54219600,4,0,0,155136,2,1448511145
1925,42616190,11051459,53667649,9,0,0,2048,17,2316613427
1926,42667710,10992241,53659951,1,0,0,65024,5,10493247484
1927,42698151,42182477,84880628,6,0,1,123392,7,10581195276
1928,42804590,11259148,54063738,9,0,0,13312,17,1151743074
1929,42809439,42077398,84886837,4,0,1,21504,2,9257247210
1930,42831201,42071007,84902208,6,0,1,40960,7,8850451700
1931,42864751,42113096,84977847,6,0,1,150528,7,2112741828
1932,42979210,10944152,53923362,9,0,0,1024,17,7343578356
1933,42994201,42068018,85062219,6,0,1,221184,7,856975830
1934,43019050,11095467,54114517,9,0,0,4608,17,682058754
1935,43066230,10910553,53976783,9,0,0,512,17,7690716828
1936,43084801,42047221,85132022,6,0,1,113664,7,8513447661
1937,43103450,42029452,85132902,2,0,1,21504,4,8742178700
1938,43121431,42193662,85315093,6,0,1,226304,7,2936351913
1939,43142429,42190319,85332748,4,0,1,30720,2,954163271
1940,43162580,11278498,54441078,4,0,0,82432,2,8480765969
1941,43170889,42184281,85355170,4,0,1,46080,2,6190864823
1942,43263920,11309757,54573677,1,0,0,76800,5,10590124647
1943,43265221,42149394,85414615,6,0,1,109568,7,2001612688
1944,43286330,11389299,54675629,4,0,0,45056,2,7819249201
1945,43309690,11217191,54526881,4,0,0,29184,2,5717129523
1946,43374290,11587127,54961417,1,0,0,122880,5,2376640544
1947,43383641,42169554,85553195,6,0,1,211968,7,4810653262
1948,43395891,42178373,85574264,6,0,1,55296,7,7928089905
1949,43408921,42276458,85685379,6,0,1,59904,7,6652868475
1950,43447720,11250507,54698227,9,0,0,2048,17,4003870719
1951,43496239,42217713,85713952,1,0,1,36352,5,3110343261
1952,43497700,11546199,55043899,4,0,0,50176,2,5264531694
1953,43514130,42201128,85715258,2,0,1,2048,4,1549124406
1954,43535169,42180755,85715924,4,0,1,1024,2,3353008915
1955,43565810,11319174,54884984,1,0,0,13824,5,9422626674
1956,43569940,11633035,55202975,1,0,0,84992,5,1404411043
1957,43581820,11622738,55204558,1,0,0,5120,5,10529714958
1958,43837460,11141608,54979068,1,0,0,57856,5,3787706199
1959,43867470,11440067,55307537,4,0,0,200192,2,2047308502
1960,43874461,42019572,85894033,6,0,1,244224,7,1472576911
1961,43878380,11487324,55365704,1,0,0,75264,5,2955564953
1962,43928361,42161318,86089679,6,0,1,96768,7,2499056754
1963,43989060,11424452,55413512,9,0,0,3584,17,3365365340
1964,44011021,42087438,86098459,6,0,1,204288,7,7882389307
1965,44046600,42096822,86143422,2,0,1,55296,4,10715397006
1966,44110750,42034151,86144901,2,0,1,15360,4,3092999217
1967,44149671,42301444,86451115,6,0,1,297984,7,2039601257
1968,44164500,11914976,56079476,1,0,0,146432,5,2420457331
1969,44168960,42282178,86451138,2,0,1,27648,4,6856404224
1970,44228280,11755984,55984264,4,0,0,610816,2,6716259447
1971,44245400,11745943,55991343,4,0,0,10240,2,8433621717
1972,44267749,42183412,86451161,4,0,1,1024,2,5557955808
1973,44310230,42140954,86451184,2,0,1,1024,4,9498815382
1974,44321750,11666327,55988077,9,0,0,11264,17,3232632888
1975,44337389,42113818,86451207,4,0,1,51712,2,10661205006
1976,44379760,11418365,55798125,1,0,0,138752,5,983438919
1977,44384550,42066680,86451230,2,0,1,3072,4,9241344142
1978,44438651,42284549,86723200,6,0,1,202752,7,10630073755
1979,44462339,42261527,86723866,4,0,1,1024,2,4273792482
1980,44491460,11188819,55680279,9,0,0,1024,17,4587949450
1981,44554650,42182223,86736873,2,0,1,28672,4,10157871805
1982,44569140,42170096,86739236,8,0,1,1024,2,2095536929
1983,44576171,42163833,86740004,6,0,1,11776,7,4078357757
1984,44581800,11402799,55984599,9,0,0,1024,17,524318887
1985,44590671,42355416,86946087,6,0,1,137216,7,7009320728
1986,44644581,42301529,86946110,6,0,1,33792,7,2704482715
1987,44649080,42297053,86946133,2,0,1,15360,4,6731667830
1988,44665691,42344060,87009751,6,0,1,256512,7,2082227068
1989,44732111,42289034,87021145,6,0,1,8704,7,3424666763
1990,44762670,11369474,56132144,4,0,0,64512,2,7233725020
1991,44766320,42275148,87041468,2,0,1,23040,4,1768339065
1992,44832471,42277246,87109717,6,0,1,84992,7,654642490
1993,44844350,42265390,87109740,2,0,1,9728,4,8507782641
1994,44894649,42215114,87109763,0,0,1,10752,10,1755722276
1995,44902670,42208775,87111445,2,0,1,17920,4,2934670609
1996,44904750,11485921,56390671,4,0,0,60928,2,4929826144
1997,44907391,42225333,87132724,6,0,1,37376,7,9908885870
1998,44909321,42476264,87385585,6,0,1,339456,7,269272624
1999,44918430,11483456,56401886,9,0,0,1536,17,2105061228
2000,44954600,42434124,87388724,2,0,1,8192,4,9688611286
2001,44982841,42445184,87428025,6,0,1,55808,7,8356343097
2002,44985750,11673894,56659644,9,0,0,6144,17,403798040
2003,45098610,42332321,87430931,7,0,1,4608,16,7705753362
2004,45147810,11464352,56612162,9,0,0,2560,17,9043447347
2005,45158940,11417768,56576708,4,0,0,12800,2,1968605776
2006,45164030,42271407,87435437,8,0,1,7168,2,8867095558
2007,45209910,11372543,56582453,9,0,0,7680,17,5151352732
2008,45337800,11500636,56838436,1,0,0,403456,5,5872365896
2009,45349690,42095835,87445525,2,0,1,15360,4,7774988844
2010,45537720,11581370,57119090,1,0,0,75776,5,6896386161
2011,45584740,41871868,87456608,2,0,1,5120,4,7989108876
2012,45591300,11343141,56934441,9,0,0,3584,17,9735299443
2013,45622030,41837804,87459834,2,0,1,5120,4,3100748536
2014,45716590,11143264,56859854,4,0,0,65536,2,3172945202
2015,45751290,41709312,87460602,2,0,1,11776,4,2254063642
2016,45791640,41790573,87582213,2,0,1,5120,4,2620298216
2017,45836260,11134778,56971038,9,0,0,4608,17,1245374188
2018,45836760,11003103,56839863,1,0,0,4608,5,4420862777
2019,45845611,42314701,88160312,6,0,1,715264,7,9568249540
2020,45853910,11308154,57162064,9,0,0,2560,17,635389206
2021,45917970,42252686,88170656,2,0,1,35840,4,9215262595
2022,45996080,42182577,88178657,8,0,1,4608,2,2312971795
2023,46027980,42163112,88191092,2,0,1,34304,4,4977495862
2024,46049570,11109508,57159078,4,0,0,36352,2,8058906333
2025,46069461,42228460,88297921,6,0,1,219136,7,9945865119
2026,46072451,42697407,88769858,6,0,1,420864,7,6547018546
2027,46097610,42676434,88774044,8,0,1,6656,2,9982868118
2028,46098440,42681710,88780150,2,0,1,22016,4,4221888847
2029,46109590,11691051,57800641,4,0,0,140800,2,166635522
2030,46192080,43099272,89291352,8,0,1,295936,2,539720315
2031,46211671,43122821,89334492,6,0,1,21504,7,8411385111
2032,46222420,43114338,89336758,2,0,1,3584,4,3208113096
2033,46227950,11317262,57545212,4,0,0,37888,2,1999421118
2034,46259830,43092830,89352660,2,0,1,4608,4,7484755565
2035,46281620,43071063,89352683,2,0,1,3072,4,1170530756
2036,46281700,43071006,89352706,2,0,1,20480,4,9720912794
2037,46303500,43063556,89367056,2,0,1,15872,4,8643123198
2038,46394690,11336651,57731341,4,0,0,133632,2,9601647681
2039,46414181,43132904,89547085,6,0,1,168960,7,8341524785
2040,46457780,43089328,89547108,2,0,1,1024,4,1571200771
2041,46531750,11770944,58302694,4,0,0,204288,2,4315998193
2042,46543560,43003571,89547131,2,0,1,21504,4,9374216555
2043,46579241,42967913,89547154,6,0,1,11776,7,7658438245
2044,46597099,42950078,89547177,0,0,1,6144,10,5610992156
2045,46604780,11635647,58240427,1,0,0,255488,5,8777066392
2046,46607249,42939951,89547200,0,0,1,14848,10,2050165080
2047,46654560,11648625,58303185,9,0,0,1536,17,6906151791
2048,46671760,11638990,58310750,4,0,0,24576,2,2164372002
2049,46677420,42869803,89547223,2,0,1,28672,4,9856082466
2050,46698981,42985155,89684136,6,0,1,171008,7,7134114342
2051,46732240,11670454,58402694,9,0,0,512,17,9423539294
2052,46807589,42877373,89684962,0,0,1,16384,10,7134964239
2053,46829030,42855963,89684993,2,0,1,41472,4,900880179
2054,46836550,42866766,89703316,2,0,1,21504,4,3349429496
2055,46892931,42952911,89845842,6,0,1,215552,7,9691973679
2056,46911950,11793261,58705211,4,0,0,91648,2,9349688805
2057,46915130,11941557,58856687,9,0,0,2048,17,7436227319
2058,46918579,42933492,89852071,0,0,1,11264,10,4909510277
2059,46932010,12024630,58956640,0,0,0,221696,10,5151001594
2060,46946060,12029837,58975897,4,0,0,62976,2,3054067777
2061,46979059,42912526,89891585,0,0,1,7680,10,8726127720
2062,47029570,42896442,89926012,2,0,1,51712,4,5443458158
2063,47055109,42921128,89976237,0,0,1,1536,10,2395387791
2064,47056620,42924123,89980743,2,0,1,7168,4,5454143111
2065,47085680,12156882,59242562,4,0,0,58880,2,42543970
2066,47230571,42796907,90027478,6,0,1,58880,7,4308902916
2067,47244560,43125622,90370182,8,0,1,32768,2,1462235174
2068,47258780,11952590,59211370,9,0,0,2048,17,17012467
2069,47273980,43349156,90623136,8,0,1,54784,2,9308049986
2070,47322751,43359734,90682485,6,0,1,16896,7,9494121684
2071,47326121,43356387,90682508,6,0,1,13312,7,837421583
2072,47333131,43752050,91085181,6,0,1,297984,7,3325950830
2073,47335789,43749415,91085204,0,0,1,13824,10,5285905476
2074,47356830,43951335,91308165,8,0,1,233472,2,9335501621
2075,47367080,43941108,91308188,2,0,1,15872,4,7958602290
2076,47376481,44300018,91676499,6,0,1,253952,7,6316956174
2077,47377860,12221784,59599644,9,0,0,5120,17,9034422547
2078,47536471,44186240,91722711,6,0,1,46080,7,1721695659
2079,47567800,12761740,60329540,4,0,0,643072,2,3311449278
2080,47611251,44216740,91827991,6,0,1,76288,7,7373794665
2081,47673301,44302571,91975872,6,0,1,183808,7,434573819
2082,47679261,44323982,92003243,6,0,1,45056,7,4503824401
2083,47683130,12255367,59938497,4,0,0,19456,2,6118626304
2084,47689150,44315719,92004869,2,0,1,2560,4,3836481448
2085,47715090,44299486,92014576,2,0,1,4608,4,8634452564
2086,47731770,13506161,61237931,4,0,0,135168,2,4009212123
2087,47748160,12922763,60670923,4,0,0,85504,2,8769676240
2088,47804751,44225392,92030143,6,0,1,45568,7,4558724017
2089,47812640,44287876,92100516,2,0,1,70656,4,2604906592
2090,47818250,44929916,92748166,2,0,1,478208,4,6522432305
2091,47858390,13161359,61019749,9,0,0,1024,17,10428208115
2092,47858881,44889308,92748189,6,0,1,65024,7,9542127187
2093,47946129,44805503,92751632,0,0,1,6144,10,9788430290
2094,47966931,44816018,92782949,6,0,1,79360,7,2618790981
2095,47969719,44828524,92798243,0,0,1,23040,10,2161411073
2096,47970680,44829612,92800292,5,0,1,15872,11,2519437442
2097,47997470,44807328,92804798,5,0,1,7168,11,4322151013
2098,48095619,44724221,92819840,0,0,1,44032,10,2672030452
2099,48124690,44711031,92835721,5,0,1,36864,11,7996012119
2100,48145479,44773332,92918811,0,0,1,17408,10,5467153891
2101,48149569,44769265,92918834,0,0,1,26112,10,6259456432
2102,48204819,44714038,92918857,4,0,1,1536,2,3150048800
2103,48250049,44668831,92918880,0,0,1,3072,10,6540006043
2104,48262569,45008886,93271455,0,0,1,23552,10,4398726857
2105,48263640,45558456,93822096,2,0,1,102400,4,10042410979
2106,48275441,45815191,94090632,6,0,1,520192,7,1444487926
2107,48275939,45829582,94105521,4,0,1,31232,2,5689198205
2108,48278491,45936195,94214686,6,0,1,118784,7,2154041932
2109,48389110,46413393,94802503,2,0,1,336896,4,1765568717
2110,48390460,46412066,94802526,5,0,1,16384,11,368061367
2111,48438159,46365710,94803869,0,0,1,10240,10,2530187423
2112,48460560,13382056,61842616,9,0,0,1024,17,3336851925
2113,48485460,13265031,61750491,9,0,0,2048,17,6528058178
2114,48490350,46320342,94810692,5,0,1,15360,11,2707285559
2115,48510060,13551521,62061581,4,0,0,11264,2,3435932790
2116,48524370,13754376,62278746,4,0,0,42496,2,1930533715
2117,48532409,46327454,94859863,4,0,1,15872,2,3314505506
2118,48555140,46425061,94980201,5,0,1,58880,11,1975340232
2119,48625810,14253599,62879409,1,0,0,480256,5,3154126963
2120,48643370,13917042,62560412,1,0,0,4608,5,6802256205
2121,48691430,46288925,94980355,5,0,1,8704,11,2386304093
2122,48713660,13802702,62516362,1,0,0,22528,5,5241476512
2123,48714461,46292221,95006682,6,0,1,27648,7,3997492470
2124,48750089,46298618,95048707,0,0,1,30720,10,736592873
2125,48777620,14101968,62879588,9,0,0,512,17,6428281530
2126,48783500,46265361,95048861,5,0,1,8704,11,3474079652
2127,48784921,46450669,95235590,6,0,1,70144,7,718556188
2128,48872330,46363283,95235613,5,0,1,512,11,3397915049
2129,48882350,14726945,63609295,9,0,0,1024,17,5395407886
2130,48928151,46478736,95406887,6,0,1,70144,7,4603164605
2131,48957730,14371645,63329375,1,0,0,259584,5,2464637513
2132,48974810,46432100,95406910,5,0,1,3072,11,3971093175
2133,48993620,46413313,95406933,5,0,1,9728,11,5337559165
2134,49029789,46377167,95406956,0,0,1,12288,10,107913896
2135,49031349,46375630,95406979,0,0,1,6656,10,10113124865
2136,49034441,46468773,95503214,6,0,1,92160,7,10492006922
2137,49076180,14426158,63502338,1,0,0,132608,5,1549628235
2138,49084031,46728304,95812335,6,0,1,189440,7,8338381824
2139,49119430,14784951,63904381,1,0,0,358400,5,1482881202
2140,49130530,14892477,64023007,4,0,0,197120,2,797829345
2141,49177070,14393380,63570450,1,0,0,194560,5,6399285135
2142,49209091,46646502,95855593,6,0,1,75264,7,4790384530
2143,49225610,15115889,64341499,4,0,0,231936,2,4479827835
2144,49231430,14947523,64178953,9,0,0,2048,17,5757464602
2145,49272310,14407701,63680011,1,0,0,177664,5,5388659731
2146,49272980,14061566,63334546,1,0,0,16896,5,7262735698
2147,49281820,46601828,95883648,5,0,1,28672,11,93576532
2148,49349450,46556701,95906151,5,0,1,60928,11,5869475557
2149,49362150,14217151,63579301,4,0,0,28672,2,8934149194
2150,49386670,47282359,96669029,2,0,1,299520,4,4248755187
2151,49390200,15481554,64871754,1,0,0,756736,5,8727707386
2152,49512530,47221733,96734263,7,0,1,8192,16,7224928781
2153,49536940,14402720,63939660,1,0,0,115712,5,9868742751
2154,49652800,47081486,96734286,5,0,1,13824,11,8930498523
2155,49668589,47245619,96914208,0,0,1,46080,10,9432862516
2156,49758150,47156081,96914231,7,0,1,2560,16,312248064
2157,49805750,14226484,64032234,4,0,0,30208,2,573100512
2158,49876800,14265483,64142283,9,0,0,1536,17,6468957914
2159,49886030,14456919,64342949,9,0,0,3584,17,1420623589
2160,49886170,47028084,96914254,5,0,1,3584,11,2214523748
2161,49937819,47044965,96982784,0,0,1,36864,10,10496726474
2162,49960760,47022047,96982807,5,0,1,9216,11,10052756753
2163,49962020,14949606,64911626,4,0,0,65536,2,5402907589
2164,49971599,14451882,64423481,5,0,0,29184,11,5174658737
2165,50054459,46928371,96982830,0,0,1,38912,10,9266528481
2166,50077870,15498803,65576673,4,0,0,531456,2,525666290
2167,50096919,46885934,96982853,0,0,1,19968,10,77637280
2168,50138460,46844416,96982876,5,0,1,4608,11,590693257
2169,50191569,15128911,65320480,5,0,0,186368,11,4825179415
2170,50194820,14147014,64341834,9,0,0,1024,17,819502853
2171,50231379,14660256,64891635,5,0,0,61440,11,3777476888
2172,50231550,46792267,97023817,5,0,1,26624,11,1752319483
2173,50253850,13848372,64102222,9,0,0,1536,17,3877702177
2174,50306310,46717530,97023840,5,0,1,1024,11,4823412035
2175,50400960,14216634,64617594,1,0,0,43520,5,10417919115
2176,50401700,14173932,64575632,9,0,0,2560,17,9025772669
2177,50431210,46592653,97023863,7,0,1,2048,16,8736782954
2178,50445720,46578174,97023894,7,0,1,11264,16,10209401233
2179,50475560,14396529,64872089,9,0,0,1024,17,5015746996
2180,50543400,14329492,64872892,9,0,0,2560,17,7732692076
2181,50564790,46459143,97023933,5,0,1,38912,11,6388946290
2182,50634870,14541669,65176539,4,0,0,143872,2,4601447290
2183,50637960,47709380,98347340,7,0,1,68608,16,8005301204
2184,50693680,47653683,98347363,7,0,1,46080,16,6872399502
2185,50703890,14241635,64945525,1,0,0,111104,5,8227329235
2186,50720140,14505874,65226014,4,0,0,162304,2,6968261544
2187,50753359,47663813,98417172,4,0,1,5120,2,2593263795
2188,50800520,14449572,65250092,4,0,0,78848,2,5032650709
2189,50839410,47612440,98451850,5,0,1,26624,11,5617974230
2190,50844620,14779812,65624432,4,0,0,156672,2,7400609933
2191,50847340,47604533,98451873,5,0,1,4096,11,2065826741
2192,50896489,47574930,98471419,4,0,1,4608,2,10117003320
2193,50911630,47559812,98471442,2,0,1,58368,4,563025284
2194,50920569,47667295,98587864,0,0,1,4608,10,8187243148
2195,50969439,14420518,65389957,5,0,0,34816,11,9213746085
2196,50970729,47617166,98587895,4,0,1,4608,2,8136744313
2197,50976660,47640937,98617597,7,0,1,35328,16,4508388961
2198,51036279,47581341,98617620,4,0,1,8704,2,8422667175
2199,51090130,14535105,65625235,9,0,0,2560,17,9250360794
2200,51092730,14533019,65625749,9,0,0,1536,17,10547432045
2201,51118690,14599258,65717948,4,0,0,64512,2,6985464020
2202,51126789,47490862,98617651,4,0,1,30720,2,5446847178
2203,51168750,47448924,98617674,5,0,1,19968,11,5204376905
2204,51188280,15132572,66320852,9,0,0,512,17,10277041830
2205,51203090,47414607,98617697,5,0,1,35328,11,1422608416
2206,51248090,14643881,65891971,4,0,0,40960,2,6772418685
2207,51322810,47294910,98617720,5,0,1,2560,11,1792501432
2208,51360449,47257294,98617743,4,0,1,10752,2,7407851346
2209,51393160,48186466,99579626,7,0,1,62464,16,7295066028
2210,51427299,48152350,99579649,4,0,1,6656,2,4562914836
2211,51438130,48141542,99579672,5,0,1,15872,11,5492234726
2212,51452209,48150909,99603118,4,0,1,36864,2,5125793356
2213,51452530,14868143,66320673,1,0,0,279552,5,7953099657
2214,51453000,48150141,99603141,5,0,1,4096,11,5387619807
2215,51459949,48143215,99603164,4,0,1,3584,2,2566686974
2216,51502499,14491452,65993951,5,0,0,11776,11,10696589316
2217,51530750,14589900,66120650,4,0,0,98816,2,4903586840
2218,51558709,48044478,99603187,4,0,1,512,2,3467115662
2219,51596690,48006544,99603234,7,0,1,23040,16,1486034166
2220,51651060,49291363,100942423,2,0,1,402944,4,4781227545
2221,51659110,49365667,101024777,7,0,1,112640,16,8819492983
2222,51683349,49345096,101028445,4,0,1,5120,2,1975898657
2223,51737269,49296322,101033591,4,0,1,8192,2,5857227401
2224,51752499,49283646,101036145,4,0,1,9728,2,9642908894
2225,51763570,14999949,66763519,4,0,0,124416,2,6469372384
2226,51768579,49480837,101249416,1,0,1,38912,5,6373359234
2227,51894430,14872700,66767130,9,0,0,11776,17,9794261260
2228,51896599,49352840,101249439,1,0,1,45056,5,3098560213
2229,51933620,14706667,66640287,9,0,0,1024,17,3190603280
2230,51934709,49314753,101249462,1,0,1,3072,5,6841770546
2231,51936500,49312985,101249485,7,0,1,10752,16,1536532599
2232,51946030,49561907,101507937,5,0,1,60416,11,5779615911
2233,51950270,49557690,101507960,7,0,1,10240,16,563879843
2234,51971139,49542015,101513154,1,0,1,23552,5,2052205115
2235,51972930,49540247,101513177,5,0,1,10240,11,8438956575
2236,51973680,14793941,66767621,9,0,0,1536,17,3609681330
2237,52017230,15066108,67083338,4,0,0,79360,2,5085209604
2238,52043170,14884196,66927366,1,0,0,25600,5,2659500550
2239,52074459,49703792,101778251,1,0,1,97280,5,10071964406
2240,52080780,15051057,67131837,1,0,0,111104,5,6567063165
2241,52088930,14856915,66945845,9,0,0,3072,17,7641458633
2242,52200010,14932630,67132640,9,0,0,2560,17,1253341403
2243,52266429,49762271,102028700,1,0,1,74240,5,468211676
2244,52266479,49762244,102028723,1,0,1,21504,5,4918563377
2245,52292780,14907436,67200216,9,0,0,2048,17,8911737556
2246,52313800,49714946,102028746,5,0,1,4096,11,1683471406
2247,52356870,15018432,67375302,1,0,0,22528,5,2651050977
2248,52422040,15040285,67462325,9,0,0,512,17,1258908672
2249,52485610,49543159,102028769,5,0,1,2048,11,8475716524
2250,52527359,49501433,102028792,1,0,1,20992,5,2435830361
2251,52529670,15705161,68234831,4,0,0,95232,2,9279502389
2252,52648250,15554033,68202283,4,0,0,789504,2,7714694843
2253,52652080,49376735,102028815,5,0,1,11264,11,6977608818
2254,52658380,15093169,67751549,9,0,0,2560,17,3692501886
2255,52667640,15294068,67961708,4,0,0,145920,2,3389747809
2256,52687179,49485584,102172763,1,0,1,11264,5,477545558
2257,52712560,15490690,68203250,9,0,0,3072,17,1822192749
2258,52736549,49521002,102257551,1,0,1,29184,5,2310099365
2259,52764900,49526275,102291175,5,0,1,4096,11,3615754067
2260,52783189,49512518,102295707,1,0,1,7168,5,5855299219
2261,52798410,49503250,102301660,5,0,1,28160,11,7801667622
2262,52838470,15367299,68205769,4,0,0,8192,2,2277266976
2263,52953270,49439609,102392879,5,0,1,10240,11,9590474470
2264,52960569,49432333,102392902,1,0,1,16896,5,8806087788
2265,52971970,15610646,68582616,4,0,0,512512,2,6700911164
2266,52990090,49450058,102440148,5,0,1,35328,11,8842363544
2267,53003100,15246820,68249920,9,0,0,1024,17,41298007
2268,53042689,49402285,102444974,1,0,1,7680,5,567374851
2269,53164109,50637796,103801905,0,0,1,19456,10,1138048507
2270,53175650,15694691,68870341,4,0,0,214016,2,9423970122
2271,53184960,52239483,105424443,2,0,1,695296,4,178100909
2272,53240670,52231867,105472537,8,0,1,87552,2,1004409785
2273,53257670,52214890,105472560,5,0,1,4608,11,5457035970
2274,53269720,15461084,68730804,1,0,0,200704,5,4060021168
2275,53286100,52354603,105640703,8,0,1,478208,2,3315520053
2276,53334530,15555458,68889988,1,0,0,5120,5,8266033680
2277,53359260,15372815,68732075,9,0,0,4096,17,7011782060
2278,53368661,52272081,105640742,6,0,1,17920,7,6403935575
2279,53380120,15491047,68871167,1,0,0,2560,5,8040415282
2280,53424230,52216535,105640765,3,0,1,24576,3,5060445386
2281,53514540,15228594,68743134,9,0,0,4096,17,3351601584
2282,53518520,52154115,105672635,5,0,1,2560,11,7904576983
2283,53522511,52186222,105708733,9,0,1,20480,17,1603599950
2284,53533730,15271380,68805110,4,0,0,23552,2,5041222651
2285,53553380,52155384,105708764,8,0,1,48128,2,2332097457
2286,53575621,52133166,105708787,9,0,1,26624,17,1084693562
2287,53581500,52253724,105835224,8,0,1,193024,2,9914320190
2288,53589940,15201829,68791769,4,0,0,19456,2,392061556
2289,53592071,52243184,105835255,9,0,1,17920,17,5493186739
2290,53619520,15291552,68911072,1,0,0,3584,5,2814081064
2291,53664051,52171227,105835278,9,0,1,70656,17,6331798178
2292,53754451,52124940,105879391,9,0,1,53760,17,2678668038
2293,53759950,15219136,68979086,1,0,0,512,5,1767602754
2294,53762470,53356985,107119455,8,0,1,435712,2,1459100844
2295,53809160,53843365,107652525,8,0,1,394240,2,1748863043
2296,53820390,15222886,69043276,1,0,0,12800,5,4102727866
2297,53824020,15252316,69076336,1,0,0,2560,5,7887415476
2298,53830501,53822047,107652548,6,0,1,21504,7,976090831
2299,53835200,15296890,69132090,9,0,0,3072,17,4252219780
2300,53920260,53732311,107652571,5,0,1,9216,11,3669409594
2301,53927200,53994851,107922051,8,0,1,248832,2,4193774585
2302,53959881,53962324,107922205,6,0,1,8704,7,3439903393
2303,54018480,15346096,69364576,1,0,0,8192,5,5195455332
2304,54036180,15495849,69532029,1,0,0,6656,5,10099281793
2305,54079650,54174173,108253823,8,0,1,135680,2,7540675446
2306,54140310,15343734,69484044,6,0,0,3584,7,8822308779
2307,54155851,54103118,108258969,9,0,1,8192,17,5254065915
2308,54179690,15321263,69500953,1,0,0,1024,5,7342212298
2309,54188660,54481740,108670400,8,0,1,315904,2,8909723640
2310,54204670,54468316,108672986,5,0,1,4096,11,5133040322
2311,54211201,54483992,108695193,9,0,1,19968,17,6124252063
2312,54230710,15255216,69485926,9,0,0,2048,17,3275052414
2313,54241140,54725228,108966368,8,0,1,370176,2,5263362568
2314,54252650,15362476,69615126,9,0,0,512,17,6754382751
2315,54275410,15501852,69777262,4,0,0,92672,2,8506994871
2316,54281660,15159847,69441507,9,0,0,3072,17,8521120396
2317,54320470,15552011,69872481,4,0,0,142336,2,111349447
2318,54341830,54699316,109041146,8,0,1,101888,2,3376841958
2319,54350601,54690891,109041492,9,0,1,512,17,5495927628
2320,54439911,54608033,109047944,9,0,1,10240,17,1508318712
2321,54441220,54704457,109145677,8,0,1,195584,2,4012031151
2322,54504170,54642813,109146983,2,0,1,2048,4,2685179104
2323,54523270,14985632,69508902,9,0,0,512,17,800389148
2324,54537760,14766924,69304684,1,0,0,4096,5,4326942038
2325,54544940,54606050,109150990,5,0,1,15872,11,3930953844
2326,54562900,15177482,69740382,6,0,0,1536,7,9687511221
2327,54579260,54598706,109177966,5,0,1,39424,11,4264444530
2328,54607540,15013943,69621483,6,0,0,11776,7,2606574194
2329,54650910,54532676,109183586,8,0,1,34816,2,5366017987
2330,54651121,54541235,109192356,9,0,1,16896,17,5946282925
2331,54669510,14945102,69614612,6,0,0,93184,7,1801660724
2332,54684780,15017991,69702771,4,0,0,117248,2,6615965993
2333,54719370,15153446,69872816,9,0,0,1024,17,8821560655
2334,54724190,14791113,69515303,1,0,0,1024,5,9633060645
2335,54751740,14956982,69708722,6,0,0,19456,7,6980292199
2336,54761230,54609618,109370848,2,0,1,324096,4,7654149273
2337,54778970,14835977,69614947,1,0,0,1024,5,8763749503
2338,54796791,54574080,109370871,6,0,1,12288,7,6484424179
2339,54803060,54580573,109383633,2,0,1,38400,4,1765514774
2340,54816050,14748616,69564666,9,0,0,2048,17,4408307716
2341,54826920,14552951,69379871,1,0,0,1536,5,10669257790
2342,54949330,54435686,109385016,5,0,1,14848,11,6358366721
2343,54956510,14916641,69873151,1,0,0,1024,5,8118391817
2344,55000850,15351627,70352477,4,0,0,85504,2,6319427879
2345,55021240,54441690,109462930,5,0,1,21504,11,3235080727
2346,55058680,14995741,70054421,1,0,0,512,5,3998908726
2347,55072330,15084685,70157015,1,0,0,27648,5,5312784579
2348,55079460,14829955,69909415,6,0,0,13824,7,6397571871
2349,55102530,15143272,70245802,6,0,0,37888,7,9116881643
2350,55151030,15175372,70326402,4,0,0,72192,2,1743291606
2351,55239060,14947919,70186979,7,0,0,30208,16,373913496
2352,55240620,54249848,109490468,8,0,1,123904,2,10510317767
2353,55289390,54206554,109495944,5,0,1,5120,11,3640244851
2354,55348570,54285131,109633701,5,0,1,39424,11,7042289406
2355,55354920,54288343,109643263,8,0,1,118784,2,4734729188
2356,55359970,14829991,70189961,1,0,0,3584,5,9352973230
2357,55374350,54513890,109888240,8,0,1,161280,2,4199315
2358,55375780,14764628,70140408,4,0,0,17408,2,7779294170
2359,55407949,54500335,109908284,0,0,1,5120,10,9849359315
2360,55457710,55442196,110899906,8,0,1,380416,2,8307184404
2361,55466160,14588082,70054242,4,0,0,123904,2,4437638897
2362,55484580,14636640,70121220,6,0,0,89600,7,10008939580
2363,55500890,55474892,110975782,8,0,1,45568,2,10084091309
2364,55518260,15266506,70784766,1,0,0,7680,5,10340370937
2365,55528661,55461659,110990320,6,0,1,512,7,2201397662
2366,55565220,55476301,111041521,8,0,1,97280,2,3778598383
2367,55577280,15205123,70782403,6,0,0,436736,7,6240140034
2368,55598530,55447098,111045628,5,0,1,39936,11,9364323332
2369,55607400,55445805,111053205,5,0,1,14336,11,1883115990
2370,55612130,55445581,111057711,8,0,1,7168,2,1615437137
2371,55625030,55443705,111068735,5,0,1,17920,11,7796830807
2372,55663210,15123919,70787129,1,0,0,7680,5,2524002051
2373,55676300,15206503,70882803,6,0,0,313856,7,3530874864
2374,55687811,55385091,111072902,6,0,1,11264,7,8253900187
2375,55693110,14868508,70561618,6,0,0,58880,7,5536954340
2376,55697511,55405105,111102616,6,0,1,54272,7,5252427397
2377,55704190,55410802,111114992,5,0,1,3072,11,10290636385
2378,55705520,14903253,70608773,9,0,0,1536,17,3255557549
2379,55780051,55347242,111127293,6,0,1,36864,7,9961578887
2380,55817030,55311889,111128919,5,0,1,2560,11,6165745496
2381,55842580,55287210,111129790,7,0,1,12288,16,6281539360
2382,55896619,55454788,111351407,1,0,1,38400,5,194513196
2383,55918060,55619118,111537178,8,0,1,233984,2,5330754229
2384,55918700,14700114,70618814,9,0,0,512,17,1772131668
2385,55939131,55598078,111537209,6,0,1,30720,7,4642960687
2386,55951329,55585903,111537232,1,0,1,1024,5,9936597183
2387,55952250,14972751,70925001,1,0,0,1024,5,5452371806
2388,55988130,55549125,111537255,5,0,1,33280,11,5441297154
2389,56054960,14886907,70941867,9,0,0,2048,17,1617587078
2390,56081800,15252991,71334791,6,0,0,396288,7,766326967
2391,56086020,15072629,71158649,9,0,0,3584,17,1343949650
2392,56087919,55470910,111558829,1,0,1,51200,5,4059925887
2393,56102110,55456742,111558852,5,0,1,5632,11,482488578
2394,56172280,14880894,71053174,9,0,0,2048,17,3140536539
2395,56179860,55420713,111600573,5,0,1,12288,11,6696796488
2396,56195250,55482690,111677940,8,0,1,209920,2,5049090570
2397,56220661,55478877,111699538,6,0,1,43008,7,1183369309
2398,56227670,55495250,111722920,8,0,1,41984,2,8140375498
2399,56283400,55505410,111788810,8,0,1,27648,2,1133498674
2400,56343601,55497657,111841258,6,0,1,61952,7,5494369255
2401,56362950,14972488,71335438,9,0,0,2048,17,4143852630
2402,56383350,14784128,71167478,1,0,0,512,5,4299330716
2403,56409300,55500452,111909752,8,0,1,112128,2,6645602373
2404,56413501,55497634,111911135,6,0,1,14848,7,10012332413
2405,56426710,55538754,111965464,5,0,1,10752,11,6310819659
2406,56427290,14910043,71337333,9,0,0,6144,17,6457843881
2407,56482289,55483198,111965487,1,0,1,6144,5,3097456244
2408,56536629,55428881,111965510,1,0,1,16896,5,3109554302
2409,56537650,55704140,112241790,8,0,1,102400,2,2196607329
2410,56577040,55664773,112241813,5,0,1,18944,11,1768662692
2411,56597089,55670150,112267239,1,0,1,39424,5,9857009577
2412,56608269,55662696,112270965,1,0,1,512,5,5913133006
2413,56635059,55636572,112271631,1,0,1,11264,5,114091798
2414,56650080,14970927,71621007,6,0,0,184320,7,8837722105
2415,56667800,14954033,71621833,1,0,0,2560,5,824972657
2416,56690810,55614456,112305266,5,0,1,37376,11,10211298031
2417,56710410,15130902,71841312,9,0,0,1024,17,6669357484
2418,56710690,15105708,71816398,4,0,0,306176,2,5631637663
2419,56824999,55508905,112333904,1,0,1,13312,5,6337314800
2420,56858590,55510571,112369161,5,0,1,37376,11,8926374991
2421,56872860,55589198,112462058,8,0,1,111616,2,3311901911
2422,56896830,15022789,71919619,9,0,0,8704,17,1376618172
2423,56952919,55525200,112478119,1,0,1,15872,5,7395879045
2424,56960389,55780649,112741038,1,0,1,47104,5,8603340447
2425,56972680,14865872,71838552,9,0,0,2048,17,4423941031
2426,56999180,14967746,71966926,9,0,0,512,17,6547703960
2427,57007650,55733411,112741061,5,0,1,512,11,8859855744
2428,57015370,14961860,71977230,1,0,0,512,5,5125930805
2429,57042040,14997937,72039977,9,0,0,1024,17,5122424965
2430,57042149,55698935,112741084,1,0,1,12800,5,8964862380
2431,57042410,15554020,72596430,6,0,0,178688,7,9018696251
2432,57057850,15666607,72724457,4,0,0,176128,2,1055437256
2433,57073960,15414285,72488245,4,0,0,76800,2,9393985355
2434,57094889,55646218,112741107,1,0,1,5632,5,3987435403
2435,57098351,55642779,112741130,9,0,1,8192,17,8900035571
2436,57110850,55688865,112799715,5,0,1,35840,11,3156418858
2437,57210640,15794468,73005108,4,0,0,424448,2,6878902728
2438,57219710,15971068,73190778,6,0,0,238080,7,9589799203
2439,57228320,55772392,113000712,8,0,1,276480,2,3046506840
2440,57321060,55683549,113004609,5,0,1,8192,11,8322359561
2441,57326810,15472319,72799129,9,0,0,3072,17,7456939647
2442,57356899,55665843,113022742,1,0,1,12800,5,7459307257
2443,57457610,55781054,113238664,5,0,1,4096,11,8894353436
2444,57547340,15757655,73304995,6,0,0,290304,7,9858158092
2445,57554129,55684791,113238920,1,0,1,9216,5,7699469077
2446,57558420,56008792,113567212,5,0,1,10240,11,10078697127
2447,57564200,15520316,73084516,9,0,0,4608,17,1853566092
2448,57610709,55957067,113567776,1,0,1,10752,5,9370365153
2449,57616590,15841277,73457867,6,0,0,96768,7,1674681602
2450,57644290,16046773,73691063,6,0,0,326656,7,7344804236
2451,57682500,15734423,73416923,6,0,0,115712,7,9765786523
2452,57706780,15774012,73480792,9,0,0,2560,17,6890773852
2453,57716680,56334553,114051233,2,0,1,45568,4,8133224695
2454,57746060,16018502,73764562,4,0,0,90112,2,1004140264
2455,57753749,56392321,114146070,1,0,1,5632,5,6641038018
2456,57762730,15929315,73692045,9,0,0,3072,17,6712744059
2457,57775900,56387087,114162987,5,0,1,1536,11,9649982187
2458,57806870,15897759,73704629,1,0,0,6144,5,1917130873
2459,57815650,16365443,74181093,4,0,0,103936,2,8387463378
2460,57837950,16114639,73952589,4,0,0,223232,2,7533199337
2461,57838640,16114284,73952924,9,0,0,1024,17,934669054
2462,57860740,16183120,74043860,1,0,0,1024,5,7593136995
2463,57863500,16272648,74136148,4,0,0,195584,2,8969968217
2464,57873860,16530690,74404550,4,0,0,276480,2,9153679987
2465,57891300,16257977,74149277,1,0,0,2048,5,8974161541
2466,57927050,16477679,74404729,1,0,0,512,5,10668496774
2467,57931940,16388347,74320287,4,0,0,134656,2,9062625657
2468,57936490,56230363,114166853,5,0,1,6144,11,8099879391
2469,57954069,56214710,114168779,1,0,1,23040,5,6554147844
2470,57956300,16722224,74678524,4,0,0,51712,2,8822856029
2471,57990180,17191650,75181830,6,0,0,907264,7,817026975
2472,58008730,56325960,114334690,5,0,1,15872,11,1239134926
2473,58028159,56306554,114334713,1,0,1,20480,5,8398283074
2474,58084349,56250387,114334736,1,0,1,6656,5,4278438027
2475,58094449,56240310,114334759,1,0,1,8704,5,6596563047
2476,58168290,16577629,74745919,9,0,0,2560,17,10501540530
2477,58197650,16683877,74881527,6,0,0,77824,7,1663532483
2478,58204860,16698512,74903372,4,0,0,45568,2,8617221480
2479,58216770,16992585,75209355,6,0,0,90112,7,3766731244
2480,58235670,16986679,75222349,4,0,0,42496,2,6546277913
2481,58239920,17150123,75390043,1,0,0,7168,5,9964726736
2482,58270620,17051290,75321910,6,0,0,121856,7,6171696661
2483,58297050,16978897,75275947,1,0,0,2048,5,289494414
2484,58455220,16787506,75242726,4,0,0,49664,2,4303433777
2485,58483350,55969102,114452452,5,0,1,59392,11,2201683488
2486,58514999,55967467,114482466,1,0,1,36864,5,3404857319
2487,58519710,16846171,75365881,1,0,0,4608,5,6689904105
2488,58558800,55923689,114482489,5,0,1,6656,11,10577969629
2489,58576170,17406749,75982919,6,0,0,157184,7,6096606284
2490,58613520,55923654,114537174,5,0,1,33792,11,3672864822
2491,58629850,17293463,75923313,6,0,0,261120,7,2825237369
2492,58635700,17093500,75729200,1,0,0,512,5,4468023515
2493,58653860,17096811,75750671,9,0,0,512,17,7235776145
2494,58686001,55851196,114537197,6,0,1,17920,7,1797478585
2495,58699850,16952394,75652244,1,0,0,512,5,9511586034
2496,58705880,55831356,114537236,3,0,1,8704,3,9070681781
2497,58773280,55877461,114650741,5,0,1,64000,11,7979602422
2498,58776120,16946210,75722330,6,0,0,41472,7,2166533794
2499,58843150,17289893,76133043,6,0,0,83968,7,10669010939
2500,58902470,17032479,75934949,4,0,0,37888,2,6797583594
2501,59018320,16997382,76015702,4,0,0,107520,2,10699046806
2502,59068740,55582024,114650764,5,0,1,17920,11,8952698985
2503,59105750,16523690,75629440,9,0,0,4096,17,9842216899
2504,59110550,16906751,76017301,1,0,0,5120,5,293228080
2505,59291060,16988737,76279797,4,0,0,221696,2,1338642457
2506,59300180,16717464,76017644,1,0,0,1024,5,5805109972
2507,59396300,16972838,76369138,6,0,0,77312,7,7869924495
2508,59430170,17301336,76731506,6,0,0,243200,7,6589458529
2509,59440030,17160272,76600302,4,0,0,365568,2,10507626535
2510,59461680,55189107,114650787,5,0,1,57856,11,8095377816
2511,59483419,55412200,114895619,4,0,1,14848,2,1743519951
2512,59484610,16809580,76294190,1,0,0,1024,5,9433945936
2513,59522419,55373223,114895642,4,0,1,5632,2,7834619451
2514,59550510,55581992,115132502,7,0,1,40448,16,9750477236
2515,59559819,55905671,115465490,4,0,1,69632,2,4642321604
2516,59629069,55836444,115465513,0,0,1,10752,10,3371029314
2517,59659850,55805686,115465536,5,0,1,4096,11,9488380312
2518,59733129,55823908,115557037,1,0,1,55808,5,9241872282
2519,59740140,17083222,76823362,6,0,0,82432,7,7359097006
2520,59766459,55790601,115557060,4,0,1,9216,2,10286660848
2521,59788419,55811238,115599657,1,0,1,11776,5,1348857329
2522,59796960,16807733,76604693,9,0,0,14336,17,3780960157
2523,59802920,56528890,116331810,8,0,1,596992,2,8560628808
2524,59827409,56522387,116349796,4,0,1,6144,2,9747068198
2525,59831629,56518190,116349819,4,0,1,3584,2,4752758489
2526,59841689,56548113,116389802,0,0,1,66048,10,5756920308
2527,59856120,56534450,116390570,5,0,1,11776,11,9048205186
2528,59884230,56542625,116426855,5,0,1,58880,11,2528552213
2529,59889370,16872337,76761707,1,0,0,1024,5,1430324745
2530,59911250,56665269,116576519,5,0,1,22016,11,5755746774
2531,59916820,16996788,76913608,1,0,0,1024,5,8713540104
2532,59927089,56649453,116576542,1,0,1,9728,5,759298492
2533,59944999,56652108,116597107,1,0,1,9216,5,2752052912
2534,60012599,56596880,116609479,1,0,1,17920,5,8989527169
2535,60047469,56563316,116610785,1,0,1,2048,5,2585769076
2536,60124339,56489352,116613691,1,0,1,4608,5,4068649875
2537,60162379,56488822,116651201,1,0,1,47104,5,8430944184
2538,60230620,56477840,116708460,5,0,1,59904,11,2936115900
2539,60252780,17047812,77300592,1,0,0,9728,5,8192731577
2540,60257110,56462627,116719737,5,0,1,21504,11,4148292372
2541,60266469,56470445,116736914,4,0,1,2560,2,5539139343
2542,60297830,56440057,116737887,5,0,1,12800,11,5341179615
2543,60298639,56515834,116814473,0,0,1,5120,10,9271467413
2544,60356530,17176347,77532877,4,0,0,6656,2,9312201298
2545,60365119,56486983,116852102,0,0,1,9728,10,2154144502
2546,60371789,56666701,117038490,4,0,1,50176,2,5351376464
2547,60378210,17416165,77794375,4,0,0,33792,2,7826744566
2548,60399340,17724604,78123944,4,0,0,185856,2,6165818692
2549,60426529,56611984,117038513,1,0,1,11776,5,13391589
2550,60443209,56635130,117078339,1,0,1,2048,5,10382124196
2551,60448180,57741765,118189945,5,0,1,23552,11,9492718211
2552,60469950,17705173,78175123,1,0,0,46080,5,4283427876
2553,60483020,17516388,77999408,9,0,0,1536,17,4911153772
2554,60487149,57868364,118355513,1,0,1,11264,5,6356775417
2555,60504669,57991602,118496271,1,0,1,11776,5,9436948559
2556,60514640,18232934,78747574,4,0,0,283648,2,830639760
2557,60515530,18358341,78873871,4,0,0,64512,2,9846610101
2558,60545560,18027511,78573071,6,0,0,548352,7,9007688438
2559,60575290,57921004,118496294,5,0,1,6144,11,5975209119
2560,60585999,57910318,118496317,0,0,1,6144,10,9382721325
2561,60596080,17645040,78241120,9,0,0,1024,17,6942610567
2562,60609109,57887231,118496340,0,0,1,512,10,963678473
2563,60643270,17332468,77975738,9,0,0,5632,17,6284751454
2564,60687659,57808704,118496363,1,0,1,10752,5,8552661165
2565,60703059,57793327,118496386,1,0,1,12288,5,10736338182
2566,60827260,57669149,118496409,5,0,1,4608,11,4044696720
2567,60851440,17022639,77874079,9,0,0,4096,17,9052879782
2568,60865629,57630803,118496432,1,0,1,4608,5,4534562505
2569,60887400,57609055,118496455,5,0,1,6656,11,7577946405
2570,60916629,57579849,118496478,1,0,1,6144,5,3197180486
2571,60950850,17378749,78329599,6,0,0,4096,7,3293286867
2572,60981020,17610707,78591727,6,0,0,60928,7,3244386360
2573,60983140,57513361,118496501,5,0,1,2560,11,10001813776
2574,61043299,57518145,118561444,0,0,1,65536,10,7886309710
2575,61065240,18075237,79140477,6,0,0,557056,7,9374445907
2576,61094569,58480952,119575521,0,0,1,29184,10,2062484109
2577,61142310,17219966,78362276,6,0,0,33280,7,8139463701
2578,61161800,59016578,120178378,5,0,1,78848,11,4726981536
2579,61171650,17191897,78363547,1,0,0,4096,5,5276728304
2580,61203300,59002135,120205435,5,0,1,8192,11,3022260479
2581,61215160,59154143,120369303,5,0,1,2048,11,6464859193
2582,61226090,17628094,78854184,4,0,0,235520,2,2232845958
2583,61236829,59253216,120490045,1,0,1,80384,5,10232526041
2584,61249620,17663169,78912789,1,0,0,125440,5,4677559521
2585,61341109,59205125,120546234,1,0,1,29184,5,2690893531
2586,61380250,59815757,121196007,5,0,1,12288,11,8263248738
2587,61380879,60537379,121918258,1,0,1,61952,5,215519918
2588,61391299,60729017,122120316,0,0,1,92160,10,10124500069
2589,61412370,17462061,78874431,9,0,0,1536,17,10514466138
2590,61428849,60691490,122120339,1,0,1,12288,5,2088369152
2591,61432910,17349491,78782401,4,0,0,40960,2,4727261815
2592,61449869,60670493,122120362,1,0,1,1024,5,10133041288
2593,61470330,17708060,79178390,6,0,0,123904,7,4862044833
2594,61578159,60545281,122123440,0,0,1,53248,10,6772481210
2595,61598699,60690188,122288887,1,0,1,94208,5,10403970975
2596,61649120,17267156,78916276,9,0,0,11264,17,4961330663
2597,61660780,17518973,79179753,4,0,0,4096,2,3900541218
2598,61663089,61320824,122983913,0,0,1,48640,10,4231689787
2599,61669060,17745045,79414105,9,0,0,512,17,2490105565
2600,61676190,17889532,79565722,6,0,0,137728,7,4751680574
2601,61763310,17940693,79704003,1,0,0,155648,5,7244334107
2602,61785960,18046241,79832201,1,0,0,60928,5,7416652105
2603,61835050,17770163,79605213,1,0,0,129536,5,2026959890
2604,61873209,61132613,123005822,1,0,1,46592,5,3781978714
2605,61927439,61078406,123005845,1,0,1,11776,5,8597284392
2606,61927850,17884805,79812655,1,0,0,139264,5,1380322252
2607,61972599,61033269,123005868,1,0,1,4608,5,750770567
2608,62018670,17613946,79632616,4,0,0,48640,2,3795653256
2609,62058019,60973830,123031849,1,0,1,512,5,5297717533
2610,62059661,17306422,79366083,2,0,0,69120,4,3990269142
2611,62066759,60965113,123031872,0,0,1,23040,10,9011190058
2612,62098999,60932896,123031895,1,0,1,10752,5,10099197276
2613,62103439,61081406,123184845,1,0,1,41472,5,1610159996
2614,62123580,17709112,79832692,9,0,0,1536,17,772343079
2615,62139701,17717862,79857563,2,0,0,35840,4,7432973991
2616,62166940,17489616,79656556,3,0,0,76800,3,3280946165
2617,62185559,60999309,123184868,0,0,1,10240,10,2691257056
2618,62187750,17877694,80065444,9,0,0,2560,17,10396547853
2619,62192669,60992222,123184891,1,0,1,5120,5,999116732
2620,62245990,17818651,80064641,4,0,0,434176,2,3300417691
2621,62259041,17668678,79927719,2,0,0,14848,4,6936361042
2622,62269591,17631150,79900741,2,0,0,63488,4,2962188508
2623,62289559,61785042,124074601,1,0,1,69120,5,2908574527
2624,62319069,62894719,125213788,0,0,1,47616,10,1694793883
2625,62320861,17449339,79770200,2,0,0,61952,4,6548537429
2626,62352550,17461064,79813614,9,0,0,3072,17,6942665406
2627,62418980,18095923,80514903,6,0,0,207360,7,6002589699
2628,62424950,62791424,125216374,8,0,1,4096,2,3508067208
2629,62450640,62776965,125227605,8,0,1,3584,2,7169358909
2630,62495011,17650934,80145945,2,0,0,64512,4,3767219703
2631,62498220,62730665,125228885,3,0,1,14336,3,4082711670
2632,62504789,62726682,125231471,0,0,1,4096,10,9383304057
2633,62507629,62727721,125235350,0,0,1,17408,10,760587239
2634,62510490,62728726,125239216,8,0,1,6144,2,4431231719
2635,62511000,62769918,125280918,3,0,1,7680,3,10675213846
2636,62522119,63164993,125687112,1,0,1,37888,5,2168027913
2637,62573280,63184117,125757397,3,0,1,16896,3,8688012150
2638,62574229,63183191,125757420,0,0,1,13312,10,5027585650
2639,62575400,63234860,125810260,5,0,1,23552,11,10173995060
2640,62580340,63241701,125822041,3,0,1,512,3,2331632843
2641,62594050,18023844,80617894,6,0,0,337920,7,164155992
2642,62625699,63200848,125826547,0,0,1,7168,10,10551726943
2643,62655250,18032425,80687675,4,0,0,49664,2,8899856956
2644,62701570,17367485,80069055,1,0,0,11776,5,4550012895
2645,62813740,17508768,80322508,1,0,0,78848,5,1400326893
2646,62857940,17553177,80411117,6,0,0,29696,7,7822194150
2647,62867889,63376690,126244579,0,0,1,30720,10,5287581398
2648,62956890,17494810,80451700,6,0,0,133120,7,317948744
2649,62969981,17681819,80651800,2,0,0,110080,4,5007985778
2650,62974409,63339717,126314126,0,0,1,37888,10,1127288505
2651,62987990,17381098,80369088,9,0,0,1024,17,4955805290
2652,63077909,63241914,126319823,0,0,1,18944,10,7542966163
2653,63089430,64021178,127110608,3,0,1,39424,3,7294955491
2654,63141730,17998501,81140231,3,0,0,313856,3,1519542547
2655,63142050,64011637,127153687,8,0,1,22528,2,945398079
2656,63158039,64046269,127204308,0,0,1,26112,10,6928147709
2657,63191890,64046464,127238354,3,0,1,36864,3,4591488846
2658,63194860,64044480,127239340,8,0,1,1536,2,4052671588
2659,63198800,17419437,80618237,9,0,0,1024,17,6280751759
2660,63200450,17633929,80834379,4,0,0,39936,2,1425004917
2661,63221200,17793285,81014485,1,0,0,279040,5,5374646755
2662,63256759,64048044,127304803,0,0,1,43520,10,5892216129
2663,63337519,64236085,127573604,0,0,1,15360,10,8454047154
2664,63348290,17670118,81018408,1,0,0,12800,5,4943469747
2665,63352549,64281708,127634257,0,0,1,5632,10,5005032001
2666,63353730,64458716,127812446,3,0,1,23552,3,1988185500
2667,63358650,64559032,127917682,8,0,1,33792,2,3531396329
2668,63371310,17827608,81198918,9,0,0,2048,17,4819600301
2669,63393360,17854478,81247838,1,0,0,20992,5,1676221277
2670,63397150,64640371,128037521,3,0,1,1536,3,2925330103
2671,63402740,65063646,128466386,8,0,1,26112,2,8884132471
2672,63408620,65124946,128533566,3,0,1,25088,3,2134022202
2673,63409819,65123770,128533589,1,0,1,37888,5,6179331856
2674,63425199,65175411,128600610,0,0,1,31744,10,8901046496
2675,63428040,65173338,128601378,8,0,1,11776,2,213116441
2676,63455740,18594955,82050695,1,0,0,617984,5,239674053
2677,63538050,17991353,81529403,1,0,0,74752,5,4539866289
2678,63550720,65159868,128710588,3,0,1,14336,3,7511771371
2679,63555769,65229612,128785381,4,0,1,5120,2,8479365055
2680,63580010,65205394,128785404,8,0,1,13824,2,4980583794
2681,63598479,65186948,128785427,0,0,1,7168,10,3802086496
2682,63616660,18486216,82102876,1,0,0,171008,5,662696244
2683,63641620,65154461,128796081,3,0,1,13824,3,2410906772
2684,63669809,65126295,128796104,4,0,1,7680,2,6350044593
2685,63694830,65101305,128796135,3,0,1,27136,3,5409324622
2686,63715820,17831999,81547819,9,0,0,2048,17,4830501712
2687,63718119,65078039,128796158,4,0,1,12288,2,2318956494
2688,63721350,65074831,128796181,3,0,1,1536,3,10099264542
2689,63745220,65106300,128851520,3,0,1,32256,3,7141268203
2690,63757410,18014316,81771726,9,0,0,10752,17,8846146007
2691,63806530,17656043,81462573,9,0,0,2560,17,3003894150
2692,63809880,18052500,81862380,1,0,0,140800,5,4097753510
2693,63844799,65006744,128851543,1,0,1,3072,5,8032259364
2694,63903520,18393315,82296835,1,0,0,222208,5,4595147560
2695,63923579,64927987,128851566,1,0,1,20480,5,9725933925
2696,63953430,18252899,82206329,4,0,0,13312,2,1222004529
2697,64008810,18423559,82432369,3,0,0,320000,3,5734020042
2698,64047100,64805713,128852813,8,0,1,41472,2,3502964397
2699,64053590,18864802,82918392,1,0,0,153088,5,6332612002
2700,64086890,18247956,82334846,1,0,0,79872,5,3214449571
2701,64087831,18510685,82598516,2,0,0,386560,4,7516709
2702,64099280,64756289,128855569,8,0,1,1024,2,1569282240
2703,64136779,64725972,128862751,1,0,1,34304,5,1137786737
2704,64160819,64715906,128876725,1,0,1,2048,5,7468595278
2705,64161339,64718612,128879951,4,0,1,5120,2,5197913326
2706,64182479,64707691,128890170,4,0,1,5632,2,1391851039
2707,64218220,18381723,82599943,9,0,0,4608,17,99453247
2708,64242560,64767506,129010066,8,0,1,1536,2,5652537343
2709,64250020,64760069,129010089,3,0,1,4096,3,3417151718
2710,64252500,64757612,129010112,8,0,1,29696,2,9913516052
2711,64270441,64739694,129010135,9,0,1,1024,17,5105238708
2712,64271180,18383094,82654274,9,0,0,2048,17,6774393755
2713,64321580,18318564,82640144,9,0,0,2048,17,2642092101
2714,64345650,18343940,82689590,9,0,0,11264,17,9228243322
2715,64347200,18308706,82655906,9,0,0,1536,17,9807100047
2716,64371371,64638787,129010158,9,0,1,15360,17,7705289306
2717,64375630,64647389,129023019,7,0,1,35328,16,8164847387
2718,64377840,64735237,129113077,7,0,1,17408,16,8206514862
2719,64386030,64727070,129113100,7,0,1,1536,16,1943963780
2720,64418230,64695696,129113926,8,0,1,4608,2,4235520416
2721,64422431,65190861,129613292,9,0,1,72192,17,5280781855
2722,64437681,65435369,129873050,9,0,1,20480,17,3445736457
2723,64446191,65497183,129943374,9,0,1,8704,17,3551174914
2724,64447831,65604301,130052132,9,0,1,20480,17,7912099794
2725,64450490,66065107,130515597,8,0,1,8192,2,4690367792
2726,64513110,66534050,131047160,3,0,1,39936,3,7328471133
2727,64514570,18610299,83124869,9,0,0,18432,17,7897603564
2728,64516880,18963251,83480131,9,0,0,8192,17,3558328065
2729,64540540,18936972,83477512,4,0,0,2560,2,5306463965
2730,64564270,18715767,83280037,9,0,0,2048,17,8645168452
2731,64564629,66482554,131047183,1,0,1,6144,5,600818877
2732,64570809,66476397,131047206,4,0,1,1024,2,5651107130
2733,64572340,66619033,131191373,7,0,1,85504,16,10726726724
2734,64575559,66615837,131191396,1,0,1,4608,5,2192053260
2735,64590850,18885859,83476709,3,0,0,384512,3,2271787388
2736,64610730,18658499,83269229,4,0,0,31232,2,1502718951
2737,64622310,66676743,131299053,7,0,1,89600,16,9840334819
2738,64626680,66913982,131540662,8,0,1,51200,2,5474808637
2739,64637170,66949171,131586341,8,0,1,39424,2,5223581873
2740,64652700,66995828,131648528,3,0,1,1536,3,2940441364
2741,64695161,18856684,83551845,2,0,0,46080,4,8768616221
2742,64703231,67002641,131705872,9,0,1,30208,17,2349832281
2743,64723110,66983223,131706333,3,0,1,10240,3,4634371491
2744,64740300,67024020,131764320,7,0,1,40448,16,2439676402
2745,64752070,67020725,131772795,3,0,1,25088,3,9441800306
2746,64779441,67072543,131851984,6,0,1,19456,7,7291985276
2747,64793820,18854184,83648004,3,0,0,72192,3,1763437130
2748,64794620,67060270,131854890,3,0,1,4608,3,3558225584
2749,64796131,67082561,131878692,9,0,1,6656,17,4565820291
2750,64816060,18981188,83797248,1,0,0,91136,5,10436023436
2751,64822541,67071714,131894255,6,0,1,11264,7,5538802947
2752,64829239,67580963,132410202,4,0,1,76800,2,8857225129
2753,64832991,67596410,132429401,6,0,1,29184,7,7569975074
2754,64845350,68289065,133134415,8,0,1,129024,2,7643170674
2755,64932161,68245398,133177559,6,0,1,22016,7,1530981488
2756,65001110,68301067,133302177,8,0,1,13312,2,10308838267
2757,65013950,68288250,133302200,7,0,1,42496,16,2402429097
2758,65024281,68277950,133302231,9,0,1,20480,17,2968489559
2759,65037740,68264514,133302254,7,0,1,12288,16,4613695099
2760,65043449,68258828,133302277,1,0,1,6656,5,7322083388
2761,65051370,18788644,83840014,3,0,0,17920,3,10539816660
2762,65054790,18763075,83817865,9,0,0,2560,17,3704495209
2763,65068850,68290555,133359405,8,0,1,5632,2,5030147067
2764,65077020,68311115,133388135,7,0,1,28672,16,816342382
2765,65078260,19145152,84223412,3,0,0,254976,3,4511272120
2766,65108339,68282382,133390721,4,0,1,4096,2,1169621893
2767,65126309,68267318,133393627,1,0,1,4608,5,9095419829
2768,65135341,68262498,133397839,6,0,1,6656,7,4014206578
2769,65135429,68264996,133400425,4,0,1,4096,2,5989520014
2770,65141631,68259780,133401411,6,0,1,1536,7,10304001713
2771,65198760,19276958,84475718,1,0,0,269824,5,3304947976
2772,65228939,68324213,133553152,4,0,1,38400,2,5916508235
2773,65249899,68303276,133553175,4,0,1,2048,2,6764248606
2774,65266641,68286557,133553198,6,0,1,5632,7,10038952265
2775,65279929,68273292,133553221,4,0,1,1536,2,6450319491
2776,65305910,19469732,84775642,1,0,0,442368,5,209738
2777,65352081,19450572,84802653,2,0,0,88576,4,5002124689
2778,65358811,68194433,133553244,6,0,1,18432,7,8009636742
2779,65361040,68192227,133553267,3,0,1,1536,3,2410733159
2780,65369641,19762358,85131999,2,0,0,68096,4,1960609682
2781,65370020,68183270,133553290,8,0,1,11776,2,4670713039
2782,65399370,19992132,85391502,4,0,0,67072,2,10617241070
2783,65413151,68140162,133553313,9,0,1,17408,17,2326729127
2784,65421910,68190619,133612529,7,0,1,47104,16,6873764960
2785,65438450,68174781,133613231,8,0,1,12288,2,7972486527
2786,65438770,19818837,85257607,4,0,0,148480,2,3973461851
2787,65453700,68222304,133676004,8,0,1,27648,2,3728513921
2788,65475320,19600684,85076004,9,0,0,10240,17,2214213416
2789,65499589,68539801,134039390,1,0,1,46592,5,1375842665
2790,65508431,68530982,134039413,9,0,1,5632,17,3738565033
2791,65509059,68530377,134039436,1,0,1,512,5,8696004878
2792,65511631,68527828,134039459,6,0,1,14336,7,10300787472
2793,65525859,68581038,134106897,1,0,1,20480,5,3590556517
2794,65528980,68848062,134377042,3,0,1,68096,3,7170575197
2795,65548971,20540685,86089656,2,0,0,503296,4,7225718194
2796,65550930,20257378,85808308,1,0,0,52224,5,296687859
2797,65582421,68794644,134377065,9,0,1,16896,17,1408856855
2798,65595920,68843637,134439557,8,0,1,26112,2,3659470728
2799,65604139,68835441,134439580,4,0,1,4608,2,10463124436
2800,65624010,68815593,134439603,7,0,1,32768,16,9921217724
2801,65645050,68844565,134489615,3,0,1,7168,3,6670340837
2802,65691310,68798328,134489638,8,0,1,4096,2,6842045755
2803,65697469,68792192,134489661,0,0,1,7680,10,10689752907
2804,65717371,68819471,134536842,9,0,1,51712,17,10509594037
2805,65719291,68819313,134538604,9,0,1,8192,17,8054420267
2806,65736590,20714502,86451092,1,0,0,328704,5,7309973586
2807,65741790,20401609,86143399,1,0,0,126976,5,2713700126
2808,65752950,68827664,134580614,8,0,1,28672,2,2079083939
2809,65787501,21158563,86946064,2,0,0,509440,4,6044332415
2810,65787889,68792748,134580637,4,0,1,1536,2,4902617611
2811,65813720,68766940,134580660,8,0,1,3584,2,1977714638
2812,65836720,68743963,134580683,3,0,1,6656,3,3405563545
2813,65873591,21091081,86964672,2,0,0,28160,4,10176139138
2814,65895900,20647389,86543289,6,0,0,74240,7,2988655010
2815,65906199,68674515,134580714,4,0,1,38912,2,9729569541
2816,65907819,68673409,134581228,4,0,1,17408,2,5424046326
2817,65926160,21028576,86954736,1,0,0,28160,5,8625500292
2818,65955730,68653391,134609121,7,0,1,30208,16,10593566041
2819,65960611,68648549,134609160,9,0,1,23552,17,5096210390
2820,65970951,68638232,134609183,6,0,1,7168,7,9609341961
2821,65972521,68739598,134712119,6,0,1,24576,7,8903725787
2822,65976370,21133324,87109694,3,0,0,192512,3,6415985247
2823,66013590,21304382,87317972,6,0,0,27136,7,10142362532
2824,66024780,21360782,87385562,1,0,0,20992,5,2462978967
2825,66029110,68683032,134712142,8,0,1,12800,2,5752366970
2826,66066870,21125652,87192522,9,0,0,1024,17,9877398110
2827,66113841,68685858,134799699,9,0,1,18944,17,2899133161
2828,66115050,69178584,135293634,7,0,1,23040,16,1823685015
2829,66142650,21394256,87536906,3,0,0,195072,3,5428341188
2830,66162069,69131588,135293657,4,0,1,2560,2,3504324216
2831,66230910,21146378,87377288,1,0,0,65536,5,7474923454
2832,66233889,69105645,135339534,1,0,1,8192,5,1035893780
2833,66258509,69087508,135346017,1,0,1,15872,5,829050102
2834,66295470,21355466,87650936,4,0,0,69120,2,3386936653
2835,66308600,21165088,87473688,9,0,0,512,17,5165801046
2836,66314781,69196029,135510810,9,0,1,1536,17,2454315380
2837,66323960,69198440,135522400,7,0,1,19968,16,3095459632
2838,66338150,69754494,136092644,8,0,1,67072,2,6013308699
2839,66352880,21483110,87835990,4,0,0,1024,2,364402855
2840,66461520,21360072,87821592,1,0,0,365568,5,2670174953
2841,66468161,69628989,136097150,6,0,1,7168,7,9985764865
2842,66483070,69792567,136275637,7,0,1,12800,16,7604547881
2843,66488800,69895363,136384163,8,0,1,17408,2,6303754815
2844,66516781,21422228,87939009,2,0,0,91648,4,9590667073
2845,66603700,21232781,87836481,1,0,0,1536,5,9978604201
2846,66671361,21164294,87835655,2,0,0,46080,4,504861344
2847,66672180,69855180,136527360,7,0,1,44544,16,3294603768
2848,66672700,69854683,136527383,7,0,1,7680,16,5247398383
2849,66695551,21288370,87983921,2,0,0,106496,4,1309003909
2850,66704921,69968368,136673289,6,0,1,13824,7,4653683175
2851,66740350,69932962,136673312,7,0,1,13824,16,5503438198
2852,66756420,21399917,88156337,4,0,0,90624,2,9033337696
2853,66772140,21074348,87846488,3,0,0,32768,3,2728914172
2854,66786770,21557090,88343860,3,0,0,103936,3,10082311521
2855,66804140,21585062,88389202,9,0,0,4608,17,10608939445
2856,66879290,70279764,137159054,2,0,1,274944,4,10312854848
2857,66891170,70281354,137172524,7,0,1,11264,16,3661714036
2858,66988311,70184236,137172547,6,0,1,3072,7,2796972535
2859,66993820,70195473,137189293,7,0,1,16896,16,9412049441
2860,67001700,21156688,88158388,4,0,0,6656,2,3071822208
2861,67067251,70122065,137189316,6,0,1,14848,7,262593430
2862,67072440,70119886,137192326,7,0,1,3584,16,2647761128
2863,67118170,70074179,137192349,7,0,1,2560,16,1486476918
2864,67122360,70070012,137192372,7,0,1,12800,16,9764195420
2865,67146700,21044369,88191069,4,0,0,11776,2,5582541317
2866,67149601,70042794,137192395,6,0,1,5632,7,9658454544
2867,67153699,70038727,137192426,1,0,1,9216,5,4659454920
2868,67156190,22084876,89241066,4,0,0,666112,2,9480694140
2869,67157460,21187203,88344663,9,0,0,2560,17,4420194858
2870,67171510,70177059,137348569,2,0,1,89600,4,275273722
2871,67196830,70151762,137348592,7,0,1,30720,16,5044432121
2872,67224920,70939244,138164164,2,0,1,260096,4,2520524527
2873,67239910,21038533,88278443,9,0,0,1536,17,5791606279
2874,67241570,21546057,88787627,9,0,0,8192,17,883250971
2875,67247270,22044051,89291321,1,0,0,164864,5,6327413397
2876,67272230,21611816,88884046,3,0,0,43008,3,3523285763
2877,67273550,22410531,89684081,4,0,0,91648,2,3348989910
2878,67280270,22266792,89547062,3,0,0,454656,3,5376702554
2879,67291610,70888267,138179877,7,0,1,7680,16,10541441582
2880,67292581,22363553,89656134,2,0,0,357376,4,5946832430
2881,67308720,71205205,138513925,2,0,1,303616,4,6374945654
2882,67350929,71163019,138513948,0,0,1,43008,10,10434374311
2883,67400110,21952527,89352637,4,0,0,40448,2,671151826
2884,67400870,71113101,138513971,7,0,1,7680,16,6152288706
2885,67422311,71265357,138687668,6,0,1,50176,7,5136233251
2886,67437031,71250660,138687691,9,0,1,55296,17,8533959683
2887,67546180,22691142,90237322,3,0,0,236544,3,992089773
2888,67550400,22332403,89882803,4,0,0,61952,2,1169552654
2889,67582810,22102129,89684939,9,0,0,2560,17,6960374326
2890,67590900,71096814,138687714,7,0,1,5120,16,1817175027
2891,67593350,71094387,138687737,3,0,1,2560,3,7293894640
2892,67626219,71061541,138687760,1,0,1,24064,5,8026783262
2893,67627870,22166490,89794360,3,0,0,97792,3,4959626206
2894,67665130,71022669,138687799,7,0,1,19968,16,9309743995
2895,67668590,71019232,138687822,7,0,1,10752,16,3014884536
2896,67673250,22127463,89800713,9,0,0,512,17,1920745403
2897,67679660,71008185,138687845,3,0,1,15872,3,3986253109
2898,67687460,71036209,138723669,2,0,1,277504,4,7879536185
2899,67712710,22182174,89894884,4,0,0,10752,2,7419712390
2900,67753530,22869583,90623113,3,0,0,356864,3,6325997553
2901,67764031,22127531,89891562,2,0,0,28672,4,4877583263
2902,67838700,70885840,138724540,7,0,1,12288,16,4610887004
2903,67880940,70845188,138726128,7,0,1,15872,16,5399697783
2904,67890790,70859617,138750407,3,0,1,17408,3,9832719786
2905,67900350,70991292,138891642,2,0,1,115200,4,588921511
2906,67901300,70990365,138891665,3,0,1,4096,3,803325977
2907,67911291,22771171,90682462,2,0,0,20480,4,5778605752
2908,67935340,22740859,90676199,3,0,0,174080,3,1096927120
2909,67954930,23117858,91072788,3,0,0,118784,3,3013966298
2910,68044430,70847258,138891688,7,0,1,11264,16,1374876559
2911,68050850,22985723,91036573,1,0,0,654848,5,6597294586
2912,68052181,23255462,91307643,2,0,0,138240,4,8663573300
2913,68052489,70839222,138891711,1,0,1,3072,5,1984122974
2914,68059470,23024261,91083731,3,0,0,35840,3,853154211
2915,68070500,23118467,91188967,3,0,0,340480,3,9395226842
2916,68113440,70779387,138892827,7,0,1,23040,16,532884782
2917,68161330,70826773,138988103,2,0,1,183296,4,2470486885
2918,68196210,23327751,91523961,3,0,0,332288,3,1093345532
2919,68213750,22501886,90715636,9,0,0,5632,17,7344889655
2920,68218091,23022246,91240337,2,0,0,167936,4,5242143706
2921,68260400,70782529,139042929,3,0,1,70144,3,4318819338
2922,68261830,23046304,91308134,3,0,0,1536,3,8450965399
2923,68313660,22875486,91189146,9,0,0,512,17,423139417
2924,68337690,22747468,91085158,3,0,0,4608,3,10133058029
2925,68372050,70694965,139067015,7,0,1,45568,16,5533159704
2926,68448800,22816700,91265500,1,0,0,82432,5,7114322932
2927,68465930,70602058,139067988,3,0,1,12800,3,3766698049
2928,68523680,23152796,91676476,3,0,0,198656,3,8179344852
2929,68542099,70557608,139099707,1,0,1,25600,5,6472943670
2930,68549380,22977100,91526480,9,0,0,8192,17,7547798902
2931,68568860,22991682,91560542,9,0,0,6144,17,1704931196
2932,68579080,70576818,139155898,2,0,1,55808,4,9945250484
2933,68601929,70570765,139172694,1,0,1,7680,5,966987132
2934,68669820,70507060,139176880,3,0,1,6656,3,1833966077
2935,68701540,23106257,91807797,4,0,0,118784,2,1113161531
2936,68712250,23855574,92567824,3,0,0,375808,3,3067636086
2937,68736751,23674638,92411389,2,0,0,674304,4,6211784961
2938,68739171,23692989,92432160,2,0,0,68096,4,3051414421
2939,68741189,70438917,139180106,1,0,1,5120,5,9700445679
2940,68754369,70433930,139188299,1,0,1,29696,5,5760371021
2941,68771590,70417785,139189375,3,0,1,13312,3,5134479988
2942,68801720,22897339,91699059,4,0,0,2560,2,4886811609
2943,68829300,70376473,139205773,3,0,1,3072,3,9049036252
2944,68872929,70334470,139207399,1,0,1,2560,5,7099235466
2945,68902820,23533910,92436730,4,0,0,3584,2,4609985709
2946,68913080,23522535,92435615,9,0,0,11264,17,8772476462
2947,68915321,23653018,92568339,2,0,0,1536,4,2294630221
2948,68970591,23680139,92650730,2,0,0,270336,4,10138212326
2949,68972171,23775972,92748143,2,0,0,45568,4,2552353537
2950,68976330,70231325,139207655,5,0,1,9216,11,736684778
2951,69034700,23418589,92453289,1,0,0,54272,5,9133170675
2952,69040180,70210891,139251071,7,0,1,28160,16,9858338014
2953,69057410,23620799,92678209,1,0,0,90112,5,941955469
2954,69062330,70242243,139304573,3,0,1,29184,3,8851866456
2955,69181391,23552845,92734236,2,0,0,183808,4,6329671295
2956,69195830,70920184,140116014,2,0,1,277504,4,1294666056
2957,69217860,70902980,140120840,3,0,1,7680,3,6576414110
2958,69261020,23657768,92918788,3,0,0,250368,3,10062970372
2959,69300149,70857924,140158073,1,0,1,22528,5,3499978420
2960,69302480,70863965,140166445,7,0,1,13312,16,1356923441
2961,69304120,23686704,92990824,1,0,0,60416,5,10727736975
2962,69345569,70823142,140168711,1,0,1,3584,5,6510615962
2963,69365540,70806717,140172257,3,0,1,5632,3,5122646766
2964,69387360,23406460,92793820,4,0,0,1536,2,6520452159
2965,69408420,23828062,93236482,1,0,0,55296,5,6493891237
2966,69409390,23611856,93021246,9,0,0,1536,17,3274510890
2967,69409630,24265665,93675295,1,0,0,686080,5,99257372
2968,69415151,24379195,93794346,2,0,0,390656,4,6087220496
2969,69455680,23978736,93434416,3,0,0,77312,3,3393825579
2970,69458930,24340009,93798939,9,0,0,2048,17,3016594240
2971,69471019,70713408,140184427,1,0,1,8704,5,3494880747
2972,69499170,70687203,140186373,7,0,1,3072,16,7585984149
2973,69534419,70659317,140193736,1,0,1,23552,5,1203267236
2974,69588660,70744616,140333276,7,0,1,47616,16,4670023094
2975,69639390,24272281,93911671,1,0,0,293888,5,6735351622
2976,69662429,70848109,140510538,1,0,1,15360,5,7044870524
2977,69670270,24151312,93821582,3,0,0,74240,3,6522525587
2978,69671810,24123495,93795305,4,0,0,3072,2,1735126037
2979,69782690,23667092,93449782,9,0,0,5632,17,5592154576
2980,69800749,70709812,140510561,1,0,1,26624,5,7559049029
2981,69866960,23955113,93822073,9,0,0,1536,17,5655402656
2982,69961530,70549070,140510600,7,0,1,37888,16,1394053782
2983,70014920,23783372,93798292,9,0,0,9728,17,3576878134
2984,70049850,23875580,93925430,9,0,0,45056,17,8341586923
2985,70050260,23897033,93947293,4,0,0,71680,2,6269894268
2986,70064400,23969051,94033451,4,0,0,272384,2,9578431702
2987,70140890,23939860,94080750,1,0,0,155136,5,1129905328
2988,70233729,70276894,140510623,4,0,1,4096,2,6704057182
2989,70242609,70268037,140510646,4,0,1,21504,2,2315671411
2990,70245540,23704896,93950436,9,0,0,10240,17,756221521
2991,70259439,70251230,140510669,1,0,1,31232,5,2410999814
2992,70267830,24195587,94463417,1,0,0,104448,5,6124107626
2993,70273579,70237113,140510692,1,0,1,11776,5,4427318580
2994,70317480,23773129,94090609,1,0,0,32256,5,4435612217
2995,70334750,24096820,94431570,3,0,0,22528,3,10472562361
2996,70340350,24168572,94508922,1,0,0,85504,5,10491295647
2997,70375431,23941840,94317271,2,0,0,70144,4,1117559175
2998,70389900,24200761,94590661,4,0,0,159232,2,610962635
2999,70403440,23771648,94175088,4,0,0,3584,2,5333653951
3000,70408780,24451060,94859840,4,0,0,86528,2,7713606105
3001,70431750,24258337,94690087,4,0,0,118784,2,800418326
3002,70626889,69883826,140510715,4,0,1,12288,2,1993586495
3003,70631449,69915972,140547421,1,0,1,4096,5,112643187
3004,70647420,24588147,95235567,9,0,0,391168,17,9369595527
3005,70653081,24149399,94802480,2,0,0,141312,4,6562841548
3006,70657679,69889765,140547444,4,0,1,6144,2,10343310027
3007,70750470,69916094,140666564,3,0,1,48640,3,2524036452
3008,70753330,24194584,94947914,3,0,0,128512,3,10053273259
3009,70777240,24103550,94880790,1,0,0,68608,5,1317207630
3010,70805709,69860878,140666587,4,0,1,17408,2,9990715381
3011,70876489,69790137,140666626,4,0,1,24576,2,7986072530
3012,70878101,24528763,95406864,2,0,0,449536,4,4704851727
3013,71007829,69658820,140666649,1,0,1,8192,5,6660785725
3014,71018810,24251063,95269873,9,0,0,87040,17,2172097855
3015,71057390,24039282,95096672,4,0,0,5632,2,5355200703
3016,71080831,24499661,95580492,2,0,0,217088,4,3883005786
3017,71097709,69568963,140666672,4,0,1,4608,2,1574543220
3018,71099799,69566896,140666695,4,0,1,10240,2,10415325531
3019,71124510,24285768,95410278,4,0,0,10752,2,8373515240
3020,71155271,24347920,95503191,2,0,0,4096,4,3287344256
3021,71224271,24232674,95456945,2,0,0,153088,4,803388351
3022,71243219,69444154,140687373,1,0,1,57344,5,9850716415
3023,71247950,24350349,95598299,1,0,0,58368,5,5231268624
3024,71297779,69461252,140759031,1,0,1,22528,5,9314437033
3025,71320849,69438205,140759054,1,0,1,10752,5,7181410133
3026,71358211,24143709,95501920,2,0,0,88064,4,6532842288
3027,71401550,69357567,140759117,3,0,1,38400,3,4811211041
3028,71408840,24366009,95774849,4,0,0,230400,2,7236662527
3029,71419319,69339837,140759156,1,0,1,19968,5,8894657733
3030,71450410,24208681,95659091,4,0,0,30208,2,3799555536
3031,71534071,24278241,95812312,2,0,0,122880,4,4269670902
3032,71555939,69203240,140759179,1,0,1,7680,5,9501753168
3033,71599050,69160152,140759202,3,0,1,11776,3,10475509619
3034,71675380,24151665,95827045,1,0,0,5632,5,7635340742
3035,71706690,24373311,96080001,1,0,0,51200,5,3074056170
3036,71736890,69022335,140759225,3,0,1,11776,3,9769253187
3037,71745749,24480998,96226747,5,0,0,76288,11,6380399654
3038,71747119,69048523,140795642,1,0,1,52736,5,9882170639
3039,71748130,24234557,95982687,4,0,0,168448,2,8303717101
3040,71760430,69060070,140820500,3,0,1,36352,3,5312360120
3041,71767810,24234243,96002053,9,0,0,27648,17,10613073551
3042,71772669,24052637,95825306,5,0,0,42496,11,3528038135
3043,71855439,69001611,140857050,1,0,1,61952,5,317561017
3044,71858079,70075490,141933569,1,0,1,1536,5,3723229794
3045,71865931,70074856,141940787,6,0,1,30720,7,8682826292
3046,71874190,24794816,96669006,3,0,0,39936,3,3863801923
3047,71881491,25032686,96914177,2,0,0,590336,4,6416939351
3048,71884150,24371116,96255266,9,0,0,36352,17,10231906371
3049,71886209,24475738,96361947,5,0,0,40960,11,3193187359
3050,71918259,24325908,96244167,5,0,0,4096,11,7509610236
3051,71927470,24806770,96734240,4,0,0,178688,2,10177286580
3052,71934530,70034867,141969397,3,0,1,6144,3,2538734060
3053,71943039,70047089,141990128,1,0,1,14848,5,3988230679
3054,71986070,25034113,97020183,3,0,0,122368,3,1504119346
3055,71998531,70113457,142111988,6,0,1,9216,7,8581454227
3056,72008801,25155199,97164000,2,0,0,129536,4,3218703972
3057,72025059,70114976,142140035,1,0,1,20992,5,687948199
3058,72112270,25297664,97409934,4,0,0,224768,2,6441565269
3059,72118040,25508812,97626852,9,0,0,224768,17,8000413019
3060,72133550,70007791,142141341,3,0,1,2048,3,3972749851
3061,72141891,24881903,97023794,2,0,0,11776,4,1704025280
3062,72170590,24812171,96982761,3,0,0,224768,3,7908295224
3063,72179381,25105414,97284795,2,0,0,43008,4,5140644596
3064,72179480,69964447,142143927,3,0,1,4096,3,5717225046
3065,72234269,25627273,97861542,5,0,0,378880,11,5907096498
3066,72273740,25181941,97455681,4,0,0,118784,2,8139135072
3067,72314961,70982708,143297669,6,0,1,19456,7,7871448987
3068,72390480,25786728,98177208,1,0,0,702976,5,977857624
3069,72392971,70904721,143297692,6,0,1,22528,7,10044329744
3070,72402550,25513794,97916344,9,0,0,143360,17,6620545432
3071,72412591,71000291,143412882,6,0,1,36864,7,9581205878
3072,72457621,70989003,143446624,6,0,1,34816,7,2103807464
3073,72464640,25882677,98347317,4,0,0,95232,2,4128561226
3074,72484549,70962098,143446647,1,0,1,512,5,444077179
3075,72487710,25147291,97635001,9,0,0,9728,17,599644377
3076,72505650,25760657,98266307,9,0,0,292352,17,5616749090
3077,72507911,70938759,143446670,6,0,1,9216,7,4101450220
3078,72512731,70933962,143446693,6,0,1,3072,7,4705512902
3079,72524060,25927767,98451827,3,0,0,113664,3,3517616770
3080,72527980,25790298,98318278,1,0,0,170496,5,977607396
3081,72537009,70912936,143449945,4,0,1,23040,2,3258582530
3082,72541540,25331101,97872641,1,0,0,36352,5,1328327903
3083,72542360,25838098,98380458,4,0,0,108544,2,957826137
3084,72588081,70873709,143461790,6,0,1,5120,7,8849578256
3085,72588241,25828908,98417149,2,0,0,120320,4,9171503771
3086,72632450,25955391,98587841,4,0,0,381952,2,6245594224
3087,72702990,26566680,99269670,3,0,0,491520,3,401383596
3088,72724041,70742895,143466936,6,0,1,8192,7,8119169307
3089,72743031,70806438,143549469,6,0,1,29696,7,2839028979
3090,72760739,25856819,98617558,5,0,0,97280,11,9687819600
3091,72768649,25702747,98471396,5,0,0,64000,11,3428045388
3092,72791971,70757521,143549492,6,0,1,7680,7,7352832017
3093,72802760,25851978,98654738,1,0,0,121344,5,10599607687
3094,72839000,70710515,143549515,3,0,1,19968,3,5389956954
3095,72844900,26734703,99579603,3,0,0,186368,3,4921840861
3096,72848681,70700857,143549538,6,0,1,512,7,9184258279
3097,72882170,26021484,98903654,4,0,0,58368,2,2685012534
3098,72899341,26051557,98950898,2,0,0,85504,4,234909745
3099,72911370,25754943,98666313,1,0,0,37888,5,1954937897
3100,72917239,26513962,99431201,5,0,0,402432,11,6374887176
3101,72923730,26599066,99522796,3,0,0,300544,3,9796970366
3102,72927499,71096202,144023701,1,0,1,39424,5,562053277
3103,72927779,26933894,99861673,5,0,0,211456,11,7773524330
3104,72940470,71163621,144104091,3,0,1,27648,3,3054413765
3105,72947890,26655205,99603095,9,0,0,76800,17,4581088725
3106,72960591,71155555,144116146,6,0,1,1024,7,7892451961
3107,72980271,71186915,144167186,6,0,1,20480,7,3228162152
3108,72999171,27074896,100074067,2,0,0,196608,4,4203329502
3109,73013520,26741364,99754884,3,0,0,292352,3,2152106041
3110,73018330,27983920,101002250,1,0,0,112640,5,5389385817
3111,73122131,27164452,100286583,2,0,0,208896,4,5194322211
3112,73123211,71071642,144194853,6,0,1,15872,7,3517790452
3113,73138509,27155741,100294250,5,0,0,25088,11,6471511379
3114,73149309,71066462,144215771,0,0,1,2560,10,870769259
3115,73152300,27342463,100494763,3,0,0,57344,3,5021267059
3116,73176581,27300687,100477268,2,0,0,186368,4,9865641628
3117,73247679,70969168,144216847,1,0,1,13312,5,2526809555
3118,73276140,27451249,100727389,3,0,0,368128,3,6474355996
3119,73299691,27315511,100615202,2,0,0,179200,4,2294250367
3120,73323380,27567205,100890585,1,0,0,379392,5,3975410181
3121,73337219,71170375,144507594,1,0,1,57344,5,3882757991
3122,73342940,26790889,100133829,1,0,0,101888,5,5939342686
3123,73346180,26869936,100216116,3,0,0,34816,3,1212486147
3124,73380780,26953583,100334363,9,0,0,90624,17,5306652191
3125,73444191,71076725,144520916,6,0,1,8704,7,4905714526
3126,73451889,27797504,101249393,5,0,0,632832,11,5947068136
3127,73488260,26873782,100362042,1,0,0,28672,5,6269443352
3128,73506521,27435879,100942400,2,0,0,169984,4,710180781
3129,73569991,70950948,144520939,6,0,1,2560,7,3183485068
3130,73584490,70936472,144520962,8,0,1,76800,2,4715248159
3131,73635699,70993480,144629179,1,0,1,16896,5,7658983900
3132,73649291,70979911,144629202,6,0,1,10752,7,4585058373
3133,73716010,27238760,100954770,1,0,0,40448,5,2469237632
3134,73736441,27006891,100743332,2,0,0,52224,4,5244700908
3135,73737869,70891356,144629225,1,0,1,44544,5,7685563842
3136,73763081,27744833,101507914,2,0,0,329216,4,5065619548
3137,73773320,70859375,144632695,8,0,1,4096,2,7498138323
3138,73791911,70863327,144655238,6,0,1,7168,7,2118476499
3139,73816050,27141403,100957453,1,0,0,8704,5,6449220598
3140,73868570,70908265,144776835,8,0,1,7680,2,81112758
3141,73878541,27634590,101513131,2,0,0,16896,4,10480087875
3142,73882960,27524599,101407559,9,0,0,342016,17,3609281693
3143,73889899,70886959,144776858,1,0,1,12800,5,10717782949
3144,73901799,70957028,144858827,4,0,1,36864,2,1252012947
3145,73929220,70929630,144858850,8,0,1,5632,2,3872336251
3146,73929791,70929082,144858873,6,0,1,11264,7,7786331681
3147,73943490,70915406,144858896,8,0,1,25600,2,5521921493
3148,73962549,27340779,101303328,5,0,0,176640,11,5400101577
3149,73992960,70866007,144858967,8,0,1,90112,2,1040682702
3150,74031359,70887716,144919075,1,0,1,23552,5,140268566
3151,74046221,70873840,144920061,6,0,1,1536,7,5793584989
3152,74064439,27623049,101687488,5,0,0,156672,11,8381465758
3153,74065549,27963128,102028677,5,0,0,326656,11,371752359
3154,74189491,70730929,144920420,6,0,1,9728,7,8946664002
3155,74233640,27903462,102137102,1,0,0,355328,5,10602819021
3156,74246830,27668924,101915754,1,0,0,261632,5,9597078462
3157,74250240,28353517,102603757,1,0,0,178688,5,1375125564
3158,74380089,70602262,144982351,0,0,1,32768,10,8703612813
3159,74393841,70599788,144993629,6,0,1,17408,7,8949938005
3160,74403820,27989036,102392856,3,0,0,43008,3,1129574682
3161,74404449,70706967,145111416,0,0,1,62464,10,480060337
3162,74406490,71267414,145673904,2,0,1,241664,4,10624231975
3163,74424859,71334136,145758995,0,0,1,63488,10,5423682228
3164,74426150,27953579,102379729,3,0,0,157184,3,5035150775
3165,74466759,71394777,145861536,0,0,1,92160,10,5559397693
3166,74478789,27352592,101831381,5,0,0,53760,11,2579904616
3167,74536610,28326497,102863107,3,0,0,317952,3,7322357335
3168,74580220,27592520,102172740,3,0,0,81920,3,10649401179
3169,74620959,71266096,145887055,0,0,1,6656,10,3053221211
3170,74638060,28277709,102915769,4,0,0,10752,2,8502873327
3171,74647180,27573691,102220871,4,0,0,133120,2,8736383776
3172,74654050,27603478,102257528,1,0,0,30720,5,5838833132
3173,74725130,27422627,102147757,4,0,0,34816,2,5362313347
3174,74725159,28397110,103122269,5,0,0,29184,11,2635200347
3175,74732049,71177415,145909464,0,0,1,18432,10,4345498030
3176,74762390,27869493,102631883,9,0,0,62976,17,4915258943
3177,74816680,28645591,103462271,9,0,0,433152,17,2106203426
3178,74923359,71120768,146044127,0,0,1,2560,10,7992772661
3179,74927431,27721947,102649378,2,0,0,57344,4,1049831229
3180,74946020,27963910,102909930,9,0,0,153600,17,5158012039
3181,74951650,27380164,102331814,1,0,0,11264,5,6601241359
3182,74952559,71091591,146044150,0,0,1,3072,10,3784366800
3183,74954669,71089504,146044173,0,0,1,22016,10,1367761677
3184,74987570,27625102,102612672,3,0,0,29184,3,5425375454
3185,74990531,71053665,146044196,6,0,1,11776,7,9074570686
3186,75010180,28595377,103605557,3,0,0,191488,3,8121682284
3187,75055969,70988250,146044219,0,0,1,36352,10,8199023630
3188,75060640,28108843,103169483,3,0,0,55808,3,5046251931
3189,75062640,28701803,103764443,1,0,0,132096,5,10005037882
3190,75093130,28828448,103921578,9,0,0,168960,17,79637787
3191,75121201,70923041,146044242,6,0,1,15360,7,2651463318
3192,75127990,29088194,104216184,4,0,0,423936,2,2321008001
3193,75131290,27879691,103010981,9,0,0,49664,17,3401441577
3194,75169991,29250525,104420516,2,0,0,327168,4,878557653
3195,75211481,70832784,146044265,6,0,1,2048,7,6625629497
3196,75241680,28707377,103949057,4,0,0,90112,2,26281724
3197,75266090,29606576,104872666,9,0,0,802816,17,4918330339
3198,75280581,70763707,146044288,6,0,1,5120,7,1408714673
3199,75366421,70677890,146044311,6,0,1,29696,7,7049391554
3200,75376721,28167474,103544195,2,0,0,58368,4,6291694228
3201,75415411,70763110,146178521,6,0,1,13824,7,8609958306
3202,75426800,70770331,146197131,8,0,1,21504,2,2945512495
3203,75478741,29703498,105182239,2,0,0,186880,4,3403557438
3204,75521660,29581909,105103569,1,0,0,757760,5,5019092420
3205,75536950,29737352,105274302,3,0,0,302080,3,1734625560
3206,75557569,29070466,104628035,5,0,0,283648,11,213278595
3207,75575180,29801013,105376193,1,0,0,334336,5,10191371540
3208,75588920,29883594,105472514,4,0,0,157696,2,7830341842
3209,75596990,29528286,105125276,4,0,0,71168,2,7616419514
3210,75619851,70577303,146197154,6,0,1,6144,7,2123102117
3211,75659321,70537856,146197177,6,0,1,16384,7,1999225306
3212,75665140,28288776,103953916,3,0,0,15872,3,8034932742
3213,75693931,70503269,146197200,6,0,1,7168,7,7551883992
3214,75746880,29677540,105424420,4,0,0,158208,2,5699464388
3215,75840550,29651533,105492083,1,0,0,64000,5,9941634999
3216,75889911,70307312,146197223,6,0,1,15872,7,2331997092
3217,75914839,29702878,105617717,5,0,0,349696,11,2442715938
3218,75939140,29701532,105640672,3,0,0,75264,3,2889584700
3219,75939979,70266026,146206005,0,0,1,16384,10,2059033756
3220,76005451,70200577,146206028,6,0,1,4096,7,11959998
3221,76021081,70184970,146206051,6,0,1,15872,7,6474058786
3222,76069510,29441636,105511146,4,0,0,62464,2,6008469923
3223,76113480,29559132,105672612,3,0,0,104448,3,3859565463
3224,76184579,29570095,105754674,5,0,0,150528,11,10010598161
3225,76220110,29615091,105835201,1,0,0,264192,5,247483873
3226,76220570,69985512,146206082,3,0,1,9728,3,6095959251
3227,76235981,29472713,105708694,2,0,0,118272,4,1563349211
3228,76237710,29641658,105879368,1,0,0,65024,5,10716742542
3229,76296500,69909605,146206105,3,0,1,1536,3,5085194742
3230,76320001,70011759,146331760,6,0,1,37376,7,5632520028
3231,76397181,69934602,146331783,6,0,1,4096,7,1397708445
3232,76404091,69927715,146331806,6,0,1,16384,7,9550895651
3233,76414141,29696487,106110628,2,0,0,105472,4,1843808341
3234,76422531,69966628,146389159,6,0,1,79872,7,8348742713
3235,76435251,29788837,106224088,2,0,0,58880,4,3430082027
3236,76466650,69922540,146389190,3,0,1,8192,3,3653775880
3237,76474569,29644974,106119543,5,0,0,29184,11,887244429
3238,76557401,69831812,146389213,6,0,1,13824,7,9647082410
3239,76602569,30012240,106614809,5,0,0,206848,11,5226535279
3240,76707490,29552365,106259855,3,0,0,97792,3,446566709
3241,76771510,29625013,106396523,1,0,0,46080,5,5293136541
3242,76855880,29222589,106078469,3,0,0,108544,3,5075867435
3243,76893100,29590673,106483773,4,0,0,217600,2,4301099136
3244,76895631,29887472,106783103,2,0,0,130560,4,2477329860
3245,77036110,29493862,106529972,1,0,0,151552,5,2921753189
3246,77078001,69311235,146389236,6,0,1,3584,7,4372800085
3247,77112060,29892630,107004690,3,0,0,222720,3,7588462308
3248,77156641,30001079,107157720,2,0,0,93696,4,10165668306
3249,77167631,29663925,106831556,2,0,0,88576,4,6975031827
3250,77195160,29222290,106417450,4,0,0,68608,2,187187656
3251,77273679,29789719,107063398,5,0,0,129024,11,8975613706
3252,77277861,69111398,146389259,6,0,1,1024,7,4304408923
3253,77362240,29733726,107095966,1,0,0,56832,5,6376832182
3254,77376220,29367080,106743300,4,0,0,155648,2,8972737922
3255,77383479,29680254,107063733,5,0,0,1024,11,4123000525
3256,77392640,30004451,107397091,3,0,0,270336,3,3772800397
3257,77481290,30006460,107487750,3,0,0,150016,3,5120642143
3258,77534750,29625489,107160239,4,0,0,8192,2,3779476208
3259,77588750,68840182,146428932,3,0,1,25088,3,1346013692
3260,77601291,30051211,107652502,2,0,0,248832,4,3378111340
3261,77640311,30064710,107705021,2,0,0,30720,4,4037329134
3262,77651240,68893218,146544458,3,0,1,17920,3,3025141678
3263,77722090,29853557,107575647,4,0,0,199680,2,463892683
3264,77722960,29545920,107268880,1,0,0,73728,5,3477486157
3265,77723170,68923175,146646345,7,0,1,55296,16,5226500269
3266,77738530,30120169,107858699,1,0,0,236544,5,4076758249
3267,77738550,29766695,107505245,4,0,0,57344,2,6677476194
3268,77754230,30026517,107780747,4,0,0,219136,2,6935494453
3269,77763171,68892381,146655552,6,0,1,1536,7,4397447630
3270,77771739,30118183,107889922,5,0,0,102400,11,3598076970
3271,77815030,68929553,146744583,2,0,1,88576,4,4931004740
3272,77822161,68935260,146757421,6,0,1,19968,7,8477359879
3273,77835409,30323248,108158657,5,0,0,110080,11,10716593450
3274,77840720,69189442,147030162,3,0,1,36864,3,7717809686
3275,77908090,29606694,107514784,4,0,0,31232,2,5189174401
3276,77910889,30892723,108803612,5,0,0,217088,11,8032489639
3277,77939550,30557201,108496751,3,0,0,664064,3,2968975154
3278,77940110,30100405,108040515,3,0,0,60416,3,3283462295
3279,77944391,69107882,147052273,6,0,1,3584,7,10576833634
3280,77963840,69116933,147080773,3,0,1,8704,3,5982832323
3281,77976400,30573905,108550305,4,0,0,50688,2,5111040908
3282,78013900,30991400,109005300,3,0,0,13312,3,4261068462
3283,78021450,31156493,109177943,3,0,0,39936,3,3987343773
3284,78039980,69045299,147085279,3,0,1,7168,3,2769966647
3285,78049670,69127753,147177423,3,0,1,7168,3,6331243751
3286,78060061,30474777,108534838,2,0,0,124928,4,7839474309
3287,78073911,30149880,108223791,2,0,0,8704,4,10097141327
3288,78074671,31388236,109462907,2,0,0,253952,4,6302057028
3289,78126571,31244254,109370825,2,0,0,179712,4,115955619
3290,78128450,30482437,108610887,3,0,0,75264,3,2200827773
3291,78131340,69140068,147271408,3,0,1,38400,3,6028776132
3292,78184310,69108360,147292670,7,0,1,15872,16,3032445927
3293,78185561,30443133,108628694,2,0,0,58368,4,4207875116
3294,78283870,69073194,147357064,3,0,1,46592,3,5688563429
3295,78327450,69030382,147357832,7,0,1,11776,16,356986595
3296,78342890,69028276,147371166,3,0,1,23040,3,3668876974
3297,78358471,69014321,147372792,6,0,1,2560,7,5353379993
3298,78365970,69008768,147374738,3,0,1,3072,3,5007461561
3299,78378230,69033749,147411979,5,0,1,15360,11,8890693288
3300,78378421,69306658,147685079,6,0,1,19968,7,3558414792
3301,78390600,30833050,109223650,3,0,0,2560,3,3358046618
3302,78415190,31218488,109633678,9,0,0,270848,17,10675496230
3303,78428849,30604352,109033201,5,0,0,7168,11,4948948548
3304,78444120,69244390,147688510,7,0,1,6656,16,4709002006
3305,78499409,31143831,109643240,5,0,0,31232,11,3719254852
3306,78548470,69509755,148058225,2,0,1,108544,4,5066822238
3307,78565330,70103788,148669118,2,0,1,77824,4,7063674897
3308,78566440,70102701,148669141,2,0,1,26112,4,6065849501
3309,78575040,70169050,148744090,3,0,1,36864,3,2679113257
3310,78611090,30940041,109551131,9,0,0,134656,17,7748474008
3311,78645520,70159627,148805147,2,0,1,356352,4,2806945988
3312,78649039,70161254,148810293,4,0,1,8192,2,1453442500
3313,78650511,31236267,109886778,2,0,0,60928,4,4415793607
3314,78673710,70611404,149285114,2,0,1,174592,4,5742444215
3315,78700130,30991869,109691999,9,0,0,25600,17,6374971076
3316,78740460,71655878,150396338,2,0,1,645120,4,6868713232
3317,78742610,30976861,109719471,4,0,0,56320,2,10362481498
3318,78770520,31025147,109795667,9,0,0,132608,17,10683819496
3319,78824810,71644914,150469724,3,0,1,9728,3,1456484586
3320,78829020,31447770,110276790,1,0,0,337408,5,9681232009
3321,78868420,31090286,109958706,3,0,0,135680,3,6573086547
3322,78937051,31158219,110095270,2,0,0,73216,4,1558614900
3323,78949440,71520307,150469747,7,0,1,14848,16,347863103
3324,78972890,31377838,110350728,9,0,0,79872,17,8306108498
3325,78978899,30929362,109908261,5,0,0,19456,11,10082730858
3326,78993020,31717545,110710565,3,0,0,238592,3,5675785318
3327,78998250,71471520,150469770,3,0,1,16384,3,1398088343
3328,79005050,31299071,110304121,4,0,0,89600,2,10248687074
3329,79020630,71449163,150469793,3,0,1,10240,3,7149866782
3330,79046720,31325871,110372591,1,0,0,71680,5,8515004696
3331,79052010,72175052,151227062,2,0,1,664064,4,9096806059
3332,79073429,72162872,151236301,4,0,1,3584,2,5924005906
3333,79080400,72156887,151237287,7,0,1,1536,16,6065522352
3334,79116401,31521445,110637846,2,0,0,310272,4,8416914548
3335,79135070,32216314,111351384,9,0,0,699904,17,7437823278
3336,79137429,72103084,151240513,4,0,1,5120,2,2613370674
3337,79141919,72109621,151251540,4,0,1,15360,2,1271002751
3338,79172670,72101135,151273805,7,0,1,35328,16,9325432796
3339,79177790,72099881,151277671,2,0,1,6144,4,8586903742
3340,79205950,73283916,152489866,2,0,1,751104,4,4732006701
3341,79207810,73282079,152489889,2,0,1,136704,4,10216265817
3342,79214870,73278044,152492914,7,0,1,6144,16,7206359137
3343,79254859,73278728,152533587,4,0,1,65024,2,6859965361
3344,79292530,31748968,111041498,4,0,0,117760,2,10028804750
3345,79304629,32173363,111477992,5,0,0,403968,11,6371914018
3346,79394429,73143492,152537921,4,0,1,3584,2,2914333793
3347,79412740,32124399,111537139,3,0,0,194048,3,5113199385
3348,79438560,31916325,111354885,3,0,0,9728,3,10256663205
3349,79519901,31831997,111351898,2,0,0,1536,4,9786799153
3350,79553450,72985777,152539227,7,0,1,2048,16,6102265022
3351,79555860,32044690,111600550,4,0,0,106496,2,4213390434
3352,79592330,72969957,152562287,7,0,1,14336,16,4801622154
3353,79595669,72967694,152563363,4,0,1,13312,2,1672868928
3354,79613839,72953710,152567549,4,0,1,6656,2,3115185825
3355,79625360,31933446,111558806,3,0,0,70656,3,3330067922
3356,79631300,32209935,111841235,9,0,0,167424,17,8253079077
3357,79631649,72936566,152568215,4,0,1,1024,2,3329081049
3358,79649710,31978382,111628092,9,0,0,90112,17,1554454685
3359,79656570,72912951,152569521,7,0,1,2048,16,4765152147
3360,79656870,31911209,111568079,9,0,0,30208,17,7729014891
3361,79665470,72906637,152572107,2,0,1,4096,4,2339998248
3362,79669660,72946589,152616249,2,0,1,107008,4,8113502178
3363,79674560,32114227,111788787,1,0,0,75264,5,9655155858
3364,79689760,72954952,152644712,2,0,1,70656,4,5725611137
3365,79693919,72955619,152649538,4,0,1,7680,2,6291450466
3366,79788160,72889864,152678024,2,0,1,68608,4,1740572877
3367,79794220,32171221,111965441,3,0,0,58880,3,7211844689
3368,79855420,73428223,153283643,2,0,1,224256,4,1256555128
3369,79858050,31983699,111841749,9,0,0,1536,17,810389748
3370,79859949,73460829,153320778,0,0,1,30720,10,9079874334
3371,79877691,32177150,112054841,2,0,0,190976,4,9541051982
3372,79904980,32336787,112241767,1,0,0,72192,5,852440376
3373,79921299,73456522,153377821,4,0,1,23040,2,6213420759
3374,79961850,32779165,112741015,3,0,0,550912,3,9054861825
3375,79974821,73407059,153381880,9,0,1,15360,17,393659622
3376,79992120,73392346,153384466,7,0,1,4096,16,5159475568
3377,80044439,73386520,153430959,4,0,1,55808,2,3012903474
3378,80075779,73539094,153614873,0,0,1,27136,10,3379106463
3379,80106090,32309420,112415510,1,0,0,90624,5,7176986692
3380,80124150,73782970,153907120,2,0,1,224256,4,3705182115
3381,80174909,32244560,112419469,5,0,0,11264,11,2450373203
3382,80184689,73722454,153907143,4,0,1,19456,2,9395761073
3383,80186640,73867733,154054373,7,0,1,45056,16,4002566967
3384,80204269,74020556,154224825,4,0,1,50688,2,2000651291
3385,80207749,74017099,154224848,4,0,1,9216,2,7303689271
3386,80209619,74015252,154224871,0,0,1,10752,10,7826548339
3387,80233620,74328701,154562321,2,0,1,442368,4,943533142
3388,80296239,74266105,154562344,0,0,1,16896,10,5006348007
3389,80350401,31983480,112333881,2,0,0,55296,4,407327698
3390,80375789,74186578,154562367,0,0,1,14336,10,1266780917
3391,80400650,32390579,112791229,0,0,0,164352,10,3745426077
3392,80431349,74131041,154562390,0,0,1,9728,10,10419208899
3393,80438541,74123872,154562413,9,0,1,34304,17,4535015874
3394,80476379,74203704,154680083,0,0,1,53248,10,7069224062
3395,80480890,74304274,154785164,2,0,1,122880,4,10148618946
3396,80508879,32491810,113000689,5,0,0,234496,11,7066442562
3397,80509389,74275798,154785187,0,0,1,8704,10,3634583611
3398,80539331,74245895,154785226,9,0,1,33792,17,9576762416
3399,80543410,32256266,112799676,1,0,0,27648,5,5486953493
3400,80557560,74273264,154830824,2,0,1,118272,4,8815007143
3401,80562499,74268348,154830847,0,0,1,56832,10,1391057372
3402,80567610,32643065,113210675,0,0,0,67072,10,10024612063
3403,80572420,32556130,113128550,1,0,0,327168,5,2854409273
3404,80625540,32564676,113190216,1,0,0,130048,5,3446730687
3405,80640369,74190525,154830894,4,0,1,55296,2,2606353005
3406,80659370,32491199,113150569,0,0,0,72192,10,9687838467
3407,80663779,74167138,154830917,4,0,1,17920,2,3761331441
3408,80686660,32533866,113220526,4,0,0,32256,2,8966089146
3409,80709689,74136196,154845885,0,0,1,33280,10,7450711265
3410,80716460,33728926,114445386,4,0,0,363008,2,1810517843
3411,80722370,33241247,113963617,3,0,0,585216,3,6247716485
3412,80726789,32660063,113386852,5,0,0,134144,11,4688970532
3413,80734591,74133777,154868368,9,0,1,47616,17,10298821506
3414,80744700,32671966,113416666,9,0,0,74752,17,10972829
3415,80750359,74121235,154871594,0,0,1,5120,10,8297583840
3416,80820910,33179702,114000612,9,0,0,121344,17,2180554027
3417,80825481,33320566,114146047,2,0,0,305664,4,7129722307
3418,80860361,74043034,154903395,6,0,1,11264,7,1797428952
3419,80862161,32769683,113631844,2,0,0,53760,4,7399089519
3420,80892491,74011250,154903741,9,0,1,512,17,3449903868
3421,80903511,32580004,113483515,2,0,0,4608,4,8081284734
3422,80914480,33115171,114029651,4,0,0,95232,2,4590306310
3423,80915990,32797705,113713695,3,0,0,53248,3,5656982515
3424,80956271,73947931,154904202,9,0,1,10240,17,6327152351
3425,80967551,73942143,154909694,9,0,1,17920,17,7507225781
3426,80987150,33064060,114051210,9,0,0,70656,17,2443646861
3427,80996529,33485914,114482443,5,0,0,98304,11,4463261073
3428,81058640,33276027,114334667,3,0,0,453632,3,4079742421
3429,81080080,33372349,114452429,1,0,0,23040,5,5729857400
3430,81088079,73838719,154926798,4,0,1,56832,2,8204792477
3431,81121531,33415604,114537135,2,0,0,97280,4,2132256310
3432,81144071,73784993,154929064,6,0,1,3584,7,7676433461
3433,81145700,32626323,113772023,4,0,0,12288,2,4191307054
3434,81146591,73789604,154936195,6,0,1,31744,7,8452805242
3435,81173360,33477358,114650718,0,0,0,328192,10,123543171
3436,81179480,73836185,155015665,2,0,1,113664,4,1663012209
3437,81208931,73827446,155036377,6,0,1,22528,7,6430189688
3438,81242251,33265221,114507472,2,0,0,81920,4,3929807573
3439,81245550,33439862,114685412,4,0,0,75776,2,2106796646
3440,81257409,73805349,155062758,4,0,1,40960,2,10526394355
3441,81267239,33283436,114550675,5,0,0,44032,11,9152992874
3442,81287211,33608385,114895596,2,0,0,108544,4,9183416589
3443,81291041,74708193,155999234,9,0,1,15872,17,626845764
3444,81315999,74683258,155999257,0,0,1,9216,10,2153555478
3445,81326900,33365711,114692611,3,0,0,23552,3,6861135284
3446,81353690,74645590,155999280,2,0,1,14336,4,6064893519
3447,81360820,33771651,115132471,0,0,0,256512,10,8660519838
3448,81403159,33459342,114862501,5,0,0,88576,11,2398738568
3449,81417041,74582262,155999303,9,0,1,13312,17,8986853463
3450,81457089,74542245,155999334,0,0,1,39424,10,4954173411
3451,81458300,33595992,115054292,3,0,0,144896,3,1727615110
3452,81465529,33999938,115465467,5,0,0,303616,11,2032498468
3453,81478361,74529753,156008114,9,0,1,512,17,10709583045
3454,81496179,74576676,156072855,0,0,1,13824,10,2779192270
3455,81524731,74551990,156076721,9,0,1,6144,17,10688767491
3456,81539971,74538338,156078309,6,0,1,15872,7,462372795
3457,81558410,33997629,115556039,1,0,0,296960,5,4083979924
3458,81571930,33684772,115256702,3,0,0,97280,3,623169821
3459,81576440,74526542,156102982,5,0,1,34304,11,5293918235
3460,81581600,74995373,156576973,2,0,1,114176,4,8126048345
3461,81596831,75075550,156672381,9,0,1,52224,17,5838369111
3462,81604059,34026756,115630815,5,0,0,99840,11,7622521535
3463,81632140,33924874,115557014,9,0,0,3072,17,142379007
3464,81632670,75048672,156681342,2,0,1,80896,4,5241579175
3465,81654609,75099483,156754092,0,0,1,67584,10,6961103884
3466,81680069,75087017,156767086,0,0,1,14336,10,1946691338
3467,81718290,34055824,115774114,3,0,0,296960,3,9666588161
3468,81741110,34260257,116001367,0,0,0,575488,10,5529687037
3469,81762621,75004488,156767109,9,0,1,21504,17,3813750879
3470,81782570,74984562,156767132,5,0,1,512,11,6067878763
3471,81792010,34016782,115808792,9,0,0,109056,17,4698013900
3472,81804160,34295598,116099758,9,0,0,46080,17,10143702797
3473,81821899,33953642,115775541,5,0,0,4608,11,326678921
3474,81832731,74934432,156767163,9,0,1,50688,17,4686090307
3475,81845971,33972048,115818019,2,0,0,30208,4,27328851
3476,81855651,74911543,156767194,9,0,1,2048,17,2087448193
3477,81855931,74911286,156767217,9,0,1,3072,17,3200172008
3478,81876171,74891069,156767240,9,0,1,24576,17,6115565816
3479,81878810,74981203,156860013,2,0,1,175616,4,3932377211
3480,81926089,34109933,116036022,5,0,0,113664,11,4007804570
3481,81934719,34268073,116202792,5,0,0,66048,11,8872515301
3482,81935001,74925035,156860036,9,0,1,8704,17,3996918437
3483,81937201,74922858,156860059,9,0,1,3584,17,5413448523
3484,81973790,34598627,116572417,3,0,0,292352,3,5530845094
3485,81977721,34204924,116182645,2,0,0,99840,4,10718001241
3486,81983201,74876889,156860090,9,0,1,22528,17,4859038555
3487,82023439,34062256,116085695,5,0,0,141312,11,2678483104
3488,82028830,34320943,116349773,1,0,0,32768,5,8610459448
3489,82068020,34306388,116374408,3,0,0,52224,3,2111745778
3490,82093040,34118823,116211863,1,0,0,29696,5,8853265537
3491,82118300,34832597,116950897,0,0,0,322048,10,10306424604
3492,82123501,74736636,156860137,6,0,1,27136,7,5164768726
3493,82127090,34449406,116576496,1,0,0,13312,5,3370090872
3494,82169200,34409705,116578905,3,0,0,7680,3,4213055455
3495,82193270,34885046,117078316,1,0,0,130560,5,7705362108
3496,82239529,34798938,117038467,5,0,0,247808,11,578569499
3497,82258190,74601970,156860160,5,0,1,1024,11,6690521539
3498,82287340,74572843,156860183,5,0,1,1536,11,5134227749
3499,82308340,74551866,156860206,3,0,1,17408,3,4589386236
3500,82338271,34624661,116962932,2,0,0,39424,4,1293795284
3501,82347109,34774621,117121730,5,0,0,142336,11,7819279380
3502,82365680,74494549,156860229,2,0,1,41472,4,3463770797
3503,82387370,34464709,116852079,1,0,0,56832,5,3155151203
3504,82404170,74456082,156860252,5,0,1,99328,11,9214011600
3505,82430230,34756747,117186977,0,0,0,214016,10,2514356170
3506,82439010,75600292,158039302,2,0,1,916480,4,5757066293
3507,82445071,75600959,158046030,6,0,1,5120,7,1330480999
3508,82462580,35622799,118085379,3,0,0,775680,3,518499052
3509,82483210,36013038,118496248,9,0,0,461824,17,10457396141
3510,82532120,34851382,117383502,9,0,0,187392,17,3031231798
3511,82534620,34934715,117469335,9,0,0,177664,17,1175286439
3512,82544241,75505335,158049576,6,0,1,5632,7,7278228949
3513,82563320,35973920,118537240,9,0,0,133632,17,9689232068
3514,82585861,75465661,158051522,9,0,1,3072,17,10303788266
3515,82627820,35988807,118616627,1,0,0,62464,5,3390166389
3516,82642851,75418158,158061009,9,0,1,34816,17,6186421811
3517,82643540,35711950,118355490,1,0,0,380416,5,7427317579
3518,82650919,35539003,118189922,5,0,0,343040,11,3869444794
3519,82654519,34909241,117563760,5,0,0,67072,11,4688569053
3520,82688521,75392480,158081001,6,0,1,7680,7,77379369
3521,82710370,75505560,158215930,2,0,1,280576,4,9847492191
3522,82761341,75456855,158218196,9,0,1,3584,17,3471300359
3523,82776809,36113050,118889859,5,0,0,244736,11,6651846864
3524,82784520,35448087,118232607,4,0,0,15872,2,1187438589
3525,82859980,35334824,118194804,1,0,0,15872,5,4653403694
3526,82862400,35952868,118815268,3,0,0,12800,3,177853184
3527,82864759,35946586,118811345,5,0,0,398336,11,8501294194
3528,82884161,75337275,158221436,9,0,1,2048,17,4496535825
3529,82965110,35943648,118908758,1,0,0,61952,5,3069432741
3530,82977451,75250091,158227542,6,0,1,20992,7,9220163315
3531,82979281,75259049,158238330,6,0,1,14848,7,4202185430
3532,83004981,75243987,158248968,9,0,1,26112,17,570751389
3533,83031599,35902002,118933601,5,0,0,81408,11,7181227866
3534,83042361,36160391,119202752,2,0,0,443904,4,56270182
3535,83052559,36202834,119255393,5,0,0,74240,11,5415245493
3536,83099230,35498342,118597572,1,0,0,112128,5,5685601030
3537,83114729,36733254,119847983,5,0,0,654336,11,7081809676
3538,83134771,75118131,158252902,6,0,1,3584,7,6777992194
3539,83151100,36164711,119315811,9,0,0,126464,17,9883588191
3540,83276670,36652525,119929195,9,0,0,43008,17,649570457
3541,83282510,36073269,119355779,1,0,0,79360,5,10484297453
3542,83284570,35992686,119277256,3,0,0,71680,3,9077030716
3543,83286090,36629978,119916068,4,0,0,35328,2,6799365834
3544,83304001,36874354,120178355,2,0,0,536576,4,9824268224
3545,83316630,36588160,119904790,4,0,0,186368,2,7678787961
3546,83327160,36078642,119405802,9,0,0,137728,17,5639441163
3547,83351030,36847495,120198525,1,0,0,66048,5,7336223090
3548,83392630,36929643,120322273,3,0,0,36352,3,4433094696
3549,83424399,35799124,119223523,5,0,0,68096,11,2727643664
3550,83452640,36836921,120289561,0,0,0,224256,10,6212052940
3551,83485710,35747040,119232750,0,0,0,30208,10,1688082486
3552,83495529,36139777,119635306,5,0,0,11776,11,3111713519
3553,83521890,36699320,120221210,0,0,0,49152,10,4760260942
3554,83529741,36917831,120447572,2,0,0,86016,4,5555607240
3555,83551230,36354051,119905281,0,0,0,1536,10,9033596684
3556,83584151,74674652,158258803,6,0,1,19968,7,5432502416
3557,83605570,37142992,120748562,4,0,0,523264,2,8655132000
3558,83636220,36830251,120466471,4,0,0,61952,2,9100439872
3559,83646041,74627499,158273540,6,0,1,42496,7,2671362243
3560,83676011,74616555,158292566,6,0,1,22016,7,1831868401
3561,83678470,36526942,120205412,3,0,0,22528,3,457478674
3562,83682061,74615997,158298058,6,0,1,8704,7,8219099439
3563,83688500,74827286,158515786,8,0,1,27648,2,6493419920
3564,83731440,36659601,120391041,3,0,0,19456,3,8243940243
3565,83819120,36952443,120771563,0,0,0,16384,10,8180481610
3566,83859780,37078289,120938069,0,0,0,510976,10,6450228218
3567,83874561,74641248,158515809,6,0,1,2048,7,9523466967
3568,83906631,74609201,158515832,6,0,1,6656,7,450162676
3569,83915431,74600424,158515855,6,0,1,59392,7,4352297362
3570,83931790,37275160,121206950,9,0,0,35840,17,1569308837
3571,83935580,74580338,158515918,2,0,1,1024,4,396309311
3572,84003820,37347214,121351034,9,0,0,177152,17,10371227762
3573,84020389,37037378,121057767,5,0,0,284672,11,7995888195
3574,84030840,74485101,158515941,8,0,1,16384,2,7947028291
3575,84050260,36732090,120782350,3,0,0,35328,3,6834826957
3576,84058330,36912678,120971008,4,0,0,108032,2,2269039104
3577,84095470,36662163,120757633,9,0,0,29696,17,5030406713
3578,84144440,37313808,121458248,4,0,0,104448,2,8351261770
3579,84182479,37013505,121195984,5,0,0,220672,11,7520831897
3580,84200790,37479296,121680086,3,0,0,302080,3,9519917684
3581,84201121,74343726,158544847,6,0,1,91136,7,6972744557
3582,84210420,37777788,121988208,3,0,0,5120,3,6732114902
3583,84218599,36840439,121059038,5,0,0,4096,11,2058103673
3584,84225040,37693195,121918235,1,0,0,359424,5,4254949550
3585,84327200,38420102,122747302,1,0,0,766976,5,6592856988
3586,84351240,36415308,120766548,4,0,0,29184,2,1275970022
3587,84362260,37390543,121752803,4,0,0,51712,2,9025889833
3588,84382440,74162430,158544870,8,0,1,22016,2,1287204637
3589,84391030,37595579,121986609,9,0,0,224256,17,5828772612
3590,84399850,37408850,121808700,4,0,0,107520,2,1558206389
3591,84404670,74188450,158593120,8,0,1,39424,2,1803881969
3592,84423309,38453854,122877163,5,0,0,228864,11,5883445681
3593,84425450,74167693,158593143,8,0,1,1536,2,2442151985
3594,84436120,37974464,122410584,3,0,0,113664,3,4201927640
3595,84473069,37786262,122259331,5,0,0,179200,11,10218716870
3596,84550600,37569693,122120293,9,0,0,278528,17,1915095542
3597,84575419,37850632,122426051,5,0,0,50688,11,2991491016
3598,84595721,38388169,122983890,2,0,0,350208,4,7967373511
3599,84602110,37840420,122442530,3,0,0,38400,3,1985643371
3600,84604640,38190265,122794905,1,0,0,156160,5,3771026312
3601,84623580,37752349,122375929,9,0,0,92672,17,2750571108
3602,84648130,73945036,158593166,8,0,1,14336,2,170500241
3603,84736110,38269689,123005799,0,0,0,6656,10,5906296078
3604,84813991,73779198,158593189,6,0,1,61952,7,8105079867
3605,84832041,38171707,123003748,2,0,0,65024,4,6441510850
3606,84833401,38351413,123184814,2,0,0,119808,4,7991544386
3607,84853219,38242405,123095624,5,0,0,159232,11,9056310212
3608,84860799,37946609,122807408,5,0,0,40960,11,2520440525
3609,84865069,38504465,123369534,5,0,0,339968,11,9169524815
3610,84869150,74874383,159743533,5,0,1,53760,11,5916989979
3611,84927530,74883465,159810995,8,0,1,48640,2,10215242017
3612,84966550,38299377,123265927,4,0,0,64000,2,9196287748
3613,84971350,38547418,123518768,0,0,0,204800,10,6057115221
3614,84973139,39100948,124074087,5,0,0,266752,11,5403731304
3615,84989049,39343719,124332768,5,0,0,318464,11,8610208537
3616,85035220,75033237,160068457,8,0,1,45568,2,8831647306
3617,85076499,38558711,123635210,5,0,0,36352,11,8898610334
3618,85092789,38591260,123684049,5,0,0,46592,11,7506617850
3619,85096650,74987765,160084415,8,0,1,20992,2,5031420194
3620,85106840,38041447,123148287,9,0,0,105984,17,2204783302
3621,85108930,37922896,123031826,4,0,0,78848,2,5685460785
3622,85138019,38286544,123424563,5,0,0,47616,11,3979766349
3623,85145860,38252089,123397949,3,0,0,93184,3,121006438
3624,85165670,39260798,124426468,9,0,0,115712,17,1130538120
3625,85167989,38378281,123546270,5,0,0,65024,11,2200859280
3626,85196980,38464601,123661581,1,0,0,43008,5,372868379
3627,85204821,38644626,123849447,2,0,0,103936,4,5232674535
3628,85218539,38380353,123598892,5,0,0,62464,11,4654467443
3629,85301470,39047389,124348859,3,0,0,52736,3,2827788605
3630,85303609,38246116,123549725,5,0,0,11264,11,1188357639
3631,85305790,38902756,124208546,9,0,0,427008,17,4318416730
3632,85307150,39280543,124587693,3,0,0,219648,3,4016013810
3633,85416149,38110286,123526435,5,0,0,25088,11,9697550928
3634,85430210,38525790,123956000,9,0,0,1536,17,5456059707
3635,85460670,39163082,124623752,4,0,0,118272,2,9878168119
3636,85469280,38894586,124363866,9,0,0,49152,17,9400328176
3637,85501090,38890099,124391189,0,0,0,89600,10,1456449002
3638,85507020,38728693,124235713,9,0,0,89088,17,3065768911
3639,85513870,38938361,124452231,4,0,0,84480,2,1387591313
3640,85521280,74563158,160084438,8,0,1,15360,2,10621386370
3641,85541820,74564036,160105856,8,0,1,27136,2,1090451569
3642,85588070,39187318,124775388,1,0,0,248320,5,754488992
3643,85645530,74460349,160105879,8,0,1,20480,2,6352989708
3644,85649189,38871557,124520746,5,0,0,224768,11,7615241599
3645,85675880,39241066,124916946,3,0,0,293376,3,3763238343
3646,85701350,38960263,124661613,9,0,0,51712,17,6277600281
3647,85751750,38887937,124639687,9,0,0,52224,17,5887001692
3648,85774950,39248862,125023812,3,0,0,33280,3,4052037171
3649,85778179,74327723,160105902,0,0,1,23040,10,1184528332
3650,85803399,38271179,124074578,5,0,0,1536,11,3879985592
3651,85816780,74309292,160126072,8,0,1,43520,2,2610604037
3652,85826731,39287162,125113893,2,0,0,25088,4,8499533459
3653,85925000,39178551,125103551,3,0,0,261632,3,2073098111
3654,85970850,39224111,125194961,1,0,0,102912,5,4432935445
3655,85994131,39443487,125437618,2,0,0,203776,4,7670125848
3656,85998001,39377506,125375507,2,0,0,306176,4,5488398847
3657,86098530,39487044,125585574,3,0,0,461824,3,8302874015
3658,86146100,39487568,125633668,0,0,0,87040,10,9446856670
3659,86150809,39083224,125234033,5,0,0,2048,11,6174782252
3660,86169371,39896675,126066046,2,0,0,57856,4,8515874360
3661,86280221,39447786,125728007,2,0,0,134144,4,6805694980
3662,86284710,73841385,160126095,8,0,1,4096,2,5641328460
3663,86288270,38861058,125149328,4,0,0,116224,2,5747420949
3664,86303529,73871192,160174721,4,0,1,61952,2,1421832594
3665,86348420,39258705,125607125,4,0,0,70656,2,152790202
3666,86384040,38872048,125256088,4,0,0,45568,2,1253131536
3667,86394019,73780725,160174744,4,0,1,12288,2,6392111419
3668,86398230,39359136,125757366,3,0,0,96256,3,8880143425
3669,86480400,39175911,125656311,4,0,0,74240,2,9550298006
3670,86498600,39745956,126244556,1,0,0,284160,5,1821073935
3671,86512680,40060196,126572876,3,0,0,285696,3,3113791897
3672,86531010,39413189,125944199,9,0,0,192000,17,7604369012
3673,86619531,73555236,160174767,9,0,1,4608,17,6602071734
3674,86675229,39286553,125961782,5,0,0,4608,11,1454287867
3675,86676750,39283605,125960355,4,0,0,37888,2,4509978891
3676,86679791,38426435,125106226,2,0,0,8704,4,3845049055
3677,86729449,38543662,125273111,5,0,0,8192,11,3135439642
3678,86730350,38956739,125687089,4,0,0,99840,2,2862389827
3679,86733700,39337985,126071685,0,0,0,18432,10,5178805804
3680,86746570,39301825,126048395,9,0,0,81920,17,4273754780
3681,86758341,40050617,126808958,2,0,0,343552,4,4737990440
3682,86777160,39100818,125877978,0,0,0,33280,10,3188330565
3683,86822730,39490152,126312882,3,0,0,41984,3,114190529
3684,86825379,38831267,125656646,5,0,0,1024,11,4743559985
3685,86864660,39578054,126442714,0,0,0,67072,10,6569855498
3686,86930550,39335580,126266130,9,0,0,70656,17,9519113045
3687,86946841,73227949,160174790,9,0,1,26624,17,301685795
3688,86961320,39186064,126147384,3,0,0,24064,3,1823660631
3689,86968161,73206668,160174829,9,0,1,17920,17,1673843384
3690,87011121,73163731,160174852,9,0,1,7680,17,7926874789
3691,87034329,39240477,126274806,5,0,0,2560,11,635462249
3692,87042940,40037179,127080119,1,0,0,100352,5,6705891818
3693,87043840,39609867,126653707,3,0,0,265216,3,9303251760
3694,87052709,38892137,125944846,5,0,0,2048,11,2992452220
3695,87059599,39384698,126444297,5,0,0,5120,11,4930493841
3696,87063899,39232707,126296606,5,0,0,5632,11,6277948730
3697,87083710,39965810,127049520,9,0,0,560640,17,1678566989
3698,87150620,39221742,126372362,1,0,0,12288,5,1254707256
3699,87155700,73019175,160174875,7,0,1,3072,16,7538375962
3700,87187050,40340449,127527499,4,0,0,497664,2,4154331109
3701,87224920,39914617,127139537,0,0,0,77824,10,2820108262
3702,87324401,72907679,160232080,9,0,1,61440,17,8824371973
3703,87343980,39901892,127245872,3,0,0,5120,3,10646991676
3704,87349540,39766083,127115623,9,0,0,16384,17,819746373
3705,87391901,39718684,127110585,2,0,0,97280,4,5217973669
3706,87426260,72806384,160232644,7,0,1,10752,16,4743428540
3707,87433660,40483664,127917324,1,0,0,330752,5,9445515534
3708,87448870,73198105,160646975,2,0,1,552960,4,5104988905
3709,87461941,41248624,128710565,2,0,0,323584,4,5484776278
3710,87514800,40074739,127589539,3,0,0,52224,3,6891493805
3711,87528940,40283483,127812423,9,0,0,475136,17,610765680
3712,87536670,73177922,160714592,7,0,1,17408,16,5928744887
3713,87552189,39528733,127080922,5,0,0,2560,11,3376860390
3714,87584970,73129645,160714615,2,0,1,78336,4,1772533370
3715,87646760,39926805,127573565,7,0,0,82432,16,2944598867
3716,87652540,40489438,128141978,9,0,0,50176,17,363878938
3717,87656719,39459083,127115802,5,0,0,512,11,1148989028
3718,87681030,40838910,128519940,3,0,0,128512,3,7095472197
3719,87750400,72964246,160714646,7,0,1,54784,16,7127696965
3720,87753190,39795236,127548426,4,0,0,68608,2,6479290468
3721,87773960,73654605,161428565,2,0,1,363520,4,7775276710
3722,87820851,73607737,161428588,9,0,1,17408,17,5417862725
3723,87822630,73620265,161442895,7,0,1,35840,16,3510369791
3724,87830800,40635563,128466363,4,0,0,459264,2,9200633506
3725,87831261,73645289,161476550,9,0,1,52736,17,7092110881
3726,87836139,40081520,127917659,5,0,0,1024,11,1774672587
3727,87852670,73628066,161480736,7,0,1,6656,16,498721520
3728,87855750,40995747,128851497,3,0,0,165376,3,8831921527
3729,87860131,39515713,127375844,2,0,0,109056,4,499237869
3730,87871270,39304037,127175307,4,0,0,21504,2,10083585457
3731,87898820,73921368,161820188,2,0,1,321536,4,2909340348
3732,87977441,73843413,161820854,9,0,1,11264,17,1437039417
3733,87977590,39947151,127924741,0,0,0,23040,10,8908006436
3734,87980440,39836085,127816525,9,0,0,13312,17,3667641586
3735,87981250,41028793,129010043,0,0,0,355840,10,8300658730
3736,88007609,39917623,127925232,5,0,0,1536,11,762677142
3737,88014090,39600116,127614206,7,0,0,25600,16,7013567473
3738,88016330,73940872,161957202,2,0,1,129536,4,6991135541
3739,88034250,40123507,128157757,9,0,0,51712,17,4079382422
3740,88042900,40232076,128274976,3,0,0,115200,3,5492563463
3741,88053291,73920608,161973899,9,0,1,1024,17,3448937978
3742,88076860,39876761,127953621,4,0,0,41472,2,3882724572
3743,88082980,74439629,162522609,2,0,1,837120,4,6056139911
3744,88091790,74441785,162533575,7,0,1,39936,16,7040088537
3745,88097791,40142062,128239853,2,0,0,73216,4,4326071937
3746,88115430,74418184,162533614,2,0,1,60928,4,9401449273
3747,88125451,40408092,128533543,2,0,0,44544,4,81929380
3748,88127690,41189859,129317549,7,0,0,202240,16,4983984979
3749,88161860,40318901,128480761,3,0,0,47104,3,2279875838
3750,88168170,40627888,128796058,7,0,0,34816,16,6664346841
3751,88211780,41250219,129461999,7,0,0,45056,16,6231440675
3752,88222990,40560941,128783931,7,0,0,240640,16,4116300342
3753,88224860,40355396,128580256,9,0,0,153088,17,6544378356
3754,88242770,40870284,129113054,9,0,0,295424,17,3700630339
3755,88247320,74319494,162566814,2,0,1,94208,4,9814857610
3756,88285001,74305901,162590902,9,0,1,27648,17,3012024193
3757,88306660,74295712,162602372,7,0,1,16896,16,9497558054
3758,88312000,74301471,162613471,7,0,1,36352,16,7824059462
3759,88392940,40755763,129148703,7,0,0,37376,16,5127823896
3760,88412359,40701902,129114261,5,0,0,1024,11,10460156153
3761,88455340,41391901,129847241,3,0,0,597504,3,10458737763
3762,88465850,74153113,162618963,7,0,1,26112,16,8118956550
3763,88499930,74318124,162818054,2,0,1,254976,4,5471140555
3764,88502130,40298956,128801086,9,0,0,5632,17,7573085095
3765,88571741,74253047,162824788,9,0,1,24064,17,607940225
3766,88578710,74247461,162826171,2,0,1,14848,4,4601701343
3767,88617130,74331866,162948996,3,0,1,26624,3,3143491347
3768,88626659,74324879,162951538,4,0,1,29184,2,9564697829
3769,88676100,40437803,129113903,9,0,0,2560,17,3590212337
3770,88695680,40323861,129019541,4,0,0,30720,2,1049159092
3771,88714860,74271084,162985944,2,0,1,181760,4,1933763952
3772,88732040,40426982,129159022,4,0,0,33792,2,3415346408
3773,88764959,40020399,128785358,5,0,0,4608,11,10214028079
3774,88790851,74208329,162999180,9,0,1,2560,17,6186131409
3775,88791480,74350779,163142259,2,0,1,194048,4,5111107363
3776,88806920,74875405,163682325,2,0,1,272384,4,10500143569
3777,88856401,74825947,163682348,9,0,1,8192,17,2057346043
3778,88869509,74812862,163682371,4,0,1,2560,2,5631590638
3779,88893320,40487383,129380703,4,0,0,156160,2,2210885070
3780,88893600,40220864,129114464,9,0,0,512,17,8204453494
3781,88896871,41382533,130279404,2,0,0,537600,4,448950985
3782,88922060,74760334,163682394,2,0,1,201728,4,5344311926
3783,88954440,40988879,129943319,4,0,0,93184,2,3893499416
3784,88965169,74717248,163682417,4,0,1,20480,2,4020215292
3785,88969689,40692861,129662550,5,0,0,3584,11,1406207725
3786,88973761,74708679,163682440,9,0,1,5632,17,8117892880
3787,88981690,40933214,129914904,7,0,0,70656,16,10681366784
3788,88982040,40598619,129580659,9,0,0,3584,17,1421315895
3789,89014830,40545543,129560373,7,0,0,155136,16,9021063910
3790,89027170,39995826,129022996,9,0,0,11264,17,5616540338
3791,89029861,40353205,129383066,2,0,0,7680,4,3714552000
3792,89037210,41477093,130514303,7,0,0,3584,16,6017311228
3793,89087520,40318449,129405969,9,0,0,1024,17,5861626144
3794,89099501,74582962,163682463,9,0,1,5632,17,6183091618
3795,89123400,41255266,130378666,7,0,0,253952,16,9686836467
3796,89173440,41441547,130614987,9,0,0,4096,17,1472223246
3797,89188830,41112437,130301267,1,0,0,71680,5,7515533446
3798,89222980,41213225,130436205,4,0,0,13312,2,5626169835
3799,89231650,40196306,129427956,9,0,0,1024,17,2889569771
3800,89247751,74434735,163682486,9,0,1,65536,17,1235728246
3801,89266400,40600832,129867232,3,0,0,65536,3,168130512
3802,89281589,74400920,163682509,1,0,1,11776,5,1572243989
3803,89287750,40605603,129893353,3,0,0,66560,3,1166588677
3804,89338840,40265109,129603949,9,0,0,512,17,9012503925
3805,89340860,41616063,130956923,7,0,0,247296,16,7835088987
3806,89363291,74322325,163685616,9,0,1,4608,17,7404235569
3807,89387830,40485197,129873027,3,0,0,18944,3,2864522333
3808,89444371,74257634,163702005,9,0,1,35328,17,9194245988
3809,89471190,41410362,130881552,4,0,0,220672,2,5165175914
3810,89475860,41037328,130513188,7,0,0,163328,16,876118563
3811,89514101,74191276,163705377,9,0,1,4608,17,2097689126
3812,89532891,40459622,129992513,2,0,0,40448,4,7947121291
3813,89586360,41504923,131091283,4,0,0,61440,2,10099617646
3814,89587940,41436866,131024806,7,0,0,222720,16,9755989183
3815,89676889,40838685,130515574,5,0,0,4096,11,9010862054
3816,89751281,41295856,131047137,2,0,0,73216,4,191839203
3817,89769031,73941492,163710523,9,0,1,8192,17,5083354069
3818,89806090,40964147,130770237,1,0,0,125952,5,4662821617
3819,89806650,40297131,130103781,1,0,0,7168,5,5374082660
3820,89884390,41187331,131071721,7,0,0,80384,16,9460864256
3821,89887971,41303379,131191350,2,0,0,148480,4,806259688
3822,89893241,73824054,163717295,9,0,1,10752,17,4672431379
3823,89893991,41640090,131534081,2,0,0,147456,4,4082123687
3824,89943760,41186086,131129846,1,0,0,11264,5,4909254547
3825,90032429,73685993,163718422,1,0,1,21504,5,4351514059
3826,90062219,73658514,163720733,4,0,1,2560,2,4119315986
3827,90132850,41166180,131299030,3,0,0,159744,3,5228082805
3828,90142540,40929984,131072524,9,0,0,2560,17,9487071851
3829,90144300,41344830,131489130,4,0,0,462336,2,2787769843
3830,90149341,73582298,163731639,9,0,1,16896,17,7220875020
3831,90150921,41607726,131758647,2,0,0,164864,4,9575428386
3832,90162920,41658949,131821869,1,0,0,78848,5,1566311698
3833,90171760,39797728,129969488,3,0,0,10752,3,7183601571
3834,90187559,73549828,163737387,1,0,1,27136,5,3110930907
3835,90233441,73522562,163756003,9,0,1,46592,17,7554288002
3836,90277569,73481020,163758589,4,0,1,4096,2,4924142879
3837,90307171,41827389,132134560,2,0,0,566784,4,7384304339
3838,90357380,41902182,132259562,4,0,0,406528,2,4732539342
3839,90379761,73406115,163785876,9,0,1,49664,17,7997485610
3840,90402491,73385331,163787822,9,0,1,3072,17,8757601873
3841,90415971,73391988,163807959,9,0,1,58880,17,4265397303
3842,90430130,41864438,132294568,9,0,0,4096,17,5194969613
3843,90451940,41939674,132391614,7,0,0,138240,16,6418518800
3844,90462191,42088030,132550221,2,0,0,257024,4,4038100691
3845,90529810,41004762,131534572,7,0,0,1536,16,4287097830
3846,90548450,42062501,132610951,7,0,0,36864,16,3883207950
3847,90550341,40797898,131348239,2,0,0,99328,4,3843524578
3848,90562831,42205423,132768254,2,0,0,117760,4,9292536762
3849,90565170,42167165,132732335,4,0,0,204800,2,4491801353
3850,90578060,42274693,132852753,1,0,0,32768,5,5282160434
3851,90599650,73289142,163888792,2,0,1,179712,4,6348672314
3852,90634810,41011090,131645900,9,0,0,4096,17,2292789478
3853,90644671,73248947,163893618,6,0,1,7680,7,3724114408
3854,90661080,73279439,163940519,2,0,1,78848,4,4265540055
3855,90664810,41934886,132599696,3,0,0,162304,3,9106159001
3856,90684400,41160915,131845315,1,0,0,60928,5,7030242080
3857,90722310,42376101,133098411,7,0,0,199680,16,209179925
3858,90744400,42372973,133117373,7,0,0,35840,16,3818265800
3859,90797890,42125835,132923725,9,0,0,5632,17,10046592583
3860,90798120,73143385,163941505,8,0,1,1536,2,5550954543
3861,90827770,73116864,163944634,8,0,1,15872,2,123498499
3862,90831230,42470924,133302154,4,0,0,117760,2,5941615230
3863,90845100,41987913,132833013,1,0,0,16384,5,7676250245
3864,90859701,73096494,163956195,9,0,1,36864,17,2239740759
3865,90899500,73064100,163963600,8,0,1,6656,2,7839661873
3866,90918770,73045176,163963946,8,0,1,512,2,8175493929
3867,90930850,41362447,132293297,3,0,0,110592,3,1027101336
3868,90944970,41724942,132669912,7,0,0,92672,16,4008316874
3869,90951640,42085908,133037548,7,0,0,115712,16,8861246848
3870,90955549,40871179,131826728,5,0,0,15872,11,4248506736
3871,90956330,40680610,131636940,4,0,0,71680,2,1866610482
3872,90957549,41380519,132338068,5,0,0,3072,11,2796939001
3873,90958280,73026538,163984818,2,0,1,23040,4,1872790594
3874,90981260,73091611,164072871,2,0,1,156160,4,278107908
3875,90988470,73126734,164115204,2,0,1,34816,4,2460694785
3876,90993179,41142496,132135675,5,0,0,3584,11,2890482082
3877,91015620,42250631,133266251,1,0,0,135168,5,10486215810
3878,91067060,42486053,133553113,4,0,0,477184,2,675913397
3879,91081030,73039679,164120709,7,0,1,17920,16,3714647055
3880,91094420,73423291,164517711,2,0,1,37888,4,6318210971
3881,91096229,41516469,132612698,5,0,0,5632,11,601466665
3882,91168201,42443479,133611680,2,0,0,191488,4,10439735398
3883,91180620,42852172,134032792,7,0,0,305664,16,2003903445
3884,91183300,73508897,164692197,2,0,1,95232,4,4917820154
3885,91200041,73532609,164732650,9,0,1,13312,17,10692764378
3886,91327110,73415590,164742700,7,0,1,28160,16,3221750370
3887,91332330,42774544,134106874,1,0,0,221184,5,3081638141
3888,91343251,73444220,164787471,9,0,1,5120,17,3808308871
3889,91349511,73539094,164888605,9,0,1,7168,17,9476950621
3890,91355789,73532855,164888644,4,0,1,15360,2,5953808740
3891,91368619,41261794,132630413,5,0,0,1024,11,4067438973
3892,91406940,73481727,164888667,8,0,1,28160,2,1634812956
3893,91421051,73467639,164888690,9,0,1,19456,17,5533941182
3894,91443619,73446942,164890561,0,0,1,54784,10,6811133226
3895,91483630,43053189,134536819,4,0,0,154112,2,8549021658
3896,91486720,41504282,132991002,3,0,0,92672,3,8949266035
3897,91488050,42881450,134369500,7,0,0,861696,16,22443128
3898,91506900,73389557,164896457,8,0,1,4608,2,9396045562
3899,91518709,41675598,133194307,5,0,0,3072,11,720031813
3900,91531899,73370516,164902415,4,0,1,24064,2,9168099560
3901,91569800,74007037,165576837,2,0,1,146432,4,8193566887
3902,91575589,74136245,165711834,1,0,1,56832,5,6029972892
3903,91586360,74139880,165726240,2,0,1,111616,4,3674317250
3904,91591110,74150074,165741184,8,0,1,5632,2,4112636956
3905,91617320,42058661,133675981,4,0,0,174080,2,9227873785
3906,91618211,74267172,165885383,9,0,1,74240,17,10389667726
3907,91640351,74245055,165885406,9,0,1,27136,17,7562100184
3908,91642271,42966592,134608863,2,0,0,90624,4,912271377
3909,91681400,74248223,165929623,2,0,1,23552,4,4085188236
3910,91683471,74253686,165937157,9,0,1,57856,17,427715939
3911,91713041,42326326,134039367,2,0,0,21504,4,9315760283
3912,91717930,74219266,165937196,8,0,1,7168,2,10527549874
3913,91757179,74180040,165937219,4,0,1,512,2,6331443162
3914,91830011,74107231,165937242,9,0,1,25600,17,2862712604
3915,91836010,74101255,165937265,8,0,1,4608,2,1068086689
3916,91839430,41772429,133611859,9,0,0,512,17,167190355
3917,91845860,74385219,166231079,2,0,1,142336,4,7645888475
3918,91865410,42818364,134683774,1,0,0,244736,5,9132932034
3919,91894089,74337013,166231102,4,0,1,23552,2,3859597385
3920,91917990,74396306,166314296,2,0,1,52224,4,9055653971
3921,91923669,74396913,166320582,1,0,1,2048,5,8767989760
3922,91946660,43154916,135101576,7,0,0,301568,16,3865277181
3923,91949640,42456308,134405948,1,0,0,94720,5,8581344995
3924,91963930,41821993,133785923,9,0,0,4096,17,3676565793
3925,91966080,41647096,133613176,9,0,0,2048,17,8756471709
3926,92031269,74289360,166320629,1,0,1,9216,5,6923555088
3927,92045680,41566826,133612506,9,0,0,2048,17,10664903802
3928,92052190,74268462,166320652,2,0,1,4096,4,3123940541
3929,92088069,74272565,166360634,1,0,1,60416,5,6813348463
3930,92089859,74270798,166360657,4,0,1,15872,2,5383796244
3931,92107150,74272353,166379503,2,0,1,57344,4,10629436004
3932,92113230,41567009,133680239,1,0,0,13824,5,2613690724
3933,92116590,41673078,133789668,9,0,0,5120,17,1514146450
3934,92133179,41618958,133752137,5,0,0,1536,11,6522213617
3935,92133430,74361079,166494509,2,0,1,43520,4,8312953290
3936,92148220,74387156,166535376,8,0,1,6144,2,4429110152
3937,92150759,74385283,166536042,4,0,1,1024,2,387497609
3938,92181210,42236617,134417827,4,0,0,38912,2,10359264801
3939,92281801,42188713,134470514,2,0,0,101376,4,3935382970
3940,92290149,74249439,166539588,1,0,1,5632,5,9951551643
3941,92291980,42906261,135198241,3,0,0,189952,3,7985807813
3942,92329711,42109823,134439534,2,0,0,71168,4,9667756911
3943,92336279,74205078,166541357,1,0,1,11776,5,2961688539
3944,92337649,74233134,166570783,1,0,1,37376,5,3490565766
3945,92341580,42035431,134377011,4,0,0,24576,2,1270075848
3946,92345419,74225387,166570806,1,0,1,11264,5,3659589570
3947,92357580,42251486,134609066,9,0,0,512,17,9789681450
3948,92364680,42347400,134712080,1,0,0,86016,5,6162650413
3949,92367909,42121931,134489840,5,0,0,512,11,1408889895
3950,92389590,42098731,134488321,7,0,0,58368,16,8426697758
3951,92421100,74261207,166682307,3,0,1,24064,3,8318649970
3952,92458970,42122235,134581205,9,0,0,1536,17,462058542
3953,92463009,42026583,134489592,5,0,0,4096,11,9040348997
3954,92475471,74206859,166682330,9,0,1,17408,17,9163321402
3955,92508340,74174013,166682353,3,0,1,3072,3,4560923047
3956,92524360,42056231,134580591,3,0,0,137728,3,8634176838
3957,92530301,74152075,166682376,9,0,1,10240,17,975361869
3958,92578180,74104219,166682399,8,0,1,9728,2,959949566
3959,92584400,74098022,166682422,8,0,1,11264,2,6483690085
3960,92588390,42922397,135510787,7,0,0,503808,16,9539591073
3961,92591591,74378746,166970337,6,0,1,61440,7,10683027927
3962,92592129,41946452,134538581,5,0,0,5632,11,6749811299
3963,92608140,74715748,167323888,3,0,1,35840,3,4179450758
3964,92658640,42351029,135009669,1,0,0,229376,5,6568129409
3965,92680440,43393093,136073533,7,0,0,209920,16,5267791302
3966,92693630,42599981,135293611,4,0,0,113664,2,5294937070
3967,92704099,41981726,134685825,5,0,0,6656,11,6074710667
3968,92705760,43185973,135891733,7,0,0,262656,16,937077732
3969,92707980,74616369,167324349,8,0,1,10240,2,6459597145
3970,92749509,74699072,167448581,1,0,1,47104,5,7164670120
3971,92760221,42470023,135230244,2,0,0,104960,4,3448815604
3972,92788700,74852805,167641505,8,0,1,11264,2,7188708506
3973,92810360,42520910,135331270,4,0,0,49664,2,9849471395
3974,92839209,74802327,167641536,0,0,1,19456,10,7063099258
3975,92870191,74771368,167641559,9,0,1,25600,17,2524305547
3976,92879880,42700457,135580337,4,0,0,87552,2,8788560174
3977,92886570,42033637,134920207,4,0,0,29696,2,8798202325
3978,92898691,74742891,167641582,9,0,1,34816,17,1365717675
3979,92898740,74742865,167641605,8,0,1,8192,2,2281338352
3980,92912661,42392563,135305224,2,0,0,37888,4,3886473017
3981,92986089,74655539,167641628,1,0,1,512,5,844166278
3982,93001070,42947680,135948750,1,0,0,103936,5,7772040360
3983,93029731,74719638,167749369,9,0,1,65024,17,6865549420
3984,93040110,42771572,135811682,4,0,0,173056,2,8959672804
3985,93045470,74703922,167749392,7,0,1,4608,16,5508258928
3986,93100580,42503218,135603798,3,0,0,59392,3,913367789
3987,93117479,74631936,167749415,1,0,1,15872,5,7270961447
3988,93137440,42779432,135916872,4,0,0,82432,2,1904001869
3989,93141980,43531286,136673266,6,0,0,478720,7,4297187566
3990,93156880,42365497,135522377,7,0,0,37888,16,8583927603
3991,93187870,74580155,167768025,8,0,1,8704,2,8412194550
3992,93199600,42146394,135345994,4,0,0,12288,2,9190227403
3993,93229530,74538518,167768048,8,0,1,9216,2,4342098437
3994,93238461,74556153,167794614,9,0,1,12288,17,9787516395
3995,93249251,74545386,167794637,9,0,1,17920,17,5419265008
3996,93378570,42986437,136365007,3,0,0,112128,3,3228440035
3997,93384790,42832311,136217101,4,0,0,44544,2,2588358407
3998,93392569,42131414,135523983,5,0,0,5120,11,9483568574
3999,93401970,42278714,135680684,7,0,0,124928,16,5680768231
4000,93404880,42755051,136159931,1,0,0,27648,5,6056657017
4001,93422600,74372084,167794684,3,0,1,5632,3,5418660596
4002,93444819,74349888,167794707,4,0,1,5632,2,9437791153
4003,93460590,74345045,167805635,8,0,1,39424,2,405977388
4004,93508341,42643143,136151484,2,0,0,58880,4,8421139182
4005,93516741,43010596,136527337,2,0,0,340992,4,4723903701
4006,93522180,42565874,136088054,9,0,0,4096,17,176656220
4007,93550631,74311550,167862181,6,0,1,11776,7,8514530914
4008,93583970,42333089,135917059,9,0,0,512,17,8573190439
4009,93596571,74265633,167862204,9,0,1,15872,17,2994024347
4010,93624201,74251349,167875550,9,0,1,8192,17,9535373173
4011,93663011,43043708,136706719,2,0,0,109568,4,10712575296
4012,93668261,74229141,167897402,6,0,1,54784,7,7694998954
4013,93675821,43286808,136962629,2,0,0,760832,4,10443015437
4014,93690180,42530688,136220868,7,0,0,12288,16,1188158404
4015,93714221,43389665,137103886,2,0,0,146432,4,8250918868
4016,93732730,74167258,167899988,3,0,1,4096,3,3743515133
4017,93745151,43413880,137159031,2,0,0,130048,4,9095036882
4018,93754971,43304276,137059247,2,0,0,315904,4,5223531241
4019,93787309,74343717,168131026,4,0,1,90624,2,3333999199
4020,93802660,75046657,168849317,8,0,1,19456,2,8290688091
4021,93811390,75137580,168948970,8,0,1,25600,2,8050747954
4022,93811739,43292482,137104221,5,0,0,1024,11,5505654598
4023,93836859,43126113,136962972,5,0,0,1024,11,482453077
4024,93853520,75095473,168948993,3,0,1,1536,3,6840499157
4025,93861960,75087056,168949016,3,0,1,18944,3,10497351083
4026,93865130,43327173,137192303,4,0,0,9728,2,7211225855
4027,93865599,75307370,169172969,4,0,1,2048,2,7484336967
4028,93908730,75318292,169227022,8,0,1,61952,2,6490208391
4029,93909830,75509032,169418862,2,0,1,147456,4,2326368656
4030,93913361,75505524,169418885,9,0,1,36864,17,7340489992
4031,93917749,42487106,136404855,5,0,0,1024,11,6882450834
4032,93950011,43239251,137189262,2,0,0,54784,4,6558873632
4033,93961690,42769076,136730766,7,0,0,78848,16,966180705
4034,94010111,75408797,169418908,6,0,1,4608,7,5452647489
4035,94029070,43090306,137119376,7,0,0,49664,16,809699719
4036,94045940,75372999,169418939,8,0,1,33280,2,9888010493
4037,94051991,75375887,169427878,9,0,1,14336,17,6197643470
4038,94060580,75444112,169504692,3,0,1,74752,3,7653651232
4039,94090311,75414404,169504715,6,0,1,20992,7,9948637775
4040,94102939,75459246,169562185,4,0,1,24576,2,5972959289
4041,94122330,43330516,137452846,1,0,0,213504,5,6899537529
4042,94126400,43046101,137172501,4,0,0,44032,2,3293305230
4043,94132630,43215908,137348538,1,0,0,465920,5,5449495879
4044,94149341,75412867,169562208,9,0,1,11776,17,258722100
4045,94162390,75399841,169562231,8,0,1,3584,2,8123380152
4046,94191961,75370293,169562254,9,0,1,3072,17,7159455682
4047,94200991,75361286,169562277,9,0,1,512,17,5324099782
4048,94204910,43182861,137387771,4,0,0,128512,2,7217612042
4049,94214741,43240351,137455092,2,0,0,2560,4,5415323366
4050,94253670,75308630,169562300,3,0,1,5632,3,3553992605
4051,94265650,75296673,169562323,3,0,1,13824,3,4423840373
4052,94293160,75269186,169562346,7,0,1,23552,16,3531772323
4053,94304590,43154269,137458859,4,0,0,12288,2,2839222986
4054,94306401,76472033,170778434,6,0,1,121344,7,8563454266
4055,94315439,76463018,170778457,4,0,1,25088,2,3659803598
4056,94335330,76468468,170803798,7,0,1,71680,16,8414167679
4057,94378689,43103714,137482403,5,0,0,2560,11,5012950163
4058,94391050,43991781,138382831,1,0,0,580608,5,2070157913
4059,94438060,76365761,170803821,8,0,1,11776,2,623076563
4060,94441590,43263838,137705428,4,0,0,30720,2,6008960285
4061,94506530,43096214,137602744,7,0,0,80896,16,2518129561
4062,94527941,76472829,171000770,6,0,1,56832,7,10094257170
4063,94536381,76464428,171000809,6,0,1,33792,7,9949625887
4064,94539100,76461732,171000832,3,0,1,24064,3,2448384753
4065,94543760,43620381,138164141,3,0,0,331264,3,7401976504
4066,94544110,42910163,137454273,4,0,0,4608,2,9825049769
4067,94546100,76454755,171000855,8,0,1,13824,2,2392298103
4068,94558691,76442187,171000878,9,0,1,4096,17,3485698927
4069,94563420,76437481,171000901,3,0,1,1024,3,5906092270
4070,94569789,76475797,171045586,4,0,1,25088,2,10327810029
4071,94578180,44109465,138687645,7,0,0,326144,16,7671719580
4072,94596260,76449349,171045609,2,0,1,20480,4,9424327959
4073,94609020,43904874,138513894,7,0,0,430080,16,3255121061
4074,94636550,43951700,138588250,4,0,0,243712,2,7804290220
4075,94669580,43265139,137934719,4,0,0,12800,2,3706490795
4076,94683580,76362052,171045632,8,0,1,1536,2,8433685612
4077,94684200,76361455,171045655,8,0,1,9728,2,9598989600
4078,94711620,76362941,171074561,3,0,1,15360,3,1356589396
4079,94740579,76334005,171074584,4,0,1,19968,2,8186734428
4080,94785100,76289507,171074607,2,0,1,14848,4,2793318626
4081,94838999,76235631,171074630,1,0,1,1024,5,8984375346
4082,94847189,76227464,171074653,4,0,1,1536,2,652868229
4083,94897601,76177075,171074676,6,0,1,43008,7,9969996230
4084,94907001,76167746,171074747,6,0,1,53248,7,707471976
4085,94912790,43894724,138807514,4,0,0,3072,2,8473145401
4086,94916100,43975519,138891619,1,0,0,170496,5,1992448273
4087,94921820,76152950,171074770,3,0,1,5632,3,10207137199
4088,94943330,76134908,171078238,8,0,1,9216,2,10404114063
4089,94947920,43875017,138822937,3,0,0,6656,3,1455839102
4090,94958719,76167285,171126004,4,0,1,28160,2,4448872142
4091,94959219,76296177,171255396,4,0,1,35840,2,622760511
4092,94961590,44440874,139402464,4,0,0,122880,2,7053049157
4093,94965049,43859244,138824293,5,0,0,1024,11,5252468610
4094,95011470,76253408,171264878,8,0,1,31232,2,8210952406
4095,95043700,44107784,139151484,4,0,0,102912,2,7593287463
4096,95080939,43868565,138949504,5,0,0,19456,11,8468739592
4097,95085211,76212937,171298148,6,0,1,11264,7,6538401264
4098,95093740,76205394,171299134,8,0,1,1536,2,7152594001
4099,95159290,44011763,139171053,7,0,0,49664,16,5325904200
4100,95190129,43919192,139109321,5,0,0,28672,11,8084707071
4101,95221520,76085569,171307089,7,0,1,9728,16,5136061781
4102,95246291,76062744,171309035,6,0,1,3072,7,5077909545
4103,95256299,76137470,171393769,4,0,1,42496,2,3166014305
4104,95258461,76135331,171393792,6,0,1,9216,7,2198183582
4105,95287899,43867976,139155875,5,0,0,14336,11,6064106570
4106,95293820,76099995,171393815,7,0,1,8192,16,229168303
4107,95323061,76070777,171393838,6,0,1,5120,7,6088505525
4108,95323820,44041181,139365001,4,0,0,79360,2,8794418388
4109,95339870,44080401,139420271,7,0,0,58368,16,7305059659
4110,95341740,76057550,171399290,8,0,1,28672,2,2383450847
4111,95435540,76244207,171679747,8,0,1,84480,2,4677449391
4112,95501511,76349834,171851345,6,0,1,19456,7,3749492152
4113,95520131,43806732,139326863,2,0,0,8704,4,3673634246
4114,95532880,43909410,139442290,7,0,0,72192,16,292199905
4115,95534620,76734015,172268635,8,0,1,41984,2,7861496527
4116,95541520,76727138,172268658,8,0,1,12288,2,680723005
4117,95582610,44198452,139781062,1,0,0,30208,5,7942477925
4118,95623620,43898321,139521941,4,0,0,11776,2,1778402269
4119,95627690,43986591,139614281,4,0,0,100352,2,8222262209
4120,95728420,76540261,172268681,8,0,1,5632,2,4810057425
4121,95733600,76572596,172306196,7,0,1,45056,16,4490084396
4122,95744021,44121810,139865831,2,0,0,214016,4,1435113127
4123,95761701,76707327,172469028,6,0,1,35328,7,1794567820
4124,95763010,76714667,172477677,7,0,1,12800,16,8963950703
4125,95799320,76678380,172477700,8,0,1,8192,2,8497285315
4126,95832771,43784965,139617736,2,0,0,11264,4,5053219955
4127,95850380,43725525,139575905,7,0,0,22528,16,4478395091
4128,95881670,44628845,140510515,7,0,0,581632,16,6016394716
4129,95881911,76595812,172477723,6,0,1,3072,7,6965174590
4130,95888380,43572507,139460887,4,0,0,43520,2,8440255255
4131,95913990,44633408,140547398,7,0,0,120320,16,136972480
4132,95947001,76530745,172477746,6,0,1,2560,7,4723870255
4133,96005851,44327402,140333253,2,0,0,216576,4,1043288518
4134,96013119,44602520,140615639,5,0,0,223744,11,10114408201
4135,96022470,44736530,140759000,7,0,0,235008,16,4585385733
4136,96057300,44601574,140658874,7,0,0,141824,16,10031454508
4137,96063530,44603011,140666541,7,0,0,25088,16,8123698775
4138,96067520,76410559,172478079,8,0,1,32256,2,1692953378
4139,96102240,76387869,172490109,8,0,1,24576,2,558754862
4140,96115580,76411243,172526823,8,0,1,23040,2,1368686525
4141,96124801,76403405,172528206,6,0,1,14848,7,975579638
4142,96129251,44105397,140234648,2,0,0,14336,4,9642110639
4143,96271960,44523659,140795619,1,0,0,86016,5,5407879902
4144,96272361,44589432,140861793,2,0,0,15360,4,1503865182
4145,96329250,44358100,140687350,4,0,0,67584,2,6272971639
4146,96347450,76402691,172750141,8,0,1,65024,2,4721476573
4147,96400910,76914833,173315743,8,0,1,45568,2,5184056445
4148,96417620,76898146,173315766,8,0,1,3072,2,8155940288
4149,96433770,44335618,140769388,1,0,0,33280,5,4908282653
4150,96455910,44364559,140820469,1,0,0,81408,5,8812860247
4151,96500230,44356797,140857027,1,0,0,119808,5,6406948569
4152,96503290,76812499,173315789,8,0,1,20480,2,9441654245
4153,96531600,76784220,173315820,7,0,1,6656,16,8444068712
4154,96560321,76889268,173449589,6,0,1,14848,7,5760536006
4155,96592250,77034663,173626913,8,0,1,29696,2,772847522
4156,96597841,77034637,173632478,6,0,1,8192,7,1779809250
4157,96599011,77034773,173633784,6,0,1,2048,7,5983978649
4158,96660170,44515122,141175292,1,0,0,259072,5,9348393701
4159,96671771,77176014,173847785,6,0,1,12800,7,9178395226
4160,96682960,45136332,141819292,4,0,0,739840,2,9828038245
4161,96688200,44905649,141593849,7,0,0,110592,16,4050280988
4162,96691169,77172428,173863597,1,0,1,16896,5,88857515
4163,96709530,44258783,140968313,7,0,0,49664,16,5323646855
4164,96789061,77074997,173864058,6,0,1,10240,7,201701354
4165,96805820,77170800,173976620,8,0,1,30720,2,1992308467
4166,96823950,77224825,174048775,8,0,1,12288,2,8584635553
4167,96855480,44460643,141316123,4,0,0,186368,2,8124652804
4168,96886519,77250781,174137300,1,0,1,2560,5,6447046078
4169,96898490,77266131,174164621,8,0,1,30208,2,9378114090
4170,97048759,77246484,174295243,1,0,1,40448,5,10558554536
4171,97054610,45006906,142061516,4,0,0,219136,2,7364825663
4172,97084661,77265276,174349937,6,0,1,27136,7,7080699819
4173,97119360,44795903,141915263,4,0,0,314880,2,5696614174
4174,97141610,77210913,174352523,8,0,1,4096,2,6532445021
4175,97160020,44773518,141933538,1,0,0,59904,5,9966050173
4176,97179369,77173410,174352779,1,0,1,9216,5,3496869438
4177,97235651,77196003,174431654,6,0,1,27136,7,8007859691
4178,97281069,77177463,174458532,1,0,1,48128,5,3638656617
4179,97282550,77262943,174545493,8,0,1,45568,2,2701547209
4180,97309421,77278550,174587971,6,0,1,7168,7,3170845078
4181,97329220,45582374,142911594,4,0,0,179200,2,771135383
4182,97336601,44987852,142324453,2,0,0,260096,4,2091000887
4183,97346720,45136506,142483226,1,0,0,95232,5,4823569528
4184,97349700,45791572,143141272,4,0,0,531456,2,4908167505
4185,97392760,77195234,174587994,8,0,1,7680,2,8637007121
4186,97446280,44909199,142355479,4,0,0,46592,2,5451675225
4187,97451609,77191218,174642827,1,0,1,66048,5,8697410201
4188,97514700,45185880,142700580,1,0,0,301056,5,3680487015
4189,97548751,77094123,174642874,6,0,1,12288,7,6400734549
4190,97594859,77408394,175003253,1,0,1,21504,5,3960708857
4191,97600060,45008769,142608829,1,0,0,412160,5,9621957365
4192,97600201,77403075,175003276,9,0,1,512,17,5850392086
4193,97607669,77395630,175003299,1,0,1,61440,5,6833253273
4194,97622220,44753030,142375250,7,0,0,63488,16,9200224505
4195,97622261,77489261,175111522,9,0,1,38400,17,4668026665
4196,97633751,77554140,175187891,9,0,1,52224,17,4516783580
4197,97648871,77539043,175187914,9,0,1,10240,17,10596701758
4198,97682189,77588147,175270336,1,0,1,5632,5,10636237139
4199,97728899,77541460,175270359,1,0,1,3584,5,3794374563
4200,97744800,77525582,175270382,5,0,1,3072,11,9285458768
4201,97758330,45539308,143297638,1,0,0,303104,5,10709764605
4202,97761950,45217371,142979321,7,0,0,222208,16,5213004533
4203,97797561,77472844,175270405,9,0,1,18432,17,7504409414
4204,97804870,45607973,143412843,7,0,0,377856,16,9028659361
4205,97846380,45358883,143205263,1,0,0,209920,5,9271685906
4206,97913951,77356477,175270428,9,0,1,11264,17,2021009613
4207,97917960,77359230,175277190,5,0,1,29696,11,2901754704
4208,97926971,77350242,175277213,6,0,1,6144,7,2401154069
4209,97939660,45506941,143446601,1,0,0,110592,5,2511635943
4210,97946850,45744908,143691758,1,0,0,400384,5,4467978974
4211,97990951,77286285,175277236,9,0,1,3072,17,3571305279
4212,98117410,45835234,143952644,7,0,0,539648,16,3468829560
4213,98117820,45431626,143549446,1,0,0,109568,5,2308515114
4214,98132810,45566459,143699269,7,0,0,24576,16,1995453877
4215,98176891,45609264,143786155,2,0,0,188928,4,2555808921
4216,98240141,77039481,175279622,6,0,1,25088,7,3495767736
4217,98320261,77002479,175322740,6,0,1,54272,7,1205959483
4218,98347571,76975192,175322763,6,0,1,7680,7,9975326933
4219,98348480,45675198,144023678,4,0,0,138240,2,7235626501
4220,98351891,45629636,143981527,2,0,0,94720,4,1793683648
4221,98357570,76965216,175322786,5,0,1,51200,11,5784880190
4222,98466010,45871475,144337485,1,0,0,350720,5,8800599862
4223,98482339,76840470,175322809,1,0,1,1536,5,10594395835
4224,98533319,76789513,175322832,1,0,1,39424,5,7477632789
4225,98541810,45979083,144520893,7,0,0,43520,16,5932882197
4226,98554341,76977633,175531974,9,0,1,6656,17,5037083589
4227,98561750,46067374,144629124,7,0,0,323584,16,10519289390
4228,98577921,76955538,175533459,9,0,1,15360,17,5132563935
4229,98597430,77373857,175971287,5,0,1,7168,11,10578041261
4230,98612340,77821945,176434285,5,0,1,3072,11,8345066416
4231,98613329,78170791,176784120,1,0,1,119808,5,7247291510
4232,98631271,78152872,176784143,6,0,1,6656,7,2810520410
4233,98631430,45876141,144507571,4,0,0,473600,2,6626008740
4234,98636120,78148046,176784166,5,0,1,19968,11,9151206271
4235,98644561,46214243,144858804,2,0,0,125952,4,9711403592
4236,98693839,78090350,176784189,1,0,1,6656,5,7393827511
4237,98709260,46067552,144776812,1,0,0,309248,5,9585714778
4238,98713750,45649498,144363248,7,0,0,84480,16,3802152746
4239,98718811,78065401,176784212,6,0,1,6656,7,8491275461
4240,98722630,78078476,176801106,8,0,1,5632,2,9621355767
4241,98751501,78108323,176859824,9,0,1,65536,17,8903813714
4242,98761760,45768741,144530501,4,0,0,31232,2,3372444347
4243,98808520,78149037,176957557,8,0,1,57344,2,7229404613
4244,98830101,78127479,176957580,6,0,1,18432,7,9062815851
4245,98861440,78096163,176957603,8,0,1,17408,2,1437999576
4246,98893431,78064195,176957626,6,0,1,4608,7,8377208087
4247,98896910,78060739,176957649,8,0,1,14336,2,3893218653
4248,98922200,46095632,145017832,4,0,0,79360,2,3874100169
4249,99003080,78108867,177111947,8,0,1,45568,2,7473919546
4250,99009800,45810605,144820405,7,0,0,142848,16,29586886
4251,99040710,45952896,144993606,4,0,0,36864,2,505560747
4252,99062570,45919758,144982328,4,0,0,156160,2,8665082131
4253,99072181,78039789,177111970,9,0,1,6656,17,1466752460
4254,99094591,78092174,177186765,9,0,1,11264,17,4264916308
4255,99130771,78123770,177254541,6,0,1,14848,7,3514150092
4256,99188351,46040326,145228677,2,0,0,136704,4,7909376356
4257,99194490,78217624,177412114,8,0,1,43008,2,4415580829
4258,99288370,78537352,177825722,2,0,1,448000,4,4524866349
4259,99294450,79162401,178456851,2,0,1,71680,4,1570133880
4260,99301690,79258819,178560509,5,0,1,37888,11,1236015438
4261,99314610,45717013,145031623,7,0,0,45056,16,1174728658
4262,99322801,45847836,145170637,2,0,0,147456,4,1297228137
4263,99349671,46287486,145637157,2,0,0,330752,4,8573065993
4264,99352570,79207970,178560540,2,0,1,116224,4,9218883918
4265,99368410,45967121,145335531,4,0,0,52736,2,7480831604
4266,99379590,46334029,145713619,7,0,0,68096,16,8485835565
4267,99403221,79282606,178685827,6,0,1,35840,7,6992296516
4268,99403600,79282250,178685850,8,0,1,33280,2,7440239060
4269,99408100,79277773,178685873,5,0,1,3584,11,8352507464
4270,99462509,79223387,178685896,0,0,1,27648,10,839266132
4271,99523760,79162599,178686359,8,0,1,2048,2,6110833567
4272,99552419,79134286,178686705,0,0,1,512,10,5603865354
4273,99579270,79111800,178691070,5,0,1,15360,11,8557916197
4274,99581381,79124551,178705932,6,0,1,36352,7,2426229637
4275,99596870,79236565,178833435,8,0,1,62976,2,9409801526
4276,99681301,79152157,178833458,6,0,1,2560,7,5212984373
4277,99688760,46355344,146044104,1,0,0,439808,5,7698302216
4278,99701861,79131620,178833481,6,0,1,12288,7,7532724423
4279,99748960,79084544,178833504,5,0,1,77312,11,4061184065
4280,99759120,46437988,146197108,4,0,0,60928,2,569874336
4281,99765950,79068224,178834174,8,0,1,26112,2,1403699674
4282,99795780,79038417,178834197,8,0,1,4608,2,2035375974
4283,99827280,79006940,178834220,3,0,1,17920,3,626718898
4284,99892051,45932206,145824257,2,0,0,207872,4,2674124937
4285,99947350,46231148,146178498,4,0,0,431104,2,6299454239
4286,99955990,45717891,145673881,4,0,0,73728,2,885836033
4287,99963600,78870643,178834243,5,0,1,7168,11,7910836554
4288,99975900,78859481,178835381,5,0,1,21504,11,3627507322
4289,99987270,78848134,178835404,5,0,1,13312,11,6585826718
4290,99996441,78950137,178946578,6,0,1,34816,7,590247089
4291,99996980,78949621,178946601,5,0,1,7680,11,713704746
4292,100006700,78939924,178946624,8,0,1,24576,2,965812272
4293,100026889,78919758,178946647,0,0,1,1024,10,9499832665
4294,100081090,46250647,146331737,7,0,0,375296,16,7618535190
4295,100085721,78860949,178946670,6,0,1,10240,7,5674982979
4296,100094080,46111902,146205982,7,0,0,28672,16,4828646282
4297,100103721,46267732,146371453,2,0,0,130048,4,3817380398
4298,100148310,78798383,178946693,5,0,1,17408,11,3507688309
4299,100162870,46226234,146389104,1,0,0,57856,5,6247810673
4300,100197630,46546922,146744552,7,0,0,71168,16,8390370304
4301,100201110,78745606,178946716,5,0,1,27648,11,5975012577
4302,100216320,78730419,178946739,5,0,1,16896,11,9303775832
4303,100251050,46187481,146438531,1,0,0,4608,5,9817913629
4304,100342931,78688290,179031221,6,0,1,34816,7,5935285040
4305,100345411,78690544,179035955,6,0,1,67584,7,5096484722
4306,100357741,46186694,146544435,2,0,0,95744,4,218323004
4307,100371340,78679503,179050843,5,0,1,1024,11,1217920110
4308,100386690,46128550,146515240,1,0,0,76800,5,937590660
4309,100421851,46069958,146491809,2,0,0,35840,4,5960383363
4310,100446430,46276415,146722845,1,0,0,143872,5,4570271713
4311,100456921,78612562,179069483,9,0,1,23552,17,4674659380
4312,100466501,78646303,179112804,9,0,1,8704,17,159640598
4313,100544180,46024641,146568821,1,0,0,37888,5,6096762894
4314,100551400,78611156,179162556,5,0,1,10240,11,1391713080
4315,100582470,46296438,146878908,7,0,0,61440,16,1443294379
4316,100629830,45951808,146581638,1,0,0,8192,5,10314538118
4317,100637720,78770161,179407881,7,0,1,17408,16,9346869577
4318,100697380,46162785,146860165,4,0,0,144384,2,1603397653
4319,100788411,45979858,146768269,2,0,0,4096,4,10467776613
4320,100789870,46240269,147030139,1,0,0,81408,5,78973140
4321,100837311,46434074,147271385,2,0,0,167424,4,2980937988
4322,100914700,78922498,179837198,5,0,1,62976,11,4746805709
4323,100933200,78983760,179916960,5,0,1,22016,11,1877286344
4324,100969270,78947713,179916983,5,0,1,5120,11,10282785747
4325,100981410,78937655,179919065,5,0,1,54272,11,10450412578
4326,100992300,79048929,180041229,6,0,1,15360,7,1352706312
4327,101007401,79052469,180059870,9,0,1,46080,17,1099803378
4328,101014041,79193062,180207103,6,0,1,130048,7,4768775391
4329,101050731,79193278,180244009,6,0,1,56832,7,7069677359
4330,101052221,79205220,180257441,9,0,1,24064,17,4374167468
4331,101087130,46898346,147985476,1,0,0,206336,5,8128546794
4332,101116670,79161145,180277815,7,0,1,28672,16,3647208370
4333,101118710,46200191,147318901,4,0,0,86016,2,2688326199
4334,101139691,79142630,180282321,6,0,1,7168,7,6065270377
4335,101174170,79108305,180282475,7,0,1,8704,16,9160002355
4336,101238520,46499471,147737991,4,0,0,119296,2,10662293770
4337,101241200,45643815,146885015,7,0,0,19968,16,2856187955
4338,101246210,46676375,147922585,7,0,0,390656,16,1488359789
4339,101261701,79032908,180294609,9,0,1,23552,17,6078277411
4340,101275310,46528224,147803534,1,0,0,215040,5,9156114067
4341,101286311,46006336,147292647,2,0,0,69632,4,4804273561
4342,101368171,46159643,147527814,2,0,0,57856,4,3002322274
4343,101368641,79015216,180383857,6,0,1,21504,7,6831553693
4344,101424251,78959629,180383880,9,0,1,19456,17,7929146045
4345,101444850,78939053,180383903,5,0,1,7168,11,7700792207
4346,101460351,79404309,180864660,9,0,1,52736,17,5251601594
4347,101535850,79341074,180876924,7,0,1,50176,16,454440981
4348,101555931,79504708,181060639,6,0,1,3072,7,1013899325
4349,101560211,79500451,181060662,6,0,1,17408,7,1931328595
4350,101567330,79556540,181123870,6,0,1,8192,7,2246021605
4351,101576120,46043740,147619860,1,0,0,25088,5,75995924
4352,101651361,79518502,181169863,9,0,1,2560,17,1417172416
4353,101659281,46388805,148048086,2,0,0,163328,4,294789273
4354,101666531,79610568,181277099,9,0,1,51200,17,809183607
4355,101686511,46311788,147998299,2,0,0,41984,4,2304668979
4356,101704469,79572653,181277122,0,0,1,10240,10,3872028575
4357,101780901,46610749,148391650,2,0,0,596480,4,2405747663
4358,101792070,45892986,147685056,1,0,0,7168,5,4356284230
4359,101792460,79650692,181443152,7,0,1,13824,16,8618856050
4360,101815409,79668669,181484078,0,0,1,10752,10,1653886686
4361,101822540,79661561,181484101,5,0,1,14848,11,2804184655
4362,101854081,79813124,181667205,9,0,1,39424,17,7144140308
4363,101854261,46752715,148606976,2,0,0,487424,4,3552461454
4364,101896820,79770408,181667228,7,0,1,12288,16,10093326680
4365,101907589,79760153,181667742,0,0,1,7168,10,2075063733
4366,101962950,79704815,181667765,5,0,1,4096,11,234121198
4367,102013850,46444591,148458441,7,0,0,219136,16,850539909
4368,102040000,79823348,181863348,5,0,1,66560,11,6401178643
4369,102079450,79819558,181899008,3,0,1,40960,3,9493364208
4370,102086730,79812301,181899031,3,0,1,3072,3,326573112
4371,102095280,46064526,148159806,7,0,0,12288,16,7173140281
4372,102108681,79790373,181899054,9,0,1,22016,17,7005600900
4373,102130390,46659587,148789977,1,0,0,150528,5,1107592273
4374,102142840,46526247,148669087,7,0,0,203776,16,1567930971
4375,102165680,46578387,148744067,7,0,0,116224,16,667387169
4376,102264440,46444192,148708632,4,0,0,129536,2,9495830126
4377,102300880,79598197,181899077,8,0,1,12800,2,6223185287
4378,102304370,46594118,148898488,4,0,0,278016,2,1317761034
4379,102340290,79558810,181899100,8,0,1,11776,2,826136730
4380,102380611,46597379,148977990,2,0,0,53248,4,5465106003
4381,102442250,79456873,181899123,8,0,1,7680,2,6264489265
4382,102448370,79450776,181899146,3,0,1,10752,3,6192896080
4383,102478341,46311815,148790156,2,0,0,512,4,2678536097
4384,102486150,79413019,181899169,8,0,1,18944,2,1737304016
4385,102518960,79454091,181973051,5,0,1,17408,11,8084126026
4386,102531660,46476444,149008104,4,0,0,14848,2,8632939917
4387,102533770,79439304,181973074,3,0,1,9216,3,2769912345
4388,102623390,79350510,181973900,3,0,1,6656,3,9725979370
4389,102689140,47299641,149988781,4,0,0,618496,2,7905707359
4390,102869730,46383372,149253102,1,0,0,107008,5,8509564264
4391,102903740,46258016,149161756,4,0,0,197120,2,8670527089
4392,103056680,46508362,149565042,1,0,0,81408,5,3574724806
4393,103072270,46646612,149718882,7,0,0,263680,16,2606784214
4394,103081480,46452979,149534459,7,0,0,291328,16,3326209352
4395,103154430,46932677,150087107,1,0,0,305664,5,8433808441
4396,103176000,46594618,149770618,4,0,0,25088,2,5233880719
4397,103361090,46746492,150107582,4,0,0,67072,2,1873354356
4398,103418280,46873646,150291926,4,0,0,275968,2,5093989028
4399,103454400,46539552,149993952,4,0,0,16896,2,7326711800
4400,103584560,78389363,181973923,3,0,1,12288,3,9680824834
4401,103598281,46792239,150390520,2,0,0,242176,4,3983921405
4402,103699510,46770191,150469701,7,0,0,226816,16,796614198
4403,103729661,46392296,150121957,2,0,0,47104,4,10074558753
4404,103746570,78241299,181987869,3,0,1,39424,3,738922133
4405,103781940,78216895,181998835,3,0,1,7168,3,5755464380
4406,103796400,78202458,181998858,3,0,1,1024,3,9187204972
4407,103804030,78194851,181998881,5,0,1,40960,11,6075512393
4408,103812270,46681965,150494235,7,0,0,79360,16,4298816037
4409,104025390,77973570,181998960,3,0,1,27136,3,1895950153
4410,104056291,46340024,150396315,2,0,0,18944,4,310740705
4411,104058590,46668842,150727432,1,0,0,274944,5,3759307445
4412,104146871,47074561,151221432,2,0,0,239104,4,6116592281
4413,104148110,77850873,181998983,3,0,1,5632,3,4834977193
4414,104241570,77760735,182002305,6,0,1,54784,7,8762631957
4415,104250930,77780180,182031110,2,0,1,93184,4,7032951512
4416,104287109,77800075,182087184,4,0,1,50688,2,5533961490
4417,104294551,46628949,150923500,2,0,0,230400,4,384324809
4418,104295041,46680920,150975961,2,0,0,39424,4,6747248689
4419,104350270,46798287,151148557,1,0,0,348160,5,6941697383
4420,104359450,77746644,182106094,3,0,1,3584,3,5354801890
4421,104469060,77642180,182111240,3,0,1,8192,3,10448018617
4422,104476920,46980455,151457375,7,0,0,157696,16,3378024455
4423,104499261,46765227,151264488,2,0,0,16384,4,1739552777
4424,104506930,47037813,151544743,7,0,0,91648,16,10554111506
4425,104513200,78258231,182771431,2,0,1,5120,4,10343755333
4426,104526500,78267384,182793884,3,0,1,10752,3,89842458
4427,104557160,47478925,152036085,1,0,0,217088,5,1055305645
4428,104617061,47028366,151645427,2,0,0,152576,4,9790099427
4429,104654500,46731831,151386331,7,0,0,5632,16,1234972552
4430,104684170,47222889,151907059,7,0,0,272896,16,9953950423
4431,104708200,46948014,151656214,7,0,0,35328,16,8621006678
4432,104731701,47620400,152352101,2,0,0,447488,4,8292477297
4433,104734230,78060884,182795114,5,0,1,22016,11,6843464135
4434,104745700,47336677,152082377,7,0,0,59392,16,786058932
4435,104755670,78284758,183040428,3,0,1,55808,3,232625808
4436,104811410,78279483,183090893,6,0,1,48128,7,6209594034
4437,104843740,47329435,152173175,4,0,0,113664,2,4470910780
4438,104847820,47642023,152489843,1,0,0,420864,5,10516897462
4439,104944900,78146024,183090924,6,0,1,2560,7,5172373597
4440,104951850,78161272,183113122,6,0,1,26112,7,5539921431
4441,105022320,78464498,183486818,2,0,1,227328,4,3035868411
4442,105082270,47519877,152602147,7,0,0,61952,16,8732577122
4443,105100680,78386161,183486841,3,0,1,7168,3,6150682308
4444,105117000,78535012,183652012,6,0,1,24576,7,9974712296
4445,105120500,78531535,183652035,6,0,1,19456,7,7340560378
4446,105144770,48070168,153214938,7,0,0,27648,16,73296531
4447,105157870,47946970,153104840,4,0,0,272896,2,2794206506
4448,105176760,48771122,153947882,4,0,0,133632,2,5479511610
4449,105188650,48045165,153233815,7,0,0,44544,16,3093935872
4450,105276030,48948772,154224802,4,0,0,492544,2,4090397726
4451,105314530,48981188,154295718,7,0,0,232448,16,4465797509
4452,105348100,78303958,183652058,6,0,1,59392,7,2289091685
4453,105384520,78561450,183945970,2,0,1,369152,4,3874221807
4454,105398070,78552005,183950075,3,0,1,19968,3,1827718062
4455,105413631,48201219,153614850,2,0,0,276480,4,9195902569
4456,105418491,78573487,183991978,9,0,1,6656,17,6846841314
4457,105419550,78572451,183992001,2,0,1,13312,4,5133705945
4458,105428551,78563473,183992024,9,0,1,17408,17,1522386319
4459,105436190,78565151,184001341,3,0,1,17408,3,8738571089
4460,105508390,78510185,184018575,6,0,1,13312,7,5972730699
4461,105511820,78538627,184050447,6,0,1,83968,7,9892438609
4462,105517581,49032830,154550411,2,0,0,306176,4,6165475658
4463,105545201,48911899,154457100,2,0,0,511488,4,5605861882
4464,105548521,78539441,184087962,9,0,1,19968,17,2818620153
4465,105554760,48472344,154027104,4,0,0,33280,2,5638828596
4466,105649720,78635903,184285623,2,0,1,36352,4,9497399927
4467,105657509,78629599,184287108,1,0,1,15360,5,3356578641
4468,105698790,78605268,184304058,3,0,1,2560,3,8188286325
4469,105709140,48592061,154301201,1,0,0,17920,5,3222937793
4470,105754410,78900420,184654830,7,0,1,27136,16,3249370668
4471,105789781,48890279,154680060,2,0,0,386048,4,6105066733
4472,105795340,48111757,153907097,7,0,0,48640,16,6644152835
4473,105807791,79004231,184812022,9,0,1,7680,17,2314810961
4474,105817760,78994285,184812045,3,0,1,5120,3,4740076488
4475,105844020,48933298,154777318,1,0,0,318976,5,3088684469
4476,105867450,78944618,184812068,7,0,1,2048,16,3625678504
4477,105875750,48686548,154562298,4,0,0,38912,2,4187939990
4478,105876061,78936030,184812091,9,0,1,5632,17,7128515189
4479,105889650,78922472,184812122,2,0,1,23552,4,4169773358
4480,105899240,79091339,184990579,3,0,1,42496,3,6380881642
4481,105906340,79124160,185030500,3,0,1,5632,3,620655624
4482,105913129,79384896,185298025,4,0,1,47104,2,9996236281
4483,105935351,48895450,154830801,2,0,0,149504,4,2874907387
4484,105975440,48809701,154785141,1,0,0,25600,5,9265729856
4485,106001190,79305710,185306900,7,0,1,17408,16,4001759409
4486,106007300,48856245,154863545,1,0,0,28160,5,5978436467
4487,106027210,79281636,185308846,7,0,1,3072,16,9824753792
4488,106079651,48935991,155015642,2,0,0,94208,4,9448449596
4489,106091640,48895275,154986915,7,0,0,17408,16,9903199947
4490,106137670,48745928,154883598,7,0,0,8704,16,532188489
4491,106161021,79157873,185318894,9,0,1,2048,17,4321728546
4492,106163371,79271351,185434722,9,0,1,68608,17,9259142233
4493,106174400,79260345,185434745,7,0,1,4096,16,9021347441
4494,106177820,79256948,185434768,6,0,1,6144,7,5870641799
4495,106189630,79245161,185434791,6,0,1,29696,7,5010613015
4496,106214830,49145671,155360501,4,0,0,206336,2,4422376979
4497,106271581,50409738,156681319,2,0,0,2560,4,8012680167
4498,106276950,79522665,185799615,2,0,1,237056,4,3705346513
4499,106284139,79538835,185822974,4,0,1,46592,2,3728275675
4500,106324490,79604395,185928885,7,0,1,11776,16,3413567617
4501,106324530,49674681,155999211,1,0,0,56320,5,10005965569
4502,106407360,49527845,155935205,4,0,0,668672,2,5314801066
4503,106428380,50184051,156612431,1,0,0,33280,5,8645841844
4504,106435399,79493509,185928908,4,0,1,17920,2,111973681
4505,106447640,79481291,185928931,7,0,1,31232,16,340771192
4506,106457741,50119209,156576950,2,0,0,160768,4,9994626348
4507,106479911,79449043,185928954,9,0,1,20992,17,8715908090
4508,106487120,79472927,185960047,7,0,1,109056,16,6780753682
4509,106492899,79470959,185963858,4,0,1,5632,2,9343890442
4510,106500330,50027613,156527943,7,0,0,899584,16,6467731959
4511,106508470,49473558,155982028,4,0,0,153600,2,8048470746
4512,106524350,49729478,156253828,1,0,0,229376,5,8055474608
4513,106572890,79456388,186029278,7,0,1,57856,16,3878146565
4514,106573430,79542352,186115782,3,0,1,73216,3,6865906839
4515,106590980,79524825,186115805,7,0,1,28672,16,667758523
4516,106597560,80496261,187093821,7,0,1,121344,16,1260783316
4517,106614520,81121219,187735739,2,0,1,393728,4,7828144577
4518,106724159,81011603,187735762,4,0,1,1024,2,7229094545
4519,106739891,49932467,156672358,2,0,0,196608,4,6307795100
4520,106824330,49777938,156602268,4,0,0,82944,2,5360875288
4521,106856360,80879425,187735785,3,0,1,23040,3,6601809506
4522,106901890,49852179,156754069,7,0,0,238592,16,892209026
4523,106949750,81354005,188303755,2,0,1,322048,4,2960057170
4524,106951220,49908770,156859990,7,0,0,242688,16,7659403876
4525,106981880,81381848,188363728,3,0,1,10752,3,7993799956
4526,106996840,49789143,156785983,7,0,0,61440,16,8060262020
4527,107012880,81350871,188363751,3,0,1,6656,3,4267045116
4528,107027841,49652675,156680516,2,0,0,26624,4,3462122510
4529,107042859,81320923,188363782,4,0,1,13824,2,1405053831
4530,107069299,81294522,188363821,4,0,1,22016,2,2746008567
4531,107086040,81277804,188363844,2,0,1,204288,4,7021245453
4532,107099709,81264174,188363883,4,0,1,25088,2,4098384861
4533,107107820,81256086,188363906,7,0,1,6144,16,4635379394
4534,107117460,81478766,188596226,2,0,1,297984,4,1381736666
4535,107123370,81501048,188624418,2,0,1,14336,4,9762499748
4536,107135610,49631453,156767063,7,0,0,42496,16,328797790
4537,107139139,82002927,189142066,0,0,1,92160,10,4784102927
4538,107198550,81943539,189142089,7,0,1,7168,16,3917216536
4539,107229520,50134324,157363844,7,0,0,213504,16,3854558325
4540,107235780,50536889,157772669,7,0,0,342016,16,1159432141
4541,107259800,82277520,189537320,2,0,1,323072,4,587017198
4542,107283480,82433456,189716936,2,0,1,453120,4,758437232
4543,107287980,82444433,189732413,2,0,1,49664,4,4026989332
4544,107329040,82416200,189745240,7,0,1,22528,16,165354494
4545,107334200,82413306,189747506,3,0,1,3584,3,1722699875
4546,107346341,82419549,189765890,9,0,1,32768,17,3959006719
4547,107425290,50051640,157476930,4,0,0,193024,2,7775051237
4548,107427240,82344049,189771289,7,0,1,17920,16,5662369467
4549,107436731,51079032,158515763,2,0,0,677888,4,8721836528
4550,107446030,49754038,157200068,1,0,0,100864,5,6563334242
4551,107455620,82325243,189780863,3,0,1,13824,3,10007026948
4552,107463699,82322758,189786457,4,0,1,26624,2,9556057442
4553,107475630,82416084,189891714,2,0,1,223232,4,8921714816
4554,107494230,50174208,157668438,4,0,0,116224,2,3798185652
4555,107537980,82362003,189899983,7,0,1,16384,16,8774410452
4556,107560690,50064994,157625684,7,0,0,6144,16,4407894468
4557,107591210,50219559,157810769,4,0,0,26624,2,449458208
4558,107621390,50923434,158544824,7,0,0,94720,16,1371308542
4559,107622950,50268070,157891020,4,0,0,132608,2,1797880733
4560,107650190,82252059,189902249,3,0,1,3584,3,6230593773
4561,107692720,82276026,189968746,2,0,1,122880,4,2502530410
4562,107713560,82272650,189986210,7,0,1,5120,16,5960653547
4563,107754220,82239274,189993494,3,0,1,14336,3,8567610933
4564,107809201,82290229,190099430,9,0,1,33792,17,5841875785
4565,107809271,82309645,190118916,9,0,1,55808,17,836833299
4566,107813370,82329629,190142999,3,0,1,7680,3,3951500343
4567,107828640,82329281,190157921,7,0,1,34816,16,7434256984
4568,107858570,82465022,190323592,3,0,1,84480,3,9226708781
4569,107899040,82424591,190323631,3,0,1,22528,3,9544236656
4570,108093650,49872393,157966043,1,0,0,73216,5,1466378580
4571,108094330,49986632,158080962,7,0,0,59904,16,4001939217
4572,108125460,82200401,190325861,3,0,1,29184,3,6185115787
4573,108152800,82232446,190385246,7,0,1,110080,16,2242393430
4574,108193201,82193479,190386680,9,0,1,23040,17,1058405575
4575,108208180,50418931,158627111,1,0,0,64512,5,8718584136
4576,108209001,82220902,190429903,9,0,1,74752,17,4704930644
4577,108245469,82186022,190431491,4,0,1,15872,2,989528030
4578,108288930,50304167,158593097,1,0,0,158208,5,9158066159
4579,108312361,50295063,158607424,2,0,0,46592,4,9009209986
4580,108319790,82149235,190469025,7,0,1,59392,16,1640483559
4581,108323250,82195698,190518948,7,0,1,61952,16,8747342786
4582,108340420,82191745,190532165,5,0,1,31232,11,6048824974
4583,108358730,49916983,158275713,1,0,0,5120,5,4425274276
4584,108359990,50941549,159301539,4,0,0,764416,2,61261691
4585,108373171,82170369,190543540,9,0,1,32256,17,2888163363
4586,108380340,82457551,190837891,2,0,1,432128,4,8622554022
4587,108411410,82440366,190851776,3,0,1,16896,3,6270069546
4588,108415031,82437001,190852032,9,0,1,9216,17,7113582939
4589,108415970,50903555,159319525,7,0,0,5632,16,3484569114
4590,108423069,82434250,190857319,4,0,1,16896,2,9306480770
4591,108437941,82421644,190859585,9,0,1,3584,17,9489602897
4592,108480980,51584623,160065603,7,0,0,550400,16,7480398972
4593,108495880,51243395,159739275,1,0,0,777216,5,265026011
4594,108544950,82327960,190872910,3,0,1,60416,3,8747644037
4595,108555621,51187889,159743510,2,0,0,13824,4,9197587640
4596,108562761,82323616,190886377,9,0,1,17408,17,4928045051
4597,108590730,82997240,191587970,2,0,1,749056,4,4010678878
4598,108666790,51144158,159810948,4,0,0,221184,2,3877800827
4599,108668610,82919383,191587993,3,0,1,17920,3,9449848636
4600,108700790,50616996,159317786,4,0,0,53248,2,4364226399
4601,108701990,51366444,160068434,4,0,0,9216,2,7540980118
4602,108756190,51349643,160105833,1,0,0,70144,5,10067394495
4603,108772690,51353359,160126049,4,0,0,66048,2,1683061835
4604,108779900,82808116,191588016,3,0,1,7168,3,5151487852
4605,108780990,51393652,160174642,4,0,0,159232,2,2061484159
4606,108797520,51849400,160646920,4,0,0,682496,2,1119912829
4607,108809200,82780408,191589608,7,0,1,9216,16,6656148298
4608,108819880,82786836,191606716,2,0,1,37376,4,2841792072
4609,108838160,82770502,191608662,5,0,1,3072,11,10587683962
4610,108839720,82787161,191626881,3,0,1,48640,3,4023294609
4611,108865119,82778977,191644096,4,0,1,9216,2,9535111504
4612,108879830,82815034,191694864,2,0,1,102400,4,6840339691
4613,108906851,82793198,191700049,9,0,1,16384,17,3035317502
4614,108907500,51807069,160714569,1,0,0,133120,5,1046130592
4615,108937241,51147151,160084392,2,0,0,52224,4,1622315495
4616,108945609,82765728,191711337,4,0,1,35840,2,8558833195
4617,108953071,82762854,191715925,9,0,1,10240,17,4792139933
4618,109007221,82730878,191738099,9,0,1,13312,17,9743560016
4619,109008620,82735278,191743898,3,0,1,19456,3,8196288977
4620,109021809,82728093,191749902,4,0,1,19968,2,6723304873
4621,109139601,82612567,191752168,9,0,1,3584,17,10654121638
4622,109143990,82609484,191753474,7,0,1,2048,16,2851242247
4623,109145621,51256820,160402441,2,0,0,13824,4,8271146916
4624,109150420,51523566,160673986,1,0,0,88576,5,9234346676
4625,109182610,82744449,191927059,5,0,1,27136,11,6271977625
4626,109200070,82727012,191927082,7,0,1,32768,16,7037308212
4627,109200090,82727015,191927105,2,0,1,65536,4,4260321161
4628,109202080,82725048,191927128,5,0,1,19968,11,2661273364
4629,109204650,83299374,192504024,2,0,1,750080,4,3438481595
4630,109239051,83273691,192512742,9,0,1,10240,17,9230375146
4631,109282019,83231576,192513595,4,0,1,18432,2,10343759242
4632,109286720,83327380,192614100,7,0,1,4608,16,6415810615
4633,109317331,51448934,160766265,2,0,0,141312,4,3613632603
4634,109323250,83290873,192614123,7,0,1,62976,16,8021161366
4635,109420800,83193346,192614146,3,0,1,512,3,1621254051
4636,109457760,83156409,192614169,3,0,1,3072,3,6514854208
4637,109480400,83133792,192614192,5,0,1,8704,11,4281356739
4638,109490150,51458564,160948714,7,0,0,89088,16,7312102814
4639,109515260,51708976,161224236,7,0,0,137728,16,2671098345
4640,109522621,83091594,192614215,9,0,1,10240,17,3980918876
4641,109554929,51335545,160890474,5,0,0,16384,11,3847326126
4642,109560530,51557854,161118384,1,0,0,67584,5,1135733717
4643,109562910,51494715,161057625,7,0,0,357376,16,2879751261
4644,109600240,83013998,192614238,7,0,1,13824,16,5958829786
4645,109609970,51458130,161068100,6,0,0,34304,7,10438763256
4646,109610090,83004171,192614261,3,0,1,17408,3,3580817818
4647,109646230,51782312,161428542,4,0,0,166912,2,4201670315
4648,109675000,52010870,161685870,4,0,0,163328,2,7041438934
4649,109677391,82939200,192616591,9,0,1,9216,17,7981631109
4650,109726070,52082526,161808596,1,0,0,270336,5,6994865987
4651,109757630,51954799,161712429,4,0,0,87040,2,1225290877
4652,109770130,51855634,161625764,4,0,0,238080,2,6960649898
4653,109795330,82840155,192635485,7,0,1,23552,16,3382478546
4654,109834149,82813079,192647228,4,0,1,16384,2,1504177936
4655,109843700,51792383,161636083,7,0,0,33792,16,8994794784
4656,109891990,51972474,161864464,6,0,0,67072,7,5730043501
4657,109909839,82738055,192647894,4,0,1,1024,2,3998057311
4658,109914340,51557861,161472201,1,0,0,39936,5,1147300529
4659,109921899,82731141,192653040,4,0,1,8192,2,10685630634
4660,109936969,82733355,192670324,4,0,1,24064,2,5951026492
4661,109972230,52250673,162222903,4,0,0,310272,2,1328465912
4662,110002170,82672340,192674510,2,0,1,6656,4,9913874911
4663,110006889,82667877,192674766,4,0,1,9216,2,6502310871
4664,110027080,82648404,192675484,3,0,1,19456,3,10077423078
4665,110032030,52335964,162367994,7,0,0,95232,16,7114893186
4666,110047741,51765870,161813611,2,0,0,16384,4,2590550690
4667,110048790,82635801,192684591,2,0,1,19968,4,3768261176
4668,110072551,82612357,192684908,9,0,1,9216,17,2759679333
4669,110074860,84829951,194904811,2,0,1,913920,4,10305735687
4670,110079160,52001615,162080775,7,0,0,5120,16,8142464742
4671,110215380,52307206,162522586,1,0,0,223232,5,2159318993
4672,110223359,84681475,194904834,4,0,1,3072,2,2665194010
4673,110226271,84678586,194904857,9,0,1,9728,17,10622718057
4674,110234780,52150812,162385592,1,0,0,3584,5,9564357835
4675,110239619,84665261,194904880,4,0,1,4096,2,4859314854
4676,110256921,84701874,194958795,9,0,1,138240,17,1793957550
4677,110258871,52274681,162533552,2,0,0,35840,4,8144566213
4678,110260050,84730735,194990785,6,0,1,41472,7,1721172286
4679,110301910,84708785,195010695,7,0,1,46080,16,2656167094
4680,110311510,84707585,195019095,7,0,1,17920,16,604143529
4681,110345290,52603683,162948973,1,0,0,331264,5,7800015672
4682,110365280,84654161,195019441,7,0,1,512,16,1127884533
4683,110374710,84790301,195165011,2,0,1,309760,4,1799965581
4684,110378650,52695257,163073907,4,0,0,40448,2,2121018065
4685,110415100,84755608,195170708,7,0,1,18944,16,6291320462
4686,110455701,84743268,195198969,9,0,1,26112,17,8404800339
4687,110525830,84674765,195200595,3,0,1,2560,3,8560207115
4688,110549130,52851384,163400514,1,0,0,160256,5,6949314642
4689,110594370,84621845,195216215,7,0,1,20480,16,8953878165
4690,110614120,52337395,162951515,6,0,0,8192,7,6277527319
4691,110658130,52295615,162953745,6,0,0,7168,7,3095436483
4692,110680140,84536946,195217086,7,0,1,12288,16,4137754097
4693,110680660,84551914,195232574,2,0,1,6656,4,1158022745
4694,110683780,52998514,163682294,1,0,0,464896,5,9799526785
4695,110719909,84515251,195235160,4,0,1,4096,2,2138026375
4696,110721210,52594086,163315296,1,0,0,10240,5,9198029194
4697,110742860,84492556,195235416,3,0,1,9216,3,3820214142
4698,110795570,84484840,195280410,3,0,1,3584,3,1708215223
4699,110852540,84430456,195282996,3,0,1,4096,3,6137191178
4700,110953831,84329524,195283355,9,0,1,9728,17,9198052256
4701,110964210,52576413,163540623,1,0,0,263680,5,247811825
4702,110966159,84339821,195305980,4,0,1,23040,2,4071662463
4703,110987060,84449682,195436742,2,0,1,81920,4,3868014606
4704,111076429,84360336,195436765,4,0,1,9216,2,5410772438
4705,111086960,84349828,195436788,7,0,1,4608,16,4116866877
4706,111104080,84341912,195445992,7,0,1,29184,16,9297082905
4707,111165799,84283419,195449218,4,0,1,5120,2,9091539940
4708,111175490,84486668,195662158,2,0,1,110592,4,6608411491
4709,111195560,84934956,196130516,3,0,1,32256,3,4717094291
4710,111219680,53059426,164279106,1,0,0,240128,5,1574514423
4711,111225480,84906342,196131822,7,0,1,2048,16,3412256799
4712,111246100,84886388,196132488,3,0,1,1024,3,1049718840
4713,111274260,85655323,196929583,2,0,1,473088,4,1843250352
4714,111276950,85653939,196930889,7,0,1,2048,16,5226572008
4715,111280330,85660117,196940447,2,0,1,20480,4,8576732975
4716,111322490,52762393,164084883,1,0,0,7680,5,5933032780
4717,111403960,85644474,197048434,2,0,1,211968,4,3810091064
4718,111419380,85652365,197071745,7,0,1,11264,16,2348426011
4719,111443300,53344148,164787448,6,0,0,117248,7,417957384
4720,111453940,53021277,164475217,1,0,0,202752,5,10673167438
4721,111484970,52796187,164281157,4,0,0,6656,2,7190163718
4722,111532650,53109087,164641737,7,0,0,193536,16,7924007973
4723,111552761,53335821,164888582,2,0,0,331776,4,2330028114
4724,111589450,85547253,197136703,7,0,1,35328,16,10258999074
4725,111618910,85517816,197136726,7,0,1,24576,16,2775819588
4726,111647570,52456764,164104334,4,0,0,6144,2,1027269695
4727,111648040,53428717,165076757,1,0,0,271872,5,9459531265
4728,111679400,85457349,197136749,3,0,1,29184,3,8382579809
4729,111697630,85439142,197136772,6,0,1,11776,7,900860984
4730,111698090,85474534,197172624,3,0,1,59392,3,10474152937
4731,111700640,85472498,197173138,7,0,1,19456,16,6778416679
4732,111702720,53266697,164969417,4,0,0,80896,2,3522927194
4733,111713510,85480853,197194363,3,0,1,22016,3,8448002235
4734,111723320,52837574,164560894,7,0,0,61952,16,4089473206
4735,111774420,53767091,165541511,4,0,0,160768,2,3824463427
4736,111787280,53609722,165397002,6,0,0,44544,7,5182753958
4737,111829281,53159971,164989252,2,0,0,65024,4,4659569832
4738,111863530,52813626,164677156,6,0,0,10752,7,1831810528
4739,111864490,85463746,197328236,2,0,1,43008,4,5340714757
4740,111915280,53249767,165165047,7,0,0,54784,16,7328881790
4741,111959971,53423436,165383407,2,0,0,146432,4,7625882640
4742,111965210,52748150,164713360,1,0,0,40448,5,8117213254
4743,112021150,85440934,197462084,7,0,1,5632,16,6727352558
4744,112033210,85428897,197462107,6,0,1,4096,7,4932166388
4745,112037871,53136435,165174306,2,0,0,10752,4,4113005726
4746,112062350,85490955,197553305,7,0,1,14336,16,443343144
4747,112102200,85452731,197554931,7,0,1,2560,16,6184493813
4748,112217600,85337677,197555277,3,0,1,512,3,501265704
4749,112278500,85279363,197557863,7,0,1,4096,16,6409519582
4750,112289751,53628438,165918189,2,0,0,107520,4,3097068288
4751,112296250,53415561,165711811,6,0,0,317952,7,6887094954
4752,112313600,85251548,197565148,3,0,1,34816,3,3493241968
4753,112321010,53017758,165338768,6,0,0,165376,7,4744321382
4754,112326660,53558700,165885360,6,0,0,267264,7,8553825425
4755,112331510,85239213,197570723,7,0,1,4608,16,10180853600
4756,112349660,85248542,197598202,6,0,1,27136,7,10207873465
4757,112368350,85339907,197708257,3,0,1,31744,3,2200365179
4758,112373370,53056873,165430243,4,0,0,47104,2,1280284480
4759,112387950,85605111,197993061,6,0,1,9216,7,905728695
4760,112391120,86166881,198558001,2,0,1,285696,4,6938340184
4761,112447510,86123828,198571338,2,0,1,64000,4,10078973924
4762,112448160,53782896,166231056,1,0,0,371200,5,9909148650
4763,112460260,53476874,165937134,3,0,0,24576,3,6744624470
4764,112462620,53566098,166028718,6,0,0,106496,7,4709600020
4765,112498100,53431500,165929600,3,0,0,37376,3,3806608743
4766,112511540,53849071,166360611,4,0,0,131072,2,10255439224
4767,112535900,53784659,166320559,4,0,0,20480,2,41038960
4768,112575350,53030771,165606121,3,0,0,73728,3,2053396491
4769,112587910,85983451,198571361,6,0,1,5120,7,4256946941
4770,112600181,85971203,198571384,6,0,1,8192,7,578454853
4771,112606200,85965207,198571407,3,0,1,12288,3,3255727713
4772,112639910,85931520,198571430,7,0,1,6144,16,4557328784
4773,112641761,85929692,198571453,6,0,1,41472,7,1793398091
4774,112666340,85960056,198626396,2,0,1,73728,4,3332822494
4775,112672660,85953759,198626419,7,0,1,6656,16,6413314586
4776,112692650,85939313,198631963,8,0,1,18432,2,6817225863
4777,112702430,53751839,166454269,7,0,0,140800,16,4970056523
4778,112704210,85934638,198638848,7,0,1,20992,16,6045026262
4779,112712370,53601903,166314273,1,0,0,272896,5,1233688081
4780,112752980,53817780,166570760,6,0,0,51712,7,10583095424
4781,112759551,85884686,198644237,6,0,1,17408,7,5370486203
4782,112760810,85908966,198669776,8,0,1,44544,2,1460886546
4783,112760960,54200814,166961774,6,0,0,27136,7,1943880558
4784,112783480,85900106,198683586,7,0,1,29184,16,6188109078
4785,112817910,54038228,166856138,6,0,0,271360,7,1169366751
4786,112850489,85840829,198691318,4,0,1,12288,2,2536995445
4787,112886411,85831164,198717575,6,0,1,17920,7,6285756132
4788,112889500,85828741,198718241,3,0,1,1024,3,4860882842
4789,112939091,85780021,198719112,6,0,1,12288,7,7143403490
4790,112941000,85789953,198730953,8,0,1,10240,2,2611145900
4791,112943270,85802948,198746218,7,0,1,33280,16,4633722839
4792,112995140,53687144,166682284,1,0,0,276992,5,9607845930
4793,113093100,53860383,166953483,4,0,0,160768,2,6660233024
4794,113098700,85664494,198763194,8,0,1,11776,2,568089011
4795,113108010,85660330,198768340,3,0,1,8192,3,4069019114
4796,113119500,86149664,199269164,2,0,1,194560,4,2465642532
4797,113125650,86170112,199295762,3,0,1,36864,3,7155984728
4798,113133140,86162645,199295785,7,0,1,512,16,8825651640
4799,113136609,86159378,199295987,4,0,1,49664,2,3790712340
4800,113156781,86196902,199353683,6,0,1,4096,7,6861160578
4801,113159200,86194506,199353706,7,0,1,7168,16,4549012409
4802,113178330,54270228,167448558,4,0,0,332800,2,2751177906
4803,113187110,54046430,167233540,1,0,0,97792,5,6264512985
4804,113251710,53824600,167076310,1,0,0,182784,5,10631218938
4805,113275920,86078300,199354220,7,0,1,22528,16,5725364763
4806,113277230,53597173,166874403,6,0,0,27136,7,8904823078
4807,113299630,86677333,199976963,2,0,1,194560,4,6494605139
4808,113313820,86663166,199976986,7,0,1,9728,16,76477563
4809,113338570,86638439,199977009,8,0,1,14336,2,10162455463
4810,113365081,86611951,199977032,6,0,1,28160,7,9880083335
4811,113374270,53726867,167101137,4,0,0,81408,2,3948917529
4812,113388260,54075164,167463424,4,0,0,48640,2,2116263764
4813,113415319,86561736,199977055,0,0,1,4096,10,10026707449
4814,113415320,54226162,167641482,1,0,0,515584,5,6836992567
4815,113421491,86555587,199977078,6,0,1,4608,7,7427352867
4816,113422390,53435175,166857565,1,0,0,4608,5,4179839537
4817,113427580,54299403,167726983,6,0,0,280064,7,6356297315
4818,113433570,86543531,199977101,2,0,1,17408,4,4146070768
4819,113435611,54048740,167484351,2,0,0,68608,4,8731285631
4820,113439051,54355540,167794591,2,0,0,87040,4,9075923120
4821,113450050,54299264,167749314,4,0,0,73216,2,1823463734
4822,113465950,86511174,199977124,8,0,1,8704,2,9607171766
4823,113476930,86501020,199977950,7,0,1,16896,16,10434350417
4824,113484209,86493764,199977973,0,0,1,7168,10,4108851307
4825,113487870,86490126,199977996,3,0,1,13824,3,7518926371
4826,113498370,86479649,199978019,3,0,1,15360,3,8766074325
4827,113511570,54256432,167768002,4,0,0,60928,2,42111440
4828,113512280,86509849,200022129,2,0,1,16896,4,8237682302
4829,113515051,86507101,200022152,6,0,1,22528,7,6375325793
4830,113524429,86500855,200025284,0,0,1,36352,10,8109167813
4831,113537260,86494156,200031416,8,0,1,9728,2,9931945650
4832,113552560,86504061,200056621,8,0,1,32768,2,41026316
4833,113576580,54537396,168113976,3,0,0,338944,3,10214261541
4834,113580990,86531573,200112563,7,0,1,4608,16,8173830136
4835,113607740,86521873,200129613,8,0,1,35328,2,5809465258
4836,113607780,86521856,200129636,8,0,1,23552,2,5404967391
4837,113617860,54244298,167862158,3,0,0,66048,3,2308653278
4838,113625780,86503879,200129659,2,0,1,4096,4,9895736054
4839,113640090,86489592,200129682,8,0,1,12288,2,8717251778
4840,113640690,54490313,168131003,4,0,0,55808,2,8546342961
4841,113643550,54936096,168579646,4,0,0,480256,2,4977966392
4842,113653330,54549238,168202568,4,0,0,116224,2,5896685590
4843,113657950,86471755,200129705,3,0,1,13312,3,8071944166
4844,113666390,86463338,200129728,2,0,1,34304,4,4906764612
4845,113693940,86435811,200129751,8,0,1,2048,2,3616702195
4846,113713681,54901735,168615416,2,0,0,19968,4,6385023322
4847,113720320,55228627,168948947,4,0,0,267264,2,6427027576
4848,113743130,86386644,200129774,3,0,1,26112,3,6637183242
4849,113750540,86384854,200135394,3,0,1,6144,3,897086359
4850,113772620,54602762,168375382,4,0,0,5632,2,3407642967
4851,113794669,86343311,200137980,0,0,1,4096,10,2376068914
4852,113805200,54804109,168609309,1,0,0,97280,5,10661929181
4853,113816310,54874798,168691108,1,0,0,134144,5,264350005
4854,113822020,86316728,200138748,3,0,1,11776,3,2649124763
4855,113846260,55326662,169172922,6,0,0,337920,7,6090712733
4856,113857221,86302392,200159613,6,0,1,22016,7,5614262285
4857,113872380,86367206,200239586,2,0,1,36352,4,31332833
4858,113879650,55190289,169069939,7,0,0,396800,16,6234154419
4859,113880779,86402706,200283485,0,0,1,17408,10,10554585319
4860,113915970,86373212,200289182,7,0,1,18944,16,2127301465
4861,113924960,54772411,168697371,3,0,0,20480,3,9153840137
4862,113935230,86373179,200308409,3,0,1,9728,3,5552435363
4863,113967150,86357063,200324213,7,0,1,13312,16,3235700592
4864,113976580,54659139,168635719,3,0,0,66560,3,795737909
4865,113982110,55234094,169216204,6,0,0,141824,7,8766469645
4866,113990951,55345918,169336869,2,0,0,360448,4,5913721932
4867,114023560,86305398,200328958,3,0,1,7168,3,7200269691
4868,114033931,55346025,169379956,2,0,0,141312,4,8081674604
4869,114138590,86350865,200489455,7,0,1,38400,16,2567054555
4870,114191880,55279070,169470950,7,0,0,84480,16,6232184136
4871,114215660,55011339,169226999,4,0,0,35328,2,3223464413
4872,114256310,86435266,200691576,7,0,1,33792,16,9523800179
4873,114270930,86432882,200703812,8,0,1,6144,2,7132266348
4874,114272310,55146529,169418839,4,0,0,127488,2,2708004221
4875,114284531,86451323,200735854,6,0,1,19968,7,6010824959
4876,114309710,55252436,169562146,6,0,0,188416,7,8042733255
4877,114341771,86507114,200848885,6,0,1,23552,7,9143369450
4878,114344390,86635948,200980338,3,0,1,42496,3,9067381441
4879,114385360,55119309,169504669,3,0,0,110592,3,4981727750
4880,114392210,86592506,200984716,8,0,1,12800,2,6909871242
4881,114399830,86690900,201090730,2,0,1,35840,4,817685436
4882,114414260,86795116,201209376,8,0,1,21504,2,5308621231
4883,114417730,55194884,169612614,4,0,0,71680,2,2205044577
4884,114425610,86783789,201209399,7,0,1,8704,16,231605866
4885,114465420,55344603,169810023,6,0,0,125952,7,5404504717
4886,114566070,86654451,201220521,7,0,1,17920,16,8368255873
4887,114584570,86635974,201220544,8,0,1,25600,2,10141205696
4888,114598400,55407106,170005506,4,0,0,249856,2,7819245704
4889,114627121,86672249,201299370,6,0,1,29696,7,7583526290
4890,114658810,86640583,201299393,8,0,1,4608,2,2900128057
4891,114715321,55395044,170110365,2,0,0,228352,4,5744251002
4892,114719470,86582777,201302247,8,0,1,17920,2,7401380549
4893,114747739,86554531,201302270,0,0,1,12288,10,7818406589
4894,114757940,55065210,169823150,1,0,0,43008,5,9991303515
4895,114803470,55480251,170283721,3,0,0,212480,3,9615551936
4896,114921831,55856580,170778411,2,0,0,709120,4,8654798232
4897,114933289,86431115,201364404,0,0,1,10752,10,7818419377
4898,114956390,55262568,170218958,7,0,0,116736,16,7710716814
4899,114967380,86397047,201364427,6,0,1,17920,7,5982873365
4900,115020889,86343561,201364450,0,0,1,7680,10,1642260798
4901,115056739,86307734,201364473,0,0,1,2560,10,1782210283
4902,115062080,55724200,170786280,6,0,0,25600,7,5502479476
4903,115072550,86390740,201463290,7,0,1,32256,16,5659122003
4904,115127500,55873247,171000747,7,0,0,225792,16,472280012
4905,115139979,86323334,201463313,0,0,1,10240,10,816749617
4906,115181290,55750630,170931920,6,0,0,420352,7,1211040734
4907,115211480,86251856,201463336,6,0,1,17920,7,7185768948
4908,115222820,55580955,170803775,7,0,0,57344,16,6032278401
4909,115257049,86206310,201463359,0,0,1,7168,10,4817166554
4910,115257510,86205936,201463446,8,0,1,96768,2,5941534500
4911,115280060,55765503,171045563,4,0,0,138752,2,893497461
4912,115309370,55765168,171074538,3,0,0,94720,3,8632888708
4913,115319881,86154984,201474865,6,0,1,38400,7,1028462528
4914,115321349,86161990,201483339,0,0,1,13824,10,2301693885
4915,115322800,86192985,201515785,7,0,1,5632,16,1177177686
4916,115323291,56070455,171393746,2,0,0,236032,4,6755866205
4917,115324250,55679014,171003264,7,0,0,7680,16,1589532586
4918,115328290,56343291,171671581,7,0,0,422400,16,8396379300
4919,115335269,86186131,201521400,0,0,1,8192,10,2489135909
4920,115343031,86266052,201609083,9,0,1,18432,17,8402518670
4921,115346840,86262266,201609106,6,0,1,3072,7,6976330968
4922,115379550,55906436,171285986,7,0,0,10752,16,1301488911
4923,115466560,86151927,201618487,7,0,1,49152,16,2340172681
4924,115472710,55981382,171454092,1,0,0,23040,5,3565615411
4925,115476070,86332841,201808911,6,0,1,114176,7,7437867542
4926,115478699,86330235,201808934,0,0,1,2048,10,9411411375
4927,115507010,86302282,201809292,7,0,1,27648,16,724282278
4928,115550701,55880552,171431253,2,0,0,45056,4,7812548190
4929,115580970,86228345,201809315,7,0,1,19968,16,5150519451
4930,115692380,86116958,201809338,8,0,1,13824,2,6717560418
4931,115695240,55699557,171394797,6,0,0,3072,7,10017079043
4932,115706000,86112102,201818102,8,0,1,10240,2,2453273838
4933,115723369,86095399,201818768,0,0,1,1024,10,10328296407
4934,115771990,86074622,201846612,8,0,1,46080,2,4689966080
4935,115816220,86030415,201846635,8,0,1,512,2,3174624092
4936,115840100,55702758,171542858,7,0,0,125952,16,9645406186
4937,115844650,55835074,171679724,3,0,0,26624,3,8023182254
4938,115877190,85993518,201870708,8,0,1,28160,2,998645338
4939,115895680,55876606,171772286,4,0,0,303616,2,187988102
4940,115902140,55600837,171502977,6,0,0,512,7,2837058771
4941,115987710,56051252,172038962,4,0,0,56320,2,3480985208
4942,116027150,86081211,202108361,6,0,1,78336,7,3690284181
4943,116038220,86074647,202112867,6,0,1,7168,7,6876829988
4944,116060519,86275851,202336370,0,0,1,10240,10,4141802862
4945,116110459,86590734,202701193,0,0,1,97792,10,2380670638
4946,116148170,56296320,172444490,4,0,0,210432,2,7743543031
4947,116267421,55690403,171957824,2,0,0,219648,4,634525729
4948,116285330,55210500,171495830,6,0,0,1536,7,7441863981
4949,116314629,86386587,202701216,0,0,1,5120,10,905437833
4950,116317041,55951571,172268612,2,0,0,183808,4,8811609092
4951,116367390,86344755,202712145,8,0,1,45056,2,7742774903
4952,116430640,86325673,202756313,6,0,1,15872,7,4965268471
4953,116435140,86324908,202760048,6,0,1,19456,7,8519879004
4954,116531349,86233525,202764874,0,0,1,7680,10,2275262987
4955,116588529,55413670,172002199,8,0,0,86528,2,4987910122
4956,116588549,86181164,202769713,0,0,1,18944,10,395380692
4957,116609310,86394317,203003627,8,0,1,25088,2,3986074985
4958,116644799,55693945,172338744,8,0,0,101888,2,8343010837
4959,116698609,55094768,171793377,8,0,0,69120,2,5641223377
4960,116699310,55777853,172477163,3,0,0,26624,3,4573653005
4961,116711591,55133795,171845386,2,0,0,2048,4,7083746011
4962,116748121,55720884,172469005,2,0,0,80384,4,4181002845
4963,116833460,86170190,203003650,8,0,1,3072,2,6897662014
4964,116864371,55219008,172083379,2,0,0,99328,4,10251836471
4965,116918300,55831810,172750110,3,0,0,575488,3,4700174717
4966,116922680,86106132,203028812,6,0,1,27136,7,8396188031
4967,116923659,86105176,203028835,0,0,1,512,10,10381854228
4968,116936469,86136264,203072733,0,0,1,52224,10,5054523017
4969,116941550,55633193,172574743,1,0,0,77312,5,2012027972
4970,116961111,55829324,172790435,2,0,0,126464,4,6749711535
4971,116964420,86108352,203072772,6,0,1,4096,7,4249656030
4972,116967710,86105085,203072795,8,0,1,6656,2,919035986
4973,116970790,55781090,172751880,6,0,0,5632,7,2167492538
4974,116970930,55506724,172477654,6,0,0,1536,7,6085712502
4975,116976539,86097813,203074352,4,0,1,17920,2,4337911084
4976,116997280,55551561,172548841,6,0,0,14336,7,8222482265
4977,117009630,55799080,172808710,4,0,0,59904,2,583526180
4978,117057130,86027426,203084556,6,0,1,5632,7,7192504253
4979,117102560,55939939,173042499,4,0,0,178688,2,10462996782
4980,117137899,56162354,173300253,8,0,0,403456,2,7408761137
4981,117162740,56152980,173315720,7,0,0,50688,16,433738505
4982,117174110,85911726,203085836,6,0,1,14336,7,2664612190
4983,117185140,85970058,203155198,8,0,1,7168,2,2176548728
4984,117252140,55874083,173126223,3,0,0,109568,3,7024683645
4985,117268699,85886522,203155221,4,0,1,5120,2,9274729821
4986,117277939,85877305,203155244,4,0,1,33280,2,369694990
4987,117280009,85879924,203159933,4,0,1,12800,2,8726254142
4988,117317510,56934270,174251780,7,0,0,96256,16,6230319884
4989,117355479,85815433,203170912,4,0,1,11776,2,2281089043
4990,117378179,85793604,203171783,0,0,1,12288,10,10287484542
4991,117385210,56064356,173449566,7,0,0,311296,16,1858328178
4992,117388780,56659972,174048752,1,0,0,191488,5,8513210420
4993,117447840,85725428,203173268,8,0,1,15360,2,3485870907
4994,117451270,56116701,173567971,7,0,0,260608,16,40833352
4995,117461560,85777694,203239254,3,0,1,3072,3,3102956282
4996,117489741,56279704,173769445,2,0,0,209920,4,8054090190
4997,117505740,85733537,203239277,6,0,1,5120,7,3029007017
4998,117530110,85709190,203239300,6,0,1,13824,7,3416339577
4999,117559021,56872610,174431631,2,0,0,205312,4,2112187512
5000,117566900,85674796,203241696,3,0,1,4608,3,9414984727
5001,117601999,85640683,203242682,4,0,1,1536,2,3516181036
5002,117606409,56939061,174545470,8,0,0,223744,2,5365160268
5003,117614530,85630994,203245524,6,0,1,13312,7,1923089294
5004,117618590,55986220,173604810,1,0,0,120832,5,4051911625
5005,117637369,57365861,175003230,8,0,0,869888,2,1803758467
5006,117637860,85608432,203246292,8,0,1,11776,2,9422228446
5007,117644590,85720203,203364793,3,0,1,39936,3,4368933922
5008,117647720,56940228,174587948,7,0,0,139264,16,2994173982
5009,117652380,85828145,203480525,6,0,1,55808,7,6049977741
5010,117660891,57390011,175050902,2,0,0,156160,4,8375079842
5011,117661810,85940529,203602339,6,0,1,34304,7,10391350748
5012,117680679,85987933,203668612,0,0,1,36352,10,3996184008
5013,117691110,56506393,174197503,7,0,0,101888,16,6639933444
5014,117730430,56728079,174458509,4,0,0,88064,2,6514677177
5015,117744650,85958320,203702970,8,0,1,22528,2,5436841725
5016,117746360,56891421,174637781,4,0,0,163328,2,10374059840
5017,117769780,85948927,203718707,8,0,1,9216,2,3902070769
5018,117797950,56454945,174252895,7,0,0,3584,16,604502434
5019,117808230,56929933,174738163,4,0,0,115200,2,1016654512
5020,117825109,85931087,203756196,4,0,1,14336,2,1461006844
5021,117848340,56364029,174212369,6,0,0,1024,7,318916921
5022,117850860,57314989,175165849,4,0,0,178176,2,2222062887
5023,117853789,86047550,203901339,4,0,1,36352,2,1808280468
5024,117855009,86046353,203901362,4,0,1,12800,2,5639014526
5025,117855710,86045675,203901385,8,0,1,3584,2,10398293103
5026,117856641,57466060,175322701,2,0,0,141312,4,409032628
5027,117870110,56772694,174642804,4,0,0,16384,2,9944575226
5028,117878829,57561376,175440205,8,0,0,311808,2,730778488
5029,117883850,86658024,204541874,6,0,1,82944,7,5180961511
5030,117941559,86600338,204541897,0,0,1,15872,10,7593518472
5031,117987970,86554129,204542099,6,0,1,23040,7,8863034009
5032,117994870,86547252,204542122,6,0,1,24064,7,5792842346
5033,117996630,86545515,204542145,6,0,1,12800,7,1731805990
5034,118016900,86611759,204628659,6,0,1,23040,7,9619531113
5035,118032351,57039010,175071361,2,0,0,67072,4,2574204893
5036,118248520,57081067,175329587,7,0,0,22016,16,5127748179
5037,118294829,86406110,204700939,0,0,1,4096,10,2664667827
5038,118303660,56805164,175108824,7,0,0,122880,16,7678658849
5039,118311840,56958465,175270305,7,0,0,270336,16,2448862798
5040,118322330,56789169,175111499,1,0,0,8704,5,1751685050
5041,118398379,86302583,204700962,0,0,1,8704,10,9017043785
5042,118474729,86457311,204932040,4,0,1,41472,2,8088515603
5043,118502419,86429644,204932063,0,0,1,512,10,10517592738
5044,118511140,86420946,204932086,6,0,1,11264,7,7219596238
5045,118532370,86399739,204932109,6,0,1,30720,7,6374240392
5046,118563471,56624397,175187868,2,0,0,72192,4,6660447406
5047,118591409,86343710,204935119,4,0,1,16896,2,5888055687
5048,118612610,86322711,204935321,6,0,1,55808,7,4470464479
5049,118633720,56643447,175277167,7,0,0,22016,16,1008039458
5050,118655039,86280305,204935344,4,0,1,20992,2,7198068676
5051,118662320,57771942,176434262,7,0,0,1222144,16,5116414744
5052,118680709,86257489,204938198,0,0,1,22016,10,8438842965
5053,118683360,57820524,176503884,1,0,0,228352,5,3423343830
5054,118722051,56557548,175279599,2,0,0,7680,4,2093635348
5055,118728209,86210012,204938221,0,0,1,16896,10,8643118250
5056,118752360,57802761,176555121,7,0,0,138240,16,6541294624
5057,118757139,86181105,204938244,4,0,1,36352,2,9809430312
5058,118784090,56986227,175770317,3,0,0,80384,3,5404434649
5059,118796710,57154585,175951295,3,0,0,48128,3,4957024478
5060,118796780,57987309,176784089,6,0,0,1536,7,6745258333
5061,118799919,86140579,204940498,0,0,1,16384,10,6685672992
5062,118808590,86131931,204940521,6,0,1,2560,7,6953184176
5063,118855419,86096332,204951751,4,0,1,40960,2,9233672087
5064,118914470,56856338,175770808,6,0,0,1536,7,8066371760
5065,118981730,86235884,205217614,6,0,1,23552,7,4028689178
5066,118982590,86235850,205218440,6,0,1,19968,7,4114975068
5067,118985740,57527238,176512978,3,0,0,23552,3,4197727364
5068,118995889,57805194,176801083,8,0,0,55296,2,9041434924
5069,119011759,86209691,205221450,4,0,1,43520,2,3190185609
5070,119056679,57726919,176783598,8,0,0,313344,2,919729265
5071,119109329,86112144,205221473,4,0,1,5120,2,3131885479
5072,119116280,86107111,205223391,7,0,1,112640,16,4650722310
5073,119122740,57383039,176505779,6,0,0,6144,7,4513012753
5074,119143609,57544494,176688103,8,0,0,287232,2,10191162217
5075,119156559,86066855,205223414,0,0,1,5632,10,2659528339
5076,119173840,86049932,205223772,6,0,1,7168,7,7662957447
5077,119186610,57673175,176859785,4,0,0,192512,2,4629599194
5078,119198350,86025445,205223795,6,0,1,3072,7,4818662322
5079,119202299,86024662,205226961,4,0,1,45568,2,6222944178
5080,119210130,86016854,205226984,8,0,1,8192,2,5562709038
5081,119232080,57368460,176600540,7,0,0,148992,16,9498050047
5082,119237940,85992545,205230485,8,0,1,11776,2,3539160276
5083,119270169,57779722,177049891,8,0,0,290304,2,5648306711
5084,119272129,85958379,205230508,4,0,1,12800,2,68187635
5085,119274330,57815864,177090194,7,0,0,132096,16,10643557170
5086,119307480,85923051,205230531,8,0,1,8704,2,7687476704
5087,119307580,57649946,176957526,3,0,0,286208,3,10217975792
5088,119323730,85906824,205230554,6,0,1,7168,7,10018236333
5089,119326040,86319249,205645289,7,0,1,165888,16,3988454358
5090,119339300,57530999,176870299,1,0,0,34304,5,1974471725
5091,119341789,86407618,205749407,0,0,1,33280,10,8583419087
5092,119343349,86409924,205753273,4,0,1,6144,2,529841023
5093,119356320,57754177,177110497,7,0,0,66560,16,9083984557
5094,119358840,57602576,176961416,7,0,0,12288,16,9430544768
5095,119383150,86383650,205766800,8,0,1,10240,2,5477217651
5096,119388271,58239808,177628079,2,0,0,133632,4,8446205454
5097,119404251,58128380,177532631,2,0,0,27648,4,3832089359
5098,119411410,58000681,177412091,4,0,0,7168,2,1800084068
5099,119424239,86359681,205783920,0,0,1,12288,10,688184471
5100,119435801,57974083,177409884,2,0,0,417280,4,1874148875
5101,119453900,57824048,177277948,4,0,0,18944,2,7371737813
5102,119465469,86617765,206083234,0,0,1,51712,10,5246654211
5103,119520929,58259349,177780278,8,0,0,140800,2,3234123432
5104,119523880,57588044,177111924,6,0,0,4608,7,5621766507
5105,119546540,58040800,177587340,3,0,0,169472,3,8872259956
5106,119550459,86659399,206209858,4,0,1,25600,2,6403100230
5107,119571470,58371594,177943064,1,0,0,290816,5,6899732839
5108,119581540,57929138,177510678,6,0,0,9216,7,7352031148
5109,119584579,86627197,206211776,4,0,1,20480,2,3026208365
5110,119594140,57820984,177415124,1,0,0,8704,5,4706513619
5111,119600071,58028655,177628726,2,0,0,2048,4,7195003811
5112,119633230,57779219,177412449,4,0,0,1024,2,8015021837
5113,119635999,86579590,206215589,0,0,1,17408,10,10582623053
5114,119656750,86608065,206264815,8,0,1,2048,2,5112475201
5115,119665670,86609489,206275159,8,0,1,31744,2,266287838
5116,119675650,57746228,177421878,4,0,0,1024,2,8589688169
5117,119708881,57712662,177421543,2,0,0,20992,4,5109105226
5118,119712259,86679242,206391501,0,0,1,18432,10,8607445850
5119,119722280,86669244,206391524,6,0,1,2560,7,4004348818
5120,119726720,58333050,178059770,1,0,0,47616,5,438026865
5121,119764371,57882741,177647112,2,0,0,43008,4,2947252348
5122,119795379,86596168,206391547,0,0,1,13824,10,4958241856
5123,119808600,57899315,177707915,6,0,0,43008,7,948700637
5124,119847320,86622356,206469676,6,0,1,52736,7,10131073037
5125,119894139,86575895,206470034,0,0,1,21504,10,3546049677
5126,119899489,86615740,206515229,4,0,1,60928,2,1077409211
5127,119921400,86726828,206648228,6,0,1,3584,7,7810618845
5128,119921850,86727048,206648898,6,0,1,6656,7,2203216861
5129,119927500,58319572,178247072,1,0,0,20992,5,8703362666
5130,119947320,86701601,206648921,8,0,1,11264,2,10500597137
5131,120019811,57653880,177673691,2,0,0,16384,4,6219747112
5132,120032040,58653764,178685804,3,0,0,367104,3,6858797383
5133,120035621,58091482,178127103,2,0,0,99840,4,6363410548
5134,120075520,58484966,178560486,6,0,0,186880,7,10674209507
5135,120111531,58919627,179031158,2,0,0,276992,4,8494416411
5136,120126150,57817249,177943399,4,0,0,1024,2,2757149996
5137,120129520,58703892,178833412,1,0,0,369152,5,3214422518
5138,120222610,58723937,178946547,1,0,0,364544,5,9674943559
5139,120268799,86380145,206648944,4,0,1,2560,2,9434791616
5140,120335540,58167983,178503523,1,0,0,136704,5,751968136
5141,120342039,86306928,206648967,4,0,1,26112,2,6851819870
5142,120363179,86286146,206649325,0,0,1,10240,10,5635301779
5143,120376700,86272648,206649348,3,0,1,5120,3,4231953225
5144,120398409,86251461,206649870,4,0,1,32256,2,9697282230
5145,120429969,86325134,206755103,0,0,1,23552,10,3917644703
5146,120437129,86317997,206755126,0,0,1,14848,10,1790666376
5147,120457530,86297619,206755149,3,0,1,30720,3,8271592550
5148,120459450,86295722,206755172,7,0,1,10240,16,8705251843
5149,120481559,86273636,206755195,4,0,1,57344,2,101582379
5150,120502950,86271287,206774237,7,0,1,39424,16,9168623737
5151,120514590,86272593,206787183,3,0,1,18432,3,7930975426
5152,120525410,58308741,178834151,4,0,0,2048,2,5430956373
5153,120568290,58267068,178835358,4,0,0,3584,2,3675596035
5154,120592949,86194273,206787222,0,0,1,6656,10,5070724592
5155,120623109,86177204,206800313,4,0,1,23552,2,7220504384
5156,120625310,86178229,206803539,6,0,1,5120,7,8724452878
5157,120642659,86167601,206810260,4,0,1,24064,2,9396909796
5158,120645460,86242263,206887723,3,0,1,102912,3,3817401093
5159,120687831,58348093,179035924,2,0,0,15360,4,1889966037
5160,120712000,58946813,179658813,1,0,0,211968,5,1025997337
5161,120739840,86203349,206943189,7,0,1,132608,16,1086676608
5162,120751900,86191955,206943855,3,0,1,1024,3,8759917912
5163,120753721,58563446,179317167,2,0,0,182784,4,448216052
5164,120769850,86262524,207032374,7,0,1,126464,16,3916185279
5165,120794180,58613678,179407858,1,0,0,45568,5,10493486159
5166,120817129,86246703,207063832,0,0,1,23552,10,2934842007
5167,120839659,86227399,207067058,0,0,1,5120,10,4575280681
5168,120857620,86230293,207087913,3,0,1,23552,3,8997592092
5169,120864390,58972785,179837175,1,0,0,316928,5,6367789462
5170,120869350,59047587,179916937,1,0,0,261632,5,3095129744
5171,120888570,86204489,207093059,6,0,1,8192,7,2596809449
5172,120903980,59015062,179919042,4,0,0,6656,2,10226039013
5173,120905401,58835179,179740580,2,0,0,268288,4,4964305334
5174,120917101,58279181,179196282,2,0,0,10752,4,3370003440
5175,120928470,59112736,180041206,3,0,0,360960,3,2148673377
5176,120949360,86152973,207102333,3,0,1,10752,3,6850683870
5177,120950670,58370230,179320900,4,0,0,5120,2,6561037213
5178,120962979,86144899,207107878,0,0,1,4096,10,1288908831
5179,120984530,86340597,207325127,6,0,1,39424,7,9505810486
5180,121039511,59096668,180136179,2,0,0,246784,4,896280013
5181,121085800,86301329,207387129,6,0,1,27648,7,1092378753
5182,121094300,86411323,207505623,3,0,1,5632,3,7358426832
5183,121114539,86391107,207505646,0,0,1,29696,10,9782775914
5184,121137190,58921846,180059036,1,0,0,58368,5,4883757718
5185,121182760,86324180,207506940,6,0,1,22528,7,134886704
5186,121200370,86323932,207524302,6,0,1,17920,7,490777069
5187,121236560,58924914,180161474,3,0,0,82944,3,7684695198
5188,121252110,58923739,180175849,1,0,0,47104,5,6955121172
5189,121260830,86279865,207540695,6,0,1,42496,7,6594595539
5190,121265460,58941620,180207080,3,0,0,102400,3,1609332153
5191,121267410,58955160,180222570,6,0,0,50688,7,3493251694
5192,121313619,86231262,207544881,4,0,1,6656,2,3387673745
5193,121344510,86200730,207545240,3,0,1,9728,3,5430696936
5194,121357739,86320548,207678287,4,0,1,20480,2,9930755404
5195,121375739,86302571,207678310,4,0,1,8192,2,5128923168
5196,121387970,86290379,207678349,6,0,1,12800,7,4373154824
5197,121399690,58984144,180383834,1,0,0,191488,5,4187437010
5198,121430950,59006181,180437131,3,0,0,59392,3,10144328565
5199,121479520,86198852,207678372,6,0,1,11776,7,6551599688
5200,121534630,58525209,180059839,4,0,0,2560,2,5854192468
5201,121599189,86079206,207678395,4,0,1,20480,2,7896173045
5202,121599770,59061634,180661404,4,0,0,7168,2,6111087129
5203,121638549,86078112,207716661,4,0,1,14336,2,5792306308
5204,121668451,58990746,180659197,2,0,0,76288,4,7623437732
5205,121714810,59345806,181060616,1,0,0,249344,5,8697038493
5206,121729220,85987464,207716684,3,0,1,512,3,10343937046
5207,121775210,85941497,207716707,6,0,1,8704,7,9413040954
5208,121796460,59032106,180828566,4,0,0,3072,2,7920363037
5209,121827820,58674727,180502547,6,0,0,17408,7,822006915
5210,121837900,59605229,181443129,6,0,0,544768,7,7462125838
5211,121850109,85866621,207716730,4,0,1,7680,2,3177879155
5212,121914001,59696350,181610351,2,0,0,375296,4,7658018444
5213,121924609,85792144,207716753,4,0,1,76288,2,2888813894
5214,121928730,58820375,180749105,6,0,0,114688,7,4826940228
5215,121957790,59227572,181185362,4,0,0,3584,2,5851176856
5216,121979099,85737677,207716776,4,0,1,38912,2,7014572675
5217,121991970,59285106,181277076,1,0,0,180224,5,7624833691
5218,122035729,85681110,207716839,4,0,1,50176,2,290670590
5219,122036140,85681286,207717426,3,0,1,4608,3,9486719197
5220,122036360,85682244,207718604,3,0,1,13824,3,563338240
5221,122059780,59436200,181495980,3,0,0,38912,3,10012946450
5222,122072820,85650164,207722984,3,0,1,8704,3,3759754181
5223,122084970,85646955,207731925,6,0,1,3584,7,4586837570
5224,122128940,59355107,181484047,1,0,0,134144,5,1112369276
5225,122129760,85602831,207732591,3,0,1,11264,3,136057288
5226,122136299,85597918,207734217,4,0,1,2560,2,153897141
5227,122176150,59491032,181667182,1,0,0,186368,5,1769049367
5228,122229700,59633625,181863325,6,0,0,582144,7,1469723931
5229,122236650,59736330,181972980,6,0,0,242176,7,3607801149
5230,122284441,59614544,181898985,2,0,0,98816,4,5546544027
5231,122345690,85401649,207747339,3,0,1,40960,3,21676821
5232,122357460,85393638,207751098,3,0,1,17920,3,7821444920
5233,122363369,85406433,207769802,4,0,1,14336,2,10232103433
5234,122363879,85420208,207784087,4,0,1,25088,2,2979453436
5235,122395690,59273190,181668880,4,0,0,3584,2,8397588699
5236,122399089,85385021,207784110,4,0,1,26112,2,6529760006
5237,122413871,59267512,181681383,2,0,0,40960,4,8487601737
5238,122459220,85339133,207798353,3,0,1,2048,3,1325821923
5239,122482190,59386664,181868854,3,0,0,9728,3,4014738105
5240,122509641,59356226,181865867,2,0,0,8192,4,6807345629
5241,122527320,59158610,181685930,4,0,0,14848,2,4780085849
5242,122581420,85221145,207802565,3,0,1,6656,3,7432134963
5243,122602360,59065359,181667719,4,0,0,1536,2,2416304244
5244,122608720,85197711,207806431,5,0,1,6144,11,8926734733
5245,122624510,59349367,181973877,4,0,0,2560,2,10034129358
5246,122641039,85186297,207827336,4,0,1,23040,2,6320168458
5247,122664100,59323730,181987830,6,0,0,45568,7,10166397904
5248,122668490,85529965,208198455,7,0,1,652800,16,1699200284
5249,122728040,59270772,181998812,1,0,0,35840,5,727151259
5250,122736370,85488557,208224927,7,0,1,43520,16,9676154506
5251,122744990,59257292,182002282,4,0,0,10752,2,8991519716
5252,122787650,85664957,208452607,7,0,1,442880,16,5690393412
5253,122795220,85666817,208462037,3,0,1,7680,3,2815312314
5254,122815980,85721205,208537185,3,0,1,40448,3,2653581162
5255,122825210,59260244,182085454,4,0,0,2560,2,7243358591
5256,122880419,85687264,208567683,4,0,1,23040,2,10531873740
5257,122931760,59548449,182480209,3,0,0,176640,3,9614430940
5258,122958150,85622503,208580653,3,0,1,11264,3,1127111145
5259,122975249,85609276,208584525,4,0,1,5632,2,5636387913
5260,122982099,85603604,208585703,4,0,1,13824,2,7852210817
5261,122997951,59287697,182285648,2,0,0,206848,4,3094771438
5262,122998990,59661009,182659999,1,0,0,54784,5,9038974770
5263,123038270,85550339,208588609,3,0,1,4608,3,6528284681
5264,123045060,85570888,208615948,3,0,1,49664,3,4107219508
5265,123064220,59976185,183040405,6,0,0,591360,7,7882271189
5266,123067010,85563975,208630985,7,0,1,15360,16,1460163905
5267,123069979,85563912,208633891,4,0,1,4608,2,2923453550
5268,123080230,85555264,208635494,5,0,1,19456,11,5187552587
5269,123080710,85642357,208723067,7,0,1,146944,16,8257141113
5270,123085050,60380818,183465868,3,0,0,741888,3,1438391085
5271,123117380,85655220,208772600,3,0,1,58880,3,3739258338
5272,123131410,85723611,208855021,7,0,1,62976,16,10529415628
5273,123135410,59525080,182660490,4,0,0,1536,2,1531431968
5274,123173699,85681345,208855044,4,0,1,15360,2,10679100049
5275,123175379,85691992,208867371,4,0,1,16896,2,1131486302
5276,123217990,85654207,208872197,5,0,1,7680,11,7561056521
5277,123234300,85706016,208940316,3,0,1,110080,3,2366427983
5278,123252100,59968014,183220114,3,0,0,114176,3,8172448642
5279,123325430,59718141,183043571,6,0,0,10240,7,3125762205
5280,123327079,85655878,208982957,4,0,1,82944,2,5155886354
5281,123333870,85650393,208984263,5,0,1,2048,11,4196122269
5282,123400380,60086415,183486795,6,0,0,68608,7,2289589186
5283,123405110,85580331,208985441,5,0,1,13824,11,4362138712
5284,123407180,85611912,209019092,3,0,1,7680,3,245221275
5285,123432780,85747777,209180557,7,0,1,274944,16,4312760659
5286,123454930,59137357,182592287,1,0,0,7168,5,10014916518
5287,123481409,85707102,209188511,4,0,1,25088,2,3932255747
5288,123556610,59162373,182718983,1,0,0,44544,5,6679259185
5289,123573240,59517622,183090862,1,0,0,155136,5,6334334723
5290,123592730,85602519,209195249,3,0,1,7680,3,3555521112
5291,123612610,85596436,209209046,3,0,1,13312,3,8137891035
5292,123626890,85696438,209323328,7,0,1,122368,16,10131156531
5293,123632691,60019298,183651989,2,0,0,403456,4,10053597637
5294,123641069,85683079,209324148,0,0,1,19968,10,5688078760
5295,123653559,85930452,209584011,4,0,1,13312,2,117418954
5296,123658871,60016009,183674880,2,0,0,68096,4,1691785109
5297,123684889,85985203,209670092,4,0,1,13312,2,3601058216
5298,123697090,85977188,209674278,3,0,1,6656,3,6149733842
5299,123744449,86011230,209755679,4,0,1,20992,2,4949205637
5300,123750670,59362429,183113099,6,0,0,72704,7,5910346582
5301,123755000,60091201,183846201,3,0,0,259584,3,6953584877
5302,123757681,59756015,183513696,2,0,0,88064,4,2790091066
5303,123777620,86049194,209826814,3,0,1,33792,3,1799356320
5304,123781780,86117808,209899588,7,0,1,53760,16,4642310996
5305,123865710,59659397,183525107,3,0,0,37376,3,5460758609
5306,123918280,59812003,183730283,6,0,0,181760,7,7624855
5307,123960790,59693319,183654109,4,0,0,6656,2,8713708307
5308,123962350,59979548,183941898,6,0,0,87552,7,3767026835
5309,123981350,59902158,183883508,3,0,0,122368,3,6339363187
5310,124003450,86007417,210010867,3,0,1,43008,3,3940297120
5311,124046060,59685182,183731242,4,0,0,3072,2,3532298570
5312,124054560,86372058,210426618,7,0,1,280064,16,7388724482
5313,124060680,86556049,210616729,7,0,1,219136,16,10157361635
5314,124150541,59764658,183915199,2,0,0,103936,4,2113296078
5315,124175680,86441080,210616760,7,0,1,112640,16,7495656248
5316,124221570,86395213,210616783,3,0,1,23040,3,8431822180
5317,124229130,86406233,210635363,8,0,1,54272,2,3524717100
5318,124231700,86427868,210659568,7,0,1,41472,16,3778970976
5319,124235580,59904926,184140506,1,0,0,100864,5,9905408615
5320,124250400,60527880,184778280,6,0,0,323072,7,7335716905
5321,124273000,59718955,183991955,1,0,0,72704,5,10156804539
5322,124276730,86423042,210699772,3,0,1,8192,3,10376564406
5323,124276970,86429883,210706853,5,0,1,22528,11,6829260413
5324,124318390,59855518,184173908,3,0,0,43008,3,1159195968
5325,124322750,60332057,184654807,3,0,0,7168,3,1139145026
5326,124328120,60324480,184652600,1,0,0,502784,5,8660907278
5327,124372290,86342166,210714456,5,0,1,19456,11,3085616680
5328,124378960,86449732,210828692,3,0,1,187392,3,5328091941
5329,124388499,86452022,210840521,0,0,1,17408,10,8940723299
5330,124389241,60705667,185094908,2,0,0,157184,4,9649178283
5331,124408121,60491608,184899729,2,0,0,211456,4,5599410221
5332,124415540,60264273,184679813,6,0,0,81920,7,8594022825
5333,124430129,86425151,210855280,1,0,1,22016,5,7415066833
5334,124448130,60807739,185255869,6,0,0,117760,7,552982417
5335,124452590,60359409,184811999,3,0,0,110592,3,10713298387
5336,124459650,86446083,210905733,3,0,1,87552,3,5586983755
5337,124480950,60953749,185434699,6,0,0,315392,7,6895092907
5338,124529190,86401916,210931106,5,0,1,23040,11,6872660767
5339,124534360,86405823,210940183,3,0,1,22528,3,6547903187
5340,124565879,86379178,210945057,4,0,1,16896,2,5164316168
5341,124569730,60617399,185187129,6,0,0,63488,7,2704240419
5342,124578089,86371662,210949751,4,0,1,16896,2,4882424145
5343,124585290,86412886,210998176,2,0,1,35328,4,5007308275
5344,124597250,60433227,185030477,1,0,0,122880,5,622473132
5345,124600170,60553060,185153230,3,0,0,119296,3,1084766396
5346,124605910,86393239,210999149,3,0,1,12800,3,1996051166
5347,124617401,61150651,185768052,2,0,0,308224,4,2622663778
5348,124629460,86370253,210999713,3,0,1,10752,3,482690474
5349,124656709,86425777,211082486,4,0,1,8704,2,9189586460
5350,124657960,86447317,211105277,5,0,1,15872,11,7026853938
5351,124667300,86502870,211170170,3,0,1,54272,3,9085583225
5352,124681910,86494862,211176772,5,0,1,17408,11,5545081189
5353,124714260,60959857,185674117,6,0,0,356352,7,10532063898
5354,124781679,86396079,211177758,4,0,1,1536,2,1238036912
5355,124807300,86392869,211200169,5,0,1,24064,11,881983066
5356,124830520,61098342,185928862,1,0,0,322048,5,6367464967
5357,124833890,86371668,211205558,5,0,1,17408,11,7231327833
5358,124885580,61228596,186114176,6,0,0,245248,7,4177939526
5359,124902190,60615603,185517793,4,0,0,4608,2,4952098602
5360,124903140,60547368,185450508,1,0,0,9216,5,2595407583
5361,124919479,86293210,211212689,0,0,1,19456,10,3238260351
5362,124924921,61242231,186167152,2,0,0,168448,4,4680890567
5363,124962639,86344522,211307161,4,0,1,12800,2,2470395118
5364,125070680,86236504,211307184,5,0,1,15872,11,8650287340
5365,125093709,86213498,211307207,0,0,1,8192,10,10371942004
5366,125172290,60764398,185936688,6,0,0,1024,7,8110156767
5367,125191070,60578789,185769859,4,0,0,3072,2,4137674005
5368,125235340,61083100,186318440,1,0,0,61440,5,2302105619
5369,125283169,86024061,211307230,0,0,1,9216,10,3160043137
5370,125284410,60502918,185787328,4,0,0,2048,2,9035728495
5371,125296369,86010884,211307253,0,0,1,8192,10,6195724936
5372,125342380,86048828,211391208,7,0,1,185344,16,5756735150
5373,125366900,60444367,185811267,4,0,0,1536,2,3184085575
5374,125382741,60641919,186024660,2,0,0,7168,4,3194729911
5375,125393510,61173984,186567494,1,0,0,166912,5,7380344441
5376,125417090,60773933,186191023,3,0,0,77824,3,6828009440
5377,125421970,60693789,186115759,3,0,0,5120,3,7340318800
5378,125429970,60975478,186405448,6,0,0,46592,7,8205836221
5379,125432500,61648905,187081405,1,0,0,547328,5,5325129304
5380,125438819,85958700,211397519,0,0,1,22016,10,6728683468
5381,125442790,61639262,187082052,4,0,0,2048,2,6808409952
5382,125460529,85954409,211414938,0,0,1,6656,10,6274292662
5383,125467070,61445965,186913035,6,0,0,460800,7,10490006521
5384,125471500,61614007,187085507,6,0,0,11264,7,7792000489
5385,125503559,85912365,211415924,4,0,1,1536,2,8066435701
5386,125509010,62226706,187735716,3,0,0,276992,3,3695867961
5387,125530450,61563348,187093798,1,0,0,27136,5,9364808518
5388,125538170,61617670,187155840,6,0,0,168960,7,10728117163
5389,125554209,61858538,187412747,5,0,0,45056,11,4887337355
5390,125588620,61045248,186633868,4,0,0,2560,2,4660812795
5391,125597721,61890417,187488138,2,0,0,41472,4,2630931852
5392,125605020,61605669,187210689,1,0,0,164864,5,5321542517
5393,125606689,85827618,211434307,4,0,1,14848,2,5432590235
5394,125637049,85816148,211453197,0,0,1,10752,10,320988783
5395,125644530,61270088,186914618,4,0,0,5120,2,8907422344
5396,125651501,62359968,188011469,2,0,0,520704,4,5467208325
5397,125671700,61933024,187604724,3,0,0,34816,3,1674608557
5398,125700689,85776040,211476729,0,0,1,28672,10,177531491
5399,125738180,85744962,211483142,5,0,1,22528,11,1749820210
5400,125761290,61630531,187391821,1,0,0,73216,5,6068955937
5401,125762820,62303638,188066458,3,0,0,155136,3,3260503914
5402,125787260,62353477,188140737,1,0,0,243712,5,7567327125
5403,125801790,62051004,187852794,6,0,0,258048,7,1448914976
5404,125822990,62474947,188297937,1,0,0,351232,5,5221650447
5405,125827440,61910396,187737836,3,0,0,6656,3,10680613045
5406,125873030,61586282,187459312,6,0,0,82944,7,4410782592
5407,125886249,85601438,211487687,4,0,1,16384,2,2258316108
5408,125907609,85667941,211575550,0,0,1,122368,10,3364484329
5409,125912430,62106550,188018980,6,0,0,24576,7,584416496
5410,125956131,62220821,188176952,2,0,0,118784,4,1397400894
5411,125962920,62400785,188363705,1,0,0,190976,5,9709531330
5412,125983260,85679380,211662640,5,0,1,32768,11,2238154542
5413,125984230,85774018,211758248,5,0,1,303616,11,7241784514
5414,126005710,62178301,188184011,6,0,0,23040,7,3785384483
5415,126013110,62177788,188190898,6,0,0,22528,7,10665141523
5416,126037320,62266412,188303732,1,0,0,18944,5,1179506290
5417,126066200,62239294,188305494,1,0,0,5632,5,9130060680
5418,126093210,85669864,211763074,6,0,1,7680,7,1008298300
5419,126118980,61900187,188019167,9,0,0,512,17,2326471851
5420,126144240,85640455,211784695,8,0,1,35328,2,8260503045
5421,126166960,62340074,188507034,1,0,0,65024,5,1883254987
5422,126179430,85607897,211787327,8,0,1,3584,2,8786368453
5423,126182510,85614662,211797172,8,0,1,32256,2,2547982513
5424,126207200,62279999,188487199,3,0,0,166912,3,1202135319
5425,126216320,62601830,188818150,6,0,0,229888,7,4506726604
5426,126231360,85643878,211875238,6,0,1,32256,7,10698347496
5427,126243530,85632272,211875802,6,0,1,10752,7,9431091170
5428,126323290,85554349,211877639,8,0,1,9728,2,944216296
5429,126344260,62915660,189259920,6,0,0,266752,7,1543833518
5430,126359650,85553381,211913031,6,0,1,70144,7,10133316304
5431,126360110,85570912,211931022,8,0,1,15872,2,3551749455
5432,126396270,62228125,188624395,3,0,0,56320,3,6212675903
5433,126438780,62678124,189116904,1,0,0,403456,5,4836440321
5434,126450500,85577404,212027904,8,0,1,40448,2,7493333647
5435,126459421,62386520,188845941,2,0,0,91136,4,4239322887
5436,126530600,85766954,212297554,5,0,1,288256,11,8954156650
5437,126532930,62112674,188645604,1,0,0,13312,5,10292306674
5438,126533221,62608822,189142043,2,0,0,82432,4,2873424674
5439,126616679,85681336,212298015,0,0,1,10240,10,9746148275
5440,126618429,85686647,212305076,0,0,1,12800,10,1693542701
5441,126622680,62914617,189537297,1,0,0,368640,5,9463249735
5442,126631399,85677543,212308942,0,0,1,6144,10,986966918
5443,126662630,62628209,189290839,6,0,0,101376,7,6890500169
5444,126662770,85676077,212338847,3,0,1,31232,3,8165863945
5445,126675130,85677888,212353018,3,0,1,15872,3,2173498468
5446,126715571,62463050,189178621,2,0,0,99328,4,3387389882
5447,126747020,85611183,212358203,6,0,1,16384,7,9792201644
5448,126769880,85594824,212364704,8,0,1,5120,2,4194510156
5449,126805980,62849681,189655661,3,0,0,194048,3,4105635374
5450,126863660,85582795,212446455,5,0,1,57856,11,10690912627
5451,126898490,85547988,212446478,3,0,1,16896,3,5467355665
5452,126913470,62453899,189367369,4,0,0,1024,2,9899093044
5453,126922790,85523711,212446501,8,0,1,5632,2,9783667632
5454,126976450,85470074,212446524,8,0,1,16896,2,5086044684
5455,127038800,85407747,212446547,6,0,1,8192,7,10198518333
5456,127073030,62692837,189765867,1,0,0,55296,5,2875801898
5457,127082720,85365082,212447802,6,0,1,30208,7,6449942997
5458,127093860,85366437,212460297,8,0,1,8704,2,6152321795
5459,127098320,63001087,190099407,6,0,0,75776,7,2973002193
5460,127106510,85363612,212470122,3,0,1,9728,3,7205940726
5461,127118170,63116589,190234759,1,0,0,36352,5,7861651876
5462,127218510,62767355,189985865,3,0,0,5120,3,9075347398
5463,127331891,62991678,190323569,2,0,0,279552,4,4451710432
5464,127357780,62515558,189873338,4,0,0,512,2,3464771409
5465,127373610,62651365,190024975,3,0,0,6656,3,2588311416
5466,127381760,62835481,190217241,6,0,0,73216,7,9042172316
5467,127437449,85036859,212474308,0,0,1,6656,10,1773689200
5468,127460879,85017641,212478520,0,0,1,6656,10,1429631225
5469,127515630,84964836,212480466,6,0,1,3072,7,4734526836
5470,127568090,62670280,190238370,4,0,0,11776,2,8650722749
5471,127589100,62528068,190117168,4,0,0,1536,2,6403059287
5472,127618089,84864963,212483052,0,0,1,4096,10,9381892865
5473,127655581,62670257,190325838,2,0,0,7168,4,9343893448
5474,127716480,62890363,190606843,3,0,0,98816,3,5295802144
5475,127720510,84763208,212483718,3,0,1,1024,3,977331841
5476,127744640,62608153,190352793,3,0,0,69632,3,3657841729
5477,127769570,84818307,212587877,8,0,1,32768,2,3163588817
5478,127826780,84761152,212587932,8,0,1,12288,2,260899701
5479,127833770,62733509,190567279,6,0,0,65024,7,9749984078
5480,127908849,84679106,212587955,0,0,1,1024,10,7546650622
5481,127929629,84658349,212587978,0,0,1,7680,10,8313934881
5482,127934060,84722645,212656705,8,0,1,41472,2,4856839056
5483,127934269,84728645,212662914,0,0,1,21504,10,10530228721
5484,127938759,84771542,212710301,0,0,1,21504,10,700401802
5485,128012639,84707090,212719729,0,0,1,17408,10,9861833200
5486,128021799,84699415,212721214,1,0,1,15360,5,5620399643
5487,128043191,62647699,190690890,2,0,0,78336,4,3484673716
5488,128091100,84689793,212780893,3,0,1,10240,3,8242366029
5489,128162500,84621939,212784439,8,0,1,5632,2,3906460063
5490,128166059,84636812,212802871,1,0,1,59904,5,8336336669
5491,128171139,84811700,212982839,0,0,1,61440,10,4592318848
5492,128177180,62533545,190710725,6,0,0,65024,7,2757777822
5493,128257910,84724952,212982862,6,0,1,512,7,9423228199
5494,128290831,84692070,212982901,9,0,1,51200,17,9859378781
5495,128340120,84642804,212982924,8,0,1,10752,2,8189157362
5496,128350579,84683871,213034450,1,0,1,51200,5,6336191336
5497,128418710,84615763,213034473,8,0,1,9216,2,5004437358
5498,128418990,62295502,190714492,1,0,0,12288,5,145624966
5499,128453860,84582219,213036079,6,0,1,59904,7,7459070208
5500,128456640,84579486,213036126,6,0,1,25600,7,9281426775
5501,128458900,62564501,191023401,6,0,0,64512,7,925879873
5502,128472560,84563589,213036149,6,0,1,4096,7,6716554108
5503,128482830,62555289,191038119,6,0,0,14848,7,4619643234
5504,128504100,84532088,213036188,8,0,1,33792,2,5904046278
5505,128590481,62314971,190905452,2,0,0,7168,4,276522806
5506,128605251,62663529,191268780,2,0,0,58880,4,1520829470
5507,128614421,84421790,213036211,9,0,1,11264,17,368153369
5508,128662730,63028869,191691599,6,0,0,83456,7,4286870130
5509,128662950,84373284,213036234,8,0,1,29696,2,8266229475
5510,128664650,62831039,191495689,4,0,0,512,2,283298502
5511,128696110,84340147,213036257,8,0,1,34304,2,3655253401
5512,128699830,63227198,191927028,3,0,0,565248,3,10435165474
5513,128746780,84311036,213057816,6,0,1,6144,7,1721295261
5514,128761490,84351524,213113014,3,0,1,47616,3,1249162701
5515,128768061,62682789,191450850,2,0,0,87552,4,541757248
5516,128790621,62797326,191587947,2,0,0,72192,4,884546479
5517,128847319,84270841,213118160,0,0,1,8192,10,9901326691
5518,128852530,84267896,213120426,6,0,1,3584,7,6179906314
5519,128853580,63135143,191988723,4,0,0,3072,2,2129051482
5520,128887660,63040739,191928399,4,0,0,4096,2,4726176308
5521,128904080,84221672,213125752,3,0,1,23040,3,57023790
5522,128905951,84239685,213145636,9,0,1,20992,17,8608404296
5523,128922780,63176057,192098837,6,0,0,239104,7,4011247701
5524,128935259,84215203,213150462,0,0,1,7680,10,628948509
5525,128938129,84280110,213218239,0,0,1,23040,10,634051655
5526,128952990,84278404,213231394,6,0,1,12288,7,4898310865
5527,128962650,63001568,191964218,4,0,0,512,2,3278879955
5528,129038740,62914276,191953016,4,0,0,1536,2,9362246563
5529,129052330,62938782,191991112,1,0,0,6656,5,310569617
5530,129095320,63090706,192186026,3,0,0,116736,3,5767457758
5531,129125490,84109130,213234620,3,0,1,5120,3,889759592
5532,129178160,63044439,192222599,3,0,0,113152,3,292540121
5533,129179410,84058462,213237872,8,0,1,5120,2,4779007896
5534,129187170,84078304,213265474,3,0,1,48128,3,571096863
5535,129189350,62809865,191999215,6,0,0,6144,7,6096949532
5536,129193160,84124171,213317331,3,0,1,30720,3,5278818782
5537,129211880,62976220,192188100,4,0,0,3584,2,2168536353
5538,129240010,84108657,213348667,8,0,1,7680,2,1940305690
5539,129267160,62919825,192186985,4,0,0,3072,2,9441537150
5540,129273580,63088456,192362036,3,0,0,127488,3,6347212035
5541,129316520,84049282,213365802,3,0,1,7168,3,10085913969
5542,129381910,83991127,213373037,2,0,1,32768,4,2010523419
5543,129383130,85269653,214652783,8,0,1,14848,2,3710991853
5544,129386561,63088307,192474868,2,0,0,40960,4,10288023122
5545,129449890,85202916,214652806,3,0,1,9216,3,943512736
5546,129452240,85779841,215232081,6,0,1,30208,7,8745663827
5547,129454249,85777855,215232104,0,0,1,14336,10,8136336440
5548,129464010,63028425,192492435,4,0,0,512,2,4335271697
5549,129468980,63145097,192614077,6,0,0,318976,7,1668604537
5550,129471810,63251127,192722937,6,0,0,44032,7,7748527454
5551,129472460,63192905,192665365,6,0,0,34304,7,1657521368
5552,129517080,87255522,216772602,7,0,1,295936,16,10157479168
5553,129533521,87239104,216772625,9,0,1,9216,17,3485341267
5554,129539481,87233167,216772648,9,0,1,19968,17,8620817738
5555,129539580,87233091,216772671,8,0,1,12288,2,6548025591
5556,129557430,87215264,216772694,6,0,1,6144,7,2626980787
5557,129559020,87213697,216772717,8,0,1,11264,2,6987884855
5558,129560410,87222969,216783379,8,0,1,47104,2,10562893563
5559,129562020,63809003,193371023,6,0,0,8192,7,4559200055
5560,129580490,63502887,193083377,1,0,0,58368,5,6836809914
5561,129625980,63656619,193282599,4,0,0,4608,2,3510057187
5562,129628731,63491714,193120445,2,0,0,110080,4,5987917525
5563,129636290,87147112,216783402,8,0,1,14336,2,8651118396
5564,129689820,64069113,193758933,1,0,0,25600,5,3484399746
5565,129709780,63833209,193542989,3,0,0,420864,3,1655580362
5566,129778860,87005018,216783878,3,0,1,22016,3,6826003199
5567,129803540,87139579,216943119,3,0,1,23040,3,9444865820
5568,129877100,63326310,193203410,1,0,0,10240,5,6506296643
5569,129878500,63872610,193751110,1,0,0,190976,5,2735605542
5570,129883190,63809709,193692899,1,0,0,347136,5,3358771520
5571,129905110,64023012,193928122,3,0,0,372224,3,31662895
5572,129929240,64279767,194209007,6,0,0,514560,7,9081585452
5573,129929320,63885367,193814687,3,0,0,76800,3,10715385820
5574,129965600,63401565,193367165,3,0,0,5120,3,7001923487
5575,130066470,86876672,216943142,3,0,1,19968,3,3907062345
5576,130108891,86834274,216943165,9,0,1,12800,17,555452649
5577,130124480,63666776,193791256,3,0,0,105984,3,4565657006
5578,130149099,86794089,216943188,1,0,1,3072,5,9677679220
5579,130155590,64085287,194240877,1,0,0,95744,5,10022021262
5580,130155651,86787560,216943211,9,0,1,4608,17,7657236153
5581,130156911,63820995,193977906,2,0,0,68096,4,4200867259
5582,130206510,64518224,194724734,6,0,0,937472,7,6174830558
5583,130239220,64534255,194773475,6,0,0,146432,7,5092141360
5584,130303511,86639723,216943234,9,0,1,65536,17,2463613727
5585,130314290,64590490,194904780,1,0,0,92672,5,8061595382
5586,130350340,63628213,193978553,4,0,0,2048,2,2368979299
5587,130399841,86553018,216952859,9,0,1,26112,17,2409146764
5588,130414210,64314626,194728836,1,0,0,12800,5,3862188301
5589,130425371,86532140,216957511,9,0,1,8704,17,5514398735
5590,130442030,86526529,216968559,3,0,1,14848,3,7443285049
5591,130442440,64357578,194800018,1,0,0,87040,5,5468316694
5592,130514090,63697592,194211682,6,0,0,8704,7,5407467525
5593,130521380,64401569,194922949,6,0,0,20992,7,9890440032
5594,130598420,64473290,195071710,1,0,0,73216,5,9065195039
5595,130601841,64274640,194876481,2,0,0,250880,4,7605183251
5596,130604400,86390547,216994947,8,0,1,27136,2,6262954926
5597,130669050,86325920,216994970,3,0,1,512,3,7192196968
5598,130671190,64481195,195152385,1,0,0,264704,5,9858707019
5599,130684670,64040243,194724913,4,0,0,512,2,4751218233
5600,130685570,86309423,216994993,3,0,1,3584,3,215175607
5601,130702181,86576598,217278779,9,0,1,91648,17,926552196
5602,130720050,86600460,217320510,3,0,1,1024,3,239853915
5603,130749090,86627421,217376511,8,0,1,14336,2,10249258339
5604,130774590,86601944,217376534,8,0,1,25600,2,10031949641
5605,130786060,86622656,217408716,3,0,1,18432,3,9934199222
5606,130860980,64575739,195436719,1,0,0,199168,5,2601311077
5607,130861400,86548120,217409520,3,0,1,13824,3,8655156847
5608,130886300,64484275,195370575,1,0,0,43008,5,1286734365
5609,130887501,64958149,195845650,2,0,0,223744,4,3195838789
5610,130919271,64596525,195515796,2,0,0,32768,4,6209487935
5611,130923181,86494720,217417901,9,0,1,18944,17,5354158665
5612,130927991,64611485,195539476,2,0,0,4096,4,2962895724
5613,130966361,86452616,217418977,9,0,1,13312,17,1427587450
5614,130970730,64734796,195705526,4,0,0,3072,2,3566549411
5615,130997610,64568233,195565843,1,0,0,12288,5,6448538932
5616,131053901,64159318,195213219,2,0,0,12288,4,1667079420
5617,131057690,64462089,195519779,1,0,0,12800,5,9330308854
5618,131065720,64924685,195990405,1,0,0,304128,5,1752172803
5619,131085140,86337490,217422630,3,0,1,512,3,3747925825
5620,131110669,86357391,217468060,0,0,1,18944,10,7139923179
5621,131175090,65220436,196395526,3,0,0,74752,3,10161151056
5622,131179271,64915332,196094603,2,0,0,226304,4,2925639732
5623,131252050,64381579,195633629,6,0,0,12288,7,1700808166
5624,131306770,64438695,195745465,6,0,0,116736,7,2313329427
5625,131334210,86193391,217527601,8,0,1,39936,2,9901253530
5626,131351200,64500713,195851913,3,0,0,20480,3,3394039998
5627,131373380,86181857,217555237,8,0,1,43520,2,4490518199
5628,131380900,86174683,217555583,3,0,1,512,3,7217485886
5629,131407010,65007290,196414300,3,0,0,59904,3,4979332718
5630,131443780,64848373,196292153,6,0,0,7168,7,10376893266
5631,131452450,64837496,196289946,6,0,0,218112,7,3326183549
5632,131514370,86062782,217577152,8,0,1,30720,2,1707202496
5633,131523220,86089790,217613010,3,0,1,31744,3,5742895923
5634,131526561,65371058,196897619,2,0,0,451072,4,3563456699
5635,131535730,86078266,217613996,8,0,1,1536,2,1660597118
5636,131555860,65580804,197136664,6,0,0,212992,7,2736222393
5637,131557850,64814877,196372727,6,0,0,225792,7,10575532768
5638,131564411,86057317,217621728,9,0,1,12288,17,10274185708
5639,131587000,64809025,196396025,4,0,0,1536,2,8200496991
5640,131592270,64917167,196509437,1,0,0,70144,5,8278352334
5641,131598440,86042801,217641241,8,0,1,9728,2,8430607443
5642,131617360,65555225,197172585,1,0,0,117248,5,6050629125
5643,131665071,64938745,196603816,2,0,0,151552,4,9904014744
5644,131671670,65630041,197301711,6,0,0,131584,7,10448050185
5645,131697550,64960110,196657660,1,0,0,31744,5,1822490675
5646,131745710,85990975,217736685,8,0,1,33792,2,10518657182
5647,131777411,85969502,217746913,9,0,1,512,17,757450424
5648,131778261,85968908,217747169,9,0,1,9216,17,4623152799
5649,131809021,85967496,217776517,9,0,1,16896,17,9533962464
5650,131863680,65598381,197462061,1,0,0,253440,5,3040035617
5651,131894190,65177532,197071722,3,0,0,67584,3,10428527594
5652,131911491,85868892,217780383,9,0,1,6144,17,5109652733
5653,131915421,85879454,217794875,9,0,1,48128,17,9148409200
5654,131955490,64951067,196906557,1,0,0,28672,5,1991915131
5655,131965201,64740539,196705740,2,0,0,8704,4,10132595172
5656,131980341,85862491,217842832,9,0,1,34816,17,5840745618
5657,131991710,85864304,217856014,8,0,1,8704,2,2314288092
5658,132006640,65236676,197243316,4,0,0,512,2,9400813528
5659,132018410,65495893,197514303,1,0,0,86016,5,7123656363
5660,132020760,85934751,217955511,3,0,1,66560,3,5408213375
5661,132032300,86027401,218059701,3,0,1,30720,3,3187069711
5662,132036170,64861628,196897798,4,0,0,512,2,10396421931
5663,132046721,64914663,196961384,2,0,0,32256,4,8567869117
5664,132067070,85992654,218059724,3,0,1,5120,3,1011081566
5665,132075530,65884072,197959602,1,0,0,393728,5,3058617265
5666,132098219,85961528,218059747,0,0,1,3584,10,4660530812
5667,132143990,65029125,197173115,4,0,0,1536,2,7218984869
5668,132233580,65543901,197777481,1,0,0,131584,5,5309146735
5669,132241681,65466553,197708234,2,0,0,90112,4,5304450236
5670,132260340,65202258,197462598,4,0,0,1536,2,6926243250
5671,132320660,65352721,197673381,6,0,0,183808,7,2024820220
5672,132327040,65638004,197965044,6,0,0,7168,7,8731223707
5673,132335630,86100908,218436538,8,0,1,14336,2,3842753389
5674,132426879,86118571,218545450,8,0,1,41472,2,1652618420
5675,132478501,65841720,198320221,2,0,0,427520,4,7972817008
5676,132588359,85957114,218545473,8,0,1,18944,2,9725462127
5677,132658401,65782797,198441198,2,0,0,101888,4,7698292554
5678,132723500,64805573,197529073,1,0,0,5632,5,8710411712
5679,132731189,85822009,218553198,0,0,1,5120,10,7905116500
5680,132752510,85950494,218703004,7,0,1,35840,16,3717769515
5681,132783400,85941648,218725048,8,0,1,19456,2,8954031527
5682,132791140,86034475,218825615,3,0,1,26624,3,2017088443
5683,132807660,65005761,197813421,3,0,0,32768,3,9694415539
5684,132810130,86642743,219452873,5,0,1,464896,11,6414024709
5685,132833201,65356737,198189938,2,0,0,182784,4,9217440925
5686,132839330,86613566,219452896,3,0,1,18432,3,2574411604
5687,132880430,65153952,198034382,3,0,0,54272,3,10663535633
5688,132905750,65494062,198399812,6,0,0,261120,7,3590260459
5689,132913510,65125263,198038773,6,0,0,14336,7,7958913910
5690,132931519,86521400,219452919,0,0,1,16896,10,5046119987
5691,132940270,65580534,198520804,1,0,0,204800,5,9665569103
5692,133032730,86432289,219465019,8,0,1,19456,2,6532152959
5693,133036380,86465589,219501969,3,0,1,35840,3,8715862750
5694,133242400,86261054,219503454,3,0,1,15360,3,3285898334
5695,133316510,86980839,220297349,5,0,1,380928,11,8657489180
5696,133350951,65207027,198557978,2,0,0,107520,4,4281486564
5697,133357451,65052680,198410131,2,0,0,33792,4,10626266333
5698,133366130,65260243,198626373,3,0,0,51712,3,2965090432
5699,133399921,65058460,198458381,2,0,0,56320,4,1581342936
5700,133463590,64496191,197959781,4,0,0,512,2,4529605470
5701,133499710,64547615,198047325,6,0,0,11776,7,59417050
5702,133558290,86739098,220297388,3,0,1,31232,3,9809317244
5703,133596750,65235753,198832503,3,0,0,207872,3,1984014143
5704,133614610,86753070,220367680,3,0,1,4096,3,9642918305
5705,133675320,64895995,198571315,3,0,0,40960,3,6968658680
5706,133678400,64897140,198575540,6,0,0,13312,7,10000909225
5707,133722200,65123509,198845709,4,0,0,3072,2,3569711259
5708,133739750,86627953,220367703,8,0,1,12288,2,5682264045
5709,133758200,86609526,220367726,3,0,1,512,3,10239651941
5710,133805480,86562269,220367749,8,0,1,4096,2,7040253597
5711,133948360,86419412,220367772,3,0,1,9216,3,10582899234
5712,133959230,64565965,198525195,6,0,0,14336,7,10481315192
5713,133964040,86403755,220367795,8,0,1,6656,2,8042390493
5714,133983730,64575082,198558812,4,0,0,2560,2,5993764104
5715,134013850,64581935,198595785,4,0,0,512,2,6661691229
5716,134025260,65017091,199042351,6,0,0,56320,7,8267159756
5717,134046001,64870836,198916837,2,0,0,58880,4,5627061146
5718,134091210,86276608,220367818,3,0,1,2048,3,4691967942
5719,134094490,64774679,198869169,6,0,0,35328,7,1683803814
5720,134095600,65572580,199668180,3,0,0,248320,3,435056985
5721,134113081,64895178,199008259,2,0,0,25088,4,593115083
5722,134269340,86098501,220367841,8,0,1,12288,2,7782601910
5723,134286051,64968825,199254876,2,0,0,40960,4,22492383
5724,134299900,64354245,198654145,4,0,0,512,2,2777354710
5725,134319850,86048973,220368823,8,0,1,10240,2,8589255800
5726,134399940,64623151,199023091,4,0,0,3072,2,4788305231
5727,134416641,64937019,199353660,2,0,0,102912,4,8339972666
5728,134417860,85950986,220368846,8,0,1,2048,2,597526210
5729,134427180,85941689,220368869,3,0,1,512,3,1178744398
5730,134473840,64795301,199269141,6,0,0,44032,7,4071276916
5731,134484540,85884352,220368892,3,0,1,33280,3,8827559319
5732,134528170,64714203,199242373,3,0,0,318464,3,2076884754
5733,134566140,85802783,220368923,3,0,1,16384,3,7859113123
5734,134567700,85801246,220368946,8,0,1,10240,2,10594676999
5735,134570860,85798109,220368969,3,0,1,10240,3,9029294851
5736,134634570,64347378,198981948,4,0,0,1536,2,50648367
5737,134695790,85673202,220368992,8,0,1,7168,2,8104993453
5738,134731340,64524362,199255702,4,0,0,2048,2,1953600568
5739,134778940,85769963,220548903,3,0,1,17408,3,6424994539
5740,134784660,64470395,199255055,4,0,0,512,2,6506108117
5741,134794430,64346355,199140785,4,0,0,2560,2,1676322073
5742,134800220,64322505,199122725,4,0,0,4608,2,8844376473
5743,134809340,64633093,199442433,4,0,0,3584,2,7014935013
5744,134826030,64469934,199295964,4,0,0,512,2,1355457968
5745,134869361,64426362,199295723,2,0,0,87040,4,3704226967
5746,134932020,64185161,199117181,4,0,0,1536,2,6356256402
5747,135002750,85564586,220567336,5,0,1,12288,11,8541490667
5748,135076790,85520613,220597403,3,0,1,8192,3,10363384492
5749,135086900,63995237,199082137,4,0,0,1024,2,2550490206
5750,135153191,85723502,220876693,9,0,1,96768,17,4799159027
5751,135206861,85669855,220876716,9,0,1,16384,17,4541708150
5752,135259920,85616819,220876739,6,0,1,8704,7,2640291950
5753,135263811,85776797,221040608,9,0,1,64512,17,1759514354
5754,135352480,64001717,199354197,4,0,0,1536,2,4348163612
5755,135362840,63959441,199322281,3,0,0,49152,3,3210800574
5756,135379500,85661131,221040631,6,0,1,34304,7,6638906952
5757,135387230,85653424,221040654,6,0,1,18432,7,2620790782
5758,135391050,64137216,199528266,3,0,0,112128,3,2041621212
5759,135431110,64141639,199572749,3,0,0,145920,3,1743624063
5760,135460011,64125093,199585104,2,0,0,40448,4,4046479938
5761,135528050,64192703,199720753,4,0,0,512,2,3162314822
5762,135530010,85931913,221461923,5,0,1,242688,11,6076649858
5763,135536910,64178622,199715532,4,0,0,1536,2,269753146
5764,135575111,64401829,199976940,2,0,0,467968,4,6448183448
5765,135595981,85866654,221462635,9,0,1,33280,17,3309679960
5766,135621780,85937099,221558879,6,0,1,8192,7,4546417173
5767,135647740,85911162,221558902,5,0,1,64512,11,3469512807
5768,135647761,64481829,200129590,2,0,0,55808,4,7796032227
5769,135689210,64423330,200112540,3,0,0,176640,3,9413189873
5770,135712620,63956831,199669451,4,0,0,4096,2,1289523347
5771,135723060,85875588,221598648,7,0,1,161792,16,8557760918
5772,135762380,85841541,221603921,3,0,1,10752,3,5261042430
5773,135774650,85879515,221654165,3,0,1,77824,3,3959254117
5774,135777420,64244614,200022034,6,0,0,144384,7,3753319993
5775,135847180,85817111,221664291,6,0,1,12800,7,2820193321
5776,135873870,85817377,221691247,3,0,1,26112,3,9750058677
5777,135910150,85783287,221693437,6,0,1,8704,7,7733166373
5778,135965971,85766279,221732250,9,0,1,79872,17,4248543740
5779,135995100,63818207,199813307,4,0,0,11264,2,6660249589
5780,136013681,85749990,221763671,9,0,1,38400,17,6636689684
5781,136016810,64035152,200051962,3,0,0,5120,3,9179214392
5782,136041260,85729593,221770853,6,0,1,34304,7,5055855192
5783,136063110,85730276,221793386,6,0,1,19968,7,7179476787
5784,136072141,85726634,221798775,9,0,1,17408,17,8657703438
5785,136075210,85737549,221812759,3,0,1,7168,3,5223422654
5786,136086970,63890957,199977927,4,0,0,2560,2,4090899550
5787,136091750,85721368,221813118,3,0,1,9728,3,3326041630
5788,136101061,65108252,201209313,2,0,0,389120,4,4198915041
5789,136116130,85697974,221814104,3,0,1,1536,3,3016578111
5790,136121350,64509758,200631108,6,0,0,52224,7,2177738566
5791,136133550,64322108,200455658,6,0,0,351232,7,6800938192
5792,136134811,85680573,221815384,9,0,1,14336,17,9658116920
5793,136146420,85671230,221817650,3,0,1,3584,3,3528593796
5794,136170951,64318481,200489432,2,0,0,52224,4,823406506
5795,136182800,85698092,221880892,5,0,1,118784,11,89808916
5796,136273620,64364234,200637854,4,0,0,1536,2,9411820476
5797,136280620,85611298,221891918,3,0,1,24064,3,1687259728
5798,136324430,85570394,221894824,6,0,1,4608,7,9852792987
5799,136325920,85604281,221930201,6,0,1,89600,7,5052317577
5800,136331639,85603772,221935411,1,0,1,2560,5,2161624421
5801,136418990,85696219,222115209,5,0,1,332288,11,2254386598
5802,136481471,63991994,200473465,2,0,0,58368,4,10386118270
5803,136506570,64102916,200609486,3,0,0,61440,3,5499715403
5804,136511200,85624870,222136070,6,0,1,2048,7,8451489479
5805,136515240,86124679,222639919,5,0,1,55808,11,5931952318
5806,136529250,86240647,222769897,3,0,1,6144,3,2139972434
5807,136577690,86192230,222769920,6,0,1,4608,7,8614437779
5808,136584650,64779731,201364381,3,0,0,203776,3,3158700617
5809,136585510,86211894,222797404,3,0,1,17920,3,6133717149
5810,136588700,86293966,222882666,3,0,1,43520,3,5196594119
5811,136600790,86285332,222886122,6,0,1,11776,7,194266197
5812,136614509,86275159,222889668,4,0,1,5632,2,5399580048
5813,136674180,86219034,222893214,8,0,1,5632,2,333007971
5814,136691209,86231560,222922769,1,0,1,37376,5,9227361737
5815,136739450,86209714,222949164,6,0,1,20992,7,4816506496
5816,136744669,86212377,222957046,4,0,1,17408,2,3144467571
5817,136784010,64306339,201090349,3,0,0,95744,3,6830311366
5818,136796850,64264304,201061154,3,0,0,244224,3,8527005370
5819,136839130,86411760,223250890,5,0,1,341504,11,7397790241
5820,136856699,86415995,223272694,1,0,1,5120,5,10005692072
5821,136875719,86402147,223277866,1,0,1,8192,5,1326715892
5822,136880509,86400583,223281092,1,0,1,5120,5,885332695
5823,136906479,86386314,223292793,4,0,1,39424,2,6347852368
5824,136919039,86374420,223293459,4,0,1,1024,2,3603400886
5825,136929149,86371031,223300180,4,0,1,39936,2,9451420037
5826,136931630,64288868,201220498,3,0,0,36352,3,5232245951
5827,136940779,86388803,223329582,1,0,1,10752,5,4264032751
5828,136962319,86370617,223332936,4,0,1,15872,2,1653343369
5829,136995560,63927086,200922646,4,0,0,1536,2,6007177766
5830,137000120,64419912,201420032,7,0,0,182272,16,9338396522
5831,137037840,86295455,223333295,6,0,1,9728,7,6700415018
5832,137056150,64243197,201299347,3,0,0,258560,3,2965323831
5833,137058200,64032507,201090707,4,0,0,512,2,4250290919
5834,137085150,64005378,201090528,4,0,0,512,2,7014329597
5835,137088420,64374847,201463267,3,0,0,141824,3,1787483482
5836,137094380,86245227,223339607,6,0,1,37888,7,4770693834
5837,137126310,86732127,223858437,5,0,1,569856,11,1996843803
5838,137150900,86985463,224136363,5,0,1,404992,11,3384589228
5839,137154250,64147974,201302224,4,0,0,9216,2,7948011834
5840,137161500,87156087,224317587,5,0,1,371200,11,4147789437
5841,137172279,87146934,224319213,4,0,1,2560,2,8671412223
5842,137175361,64497939,201673300,2,0,0,141824,4,4654239749
5843,137219549,87147894,224367443,4,0,1,4096,2,10294278312
5844,137268420,64196305,201464725,4,0,0,4096,2,3117894792
5845,137297850,87777154,225075004,5,0,1,139264,11,6319635994
5846,137315910,64293142,201609052,3,0,0,227328,3,7665156939
5847,137346739,88025951,225372690,4,0,1,73728,2,5377553605
5848,137440900,88314278,225755178,5,0,1,219136,11,4256292689
5849,137448450,64360438,201808888,3,0,0,219136,3,2036808816
5850,137482469,88347947,225830416,1,0,1,22016,5,2176321659
5851,137569970,63962181,201532151,4,0,0,1024,2,5583067208
5852,137592849,88237590,225830439,4,0,1,31744,2,3988658471
5853,137594030,64079917,201673947,4,0,0,2048,2,48364406
5854,137599320,64247269,201846589,3,0,0,87552,3,10169257236
5855,137628709,88201753,225830462,1,0,1,11264,5,10171932356
5856,137631049,88199436,225830485,4,0,1,5632,2,7635788546
5857,137654019,88176489,225830508,1,0,1,18432,5,6558954362
5858,137706180,63971121,201677301,4,0,0,5632,2,4518661076
5859,137722570,64244103,201966673,4,0,0,512,2,6882839494
5860,137775630,88098308,225873938,5,0,1,122880,11,9000248809
5861,137832140,63777301,201609441,4,0,0,1024,2,1108708
5862,137841109,88032852,225873961,4,0,1,26112,2,5461307192
5863,137850921,64062594,201913515,2,0,0,88064,4,4640981475
5864,137855979,88018037,225874016,4,0,1,20992,2,3769572504
5865,137890570,63784960,201675530,3,0,0,5120,3,336063897
5866,137942479,87931560,225874039,4,0,1,2560,2,4894225756
5867,138002149,87871913,225874062,1,0,1,16896,5,7575531321
5868,138028630,63939996,201968626,4,0,0,2560,2,748506491
5869,138041589,87832496,225874085,1,0,1,18944,5,5354364018
5870,138151650,87951288,226102938,5,0,1,341504,11,5064650124
5871,138160019,87942942,226102961,1,0,1,14336,5,4172264519
5872,138165900,64837688,203003588,3,0,0,740864,3,6685035023
5873,138170220,88222710,226392930,5,0,1,604672,11,4384576837
5874,138213919,88179626,226393545,4,0,1,18944,2,6885929324
5875,138253061,64448109,202701170,2,0,0,162816,4,696372488
5876,138294040,88109370,226403410,5,0,1,7680,11,4490390227
5877,138368600,88285083,226653683,5,0,1,340992,11,3798748245
5878,138373280,88330837,226704117,5,0,1,32256,11,3025288143
5879,138377600,63431669,201809269,4,0,0,1024,2,2370320180
5880,138442990,64110503,202553493,3,0,0,214016,3,6573773177
5881,138460189,88249438,226709627,1,0,1,110592,5,6765055098
5882,138476310,64678865,203155175,3,0,0,201728,3,9697449465
5883,138508679,88232217,226740896,4,0,1,31232,2,279809843
5884,138532279,88214979,226747258,4,0,1,30208,2,8982103317
5885,138656051,65342093,203998144,2,0,0,129024,4,2873059187
5886,138692400,63657421,202349821,4,0,0,512,2,8612280735
5887,138696470,63893550,202590020,3,0,0,119808,3,5925261753
5888,138794259,87954305,226748564,4,0,1,2048,2,8293706197
5889,138798889,87960958,226759847,4,0,1,23040,2,8126915762
5890,138809759,87958550,226768309,4,0,1,17920,2,8604354045
5891,138827109,87942186,226769295,4,0,1,1536,2,9950700516
5892,138838520,64395680,203234200,3,0,0,151040,3,5756232245
5893,138851941,64470237,203322178,2,0,0,136192,4,9555665985
5894,138855250,87914711,226769961,3,0,1,1024,3,10313595267
5895,138878180,87896927,226775107,6,0,1,8192,7,1259405867
5896,138885630,87900794,226786424,6,0,1,12288,7,10479864452
5897,138905360,87887017,226792377,6,0,1,28160,7,5177681050
5898,138921709,87882402,226804111,1,0,1,3072,5,4340295458
5899,138934859,87889107,226823966,1,0,1,36352,5,150518897
5900,139021270,87844262,226865532,6,0,1,54784,7,6181433930
5901,139034240,87931473,226965713,5,0,1,165376,11,8173976812
5902,139080670,63948119,203028789,3,0,0,82432,3,8394726918
5903,139143180,87848976,226992156,6,0,1,6144,7,5372891957
5904,139220530,87803837,227024367,5,0,1,83968,11,7152596963
5905,139312950,63443340,202756290,3,0,0,27136,3,8232709217
5906,139350980,63351039,202702019,4,0,0,2560,2,8092200525
5907,139416250,64485066,203901316,3,0,0,443392,3,1985709020
5908,139466750,87575700,227042450,6,0,1,32768,7,2722740923
5909,139493680,63579030,203072710,3,0,0,143872,3,4407496742
5910,139524751,63634416,203159167,2,0,0,12800,4,4463817216
5911,139600559,87592867,227193426,4,0,1,30208,2,762734647
5912,139622390,87666726,227289116,5,0,1,29696,11,7383821496
5913,139666831,63572384,203239215,2,0,0,16384,4,6697737330
5914,139689649,87739025,227428674,4,0,1,15872,2,3555047564
5915,139701630,87807609,227509239,6,0,1,73216,7,8946879928
5916,139705299,87803963,227509262,4,0,1,4096,2,4631916469
5917,139710570,64501498,204212068,3,0,0,55296,3,6681776664
5918,139717679,87804897,227522576,4,0,1,21504,2,6385021890
5919,139729800,87792815,227522615,2,0,1,1024,4,10450509777
5920,139742220,64767004,204509224,3,0,0,387584,3,4000508122
5921,139758849,87763789,227522638,4,0,1,5120,2,1746847271
5922,139812390,87710271,227522661,6,0,1,3072,7,3380225708
5923,139864800,88475837,228340637,5,0,1,387072,11,907712896
5924,139870250,88538513,228408763,6,0,1,15872,7,4060570063
5925,139905731,64289466,204195197,2,0,0,421888,4,444011392
5926,139945380,88463406,228408786,6,0,1,43008,7,2715084841
5927,139962990,88482510,228445500,5,0,1,64512,11,557944834
5928,140029630,88434909,228464539,6,0,1,52736,7,324705304
5929,140064700,88564027,228628727,6,0,1,15360,7,5362772837
5930,140074980,88553770,228628750,2,0,1,8192,4,1025287939
5931,140088860,88539913,228628773,6,0,1,15360,7,6763385875
5932,140124841,63830543,203955384,2,0,0,177152,4,9464910753
5933,140140870,88487926,228628796,6,0,1,22016,7,10013226831
5934,140141850,64559066,204700916,3,0,0,161280,3,8611169622
5935,140237811,64304040,204541851,2,0,0,107008,4,8036240689
5936,140261590,88367229,228628819,5,0,1,32768,11,1097068803
5937,140269310,63423681,203692991,4,0,0,1536,2,1416266399
5938,140290800,88338042,228628842,5,0,1,70144,11,4685035194
5939,140302471,63989738,204292209,2,0,0,177664,4,8231912745
5940,140374330,88329072,228703402,5,0,1,117248,11,274618609
5941,140382640,63169767,203552407,3,0,0,8192,3,3665010370
5942,140494990,63507701,204002691,3,0,0,14848,3,4732392560
5943,140518530,88214584,228733114,5,0,1,69120,11,3157661038
5944,140520950,88755383,229276333,5,0,1,212992,11,5828136862
5945,140579400,89019987,229599387,5,0,1,258048,11,6943665515
5946,140623560,89074116,229697676,5,0,1,94720,11,2617286818
5947,140627400,89097762,229725162,6,0,1,60928,7,3933366362
5948,140636920,89121529,229758449,2,0,1,32768,4,4844443157
5949,140689480,89070982,229760462,6,0,1,13824,7,6783152432
5950,140733399,89157315,229890714,4,0,1,17408,2,3087744000
5951,140744300,63884336,204628636,3,0,0,129024,3,576133218
5952,140823770,63132105,203955875,4,0,0,1536,2,6467287824
5953,140884641,63353413,204238054,2,0,0,53248,4,10489176352
5954,140912599,88978138,229890737,4,0,1,5632,2,852626682
5955,141047519,88843241,229890760,4,0,1,37376,2,1562470427
5956,141076420,62945268,204021688,4,0,0,3584,2,2064779227
5957,141350330,88570545,229920875,5,0,1,94720,11,8868189080
5958,141360720,88689648,230050368,6,0,1,11264,7,1851070808
5959,141367349,88727837,230095186,4,0,1,32256,2,10302948776
5960,141389600,63542417,204932017,3,0,0,677376,3,10724922029
5961,141395109,88700116,230095225,4,0,1,65024,2,2595985669
5962,141396030,62907760,204303790,3,0,0,15872,3,9814858949
5963,141417050,88714421,230131471,5,0,1,81408,11,4792796772
5964,141448720,88816861,230265581,5,0,1,175616,11,6312436366
5965,141504350,88762857,230267207,6,0,1,2560,7,9314464708
5966,141513630,63652614,205166244,3,0,0,652288,3,9414241564
5967,141569780,63076072,204645852,4,0,0,1536,2,7843500025
5968,141571130,88856472,230427602,5,0,1,243200,11,4995416951
5969,141577220,63360955,204938175,4,0,0,9216,2,7973901498
5970,141602090,89039712,230641802,5,0,1,195072,11,5500872847
5971,141631590,62910486,204542076,3,0,0,512,3,393145536
5972,141636720,89006708,230643428,6,0,1,2560,7,1541903002
5973,141648951,63076320,204725271,2,0,0,32768,4,8682033163
5974,141682310,89116266,230798576,5,0,1,123904,11,5423035826
5975,141696970,63028636,204725606,3,0,0,1024,3,10730330634
5976,141707959,89090640,230798599,4,0,1,6144,2,7584649903
5977,141758560,89040062,230798622,5,0,1,2560,11,9102175158
5978,141827929,88970716,230798645,4,0,1,2048,2,8433443879
5979,141840920,63094378,204935298,4,0,0,512,2,3429862456
5980,141845230,63089866,204935096,3,0,0,9728,3,3575147771
5981,141968371,63253056,205221427,2,0,0,9728,4,3519744701
5982,141983159,88815509,230798668,4,0,1,5632,2,10498088672
5983,142117941,63099650,205217591,2,0,0,168448,4,898425804
5984,142180770,63111091,205291861,4,0,0,512,2,3653349280
5985,142280080,88533051,230813131,5,0,1,173056,11,4609533450
5986,142292789,88554304,230847093,0,0,1,34816,10,1356526253
5987,142444030,88454611,230898641,5,0,1,142336,11,6679602045
5988,142468360,62472091,204940451,4,0,0,7168,2,5799164589
5989,142483021,62808661,205291682,2,0,0,138752,4,9708485988
5990,142550480,62667937,205218417,3,0,0,2560,3,8612183295
5991,142597309,88304558,230901867,4,0,1,5120,2,210184830
5992,142637491,62760478,205397969,2,0,0,81920,4,6190302850
5993,142717340,88186115,230903455,5,0,1,15872,11,5174351226
5994,142770500,88181548,230952048,5,0,1,39936,11,1744920891
5995,142829821,62824562,205654383,2,0,0,22528,4,9403290713
5996,142845391,62797911,205643302,2,0,0,101888,4,9876435092
5997,142927720,62296029,205223749,4,0,0,1024,2,2073497265
5998,142975731,62636504,205612235,2,0,0,204288,4,1674142540
5999,143024390,62270481,205294871,3,0,0,8704,3,1079505107
6000,143132311,62097036,205229347,2,0,0,7680,4,2473231811
6001,143141670,62150526,205292196,4,0,0,1024,2,8349366660
6002,143177400,87774671,230952071,5,0,1,18944,11,6385506160
6003,143209191,62040192,205249383,2,0,0,36864,4,6269717503
6004,143211010,87912816,231123826,5,0,1,329728,11,2260346771
6005,143234320,61992618,205226938,4,0,0,10240,2,679146783
6006,143238790,61984578,205223368,4,0,0,6144,2,9291983680
6007,143240350,61990112,205230462,4,0,0,3584,2,6974363906
6008,143241660,62413861,205655521,3,0,0,1024,3,3209434579
6009,143253630,62293025,205546655,4,0,0,6656,2,3239039973
6010,143271890,62375606,205647496,3,0,0,7168,3,4620443611
6011,143314030,87812382,231126412,5,0,1,4096,11,6856057034
6012,143416031,62458575,205874606,2,0,0,22528,4,9824298923
6013,143429200,62215731,205644931,3,0,0,1536,3,7440662658
6014,143494690,88418015,231912705,5,0,1,694272,11,4846283255
6015,143495061,62712863,206207924,2,0,0,257536,4,161628246
6016,143518520,61924552,205443072,4,0,0,512,2,6293143086
6017,143606410,62102678,205709088,4,0,0,1536,2,2846706038
6018,143710710,62372322,206083032,4,0,0,2560,2,7923631470
6019,143759000,61885440,205644440,3,0,0,3072,3,9915728151
6020,143777030,88135706,231912736,5,0,1,72192,11,10724209869
6021,143790740,88122019,231912759,5,0,1,13824,11,4925007946
6022,143799630,61845636,205645266,4,0,0,1024,2,2985603203
6023,143867880,88131539,231999419,5,0,1,118272,11,9549115335
6024,143994050,61550554,205544604,3,0,0,1024,3,6981375267
6025,144072141,61750140,205822281,2,0,0,19456,4,2883707373
6026,144084250,87950191,232034441,7,0,1,67072,16,10736570955
6027,144131691,61950538,206082229,2,0,0,423936,4,6972445287
6028,144215940,61427541,205643481,3,0,0,512,3,3793775665
6029,144224711,61581979,205806690,2,0,0,8192,4,8777110636
6030,144226910,61428276,205655186,4,0,0,2560,2,9585556416
6031,144242230,61479074,205721304,3,0,0,5120,3,7121788416
6032,144248790,87938376,232187166,3,0,1,19456,3,5405040147
6033,144249380,61960439,206209819,4,0,0,6144,2,3050715404
6034,144279139,87908050,232187189,0,0,1,42496,10,4618136487
6035,144304081,61825352,206129433,2,0,0,151552,4,5347236083
6036,144310491,62156019,206466510,2,0,0,226816,4,7565935474
6037,144411639,87775573,232187212,0,0,1,9728,10,5136354597
6038,144415220,61667991,206083211,4,0,0,512,2,9527129646
6039,144422690,61248471,205671161,4,0,0,4096,2,8668175187
6040,144430261,61834491,206264752,2,0,0,161280,4,6382792721
6041,144438330,61828848,206267178,4,0,0,7680,2,5600017517
6042,144451169,87736066,232187235,1,0,1,22528,5,7971939517
6043,144456471,61935007,206391478,2,0,0,131072,4,10642093551
6044,144469900,61745666,206215566,4,0,0,6144,2,9050433729
6045,144522461,62120660,206643121,2,0,0,365568,4,7319256777
6046,144525259,87661999,232187258,0,0,1,8192,10,1080972652
6047,144529150,61410892,205940042,4,0,0,512,2,1236674266
6048,144546159,87641122,232187281,1,0,1,6656,5,4910082037
6049,144579499,87607805,232187304,0,0,1,6144,10,2322880894
6050,144601140,61610613,206211753,3,0,0,6144,3,5567540288
6051,144618381,61851272,206469653,2,0,0,10240,4,2428497109
6052,144625409,87561918,232187327,1,0,1,7680,5,4002963907
6053,144634980,61578691,206213671,4,0,0,6144,2,1378451419
6054,144636800,61699307,206336107,3,0,0,4608,3,4521013309
6055,144637850,61858500,206496350,3,0,0,10752,3,10641235507
6056,144647229,87540121,232187350,0,0,1,90112,10,10527743668
6057,144667219,87520154,232187373,0,0,1,36352,10,5753093274
6058,144675770,61830557,206506327,4,0,0,1536,2,848456640
6059,144715480,61676714,206392194,3,0,0,2048,3,8597471962
6060,144788749,87398647,232187396,0,0,1,16384,10,6106460627
6061,144804089,87383330,232187419,1,0,1,6656,5,303761171
6062,144810120,61659891,206470011,3,0,0,1024,3,9405846622
6063,144854059,87333383,232187442,1,0,1,12800,5,1750555629
6064,144916389,87271076,232187465,1,0,1,6144,5,7095184182
6065,144928500,61464809,206393309,4,0,0,3584,2,4047430028
6066,144929030,61468129,206397159,4,0,0,2560,2,9429576852
6067,144943540,61705335,206648875,3,0,0,2048,3,7768780505
6068,145027930,61620275,206648205,3,0,0,2048,3,2191808543
6069,145034890,61277013,206311903,4,0,0,2560,2,1221364520
6070,145051120,61595635,206646755,3,0,0,5120,3,7298765072
6071,145059129,87143884,232203013,1,0,1,37376,5,351969560
6072,145066229,87144261,232210490,1,0,1,19968,5,4059866970
6073,145099199,87130897,232230096,0,0,1,38912,10,443110747
6074,145132099,87100583,232232682,1,0,1,4096,5,2711058097
6075,145170149,87062892,232233041,0,0,1,9728,10,3597985886
6076,145431059,86805528,232236587,1,0,1,5632,5,10087006662
6077,145477289,86762102,232239391,1,0,1,16384,5,1172270853
6078,145565260,61079912,206645172,4,0,0,6656,2,6564677739
6079,145578941,61176139,206755080,2,0,0,266752,4,4142023893
6080,145594820,61052738,206647558,3,0,0,2560,3,5842927879
6081,145651140,60998162,206649302,4,0,0,1024,2,7386848673
6082,145651739,86622100,232273839,1,0,1,54272,5,9523203665
6083,145733589,86563641,232297230,0,0,1,5120,10,9776050962
6084,145750990,60898849,206649839,3,0,0,1536,3,10178930018
6085,145878750,86422692,232301442,2,0,1,6656,4,3012391291
6086,145896269,86430804,232327073,1,0,1,23552,5,10655222199
6087,145908569,86439473,232348042,0,0,1,6144,10,9807238713
6088,145982090,60773284,206755374,3,0,0,512,3,3794373844
6089,145992931,60794229,206787160,2,0,0,39424,4,2884366231
6090,146008729,86342219,232350948,0,0,1,4608,10,6956181663
6091,146059220,86296913,232356133,2,0,1,16384,4,1248558541
6092,146164590,86195409,232359999,2,0,1,6144,4,1734039785
6093,146179639,86183586,232363225,1,0,1,5120,5,8963165656
6094,146194089,86169290,232363379,0,0,1,8704,10,5195301226
6095,146257740,60508040,206765780,3,0,0,1024,3,10357504585
6096,146257929,86116383,232374312,0,0,1,43520,10,9668202298
6097,146260450,86124983,232385433,2,0,1,26624,4,3909417492
6098,146265649,86124290,232389939,1,0,1,7168,5,5514109274
6099,146276979,86123957,232400936,0,0,1,35840,10,3012985423
6100,146329810,60572558,206902368,9,0,0,10752,17,5110875093
6101,146359550,86046234,232405784,2,0,1,4096,4,10730382007
6102,146393889,86131271,232525160,0,0,1,45568,10,7932180668
6103,146397250,86159080,232556330,2,0,1,13824,4,3251550782
6104,146440670,86187976,232628646,8,0,1,31744,2,445478963
6105,146448360,86290217,232738577,2,0,1,37888,4,6468509552
6106,146474260,60406884,206881144,3,0,0,4096,3,4028323240
6107,146501840,86236760,232738600,2,0,1,6144,4,239566691
6108,146520629,86410675,232931304,1,0,1,76288,5,7540186837
6109,146555120,86378130,232933250,8,0,1,3072,2,5582789935
6110,146555520,86392125,232947645,2,0,1,16896,4,751698820
6111,146560809,86485739,233046548,1,0,1,14336,5,3538883514
6112,146562389,86631849,233194238,0,0,1,3584,10,1239480190
6113,146570630,86689390,233260020,8,0,1,48640,2,1782499555
6114,146578160,60315229,206893389,3,0,0,5120,3,5906700592
6115,146599859,86660184,233260043,0,0,1,1024,10,2166623530
6116,146624950,60607193,207232143,6,0,0,141312,7,3593461159
6117,146635849,86624217,233260066,0,0,1,8192,10,5273009205
6118,146656790,86609120,233265910,2,0,1,15360,4,1322122239
6119,146681290,86608250,233289540,8,0,1,14336,2,6400159689
6120,146711400,86714311,233425711,8,0,1,23040,2,9388293642
6121,146738240,87355001,234093241,7,0,1,498688,16,5734760260
6122,146785691,60719909,207505600,2,0,0,354816,4,5211335872
6123,146800289,87292975,234093264,4,0,1,10240,2,9214013895
6124,146801240,87292047,234093287,2,0,1,17920,4,6388054063
6125,146801849,87291461,234093310,4,0,1,16384,2,6104200002
6126,146830350,60695247,207525597,3,0,0,4096,3,328601686
6127,146854861,60861777,207716638,2,0,0,125440,4,8443028291
6128,146892049,87201284,234093333,4,0,1,12288,2,7235664759
6129,146892699,87200657,234093356,4,0,1,24064,2,2713664033
6130,146910299,87261415,234171714,0,0,1,12288,10,9466444721
6131,146928750,87271138,234199888,7,0,1,196096,16,6412929407
6132,146951061,60727203,207678264,2,0,0,393728,4,388502418
6133,147019840,87180071,234199911,2,0,1,18432,4,7326425449
6134,147050220,87149714,234199934,7,0,1,29696,16,6682409062
6135,147068939,87142660,234211599,4,0,1,38912,2,7338937352
6136,147088270,87192303,234280573,2,0,1,31744,4,5468465382
6137,147174730,60332187,207506917,3,0,0,4096,3,4902482374
6138,147198630,87162993,234361623,7,0,1,205312,16,4923979858
6139,147263289,87109716,234373005,4,0,1,44544,2,6458529767
6140,147322241,60202038,207524279,2,0,0,56832,4,5353824141
6141,147346650,87030861,234377511,2,0,1,7168,4,5752175666
6142,147440900,86943076,234383976,7,0,1,30720,16,8644821785
6143,147462029,86947546,234409575,4,0,1,11776,2,7093438289
6144,147466249,86951698,234417947,4,0,1,13312,2,4014109614
6145,147524941,86894389,234419330,9,0,1,14848,17,3580594042
6146,147601519,86860989,234462508,4,0,1,65024,2,9477042392
6147,147634800,86850416,234485216,2,0,1,32768,4,7979275356
6148,147640140,86989948,234630088,2,0,1,81920,4,9704082420
6149,147674880,60091201,207766081,3,0,0,2560,3,8709461463
6150,147697979,86957172,234655151,0,0,1,26624,10,6764579577
6151,147709091,60074973,207784064,2,0,0,34304,4,1256753874
6152,147790419,86924460,234714879,0,0,1,24576,10,7282131607
6153,147833740,86895387,234729127,2,0,1,47616,4,6151580761
6154,147836130,59978216,207814346,3,0,0,512,3,6613048185
6155,147895129,86840343,234735472,0,0,1,14336,10,4444621358
6156,147915940,86834785,234750725,2,0,1,14336,4,7056425251
6157,147936350,86818561,234754911,2,0,1,6656,4,4574273937
6158,147959689,86798768,234758457,0,0,1,5632,10,9928865500
6159,147968150,86979372,234947522,7,0,1,89088,16,5494374045
6160,147985460,59958813,207944273,3,0,0,2560,3,5928226369
6161,148049580,59992296,208041876,3,0,0,1536,3,801115480
6162,148054339,86940965,234995304,4,0,1,32768,2,3787053499
6163,148067011,59974374,208041385,2,0,0,27648,4,3348468012
6164,148071530,87077498,235149028,7,0,1,271360,16,2174401360
6165,148092440,87056934,235149374,3,0,1,512,3,9900649089
6166,148181600,86968747,235150347,7,0,1,12800,16,9411787361
6167,148193960,59747433,207941393,4,0,0,1536,2,5340411440
6168,148232980,87069038,235302018,7,0,1,94720,16,2568965333
6169,148261270,87074415,235335685,2,0,1,13312,4,1386300445
6170,148289560,59680132,207969692,4,0,0,1536,2,5638005997
6171,148334820,87103618,235438438,7,0,1,58368,16,199209913
6172,148377751,59904720,208282471,2,0,0,57856,4,5377639546
6173,148419920,59638399,208058319,3,0,0,512,3,42789673
6174,148451930,59571807,208023737,3,0,0,1024,3,3463160735
6175,148491400,59509423,208000823,4,0,0,2560,2,3056954269
6176,148537819,87028021,235565840,0,0,1,7680,10,8071533934
6177,148546150,87174417,235720567,7,0,1,143360,16,3364307039
6178,148554369,87166738,235721107,0,0,1,26112,10,80689634
6179,148576210,59652987,208229197,3,0,0,2048,3,6886714959
6180,148600269,87121824,235722093,0,0,1,1536,10,2215911432
6181,148633970,87108846,235742816,2,0,1,7168,4,3678107395
6182,148639980,87187631,235827611,8,0,1,67584,2,3921611210
6183,148657929,87170450,235828379,0,0,1,11776,10,558681537
6184,148684640,87223867,235908507,2,0,1,38912,4,85101167
6185,148759170,87195617,235954787,6,0,1,9728,7,3340279655
6186,148790230,87305194,236095424,7,0,1,79872,16,850280120
6187,148799760,87295687,236095447,8,0,1,7168,2,5214365035
6188,148800020,59484190,208284210,3,0,0,5632,3,5306489773
6189,148824420,59438284,208262704,4,0,0,512,2,9336325325
6190,148859189,87236281,236095470,0,0,1,11264,10,7523836989
6191,148877031,59560866,208437897,2,0,0,87552,4,9348142343
6192,148934290,59356853,208291143,4,0,0,512,2,3951867984
6193,148956630,87184187,236140817,2,0,1,36352,4,3216548786
6194,148973760,87745799,236719559,2,0,1,138752,4,413207507
6195,149016660,59701064,208717724,3,0,0,187392,3,6702876965
6196,149036610,87682972,236719582,2,0,1,4096,4,2159194004
6197,149045870,87727113,236772983,7,0,1,27648,16,10523579501
6198,149057960,59851519,208909479,3,0,0,66560,3,9496223594
6199,149087300,59767682,208854982,3,0,0,169472,3,373943952
6200,149166540,59456470,208623010,4,0,0,512,2,916619951
6201,149175210,59447512,208622722,4,0,0,4608,2,10288889493
6202,149309180,87511524,236820704,2,0,1,49664,4,9397737223
6203,149334990,88179785,237514775,7,0,1,468480,16,7721495236
6204,149364670,88150128,237514798,2,0,1,9216,4,629704773
6205,149414720,59357857,208772577,4,0,0,3072,2,782233433
6206,149421710,88109514,237531224,6,0,1,41472,7,8733235159
6207,149425100,59635294,209060394,3,0,0,75776,3,9592943432
6208,149482220,88085125,237567345,7,0,1,272384,16,2994997495
6209,149497330,88070038,237567368,6,0,1,19968,7,1002894508
6210,149564951,59415295,208980246,2,0,0,4608,4,9881334193
6211,149597491,59377511,208975002,2,0,0,32768,4,3368383875
6212,149603750,87963641,237567391,8,0,1,23552,2,4510425672
6213,149647930,87919484,237567414,2,0,1,31232,4,2882405822
6214,149652390,59276199,208928589,4,0,0,2048,2,7685417503
6215,149717660,87957393,237675053,7,0,1,231424,16,3978890503
6216,149729460,59420724,209150184,3,0,0,99328,3,1279066154
6217,149742130,87933269,237675399,2,0,1,512,4,2772795137
6218,149755201,59557893,209313094,2,0,0,87040,4,2467690737
6219,149765070,87910483,237675553,6,0,1,8704,7,8991019437
6220,149787450,87888462,237675912,6,0,1,9728,7,689374614
6221,149800931,59412340,209213271,2,0,0,13312,4,8094738133
6222,149801640,87875898,237677538,7,0,1,2560,16,2094979006
6223,149809110,87924191,237733301,7,0,1,48640,16,6230575498
6224,149843019,87893945,237736964,0,0,1,26624,10,6304881922
6225,149871159,87872427,237743586,0,0,1,20992,10,589037549
6226,149893011,60402442,210295453,2,0,0,457216,4,4666318460
6227,149894539,88489194,238383733,0,0,1,519680,10,1872931780
6228,149950950,60108768,210059718,3,0,0,160256,3,5109707928
6229,149973369,88523166,238496535,0,0,1,68096,10,2208542685
6230,150002649,88580169,238582818,0,0,1,59904,10,7832033158
6231,150017660,88565181,238582841,7,0,1,10752,16,5705017983
6232,150029170,88560703,238589873,7,0,1,35328,16,1172364753
6233,150029351,59726305,209755656,2,0,0,253952,4,3799857178
6234,150070330,60085792,210156122,3,0,0,229888,3,8159799329
6235,150093241,59917603,210010844,2,0,0,308736,4,3137788059
6236,150124601,60198807,210323408,2,0,0,91648,4,2056295679
6237,150149160,88504693,238653853,6,0,1,22016,7,4570112193
6238,150186711,88485158,238671869,9,0,1,19456,17,9600581983
6239,150207300,88525020,238732320,2,0,1,35328,4,10696703162
6240,150211040,88565187,238776227,7,0,1,45056,16,9957631139
6241,150227360,88554141,238781501,2,0,1,9728,4,4437241000
6242,150333200,59546730,209879930,4,0,0,5632,2,9351914279
6243,150384760,88427867,238812627,6,0,1,4096,7,2923334049
6244,150403110,88421986,238825096,2,0,1,51200,4,10567295917
6245,150412281,60137010,210549291,2,0,0,283648,4,3632837000
6246,150417760,59643705,210061465,4,0,0,5632,2,3842913381
6247,150454501,59902002,210356503,2,0,0,108544,4,9276953332
6248,150663061,60036688,210699749,2,0,0,89600,4,10276643613
6249,150736651,59880055,210616706,2,0,0,221184,4,3946779957
6250,150755900,88070822,238826722,2,0,1,2560,4,6437960369
6251,150770110,88061118,238831228,6,0,1,7168,7,8634810434
6252,150835060,88001821,238836881,2,0,1,11776,4,3928669910
6253,150904080,59761283,210665363,3,0,0,10240,3,3544140157
6254,150924570,87921729,238846299,6,0,1,18432,7,4173634990
6255,150980420,87869438,238849858,6,0,1,16896,7,8979773923
6256,150992529,87926899,238919428,0,0,1,117248,10,1003373167
6257,151067360,87948693,239016053,6,0,1,7168,7,10076333802
6258,151085439,88002755,239088194,0,0,1,108544,10,123836429
6259,151115649,87972568,239088217,0,0,1,9216,10,9652597967
6260,151125171,59687478,210812649,2,0,0,180224,4,7752381941
6261,151250940,87837316,239088256,6,0,1,20992,7,7826400791
6262,151347870,87744823,239092693,2,0,1,41984,4,575712015
6263,151400010,59651927,211051937,3,0,0,151040,3,6063154551
6264,151462270,87630446,239092716,2,0,1,21504,4,2004112362
6265,151488770,87603969,239092739,2,0,1,4096,4,998939073
6266,151510010,87584647,239094657,2,0,1,29696,4,1202067353
6267,151524801,87585813,239110614,9,0,1,35328,17,7858401536
6268,151713030,87402736,239115766,6,0,1,16896,7,6284165232
6269,151745870,87393801,239139671,2,0,1,13312,4,1429354187
6270,151758980,87389822,239148802,2,0,1,12800,4,6780815078
6271,151767769,59539369,211307138,5,0,0,297472,11,10319624285
6272,151860699,87301047,239161746,0,0,1,50176,10,8123545693
6273,152030730,87162325,239193055,8,0,1,52224,2,3420315570
6274,152066440,87146582,239213022,2,0,1,6144,4,10160757178
6275,152112300,87100745,239213045,6,0,1,6144,7,4627848527
6276,152170500,87042568,239213068,2,0,1,17408,4,8167068182
6277,152181640,87070757,239252397,2,0,1,15360,4,7477500324
6278,152212989,87093329,239306318,1,0,1,112640,5,5380585875
6279,152248809,87059455,239308264,1,0,1,3072,5,9408056383
6280,152266939,87070977,239337916,1,0,1,46592,5,239821752
6281,152278609,87377278,239655887,0,0,1,186368,10,7279397835
6282,152319710,87500763,239820473,2,0,1,68096,4,7323955202
6283,152363810,87467135,239830945,2,0,1,36352,4,9532147306
6284,152383540,58744920,211128460,9,0,0,512,17,905589816
6285,152390460,59272157,211662617,3,0,0,268288,3,5912743742
6286,152393500,87496674,239890174,2,0,1,19968,4,5332765804
6287,152427500,87462697,239890197,2,0,1,6144,4,4675945859
6288,152436640,59298219,211734859,3,0,0,38400,3,3090788681
6289,152441059,88200763,240641822,1,0,1,121344,5,2717683676
6290,152444189,88311530,240755719,1,0,1,58368,5,3482968956
6291,152452859,89328853,241781712,0,0,1,517120,10,8239366030
6292,152479140,89381895,241861035,2,0,1,30720,4,8503434542
6293,152498129,89364680,241862809,1,0,1,13824,5,5635126293
6294,152507779,89356656,241864435,1,0,1,2560,5,5025577192
6295,152510950,89357031,241867981,6,0,1,5632,7,7279219385
6296,152687460,89183427,241870887,2,0,1,4608,4,10010719832
6297,152700679,89890408,242591087,0,0,1,196608,10,3049238323
6298,152704129,90029791,242733920,0,0,1,43520,10,171978548
6299,152807970,89925973,242733943,6,0,1,3072,7,5259805388
6300,152951569,89992507,242944076,0,0,1,292352,10,1276646763
6301,153063419,89997767,243061186,0,0,1,148480,10,6532892551
6302,153142690,58885191,212027881,3,0,0,202752,3,9606519146
6303,153244609,90008934,243253543,0,0,1,265728,10,1735858388
6304,153303909,90087219,243391128,0,0,1,70656,10,6598153370
6305,153527969,90058615,243586584,0,0,1,140800,10,10394547583
6306,153577729,90165439,243743168,0,0,1,214016,10,6231569333
6307,153623359,90124156,243747515,0,0,1,5120,10,3432857621
6308,153842740,58227330,212070070,3,0,0,20992,3,3749644179
6309,153846809,90030198,243877007,0,0,1,79872,10,10404613108
6310,153918690,58144961,212063651,3,0,0,117248,3,7441355090
6311,153942950,89964078,243907028,8,0,1,29696,2,2766678238
6312,153974829,89983784,243958613,0,0,1,76800,10,5148726609
6313,154086199,89872437,243958636,4,0,1,10240,2,10025454333
6314,154114119,89973843,244087962,0,0,1,285184,10,1675779477
6315,154160020,58084163,212244183,3,0,0,30720,3,10445589383
6316,154160219,89934909,244095128,4,0,1,3072,2,2759853497
6317,154161670,58426184,212587854,3,0,0,327168,3,4229293746
6318,154180170,57938573,212118743,3,0,0,60928,3,9483954703
6319,154184060,58262372,212446432,3,0,0,149504,3,6459633358
6320,154186889,89924445,244111334,4,0,1,28160,2,771695309
6321,154195320,89927518,244122838,8,0,1,17920,2,4534411998
6322,154220559,90238443,244459002,0,0,1,456704,10,2699347960
6323,154291080,90167945,244459025,6,0,1,2048,7,2160251074
6324,154336829,90421051,244757880,4,0,1,41472,2,5590079172
6325,154363659,90688769,245052428,0,0,1,291840,10,965657821
6326,154488979,90680406,245169385,0,0,1,90112,10,9998160565
6327,154501759,90762649,245264408,0,0,1,329216,10,3682857001
6328,154526139,90740215,245266354,4,0,1,3072,2,8660982527
6329,154664710,58318106,212982816,3,0,0,432640,3,2746128084
6330,154677619,90588991,245266610,4,0,1,9216,2,3323358438
6331,154726440,58120953,212847393,3,0,0,25088,3,6084760611
6332,154747980,90527745,245275725,8,0,1,26112,2,9819175346
6333,154779280,58255147,213034427,3,0,0,168960,3,3694737536
6334,154872309,90404031,245276340,4,0,1,18944,2,10703486216
6335,154888660,90389626,245278286,8,0,1,3072,2,10635422452
6336,154900109,90479171,245379280,4,0,1,75264,2,8315752033
6337,154921529,90492374,245413903,4,0,1,48128,2,2890937314
6338,154983789,90430268,245414057,4,0,1,8704,2,5506519801
6339,155042301,90387386,245429687,9,0,1,1024,17,2020364676
6340,155086589,90343550,245430139,4,0,1,9216,2,2092038747
6341,155100020,90337932,245437952,2,0,1,19968,4,10362507453
6342,155129140,90309171,245438311,8,0,1,9728,2,8527516319
6343,155134880,90412192,245547072,8,0,1,17920,2,5328951245
6344,155184100,90362995,245547095,2,0,1,18944,4,591780767
6345,155203659,90343459,245547118,4,0,1,3584,2,1608071525
6346,155252210,90294931,245547141,2,0,1,14336,4,1787909795
6347,155278070,90269094,245547164,6,0,1,14336,7,9980875935
6348,155281750,90274109,245555859,2,0,1,55808,4,9438723055
6349,155319740,90270838,245590578,2,0,1,46080,4,9360767322
6350,155397030,90204143,245601173,6,0,1,1536,7,7558285346
6351,155509290,90096389,245605679,6,0,1,7168,7,1312070795
6352,155526250,90079775,245606025,8,0,1,512,2,6787113494
6353,155563650,90052685,245616335,6,0,1,28160,7,3637593735
6354,155589500,90027194,245616694,8,0,1,9728,2,10541542177
6355,155596639,90068880,245665519,4,0,1,17408,2,7862392777
6356,155764300,90029544,245793844,6,0,1,33792,7,1610610258
6357,155767310,91051713,246819023,5,0,1,102400,11,4084453951
6358,155812100,57223956,213036056,3,0,0,5120,3,9674156926
6359,155824440,91914872,247739312,5,0,1,306176,11,636055406
6360,155864880,91874455,247739335,8,0,1,8704,2,7399318611
6361,155935099,91805720,247740819,4,0,1,20480,2,5430560338
6362,155935330,57561997,213497327,3,0,0,174592,3,1325678106
6363,155957169,92135850,248093019,0,0,1,264192,10,4954648660
6364,155958900,57843906,213802806,3,0,0,312832,3,7013275468
6365,156061260,92031790,248093050,6,0,1,8704,7,7392494521
6366,156097730,92028750,248126480,8,0,1,36352,2,8125196938
6367,156151969,92112656,248264625,0,0,1,148480,10,9005396271
6368,156157549,92107099,248264648,4,0,1,6144,2,2920319165
6369,156182410,92163872,248346282,5,0,1,80896,11,1494809744
6370,156234899,92111406,248346305,4,0,1,11776,2,4778083135
6371,156254069,92092259,248346328,4,0,1,24064,2,6447471043
6372,156295830,57069949,213365779,3,0,0,20992,3,7929037567
6373,156305330,92041021,248346351,3,0,1,11776,3,1508364332
6374,156360530,91997411,248357941,8,0,1,22528,2,2609748098
6375,156368390,57020737,213389127,0,0,0,20480,10,1499921785
6376,156387069,91970903,248357972,0,0,1,53248,10,7694886093
6377,156405870,57424750,213830620,3,0,0,9728,3,1470587315
6378,156497280,57210187,213707467,0,0,0,187392,10,4502135193
6379,156508510,91857160,248365670,8,0,1,9728,2,1557077524
6380,156517590,57310043,213827633,3,0,0,81408,3,6206594677
6381,156557780,91807913,248365693,8,0,1,5632,2,9169112503
6382,156740120,91625596,248365716,8,0,1,19456,2,5414355869
6383,156766370,91625936,248392306,7,0,1,77824,16,5212276537
6384,156832850,91633098,248465948,8,0,1,45568,2,9734219483
6385,156967920,91530411,248498331,8,0,1,3584,2,1132545063
6386,157046260,56995767,214042027,0,0,0,78336,10,5248967327
6387,157054260,56919573,213973833,0,0,0,217088,10,3380906584
6388,157079300,57343076,214422376,3,0,0,567808,3,701047095
6389,157195110,57253809,214448919,0,0,0,87040,10,9013342679
6390,157198270,56966436,214164706,0,0,0,208384,10,4044452104
6391,157268600,57384160,214652760,3,0,0,104960,3,10072050444
6392,157281610,91217707,248499317,8,0,1,1536,2,8926125965
6393,157285580,56698728,213984308,0,0,0,34304,10,9993648139
6394,157480470,57014515,214494985,0,0,0,60416,10,7635576670
6395,157754200,56722354,214476554,0,0,0,90624,10,10611947512
6396,157850720,57007461,214858181,0,0,0,52736,10,40146672
6397,157872520,57294128,215166648,0,0,0,569344,10,8926938876
6398,157961840,56880250,214842090,0,0,0,216064,10,3154016842
6399,158044820,56204529,214249349,0,0,0,136704,10,8154295317
6400,158141970,90368594,248510564,7,0,1,10752,16,3219800748
6401,158161900,57063271,215225171,3,0,0,192000,3,8010115841
6402,158203250,57186959,215390209,3,0,0,230912,3,3984318405
6403,158348350,56929025,215277375,3,0,0,148480,3,5589341050
6404,158363490,56956340,215319830,0,0,0,139264,10,9474282785
6405,158407490,57149454,215556944,0,0,0,361472,10,9330139905
6406,158445620,57315714,215761334,0,0,0,320000,10,4418048608
6407,158682110,56732154,215414264,0,0,0,78848,10,4955783677
6408,158687880,56735299,215423179,3,0,0,29184,3,2622727011
6409,158695280,56536778,215232058,3,0,0,22528,3,3485742533
6410,158928550,56677869,215606419,0,0,0,162304,10,7699755697
6411,158980820,57007474,215988294,0,0,0,296960,10,5155762681
6412,159222780,89850644,249073424,3,0,1,73728,3,1310311088
6413,159377320,56286491,215663811,3,0,0,31744,3,1300947232
6414,159633290,56202791,215836081,3,0,0,245248,3,3136967420
6415,159782460,55848474,215630934,0,0,0,80384,10,7091284535
6416,159882700,56192328,216075028,3,0,0,231424,3,6875463970
6417,159901559,89441504,249343063,1,0,1,17920,5,3318272490
6418,159911381,89593235,249504616,9,0,1,36352,17,8832861879
6419,160052321,89452318,249504639,9,0,1,3584,17,2330616139
6420,160101741,89402921,249504662,9,0,1,8704,17,8639702993
6421,160103581,89401104,249504685,9,0,1,1536,17,4496736289
6422,160281880,56233164,216515044,0,0,0,306688,10,9699574398
6423,160396970,55858939,216255909,6,0,0,159232,7,9041213971
6424,160448610,56546314,216994924,0,0,0,74240,10,55703279
6425,160539090,56404006,216943096,3,0,0,443904,3,9830594839
6426,160797700,55928056,216725756,6,0,0,266240,7,1286388315
6427,160847490,56418316,217265806,6,0,0,412672,7,9823892592
6428,160884890,56523803,217408693,6,0,0,105472,7,3441590238
6429,160946009,88558699,249504708,4,0,1,9216,2,182998526
6430,160965470,56063966,217029436,3,0,0,93696,3,6633717992
6431,160982670,55594324,216576994,6,0,0,45568,7,1185815539
6432,161034940,55609673,216644613,6,0,0,205312,7,6480331755
6433,161090790,56436788,217527578,3,0,0,157184,3,5464511608
6434,161109020,56727686,217836706,0,0,0,55808,10,7362283992
6435,161161189,89005808,250166997,0,0,1,360960,10,5351401806
6436,161348710,55423869,216772579,6,0,0,153600,7,7488996163
6437,161373130,56664373,218037503,3,0,0,267776,3,7788842517
6438,161534530,55248818,216783348,3,0,0,34816,3,9940802733
6439,161549470,88856122,250405592,5,0,1,213504,11,9961790281
6440,161620560,56568333,218188893,6,0,0,161280,7,2572354474
6441,161655070,55721418,217376488,3,0,0,126464,3,3076388646
6442,161697021,89179197,250876218,9,0,1,703488,17,9040665417
6443,161709991,89263852,250973843,9,0,1,208384,17,369267610
6444,161720271,89337503,251057774,9,0,1,114688,17,7685747617
6445,161745361,89523110,251268471,9,0,1,250368,17,2329643926
6446,161752420,56684095,218436515,3,0,0,309760,3,1985151685
6447,161812991,89637778,251450769,9,0,1,214016,17,3885585765
6448,161998421,89603649,251602070,9,0,1,155136,17,6657100257
6449,162089920,56583398,218673318,3,0,0,331776,3,515654446
6450,162114971,89518223,251633194,9,0,1,126976,17,9560460918
6451,162122230,56595929,218718159,6,0,0,49664,7,9194339116
6452,162189180,89711193,251900373,7,0,1,613376,16,6751590083
6453,162327960,56931546,219259506,0,0,0,140800,10,9581278956
6454,162357390,55929986,218287376,6,0,0,110080,7,8372558734
6455,162395231,90154713,252549944,9,0,1,386048,17,6141243970
6456,162480720,55836810,218317530,6,0,0,44032,7,3680267370
6457,162562081,90054189,252616270,9,0,1,61952,17,456540198
6458,162582560,55477118,218059678,6,0,0,72704,7,3512741702
6459,162627560,56401036,219028596,6,0,0,113152,7,2899044353
6460,162640190,56812660,219452850,3,0,0,110080,3,3180616680
6461,162756921,90007120,252764041,9,0,1,324608,17,6770646090
6462,162777500,55130971,217908471,6,0,0,139264,7,3581253080
6463,162812910,89958863,252771773,2,0,1,12288,4,250280436
6464,162849801,90012601,252862402,9,0,1,192000,17,8272499480
6465,162860460,55279270,218139730,0,0,0,86016,10,9025086061
6466,162866180,55984150,218850330,3,0,0,68608,3,4670785787
6467,162873360,89993842,252867202,5,0,1,25600,11,4346268164
6468,162874350,55429741,218304091,0,0,0,54784,10,941265514
6469,162882060,56725012,219607072,3,0,0,164864,3,5089651854
6470,162955260,55532937,218488197,6,0,0,169472,7,8616982586
6471,162961539,89931660,252893199,1,0,1,42496,5,5735481499
6472,163001360,55813860,218815220,3,0,0,165376,3,6915840751
6473,163029500,55833177,218862677,6,0,0,40448,7,3090588860
6474,163057731,90078065,253135796,9,0,1,273920,17,9763785433
6475,163090221,90045941,253136162,9,0,1,178176,17,6372025225
6476,163189989,89946196,253136185,4,0,1,3072,2,1095369269
6477,163239250,89896958,253136208,2,0,1,11776,4,9826368901
6478,163275019,89861212,253136231,4,0,1,5632,2,6730903694
6479,163282500,55262348,218544848,3,0,0,185856,3,699104526
6480,163289240,89935083,253224323,5,0,1,217600,11,505983802
6481,163426400,89834450,253260850,5,0,1,81920,11,9261838560
6482,163426440,89855742,253282182,2,0,1,51200,4,8486723769
6483,163514210,55416706,218930916,0,0,0,115200,10,7768430679
6484,163576730,89707718,253284448,2,0,1,3584,4,3876675451
6485,163633781,89710787,253344568,9,0,1,152064,17,7972379495
6486,163649001,90074175,253723176,9,0,1,758272,17,7715336526
6487,163700050,56198309,219898359,0,0,0,395776,10,8025855260
6488,163755060,89974104,253729164,2,0,1,4096,4,4976909973
6489,163783910,54919071,218702981,6,0,0,97280,7,845377504
6490,163785750,89948560,253734310,2,0,1,8192,4,8158884066
6491,163808220,89935965,253744185,2,0,1,6144,4,835358368
6492,163820770,89925681,253746451,2,0,1,3584,4,7339872840
6493,163824491,90176003,254000494,9,0,1,384512,17,2876297280
6494,163857570,56118032,219975602,6,0,0,253440,7,2766587581
6495,163922870,90090016,254012886,2,0,1,38400,4,7588254230
6496,163945610,54599793,218545403,0,0,0,1536,10,6355411666
6497,164202950,89839632,254042582,5,0,1,43520,11,6442832401
6498,164219750,89850975,254070725,5,0,1,98304,11,4235782520
6499,164266680,89821536,254088216,5,0,1,14336,11,3856662796
6500,164358980,54761415,219120395,3,0,0,15360,3,1185974724
6501,164365021,90236902,254601923,9,0,1,1006080,17,1255565963
6502,164383530,54883175,219266705,7,0,0,23552,16,7734864209
6503,164444091,90250802,254694893,9,0,1,211968,17,4307368512
6504,164471380,90378211,254849591,5,0,1,393216,11,10192447227
6505,164490610,90369494,254860104,5,0,1,43520,11,4296806881
6506,164501931,90442269,254944200,9,0,1,150528,17,8162032717
6507,164508641,90634849,255143490,9,0,1,504320,17,9042761284
6508,164515270,55614092,220129362,6,0,0,129024,7,6066549337
6509,164540530,54657888,219198418,7,0,0,256000,16,7542520550
6510,164559990,54853346,219413336,7,0,0,96256,16,6724388045
6511,164614790,90711596,255326386,5,0,1,380416,11,5364867015
6512,164640890,54743095,219383985,7,0,0,244736,16,487185325
6513,164656911,90735424,255392335,9,0,1,179200,17,8639489635
6514,164724760,90685008,255409768,2,0,1,27136,4,7637533966
6515,164767420,54651867,219419287,0,0,0,19456,10,9566695916
6516,164773499,90637037,255410536,4,0,1,11776,2,5432021043
6517,164785930,55515092,220301022,0,0,0,5632,10,4149655644
6518,164826229,90588507,255414736,4,0,1,6144,2,1341261787
6519,164833200,90585402,255418602,6,0,1,6144,7,10724174753
6520,164918869,90500079,255418948,4,0,1,512,2,237184930
6521,164919561,90510952,255430513,9,0,1,33280,17,1730036595
6522,164920730,55378553,220299283,7,0,0,6144,16,7063511491
6523,164923419,90507117,255430536,4,0,1,2048,2,7871795101
6524,164931970,90502302,255434272,2,0,1,6656,4,5408599773
6525,164936320,90505031,255441351,5,0,1,41984,11,4723069290
6526,164941440,90646119,255587559,5,0,1,369664,11,10654755880
6527,164946340,90804557,255750897,5,0,1,234496,11,2308503316
6528,164954960,55342366,220297326,3,0,0,320000,3,2678943670
6529,164967951,90860781,255828732,9,0,1,71680,17,5640372050
6530,164979569,90853533,255833102,4,0,1,8192,2,2557090239
6531,164983751,90887581,255871332,9,0,1,75264,17,1838963228
6532,164986320,55103528,220089848,7,0,0,330240,16,7677861805
6533,165098490,55317766,220416256,3,0,0,76288,3,1904454310
6534,165116180,90762347,255878527,3,0,1,11776,3,256193218
6535,165116220,54872977,219989197,3,0,0,44544,3,10577779957
6536,165136200,55231457,220367657,7,0,0,218624,16,380043656
6537,165171569,90716676,255888245,4,0,1,35328,2,8733580360
6538,165185590,55013402,220198992,6,0,0,205312,7,4881726316
6539,165191330,90704654,255895984,6,0,1,13824,7,2400934537
6540,165192400,90726863,255919263,2,0,1,57344,4,2642582991
6541,165195669,90735699,255931368,4,0,1,10240,2,9670143704
6542,165211280,54925133,220136413,6,0,0,23040,7,707647700
6543,165212090,54987705,220199795,7,0,0,2560,16,10491573123
6544,165229220,54860807,220090027,0,0,0,512,10,10419013838
6545,165238280,90722005,255960285,6,0,1,40960,7,727385741
6546,165265599,90709045,255974644,4,0,1,4608,2,1333901476
6547,165270300,90720067,255990367,7,0,1,33792,16,8984547972
6548,165309600,55460067,220769667,3,0,0,354816,3,6062682182
6549,165332240,55544430,220876670,6,0,0,233472,7,8222863568
6550,165335530,55033270,220368800,0,0,0,3072,10,3594534227
6551,165407020,90658983,256066003,5,0,1,157696,11,8362528707
6552,165493160,55547425,221040585,3,0,0,357376,3,7065927825
6553,165599070,91836806,257435876,5,0,1,1285120,11,6468176191
6554,165617860,91823162,257441022,3,0,1,8192,3,674654974
6555,165621160,55310514,220931674,6,0,0,180224,7,7503341025
6556,165652280,91827714,257479994,2,0,1,6144,4,7294193944
6557,165670360,55450352,221120712,0,0,0,6656,10,5286900326
6558,165676841,91840692,257517533,9,0,1,96768,17,2566523162
6559,165690150,92322979,258013129,5,0,1,715776,11,10293621733
6560,165749880,55291421,221041301,7,0,0,2048,16,10457279491
6561,165808380,55649753,221458133,7,0,0,344064,16,4985830324
6562,165809060,55490247,221299307,3,0,0,34304,3,6189465834
6563,165810511,92227342,258037853,9,0,1,304128,17,6356012111
6564,165854170,92212456,258066626,5,0,1,64512,11,7040798499
6565,165870730,55181381,221052111,6,0,0,30720,7,8928208795
6566,165901840,55140888,221042728,6,0,0,4608,7,3203288048
6567,165915870,92162304,258078174,2,0,1,46592,4,3215055868
6568,165924620,92221989,258146609,5,0,1,176640,11,3801894664
6569,166068339,92350826,258419165,0,0,1,443904,10,239814949
6570,166077790,55384110,221461900,6,0,0,12288,7,8811423451
6571,166088250,92404395,258492645,5,0,1,166912,11,3647227899
6572,166160750,54972933,221133683,6,0,0,42496,7,9818991426
6573,166169910,55388946,221558856,7,0,0,284160,16,7302915644
6574,166195550,92311394,258506944,2,0,1,21504,4,7827484688
6575,166198760,92454775,258653535,5,0,1,312832,11,963128120
6576,166233361,92535432,258768793,9,0,1,283648,17,6733221246
6577,166266451,93273490,259539941,9,0,1,835584,17,3396530008
6578,166334670,54783991,221118661,7,0,0,151040,16,5416733422
6579,166370960,93237379,259608339,5,0,1,333824,11,7413714809
6580,166397830,54738184,221136014,7,0,0,3584,16,2861348846
6581,166410760,54772794,221183554,3,0,0,14336,3,602243492
6582,166439700,54619298,221058998,3,0,0,22528,3,8723845271
6583,166453181,93228326,259681507,9,0,1,73216,17,4514910779
6584,166454390,55800746,222255136,7,0,0,47104,16,4735013180
6585,166468541,93261598,259730139,9,0,1,32768,17,2526491399
6586,166501520,56918939,223420459,7,0,0,264192,16,1547010113
6587,166606390,56133509,222739899,3,0,0,46080,3,10039758300
6588,166668871,93126536,259795407,9,0,1,96256,17,7249470797
6589,166680950,93130045,259810995,2,0,1,24064,4,10290116373
6590,166723311,93446534,260169845,9,0,1,618496,17,6250071157
6591,166737760,93524602,260262362,5,0,1,202752,11,778754632
6592,166744761,93836339,260581100,9,0,1,530944,17,7685473645
6593,166759520,55867241,222626761,7,0,0,125952,16,1403285338
6594,166764050,55764367,222528417,7,0,0,58880,16,599745732
6595,166765151,93878880,260644031,9,0,1,11264,17,1729280187
6596,166776520,56740402,223516922,6,0,0,180224,7,2148234505
6597,166777581,94297211,261074792,9,0,1,296960,17,3590491756
6598,166779391,94502792,261282183,9,0,1,60416,17,2585919658
6599,166793710,94537081,261330791,5,0,1,210432,11,8646754846
6600,166838850,94564045,261402895,5,0,1,252416,11,7156141536
6601,166879880,94523038,261402918,5,0,1,4608,11,5066531017
6602,166882890,94719492,261602382,5,0,1,299520,11,6861574231
6603,166899590,94702815,261602405,2,0,1,23552,4,6463793845
6604,166932150,55194111,222126261,4,0,0,1536,2,8855536872
6605,166966601,94635827,261602428,9,0,1,38400,17,3777345484
6606,166974580,55305404,222279984,4,0,0,1024,2,5572333727
6607,167001620,94600831,261602451,2,0,1,3072,4,329431282
6608,167038210,55731664,222769874,3,0,0,98304,3,5405443154
6609,167095630,94506844,261602474,2,0,1,15872,4,5806813884
6610,167120370,94580129,261700499,5,0,1,246784,11,4751185750
6611,167126450,56099775,223226225,6,0,0,130560,7,9236448372
6612,167160720,56025702,223186422,7,0,0,230912,16,6359936126
6613,167161190,55953403,223114593,3,0,0,461312,3,4813408937
6614,167164940,56512716,223677656,7,0,0,318464,16,1976324009
6615,167165420,94556757,261722177,2,0,1,18432,4,1096359261
6616,167257280,55858584,223115864,0,0,0,4096,10,1064276346
6617,167270770,94463362,261734132,2,0,1,22016,4,5308706215
6618,167275800,55975067,223250867,6,0,0,59904,7,240541328
6619,167279600,94532442,261812042,5,0,1,140800,11,7565908724
6620,167283480,55832563,223116043,0,0,0,512,10,1066564768
6621,167313801,94538605,261852406,9,0,1,68096,17,9834603242
6622,167384800,55497843,222882643,6,0,0,37376,7,8315509434
6623,167399040,95475836,262874876,5,0,1,782336,11,8573628802
6624,167424240,54993658,222417898,7,0,0,192000,16,1721247828
6625,167454580,55502443,222957023,0,0,0,5120,10,10415479606
6626,167454900,95486224,262941124,5,0,1,258048,11,62108826
6627,167456310,54616793,222073103,4,0,0,5632,2,7390855461
6628,167495990,95450728,262946718,2,0,1,26624,4,4225035844
6629,167529710,95417674,262947384,2,0,1,1024,4,4646770648
6630,167545830,56011704,223557534,7,0,0,96256,16,6871520259
6631,167570880,95391836,262962716,2,0,1,40448,4,4701190122
6632,167590810,56410678,224001488,3,0,0,57344,3,6762962528
6633,167610630,56243448,223854078,0,0,0,4608,10,2944937842
6634,167681420,55842931,223524351,4,0,0,8192,2,5296294032
6635,167707080,95259430,262966510,2,0,1,4096,4,7108643153
6636,167756880,56078752,223835632,6,0,0,56832,7,8570815103
6637,167772941,95276762,263049703,9,0,1,220672,17,554447886
6638,167823970,55597292,223421262,0,0,0,2560,10,4466560924
6639,167849820,55710233,223560053,4,0,0,8192,2,6656923085
6640,167872430,95389893,263262323,5,0,1,458752,11,4081035248
6641,167881340,95534742,263416082,5,0,1,321536,11,1837253217
6642,167911010,95518874,263429884,2,0,1,57344,4,2482333162
6643,167946570,95483673,263430243,2,0,1,9728,4,125683018
6644,167983639,95498227,263481866,0,0,1,116224,10,4525830743
6645,167986240,56149996,224136236,3,0,0,338432,3,7176367214
6646,168076751,95417685,263494436,9,0,1,54272,17,6620403014
6647,168143079,95757026,263900105,0,0,1,692224,10,7489319920
6648,168146120,55837873,223983993,7,0,0,67072,16,4929493176
6649,168187910,95716860,263904770,2,0,1,1536,4,377652941
6650,168328650,55412155,223740805,4,0,0,9728,2,3768544536
6651,168350260,95559336,263909596,2,0,1,7680,4,9044195674
6652,168361160,55539957,223901117,4,0,0,1024,2,6147921597
6653,168363000,95549182,263912182,2,0,1,4096,4,10733195180
6654,168460499,95540631,264001130,0,0,1,85504,10,6779675716
6655,168462791,96174851,264637642,9,0,1,631296,17,9696812547
6656,168482880,54938717,223421597,4,0,0,1024,2,1273784580
6657,168529200,55323281,223852481,7,0,0,12800,16,8828456383
6658,168531670,55286623,223818293,6,0,0,26624,7,3634855364
6659,168568470,96083152,264651622,2,0,1,4608,4,10643509083
6660,168596540,96055748,264652288,2,0,1,11264,4,5348667454
6661,168604010,55807424,224411434,7,0,0,3072,16,6945047308
6662,168623880,56563572,225187452,0,0,0,1024,10,1411138224
6663,168643731,96116609,264760340,9,0,1,261632,17,8471124149
6664,168656169,96536278,265192447,0,0,1,736256,10,10211614528
6665,168721290,55646130,224367420,6,0,0,108544,7,5789878083
6666,168730470,96462963,265193433,2,0,1,1536,4,5680809063
6667,168741550,96458963,265200513,2,0,1,33792,4,10396936214
6668,168747320,96458019,265205339,2,0,1,7680,4,35631055
6669,168750649,96508348,265258997,0,0,1,121344,10,3199202844
6670,168809090,55830482,224639572,0,0,0,512,10,4829139852
6671,168826280,55855397,224681677,6,0,0,25088,7,4667905780
6672,168836779,96513367,265350146,0,0,1,249856,10,3715750281
6673,168840790,96510662,265351452,2,0,1,2048,4,6417200078
6674,168883239,96517649,265400888,0,0,1,133632,10,8884231925
6675,168893290,55594015,224487305,6,0,0,137728,7,793202657
6676,168894600,56180381,225074981,4,0,0,255488,2,1492438531
6677,168904740,56850415,225755155,3,0,0,907776,3,4318811637
6678,168906950,55503525,224410475,0,0,0,8704,10,9287521088
6679,168920411,96505884,265426295,9,0,1,69632,17,10039537200
6680,168942730,55910907,224853637,7,0,0,181760,16,3470504606
6681,168961930,56410729,225372659,4,0,0,276992,2,192869516
6682,169020980,55549198,224570178,0,0,0,2048,10,8854355491
6683,169083141,96351398,265434539,9,0,1,13824,17,3366984055
6684,169146571,96304934,265451505,9,0,1,41984,17,8207998644
6685,169222840,55416553,224639393,6,0,0,209408,7,2061836794
6686,169240780,56589613,225830393,3,0,0,246784,3,7771179845
6687,169312920,96139661,265452581,2,0,1,13312,4,367351743
6688,169350299,96236940,265587239,0,0,1,311296,10,7785516142
6689,169405759,96190926,265596685,1,0,1,17408,5,2058727303
6690,169464950,96136241,265601191,2,0,1,7168,4,9113881358
6691,169474040,96155310,265629350,2,0,1,36352,4,6027047615
6692,169484290,56389609,225873899,7,0,0,142336,16,3289314756
6693,169486060,96144878,265630938,2,0,1,15872,4,3550501581
6694,169510449,96122244,265632693,0,0,1,14336,10,1796425378
6695,169512711,96187358,265700069,9,0,1,82944,17,5358766115
6696,169528961,96371773,265900734,9,0,1,399872,17,488703043
6697,169537660,96364047,265901707,2,0,1,12800,4,8965327260
6698,169555870,55732370,225288240,3,0,0,170496,3,8658779887
6699,169556639,96468790,266025429,0,0,1,265216,10,278502926
6700,169576000,96459383,266035383,2,0,1,18944,4,9134069852
6701,169609690,56339930,225949620,6,0,0,31744,7,733475294
6702,169691830,56411085,226102915,7,0,0,144384,16,174958875
6703,169723520,55481604,225205124,0,0,0,3072,10,5619276256
6704,169739869,96299770,266039639,1,0,1,14336,5,3125537707
6705,169748400,56521654,226270054,4,0,0,403456,2,6700640264
6706,169791081,96355821,266146902,9,0,1,251904,17,2606703814
6707,169828460,96342464,266170924,3,0,1,9216,3,9427413330
6708,169844161,96369112,266213273,9,0,1,41984,17,619660949
6709,169856580,96374396,266230976,3,0,1,2560,3,10457176948
6710,169856929,96374070,266230999,1,0,1,7680,5,2249121236
6711,169875520,56445406,226320926,4,0,0,128512,2,9489215486
6712,169891610,56379099,226270709,3,0,0,2048,3,9245870753
6713,169907160,96323862,266231022,3,0,1,3072,3,10680143782
6714,169918110,96312935,266231045,2,0,1,2048,4,3731083163
6715,169949779,96281289,266231068,1,0,1,14848,5,1759585415
6716,169977671,96431048,266408719,9,0,1,265728,17,5126441850
6717,170016950,96417017,266433967,7,0,1,29184,16,4744824609
6718,170023011,97212933,267235944,9,0,1,295936,17,4093060389
6719,170030170,97209000,267239170,2,0,1,5120,4,7999569034
6720,170050270,97198110,267248380,2,0,1,6656,4,8822552412
6721,170101091,97543085,267644176,9,0,1,357888,17,10728391140
6722,170107179,97537020,267644199,1,0,1,10752,5,3667250014
6723,170114550,97531411,267645961,3,0,1,24576,3,393395867
6724,170222550,56285194,226507744,6,0,0,10752,7,4764270103
6725,170231000,97489982,267720982,2,0,1,111616,4,6094365097
6726,170240800,56463294,226704094,7,0,0,165376,16,2337461382
6727,170250960,56402700,226653660,6,0,0,52224,7,3506159534
6728,170251700,56327424,226579124,6,0,0,36352,7,10432419842
6729,170464680,55987225,226451905,0,0,0,1024,10,5049988807
6730,170509650,97212552,267722202,2,0,1,36352,4,10394298888
6731,170530541,97202504,267733045,9,0,1,27136,17,7122129336
6732,170573360,97187533,267760893,2,0,1,11264,4,9896672632
6733,170612371,97898298,268510669,9,0,1,491520,17,8251240850
6734,170617100,56248409,226865509,3,0,0,98304,3,247560372
6735,170618290,56463219,227081509,6,0,0,40960,7,3203043714
6736,170638110,56149931,226788041,0,0,0,1024,10,5849682873
6737,170645990,56494766,227140756,4,0,0,14848,2,5635867007
6738,170684050,56308083,226992133,4,0,0,71680,2,1474282529
6739,170714140,56714511,227428651,7,0,0,312320,16,514850340
6740,170749580,97825105,268574685,3,0,1,51200,3,7292685101
6741,170755680,56170035,226925715,0,0,0,4096,10,9565251052
6742,170762969,97817829,268580798,1,0,1,22528,5,257041850
6743,170769380,56739836,227509216,4,0,0,127488,2,3731303128
6744,170803630,56449938,227253568,7,0,0,62464,16,6293826618
6745,170819970,56702583,227522553,4,0,0,43520,2,1990732542
6746,170824030,56318777,227142807,3,0,0,6656,3,4134578739
6747,170824140,56845412,227669552,3,0,0,185344,3,3100964373
6748,170842939,97740125,268583064,1,0,1,3584,5,1176648334
6749,170846019,97737813,268583832,1,0,1,11776,5,9569443578
6750,170856820,56400229,227257049,0,0,0,512,10,4324008255
6751,170871869,97712629,268584498,1,0,1,1024,5,4871944758
6752,170872410,97717273,268589683,5,0,1,24576,11,660916204
6753,170888780,56581569,227470349,6,0,0,136704,7,9621280888
6754,170918650,98414447,269333097,5,0,1,692736,11,2592057121
6755,170955460,98391871,269347331,5,0,1,29696,11,6622667110
6756,171056729,98310326,269367055,1,0,1,28672,5,2357923154
6757,171075299,98304805,269380104,1,0,1,47616,5,3159779101
6758,171124100,56545943,227670043,0,0,0,1536,10,6067483652
6759,171131360,98260206,269391566,3,0,1,23552,3,7331820569
6760,171138460,56762006,227900466,3,0,0,120320,3,7229368628
6761,171161310,98832753,269994063,5,0,1,493056,11,784860252
6762,171171000,98823086,269994086,5,0,1,9216,11,9051998469
6763,171179840,98820110,269999950,3,0,1,23552,3,3922954633
6764,171265020,56967026,228232046,4,0,0,558080,2,4061912163
6765,171274360,99016468,270290828,5,0,1,544768,11,8305693589
6766,171310550,56949778,228260328,0,0,0,1024,10,2286038920
6767,171320930,57307774,228628704,6,0,0,404992,7,8977156894
6768,171335980,56603061,227939041,0,0,0,1024,10,10060262922
6769,171357350,98939008,270296358,3,0,1,3584,3,4978553568
6770,171360420,56899573,228259993,4,0,0,91648,2,3318881288
6771,171436360,56384381,227820741,0,0,0,4096,10,8768155543
6772,171446029,98850352,270296381,1,0,1,512,5,8502823775
6773,171462639,56384575,227847214,0,0,0,1024,10,2319458094
6774,171486929,98811017,270297946,1,0,1,7168,5,6398253096
6775,171583640,56825100,228408740,3,0,0,97792,3,8290284735
6776,171615870,56430238,228046108,7,0,0,88064,16,1994635663
6777,171684809,98620791,270305600,1,0,1,5120,5,3537939573
6778,171689309,56240903,227930212,0,0,0,5120,10,6550647596
6779,171760770,57196638,228957408,6,0,0,209408,7,1296387566
6780,171793359,57244576,229037935,0,0,0,2560,10,10481480778
6781,171810560,98507390,270317950,7,0,1,512,16,9599615598
6782,171835259,98482845,270318104,0,0,1,8704,10,2287130839
6783,171875370,98458029,270333399,7,0,1,37376,16,3433192552
6784,171875640,56385647,228261287,0,0,0,3072,10,6107186323
6785,171885140,56560329,228445469,3,0,0,120320,3,2230506618
6786,171889030,98453871,270342901,2,0,1,4608,4,1408110796
6787,171988449,98366095,270354544,1,0,1,31232,5,3941359969
6788,172004310,57245125,229249435,7,0,0,43008,16,6866510316
6789,172008149,56622432,228630581,0,0,0,5632,10,9587406491
6790,172014690,56763318,228778008,4,0,0,71168,2,2073771822
6791,172025339,98360842,270386181,1,0,1,8192,5,7191275203
6792,172082900,98305867,270388767,7,0,1,4096,16,5402773998
6793,172095930,57433806,229529736,3,0,0,245248,3,7864020383
6794,172131609,98258234,270389843,1,0,1,13312,5,6962817050
6795,172141310,56958261,229099571,4,0,0,176128,2,3271042767
6796,172151260,56697073,228848333,4,0,0,63488,2,7277350050
6797,172184450,98208619,270393069,7,0,1,5120,16,10216786909
6798,172233810,56905782,229139592,7,0,0,91136,16,2969878409
6799,172242850,57307665,229550515,6,0,0,68096,7,10065706074
6800,172297969,98104756,270402725,4,0,1,30208,2,390375799
6801,172303350,98130219,270433569,2,0,1,28160,4,8101381923
6802,172329900,56906408,229236308,3,0,0,32768,3,8447996179
6803,172332680,57122309,229454989,3,0,0,206336,3,9351849070
6804,172351220,56875081,229226301,6,0,0,95744,7,4431969775
6805,172355369,56670463,229025832,0,0,0,2048,10,3216871269
6806,172404339,98029998,270434337,4,0,1,11776,2,9228856040
6807,172434060,57385784,229819844,4,0,0,192512,2,2504294128
6808,172530080,97948211,270478291,2,0,1,29184,4,4403822229
6809,172567109,97912053,270479162,4,0,1,12288,2,239575070
6810,172568470,57449716,230018186,4,0,0,292864,2,7063351701
6811,172603799,97889523,270493322,4,0,1,512,2,1278647340
6812,172614380,56665663,229280043,6,0,0,6656,7,1034816400
6813,172617840,56963120,229580960,6,0,0,80384,7,442356254
6814,172649600,56742498,229392098,6,0,0,36352,7,6838816658
6815,172680770,56910821,229591591,6,0,0,34816,7,1763814584
6816,172695790,97814117,270509907,2,0,1,15872,4,8186986161
6817,172722570,57168121,229890691,3,0,0,232448,3,1281593247
6818,172733400,57398040,230131440,6,0,0,118784,7,10420784321
6819,172757960,97753893,270511853,8,0,1,3072,2,947657591
6820,172770880,57279465,230050345,4,0,0,105472,2,3011400114
6821,172794600,97733622,270528222,7,0,1,1024,16,6518205740
6822,172818850,56823142,229641992,3,0,0,28672,3,4726498497
6823,172980610,97548278,270528888,2,0,1,1024,4,4303062423
6824,173007100,57208057,230215157,6,0,0,172032,7,8441648204
6825,173070500,97543114,270613614,5,0,1,59392,11,6642455257
6826,173083280,97680269,270763549,7,0,1,122880,16,3680239819
6827,173125860,97746277,270872137,8,0,1,37376,2,4515414402
6828,173137750,57111906,230249656,6,0,0,113152,7,9463293870
6829,173166090,56929073,230095163,7,0,0,146944,16,1483317687
6830,173174410,97703780,270878190,8,0,1,14336,2,1991201839
6831,173185070,97695386,270880456,8,0,1,3584,2,4966846977
6832,173217190,57076194,230293384,7,0,0,51712,16,9181389538
6833,173264690,97677168,270941858,2,0,1,43008,4,4068920786
6834,173267170,97674711,270941881,7,0,1,2560,16,6431729684
6835,173272180,97680598,270952778,7,0,1,2560,16,7121978178
6836,173280610,97684780,270965390,2,0,1,24576,4,1695436585
6837,173292210,57173849,230466059,7,0,0,6144,16,5813471494
6838,173301530,97734096,271035626,2,0,1,24064,4,3733360186
6839,173323120,97712529,271035649,7,0,1,6656,16,10521043335
6840,173369970,57428583,230798553,7,0,0,206848,16,6052949859
6841,173371800,97663872,271035672,8,0,1,12800,2,7206279871
6842,173391900,98391816,271783716,5,0,1,512512,11,4085514333
6843,173400250,57335248,230735498,6,0,0,291840,7,9858121145
6844,173414510,98369229,271783739,2,0,1,1024,4,2264255166
6845,173433560,98350202,271783762,8,0,1,7680,2,5289556708
6846,173438140,98345645,271783785,8,0,1,22016,2,7662807007
6847,173469470,57375291,230844761,3,0,0,89088,3,3280788058
6848,173491750,98334164,271825914,7,0,1,45568,16,5790314310
6849,173505100,98329132,271834232,8,0,1,10240,2,231075543
6850,173508120,57443905,230952025,3,0,0,23552,3,2002918095
6851,173513130,98321358,271834488,8,0,1,9216,2,3039166943
6852,173559920,98281005,271840925,7,0,1,9216,16,5413135216
6853,173585160,98257711,271842871,2,0,1,3072,4,2888829489
6854,173605220,98272653,271877873,7,0,1,23040,16,9816386254
6855,173607410,98293618,271901028,5,0,1,19968,11,3777819564
6856,173614210,99327701,272941911,5,0,1,454656,11,3843530359
6857,173630420,99311514,272941934,7,0,1,16384,16,1015386592
6858,173636070,99515580,273151650,5,0,1,315904,11,3557297677
6859,173671870,99479811,273151681,2,0,1,23552,4,9315093618
6860,173688819,99462893,273151712,4,0,1,67584,2,3201321577
6861,173689150,99462585,273151735,8,0,1,2560,2,3130980549
6862,173706970,99444796,273151766,2,0,1,22528,4,4941548493
6863,173718490,99433307,273151797,7,0,1,9216,16,10552372355
6864,173718660,57334698,231053358,0,0,0,1536,10,3452301309
6865,173723450,99473945,273197395,5,0,1,60928,11,5928436726
6866,173737429,99459989,273197418,4,0,1,512,2,7980864521
6867,173753010,57994076,231747086,3,0,0,228352,3,3607783783
6868,173756520,99440921,273197441,7,0,1,1536,16,1428544339
6869,173759880,99453863,273213743,2,0,1,19456,4,9263905588
6870,173805890,58106792,231912682,7,0,0,65024,16,4199200318
6871,173808070,57703986,231512056,3,0,0,130560,3,10362213513
6872,173810650,99403116,273213766,7,0,1,5120,16,1105244897
6873,173813150,58373993,232187143,3,0,0,457728,3,3562134430
6874,173832780,58060067,231892847,4,0,0,310272,2,6032599921
6875,173865629,99348160,273213789,4,0,1,5632,2,7103343068
6876,173882840,99330972,273213812,3,0,1,12800,3,10209515580
6877,173898320,99315515,273213835,3,0,1,13824,3,8029844363
6878,173907160,99306706,273213866,2,0,1,1024,4,4684186654
6879,173910090,99303799,273213889,2,0,1,512,4,3896534740
6880,173912500,99419427,273331927,5,0,1,107520,11,2555873724
6881,173920890,58597611,232518501,7,0,0,142848,16,3240094184
6882,173951400,99419358,273370758,8,0,1,28160,2,4063161442
6883,173982149,99399901,273382050,4,0,1,8192,2,8071135685
6884,173982910,99401406,273384316,8,0,1,3584,2,10430900314
6885,173993720,99392414,273386134,3,0,1,2560,3,664537986
6886,173994139,99392661,273386800,4,0,1,1024,2,5352090374
6887,174015500,99413324,273428824,8,0,1,28672,2,6721149309
6888,174061450,58692773,232754223,3,0,0,51200,3,1709621870
6889,174087160,99503657,273590817,2,0,1,72192,4,16818671
6890,174109140,59316548,233425688,4,0,0,145920,2,1774438504
6891,174118809,99492389,273611198,4,0,1,46080,2,2264327402
6892,174174259,99442085,273616344,1,0,1,8192,5,6612257612
6893,174188590,58440017,232628607,4,0,0,83968,2,922688285
6894,174188990,99575596,273764586,8,0,1,85504,2,7587136233
6895,174218380,99546229,273764609,7,0,1,26624,16,6615751627
6896,174232030,58506524,232738554,7,0,0,312320,16,4259696279
6897,174232220,99533371,273765591,3,0,1,30208,3,8770820917
6898,174235810,58810715,233046525,3,0,0,186880,3,5808856744
6899,174240430,59000044,233240474,3,0,0,93696,3,8552743110
6900,174250160,99515454,273765614,7,0,1,23040,16,6029452159
6901,174250250,58316747,232566997,0,0,0,2560,10,10736888712
6902,174260540,100436036,274696576,5,0,1,644096,11,8691151188
6903,174263620,100433315,274696935,7,0,1,9728,16,2330614429
6904,174295210,100592086,274887296,5,0,1,126464,11,9595945013
6905,174368530,58386340,232754870,0,0,0,2048,10,5930847726
6906,174368570,100518757,274887327,2,0,1,36352,4,10385324945
6907,174402040,58857957,233259997,7,0,0,64000,16,5401924225
6908,174406530,58930159,233336689,0,0,0,2048,10,5789455146
6909,174415500,100471850,274887350,2,0,1,2048,4,514184790
6910,174416860,100470513,274887373,7,0,1,16896,16,2511689633
6911,174451690,100435706,274887396,3,0,1,27136,3,1718999239
6912,174459470,100427949,274887419,3,0,1,82944,3,4921601706
6913,174465130,100422312,274887442,2,0,1,14336,4,7879932052
6914,174478000,100627967,275105967,7,0,1,40960,16,436616639
6915,174480360,59214451,233694811,7,0,0,100352,16,9711650250
6916,174498360,59410069,233908429,4,0,0,312320,2,3849816634
6917,174521480,100584510,275105990,3,0,1,37376,3,8305109199
6918,174554070,59259168,233813238,7,0,0,388608,16,1196906693
6919,174585240,100520773,275106013,7,0,1,1536,16,1694428819
6920,174605190,100500846,275106036,3,0,1,28160,3,8122670967
6921,174619530,58255989,232875519,7,0,0,8704,16,3513198805
6922,174623060,58471295,233094355,6,0,0,4608,7,6916573772
6923,174644800,100461259,275106059,3,0,1,19456,3,5203788226
6924,174672990,100454955,275127945,2,0,1,13312,4,3122199714
6925,174687140,100440828,275127968,3,0,1,12800,3,5170784886
6926,174693020,100434971,275127991,3,0,1,3584,3,5988654725
6927,174694930,100433084,275128014,8,0,1,2048,2,9221062893
6928,174712570,59487295,234199865,3,0,0,92160,3,5752473238
6929,174742230,59350988,234093218,6,0,0,224768,7,959678799
6930,174788950,58475770,233264720,0,0,0,2048,10,1252290203
6931,174833690,59338001,234171691,4,0,0,257024,2,10197083281
6932,174835490,58698638,233534128,4,0,0,99328,2,1251592878
6933,174840740,59183971,234024711,3,0,0,242176,3,5496570784
6934,174846320,100281717,275128037,2,0,1,1536,4,5976976014
6935,174849050,58710660,233559710,7,0,0,16896,16,5297575514
6936,174861059,100267001,275128060,1,0,1,17920,5,2392079844
6937,174889430,100243668,275133098,5,0,1,174592,11,5215575825
6938,174907830,100242258,275150088,5,0,1,71680,11,10111760663
6939,174914260,100236494,275150754,8,0,1,1024,2,8383697333
6940,174923570,100229374,275152944,5,0,1,13312,11,8399842791
6941,174936890,59014002,233950892,7,0,0,139264,16,9670310855
6942,174979530,100271862,275251392,5,0,1,162304,11,5178172778
6943,175021260,100230155,275251415,8,0,1,512,2,3929290268
6944,175093250,59187300,234280550,6,0,0,155136,7,2183957943
6945,175098930,100156262,275255192,5,0,1,45568,11,4336155268
6946,175102850,100168678,275271528,2,0,1,3584,4,1592910456
6947,175143570,59192846,234336416,6,0,0,45568,7,2727666262
6948,175151370,58436377,233587747,0,0,0,1024,10,3162362047
6949,175171970,100111822,275283792,3,0,1,39936,3,9633076208
6950,175185700,100118891,275304591,3,0,1,47104,3,1528445484
6951,175202380,100117087,275319467,7,0,1,12800,16,4438774054
6952,175203700,100141185,275344885,2,0,1,28160,4,7276349318
6953,175209210,100153202,275362412,2,0,1,52224,4,6683292475
6954,175215900,100152209,275368109,8,0,1,18944,2,2432834996
6955,175290630,100083150,275373780,2,0,1,8192,4,2128000986
6956,175353610,100024036,275377646,3,0,1,6144,3,2954963565
6957,175358150,100030914,275389064,8,0,1,14848,2,10289862690
6958,175360650,58961859,234322509,7,0,0,41472,16,7940543715
6959,175418680,59195239,234613919,6,0,0,116736,7,8785067895
6960,175420180,59062024,234482204,0,0,0,9216,10,2368548521
6961,175428610,100007557,275436167,3,0,1,43008,3,10249176489
6962,175437369,99998821,275436190,1,0,1,26112,5,10396367604
6963,175440770,99995443,275436213,7,0,1,8192,16,5285089774
6964,175458590,99977646,275436236,8,0,1,25600,2,5663431258
6965,175479180,99957079,275436259,3,0,1,4096,3,8665129686
6966,175484159,99952123,275436282,1,0,1,12800,5,2214905621
6967,175508790,59438709,234947499,6,0,0,338432,7,5747394263
6968,175520770,59223972,234744742,0,0,0,512,10,2260700477
6969,175529459,99937128,275466587,1,0,1,43008,5,8455057967
6970,175569340,59145516,234714856,4,0,0,103424,2,9303511765
6971,175576339,99892641,275468980,1,0,1,11264,5,806838091
6972,175581400,99888886,275470286,3,0,1,2048,3,8590996621
6973,175588050,99886448,275474498,8,0,1,6656,2,8171549008
6974,175634300,99908612,275542912,5,0,1,96256,11,7333889966
6975,175649460,59137811,234787271,0,0,0,512,10,4118549740
6976,175657190,101174156,276831346,5,0,1,249344,11,7902559455
6977,175663930,101218022,276881952,2,0,1,40960,4,5587429019
6978,175729570,59381980,235111550,7,0,0,201216,16,3473626446
6979,175741120,101738204,277479324,5,0,1,451584,11,7169680587
6980,175752660,101736710,277489370,8,0,1,4608,2,9791487583
6981,175790740,101740047,277530787,7,0,1,44544,16,10544962751
6982,175797870,101810182,277608052,5,0,1,430080,11,7227452334
6983,175798460,59196821,234995281,4,0,0,156672,2,10187727464
6984,175858090,101760312,277618402,8,0,1,6144,2,644612561
6985,175873720,102004280,277878000,5,0,1,391168,11,8607615949
6986,175878970,101999696,277878666,3,0,1,11264,3,9367093348
6987,175890890,101990645,277881535,8,0,1,23552,2,7983449027
6988,175894960,59253273,235148233,6,0,0,120320,7,3993986446
6989,175905560,59395138,235300698,3,0,0,3072,3,3963986083
6990,175938480,101954330,277892810,8,0,1,27648,2,3679196244
6991,175954020,101977289,277931309,5,0,1,10752,11,1777826288
6992,175959740,102155173,278114913,5,0,1,199168,11,2569382182
6993,175969890,59249870,235219760,4,0,0,14848,2,5902820342
6994,175981740,59688050,235669790,7,0,0,247808,16,888124709
6995,176008770,59557047,235565817,7,0,0,268288,16,2835512478
6996,176021190,59744269,235765459,4,0,0,74240,2,3438734491
6997,176024130,102090806,278114936,7,0,1,32256,16,9527610929
6998,176040520,102094085,278134605,7,0,1,41984,16,9084513864
6999,176054780,102094340,278149120,8,0,1,1536,2,3594431088
7000,176055830,102120851,278176681,3,0,1,19456,3,8738526465
7001,176076540,102101895,278178435,7,0,1,13312,16,6254383942
7002,176086460,59507795,235594255,4,0,0,93184,2,7953182688
7003,176091090,59722173,235813263,3,0,0,71680,3,7063067040
7004,176091700,59627253,235718953,7,0,0,161280,16,5229522557
7005,176107910,59785939,235893849,4,0,0,125952,2,1101386597
7006,176128490,59308260,235436750,0,0,0,3072,10,1656505181
7007,176184150,59558643,235742793,4,0,0,53248,2,8336137352
7008,176199430,102016020,278215450,3,0,1,34304,3,5644676701
7009,176216590,102002406,278218996,3,0,1,5632,3,8403150904
7010,176251570,101972572,278224142,3,0,1,8192,3,6860595219
7011,176268170,101982401,278250571,5,0,1,39424,11,882383961
7012,176286260,59809141,236095401,6,0,0,238592,7,6879285956
7013,176300220,59420316,235720536,7,0,0,5120,16,7157802339
7014,176300850,101958561,278259411,7,0,1,7680,16,2319452454
7015,176316270,101945131,278261401,8,0,1,20480,2,4594470549
7016,176363070,59659612,236022682,6,0,0,128000,7,7260794222
7017,176384410,59792698,236177108,3,0,0,109056,3,1619417111
7018,176387710,102149831,278537541,5,0,1,225280,11,10248952051
7019,176417840,102120059,278537899,7,0,1,19968,16,2957774351
7020,176418710,102119212,278537922,3,0,1,11776,3,10587734493
7021,176422220,102128698,278550918,7,0,1,31744,16,10261573131
7022,176433090,59497148,235930238,3,0,0,2048,3,2510529637
7023,176434990,60279664,236714654,7,0,0,206336,16,4106523489
7024,176447010,102108120,278555130,2,0,1,6656,4,2095621113
7025,176473170,102115062,278588232,5,0,1,46080,11,9325526634
7026,176480190,60239346,236719536,0,0,0,4096,10,1435434379
7027,176493350,60752054,237245404,7,0,0,674816,16,3717675730
7028,176497349,59628700,236126049,0,0,0,3584,10,4593575394
7029,176504600,102084605,278589205,3,0,1,12800,3,6189094271
7030,176517130,59855631,236372761,0,0,0,3072,10,3838631171
7031,176549210,102050395,278599605,7,0,1,11264,16,3931806602
7032,176568340,60946412,237514752,6,0,0,870400,7,5616770130
7033,176614530,60103735,236718265,3,0,0,11776,3,1217217689
7034,176667260,60578635,237245895,3,0,0,1536,3,6787844594
7035,176678510,101947647,278626157,7,0,1,66048,16,10505795352
7036,176710570,101917036,278627606,8,0,1,10752,2,534753537
7037,176744500,60822822,237567322,7,0,0,92160,16,2839499641
7038,176767990,101867630,278635620,8,0,1,10240,2,5614250099
7039,176777970,101858214,278636184,7,0,1,10752,16,10191309819
7040,176782340,60088326,236870666,6,0,0,26112,7,5700623387
7041,176798200,59622270,236420470,0,0,0,4096,10,10457033299
7042,176832130,60762771,237594901,7,0,0,90112,16,6477265175
7043,176834270,60696931,237531201,6,0,0,53760,7,8822394216
7044,176850330,60399199,237249529,0,0,0,8192,10,956591502
7045,176865330,60673889,237539219,7,0,0,26112,16,211396994
7046,176875050,101836846,278711896,8,0,1,32768,2,9876323759
7047,176903940,101807979,278711919,2,0,1,43520,4,5425834513
7048,176926310,60320700,237247010,0,0,0,3584,10,7941438233
7049,176934640,60008153,236942793,3,0,0,1024,3,9644313591
7050,176969750,101745469,278715219,7,0,1,22528,16,10077650876
7051,176982660,101736547,278719207,6,0,1,12800,7,7860345242
7052,176991100,101741508,278732608,7,0,1,14336,16,5962524839
7053,176997380,101736406,278733786,3,0,1,13824,3,4122912735
7054,177016560,60906753,237923313,6,0,0,375296,7,123890033
7055,177048650,60636190,237684840,6,0,0,17408,7,7685343431
7056,177074790,101693931,278768721,5,0,1,57856,11,7176118630
7057,177124440,60636309,237760749,0,0,0,3072,10,8441396935
7058,177141000,60871657,238012657,7,0,0,72192,16,482071478
7059,177145160,101643512,278788672,3,0,1,13312,3,4718591684
7060,177145910,61120639,238266549,4,0,0,57856,2,1045011417
7061,177194630,60796008,237990638,7,0,0,80384,16,3968789388
7062,177293759,101549636,278843395,1,0,1,75776,5,5881427584
7063,177302540,101556871,278859411,8,0,1,7680,2,3856352792
7064,177322200,101579550,278901750,8,0,1,2048,2,7146052988
7065,177359090,101789293,279148383,5,0,1,121856,11,6157129322
7066,177397549,60851349,238248898,8,0,0,178688,2,5621026859
7067,177398980,60567143,237966123,6,0,0,66048,7,10027716129
7068,177407640,102208163,279615803,3,0,1,33280,3,7018473949
7069,177415910,60992127,238408037,0,0,0,1024,10,1720982144
7070,177416090,102200584,279616674,7,0,1,12288,16,1860749157
7071,177433409,102184891,279618300,4,0,1,2560,2,2275487635
7072,177449740,60473752,237923492,3,0,0,512,3,2856860048
7073,177466730,60727701,238194431,6,0,0,222720,7,756591698
7074,177468500,103011210,280479710,5,0,1,766464,11,1953069903
7075,177486490,102993890,280480380,8,0,1,4096,2,7398900944
7076,177498599,60771093,238269692,8,0,0,10240,2,381825211
7077,177510270,60986242,238496512,7,0,0,290304,16,73205788
7078,177523480,102956923,280480403,2,0,1,18944,4,1375294417
7079,177549660,102930766,280480426,3,0,1,512,3,1464038379
7080,177598680,102881769,280480449,2,0,1,79360,4,1575035274
7081,177606310,102874162,280480472,8,0,1,1024,2,1192639982
7082,177606499,60724320,238330819,8,0,0,6144,2,1799895208
7083,177617860,60964935,238582795,6,0,0,140800,7,9176964093
7084,177635300,61380722,239016022,6,0,0,316928,7,8976602871
7085,177732440,102748055,280480495,8,0,1,5120,2,10257987117
7086,177733680,102746838,280480518,8,0,1,53760,2,10727714760
7087,177769060,102711481,280480541,3,0,1,25600,3,9584479620
7088,177778300,60873681,238651981,7,0,0,16384,16,9046823178
7089,177778430,60945190,238723620,3,0,0,4096,3,8926429883
7090,177785120,61303051,239088171,7,0,0,236032,16,7211703865
7091,177792840,102809741,280602581,5,0,1,364032,11,4520122215
7092,177815700,102789787,280605487,3,0,1,4608,3,2801455506
7093,177817250,102830599,280647849,3,0,1,65536,3,5651619896
7094,177817450,102831475,280648925,2,0,1,13312,4,10400611400
7095,177840240,61175992,239016232,3,0,0,512,3,10317645198
7096,177841230,61036408,238877638,0,0,0,1024,10,1468384209
7097,177842020,102807776,280649796,2,0,1,12288,4,5242951228
7098,177884220,61328779,239212999,7,0,0,44032,16,4959572559
7099,177886610,61206060,239092670,3,0,0,12288,3,2647667604
7100,177919450,102734468,280653918,8,0,1,15360,2,3356156979
7101,177944930,102719239,280664169,8,0,1,15360,2,2006207913
7102,178002030,61086873,239088903,3,0,0,2048,3,10570313384
7103,178098140,102569691,280667831,2,0,1,17408,4,4068290052
7104,178105580,60989054,239094634,0,0,0,6144,10,7409481070
7105,178130550,61009098,239139648,3,0,0,1536,3,320716397
7106,178232290,60877581,239109871,0,0,0,4096,10,9042810172
7107,178232410,102439287,280671697,8,0,1,6144,2,7815517168
7108,178269179,60869978,239139157,8,0,0,24064,2,7108259915
7109,178283100,60827491,239110591,0,0,0,1024,10,2157495264
7110,178284390,102407582,280691972,8,0,1,31232,2,465272731
7111,178377740,102317681,280695421,2,0,1,4608,4,10438382467
7112,178399530,102296877,280696407,2,0,1,1536,4,2633738716
7113,178399650,102313968,280713618,2,0,1,40448,4,3923279832
7114,178425270,102319515,280744785,2,0,1,27648,4,7357066098
7115,178446660,61034425,239481085,6,0,0,128000,7,2270520561
7116,178466030,61077742,239543772,0,0,0,512,10,5975248574
7117,178503310,60749064,239252374,0,0,0,1536,10,7455542720
7118,178527360,62128080,240655440,7,0,0,4096,16,3614901696
7119,178533200,61850271,240383471,6,0,0,89600,7,6322769822
7120,178559340,102211804,280771144,5,0,1,43008,11,8600525399
7121,178582239,61073625,239655864,8,0,0,13312,2,10349060906
7122,178658500,60823544,239482044,0,0,0,3072,10,5835311687
7123,178712830,102060580,280773410,2,0,1,3584,4,6254314728
7124,178729080,60550185,239279265,0,0,0,512,10,9007971812
7125,178731870,102042104,280773974,2,0,1,10752,4,10122239054
7126,178747489,61142662,239890151,8,0,0,89088,2,9195548570
7127,178763670,102011610,280775280,2,0,1,2048,4,9579707544
7128,178801010,61836687,240637697,7,0,0,274432,16,4575725097
7129,178845650,60861353,239707003,0,0,0,4608,10,7206512571
7130,178908970,61389557,240298527,6,0,0,154624,7,4814713204
7131,178915450,61088424,240003874,7,0,0,72192,16,1882494052
7132,178924100,60896350,239820450,7,0,0,88576,16,1408726431
7133,178959060,60814673,239773733,0,0,0,512,10,3579902295
7134,179001930,60622778,239624708,7,0,0,77824,16,6071391456
7135,179113020,101672284,280785304,2,0,1,35328,4,9559307107
7136,179119600,60505755,239625355,3,0,0,2048,3,7713744252
7137,179149050,60545144,239694194,3,0,0,13824,3,6820493401
7138,179154260,101631300,280785560,2,0,1,9216,4,6625930439
7139,179165710,60547916,239713626,0,0,0,1024,10,8704469113
7140,179241029,60845970,240086999,8,0,0,145920,2,7980100163
7141,179257840,101532226,280790066,2,0,1,7168,4,438445281
7142,179261900,60173349,239435249,3,0,0,512,3,4291844277
7143,179266390,60596141,239862531,7,0,0,4096,16,6086116580
7144,179283789,101557440,280841229,0,0,1,133632,10,8159524534
7145,179317580,101555095,280872675,2,0,1,50688,4,7462759653
7146,179378580,60663936,240042516,7,0,0,105472,16,9433852323
7147,179381110,60973615,240354725,6,0,0,52736,7,10241837300
7148,179479600,60267050,239746650,3,0,0,7680,3,483557665
7149,179495650,61536830,241032480,6,0,0,322560,7,8681589793
7150,179496499,101522104,281018603,0,0,1,283136,10,5595587484
7151,179559160,101461640,281020800,2,0,1,2048,4,4135395183
7152,179587330,61125664,240712994,3,0,0,4096,3,7841704898
7153,179605180,60307548,239912728,3,0,0,1024,3,1065042636
7154,179638259,61289289,240927548,8,0,0,318976,2,1739281117
7155,179727960,60926209,240654169,6,0,0,40448,7,5160792006
7156,179758340,61170479,240928819,0,0,0,4096,10,6492749691
7157,179785229,101241882,281027111,0,0,1,22016,10,1403034827
7158,179999790,61147583,241147373,7,0,0,256512,16,10440530588
7159,180009160,101025043,281034203,2,0,1,11264,4,3562315092
7160,180012129,60239263,240251392,8,0,0,46592,2,8785299103
7161,180026990,60904036,240931026,6,0,0,7168,7,2047999264
7162,180036279,61699604,241735883,8,0,0,151040,2,5124751957
7163,180042200,61605701,241647901,6,0,0,425984,7,7926046250
7164,180079819,60561980,240641799,5,0,0,11264,11,7628304017
7165,180091590,61162918,241254508,6,0,0,255488,7,7877576645
7166,180114230,61240047,241354277,7,0,0,147968,16,6981179221
7167,180203630,60843069,241046699,6,0,0,46592,7,4690989131
7168,180206449,100834270,281040719,0,0,1,23040,10,10713448302
7169,180260850,61393626,241654476,7,0,0,21504,16,6248028360
7170,180279599,100909047,281188646,0,0,1,58880,10,10230068895
7171,180288309,100913316,281201625,1,0,1,18944,5,8466543491
7172,180310609,61378724,241689333,8,0,0,100864,2,4027699680
7173,180421240,60217104,240638344,3,0,0,2048,3,8347814684
7174,180551250,60382919,240934169,1,0,0,10240,5,4114149383
7175,180552550,100652941,281205491,2,0,1,6144,4,208072107
7176,180555460,60811788,241367248,6,0,0,42496,7,4059138540
7177,180607669,100665882,281273551,0,0,1,23552,10,7449458087
7178,180700660,60368526,241069186,6,0,0,73728,7,1713613437
7179,180711040,61045328,241756368,6,0,0,17920,7,7509809059
7180,180723580,60585574,241309154,1,0,0,178176,5,5576250437
7181,180761339,61512767,242274106,8,0,0,393216,2,9514774065
7182,180794359,61237665,242032024,8,0,0,103936,2,2297150828
7183,180797580,61733979,242531559,7,0,0,589824,16,6530484585
7184,180804870,60853708,241658578,3,0,0,10240,3,6643488568
7185,180839199,101801796,282640995,0,0,1,331264,10,5122877740
7186,180847600,60407243,241254843,3,0,0,1024,3,169301786
7187,180853850,60835974,241689824,3,0,0,1536,3,2808721188
7188,180863549,101777804,282641353,4,0,1,22016,2,9557567922
7189,180898539,60756896,241655435,8,0,0,3072,2,1921571418
7190,180914010,61025879,241939889,1,0,0,119808,5,7259971949
7191,180918649,101852253,282770902,0,0,1,232960,10,7257117766
7192,180919059,101851866,282770925,4,0,1,20480,2,7645366544
7193,180927299,61395502,242322801,8,0,0,159744,2,6886985828
7194,180927550,60892701,241820251,1,0,0,40448,5,5396953984
7195,180954620,60906392,241861012,0,0,0,8704,10,684156548
7196,181011440,61051928,242063368,1,0,0,40448,5,2129398648
7197,181029369,101867316,282896685,0,0,1,54272,10,6607222018
7198,181035609,101892426,282928035,0,0,1,78848,10,10596295787
7199,181062730,61720532,242783262,7,0,0,161792,16,8479326086
7200,181063930,61516636,242580566,7,0,0,160768,16,8098992600
7201,181104630,61725307,242829937,1,0,0,153088,5,7074065310
7202,181199560,61501530,242701090,1,0,0,360960,5,5661872562
7203,181214300,61376764,242591064,3,0,0,1536,3,8446122390
7204,181261860,60833435,242095295,7,0,0,6144,16,1846306373
7205,181278370,61644531,242922901,1,0,0,188416,5,1075255474
7206,181435980,61501631,242937611,0,0,0,9728,10,8331196810
7207,181441990,60883174,242325164,3,0,0,7680,3,5582115020
7208,181466180,61267717,242733897,6,0,0,107520,7,1968013033
7209,181468670,61389460,242858130,0,0,0,1536,10,5189698475
7210,181486290,61104283,242590573,6,0,0,32768,7,8699103245
7211,181521349,101537846,283059195,0,0,1,169472,10,3916372746
7212,181734499,101348836,283083335,0,0,1,24576,10,1605555308
7213,181762030,61413881,243175911,1,0,0,315904,5,9896221713
7214,181790430,61451648,243242078,6,0,0,217088,7,7331193455
7215,181798789,101655685,283454474,0,0,1,266240,10,10081973380
7216,181813679,61439350,243253029,8,0,0,35840,2,7800843074
7217,181832510,61421010,243253520,0,0,0,1536,10,9359701147
7218,181843270,61091354,242934624,6,0,0,38400,7,7990934468
7219,181844320,61449586,243293906,1,0,0,105472,5,6433372297
7220,181904360,61408156,243312516,3,0,0,1536,3,8951085261
7221,181938069,101560989,283499058,0,0,1,33792,10,252304294
7222,182018879,101798866,283817745,0,0,1,439808,10,2360632872
7223,182069039,101864902,283933941,0,0,1,242176,10,9560871648
7224,182075249,102740750,284815999,0,0,1,305152,10,1761357518
7225,182120720,102695302,284816022,5,0,1,27648,11,8630317056
7226,182120980,61191045,243312025,6,0,0,59392,7,6155706564
7227,182165539,61408831,243574370,8,0,0,76800,2,8921082613
7228,182204980,61305059,243510039,6,0,0,157696,7,3289366663
7229,182214110,102706475,284920585,2,0,1,84480,4,7261325045
7230,182248400,61617017,243865417,1,0,0,334336,5,8798346623
7231,182262800,102775321,285038121,5,0,1,135168,11,8546678870
7232,182317570,61221018,243538588,0,0,0,4096,10,231055857
7233,182412480,61330665,243743145,6,0,0,149504,7,1649986574
7234,182446869,60924458,243371327,8,0,0,61440,2,10127127010
7235,182458040,60796618,243254658,6,0,0,3584,7,5305219141
7236,182618149,102932030,285550179,0,0,1,459776,10,7760518388
7237,182641579,102908623,285550202,4,0,1,6144,2,9906821414
7238,182654499,102895726,285550225,0,0,1,1536,10,10329510981
7239,182661619,102938104,285599723,0,0,1,22528,10,2335157587
7240,182705689,102894057,285599746,4,0,1,512,2,4547152738
7241,182714049,61192956,243907005,8,0,0,95232,2,10092768647
7242,182736210,102889939,285626149,5,0,1,210944,11,8156569739
7243,182758760,102910987,285669747,5,0,1,87552,11,9296350733
7244,182758869,102981047,285739916,0,0,1,160768,10,218112878
7245,182769190,60917901,243687091,0,0,0,1024,10,9761525294
7246,182817190,102943670,285760860,5,0,1,66560,11,7862969179
7247,182836700,61041266,243877966,3,0,0,3072,3,5618413459
7248,182838160,60907000,243745160,0,0,0,512,10,9961487824
7249,182839480,61037504,243876984,7,0,0,37888,16,7612487047
7250,182842900,61115690,243958590,7,0,0,144384,16,3038818152
7251,182858069,102903047,285761116,4,0,1,9216,2,3825378945
7252,182929929,102908817,285838746,0,0,1,189952,10,8281202622
7253,182934379,102924017,285858396,4,0,1,43520,2,1227744822
7254,182985170,60987191,243972361,3,0,0,1024,3,896353147
7255,183021740,60968069,243989809,3,0,0,2560,3,3641246446
7256,183022549,103436262,286458811,0,0,1,203776,10,9669779117
7257,183075010,61070117,244145127,7,0,0,9728,16,3665571465
7258,183087570,103441860,286529430,3,0,1,6656,3,9649125300
7259,183112170,61082994,244195164,7,0,0,103936,16,9382573473
7260,183131750,61071212,244202962,3,0,0,8704,3,8462593953
7261,183160779,103368674,286529453,4,0,1,18944,2,4988211044
7262,183187630,103636282,286823912,5,0,1,175104,11,5685691701
7263,183188440,61270539,244458979,6,0,0,158208,7,9638075182
7264,183197749,103637552,286835301,0,0,1,146432,10,9512875723
7265,183238929,61409987,244648916,8,0,0,183296,2,9320665464
7266,183241199,61928163,245169362,8,0,0,327168,2,8408344426
7267,183299170,103864569,287163739,5,0,1,247808,11,6819105831
7268,183305220,61598834,244904054,7,0,0,308736,16,1309743293
7269,183329360,104090316,287419676,5,0,1,324608,11,5045977086
7270,183350050,61385427,244735477,3,0,0,512,3,2579702200
7271,183354090,61360537,244714627,6,0,0,57344,7,9023050940
7272,183362250,61701411,245063661,0,0,0,6144,10,8229278059
7273,183376300,61675302,245051602,6,0,0,330752,7,2604015231
7274,183384059,104563987,287948046,0,0,1,306688,10,7063475556
7275,183408899,104539170,287948069,0,0,1,25600,10,9795940601
7276,183415880,104532212,287948092,5,0,1,32256,11,9383173635
7277,183453070,61599335,245052405,0,0,0,2560,10,5037580820
7278,183478479,104469636,287948115,0,0,1,23040,10,5706976634
7279,183571209,104376929,287948138,4,0,1,20480,2,3044882077
7280,183622009,104326152,287948161,4,0,1,8192,2,7884559973
7281,183679580,104420103,288099683,5,0,1,5120,11,537463940
7282,183696219,61850830,245547049,8,0,0,512,2,8657540871
7283,183732690,61816080,245548770,0,0,0,3072,10,934711229
7284,183732800,61814070,245546870,0,0,0,336896,10,6083083631
7285,183779279,104320427,288099706,4,0,1,8192,2,826871631
7286,183823090,61936351,245759441,1,0,0,136704,5,3322984760
7287,183826680,62075947,245902627,1,0,0,50176,5,103797051
7288,183874179,104225550,288099729,4,0,1,83456,2,9509296089
7289,183893100,61900721,245793821,1,0,0,98304,5,2524482301
7290,183950030,62187797,246137827,1,0,0,43520,5,6760198191
7291,183956470,62315410,246271880,6,0,0,129536,7,6774500924
7292,184033770,62070175,246103945,1,0,0,195584,5,8092719341
7293,184047259,104052493,288099752,4,0,1,18432,2,7323119210
7294,184076340,61471471,245547811,3,0,0,2048,3,3334579494
7295,184076380,61892708,245969088,3,0,0,2048,3,2593587792
7296,184097650,104002173,288099823,5,0,1,95232,11,1833664571
7297,184142589,61690434,245833023,8,0,0,128512,2,8714867594
7298,184154919,103944927,288099846,0,0,1,29696,10,7047477851
7299,184157540,103942329,288099869,7,0,1,1536,16,5013527130
7300,184161770,61847550,246009320,6,0,0,1024,7,4970407150
7301,184171449,62307635,246479084,8,0,0,78336,2,8274581612
7302,184185130,62337189,246522319,0,0,0,141824,10,4527422910
7303,184215630,103884262,288099892,7,0,1,12800,16,2928528094
7304,184241549,61866319,246107868,8,0,0,12800,2,301238409
7305,184274090,61894421,246168511,1,0,0,68608,5,1213927945
7306,184303730,103808688,288112418,6,0,1,51712,7,9230806255
7307,184311510,103800931,288112441,7,0,1,2560,16,537824755
7308,184313269,103844664,288157933,0,0,1,312320,10,562152356
7309,184411020,103755605,288166625,7,0,1,13824,16,8537236365
7310,184425409,63244970,247670379,8,0,0,823808,2,7269568217
7311,184440330,103733887,288174217,7,0,1,36352,16,10431240049
7312,184461990,62246238,246708228,0,0,0,41984,10,9338863289
7313,184469590,62349410,246819000,6,0,0,244224,7,4098342047
7314,184502910,103687614,288190524,6,0,1,5632,7,5329393913
7315,184559119,103631428,288190547,4,0,1,32256,2,1404485886
7316,184564470,62059716,246624186,0,0,0,44544,10,7645567397
7317,184606610,103585570,288192180,6,0,1,1536,7,4039011130
7318,184607120,62473614,247080734,7,0,0,154112,16,4998423043
7319,184615570,62547266,247162836,7,0,0,84480,16,9734862156
7320,184680710,62645383,247326093,1,0,0,246272,5,10165395728
7321,184693680,62990473,247684153,3,0,0,1024,3,421311457
7322,184728179,103464987,288193166,4,0,1,1536,2,5432662857
7323,184778100,62961189,247739289,7,0,0,164864,16,1173427881
7324,184779990,103414354,288194344,7,0,1,13824,16,7249846433
7325,184913650,62770168,247683818,6,0,0,44032,7,171575392
7326,184921380,62215693,247137073,7,0,0,184832,16,1460275799
7327,184924900,103285785,288210685,5,0,1,4608,11,119689110
7328,184929580,62433976,247363556,7,0,0,122880,16,5438023668
7329,184962910,103250361,288213271,7,0,1,4096,16,3193827756
7330,184965150,62977807,247942957,0,0,0,472064,10,5385556349
7331,184967650,63125346,248092996,1,0,0,183296,5,2461986962
7332,184972780,62390963,247363743,3,0,0,512,3,3619877468
7333,184990930,63271137,248262067,6,0,0,444928,7,10583970923
7334,185021559,103193453,288215012,4,0,1,24576,2,6179723967
7335,185022220,63324039,248346259,0,0,0,267776,10,10122556384
7336,185053709,62915369,247969078,8,0,0,69120,2,797182808
7337,185053800,62983317,248037117,6,0,0,223232,7,4249569085
7338,185081260,62865776,247947036,6,0,0,13312,7,3370700438
7339,185087069,103136911,288223980,4,0,1,15872,2,7923344583
7340,185098470,103129944,288228414,7,0,1,5120,16,7228572626
7341,185100709,103159470,288260179,4,0,1,29696,2,6450290476
7342,185107320,63019137,248126457,7,0,0,109568,16,175137144
7343,185210160,62737835,247947995,3,0,0,3072,3,3968410446
7344,185245669,103015176,288260845,4,0,1,11264,2,360693158
7345,185289160,62975426,248264586,3,0,0,8192,3,3637540335
7346,185291350,63253870,248545220,0,0,0,82432,10,13964905
7347,185340390,63051869,248392259,7,0,0,87040,16,3385656437
7348,185341889,63023750,248365639,8,0,0,25088,2,8383825643
7349,185345340,63012578,248357918,1,0,0,37888,5,4492291099
7350,185352530,102911907,288264437,7,0,1,4096,16,5298072505
7351,185389960,63228310,248618270,6,0,0,94208,7,4886551161
7352,185403410,102862973,288266383,2,0,1,3072,4,3272918820
7353,185417230,63048695,248465925,0,0,0,97280,10,1108826450
7354,185459609,102808720,288268329,1,0,1,25600,5,8387782915
7355,185471850,63170744,248642594,3,0,0,7680,3,10608653280
7356,185494790,63086333,248581123,0,0,0,117760,10,3585286699
7357,185495569,102777679,288273248,4,0,1,17920,2,3575634894
7358,185501309,63406454,248907763,8,0,0,299520,2,2235097256
7359,185522980,102768876,288291856,3,0,1,14336,3,5205125270
7360,185526770,63289710,248816480,3,0,0,2560,3,6355483119
7361,185536569,102757028,288293597,4,0,1,24576,2,5284634407
7362,185553469,63358225,248911694,8,0,0,12800,2,9097797785
7363,185554040,63789000,249343040,0,0,0,416768,10,10690838529
7364,185568890,102739176,288308066,7,0,1,14336,16,4971858626
7365,185587800,102724884,288312684,2,0,1,512,4,10460360526
7366,185605170,63153060,248758230,3,0,0,512,3,6385613473
7367,185607050,63897535,249504585,0,0,0,476672,10,10237559401
7368,185614969,102698688,288313657,1,0,1,12800,5,4895192069
7369,185620020,64133829,249753849,7,0,0,196608,16,1681009745
7370,185680519,62938086,248618605,8,0,0,1024,2,2969216010
7371,185689710,64209203,249898913,1,0,0,198656,5,6490514381
7372,185704419,63654907,249359326,8,0,0,5120,2,2398409435
7373,185715449,102608042,288323491,1,0,1,16896,5,81971970
7374,185755259,102584068,288339327,1,0,1,53760,5,8210220111
7375,185827399,102541365,288368764,1,0,1,36864,5,773859624
7376,185831320,63217833,249049153,1,0,0,97280,5,7338076966
7377,185838530,102534643,288373173,7,0,1,15360,16,2599132713
7378,185846030,64268950,250114980,0,0,0,505344,10,9176466272
7379,185882750,102492049,288374799,3,0,1,2560,3,2712287036
7380,185952540,64003776,249956316,3,0,0,1024,3,4914832106
7381,185956490,102419282,288375772,5,0,1,12800,11,590972133
7382,186000520,64164871,250165391,1,0,0,165376,5,9308281687
7383,186011150,64394419,250405569,7,0,0,272896,16,10133512438
7384,186054110,102344722,288398832,3,0,1,27648,3,7191481073
7385,186083400,64138540,250221940,7,0,0,180224,16,3307401505
7386,186134649,102321762,288456411,4,0,1,64512,2,2957634081
7387,186140089,63616591,249756680,8,0,0,9216,2,1474514280
7388,186146640,102328014,288474654,6,0,1,16896,7,6145157896
7389,186155410,102360105,288515515,3,0,1,40448,3,10223401807
7390,186166210,64096477,250262687,0,0,0,133632,10,9275874685
7391,186196630,102342409,288539039,7,0,1,31232,16,2575011592
7392,186203410,102352605,288556015,6,0,1,29696,7,1341610137
7393,186205129,102359420,288564549,1,0,1,6144,5,9483646571
7394,186253790,102347180,288600970,7,0,1,11776,16,9509948360
7395,186274161,102412921,288687082,9,0,1,77312,17,8514330997
7396,186279710,64244535,250524245,0,0,0,164864,10,3843197106
7397,186280740,64523806,250804546,0,0,0,323584,10,209038248
7398,186291610,63626202,249917812,7,0,0,61952,16,8314787586
7399,186293701,102393404,288687105,9,0,1,512,17,1739255268
7400,186337220,102361677,288698897,6,0,1,22528,7,6730291738
7401,186351220,102347700,288698920,6,0,1,3072,7,8942623287
7402,186392910,63774064,250166974,7,0,0,5120,16,3479094927
7403,186403240,102295703,288698943,6,0,1,3584,7,10565099838
7404,186406860,102292106,288698966,6,0,1,26624,7,5780708694
7405,186447200,102251789,288698989,7,0,1,11264,16,1179158076
7406,186453809,102245203,288699012,1,0,1,3072,5,10447105487
7407,186463810,102235225,288699035,7,0,1,14848,16,3681725168
7408,186474179,102253513,288727692,1,0,1,7168,5,9795349059
7409,186476789,63932102,250408891,8,0,0,10752,2,8189690295
7410,186489240,63946193,250435433,1,0,0,6144,5,901150892
7411,186495600,64210331,250705931,1,0,0,258560,5,452638053
7412,186513900,102213815,288727715,6,0,1,25600,7,5184677888
7413,186519629,64287303,250806932,8,0,0,7168,2,8118345283
7414,186544400,64260325,250804725,3,0,0,512,3,2264557885
7415,186562190,64281893,250844083,0,0,0,121856,10,1971451287
7416,186582360,102165653,288748013,2,0,1,7168,4,1506032380
7417,186584411,102378648,288963059,9,0,1,207360,17,4764537333
7418,186596880,64364727,250961607,3,0,0,2560,3,4047089207
7419,186602819,64500055,251102874,8,0,0,512,2,3807113206
7420,186608120,64617518,251225638,0,0,0,268800,10,8047767145
7421,186612360,102350722,288963082,3,0,1,14848,3,10658544411
7422,186623700,64639984,251263684,3,0,0,4608,3,8564558580
7423,186644529,102318576,288963105,4,0,1,6144,2,6067703351
7424,186676220,102286908,288963128,6,0,1,1536,7,1689394893
7425,186680470,102282681,288963151,6,0,1,2560,7,9851417047
7426,186687440,64743817,251431257,1,0,0,112640,5,861059158
7427,186698170,64903542,251601712,1,0,0,298496,5,9912662762
7428,186715849,64886198,251602047,8,0,0,1024,2,8581290786
7429,186716830,102246344,288963174,3,0,1,8192,3,7666640024
7430,186750361,102260676,289011037,9,0,1,136704,17,6105572404
7431,186788589,102253330,289041919,1,0,1,27648,5,9296090900
7432,186794799,102257823,289052622,4,0,1,22016,2,4118435993
7433,186798030,102256538,289054568,6,0,1,3072,7,2573408793
7434,186824720,65791527,252616247,6,0,0,215552,7,8943654303
7435,186868100,102211682,289079782,7,0,1,68608,16,7524123211
7436,186872060,65677861,252549921,7,0,0,521728,16,4057753932
7437,186883770,66217660,253101430,7,0,0,619008,16,5327672038
7438,186884851,102742852,289627703,9,0,1,236544,17,5712920539
7439,186923639,102705370,289629009,1,0,1,2048,5,9283683180
7440,186933681,103163528,290097209,9,0,1,647680,17,615816894
7441,186937340,66198433,253135773,1,0,0,112640,5,3313471061
7442,186962250,103138250,290100500,6,0,1,35328,7,2546228301
7443,187000349,103105963,290106312,4,0,1,9216,2,4016262905
7444,187000819,103114224,290115043,1,0,1,30208,5,5333846766
7445,187047979,103092030,290140009,1,0,1,27648,5,9552761686
7446,187058460,66077679,253136139,3,0,0,1024,3,7376606638
7447,187075311,103915332,290990643,9,0,1,564736,17,6344724379
7448,187092550,66443322,253535872,1,0,0,78336,5,2418338102
7449,187093049,66484350,253577399,8,0,0,2048,2,9451755476
7450,187097970,103931436,291029406,3,0,1,28672,3,6582845935
7451,187112170,66698688,253810858,6,0,0,154624,7,8178669272
7452,187112670,103918362,291031032,3,0,1,2560,3,6206643085
7453,187117320,103915978,291033298,7,0,1,3584,16,6573961899
7454,187122750,66503978,253626728,3,0,0,10240,3,9870591311
7455,187125990,103928974,291054964,5,0,1,46592,11,152577919
7456,187129830,104014286,291144116,7,0,1,13312,16,4960018088
7457,187183280,103960859,291144139,6,0,1,11776,7,6019895536
7458,187183970,104024198,291208168,7,0,1,6144,16,4088327880
7459,187188041,104020150,291208191,9,0,1,12800,17,6244844622
7460,187217510,66654427,253871937,7,0,0,44544,16,335000412
7461,187232370,103975844,291208214,3,0,1,512,3,8784113876
7462,187278300,103929945,291208245,7,0,1,33792,16,10031976026
7463,187306090,103902178,291208268,3,0,1,21504,3,6070094926
7464,187306310,66849790,254156100,1,0,0,94208,5,7867532309
7465,187323079,103885212,291208291,1,0,1,13312,5,8625171643
7466,187334959,103876167,291211126,1,0,1,25088,5,3526619901
7467,187379380,103892259,291271639,3,0,1,57856,3,3984332728
7468,187410660,103861002,291271662,3,0,1,15360,3,4122577177
7469,187443390,66768851,254212241,0,0,0,119296,10,7394398069
7470,187454001,104258496,291712497,9,0,1,552960,17,5766073855
7471,187472460,67013023,254485483,0,0,0,40960,10,1287804609
7472,187476130,104307085,291783215,6,0,1,24576,7,3837659922
7473,187506699,104300165,291806864,4,0,1,27648,2,8676972600
7474,187523799,104314107,291837906,4,0,1,62464,2,2923126270
7475,187525480,104313092,291838572,3,0,1,1024,3,10233896127
7476,187528871,104390625,291919496,9,0,1,118272,17,179602650
7477,187536189,104437797,291973986,4,0,1,36352,2,2742457416
7478,187576371,104691038,292267409,9,0,1,477696,17,1498805809
7479,187586951,104744501,292331452,9,0,1,98816,17,8718019946
7480,187609450,67580087,255189537,6,0,0,54784,7,8338627359
7481,187641030,67531792,255172822,0,0,0,25088,10,4954382731
7482,187676571,104750302,292426873,9,0,1,68608,17,4478937729
7483,187684540,104755951,292440491,3,0,1,31232,3,6902771176
7484,187707849,67722641,255430490,8,0,0,6144,2,6611359208
7485,187716060,104724454,292440514,7,0,1,15872,16,5742667286
7486,187729300,67794582,255523882,1,0,0,3072,5,2417956179
7487,187756670,67994204,255750874,6,0,0,160256,7,9294209590
7488,187759550,104680987,292440537,7,0,1,7168,16,5528292016
7489,187782170,104658390,292440560,3,0,1,77312,3,2757286094
7490,187810211,104873297,292683508,9,0,1,265728,17,2803223292
7491,187840690,67988019,255828709,1,0,0,88576,5,7187165971
7492,187879531,104804000,292683531,9,0,1,11776,17,2198046217
7493,187898810,104784744,292683554,6,0,1,10752,7,8162403889
7494,187915811,104994608,292910419,9,0,1,252928,17,9770403550
7495,187925940,67945369,255871309,1,0,0,67072,5,8445256936
7496,187934050,104982341,292916391,3,0,1,9728,3,10159774992
7497,187950491,105132735,293083226,9,0,1,44032,17,3355298386
7498,187961241,68070627,256031868,2,0,0,11776,4,7742400208
7499,187979401,105308505,293287906,9,0,1,137216,17,9088403927
7500,188044811,105591147,293635958,9,0,1,485376,17,10065897208
7501,188083910,68379050,256462960,7,0,0,136704,16,8715293485
7502,188085321,105579865,293665186,9,0,1,77824,17,7556672114
7503,188104310,105568240,293672550,3,0,1,2048,3,2868872665
7504,188106120,105571717,293677837,7,0,1,16896,16,7649009910
7505,188141730,68682124,256823854,1,0,0,180224,5,9174222011
7506,188279340,68250735,256530075,6,0,0,39424,7,10731840754
7507,188303060,69465292,257768352,0,0,0,562688,10,6659503020
7508,188359630,67982365,256341995,3,0,0,10240,3,1134650908
7509,188431650,105247173,293678823,3,0,1,1536,3,1065117613
7510,188472090,105209959,293682049,3,0,1,5120,3,5811512442
7511,188494130,105208472,293702602,7,0,1,41472,16,3355916231
7512,188540960,105192491,293733451,7,0,1,44544,16,269018711
7513,188570590,68198329,256768919,6,0,0,163840,7,7247033861
7514,188582040,68046379,256628419,7,0,0,136704,16,2234314589
7515,188656320,68028676,256684996,3,0,0,1536,3,5756012661
7516,188687060,67959662,256646722,3,0,0,3072,3,5095272547
7517,188724849,67958503,256683352,8,0,0,11264,2,9659224435
7518,188746530,105022560,293769090,7,0,1,34816,16,5924763483
7519,188776130,68124888,256901018,6,0,0,151552,7,9088562897
7520,188852740,104917528,293770268,7,0,1,13824,16,4357348509
7521,188855250,104920751,293776001,5,0,1,29184,11,2606556480
7522,188858990,68148374,257007364,0,0,0,35328,10,10252911019
7523,188871650,68146952,257018602,3,0,0,512,3,10124112807
7524,188891830,69045672,257937502,0,0,0,486912,10,9382788983
7525,188925240,68554731,257479971,1,0,0,124416,5,9618512420
7526,188943350,69069756,258013106,1,0,0,170496,5,4944961248
7527,188990240,68798883,257789123,6,0,0,68096,7,8302282196
7528,189005450,104821431,293826881,3,0,1,16384,3,8628953445
7529,189018550,68921471,257940021,3,0,0,8192,3,1316330021
7530,189024870,104812472,293837342,3,0,1,62976,3,5310175312
7531,189068010,68872970,257940980,9,0,0,3072,17,4303638833
7532,189072420,68888715,257961135,6,0,0,66048,7,3601574547
7533,189118830,104747012,293865842,7,0,1,29696,16,7662647535
7534,189122079,69106852,258228931,8,0,0,15872,2,2141854537
7535,189162650,104712358,293875008,3,0,1,16896,3,3870435236
7536,189199500,68930748,258130248,3,0,0,5120,3,4209267908
7537,189226210,104651384,293877594,8,0,1,4096,2,3937498813
7538,189252429,104698677,293951106,1,0,1,35328,5,4390762986
7539,189289530,104661599,293951129,7,0,1,23552,16,3085744356
7540,189317890,69101252,258419142,7,0,0,138752,16,9171680213
7541,189375120,104576032,293951152,7,0,1,20992,16,5696225236
7542,189388389,68895661,258284050,8,0,0,3072,2,5935099223
7543,189410189,69025066,258435255,8,0,0,3584,2,2601638480
7544,189450519,104500656,293951175,1,0,1,36864,5,4093625121
7545,189463820,104487378,293951198,7,0,1,23552,16,5466205858
7546,189507190,69146322,258653512,1,0,0,136192,5,3561311817
7547,189523300,104434269,293957569,7,0,1,22016,16,8049320249
7548,189554279,104418270,293972549,1,0,1,25088,5,2493180322
7549,189557830,69114459,258672289,0,0,0,19968,10,2950258926
7550,189558089,104417686,293975775,1,0,1,5120,5,6185635184
7551,189565280,104420317,293985597,7,0,1,13312,16,8205827465
7552,189578950,69672660,259251610,0,0,0,116224,10,5617929932
7553,189580419,104418461,293998880,1,0,1,34304,5,943253882
7554,189663540,69876378,259539918,1,0,0,563200,5,2661903199
7555,189668800,69300312,258969112,3,0,0,3584,3,6456249602
7556,189751640,69415276,259166916,7,0,0,512,16,6590905326
7557,189774440,69478597,259253037,7,0,0,4608,16,4805199101
7558,189806090,69754310,259560400,1,0,0,67072,5,890004483
7559,189825630,69839955,259665585,6,0,0,76288,7,6826166391
7560,189850340,70135098,259985438,6,0,0,377856,7,1997672622
7561,189851539,69783551,259635090,8,0,0,1536,2,8780950725
7562,189863260,69959146,259822406,3,0,0,4096,3,2768995489
7563,189865880,70132887,259998767,7,0,0,1024,16,3604815293
7564,189879099,104120541,293999640,1,0,1,512,5,734110671
7565,189889390,70109042,259998432,1,0,0,38400,5,1241267143
7566,189913950,104086561,294000511,7,0,1,12288,16,8413980658
7567,189923099,104086938,294010037,1,0,1,19968,5,10103054098
7568,189956650,70030059,259986709,7,0,0,4096,16,2723168568
7569,190026230,70044577,260070807,7,0,0,14848,16,1712775647
7570,190081030,70296186,260377216,1,0,0,223744,5,7490988972
7571,190268340,69893794,260162134,3,0,0,5120,3,3027187869
7572,190276470,69789790,260066260,3,0,0,3584,3,7332006397
7573,190278900,70101728,260380628,9,0,0,512,17,4480842643
7574,190284689,70250253,260534942,8,0,0,4608,2,8992165605
7575,190308550,69920856,260229406,9,0,0,512,17,56086249
7576,190313960,69864868,260178828,7,0,0,1536,16,5788376598
7577,190322430,70384891,260707321,7,0,0,1536,16,1081793260
7578,190331740,103717216,294048956,7,0,1,3072,16,3308903844
7579,190420240,70316107,260736347,0,0,0,12800,10,5082399274
7580,190450570,70831590,261282160,0,0,0,620032,10,6099979144
7581,190494520,104236102,294730622,2,0,1,23040,4,9713034919
7582,190508229,70277946,260786175,8,0,0,7680,2,5153474147
7583,190509850,70799367,261309217,1,0,0,88064,5,2550173020
7584,190552380,71047905,261600285,6,0,0,524800,7,6515108821
7585,190573850,70326552,260900402,7,0,0,1024,16,1809121694
7586,190581530,104423026,295004556,5,0,1,20992,11,859963502
7587,190588270,70742498,261330768,1,0,0,70656,5,3462666017
7588,190601339,70681023,261282362,8,0,0,512,2,169383904
7589,190624310,104496463,295120773,7,0,1,41472,16,3470454515
7590,190628080,70774301,261402381,6,0,0,39936,7,2925314058
7591,190660040,104460756,295120796,7,0,1,13312,16,5635276058
7592,190672989,104496359,295169348,1,0,1,2560,5,8602152186
7593,190692460,70641482,261333942,6,0,0,10240,7,4334933497
7594,190695270,70707602,261402872,9,0,0,1536,17,1759974689
7595,190747800,70853288,261601088,3,0,0,2560,3,3199894719
7596,190760729,70841630,261602359,8,0,0,4096,2,10121918316
7597,190780660,104422653,295203313,7,0,1,22016,16,1320298460
7598,190790240,104425220,295215460,7,0,1,7168,16,5876223834
7599,190825289,70790717,261616006,8,0,0,3072,2,3215048090
7600,190830340,70963214,261793554,0,0,0,80384,10,6591211939
7601,190855270,104363736,295219006,8,0,1,5632,2,1288643034
7602,190888500,104376449,295264949,7,0,1,3072,16,1785636315
7603,190892710,70773654,261666364,9,0,0,1024,17,7594354781
7604,190896630,71006479,261903109,9,0,0,4096,17,8646171297
7605,190959730,70902067,261861797,7,0,0,512,16,5714956441
7606,190997970,70762319,261760289,7,0,0,5632,16,374152948
7607,191000720,104264793,295265513,7,0,1,10752,16,8945239465
7608,191048020,104843411,295891431,7,0,1,38400,16,4338192477
7609,191054540,70967100,262021640,0,0,0,26112,10,3281099124
7610,191065080,70663951,261729031,3,0,0,512,3,2130936348
7611,191071730,71199174,262270904,6,0,0,58368,7,5470366933
7612,191102690,70967375,262070065,1,0,0,106496,5,10215723642
7613,191105880,70965144,262071024,7,0,0,3072,16,4421182865
7614,191120220,70833451,261953671,3,0,0,512,3,10440721256
7615,191193630,70877729,262071359,7,0,0,1024,16,2210137490
7616,191238530,71520869,262759399,6,0,0,740352,7,7689447400
7617,191252610,70819864,262072474,7,0,0,3584,16,1845543998
7618,191280420,71057916,262338336,3,0,0,512,3,10597772518
7619,191349650,104603158,295952808,8,0,1,2048,2,9617776402
7620,191382730,104570101,295952831,8,0,1,1024,2,6842743675
7621,191383010,70813055,262196065,9,0,0,3584,17,3431613519
7622,191417750,71403190,262820940,6,0,0,198656,7,1902763423
7623,191444570,71089230,262533800,6,0,0,193024,7,5210632810
7624,191485380,70904413,262389793,9,0,0,1024,17,5347185413
7625,191540340,104412514,295952854,6,0,1,3072,7,7198347886
7626,191553229,71207152,262760381,8,0,0,512,2,508462262
7627,191558480,104394397,295952877,8,0,1,2048,2,4076011288
7628,191584990,70705852,262290842,0,0,0,11776,10,3773239606
7629,191591499,71168703,262760202,8,0,0,2560,2,10242669830
7630,191593010,70801746,262394756,3,0,0,3072,3,8468389965
7631,191616060,71258777,262874837,0,0,0,173568,10,3297804144
7632,191640240,71181682,262821922,9,0,0,1024,17,10668137895
7633,191643650,104309250,295952900,7,0,1,6656,16,8121715051
7634,191652720,104329242,295981962,6,0,1,512,7,4375300720
7635,191656590,71164997,262821587,9,0,0,2048,17,618937223
7636,191666220,104315765,295981985,8,0,1,20480,2,8915088917
7637,191707010,104274998,295982008,6,0,1,4096,7,6482543974
7638,191731200,71470526,263201726,0,0,0,76800,10,4984286735
7639,191756710,104225321,295982031,8,0,1,13312,2,7947809284
7640,191758179,71228589,262986768,8,0,0,1024,2,3094342960
7641,191763960,104347822,296111782,8,0,1,42496,2,8558138929
7642,191785610,104482826,296268436,3,0,1,86016,3,8329094370
7643,191823959,71261764,263085723,8,0,0,1024,2,1491965512
7644,191831860,104436599,296268459,3,0,1,24576,3,6944637046
7645,191888860,104380581,296269441,3,0,1,7680,3,2906674378
7646,191956470,71362432,263318902,3,0,0,1024,3,10718162963
7647,191965800,104303664,296269464,3,0,1,11776,3,639651683
7648,191968080,71323376,263291456,6,0,0,34304,7,10087729946
7649,191995069,71247937,263243006,8,0,0,1024,2,5191347870
7650,191997900,71418938,263416838,9,0,0,1536,17,9396648564
7651,192057890,104211597,296269487,6,0,1,17920,7,3407162911
7652,192083360,104186150,296269510,8,0,1,12288,2,9008059332
7653,192115820,71219702,263335522,1,0,0,1536,5,9717330218
7654,192140080,104129453,296269533,3,0,1,16384,3,6902646302
7655,192146630,71253851,263400481,7,0,0,3072,16,8294140335
7656,192167810,71725693,263893503,1,0,0,178176,5,3566999901
7657,192176220,104118163,296294383,8,0,1,32256,2,7638859659
7658,192188500,71413444,263601944,6,0,0,55296,7,6790255216
7659,192206180,71483343,263689523,9,0,0,5120,17,8089627643
7660,192221770,71617422,263839192,1,0,0,35328,5,3092150959
7661,192241900,104052506,296294406,8,0,1,512,2,4734628637
7662,192279470,104014959,296294429,3,0,1,2560,3,5101815239
7663,192332370,103962082,296294452,3,0,1,5120,3,355230034
7664,192343930,71657177,264001107,0,0,0,54272,10,5947074258
7665,192464199,71179870,263644069,8,0,0,512,2,566819716
7666,192478710,71198006,263676716,9,0,0,1024,17,6796408099
7667,192485610,103808865,296294475,8,0,1,5120,2,1818391458
7668,192515940,71872957,264388897,6,0,0,63488,7,7276612928
7669,192548690,71585226,264133916,1,0,0,124928,5,10722984036
7670,192549680,71819850,264369530,6,0,0,312320,7,4517876656
7671,192564030,104028960,296592990,8,0,1,62464,2,1656940452
7672,192584820,72337202,264922022,1,0,0,500224,5,7952160866
7673,192625089,71871677,264496766,8,0,0,512,2,6532856782
7674,192661780,71834799,264496579,1,0,0,62464,5,601089465
7675,192667931,105264870,297932801,9,0,1,112128,17,5904310413
7676,192692390,105266396,297958786,3,0,1,45056,3,3011212936
7677,192771360,71706164,264477524,3,0,0,7680,3,8500517093
7678,192776850,105453247,298230097,3,0,1,20992,3,1551238692
7679,192784870,105445250,298230120,3,0,1,9216,3,514175342
7680,192794470,105436796,298231266,8,0,1,3072,2,10041942761
7681,192817850,105413439,298231289,8,0,1,34816,2,2869680690
7682,192819000,105412312,298231312,5,0,1,3072,11,9695427582
7683,192842681,105733419,298576100,9,0,1,211968,17,5673763652
7684,192846810,71883742,264730552,3,0,0,1536,3,6274077037
7685,192861991,105942814,298804805,9,0,1,203776,17,9472441303
7686,192869251,106016545,298885796,9,0,1,141824,17,695723467
7687,192885720,72191394,265077114,6,0,0,258048,7,4474813348
7688,192951590,72257150,265208740,9,0,0,8192,17,7878289168
7689,192969640,105937288,298906928,8,0,1,22016,2,4008053509
7690,192970251,106156070,299126321,9,0,1,97792,17,3774257920
7691,193029921,106454874,299484795,9,0,1,546816,17,3341423794
7692,193101871,106441569,299543440,9,0,1,154112,17,2311196487
7693,193157680,106431761,299589441,3,0,1,24576,3,2788965095
7694,193162479,106426985,299589464,4,0,1,14336,2,589924117
7695,193166340,72303431,265469771,7,0,0,2560,16,494177427
7696,193182239,106416810,299599049,1,0,1,22528,5,9794150708
7697,193217339,106381733,299599072,4,0,1,3072,2,535205802
7698,193276410,106322701,299599111,3,0,1,32256,3,352184499
7699,193278580,72510889,265789469,6,0,0,125952,7,2450193385
7700,193307109,72367765,265674874,8,0,0,1024,2,4488228702
7701,193355329,106252611,299607940,4,0,1,17920,2,1284646233
7702,193362800,72324221,265687021,7,0,0,512,16,7854795296
7703,193424989,72243083,265668072,8,0,0,512,2,1145801962
7704,193425270,72400984,265826254,7,0,0,1024,16,3963755236
7705,193431810,106177436,299609246,8,0,1,2048,2,6173367507
7706,193434490,72424379,265858869,9,0,0,2560,17,5076365457
7707,193460680,72564178,266024858,7,0,0,9728,16,7443753270
7708,193461190,72443112,265904302,9,0,0,512,17,811649879
7709,193477840,106134052,299611892,8,0,1,2048,2,321242582
7710,193492610,106120358,299612968,3,0,1,13312,3,4164296506
7711,193516660,106116983,299633643,8,0,1,29696,2,3089345125
7712,193553260,72435264,265988524,3,0,0,3584,3,4131249406
7713,193582080,72588821,266170901,6,0,0,46080,7,9213263339
7714,193586461,106869242,300455703,9,0,1,713216,17,6088266027
7715,193608380,72600031,266208411,1,0,0,5632,5,5766916256
7716,193616750,106838976,300455726,8,0,1,1536,2,5023440305
7717,193633579,106878525,300512104,4,0,1,61952,2,7648298936
7718,193668870,72562083,266230953,6,0,0,54784,7,3496714437
7719,193682690,72702081,266384771,6,0,0,126464,7,2971186115
7720,193703840,72484356,266188196,3,0,0,12288,3,5142961747
7721,193716980,106795155,300512135,8,0,1,2560,2,1112083706
7722,193749350,73110975,266860325,6,0,0,163328,7,9960019584
7723,193762520,72801209,266563729,9,0,0,71680,17,4297023066
7724,193798120,72842858,266640978,1,0,0,108032,5,8333764374
7725,193802620,72597401,266400021,7,0,0,1024,16,7447430217
7726,193858769,73049265,266908034,8,0,0,1024,2,3874414808
7727,193879800,73298866,267178666,1,0,0,217088,5,1424050097
7728,193927570,72568166,266495736,9,0,0,27136,17,10052748956
7729,194006300,73445358,267451658,6,0,0,215552,7,9781594461
7730,194022880,73089619,267112499,1,0,0,279040,5,10457696810
7731,194043440,106468718,300512158,5,0,1,35328,11,5572939395
7732,194053520,72512999,266566519,3,0,0,4096,3,3825289849
7733,194070930,73315029,267385959,1,0,0,435200,5,6159592391
7734,194126189,106385992,300512181,4,0,1,59392,2,1649794181
7735,194132390,72511751,266644141,3,0,0,512,3,7749571353
7736,194180629,106340327,300520956,4,0,1,13824,2,2370347676
7737,194200099,106321830,300521929,4,0,1,12800,2,9732298115
7738,194245500,72321463,266566963,7,0,0,512,16,5449698456
7739,194251170,106273296,300524466,5,0,1,13824,11,4979584691
7740,194279479,106269941,300549420,4,0,1,49152,2,7573736757
7741,194283749,106275435,300559184,4,0,1,15360,2,2221816671
7742,194302960,73254489,267557449,6,0,0,347136,7,291051961
7743,194360010,72871769,267231779,6,0,0,23552,7,36941261
7744,194375160,106196589,300571749,5,0,1,2048,11,2210777169
7745,194449610,106123537,300573147,3,0,1,9216,3,9416569099
7746,194451600,73190502,267642102,1,0,0,175616,5,3287700312
7747,194482280,106091213,300573493,5,0,1,512,11,5893409779
7748,194484120,73160033,267644153,3,0,0,6656,3,8424058596
7749,194493650,106093030,300586680,8,0,1,12800,2,1970862157
7750,194537730,73182738,267720468,9,0,0,240128,17,7518831553
7751,194562430,106036208,300598638,5,0,1,48640,11,4240650174
7752,194576920,73174667,267751587,1,0,0,43520,5,9134140117
7753,194579250,106020280,300599530,5,0,1,9728,11,1232597063
7754,194580950,106048145,300629095,5,0,1,25600,11,4815484368
7755,194634910,73011028,267645938,3,0,0,5632,3,8411671202
7756,194666779,73054180,267720959,8,0,0,1536,2,686004483
7757,194681070,73157555,267838625,6,0,0,27136,7,6337412579
7758,194688530,73358244,268046774,9,0,0,93184,17,4294112339
7759,194691890,74028417,268720307,6,0,0,413696,7,6108315475
7760,194735270,73648808,268384078,6,0,0,276480,7,8440212364
7761,194735410,73211380,267946790,9,0,0,15872,17,565809243
7762,194746060,73357474,268103534,3,0,0,12288,3,4132703803
7763,194752430,73226885,267979315,3,0,0,16384,3,7267352440
7764,194773479,73613141,268386620,8,0,0,512,2,1096170407
7765,194791219,105844513,300635732,1,0,1,29696,5,2405762723
7766,194818860,73365675,268184535,3,0,0,6144,3,5996008749
7767,194855300,73719362,268574662,6,0,0,94720,7,4812105893
7768,194869790,105970070,300839860,5,0,1,2048,11,6019177315
7769,194941300,73445141,268386441,7,0,0,7680,16,807484821
7770,194957590,73334882,268292472,9,0,0,50176,17,8234440340
7771,194966070,73826800,268792870,6,0,0,238080,7,8552723994
7772,195027770,73791533,268819303,9,0,0,84992,17,8049333319
7773,195055829,73237134,268292963,8,0,0,1536,2,3722971690
7774,195137120,105702763,300839883,7,0,1,29696,16,8591218140
7775,195138110,73372536,268510646,6,0,0,85504,7,1899178268
7776,195139040,105700866,300839906,7,0,1,32256,16,1213341178
7777,195149810,73643395,268793205,7,0,0,1024,16,1996736688
7778,195177080,105662849,300839929,7,0,1,2048,16,3079205561
7779,195179169,73614215,268793384,8,0,0,512,2,426955530
7780,195182770,105657182,300839952,7,0,1,72704,16,3257151380
7781,195213960,73887003,269100963,9,0,0,471040,17,8180238961
7782,195230989,73643339,268874328,8,0,0,8192,2,1404962545
7783,195462790,73394966,268857756,7,0,0,512,16,4688956762
7784,195499810,73628522,269128332,6,0,0,52736,7,6425605746
7785,195518360,73397615,268915975,7,0,0,1536,16,8892528991
7786,195549539,105290436,300839975,1,0,1,6656,5,430383944
7787,195564189,105275809,300839998,1,0,1,4096,5,7729009487
7788,195565060,73536238,269101298,7,0,0,1024,16,8435983609
7789,195569860,73271130,268840990,3,0,0,1024,3,8980026282
7790,195596750,73737635,269334385,7,0,0,1024,16,7163428811
7791,195661130,73158352,268819482,3,0,0,512,3,2732219408
7792,195680170,73478636,269158806,6,0,0,62464,7,8759451814
7793,195729170,73546720,269275890,7,0,0,2560,16,8553621165
7794,195775450,73407753,269183203,6,0,0,61440,7,5374499958
7795,195789220,73323021,269112241,1,0,0,35840,5,7488254470
7796,195791969,73367640,269159609,8,0,0,2560,2,7651828964
7797,195852980,73286771,269139751,1,0,0,37376,5,877743933
7798,195857130,73331556,269188686,9,0,0,17920,17,33373635
7799,195870480,73619013,269489493,9,0,0,189952,17,1451629248
7800,195870590,73465175,269335765,7,0,0,512,16,7416367323
7801,195942430,73377749,269320179,6,0,0,23552,7,10198802409
7802,195951039,104888982,300840021,1,0,1,4608,5,5092494234
7803,195964379,104875665,300840044,0,0,1,53248,10,8307567345
7804,195975040,73345942,269320982,3,0,0,2560,3,4995896660
7805,195975490,73547120,269522610,3,0,0,1024,3,10697762847
7806,196003410,73858872,269862282,1,0,0,521216,5,7665346979
7807,196057069,105482222,301539291,0,0,1,233984,10,1642035097
7808,196074890,73830806,269905696,1,0,0,140288,5,3088911840
7809,196095879,105755899,301851778,0,0,1,91648,10,1872289053
7810,196105449,73414089,269519538,8,0,0,1024,2,8582356516
7811,196136099,105715702,301851801,0,0,1,51712,10,7915542945
7812,196209560,73709644,269919204,7,0,0,512,16,1105462563
7813,196243299,105608525,301851824,1,0,1,7680,5,5274987254
7814,196250320,73355160,269605480,7,0,0,1024,16,8944114263
7815,196259119,105592728,301851847,1,0,1,20480,5,121709967
7816,196269139,105582731,301851870,1,0,1,15360,5,6816581436
7817,196320059,73586128,269906187,8,0,0,1536,2,1661197472
7818,196385179,105466714,301851893,1,0,1,8704,5,7596657140
7819,196435510,73427419,269862929,3,0,0,2048,3,3859721529
7820,196463379,105388537,301851916,0,0,1,39424,10,7932688046
7821,196473450,73657250,270130700,6,0,0,130048,7,3390422373
7822,196498040,73408638,269906678,7,0,0,1536,16,2378889040
7823,196534680,73409404,269944084,6,0,0,54272,7,345455698
7824,196546740,73447300,269994040,9,0,0,43520,17,6989513169
7825,196582000,73337025,269919025,6,0,0,40448,7,1105223658
7826,196620080,73470973,270091053,1,0,0,17408,5,9508792313
7827,196633469,105256580,301890049,0,0,1,74752,10,3276879413
7828,196666940,73489154,270156094,7,0,0,1536,16,3746947004
7829,196695509,73487195,270182704,8,0,0,2048,2,9154211237
7830,196715960,73662261,270378221,3,0,0,1536,3,2611978377
7831,196731820,73298372,270030192,7,0,0,6144,16,6719505566
7832,196749199,73383076,270132275,8,0,0,4608,2,8354362136
7833,196826020,105082015,301908035,8,0,1,30208,2,1208415849
7834,196831350,73372561,270203911,3,0,0,1536,3,983678158
7835,196849560,73446775,270296335,6,0,0,11264,7,2114338095
7836,196867460,73291496,270158956,7,0,0,1024,16,5994957027
7837,196913700,73343075,270256775,9,0,0,60928,17,6218014071
7838,196930980,104977413,301908393,8,0,1,3584,2,891685828
7839,196945460,73668131,270613591,1,0,0,172544,5,3048064627
7840,196960440,73665488,270625928,9,0,0,33792,17,467835226
7841,196982240,73813800,270796040,6,0,0,104448,7,10530832653
7842,196987510,73776016,270763526,6,0,0,86016,7,10074553953
7843,197005900,104902516,301908416,6,0,1,9216,7,5598323932
7844,197017969,104895423,301913392,0,0,1,197632,10,9183152016
7845,197060410,104853005,301913415,6,0,1,3072,7,6986811477
7846,197060909,104902262,301963171,0,0,1,88576,10,112041173
7847,197104510,104862074,301966584,8,0,1,11776,2,1548263194
7848,197108660,73763422,270872082,6,0,0,57856,7,5254363526
7849,197119300,73919047,271038347,3,0,0,8704,3,874698068
7850,197135310,73900293,271035603,9,0,0,172544,17,1917675780
7851,197189720,73662816,270852536,9,0,0,101376,17,5008179197
7852,197198690,73598621,270797311,7,0,0,4096,16,3051976244
7853,197202209,104855301,302057510,0,0,1,151040,10,1333957282
7854,197204879,73595442,270800321,8,0,0,8704,2,4715849464
7855,197207720,73887776,271095496,6,0,0,49152,7,8857599286
7856,197208990,73417117,270626107,3,0,0,512,3,9193189282
7857,197214370,73944983,271159353,9,0,0,154112,17,4199554967
7858,197235990,74241568,271477558,6,0,0,171008,7,3174271613
7859,197254120,104805336,302059456,8,0,1,3072,2,7051037316
7860,197352049,73445597,270797646,8,0,0,1024,2,8597924389
7861,197352279,105080133,302432412,0,0,1,134144,10,10026915504
7862,197371799,73482632,270854431,8,0,0,6144,2,680343272
7863,197373179,105247903,302621082,0,0,1,70144,10,7675524605
7864,197377160,105243945,302621105,8,0,1,1536,2,50208424
7865,197397870,105223258,302621128,6,0,1,3072,7,10148036439
7866,197401069,105220082,302621151,0,0,1,35840,10,6821837868
7867,197433559,73291304,270724863,8,0,0,1024,2,10131544090
7868,197447979,105355693,302803672,0,0,1,146432,10,5349055646
7869,197487799,105439202,302927001,0,0,1,147456,10,1680298569
7870,197503699,74004863,271508562,8,0,0,5632,2,937720448
7871,197513940,73427895,270941835,9,0,0,26112,17,4981409428
7872,197582460,73128086,270710546,3,0,0,512,3,7675635257
7873,197653820,73229759,270883579,7,0,0,1024,16,5037131456
7874,197659439,73549023,271208462,8,0,0,4096,2,5014421451
7875,197696719,73582090,271278809,8,0,0,6144,2,7876610447
7876,197753169,105919588,303672757,0,0,1,300544,10,8559222804
7877,197759990,73415989,271175979,7,0,0,4608,16,3597015895
7878,197782029,105890775,303672804,0,0,1,416768,10,7285516108
7879,197828970,73596461,271425431,9,0,0,17408,17,1484056429
7880,197895810,73329861,271225671,6,0,0,7680,7,9210338997
7881,197914840,105757987,303672827,6,0,1,13312,7,3973272274
7882,197917370,105755480,303672850,8,0,1,14848,2,4070100306
7883,197918000,105754873,303672873,8,0,1,1536,2,8278412261
7884,197959500,73716041,271675541,9,0,0,95744,17,10424742423
7885,197990669,73105318,271095987,8,0,0,1536,2,3418171253
7886,198018249,105658749,303676998,0,0,1,141824,10,7509633449
7887,198055459,72918330,270973789,8,0,0,3584,2,4010740422
7888,198101480,105575541,303677021,7,0,1,4096,16,4187130511
7889,198107719,74110069,272217788,8,0,0,6656,2,4914723824
7890,198112690,73055597,271168287,9,0,0,20992,17,4775863688
7891,198121520,73096637,271218157,9,0,0,31744,17,4551883365
7892,198123850,74262304,272386154,3,0,0,3584,3,4942710744
7893,198143920,73703743,271847663,7,0,0,1024,16,7420067256
7894,198167950,73709900,271877850,9,0,0,96256,17,3632186912
7895,198176810,105500242,303677052,7,0,1,5120,16,6745993767
7896,198211319,73164227,271375546,8,0,0,2048,2,8005936495
7897,198304270,72968503,271272773,7,0,0,1536,16,8095801354
7898,198314330,74671775,272986105,9,0,0,144896,17,3040342715
7899,198324180,105352895,303677075,7,0,1,10240,16,3272584799
7900,198326039,105398390,303724429,0,0,1,137216,10,9017385588
7901,198333150,74493541,272826691,1,0,0,599040,5,8545685155
7902,198362990,105363611,303726601,5,0,1,512,11,8146363535
7903,198364339,73268467,271632806,8,0,0,6144,2,3678814258
7904,198426330,105312344,303738674,6,0,1,26624,7,9016912041
7905,198431590,73352103,271783693,9,0,0,70144,17,2707310029
7906,198488850,105250695,303739545,7,0,1,12288,16,6841160416
7907,198492650,74551081,273043731,6,0,0,187392,7,8362631623
7908,198514180,73247627,271761807,1,0,0,70656,5,6132001471
7909,198519380,74632247,273151627,1,0,0,11776,5,2346208998
7910,198572190,73306806,271878996,3,0,0,3584,3,9619936256
7911,198580799,105164947,303745746,0,0,1,10240,10,4654474887
7912,198649950,74417071,273067021,6,0,0,54272,7,10511123020
7913,198657060,73284930,271941990,3,0,0,2048,3,9428881695
7914,198803680,73396692,272200372,6,0,0,54272,7,9415541014
7915,198854050,73307528,272161578,6,0,0,23552,7,3850657700
7916,198884119,72878179,271762298,8,0,0,1536,2,8696446926
7917,198922410,104830134,303752544,7,0,1,10752,16,9827425445
7918,199038870,105018510,304057380,7,0,1,138240,16,8086003570
7919,199058090,73092616,272150706,6,0,0,129024,7,360947812
7920,199083700,72910200,271993900,7,0,0,4096,16,4948033037
7921,199107710,105136608,304244318,6,0,1,51712,7,5170934605
7922,199120710,73821178,272941888,1,0,0,368128,5,5527255200
7923,199224029,105020312,304244341,1,0,1,10240,5,5048234818
7924,199245330,72865347,272110677,9,0,0,9216,17,8383780719
7925,199331900,104994496,304326396,6,0,1,49664,7,8563978457
7926,199357309,105069233,304426542,0,0,1,82432,10,7775220999
7927,199387860,72692282,272080142,3,0,0,9728,3,10033625062
7928,199407490,72961479,272368969,6,0,0,76800,7,8427957178
7929,199463530,73805503,273269033,6,0,0,34304,7,10068612743
7930,199474700,104957724,304432424,7,0,1,13824,16,9353848050
7931,199480550,73093835,272574385,1,0,0,152064,5,3508654403
7932,199496279,105172160,304668439,1,0,1,7168,5,7049456910
7933,199530519,73113621,272644140,8,0,0,228864,2,1532237454
7934,199588600,72781016,272369616,3,0,0,2048,3,9849047988
7935,199605430,105063032,304668462,7,0,1,37376,16,2975987770
7936,199611720,73601968,273213688,6,0,0,53248,7,6977812553
7937,199640990,105038594,304679584,7,0,1,2560,16,1001408490
7938,199652540,105027067,304679607,7,0,1,23552,16,3881128258
7939,199656269,105309946,304966215,1,0,1,291328,5,134362885
7940,199698100,73352362,273050462,9,0,0,22016,17,1055173694
7941,199730560,73466812,273197372,1,0,0,149504,5,1696378304
7942,199735500,105230738,304966238,6,0,1,25088,7,40204718
7943,199817770,73330246,273148016,6,0,0,265728,7,10024280118
7944,199844060,72984214,272828274,3,0,0,5120,3,3973207041
7945,199849590,72980111,272829701,9,0,0,4608,17,5839002242
7946,199867559,105098702,304966261,1,0,1,57856,5,10549325780
7947,199872860,105093424,304966284,7,0,1,2560,16,7332245923
7948,199922940,73063672,272986612,3,0,0,1536,3,2073255760
7949,199947490,105018817,304966307,6,0,1,6144,7,3983490263
7950,199948630,105017700,304966330,7,0,1,5120,16,7462578320
7951,199990500,73774063,273764563,6,0,0,222720,7,6327062666
7952,200023319,104952760,304976079,1,0,1,33280,5,2017310255
7953,200055300,73710268,273765568,7,0,0,3072,16,2880932535
7954,200060670,73470605,273531275,9,0,0,278016,17,10260427479
7955,200062890,73471723,273534613,3,0,0,8704,3,10369338444
7956,200063920,104931536,304995456,7,0,1,10240,16,8243544305
7957,200071649,104983486,305055135,0,0,1,90624,10,868219770
7958,200073120,105033432,305106552,7,0,1,29184,16,9809527089
7959,200094930,105011645,305106575,6,0,1,8704,7,6529046024
7960,200095870,105010728,305106598,7,0,1,16896,16,3985495717
7961,200124939,105097749,305222688,1,0,1,261632,5,8529096145
7962,200126560,105110401,305236961,6,0,1,8704,7,4529545577
7963,200128639,105463334,305591973,0,0,1,532992,10,3248981975
7964,200168320,73758467,273926787,1,0,0,390656,5,10658712999
7965,200170219,105683213,305853432,1,0,1,356864,5,5456708284
7966,200174759,105758177,305932936,1,0,1,110080,5,714496250
7967,200206600,105738922,305945522,7,0,1,6144,16,1844322786
7968,200238070,73435940,273674010,6,0,0,53760,7,7228465567
7969,200281599,105964150,306245749,1,0,1,243200,5,9684579153
7970,200297479,73491777,273789256,8,0,0,72704,2,1699820323
7971,200326110,73205828,273531938,7,0,0,2048,16,10055928430
7972,200343009,106103334,306446343,1,0,1,451072,5,8469353614
7973,200368140,106081644,306449784,3,0,1,27136,3,4379444039
7974,200379809,73561900,273941709,8,0,0,11776,2,9600637838
7975,200382460,106068361,306450821,6,0,1,1536,7,277587248
7976,200391650,73416086,273807736,6,0,0,17408,7,3383484788
7977,200404070,74244411,274648481,6,0,0,399872,7,8032000497
7978,200439499,106036650,306476149,0,0,1,64000,10,2557290908
7979,200464519,106037129,306501648,0,0,1,33280,10,140827242
7980,200479800,106022514,306502314,7,0,1,11264,16,7039121080
7981,200549580,105952990,306502570,8,0,1,9216,2,5863473091
7982,200550179,74337094,274887273,8,0,0,306688,2,5808154414
7983,200552129,105985182,306537311,0,0,1,62464,10,6261126249
7984,200562800,105994974,306557774,7,0,1,34816,16,467880646
7985,200567180,105990819,306557999,8,0,1,12800,2,682006334
7986,200601169,105961016,306562185,0,0,1,6656,10,2814488082
7987,200602960,74190846,274793806,9,0,0,144384,17,5155890135
7988,200611079,106013609,306624688,1,0,1,115200,5,5435497911
7989,200619960,106245024,306864984,7,0,1,165888,16,9447372160
7990,200639899,106251846,306891745,1,0,1,64512,5,8484437262
7991,200656159,106544225,307200384,1,0,1,582656,5,2601807689
7992,200669780,106531910,307201690,8,0,1,2048,2,9134562036
7993,200679239,106527290,307206529,1,0,1,18944,5,6323645009
7994,200756520,74494849,275251369,6,0,0,96768,7,3415896278
7995,200771280,73572196,274343476,3,0,0,4608,3,5989280176
7996,200822259,106433085,307255344,0,0,1,99840,10,6882120467
7997,200826950,74278994,275105944,6,0,0,666112,7,1549725995
7998,200829279,106439225,307268504,0,0,1,37888,10,3338461437
7999,200854080,74432885,275286965,3,0,0,3584,3,8715456490
8000,200873680,73784207,274657887,7,0,0,4608,16,10712312863
8001,200892950,73605287,274498237,7,0,0,512,16,6851221264
8002,200906200,73490032,274396232,7,0,0,1536,16,8736785663
8003,200907040,106372296,307279336,6,0,1,22528,7,4155529080
8004,200907720,73748740,274656460,6,0,0,26112,7,1048401084
8005,200912560,73750654,274663214,9,0,0,17408,17,5449227698
8006,200913520,73989389,274902909,1,0,0,50688,5,2833355055
8007,200915720,106366202,307281922,7,0,1,4096,16,7329475222
8008,200917560,74210362,275127922,6,0,0,71680,7,7885825514
8009,200945810,74187265,275133075,6,0,0,16384,7,6609251758
8010,200978819,106379613,307358432,0,0,1,216576,10,7164376782
8011,201022170,106336518,307358688,7,0,1,9216,16,7594664794
8012,201063929,106438195,307502124,0,0,1,226816,10,6307137886
8013,201067360,74368784,275436144,9,0,0,122880,17,9569831809
8014,201068720,106444725,307513445,7,0,1,14336,16,4223726358
8015,201079330,106434986,307514316,6,0,1,12288,7,5153466077
8016,201080430,106467477,307547907,7,0,1,4096,16,2437168699
8017,201105949,107079563,308185512,0,0,1,753664,10,8554524971
8018,201132780,107053808,308186588,6,0,1,13312,7,7580040990
8019,201140080,107097526,308237606,3,0,1,47616,3,10309439629
8020,201212409,107053369,308265778,1,0,1,25088,5,7723146166
8021,201252579,107228771,308481350,0,0,1,422912,10,4301630110
8022,201254010,73880203,275134213,7,0,0,3584,16,9617729328
8023,201263300,74033830,275297130,3,0,0,512,3,5141214817
8024,201305140,107200232,308505372,3,0,1,13824,3,5280608045
8025,201305190,74850746,276155936,6,0,0,297472,7,6614986517
8026,201324870,74535794,275860664,3,0,0,222208,3,3322078051
8027,201345260,74143625,275488885,7,0,0,1536,16,3410208341
8028,201374399,107132279,308506678,4,0,1,2048,2,9903741570
8029,201421310,75246287,276667597,1,0,0,236544,5,5549440540
8030,201451329,107056975,308508304,0,0,1,2560,10,5920491323
8031,201463420,107049710,308513130,6,0,1,7680,7,10181206521
8032,201522310,74966398,276488708,9,0,0,383488,17,2910466301
8033,201532720,106983636,308516356,7,0,1,5120,16,7538462738
8034,201670730,73935060,275605790,1,0,0,2560,5,6524615211
8035,201708700,106808015,308516715,6,0,1,9728,7,6548799390
8036,201718540,106803321,308521861,3,0,1,8192,3,769478716
8037,201733680,73794680,275528360,6,0,0,6656,7,10392680733
8038,201757280,73862254,275619534,1,0,0,512,5,2682451172
8039,201785640,73763888,275549528,1,0,0,2560,5,7591035233
8040,201826289,106699118,308525407,0,0,1,5632,10,683646901
8041,201826340,74171191,275997531,3,0,0,142848,3,4740387859
8042,201827490,74333929,276161419,9,0,0,17920,17,5592982364
8043,201836930,106688990,308525920,7,0,1,18432,16,5466918123
8044,201845369,106881977,308727346,0,0,1,231936,10,967535920
8045,201885399,108084316,309969715,1,0,1,478208,5,6762341314
8046,201900370,75264485,277164855,9,0,0,919552,17,5629031839
8047,201941309,108822602,310763911,0,0,1,943104,10,1385732394
8048,201959209,73635073,275594282,8,0,0,7168,2,6239642727
8049,201983180,73763728,275746908,3,0,0,34304,3,9965841335
8050,202080309,75409022,277489331,8,0,0,32768,2,5006693066
8051,202106649,108657285,310763934,1,0,1,81920,5,77278382
8052,202146649,108636426,310783075,1,0,1,507904,5,7245759715
8053,202147879,108644923,310792802,0,0,1,57856,10,3447025031
8054,202169040,75019246,277188286,9,0,0,76800,17,8314542177
8055,202185109,108864717,311049826,1,0,1,642048,5,4409190343
8056,202186030,75359623,277545653,6,0,0,44544,7,3296343535
8057,202225400,108836042,311061442,7,0,1,6656,16,4203757409
8058,202243890,75149081,277392971,7,0,0,512,16,1067576590
8059,202244450,74637447,276881897,3,0,0,96256,3,10686167418
8060,202263529,108810390,311073919,0,0,1,31232,10,3134820717
8061,202284740,75039936,277324676,9,0,0,403968,17,3316693442
8062,202293000,75237764,277530764,6,0,0,25088,7,2196514471
8063,202299279,109193562,311492841,0,0,1,452096,10,10509648690
8064,202308350,74266166,276574516,7,0,0,512,16,589044231
8065,202328230,75203828,277532058,7,0,0,4096,16,609406427
8066,202352480,109140384,311492864,6,0,1,41984,7,589257762
8067,202361930,109130957,311492887,7,0,1,5632,16,3147655756
8068,202374450,74990387,277364837,3,0,0,67072,3,7685776658
8069,202510949,109095017,311605966,0,0,1,75776,10,9582994522
8070,202530700,109077072,311607772,7,0,1,512,16,4005439996
8071,202534769,74666800,277201569,8,0,0,43520,2,3495690088
8072,202546079,109432967,311979046,0,0,1,516096,10,7628589476
8073,202639799,110003185,312642984,1,0,1,578560,5,4025687905
8074,202658029,110094283,312752312,1,0,1,94720,5,5036034078
8075,202665619,74857470,277523089,8,0,0,110592,2,5805761337
8076,202702070,74690714,277392784,3,0,0,91648,3,509199514
8077,202735610,74725260,277460870,6,0,0,222720,7,5188546461
8078,202815829,110378327,313194156,1,0,1,206336,5,10701952774
8079,202816920,74508091,277325011,1,0,0,1024,5,5214742716
8080,202827799,110591990,313419789,1,0,1,81408,5,1331547304
8081,202828000,110652288,313480288,6,0,1,71168,7,9673501208
8082,202845340,74729048,277574388,3,0,0,94208,3,6233557215
8083,202861970,110624094,313486064,3,0,1,17920,3,8117371502
8084,202869730,74609571,277479301,3,0,0,60416,3,3598855989
8085,202891250,111023249,313914499,3,0,1,55808,3,190858549
8086,202916149,74428229,277344378,8,0,0,63488,2,10689533034
8087,202942270,110972252,313914522,3,0,1,2560,3,5175483343
8088,202966199,111120539,314086738,1,0,1,80896,5,5744988724
8089,203004310,111117190,314121500,6,0,1,88576,7,1336837433
8090,203048390,111291610,314340000,7,0,1,12288,16,3248564401
8091,203054089,111296196,314350285,1,0,1,73728,5,9801830833
8092,203062590,111288361,314350951,6,0,1,1024,7,9249483144
8093,203096360,111328886,314425246,6,0,1,72704,7,9649714382
8094,203096919,74718521,277815440,8,0,0,80896,2,4475414758
8095,203123040,111302229,314425269,3,0,1,12800,3,949013828
8096,203126150,74448605,277574755,1,0,0,1024,5,2083713326
8097,203150649,111378258,314528907,1,0,1,52736,5,9552998864
8098,203165640,111396385,314562025,6,0,1,2048,7,2476061242
8099,203173540,74903540,278077080,3,0,0,161280,3,9756166077
8100,203174290,74502651,277676941,7,0,0,2048,16,6709246620
8101,203201940,74527943,277729883,7,0,0,1536,16,5324346224
8102,203202630,74912260,278114890,3,0,0,52736,3,2621792458
8103,203221370,74638815,277860185,3,0,0,92160,3,4581626868
8104,203254590,74659076,277913666,7,0,0,6144,16,2480088452
8105,203257860,111304188,314562048,3,0,1,6144,3,8410518892
8106,203290710,111287475,314578185,7,0,1,23040,16,8370206364
8107,203304100,74955288,278259388,3,0,0,28672,3,4107776424
8108,203309990,75191313,278501303,9,0,0,270848,17,5768925453
8109,203320749,74666624,277987373,8,0,0,13312,2,718122779
8110,203322940,74538204,277861144,9,0,0,3072,17,2372227850
8111,203325010,111367779,314692789,7,0,1,68608,16,5730075046
8112,203333330,74616322,277949652,1,0,0,2560,5,10714709680
8113,203378060,111314752,314692812,5,0,1,2560,11,8258798400
8114,203393790,111323724,314717514,6,0,1,17920,7,1363015027
8115,203410479,112619662,316030141,1,0,1,277504,5,9035812057
8116,203414340,112975875,316390215,7,0,1,16896,16,10458951048
8117,203436689,113261994,316698683,1,0,1,54272,5,2729256948
8118,203449189,75088329,278537518,8,0,0,118784,2,2583204520
8119,203456180,113299645,316755825,7,0,1,13824,16,2233112346
8120,203504350,74887341,278391691,7,0,0,3072,16,3135986776
8121,203539740,74795766,278335506,7,0,0,2048,16,3985709590
8122,203551879,113471180,317023059,1,0,1,227840,5,9187535675
8123,203557709,113578360,317136069,1,0,1,102912,5,143208069
8124,203561569,113811164,317372733,1,0,1,41984,5,2981093752
8125,203617300,113755456,317372756,7,0,1,47616,16,8309067799
8126,203678030,113877315,317555345,3,0,1,47616,3,10216406987
8127,203687980,113867388,317555368,3,0,1,11776,3,2611304909
8128,203710840,113846150,317556990,6,0,1,33792,7,4242958046
8129,203741060,113856823,317597883,7,0,1,66560,16,3812052419
8130,203742489,74969384,278711873,8,0,0,243200,2,4350862222
8131,203744899,113912357,317657256,1,0,1,43008,5,8556188499
8132,203755050,74797222,278552272,7,0,0,1024,16,6796179224
8133,203764890,74775707,278540597,7,0,0,8704,16,3106622479
8134,203776779,113882103,317658882,0,0,1,2560,10,326702305
8135,203780750,113878542,317659292,7,0,1,17920,16,10538313130
8136,203786560,113917108,317703668,3,0,1,37376,3,1154090319
8137,203794930,74742946,278537876,7,0,0,1024,16,6662425301
8138,203796850,74744862,278541712,7,0,0,3584,16,8797721471
8139,203829110,113877784,317706894,3,0,1,5120,3,10685368792
8140,203839030,113896084,317735114,6,0,1,25600,7,2676681148
8141,203843669,74999121,278842790,8,0,0,49664,2,9695805574
8142,203867590,113868395,317735985,7,0,1,12288,16,3060193886
8143,203903930,113920646,317824576,6,0,1,33792,7,3797483192
8144,203903950,75044562,278948512,3,0,0,50176,3,2104002840
8145,203910870,75077881,278988751,3,0,0,37376,3,7536611510
8146,203914410,113910730,317825140,7,0,1,10752,16,7901846314
8147,203922159,75108787,279030946,8,0,0,106496,2,1807318223
8148,203940659,115052323,318992982,1,0,1,507904,5,6677247460
8149,204009260,75400069,279409329,6,0,0,34816,7,6348983622
8150,204022370,114997463,319019833,3,0,1,20480,3,6237588779
8151,204049160,75347758,279396918,9,0,0,47104,17,7385455863
8152,204067960,114955409,319023369,7,0,1,8704,16,6397289552
8153,204068890,114965014,319033904,7,0,1,26624,16,6999050499
8154,204074019,115276421,319350440,1,0,1,185344,5,10541918352
8155,204095520,74867399,278962919,3,0,0,6656,3,10447623
8156,204101330,75466271,279567601,6,0,0,45056,7,3623236300
8157,204116580,75265963,279382543,9,0,0,8704,17,8878353656
8158,204166470,115183993,319350463,7,0,1,1024,16,5613240992
8159,204168740,75053318,279222058,6,0,0,236032,7,5867928095
8160,204171730,75168000,279339730,3,0,0,265728,3,9700839588
8161,204176790,74888488,279065278,7,0,0,6144,16,2769497379
8162,204178809,75054036,279232845,8,0,0,35328,2,8426704517
8163,204184170,115179755,319363925,5,0,1,94208,11,9115167522
8164,204205550,115413596,319619146,5,0,1,23552,11,2923783151
8165,204230240,115428796,319659036,5,0,1,12800,11,7522087239
8166,204230349,75149519,279379868,8,0,0,131072,2,3398860681
8167,204240670,75564895,279805565,6,0,0,150016,7,2143724165
8168,204240929,115633757,319874686,1,0,1,58880,5,5767128374
8169,204259939,75556559,279816498,8,0,0,28672,2,5973089544
8170,204274090,115600619,319874709,6,0,1,23040,7,8909714502
8171,204287790,115605872,319893662,3,0,1,23040,3,8267322346
8172,204324500,75015409,279339909,1,0,0,512,5,5271022144
8173,204328689,115737727,320066416,1,0,1,17408,5,532122707
8174,204359710,75359256,279718966,3,0,0,4096,3,1969161277
8175,204377720,76054364,280432084,6,0,0,994816,7,10465877639
8176,204383449,115682998,320066447,1,0,1,1024,5,495002966
8177,204389369,116077659,320467028,1,0,1,113152,5,2435507335
8178,204405821,116725513,321131334,9,0,1,586752,17,5275405859
8179,204454649,116876699,321331348,1,0,1,520704,5,8256229684
8180,204458740,75471548,279930288,3,0,0,1536,3,9367617980
8181,204479630,116854304,321333934,5,0,1,4096,11,5843251917
8182,204493510,116840770,321334280,7,0,1,512,16,6283875555
8183,204537990,116796956,321334946,2,0,1,1024,4,7218358093
8184,204554500,116788828,321343328,7,0,1,12288,16,2174658801
8185,204622150,75438037,280060187,3,0,0,100864,3,6305466031
8186,204634290,75269647,279903937,7,0,0,4096,16,2111539732
8187,204634679,116783022,321417701,1,0,1,51200,5,9183446680
8188,204638180,116784027,321422207,7,0,1,7168,16,3230784120
8189,204645620,116822498,321468118,3,0,1,23552,3,5483413850
8190,204657070,75822617,280479687,3,0,0,156160,3,284438368
8191,204657541,117176311,321833852,9,0,1,256000,17,4558973449
8192,204683741,117178665,321862406,9,0,1,41472,17,3191547877
8193,204690870,75789487,280480357,1,0,0,2048,5,2704964811
8194,204719240,75801659,280520899,6,0,0,94208,7,2869933435
8195,204723030,117156417,321879447,7,0,1,28160,16,9159176258
8196,204745329,117832469,322577798,1,0,1,420864,5,3024601717
8197,204747711,117830110,322577821,9,0,1,2048,17,7677413844
8198,204762500,117815344,322577844,6,0,1,6144,7,1820271527
8199,204763750,75831876,280595626,3,0,0,12800,3,1512727385
8200,204765399,118322084,323087483,1,0,1,412160,5,9649229827
8201,204768300,75916521,280684821,6,0,0,7168,7,4006690351
8202,204779709,118459666,323239375,1,0,1,293888,5,5842618087
8203,204787810,118500135,323287945,3,0,1,62464,3,4471661344
8204,204822460,118465508,323287968,5,0,1,1024,11,349143252
8205,204824040,118463951,323287991,7,0,1,3584,16,6728194409
8206,204826860,76076186,280903046,6,0,0,51200,7,10547989482
8207,204860940,76001658,280862598,7,0,0,1536,16,1097177979
8208,204861350,76338164,281199514,7,0,0,11264,16,9454687867
8209,204881650,76643833,281525483,3,0,0,23040,3,625988385
8210,204893440,76874767,281768207,9,0,0,82432,17,1804782236
8211,204910839,118390131,323300970,1,0,1,113152,5,6090713653
8212,204923099,118492359,323415458,1,0,1,161792,5,5902341439
8213,204948870,77137394,282086264,9,0,0,488448,17,9264624805
8214,204951960,76178781,281130741,6,0,0,18432,7,6783364166
8215,204993071,119047728,324040799,9,0,1,385536,17,7757415010
8216,204997250,76127852,281125102,6,0,0,11264,7,2682187967
8217,205010600,119046346,324056946,7,0,1,31744,16,2155728627
8218,205018460,119083934,324102394,3,0,1,19456,3,8532049967
8219,205019239,76682087,281701326,8,0,0,129024,2,2359234542
8220,205044430,76233236,281277666,7,0,0,1536,16,1782654026
8221,205053110,76648707,281701817,1,0,0,1536,5,6729167963
8222,205055790,119387546,324443336,3,0,1,307712,3,4664979031
8223,205076680,119521920,324598600,3,0,1,294400,3,8420437455
8224,205079579,119519052,324598631,1,0,1,54784,5,5222866807
8225,205129039,76463313,281592352,8,0,0,90112,2,9316741446
8226,205154650,76357435,281512085,6,0,0,318976,7,1782750404
8227,205170990,119427664,324598654,7,0,1,1024,16,4553403078
8228,205212250,119386427,324598677,7,0,1,6144,16,5956660033
8229,205255220,119393545,324648765,3,0,1,80384,3,6385526774
8230,205271700,76566118,281837818,9,0,0,183808,17,8696729898
8231,205280990,76104925,281385915,6,0,0,163328,7,9325033273
8232,205285849,119615295,324901144,1,0,1,429568,5,5780711865
8233,205294280,77414332,282708612,9,0,0,220672,17,10467501331
8234,205294920,76915818,282210738,9,0,0,64512,17,7603652073
8235,205305199,119930329,325235528,1,0,1,407040,5,9590861669
8236,205309200,120039918,325349118,3,0,1,51712,3,4592157777
8237,205323570,120037098,325360668,7,0,1,17408,16,8846062193
8238,205346810,76740257,282087067,1,0,0,2560,5,4908991057
8239,205359430,120002864,325362294,7,0,1,2560,16,3784111481
8240,205360060,77166635,282526695,3,0,0,120832,3,6565414445
8241,205375930,77265026,282640956,9,0,0,353280,17,859344087
8242,205376440,76749413,282125853,7,0,0,7168,16,181677944
8243,205383090,77258240,282641330,1,0,0,1024,5,1267887889
8244,205415380,76499561,281914941,0,0,0,8704,10,1627597790
8245,205421139,76702507,282123646,8,0,0,66048,2,9199743465
8246,205452190,77079052,282531242,3,0,0,14848,3,6482401756
8247,205490529,120111878,325602407,1,0,1,164864,5,8343265651
8248,205510440,76979416,282489856,9,0,0,556032,17,273394003
8249,205517400,77379262,282896662,9,0,0,107008,17,233060750
8250,205566679,120140073,325706752,1,0,1,169472,5,4900488718
8251,205588060,120139065,325727125,7,0,1,13824,16,425817610
8252,205602950,76646825,282249775,7,0,0,2560,16,6067102998
8253,205611399,120120872,325732271,1,0,1,8192,5,1125075316
8254,205615120,120117612,325732732,7,0,1,10240,16,7781476954
8255,205683840,76849453,282533293,7,0,0,6656,16,141022609
8256,205684479,120093663,325778142,1,0,1,111616,5,9715545215
8257,205687719,77083160,282770879,8,0,0,204288,2,10594761687
8258,205695490,77104701,282800191,3,0,0,50688,3,8518586026
8259,205699180,120079628,325778808,7,0,1,1024,16,1487969405
8260,205709171,120304479,326013650,9,0,1,457216,17,6713116755
8261,205716871,120590632,326307503,9,0,1,356864,17,7662854305
8262,205727810,77046445,282774255,1,0,0,2048,5,6910241447
8263,205747610,77311562,283059172,0,0,0,91648,10,6549988561
8264,205747990,77521272,283269262,6,0,0,371712,7,3205897260
8265,205748570,77148918,282897488,1,0,0,2560,5,10561409823
8266,205763121,120995761,326758882,9,0,1,610304,17,7593306607
8267,205767459,120997555,326765014,1,0,1,9728,5,9168622743
8268,205777669,77377732,283155401,8,0,0,174592,2,326383485
8269,205785091,121166702,326951793,9,0,1,348160,17,1473417341
8270,205788881,121233240,327022121,9,0,1,157184,17,1627829117
8271,205814280,77771630,283585910,3,0,0,170496,3,7181764985
8272,205876419,77578032,283454451,8,0,0,76800,2,2600417559
8273,205876910,77392999,283269909,1,0,0,2048,5,10657702474
8274,205890789,121361179,327251968,1,0,1,460800,5,7594010529
8275,205913540,77837554,283751094,3,0,0,295936,3,622137263
8276,205931470,77354569,283286039,3,0,0,52736,3,8943557497
8277,205966330,77524729,283491059,1,0,0,9216,5,5731701739
8278,205968589,121462450,327431039,1,0,1,479232,5,6605658318
8279,205968649,121728296,327696945,1,0,1,560128,5,7236503637
8280,205972449,121963674,327936123,1,0,1,622592,5,4601970887
8281,206004090,77582623,283586713,1,0,0,2560,5,9754114025
8282,206004289,77582603,283586892,8,0,0,512,2,5416055539
8283,206050500,77607438,283657938,6,0,0,136192,7,5695967053
8284,206082969,77387306,283470275,8,0,0,31744,2,10614420962
8285,206100450,77706872,283807322,3,0,0,123904,3,4297747293
8286,206132760,77691136,283823896,7,0,0,512,16,3672219913
8287,206158459,77716753,283875212,8,0,0,9728,2,8518844155
8288,206213840,78250835,284464675,9,0,0,82432,17,1107199739
8289,206228469,121733351,327961820,1,0,1,60416,5,8597019949
8290,206228800,77861367,284090167,6,0,0,56832,7,9658840667
8291,206236810,77822891,284059701,9,0,0,85504,17,1413822218
8292,206299480,77773348,284072828,6,0,0,43008,7,5427617771
8293,206344040,77589395,283933435,0,0,0,4096,10,2309270737
8294,206365399,121729426,328094825,1,0,1,345600,5,548719953
8295,206390550,77471381,283861931,7,0,0,5120,16,1575909958
8296,206427930,77393291,283821221,0,0,0,1024,10,7096260345
8297,206456450,77360927,283817377,1,0,0,512,5,5363860417
8298,206465490,77974038,284439528,3,0,0,139776,3,2583659332
8299,206495809,78249726,284745535,8,0,0,378880,2,3911287867
8300,206508750,78307218,284815968,0,0,0,126464,10,1649726039
8301,206586560,77602455,284189015,3,0,0,21504,3,1390237885
8302,206590609,121520240,328110849,1,0,1,45056,5,10688275652
8303,206643860,77753057,284396917,6,0,0,168448,7,4954217186
8304,206646670,121464845,328111515,2,0,1,11264,4,1340093873
8305,206663120,77519320,284182440,3,0,0,20480,3,8412387451
8306,206678420,78427532,285105952,3,0,0,173568,3,10252977134
8307,206703080,78074325,284777405,1,0,0,10752,5,7412042519
8308,206714419,121417869,328132288,4,0,1,56320,2,4352825349
8309,206719430,78128334,284847764,3,0,0,20480,3,9901219553
8310,206720300,78053806,284774106,0,0,0,93696,10,8523492821
8311,206747979,78567216,285315195,8,0,0,442880,2,9279381314
8312,206762200,121371394,328133594,2,0,1,2048,4,5607772785
8313,206764889,121370895,328135784,4,0,1,13312,2,4367087401
8314,206801219,121354500,328155719,4,0,1,43008,2,6359179274
8315,206856550,78323191,285179741,9,0,0,236544,17,7423544355
8316,206874889,121307202,328182091,1,0,1,78336,5,115878332
8317,206879779,78588914,285468693,8,0,0,169472,2,7122479309
8318,206898199,121314074,328212273,1,0,1,66048,5,955249145
8319,206936629,78663071,285599700,8,0,0,162304,2,2250289610
8320,206953640,78403872,285357512,1,0,0,5632,5,8165716813
8321,206975889,78574259,285550148,8,0,0,267264,2,4305834224
8322,207046130,121211555,328257685,2,0,1,102912,4,1327362623
8323,207056600,78123632,285180232,7,0,0,1536,16,9789410956
8324,207057290,121201419,328258709,2,0,1,20992,4,10604348932
8325,207077859,121205596,328283455,1,0,1,64000,5,8232340953
8326,207107840,121188399,328296239,2,0,1,10240,4,8776742310
8327,207120500,121190411,328310911,2,0,1,31232,4,4984758933
8328,207164970,121150884,328315854,2,0,1,4608,4,9763242100
8329,207176850,78430875,285607725,3,0,0,26112,3,9779426961
8330,207186289,121201726,328388015,1,0,1,161792,5,7712401356
8331,207199190,79105746,286304936,3,0,0,243200,3,4784745511
8332,207218410,79310997,286529407,3,0,0,188416,3,6987065277
8333,207233249,121315569,328548818,1,0,1,290816,5,8596980719
8334,207274629,79549260,286823889,8,0,0,577024,2,3349438733
8335,207288770,78759141,286047911,6,0,0,129536,7,672738716
8336,207295609,79607570,286903179,8,0,0,77824,2,6166168798
8337,207301979,79525388,286827367,8,0,0,11264,2,7306052827
8338,207316890,78758328,286075218,3,0,0,43008,3,4032278528
8339,207372120,121179604,328551724,2,0,1,16896,4,823767204
8340,207380090,79201310,286581400,1,0,0,2048,5,2865975326
8341,207398260,78907479,286305739,7,0,0,2560,16,4558743472
8342,207405029,121158534,328563563,4,0,1,11776,2,5838215881
8343,207423090,121141459,328564549,2,0,1,1536,4,1062959976
8344,207429540,79555364,286984904,6,0,0,233984,7,5453533384
8345,207455960,79707756,287163716,3,0,0,95744,3,8407919078
8346,207469329,79176122,286645451,8,0,0,125440,2,9055617155
8347,207472219,121284250,328756469,1,0,1,395776,5,5954178046
8348,207484480,79531039,287015519,6,0,0,3584,7,2528520804
8349,207492650,80220146,287712796,6,0,0,295936,7,10597649790
8350,207496710,80394350,287891060,9,0,0,393728,17,6436477483
8351,207527439,121255235,328782674,4,0,1,36864,2,2169829723
8352,207552529,121239068,328791597,1,0,1,24064,5,6007926072
8353,207593779,121262037,328855816,1,0,1,139776,5,8207878788
8354,207625609,121254739,328880348,1,0,1,21504,5,3274861105
8355,207630191,121381012,329011203,9,0,1,176640,17,3288607323
8356,207633090,79632067,287265157,3,0,0,23040,3,9539152795
8357,207666070,121348619,329014689,2,0,1,14336,4,621401068
8358,207706320,121318848,329025168,2,0,1,57344,4,1795702391
8359,207754700,79573761,287328461,0,0,0,110592,10,7551692255
8360,207797440,80150583,287948023,0,0,0,186880,10,8786568304
8361,207834639,79739625,287574264,8,0,0,156160,2,3289393972
8362,207838869,121344974,329183843,1,0,1,279040,5,4475874520
8363,207841700,80257960,288099660,6,0,0,497152,7,6598379196
8364,207845119,121541031,329386150,1,0,1,309760,5,6238818081
8365,207881421,121516551,329397972,9,0,1,36352,17,5712650640
8366,207900719,121564525,329465244,1,0,1,112128,5,3886197342
8367,207948379,121517246,329465625,4,0,1,1536,2,5199375934
8368,207982650,80129745,288112395,3,0,0,40960,3,2372056635
8369,207986029,121528096,329514125,4,0,1,84480,2,4550047080
8370,208007690,80139340,288147030,6,0,0,16896,7,1748632928
8371,208024280,121497398,329521678,2,0,1,20480,4,2037349150
8372,208070979,121450853,329521832,0,0,1,8704,10,1043638278
8373,208078759,121454275,329533034,4,0,1,36864,2,9629168972
8374,208090851,121540458,329631309,9,0,1,230912,17,1606236492
8375,208098279,121537562,329635841,4,0,1,17408,2,4245372360
8376,208106569,121532498,329639067,0,0,1,5120,10,8206635314
8377,208122819,80067682,288190501,8,0,0,43520,2,2323868540
8378,208145290,80397231,288542521,1,0,0,512,5,6815191954
8379,208198219,121735017,329933236,0,0,1,323072,10,5771992645
8380,208207230,121835616,330042846,2,0,1,60416,4,3330839232
8381,208225149,80461910,288687059,8,0,0,160768,2,1266122690
8382,208249100,80054663,288303763,7,0,0,7680,16,8684952988
8383,208275840,80112564,288388404,6,0,0,4608,7,274130627
8384,208283469,121845575,330129044,1,0,1,266752,5,8826705092
8385,208295099,121846899,330141998,0,0,1,9728,10,7343105984
8386,208322590,121833586,330156176,2,0,1,17920,4,5948065312
8387,208322700,80640336,288963036,6,0,0,109056,7,8285186528
8388,208358379,121896794,330255173,1,0,1,222208,5,7410906572
8389,208376980,80081795,288458775,1,0,0,2048,5,3412108463
8390,208411409,121844328,330255737,0,0,1,10752,10,6103434676
8391,208430960,80706471,289137431,0,0,0,167936,10,10727934403
8392,208435190,80260362,288695552,3,0,0,27648,3,10372360753
8393,208436949,121898865,330335814,1,0,1,178688,5,6196295817
8394,208467210,80004726,288471936,7,0,0,2048,16,2184933939
8395,208484009,122039069,330523078,0,0,1,375296,10,2420898163
8396,208491649,80236020,288727669,8,0,0,93184,2,3747549367
8397,208512750,80374681,288887431,3,0,0,56832,3,2489332947
8398,208594470,80022662,288617132,3,0,0,20992,3,8432483230
8399,208640879,122302648,330943527,1,0,1,741888,5,4826641726
8400,208656769,122294330,330951099,1,0,1,31744,5,5944563614
8401,208729229,80190583,288919812,8,0,0,22528,2,6986367208
8402,208778180,122173905,330952085,8,0,1,1536,2,6118800320
8403,208864680,122089031,330953711,2,0,1,2560,4,7415591331
8404,208913949,122092598,331006547,0,0,1,66560,10,6649918367
8405,208956350,80031550,288987900,6,0,0,11264,7,10086655038
8406,208985180,79713694,288698874,7,0,0,1024,16,7229791526
8407,208986200,122020370,331006570,8,0,1,17408,2,4482145014
8408,209019210,121987383,331006593,8,0,1,8704,2,1466077921
8409,209054939,122043241,331098180,0,0,1,241664,10,8245823606
8410,209076279,122025722,331102001,1,0,1,14848,5,7645501610
8411,209077550,122032823,331110373,8,0,1,13312,2,3599267792
8412,209078880,79619659,288698539,7,0,0,9728,16,7782164138
8413,209120029,122050373,331170402,0,0,1,133120,10,9268632775
8414,209123140,122049208,331172348,8,0,1,3072,2,984658732
8415,209123260,122056040,331179300,8,0,1,28672,2,5015737514
8416,209125280,122054366,331179646,2,0,1,512,4,1472001670
8417,209150880,80353109,289503989,7,0,0,8704,16,5523567170
8418,209154779,122041932,331196711,1,0,1,39936,5,133295307
8419,209158470,122044536,331203006,2,0,1,5632,4,6002179958
8420,209181360,122037015,331218375,2,0,1,27648,4,8592952670
8421,209212020,80138651,289350671,6,0,0,141824,7,6637433412
8422,209239580,80291793,289531373,3,0,0,14848,3,701682027
8423,209242480,121979591,331222071,8,0,1,16384,2,425835909
8424,209334540,80069600,289404140,3,0,0,98816,3,1365706599
8425,209345370,121889243,331234613,2,0,1,27648,4,6064808309
8426,209355019,121921959,331276978,0,0,1,87040,10,8201628676
8427,209389440,79983094,289372534,3,0,0,71680,3,8574462267
8428,209410809,122559364,331970173,0,0,1,966656,10,7086489370
8429,209442829,122750662,332193491,1,0,1,499712,5,6915732090
8430,209457780,80365210,289822990,3,0,0,428032,3,8875807570
8431,209482829,80144373,289627202,8,0,0,64512,2,5194046139
8432,209496760,122730242,332227002,2,0,1,62976,4,9265101241
8433,209506730,79728725,289235455,7,0,0,3072,16,8666223329
8434,209556939,122699389,332256328,0,0,1,40448,10,8271665884
8435,209575540,122682273,332257813,2,0,1,15360,4,10364153493
8436,209584900,79841668,289426568,1,0,0,1024,5,4395407286
8437,209670230,122592729,332262959,8,0,1,8192,2,61959122
8438,209676329,122603567,332279896,1,0,1,64000,5,4776761399
8439,209703391,122761447,332464838,9,0,1,430592,17,474734899
8440,209745060,122724924,332469984,2,0,1,8192,4,8175611844
8441,209785110,122695168,332480278,8,0,1,23040,2,7181428952
8442,209798310,80228192,290026502,6,0,0,25088,7,6635819231
8443,209798940,122684001,332482941,2,0,1,29184,4,8246299872
8444,209805259,79840823,289646082,8,0,0,35840,2,7499103719
8445,209820600,80276586,290097186,6,0,0,74752,7,8888158690
8446,209862550,122632318,332494868,2,0,1,1536,4,3010978683
8447,209863710,122632144,332495854,8,0,1,1536,2,288903397
8448,209884720,122646991,332531711,2,0,1,64512,4,9412593644
8449,209904030,79742699,289646729,1,0,0,2048,5,7852272904
8450,209910389,122629375,332539764,0,0,1,46592,10,9533249854
8451,209913720,79693803,289607523,6,0,0,167424,7,5585646723
8452,209924920,122625875,332550795,2,0,1,26624,4,7157300859
8453,209930679,122757385,332688064,1,0,1,357376,5,7376815043
8454,209972740,122742782,332715522,2,0,1,35840,4,1222154737
8455,209993210,80033627,290026837,6,0,0,1024,7,469212536
8456,210006649,122759104,332765753,1,0,1,24576,5,9951859515
8457,210036050,122731969,332768019,6,0,1,3584,7,2082641390
8458,210046030,122722655,332768685,2,0,1,11264,4,5949150367
8459,210056809,122842419,332899228,0,0,1,88576,10,10006292209
8460,210056969,122987381,333044350,1,0,1,98816,5,6105130779
8461,210067360,122998128,333065488,8,0,1,26112,2,10590579962
8462,210117070,79901741,290018811,6,0,0,360448,7,6119116201
8463,210141879,122976269,333118148,1,0,1,91136,5,4187884083
8464,210157439,123287890,333445329,0,0,1,471552,10,8690730355
8465,210175229,123270123,333445352,0,0,1,22016,10,711119078
8466,210200130,123245245,333445375,2,0,1,3072,4,339107673
8467,210221520,80253536,290475056,3,0,0,142336,3,8540133513
8468,210221809,123310571,333532380,0,0,1,182784,10,1469708341
8469,210227609,123304794,333532403,1,0,1,9216,5,10608340669
8470,210270999,123392184,333663183,1,0,1,297984,5,5603910733
8471,210373540,123295775,333669315,8,0,1,9728,2,5471673458
8472,210379480,123295468,333674948,2,0,1,25600,4,57851727
8473,210390650,80448704,290839354,7,0,0,6656,16,10510978334
8474,210396520,81150112,291546632,6,0,0,608256,7,1059374509
8475,210398900,123288976,333687876,8,0,1,26112,2,8389694269
8476,210422419,123554693,333977112,1,0,1,350720,5,2855392994
8477,210430980,80138716,290569696,3,0,0,60416,3,3472295672
8478,210449359,123737159,334186518,1,0,1,142848,5,98262783
8479,210461240,80746726,291207966,7,0,0,209408,16,4340125635
8480,210463849,80187970,290651819,8,0,0,269312,2,3493050445
8481,210473919,80670174,291144093,8,0,0,137216,2,2572692371
8482,210491919,123723626,334215545,0,0,1,34816,10,9851940385
8483,210519199,123701838,334221037,4,0,1,17920,2,5723271345
8484,210522690,80748926,291271616,6,0,0,73216,7,9116038955
8485,210546970,81372495,291919465,6,0,0,93696,7,5075853142
8486,210580980,123655371,334236351,8,0,1,1536,2,333708654
8487,210594469,123648295,334242764,4,0,1,22528,2,6653252559
8488,210599769,123648397,334248166,0,0,1,17408,10,7720796171
8489,210619670,80981608,291601278,3,0,0,166400,3,3841383127
8490,210634420,81033907,291668327,6,0,0,14848,7,7434898627
8491,210635080,123614655,334249735,2,0,1,2048,4,10129420479
8492,210736700,123514661,334251361,2,0,1,2560,4,5827689045
8493,210759920,81486145,292246065,6,0,0,210944,7,8377460837
8494,210783899,123543441,334327340,1,0,1,49152,5,5564786839
8495,210788580,80419565,291208145,1,0,0,512,5,1345043499
8496,210935499,123391864,334327363,1,0,1,93696,5,4196525009
8497,210948980,81024983,291973963,7,0,0,178688,16,1973017196
8498,210952379,123375007,334327386,1,0,1,9728,5,6456042430
8499,210955750,123371659,334327409,2,0,1,19968,4,3858705646
8500,210996149,123331283,334327432,4,0,1,4096,2,764170202
8501,211034200,80516355,291550555,7,0,0,12800,16,1385335336
8502,211065530,81391277,292456807,3,0,0,53248,3,9629939033
8503,211073919,123299269,334373188,0,0,1,102912,10,3629539340
8504,211075829,123334273,334410102,4,0,1,38912,2,9460517461
8505,211115510,80570630,291686140,1,0,0,17920,5,2929908248
8506,211152129,123261865,334413994,4,0,1,6144,2,8617782071
8507,211156189,81270661,292426850,8,0,0,245248,2,1348871151
8508,211239679,123532417,334772096,1,0,1,198144,5,4236397070
8509,211251520,123542653,334794173,8,0,1,9728,2,6709690089
8510,211277669,123575908,334853577,1,0,1,70144,5,10360631544
8511,211280719,123578670,334859389,1,0,1,9216,5,2010743894
8512,211290100,80346695,291636795,1,0,0,7168,5,7972916748
8513,211307350,123616627,334923977,8,0,1,27136,2,2543602416
8514,211307619,123712252,335019871,4,0,1,73728,2,7810238528
8515,211338679,80552215,291890894,8,0,0,132096,2,7593515919
8516,211358270,80702347,292060617,7,0,0,128000,16,8653257556
8517,211361760,80750448,292112208,3,0,0,133120,3,6053406042
8518,211369699,123922686,335292385,4,0,1,91136,2,9936601272
8519,211402520,123951480,335354000,8,0,1,16384,2,5257825518
8520,211404840,80656580,292061420,1,0,0,2560,5,926558761
8521,211440429,123919268,335359697,4,0,1,18944,2,5268173621
8522,211453409,124251195,335704604,0,0,1,233984,10,4626463666
8523,211469650,80787670,292257320,6,0,0,36864,7,6987115514
8524,211496829,124394429,335891258,0,0,1,101376,10,8807438672
8525,211498199,124418505,335916704,0,0,1,73728,10,1808213260
8526,211539000,80719591,292258591,1,0,0,4096,5,2113433716
8527,211550580,124370950,335921530,8,0,1,7680,2,4040353542
8528,211554269,124480754,336035023,0,0,1,82944,10,8815987047
8529,211556639,124608753,336165392,0,0,1,86016,10,8273305309
8530,211557209,125411032,336968241,0,0,1,296960,10,8512893599
8531,211583890,80856578,292440468,6,0,0,44544,7,10384613898
8532,211611320,81072165,292683485,6,0,0,160256,7,6949194143
8533,211643789,125362094,337005883,4,0,1,7680,2,7820603572
8534,211657370,80886465,292543835,6,0,0,96256,7,6601172192
8535,211668700,80880266,292548966,1,0,0,4608,5,1361390848
8536,211707329,125458235,337165564,1,0,1,219648,5,10588316182
8537,211722959,81256107,292979066,8,0,0,59904,2,2513084543
8538,211738949,81064004,292802953,8,0,0,145920,2,9711425773
8539,211745209,125501084,337246293,1,0,1,79872,5,9171750600
8540,211755349,81410896,293166245,8,0,0,111616,2,2963688282
8541,211783590,125462726,337246316,8,0,1,46080,2,2651118515
8542,211798860,80945009,292743869,1,0,0,2048,5,2491286656
8543,211822099,125496523,337318622,0,0,1,130048,10,3026300815
8544,211838509,125480136,337318645,0,0,1,4608,10,2213326930
8545,211888750,81169893,293058643,7,0,0,202240,16,6755986265
8546,211893610,80725501,292619111,1,0,0,2048,5,10662866825
8547,211928139,125390529,337318668,0,0,1,11264,10,1710010176
8548,211948661,125542245,337490906,9,0,1,204288,17,4979122943
8549,211965580,81555185,293520765,3,0,0,407552,3,5445452580
8550,212023960,80970469,292994429,1,0,0,8704,5,945136571
8551,212076969,81484223,293561192,8,0,0,132608,2,793662346
8552,212124330,81511605,293635935,3,0,0,90624,3,3296678740
8553,212152691,126266392,338419083,9,0,1,1006592,17,1525525327
8554,212216210,81103309,293319519,6,0,0,15360,7,2129636281
8555,212258130,81692953,293951083,6,0,0,191488,7,7462929046
8556,212316859,126102247,338419106,1,0,1,18432,5,9608304597
8557,212351569,126067568,338419137,0,0,1,54784,10,8342263999
8558,212372300,81220138,293592438,3,0,0,74752,3,10498911218
8559,212378301,126089224,338467525,9,0,1,164864,17,3238586908
8560,212396241,126080313,338476554,9,0,1,14848,17,3673698665
8561,212435080,81134559,293569639,7,0,0,27648,16,8757276084
8562,212436211,126059677,338495888,9,0,1,33280,17,7575779095
8563,212475980,81117417,293593397,1,0,0,3072,5,2977962116
8564,212502000,81160702,293662702,1,0,0,6656,5,4942688350
8565,212516630,81529355,294045985,7,0,0,113664,16,23747623
8566,212586000,81240810,293826810,6,0,0,88064,7,180672
8567,212596281,125979923,338576204,9,0,1,217088,17,7007080781
8568,212603581,126156120,338759701,9,0,1,384000,17,3217135810
8569,212626100,126153066,338779166,8,0,1,34304,2,7818922594
8570,212638129,126183227,338821356,0,0,1,54784,10,8347668154
8571,212660899,126174278,338835177,1,0,1,48640,5,8463646879
8572,212712760,81897652,294610412,7,0,0,160256,16,9207188474
8573,212803789,126033539,338837328,1,0,1,26624,5,9649398559
8574,212834350,81896249,294730599,7,0,0,204288,16,4827173975
8575,212872291,125972449,338844740,9,0,1,11776,17,3711641039
8576,212904811,126043915,338948726,9,0,1,242688,17,5039619423
8577,212933560,82187190,295120750,1,0,0,7680,5,3522481617
8578,212948049,81983567,294931616,8,0,0,41984,2,6666978351
8579,212958521,126031912,338990433,9,0,1,82944,17,2001917616
8580,212980271,81938195,294918466,2,0,0,253952,4,1897132595
8581,212980879,126143856,339124735,1,0,1,156672,5,7793515008
8582,213000750,82889340,295890090,3,0,0,1025536,3,4877029035
8583,213010220,81249722,294259942,3,0,0,165888,3,4105645353
8584,213028660,82005493,295034153,7,0,0,76800,16,256152067
8585,213031540,82078284,295109824,3,0,0,512,3,5238901088
8586,213042610,82534989,295577599,3,0,0,5632,3,7576067281
8587,213052589,126358714,339411303,1,0,1,421376,5,8657640097
8588,213068139,82884646,295952785,8,0,0,125440,2,4496265225
8589,213079400,82835142,295914542,6,0,0,75776,7,6300538551
8590,213089860,82486000,295575860,7,0,0,116736,16,6859354868
8591,213103110,82105801,295208911,3,0,0,512,3,185862614
8592,213105019,126349566,339454585,0,0,1,113664,10,2237594816
8593,213143620,81638266,294781886,1,0,0,1024,5,8268496363
8594,213169870,126289221,339459091,6,0,1,7168,7,7735798138
8595,213220349,82319920,295540269,8,0,0,211968,2,253093775
8596,213254430,81800659,295055089,7,0,0,26112,16,4694278028
8597,213264560,81654241,294918801,1,0,0,1024,5,1028817064
8598,213313749,81782965,295096714,8,0,0,29184,2,9660616020
8599,213342970,81696792,295039762,1,0,0,3584,5,1838594171
8600,213364219,126174945,339539164,1,0,1,222208,5,6152046750
8601,213367499,126203371,339570870,0,0,1,72192,10,4967859440
8602,213407331,82068331,295475662,2,0,0,177152,4,2573667592
8603,213415769,82695990,296111759,8,0,0,126976,2,6158015134
8604,213417139,82635895,296053034,8,0,0,232960,2,291130801
8605,213427279,126574865,340002144,0,0,1,700416,10,3800671802
8606,213494831,81831899,295326730,2,0,0,30720,4,5435523941
8607,213508721,126623445,340132166,9,0,1,347136,17,3516600490
8608,213525800,126610796,340136596,5,0,1,5632,11,3159874096
8609,213568681,82504367,296073048,2,0,0,64512,4,152911955
8610,213571070,82697327,296268397,7,0,0,316416,16,10685899638
8611,213579861,126880354,340460215,9,0,1,677888,17,5883606700
8612,213585850,82396089,295981939,7,0,0,95232,16,330536661
8613,213593429,82700931,296294360,8,0,0,81408,2,5857723874
8614,213606479,126958569,340565048,0,0,1,238592,10,3913139696
8615,213619110,82963047,296582157,7,0,0,616448,16,4696712617
8616,213723060,82168324,295891384,1,0,0,512,5,7534186997
8617,213738160,82531258,296269418,1,0,0,3072,5,6629917916
8618,213747719,83062905,296810624,8,0,0,168448,2,3639675962
8619,213767410,82123795,295891205,3,0,0,3584,3,9281569154
8620,213770360,82401590,296171950,6,0,0,188928,7,2425813735
8621,213785079,126838088,340623167,1,0,1,95232,5,10160308172
8622,213787909,126930633,340718542,0,0,1,152064,10,8323182501
8623,213805701,127126143,340931844,9,0,1,483328,17,4949792043
8624,213848679,127162884,341011563,0,0,1,143872,10,4790292577
8625,213861421,127152088,341013509,9,0,1,3072,17,5527472254
8626,213864691,82249672,296114363,2,0,0,3072,4,3115155214
8627,213888289,127292422,341180711,1,0,1,306176,5,4374885088
8628,213891640,82161729,296053369,3,0,0,1024,3,8905216700
8629,213919311,82377527,296296838,2,0,0,7680,4,957892471
8630,213926480,127262841,341189321,5,0,1,19968,11,6852033697
8631,213950060,82162369,296112429,1,0,0,2048,5,7624397167
8632,213985290,82128098,296113388,1,0,0,3072,5,3628196848
8633,213990500,127199807,341190307,5,0,1,1536,11,10370862167
8634,214005130,127189043,341194173,5,0,1,6144,11,9970726771
8635,214018080,82280809,296298889,3,0,0,6656,3,8803671412
8636,214040970,82655924,296696894,1,0,0,2048,5,4949647922
8637,214094419,127209553,341303972,1,0,1,226304,5,6458779813
8638,214103979,127204320,341308299,1,0,1,16384,5,9890858344
8639,214124120,82188994,296313114,1,0,0,5120,5,9290357937
8640,214168920,82428461,296597381,7,0,0,14336,16,9050792482
8641,214179350,82634284,296813634,3,0,0,7680,3,4078889798
8642,214200849,127124250,341325099,0,0,1,3584,10,2199534321
8643,214298071,82294896,296592967,2,0,0,34304,4,5073232583
8644,214354409,82011861,296366270,8,0,0,98816,2,7173285238
8645,214376799,126959591,341336390,0,0,1,38400,10,5926586850
8646,214392360,126946296,341338656,5,0,1,3584,11,9385980219
8647,214400440,83100238,297500678,6,0,0,458752,7,2617801392
8648,214402310,126941518,341343828,5,0,1,8192,11,10055172656
8649,214436769,82738727,297175496,8,0,0,103424,2,1397250010
8650,214439120,82610562,297049682,7,0,0,402432,16,5837228237
8651,214462750,83210854,297673604,6,0,0,314368,7,8237796072
8652,214471070,82591427,297062497,7,0,0,41984,16,7293441170
8653,214490209,82346742,296836951,8,0,0,50688,2,3233177220
8654,214502619,83317115,297819734,8,0,0,114176,2,8321607661
8655,214510770,82071722,296582492,1,0,0,1024,5,7881557108
8656,214522140,82289131,296811271,3,0,0,2048,3,1943381537
8657,214547310,82051030,296598340,6,0,0,3072,7,10486531686
8658,214563770,82339043,296902813,3,0,0,3584,3,55327635
8659,214577769,83651346,298229115,8,0,0,841216,2,5824849487
8660,214624299,83810756,298435055,8,0,0,22528,2,3421040008
8661,214679289,127789827,342469116,0,0,1,572928,10,2563467929
8662,214688890,83713444,298402334,7,0,0,73216,16,3622599069
8663,214725739,127829878,342555617,0,0,1,138752,10,10635451592
8664,214727550,82773619,297501169,6,0,0,1536,7,2967503468
8665,214731500,83735479,298466979,7,0,0,76288,16,6418617011
8666,214732750,83498485,298231235,1,0,0,3584,5,5218749100
8667,214789610,82884485,297674095,3,0,0,1536,3,7525555455
8668,214814750,83628954,298443704,7,0,0,25088,16,6180092737
8669,214857380,82392163,297249543,6,0,0,1024,7,7121345727
8670,214906400,83026378,297932778,6,0,0,3072,7,4412516832
8671,214932729,127622911,342555640,1,0,1,38400,5,4014335286
8672,214955131,83424872,298380003,2,0,0,487936,4,2771272526
8673,214984051,82878918,297862969,2,0,0,141824,4,4692269951
8674,215001139,127674878,342676017,1,0,1,245248,5,5501404832
8675,215018409,83728272,298746681,8,0,0,312320,2,2864884149
8676,215053530,82878289,297931819,7,0,0,225280,16,6549651718
8677,215081029,127666802,342747831,1,0,1,175104,5,3152120492
8678,215161909,127658933,342820842,1,0,1,161792,5,9464122228
8679,215179570,127641733,342821303,2,0,1,10240,4,3857435194
8680,215207020,127617189,342824209,2,0,1,4608,4,1351088963
8681,215214550,83221487,298436037,6,0,0,2560,7,6102842229
8682,215247310,127585694,342833004,2,0,1,3072,4,4780791024
8683,215258259,83546523,298804782,8,0,0,85504,2,7692591958
8684,215291230,128194296,343485526,3,0,1,489984,3,4407555085
8685,215321779,83254298,298576077,8,0,0,269312,2,1236002191
8686,215335029,128297921,343632950,0,0,1,204288,10,10499390747
8687,215368560,83271857,298640417,6,0,0,1024,7,4071883391
8688,215372970,83231077,298604047,7,0,0,91648,16,5837115815
8689,215382840,83020297,298403137,6,0,0,2560,7,93145484
8690,215416799,128236746,343653545,1,0,1,23552,5,4538718989
8691,215418690,128253982,343672672,2,0,1,22016,4,2220048735
8692,215449809,128242792,343692601,1,0,1,56320,5,8498592076
8693,215455120,82973024,298428144,7,0,0,81920,16,7042153641
8694,215465420,82969814,298435234,3,0,0,512,3,8711484398
8695,215471439,128419391,343890830,1,0,1,255488,5,3400819412
8696,215509410,82353746,297863156,1,0,0,512,5,7211840636
8697,215529210,82700864,298230074,6,0,0,3072,7,2776231801
8698,215559239,82934759,298493998,8,0,0,88576,2,2600114820
8699,215624700,128266153,343890853,2,0,1,3584,4,7944232096
8700,215632751,83493491,299126242,2,0,0,616960,4,6049295736
8701,215643740,83129328,298773068,7,0,0,86528,16,3772981140
8702,215677230,82931988,298609218,1,0,0,16896,5,5594747228
8703,215721529,128201899,343923428,0,0,1,61440,10,8516077436
8704,215731129,128313441,344044570,0,0,1,164352,10,2069253358
8705,215785780,128317423,344103203,2,0,1,118272,4,4213248733
8706,215803839,128892146,344695985,0,0,1,580608,10,6027126421
8707,215837550,82772315,298609865,1,0,0,2048,5,3763550921
8708,215848269,128982095,344830364,1,0,1,182784,5,2109005114
8709,215850579,129287640,345138219,0,0,1,710144,10,9225953886
8710,215997530,83258984,299256514,7,0,0,291328,16,5605466141
8711,216014600,129124925,345139525,2,0,1,2048,4,7089384412
8712,216027869,129120668,345148537,0,0,1,25600,10,6523671348
8713,216033359,129123891,345157250,1,0,1,34304,5,7078642699
8714,216048939,129274021,345322960,0,0,1,219648,10,3728169046
8715,216049090,82729617,298778707,7,0,0,18432,16,9733849964
8716,216077940,129245686,345323626,2,0,1,1024,4,9653764600
8717,216105790,83151215,299257005,1,0,0,1536,5,2186205324
8718,216128659,129293678,345422337,1,0,1,132096,5,157356599
8719,216145431,83008369,299153800,2,0,0,90112,4,891524841
8720,216156449,129350827,345507276,0,0,1,140288,10,2458706215
8721,216196149,129973604,346169753,0,0,1,342528,10,6105411301
8722,216228530,83258495,299487025,6,0,0,3072,7,9637961975
8723,216267980,129904679,346172659,2,0,1,4608,4,9714215160
8724,216288799,83195973,299484772,8,0,0,310272,2,341173473
8725,216295531,83293887,299589418,2,0,0,140288,4,9580220902
8726,216315179,130189015,346504194,1,0,1,274432,5,4307482030
8727,216345639,130166260,346511899,0,0,1,21504,10,1684841826
8728,216378040,130159588,346537628,2,0,1,1024,4,3076349036
8729,216396170,130143084,346539254,2,0,1,2560,4,2592879163
8730,216411621,83186758,299598379,2,0,0,29184,4,3691267608
8731,216442609,130133744,346576353,0,0,1,58368,10,5125546954
8732,216470550,82786634,299257184,3,0,0,512,3,80208212
8733,216532889,130343386,346876275,1,0,1,150016,5,3910236348
8734,216533890,82854912,299388802,1,0,0,2048,5,9438634472
8735,216575279,130301019,346876298,1,0,1,51200,5,4988362155
8736,216627760,82870542,299498302,3,0,0,2560,3,9935036706
8737,216628910,82726539,299355449,1,0,0,1536,5,8261462594
8738,216629979,130246342,346876321,0,0,1,19968,10,2193266536
8739,216631940,82854126,299486066,1,0,0,4096,5,2695158855
8740,216644810,82954216,299599026,1,0,0,2048,5,7211216717
8741,216646070,82989096,299635166,6,0,0,4096,7,3927847611
8742,216749269,130325998,347075267,1,0,1,15360,5,4462159520
8743,216778690,82766081,299544771,6,0,0,512,7,6410601915
8744,216793899,130281391,347075290,0,0,1,19968,10,5037447936
8745,216805991,83644518,300450509,2,0,0,259584,4,1573997368
8746,216810389,83645291,300455680,8,0,0,16896,2,7467356618
8747,216826359,83000358,299826717,8,0,0,93696,2,4250243676
8748,216830059,130245254,347075313,0,0,1,512,10,69085704
8749,216855879,130219457,347075336,1,0,1,58368,5,1845514563
8750,216879829,130195530,347075359,0,0,1,4608,10,6225278883
8751,216906439,130168943,347075382,0,0,1,45568,10,8787681941
8752,216917679,130157766,347075445,1,0,1,429568,5,3415820161
8753,217004300,83835537,300839837,7,0,0,658432,16,3141956200
8754,217033759,130041709,347075468,1,0,1,52224,5,312824670
8755,217041119,130034372,347075491,0,0,1,18432,10,3589627496
8756,217063599,130173687,347237286,1,0,1,475136,5,4975352083
8757,217063830,130188014,347251844,2,0,1,48128,4,9087402651
8758,217084229,82909502,299993731,8,0,0,19968,2,4155364555
8759,217140309,83371756,300512065,8,0,0,184832,2,5275749162
8760,217151299,130125682,347276981,1,0,1,38912,5,3944478192
8761,217151370,130279968,347431338,3,0,1,309760,3,1863377205
8762,217153289,130595427,347748716,1,0,1,328192,5,9957112199
8763,217183969,130584936,347768905,1,0,1,67072,5,5834355506
8764,217195180,130576311,347771491,2,0,1,4096,4,2980725507
8765,217196630,130653602,347850232,8,0,1,85504,2,7679095028
8766,217203199,130647056,347850255,0,0,1,3072,10,5918681461
8767,217208360,130805809,348014169,3,0,1,378368,3,318738440
8768,217226639,130938459,348165098,1,0,1,312320,5,3958157557
8769,217238880,130926241,348165121,8,0,1,3072,2,4699047978
8770,217245089,130950105,348195194,1,0,1,62976,5,5791966471
8771,217248831,83874348,301123179,2,0,0,241152,4,6381781959
8772,217287429,130912209,348199638,0,0,1,9728,10,2913869069
8773,217297350,83543497,300840847,3,0,0,2560,3,4255569374
8774,217359650,83608542,300968192,1,0,0,1536,5,2885635211
8775,217392629,130811515,348204144,0,0,1,7168,10,755050030
8776,217427379,130788257,348215636,0,0,1,18944,10,7263465107
8777,217455500,83420017,300875517,3,0,0,4608,3,3490714205
8778,217484921,83716137,301201058,2,0,0,94208,4,6124881373
8779,217490440,130745177,348235617,8,0,1,37888,2,4113746807
8780,217518670,130723895,348242565,8,0,1,18432,2,805727746
8781,217519430,83848123,301367553,7,0,0,331264,16,10498095370
8782,217543260,130736659,348279919,8,0,1,27648,2,9728690858
8783,217544160,83686857,301231017,6,0,0,512,7,3495790714
8784,217554120,83972891,301527011,3,0,0,4096,3,5514961237
8785,217555090,83895503,301450593,6,0,0,1024,7,5739367898
8786,217593551,84257869,301851420,2,0,0,941056,4,1252985358
8787,217594320,130737657,348331977,8,0,1,45056,2,10382190415
8788,217603950,131422459,349026409,3,0,1,595456,3,1627578230
8789,217650820,83580018,301230838,7,0,0,53248,16,2879043410
8790,217657550,84250820,301908370,1,0,0,1024,5,8323060403
8791,217708719,131317713,349026432,0,0,1,10752,10,3997531643
8792,217714519,84174548,301889067,8,0,0,121856,2,1853815410
8793,217767400,84084355,301851755,1,0,0,1024,5,6163644857
8794,217811129,84096883,301908012,8,0,0,58880,2,7746793075
8795,217818340,131363912,349182252,3,0,1,252416,3,464577754
8796,217822550,83384816,301207366,6,0,0,2560,7,9118328743
8797,217875210,131314276,349189486,8,0,1,42496,2,10200459139
8798,217885060,131307960,349193020,2,0,1,18944,4,8766851965
8799,217899710,83468490,301368200,1,0,0,2048,5,3217041587
8800,217921420,83449767,301371187,3,0,0,9728,3,5139708664
8801,217922850,83613065,301535915,6,0,0,3072,7,6806435669
8802,217932100,131266066,349198166,2,0,1,8192,4,8979708505
8803,217944970,83532383,301477353,3,0,0,8192,3,5348528842
8804,217976559,131280064,349256623,0,0,1,136192,10,8872647282
8805,218084150,131200406,349284556,3,0,1,57344,3,7956975067
8806,218105110,83434158,301539268,1,0,0,5120,5,5468039601
8807,218142230,131148497,349290727,2,0,1,17920,4,4814681790
8808,218150190,83739836,301890026,3,0,0,3072,3,6202629748
8809,218186820,83726322,301913142,3,0,0,1024,3,499242679
8810,218195740,131101298,349297038,8,0,1,22016,2,6609115018
8811,218220959,131131266,349352225,0,0,1,2048,10,3415283100
8812,218232760,131121411,349354171,8,0,1,3072,2,10032533523
8813,218237110,83675697,301912807,6,0,0,14336,7,1516225052
8814,218241740,83671629,301913369,3,0,0,512,3,393960911
8815,218249119,131107318,349356437,0,0,1,3584,10,9845882954
8816,218282260,131130031,349412291,3,0,1,44544,3,4203634682
8817,218291431,85128281,303419712,2,0,0,892416,4,10409661357
8818,218304340,131139357,349443697,8,0,1,14848,2,10133237327
8819,218312880,131141314,349454194,2,0,1,28672,4,2317058420
8820,218322829,131295725,349618554,0,0,1,87552,10,10349897764
8821,218328430,131290927,349619357,2,0,1,4608,4,1821022751
8822,218385780,83630926,302016706,6,0,0,3584,7,4790912630
8823,218421730,83681789,302103519,3,0,0,4608,3,2159142351
8824,218444489,84176570,302621059,8,0,0,214016,2,9308857940
8825,218446970,84258601,302705571,3,0,0,1024,3,6283771705
8826,218457900,83703446,302161346,3,0,0,2560,3,4641778088
8827,218459610,131164137,349623747,8,0,1,512,2,7465924630
8828,218487240,131142613,349629853,8,0,1,20992,2,2117215252
8829,218494990,131407982,349902972,3,0,1,221696,3,2705813039
8830,218495000,83962052,302457052,1,0,0,512,5,5458124132
8831,218501109,131437165,349938274,0,0,1,90624,10,3187230818
8832,218507769,84345899,302853668,8,0,0,101888,2,3988872045
8833,218523480,131414817,349938297,8,0,1,2560,2,6496567284
8834,218564099,84297211,302861310,8,0,0,10752,2,5596328364
8835,218586300,83968461,302554761,3,0,0,512,3,3036241418
8836,218589250,84134535,302723785,3,0,0,2048,3,2986283486
8837,218616830,84319193,302936023,1,0,0,3584,5,479007335
8838,218618070,131320250,349938320,2,0,1,10240,4,6432092816
8839,218631599,84034313,302665912,8,0,0,35328,2,2950329805
8840,218680220,83624741,302304961,3,0,0,2560,3,10526498452
8841,218737529,131200814,349938343,0,0,1,16384,10,2243452990
8842,218756050,131182324,349938374,3,0,1,44032,3,1192267461
8843,218774150,131164247,349938397,2,0,1,2048,4,693203481
8844,218793730,131144690,349938420,8,0,1,5632,2,2351408052
8845,218796810,83711653,302508463,3,0,0,4608,3,9653877550
8846,218843639,84680179,303523818,8,0,0,318976,2,10520549598
8847,218875930,131062529,349938459,8,0,1,28160,2,10119059696
8848,218979109,84093376,303072485,8,0,0,105984,2,6223596484
8849,219017400,130921082,349938482,8,0,1,10752,2,371616803
8850,219045609,130899652,349945261,0,0,1,64512,10,3752386052
8851,219098120,130862413,349960533,8,0,1,29696,2,6793076752
8852,219122450,130846847,349969297,6,0,1,11776,7,9667296039
8853,219141411,84285188,303426599,2,0,0,22528,4,7617456129
8854,219155050,130816513,349971563,6,0,1,3584,7,6238540832
8855,219180061,83967720,303147781,2,0,0,147968,4,8027277844
8856,219240821,84339336,303580157,2,0,0,184832,4,10719981116
8857,219278051,84392632,303670683,2,0,0,295936,4,5210012979
8858,219282940,130718444,350001384,8,0,1,46592,2,5893657873
8859,219297910,130743203,350041113,8,0,1,78336,2,3854886650
8860,219316610,130737670,350054280,8,0,1,39424,2,8900249858
8861,219328180,83749687,303077867,1,0,0,1536,5,3870241805
8862,219331079,130731159,350062238,0,0,1,3072,10,9068150451
8863,219349260,84231232,303580492,6,0,0,1024,7,9880115697
8864,219360020,84312714,303672734,3,0,0,6656,3,7166791503
8865,219400199,84276776,303676975,8,0,0,12800,2,1404582966
8866,219429279,130634444,350063723,0,0,1,15360,10,9993674823
8867,219430230,84242822,303673052,1,0,0,512,5,3607190750
8868,219469320,130630593,350099913,2,0,1,30208,4,7527506690
8869,219475790,130639754,350115544,2,0,1,39936,4,397340934
8870,219481609,84741736,304223345,5,0,0,346624,11,4450297778
8871,219506040,130610170,350116210,8,0,1,1024,2,3367889483
8872,219514429,85139121,304653550,5,0,0,697856,11,4395890811
8873,219576530,84256847,303833377,6,0,0,1536,7,3734220010
8874,219583099,130541304,350124403,0,0,1,21504,10,3874456158
8875,219623440,130505083,350128523,2,0,1,13824,4,10547543855
8876,219653360,130503133,350156493,8,0,1,47616,2,8194400810
8877,219700690,84064517,303765207,1,0,0,2048,5,2821081482
8878,219700940,130469121,350170061,8,0,1,13824,2,4033564909
8879,219746549,84921867,304668416,8,0,0,7680,2,4743035163
8880,219755980,84488315,304244295,3,0,0,512,3,2199253606
8881,219760519,130410925,350171444,0,0,1,14848,10,1593073954
8882,219772940,84325573,304098513,6,0,0,512,7,4691205340
8883,219778799,84465317,304244116,5,0,0,68096,11,3489549679
8884,219792549,130392312,350184861,0,0,1,3072,10,929408071
8885,219841359,130344168,350185527,0,0,1,11264,10,1988758655
8886,219848511,84831050,304679561,2,0,0,36352,4,3859446885
8887,219930760,84473536,304404296,1,0,0,1024,5,7936542332
8888,219950090,130237025,350187115,2,0,1,15872,4,5196327384
8889,220025490,130209146,350234636,8,0,1,13312,2,7821276356
8890,220040801,84749784,304790585,2,0,0,214528,4,2672336639
8891,220051609,84673573,304725182,5,0,0,149504,11,5799351035
8892,220097640,130137019,350234659,8,0,1,9216,2,546944034
8893,220109859,84556194,304666053,5,0,0,40960,11,816769175
8894,220180330,84115233,304295563,6,0,0,512,7,5452853421
8895,220183960,130050722,350234682,8,0,1,9728,2,9051989707
8896,220201159,84765033,304966192,8,0,0,313856,2,7384862978
8897,220256839,84572769,304829608,8,0,0,128000,2,4377740825
8898,220282270,129952435,350234705,8,0,1,12800,2,6866596449
8899,220335369,129938774,350274143,0,0,1,1536,10,4355939878
8900,220344049,129982193,350326242,0,0,1,32768,10,7400556833
8901,220366300,129967419,350333719,8,0,1,19968,2,9168762619
8902,220424791,84681738,305106529,2,0,0,128000,4,8594648899
8903,220432350,129941576,350373926,7,0,1,10752,16,3779403866
8904,220434040,129941474,350375514,5,0,1,15872,11,614418337
8905,220452011,84735914,305187925,2,0,0,46592,4,2288295979
8906,220459140,84682976,305142116,3,0,0,512,3,9192060877
8907,220473960,84916371,305390331,3,0,0,512,3,8437311324
8908,220498710,84610774,305109484,6,0,0,5120,7,6258088588
8909,220511949,84784091,305296040,8,0,0,56320,2,4029592885
8910,220545540,130020135,350565675,7,0,1,48128,16,2774229458
8911,220573519,130039889,350613408,0,0,1,1024,10,8386832956
8912,220575050,84404878,304979928,3,0,0,2560,3,2457677674
8913,220576969,84611915,305188884,8,0,0,3072,2,9961651086
8914,220593430,130023524,350616954,7,0,1,5632,16,5596376313
8915,220604289,84608836,305213125,8,0,0,11776,2,2936359230
8916,220612759,84978076,305590835,8,0,0,145920,2,5800280677
8917,220614900,130003680,350618580,8,0,1,2560,2,10722486756
8918,220625540,84482329,305107869,6,0,0,4096,7,4565656715
8919,220644300,84757563,305401863,6,0,0,3072,7,7081190499
8920,220654410,129977176,350631586,5,0,1,20992,11,4364599239
8921,220662449,130039859,350702308,0,0,1,46080,10,9210491036
8922,220673670,84647027,305320697,3,0,0,3584,3,3444230741
8923,220692630,130113021,350805651,8,0,1,14848,2,2142580853
8924,220747281,84646974,305394255,2,0,0,8704,4,6868042931
8925,220748000,130057674,350805674,5,0,1,20480,11,9306483157
8926,220751150,84577201,305328351,3,0,0,5632,3,5469823526
8927,220773640,130032057,350805697,8,0,1,3584,2,1964184894
8928,220807660,130001892,350809552,5,0,1,39424,11,1042263028
8929,220809470,130039245,350848715,6,0,1,8192,7,9460182098
8930,220840879,130010742,350851621,0,0,1,4608,10,8347828718
8931,220843981,84387507,305231488,2,0,0,19968,4,2665001167
8932,220890249,130005999,350896248,0,0,1,16896,10,3833674068
8933,220893161,84618488,305511649,2,0,0,11776,4,1563164217
8934,220898660,130004108,350902768,8,0,1,32768,2,1147941336
8935,220900110,130045625,350945735,6,0,1,14848,7,7228321864
8936,220914880,130032265,350947145,5,0,1,1024,11,4500933905
8937,220932729,84736293,305669022,5,0,0,25600,11,8586638249
8938,220943760,130006291,350950051,5,0,1,4608,11,1912447776
8939,220948390,130006167,350954557,5,0,1,7168,11,21812019
8940,220955630,84636320,305591950,6,0,0,3584,7,5158568872
8941,220962950,84578139,305541089,6,0,0,2048,7,10206210779
8942,220964720,84704793,305669513,1,0,0,1536,5,3481535934
8943,221006541,84797020,305803561,2,0,0,101888,4,4687180017
8944,221015061,84682799,305697860,2,0,0,25088,4,4701569100
8945,221044090,129910723,350954813,8,0,1,9216,2,10711817756
8946,221047999,84954565,306002564,8,0,0,167936,2,8794425179
8947,221059000,130052850,351111850,6,0,1,15360,7,9626084352
8948,221128559,129983314,351111873,0,0,1,512,10,6430660145
8949,221155489,85081322,306236811,5,0,0,379904,11,5083663402
8950,221159000,129978191,351137191,5,0,1,22528,11,96762295
8951,221175589,129961625,351137214,0,0,1,38912,10,763338287
8952,221176910,129960327,351137237,6,0,1,1536,7,3347491987
8953,221177611,85068115,306245726,2,0,0,29184,4,10669093956
8954,221215320,129967359,351182679,7,0,1,50688,16,10173851792
8955,221215929,85036083,306252012,8,0,0,20480,2,9668926493
8956,221218399,85163661,306382060,5,0,0,122880,11,7697303769
8957,221236149,129946553,351182702,0,0,1,4096,10,4360611922
8958,221294640,129888085,351182725,8,0,1,9728,2,1351630054
8959,221323269,85234482,306557751,8,0,0,14848,2,9057296871
8960,221339040,85324849,306663889,3,0,0,512,3,4905339640
8961,221362189,85227753,306589942,8,0,0,512,2,4913703098
8962,221385979,85399182,306785161,5,0,0,155136,11,1872645604
8963,221388510,129794246,351182756,8,0,1,14336,2,8523869026
8964,221390229,85736030,307126259,5,0,0,271872,11,1657160047
8965,221420920,85227239,306648159,1,0,0,3072,5,1307747961
8966,221466250,85232561,306698811,3,0,0,2048,3,9382881600
8967,221476821,85470643,306947464,2,0,0,72192,4,9408991535
8968,221482360,129700451,351182811,6,0,1,39424,7,9417878298
8969,221487480,85338220,306825700,3,0,0,3072,3,8721142733
8970,221520410,129662424,351182834,6,0,1,38400,7,4604900944
8971,221529900,129658150,351188050,5,0,1,11776,11,3717882835
8972,221532160,129720116,351252276,6,0,1,25088,7,3064869955
8973,221538040,85443999,306982039,6,0,0,2048,7,5470224279
8974,221558450,85349262,306907712,1,0,0,512,5,3087314085
8975,221562680,85386523,306949203,6,0,0,5632,7,2579819451
8976,221571560,129680739,351252299,7,0,1,14336,16,2697556780
8977,221576480,85209952,306786432,3,0,0,4096,3,8955386884
8978,221587310,129665020,351252330,5,0,1,27648,11,1805665340
8979,221589470,85368072,306957542,1,0,0,6656,5,403435429
8980,221595030,85282846,306877876,3,0,0,5120,3,4668554638
8981,221641030,129611323,351252353,8,0,1,11264,2,6485477439
8982,221642910,129609466,351252376,7,0,1,8704,16,5092918860
8983,221643640,129613982,351257622,6,0,1,10240,7,6021211205
8984,221652781,85523736,307176517,2,0,0,8704,4,2491711933
8985,221667910,129616326,351284236,7,0,1,29184,16,4499440839
8986,221699470,129647627,351347097,2,0,1,37376,4,8900999560
8987,221700870,129657406,351358276,7,0,1,12288,16,1944942242
8988,221703199,129719884,351423083,0,0,1,82432,10,3588127429
8989,221706900,129746882,351453782,5,0,1,37376,11,4994174416
8990,221713490,129740315,351453805,6,0,1,7168,7,6294806042
8991,221713991,85762809,307476800,2,0,0,132096,4,1158540157
8992,221749570,85596598,307346168,3,0,0,512,3,4115188904
8993,221777980,86176426,307954406,3,0,0,192512,3,2541817240
8994,221807970,85842802,307650772,3,0,0,38912,3,7487806994
8995,221818039,86648578,308466617,8,0,0,205824,2,3989240582
8996,221831069,129622759,351453828,0,0,1,37888,10,8165501989
8997,221880030,129573821,351453851,5,0,1,7168,11,2548450093
8998,221887930,85920269,307808199,1,0,0,512,5,5690838138
8999,221891710,85964384,307856094,6,0,0,2048,7,8633746612
9000,221951150,129585122,351536272,7,0,1,25088,16,2753090474
9001,221975949,85809877,307785826,5,0,0,82432,11,2891262254
9002,222032049,86011338,308043387,8,0,0,143360,2,864380388
9003,222056450,85542595,307599045,6,0,0,2560,7,5118027640
9004,222064610,129696853,351761463,5,0,1,31232,11,4496495331
9005,222076610,129690618,351767228,5,0,1,16896,11,5176298085
9006,222092350,129680472,351772822,6,0,1,19456,7,687416017
9007,222107780,129673857,351781637,7,0,1,17408,16,2118519100
9008,222112530,129691028,351803558,7,0,1,23040,16,6777545497
9009,222123389,86349351,308472740,8,0,0,19968,2,1809397542
9010,222154060,129744780,351898840,6,0,1,38912,7,224584749
9011,222230390,86002754,308233144,1,0,0,512,5,8650356598
9012,222251511,86142029,308393540,2,0,0,349184,4,5695746418
9013,222264280,130655268,352919548,7,0,1,83456,16,2323423607
9014,222302671,86099004,308401675,2,0,0,26624,4,9235134752
9015,222304260,86099622,308403882,1,0,0,7168,5,4332583511
9016,222322250,130699585,353021835,6,0,1,26624,7,7559130791
9017,222369950,130699666,353069616,5,0,1,10752,11,6542309591
9018,222371130,86212557,308583687,3,0,0,16384,3,3421132754
9019,222371599,86907051,309278650,5,0,0,439808,11,3797872289
9020,222381850,86223205,308605055,1,0,0,7168,5,1704934495
9021,222467620,130611646,353079266,5,0,1,2560,11,3581935152
9022,222482861,86862447,309345308,2,0,0,205312,4,7752672542
9023,222495290,130618329,353113619,5,0,1,14848,11,7052911749
9024,222521610,130735621,353257231,7,0,1,15360,16,1799067236
9025,222531319,86751410,309282729,5,0,0,13312,11,7190753384
9026,222541311,87359585,309900896,2,0,0,276480,4,439054840
9027,222569770,86775725,309345495,6,0,0,512,7,7014411947
9028,222571380,86434667,309006047,1,0,0,1024,5,1309139480
9029,222586360,86264009,308850369,6,0,0,1024,7,1110667775
9030,222606550,130650704,353257254,7,0,1,15872,16,6739482087
9031,222649350,130607927,353257277,6,0,1,5120,7,2319738670
9032,222696750,87467701,310164451,3,0,0,120320,3,6055636249
9033,222719339,87368563,310087902,5,0,0,331264,11,6492366941
9034,222745011,87829112,310574123,2,0,0,652288,4,9352902387
9035,222754800,87024364,309779164,1,0,0,1536,5,10508740609
9036,222755710,86746396,309502106,6,0,0,2560,7,8551920472
9037,222779280,86807951,309587231,1,0,0,7680,5,3837567855
9038,222782940,86321829,309104769,1,0,0,5120,5,770211115
9039,222822980,86321643,309144623,1,0,0,4096,5,9548291166
9040,222828289,86730141,309558430,5,0,0,134656,11,169145333
9041,222836850,130420450,353257300,5,0,1,22528,11,9261852715
9042,222846359,87058624,309904983,8,0,0,512,2,7858955778
9043,222862259,87901629,310763888,8,0,0,611840,2,5904362003
9044,222879980,130377343,353257323,6,0,1,41984,7,2782264930
9045,222883170,130374176,353257346,6,0,1,17920,7,6181991013
9046,222910110,87189983,310100093,3,0,0,39936,3,3000616271
9047,222913910,130344661,353258571,6,0,1,47616,7,5885306765
9048,222932911,87850125,310783036,2,0,0,61952,4,10139115321
9049,223004690,130679591,353684281,3,0,1,175104,3,9513645327
9050,223041989,87202131,310244120,8,0,0,118272,2,570392224
9051,223061150,130623154,353684304,7,0,1,31744,16,3279602356
9052,223068360,130615967,353684327,3,0,1,55296,3,5189191954
9053,223084660,87211447,310296107,1,0,0,1536,5,8490908642
9054,223089840,130594510,353684350,6,0,1,27648,7,6494021947
9055,223099479,87196137,310295616,5,0,0,22016,11,10364231812
9056,223125051,87452394,310577445,2,0,0,4608,4,6416046139
9057,223131110,87444908,310576018,1,0,0,6144,5,2598755593
9058,223132720,130551653,353684373,6,0,1,2048,7,6476165239
9059,223133330,87630807,310764137,6,0,0,512,7,287712767
9060,223143770,130555937,353699707,6,0,1,11776,7,967382745
9061,223162590,130623899,353786489,6,0,1,11776,7,7104975852
9062,223200360,130586152,353786512,6,0,1,49152,7,632485472
9063,223208030,87833883,311041913,1,0,0,1536,5,5162330197
9064,223212690,130605748,353818438,5,0,1,41472,11,8609906446
9065,223273530,130628656,353902186,3,0,1,153088,3,5536155831
9066,223296940,130605269,353902209,3,0,1,35328,3,9598141912
9067,223334899,88157919,311492818,5,0,0,358912,11,6961551952
9068,223349550,130582011,353931561,3,0,1,40448,3,10490502648
9069,223371300,130566444,353937744,6,0,1,19456,7,8317388029
9070,223444050,88317217,311761267,3,0,0,91136,3,6840094143
9071,223483060,88010630,311493690,6,0,0,2560,7,5167344999
9072,223530109,88438885,311968994,5,0,0,478208,11,2535328339
9073,223543400,130398530,353941930,6,0,1,6656,7,8411368940
9074,223571319,88462181,312033500,8,0,0,100864,2,383785720
9075,223644940,130298168,353943108,3,0,1,13824,3,1490978494
9076,223651371,88145565,311796936,2,0,0,5632,4,10157539732
9077,223678629,88098308,311776937,8,0,0,13312,2,4068260816
9078,223719190,88076007,311795197,1,0,0,11264,5,9932370993
9079,223722509,88532109,312254618,5,0,0,275968,11,8124177102
9080,223735080,130352979,354088059,5,0,1,25088,11,1250178591
9081,223842121,88412832,312254953,2,0,0,1024,4,7215138187
9082,223878139,88540755,312418894,5,0,0,198144,11,9276452092
9083,223891659,130218910,354110569,0,0,1,33280,10,10095163052
9084,223895080,88416992,312312072,3,0,0,187392,3,813214808
9085,223904130,89056393,312960523,6,0,0,232960,7,7897847798
9086,223927700,88550191,312477891,6,0,0,25600,7,9189936231
9087,223942309,88809980,312752289,8,0,0,208384,2,10127509318
9088,223972380,89221753,313194133,6,0,0,287744,7,3883707250
9089,223975111,89310072,313285183,2,0,0,10752,4,6514857365
9090,224000059,88977023,312977082,8,0,0,54272,2,7582829021
9091,224009140,89237455,313246595,1,0,0,172032,5,518620876
9092,224023530,89696900,313720430,1,0,0,642560,5,8820464471
9093,224025010,89448215,313473225,6,0,0,64512,7,10524125119
9094,224070711,89256222,313326933,2,0,0,1024,4,9016974359
9095,224103469,89811007,313914476,8,0,0,478720,2,3048968693
9096,224115870,89289571,313405441,1,0,0,5120,5,5373808213
9097,224169990,89354637,313524627,3,0,0,89088,3,2783692321
9098,224184691,90159396,314344087,2,0,0,13312,4,841304439
9099,224188769,89951193,314139962,8,0,0,36864,2,3231432313
9100,224208379,90131598,314339977,8,0,0,656384,2,4877865750
9101,224289919,89625429,313915348,5,0,0,512,11,2843527919
9102,224312560,90216316,314528876,3,0,0,339968,3,4979147664
9103,224316971,90056526,314373497,2,0,0,1024,4,10722589337
9104,224318350,90374416,314692766,1,0,0,152064,5,3207011698
9105,224355120,129755472,354110592,5,0,1,23040,11,9863950054
9106,224358510,90203492,314562002,6,0,0,108544,7,8613432742
9107,224388651,89526518,313915169,2,0,0,2048,4,8938683063
9108,224468610,89956613,314425223,6,0,0,70656,7,4084061710
9109,224498880,129611735,354110615,5,0,1,1536,11,1443000612
9110,224510370,90207121,314717491,6,0,0,80896,7,10611016358
9111,224544510,90033317,314577827,1,0,0,51712,5,10138708005
9112,224575289,89773813,314349102,5,0,0,16384,11,8382461984
9113,224586850,90059062,314645912,6,0,0,222208,7,3501407403
9114,224656290,90079382,314735672,1,0,0,58880,5,10721350833
9115,224676101,89902061,314578162,2,0,0,1024,4,3101868255
9116,224699011,89947392,314646403,2,0,0,1536,4,825310846
9117,224726770,129383868,354110638,5,0,1,60416,11,6924047583
9118,224766000,90070172,314836172,1,0,0,35840,5,5129332890
9119,224774740,90230968,315005708,1,0,0,79360,5,4269783264
9120,224829120,129281541,354110661,8,0,1,3072,2,6265513603
9121,224835570,90346530,315182100,3,0,0,141824,3,5392597764
9122,224836560,129274124,354110684,8,0,1,6656,2,7704495260
9123,224841999,90094914,314936913,5,0,0,16384,11,4337220025
9124,224843190,90455621,315298811,6,0,0,382976,7,1593085257
9125,224861091,89856618,314717709,2,0,0,512,4,3652368198
9126,224917589,90414637,315332226,8,0,0,109568,2,7657978158
9127,224950829,129159894,354110723,1,0,1,40960,5,3255205609
9128,224955180,129155566,354110746,8,0,1,8704,2,6826948277
9129,225018151,130206488,355224639,9,0,1,907776,17,3509148531
9130,225087329,89723253,314810582,8,0,0,9728,2,3148782307
9131,225094980,90242729,315337709,6,0,0,17920,7,3246064440
9132,225117811,130176245,355294056,9,0,1,177664,17,7856297735
9133,225122670,90276915,315399585,1,0,0,128512,5,7388362178
9134,225153460,130141467,355294927,5,0,1,12288,11,4002752754
9135,225180900,90602413,315783313,6,0,0,222208,7,4663645767
9136,225203539,90506408,315709947,5,0,0,435200,11,3613086457
9137,225215039,90622487,315837526,5,0,0,159232,11,1472975607
9138,225268080,130048092,355316172,8,0,1,16384,2,10575333100
9139,225290860,130025773,355316633,7,0,1,10240,16,6050692698
9140,225390310,90122364,315512674,3,0,0,147456,3,7429536872
9141,225390460,129934188,355324648,6,0,1,6144,7,8375894557
9142,225393430,91305230,316698660,6,0,0,981504,7,47088198
9143,225423940,129932924,355356864,6,0,1,57344,7,2067736402
9144,225443251,90083515,315526766,2,0,0,1024,4,4254699957
9145,225445381,129927058,355372439,9,0,1,31744,17,4226877888
9146,225469569,90519405,315988974,8,0,0,173056,2,5162388140
9147,225481739,90233847,315715586,5,0,0,18432,11,8349561271
9148,225486171,129970185,355456356,9,0,1,144384,17,3887866614
9149,225510450,129948887,355459337,8,0,1,10240,2,8200605947
9150,225539250,91425692,316964942,6,0,0,278016,7,7770700595
9151,225545020,91335183,316880203,1,0,0,194048,5,7578730440
9152,225561880,90753090,316314970,3,0,0,49152,3,3643470877
9153,225568309,91187493,316755802,8,0,0,187392,2,3637260067
9154,225657409,91343132,317000541,8,0,0,116736,2,8310814921
9155,225663330,91359698,317023028,6,0,0,73728,7,388062386
9156,225669980,91151076,316821056,3,0,0,214016,3,3711757076
9157,225685500,129784375,355469875,6,0,1,17408,7,3027440493
9158,225685680,129791377,355477057,6,0,1,34304,7,6482428018
9159,225701370,91671340,317372710,6,0,0,692736,7,3815898112
9160,225753080,129767077,355520157,6,0,1,57344,7,3028845096
9161,225809120,129715512,355524632,2,0,1,3584,4,6486647445
9162,225809769,91235436,317045205,8,0,0,60416,2,2301670342
9163,225819099,91661320,317480419,8,0,0,353280,2,8574988103
9164,225823010,129705488,355528498,5,0,1,6144,11,1890488903
9165,225831420,91723902,317555322,3,0,0,245760,3,4036479988
9166,225863190,91715359,317578549,1,0,0,70656,5,3986478138
9167,225874751,91682216,317556967,2,0,0,5120,4,1498701617
9168,225898600,129632804,355531404,8,0,1,4608,2,2625939088
9169,225923910,92036084,317959994,6,0,0,278528,7,9759472107
9170,225925280,129626914,355552194,8,0,1,58880,2,2840671003
9171,225962720,129605179,355567899,5,0,1,2048,11,4438519357
9172,226003970,92191889,318195859,9,0,0,356352,17,2308721121
9173,226026400,92060860,318087260,6,0,0,204800,7,1443000405
9174,226059449,91950956,318010405,8,0,0,165376,2,5209855552
9175,226061940,129508865,355570805,8,0,1,4608,2,1099594652
9176,226077530,129494658,355572188,2,0,1,14848,4,7274623128
9177,226100899,92262187,318363086,5,0,0,338944,11,2798207871
9178,226143230,129444886,355588116,2,0,1,49664,4,1188382431
9179,226145030,129499418,355644448,8,0,1,31232,2,1426001195
9180,226164290,92580456,318744746,6,0,0,248832,7,3578062804
9181,226189090,92257787,318446877,3,0,0,41984,3,2685517841
9182,226244510,129399969,355644479,2,0,1,17920,4,4966793859
9183,226250870,91977181,318228051,3,0,0,43520,3,2332840449
9184,226313810,92679133,318992943,3,0,0,84992,3,9712305991
9185,226318649,92598511,318917160,5,0,0,260608,11,3065068259
9186,226344360,129300142,355644502,5,0,1,4608,11,10090829818
9187,226364200,91835738,318199938,6,0,0,13312,7,3405366066
9188,226405830,92554128,318959958,3,0,0,102912,3,1362696642
9189,226407929,92559095,318967024,8,0,0,20480,2,4932628986
9190,226419220,129225305,355644525,5,0,1,5632,11,5889859812
9191,226509850,129134698,355644548,8,0,1,11264,2,2649933225
9192,226530000,92863276,319393276,6,0,0,96256,7,5185722753
9193,226574289,92707777,319282066,8,0,0,721920,2,7228707996
9194,226592510,92072298,318664808,3,0,0,105472,3,3986358753
9195,226636420,92324341,318960761,6,0,0,2560,7,9304215357
9196,226664300,128981064,355645364,2,0,1,3072,4,9190554661
9197,226720169,92839580,319559749,8,0,0,202240,2,4842218960
9198,226745839,92091894,318837733,8,0,0,31232,2,9660383673
9199,226796520,128956479,355752999,5,0,1,40960,11,8526853952
9200,226867059,92061520,318928579,8,0,0,37376,2,10614384034
9201,226876260,92143550,319019810,3,0,0,27136,3,1729196200
9202,226901650,92448767,319350417,3,0,0,224256,3,9031915672
9203,226904540,129299260,356203800,5,0,1,11776,11,1341440074
9204,226921600,129303373,356224973,5,0,1,15872,11,9213707241
9205,226922950,129470685,356393635,2,0,1,51712,4,10693325681
9206,226967380,129557859,356525239,8,0,1,86016,2,5256719012
9207,226976970,93196521,320173491,1,0,0,93696,5,9280129131
9208,226996190,92367712,319363902,1,0,0,44032,5,149094504
9209,227007420,93568321,320575741,1,0,0,112128,5,10386375879
9210,227013740,129511522,356525262,5,0,1,10240,11,1413163740
9211,227015710,129509575,356525285,5,0,1,512,11,3483466243
9212,227019689,93039193,320058882,8,0,0,431616,2,10459689336
9213,227022600,129534228,356556828,2,0,1,50176,4,6928027936
9214,227026029,92835039,319861068,5,0,0,443904,11,1643172304
9215,227033370,129538653,356572023,5,0,1,42496,11,1315706563
9216,227035039,93431966,320467005,5,0,0,345088,11,2485962104
9217,227059760,92814903,319874663,1,0,0,44544,5,5036452351
9218,227067279,92999114,320066393,8,0,0,24576,2,2896950917
9219,227084610,129500539,356585149,5,0,1,19968,11,10145888927
9220,227140140,129445366,356585506,8,0,1,512,2,7648974262
9221,227177630,129415811,356593441,8,0,1,20992,2,3735268163
9222,227189170,93168884,320358054,6,0,0,317440,7,8147279307
9223,227219220,92992670,320211890,3,0,0,125952,3,539968078
9224,227244609,93116744,320361353,5,0,0,10752,11,10223883345
9225,227289510,129486904,356776414,8,0,1,14336,2,8494713422
9226,227334960,93638706,320973666,1,0,0,287744,5,6741266254
9227,227361679,93505081,320866760,5,0,0,334336,11,4170210188
9228,227382640,129393797,356776437,2,0,1,20480,4,5832791217
9229,227400650,129375810,356776460,2,0,1,1024,4,5713488816
9230,227401950,93249447,320651397,1,0,0,107008,5,4988316989
9231,227472870,129303613,356776483,5,0,1,31744,11,8483296710
9232,227489830,129286676,356776506,5,0,1,3584,11,2483934127
9233,227492020,129284509,356776529,2,0,1,32256,4,9678648798
9234,227579599,93511566,321091165,5,0,0,385536,11,5626606355
9235,227590720,93572617,321163337,1,0,0,104960,5,4499668377
9236,227605050,92936504,320541554,6,0,0,56320,7,9299999236
9237,227609000,129167552,356776552,8,0,1,10752,2,892403181
9238,227610770,93275201,320885971,3,0,0,62976,3,3910448809
9239,227613800,129162775,356776575,5,0,1,11264,11,1654832567
9240,227623720,129152878,356776598,8,0,1,12800,2,3206830396
9241,227684810,93446501,321131311,6,0,0,109056,7,6830712713
9242,227686860,129089761,356776621,5,0,1,5120,11,10307752002
9243,227689170,93408890,321098060,6,0,0,22528,7,6087947496
9244,227721369,94061600,321782969,5,0,0,238080,11,6303409739
9245,227744870,93505474,321250344,3,0,0,16384,3,3750816261
9246,227748170,129028474,356776644,5,0,1,3584,11,9336281202
9247,227765270,129011397,356776667,5,0,1,34816,11,3102456972
9248,227792630,94418192,322210822,1,0,0,281088,5,3676985625
9249,227896209,94517335,322413544,8,0,0,234496,2,4246008232
9250,227927940,128848750,356776690,2,0,1,11776,4,51833860
9251,227995280,128787696,356782976,2,0,1,14848,4,7740604896
9252,228029630,93780038,321809668,1,0,0,87552,5,5719390098
9253,228168710,128614289,356782999,5,0,1,7680,11,9661800074
9254,228267239,93246265,321513504,5,0,0,2048,11,2284643853
9255,228308800,93628172,321936972,3,0,0,187904,3,3959613301
9256,228372090,93658641,322030731,3,0,0,36352,3,5183019942
9257,228441939,93225534,321667473,5,0,0,36864,11,10095342632
9258,228449830,94127945,322577775,1,0,0,1536,5,2979781114
9259,228513420,93717237,322230657,1,0,0,65024,5,1161812940
9260,228519300,128263722,356783022,2,0,1,30720,4,10258843920
9261,228540409,93524041,322064450,8,0,0,110592,2,2286612457
9262,228543339,93476293,322019632,5,0,0,136704,11,3287272217
9263,228545260,128237785,356783045,2,0,1,45568,4,2207812986
9264,228569559,93548227,322117786,8,0,0,64512,2,3530952630
9265,228591630,128363149,356954779,5,0,1,23552,11,5015646139
9266,228596659,93823616,322420275,5,0,0,22016,11,9140582060
9267,228652350,93924934,322577284,1,0,0,157696,5,10706547250
9268,228683470,93627330,322310800,1,0,0,142336,5,3294688046
9269,228727220,94064444,322791664,1,0,0,189952,5,6866337954
9270,228738770,94348682,323087452,6,0,0,391168,7,4301485152
9271,228750959,94362755,323113714,5,0,0,86016,11,9191021419
9272,228751429,94536485,323287914,5,0,0,159232,11,10414731327
9273,228814050,128603422,357417472,5,0,1,32768,11,898587476
9274,228980990,93987247,322968237,1,0,0,173056,5,1689293885
9275,229001390,93792949,322794339,6,0,0,8704,7,3279251802
9276,229006160,128411335,357417495,5,0,1,1536,11,4387916141
9277,229081329,93834157,322915486,8,0,0,55808,2,3508598384
9278,229090959,128326559,357417518,0,0,1,10752,10,6180127144
9279,229215810,94199625,323415435,1,0,0,201216,5,2702202974
9280,229281470,94440749,323722219,3,0,0,227840,3,3958599737
9281,229296510,93942842,323239352,3,0,0,68608,3,1564721227
9282,229379640,128037925,357417565,5,0,1,26624,11,3534173034
9283,229454070,128039556,357493626,5,0,1,28160,11,9659053947
9284,229473110,128155994,357629104,5,0,1,512,11,4085846644
9285,229489150,94026191,323515341,3,0,0,3072,3,1724511334
9286,229496080,128173029,357669109,5,0,1,51712,11,6105368675
9287,229602800,128120955,357723755,5,0,1,24576,11,7583935448
9288,229614011,128139430,357753441,9,0,1,38912,17,7333404697
9289,229672580,94207634,323880214,1,0,0,238080,5,5562357086
9290,229677139,94114702,323791841,8,0,0,4096,2,4746480014
9291,229710600,94079970,323790570,1,0,0,224256,5,7401210905
9292,229730830,93891193,323622023,1,0,0,31232,5,9510131378
9293,229768211,128049790,357818001,9,0,1,52736,17,7559840742
9294,229768440,94272336,324040776,6,0,0,177152,7,6316360877
9295,229779810,94027841,323807651,6,0,0,37888,7,1909973266
9296,229793140,94139092,323932232,6,0,0,46080,7,10441242656
9297,229856520,94061641,323918161,1,0,0,124416,5,4089900020
9298,229905379,93890697,323796076,5,0,0,13824,11,7709179018
9299,229910560,127907464,357818024,5,0,1,10240,11,8616351623
9300,230006209,94208155,324214364,5,0,0,155648,11,1824092197
9301,230040809,94402496,324443305,5,0,0,211968,11,8056320330
9302,230076830,94301868,324378698,6,0,0,144384,7,2373467375
9303,230154140,127738537,357892677,5,0,1,58368,11,3585152502
9304,230159370,127733330,357892700,5,0,1,1536,11,4057788235
9305,230188520,127704203,357892723,6,0,1,18944,7,9971486985
9306,230206799,127731557,357938356,1,0,1,138752,5,4427679944
9307,230256670,94267277,324523947,6,0,0,41472,7,680238169
9308,230276790,94002303,324279093,3,0,0,20480,3,6955481013
9309,230277120,94312994,324590114,1,0,0,217088,5,3083437936
9310,230279530,94231758,324511288,3,0,0,81408,3,7478340648
9311,230280449,128378207,358658656,1,0,1,299008,5,8855708515
9312,230385279,94364285,324749564,5,0,0,17408,11,6955679904
9313,230402259,94196318,324598577,5,0,0,27648,11,9403537199
9314,230425690,128232997,358658687,6,0,1,36864,7,454734299
9315,230456300,128202418,358658718,6,0,1,22528,7,9675079001
9316,230468509,128190232,358658741,4,0,1,6656,2,5201348058
9317,230472881,128287675,358760556,9,0,1,228352,17,5324808776
9318,230475650,94425471,324901121,1,0,0,135168,5,6529258658
9319,230509319,128344801,358854120,1,0,1,151040,5,8028681853
9320,230513800,94495716,325009516,1,0,0,80384,5,2929074922
9321,230535220,128330334,358865554,6,0,1,25600,7,728765084
9322,230615901,128315759,358931660,9,0,1,172032,17,4468725149
9323,230657430,94691665,325349095,6,0,0,305152,7,5841743418
9324,230693990,128260756,358954746,2,0,1,19968,4,7823048035
9325,230730770,94310281,325041051,6,0,0,103424,7,5879448334
9326,230774150,94389122,325163272,6,0,0,88064,7,9482259918
9327,230790300,128168415,358958715,2,0,1,18944,4,1256941859
9328,230794270,128166839,358961109,7,0,1,14336,16,1320050953
9329,230807790,94145134,324952924,1,0,0,512,5,8931285212
9330,230816170,94764368,325580538,6,0,0,98304,7,8727253368
9331,230854560,94639971,325494531,1,0,0,140800,5,3466584169
9332,230859420,95145284,326004704,6,0,0,442368,7,6523655387
9333,230871720,128091655,358963375,7,0,1,3584,16,7854946827
9334,230907960,128101110,359009070,5,0,1,20480,11,7060914423
9335,230919130,128243878,359163008,2,0,1,83968,4,6457510682
9336,230945059,128277682,359222741,1,0,1,75264,5,3333509421
9337,230971290,128257455,359228745,2,0,1,20480,4,11844021
9338,231024881,128450360,359475241,9,0,1,159232,17,2236543752
9339,231025000,128450264,359475264,2,0,1,7168,4,629543421
9340,231029609,94984010,326013619,5,0,0,29184,11,4369879698
9341,231034720,128440567,359475287,2,0,1,3072,4,4789489165
9342,231052280,128423030,359475310,6,0,1,512,7,196984858
9343,231070070,128405263,359475333,7,0,1,2048,16,2745875024
9344,231072900,95215525,326288425,6,0,0,290304,7,4379458748
9345,231078210,128423377,359501587,7,0,1,13824,16,3242020934
9346,231137189,128562556,359699745,1,0,1,371712,5,955634002
9347,231146170,128574563,359720733,7,0,1,5632,16,4303000954
9348,231187410,95353903,326541313,1,0,0,264192,5,4064542738
9349,231209050,95098430,326307480,6,0,0,62464,7,2194262894
9350,231229270,128491822,359721092,7,0,1,9728,16,5230948778
9351,231247900,128495082,359742982,6,0,1,14848,7,9670279401
9352,231298520,95336485,326635005,3,0,0,69120,3,1028744335
9353,231315150,95531324,326846474,1,0,0,62976,5,2355977628
9354,231345240,128398728,359743968,6,0,1,1536,7,2641951955
9355,231354010,95737401,327091411,6,0,0,217088,7,10731993555
9356,231366350,95634364,327000714,3,0,0,65536,3,5245254229
9357,231374471,128427659,359802130,9,0,1,67584,17,6422321593
9358,231417539,128631222,360048761,1,0,1,192000,5,9222621377
9359,231425090,95684139,327109229,6,0,0,30720,7,4976388457
9360,231515270,95710949,327226219,3,0,0,16384,3,1878812232
9361,231524291,128915843,360440134,9,0,1,442368,17,6948802740
9362,231542950,128907135,360450085,2,0,1,17920,4,2029562741
9363,231599700,128864430,360464130,6,0,1,9728,7,4697824776
9364,231636890,95889773,327526663,6,0,0,116224,7,190124715
9365,231637250,128857271,360494521,2,0,1,45568,4,3226266951
9366,231657280,128848942,360506222,7,0,1,39424,16,4836984945
9367,231669509,129071117,360740626,1,0,1,338432,5,4880776140
9368,231670011,129149958,360819969,9,0,1,18944,17,2247603466
9369,231670949,129282789,360953738,1,0,1,100864,5,7808571248
9370,231718020,129238528,360956548,2,0,1,512,4,4267627578
9371,231725470,129371629,361097099,6,0,1,48640,7,8640252362
9372,231786291,129361430,361147721,9,0,1,66560,17,5562154650
9373,231808119,96540479,328348598,5,0,0,69632,11,307795523
9374,231817090,129330654,361147744,2,0,1,50176,4,4791563249
9375,231833511,129344284,361177795,9,0,1,20992,17,6459662582
9376,231857179,96744598,328601777,5,0,0,105472,11,4313081603
9377,231857889,96661423,328519312,5,0,0,1536,11,3079448394
9378,231908120,129275064,361183184,6,0,1,17408,7,7559759303
9379,231908810,129313535,361222345,6,0,1,23552,7,7022788759
9380,231961690,129288349,361250039,6,0,1,23552,7,2044705857
9381,232016580,129253992,361270572,2,0,1,27648,4,3735700190
9382,232020010,96994656,329014666,3,0,0,11264,3,7050957115
9383,232021039,96745744,328766783,5,0,0,24064,11,7581363921
9384,232022379,129643025,361665404,1,0,1,280064,5,737876680
9385,232057010,129964953,362021963,3,0,1,382976,3,2367419092
9386,232065490,129956496,362021986,2,0,1,1536,4,5017112064
9387,232090920,129931089,362022009,2,0,1,512,4,4870753875
9388,232092090,129929942,362022032,7,0,1,6656,16,1390857777
9389,232105320,96875573,328980893,6,0,0,124928,7,7220737710
9390,232108559,96902621,329011180,5,0,0,99328,11,5554701627
9391,232133770,97050050,329183820,3,0,0,79360,3,305072976
9392,232137739,129884316,362022055,1,0,1,6656,5,7809003552
9393,232139800,129882278,362022078,2,0,1,11264,4,6290615164
9394,232227900,129794201,362022101,2,0,1,28160,4,1744370625
9395,232286220,129781798,362068018,6,0,1,62464,7,7986190242
9396,232303661,129860845,362164506,9,0,1,31744,17,326609977
9397,232332300,129884719,362217019,2,0,1,18432,4,2999892395
9398,232379160,97001504,329380664,3,0,0,150016,3,9390374638
9399,232392770,129824915,362217685,7,0,1,11264,16,10617790249
9400,232411789,97021444,329433233,5,0,0,101376,11,1644110072
9401,232444191,129797716,362241907,9,0,1,49152,17,5398176932
9402,232524450,129760868,362285318,2,0,1,22528,4,9958996280
9403,232527561,129786038,362313599,9,0,1,23040,17,6322714175
9404,232596141,129762370,362358511,9,0,1,1536,17,8551756259
9405,232602820,129756037,362358857,2,0,1,512,4,250210140
9406,232625090,96585830,329210920,3,0,0,7168,3,9897006150
9407,232643991,129715532,362359523,9,0,1,1024,17,141689871
9408,232648560,96816661,329465221,3,0,0,4608,3,1412310820
9409,232660911,129725642,362386553,9,0,1,21504,17,10010727644
9410,232680351,130280861,362961212,9,0,1,22528,17,2786702593
9411,232686259,130458357,363144616,1,0,1,35328,5,7191705616
9412,232722820,130421819,363144639,7,0,1,512,16,5330891483
9413,232728620,130416042,363144662,7,0,1,10240,16,6854812497
9414,232790529,130367143,363157672,1,0,1,17408,5,4821251776
9415,232792900,97253089,330045989,6,0,0,10240,7,5170130743
9416,232794110,97248713,330042823,6,0,0,289280,7,1472933923
9417,232831009,97298012,330129021,5,0,0,235520,11,8146841110
9418,232835280,130325298,363160578,2,0,1,4608,4,6855723381
9419,232856490,130306674,363163164,2,0,1,4096,4,3280045200
9420,232861720,130318438,363180158,7,0,1,23552,16,433892384
9421,232865930,97050435,329916365,3,0,0,3072,3,6770473930
9422,232900950,130281474,363182424,2,0,1,3584,4,2690525608
9423,232921940,97022615,329944555,3,0,0,11776,3,3660068828
9424,232980200,96964534,329944734,3,0,0,512,3,45955608
9425,233028230,97241083,330269313,6,0,0,17408,7,6290803799
9426,233028940,130155750,363184690,7,0,1,3584,16,2881314003
9427,233053340,130274620,363327960,2,0,1,81920,4,5436652724
9428,233091550,130585735,363677285,7,0,1,9728,16,4039731496
9429,233129619,97317747,330447366,8,0,0,52224,2,9602614214
9430,233212669,131127921,364340590,1,0,1,589312,5,9595034018
9431,233213401,97025600,330239001,2,0,0,1024,4,2489266884
9432,233213921,131144553,364358474,9,0,1,11776,17,4642971368
9433,233241060,97564519,330805579,1,0,0,64512,5,5629513153
9434,233286721,131121822,364408543,9,0,1,31744,17,1095599910
9435,233340809,131233228,364574037,1,0,1,258560,5,7535545923
9436,233346310,97389408,330735718,1,0,0,147456,5,7179782080
9437,233364860,97084097,330448957,3,0,0,5120,3,6175054751
9438,233377959,131504308,364882267,1,0,1,392704,5,1083898546
9439,233403320,131478970,364882290,2,0,1,5632,4,6745088440
9440,233406100,131476221,364882321,6,0,1,26624,7,471505827
9441,233414510,131477237,364891747,2,0,1,90112,4,9036104019
9442,233433919,131462014,364895933,1,0,1,6656,5,10597640373
9443,233546340,97460184,331006524,1,0,0,74240,5,986375089
9444,233558610,97488963,331047573,3,0,0,9728,3,9494408830
9445,233611580,131290152,364901732,7,0,1,19456,16,1903423175
9446,233642360,97865625,331507985,1,0,0,40960,5,7534266978
9447,233645590,98181387,331826977,1,0,0,69632,5,9568510841
9448,233687480,97722248,331409728,3,0,0,2560,3,9329147197
9449,233743741,131160053,364903794,9,0,1,14848,17,6131108547
9450,233811750,97727518,331539268,3,0,0,24064,3,6737867962
9451,233872800,131033580,364906380,6,0,1,4096,7,5291410606
9452,233918520,98193064,332111584,6,0,0,354304,7,10457216069
9453,233922400,97811510,331733910,6,0,0,173056,7,1801613976
9454,233924401,131018633,364943034,9,0,1,59904,17,3343610327
9455,233939070,97797515,331736585,3,0,0,8704,3,9591063966
9456,233986460,97767152,331753612,3,0,0,55808,3,8731637767
9457,234005499,130938521,364944020,4,0,1,1536,2,7221214621
9458,234009160,130941952,364951112,6,0,1,11264,7,7530919922
9459,234017350,130939561,364956911,7,0,1,19456,16,7911330101
9460,234045650,130917073,364962723,6,0,1,9216,7,4708455919
9461,234045800,97877097,331922897,1,0,0,33280,5,693679507
9462,234114540,97850907,331965447,1,0,0,37888,5,3253900497
9463,234125880,97334853,331460733,1,0,0,512,5,1549377112
9464,234126209,130840060,364966269,1,0,1,5632,5,6770756427
9465,234179259,130791516,364970775,1,0,1,7168,5,7148746344
9466,234183171,130796233,364979404,9,0,1,33792,17,8795423829
9467,234225939,130753721,364979660,4,0,1,9216,2,9938489680
9468,234231879,130747935,364979814,1,0,1,8704,5,10275474137
9469,234234310,130746477,364980787,2,0,1,12800,4,2754405120
9470,234235020,130746439,364981459,6,0,1,18432,7,225803886
9471,234238810,130777725,365016535,2,0,1,34816,4,8134528929
9472,234238899,130784552,365023451,1,0,1,27648,5,4991733515
9473,234256540,130767577,365024117,2,0,1,1024,4,2650275743
9474,234275210,130752479,365027689,7,0,1,5632,16,6238318579
9475,234299091,130738903,365037994,9,0,1,34816,17,8034957542
9476,234328189,130712711,365040900,1,0,1,4608,5,2790097894
9477,234331250,98066909,332398159,3,0,0,49152,3,6248706926
9478,234333479,130713105,365046584,1,0,1,20992,5,4479601840
9479,234369619,130678271,365047890,4,0,1,2048,2,1978508614
9480,234386129,130662427,365048556,1,0,1,1024,5,2968774883
9481,234408029,130646121,365054150,1,0,1,18432,5,3365320105
9482,234416630,130664862,365081492,6,0,1,47104,7,877972989
9483,234443830,130685423,365129253,2,0,1,20480,4,5606949790
9484,234454520,130674756,365129276,7,0,1,9728,16,3485629672
9485,234487340,130641959,365129299,6,0,1,5120,7,8436948173
9486,234498310,130631012,365129322,2,0,1,9216,4,5251989898
9487,234509190,98205131,332714321,6,0,0,12800,7,5871073208
9488,234552639,130576706,365129345,1,0,1,42496,5,7278856381
9489,234570030,130574079,365144109,2,0,1,31744,4,5913268697
9490,234580740,98841603,333422343,6,0,0,312832,7,1881394608
9491,234589170,130572845,365162015,2,0,1,6144,4,9107477120
9492,234594090,98732914,333327004,1,0,0,232960,5,799344265
9493,234596800,98447527,333044327,6,0,0,118784,7,644080719
9494,234667220,130500530,365167750,2,0,1,26112,4,6205200203
9495,234685680,98759618,333445298,1,0,0,75264,5,897927304
9496,234715329,130453727,365169056,4,0,1,2048,2,10513670767
9497,234717750,130457155,365174905,2,0,1,512,4,3162005258
9498,234733611,130503226,365236837,9,0,1,70144,17,2490471963
9499,234740101,130505555,365245656,9,0,1,37888,17,4409556364
9500,234758630,131906984,366665614,7,0,1,14848,16,1988918151
9501,234761159,132026391,366787550,1,0,1,40448,5,6931571162
9502,234767361,132020212,366787573,9,0,1,39936,17,7990094023
9503,234788681,132066998,366855679,9,0,1,512,17,2627704085
9504,234798191,132063389,366861580,9,0,1,19968,17,9899821163
9505,234818221,132046648,366864869,9,0,1,4608,17,2529974056
9506,234837650,98694707,333532357,3,0,0,230400,3,6180166688
9507,234889260,132004969,366894229,7,0,1,15872,16,3699277530
9508,234894969,99257932,334152901,5,0,0,57344,11,1962221958
9509,234936269,132083355,367019624,4,0,1,38400,2,2073491029
9510,234943099,132076548,367019647,4,0,1,12800,2,6017927545
9511,234977619,132168745,367146364,4,0,1,43008,2,7593188819
9512,235040951,132230751,367271702,9,0,1,13824,17,5619073770
9513,235045840,98948542,333994382,1,0,0,50176,5,4269484550
9514,235046920,132224805,367271725,2,0,1,512,4,1440041887
9515,235077530,99057876,334135406,3,0,0,411648,3,2879979721
9516,235134009,132137739,367271748,4,0,1,23040,2,9363341420
9517,235199170,132240286,367439456,7,0,1,59904,16,10408721229
9518,235230420,98937020,334167440,1,0,0,47616,5,2711790791
9519,235236310,99091007,334327317,1,0,0,234496,5,6780643544
9520,235266260,132173219,367439479,2,0,1,27648,4,3631114097
9521,235274480,99445696,334720176,3,0,0,72704,3,4252309494
9522,235290799,132148703,367439502,4,0,1,8192,2,10600525946
9523,235308370,99232162,334540532,3,0,0,54272,3,1785956402
9524,235327940,99688053,335015993,6,0,0,247296,7,4617468688
9525,235330380,100012242,335342622,6,0,0,146432,7,7591440320
9526,235385070,99907292,335292362,3,0,0,438784,3,8381882084
9527,235418930,132020595,367439525,2,0,1,12288,4,9161147064
9528,235436660,132008059,367444719,7,0,1,5632,16,10665033825
9529,235461679,131983063,367444742,4,0,1,7168,2,5081975340
9530,235482119,131962646,367444765,4,0,1,8192,2,964874167
9531,235491381,131953407,367444788,9,0,1,512,17,3710930675
9532,235582859,131861952,367444811,4,0,1,1536,2,7105062856
9533,235735410,99423237,335158647,3,0,0,211456,3,1904508875
9534,235739040,99938064,335677104,3,0,0,199168,3,10018150807
9535,235748929,131760044,367508973,4,0,1,26112,2,2926068939
9536,235771230,131737766,367508996,2,0,1,3584,4,7937959672
9537,235771320,99673140,335444460,6,0,0,172032,7,2552875359
9538,235802971,131792706,367595677,9,0,1,46080,17,8703537023
9539,235805741,131832258,367637999,9,0,1,10240,17,6670627945
9540,235825070,100066165,335891235,6,0,0,269824,7,451730735
9541,235842059,131818918,367660977,4,0,1,23040,2,8619400395
9542,235910299,131849628,367759927,4,0,1,7168,2,7634022173
9543,235947990,99779094,335727084,1,0,0,34816,5,713753880
9544,235951190,99545513,335496703,1,0,0,131072,5,2299214997
9545,236195170,99839830,336035000,3,0,0,49664,3,687891422
9546,236234040,99382357,335616397,3,0,0,295936,3,5348850761
9547,236401909,131358041,367759950,0,0,1,30208,10,9047122559
9548,236422030,99282551,335704581,1,0,0,72704,5,7335470781
9549,236438999,131320974,367759973,0,0,1,16384,10,1990389762
9550,236441230,99458631,335899861,6,0,0,28160,7,8364312592
9551,236446770,99573075,336019845,3,0,0,141312,3,5380579032
9552,236465420,99491493,335956913,6,0,0,1024,7,6936200412
9553,236500180,131259816,367759996,5,0,1,1536,11,9585658238
9554,236590320,99524213,336114533,6,0,0,40448,7,2897425702
9555,236608000,99306548,335914548,3,0,0,48128,3,4001434282
9556,236645200,99456986,336102186,1,0,0,53248,5,7827231516
9557,236721789,131038230,367760019,0,0,1,24576,10,1242340373
9558,236769310,99859667,336628977,1,0,0,201216,5,422330284
9559,236796169,130967960,367764129,0,0,1,35328,10,7125841421
9560,236829679,131330858,368160537,0,0,1,133120,10,1203592361
9561,236971960,131189243,368161203,2,0,1,11264,4,775119045
9562,236988710,99923918,336912628,3,0,0,321536,3,550680031
9563,237026360,131174257,368200617,2,0,1,2560,4,10659609952
9564,237029470,99927329,336956799,3,0,0,144896,3,1454075628
9565,237047419,131214909,368262328,0,0,1,41472,10,6941423705
9566,237068900,100018290,337087190,1,0,0,266752,5,8248536615
9567,237072480,100246095,337318575,1,0,0,237056,5,2171710410
9568,237094270,99092856,336187126,1,0,0,34816,5,1519601501
9569,237097940,99907920,337005860,3,0,0,123392,3,6044099677
9570,237141280,100024261,337165541,6,0,0,257024,7,4002809787
9571,237154410,100091860,337246270,1,0,0,142848,5,703042004
9572,237159050,100217228,337376278,6,0,0,69632,7,7444057773
9573,237164950,99803260,336968210,3,0,0,37376,3,2474788787
9574,237220400,131042594,368262994,5,0,1,1024,11,10215311879
9575,237231760,100259123,337490883,1,0,0,251392,5,1250935798
9576,237276530,131057239,368333769,8,0,1,23040,2,7631490478
9577,237343160,99859563,337202723,1,0,0,121856,5,10665366025
9578,237352290,131078533,368430823,5,0,1,1536,11,8285089844
9579,237375250,99979789,337355039,3,0,0,119296,3,3336154696
9580,237392310,131648701,369041011,5,0,1,52224,11,1839171245
9581,237405439,132813951,370219390,0,0,1,47104,10,2366276219
9582,237451160,100100213,337551373,3,0,0,134656,3,674982744
9583,237461530,132757883,370219413,8,0,1,14336,2,5994733562
9584,237465300,133431003,370896303,7,0,1,30208,16,367334425
9585,237507230,133400869,370908099,8,0,1,4608,2,4065480947
9586,237562480,100232452,337794932,6,0,0,123392,7,2730248234
9587,237574400,133750730,371325130,6,0,1,60416,7,7294131781
9588,237618620,99996667,337615287,6,0,0,37376,7,6850951384
9589,237644140,133707079,371351219,2,0,1,35840,4,153831746
9590,237656460,133893445,371549905,5,0,1,69632,11,559651516
9591,237658800,133894651,371553451,6,0,1,5632,7,8368389195
9592,237686589,133878371,371564960,0,0,1,14336,10,4294241831
9593,237717350,133866255,371583605,6,0,1,18944,7,3949262652
9594,237731310,100662923,338394233,3,0,0,927232,3,6433271449
9595,237732950,133854097,371587047,5,0,1,5120,11,9088816424
9596,237739110,133912280,371651390,6,0,1,14848,7,424600175
9597,237792120,100626940,338419060,1,0,0,81408,5,6292435972
9598,237795450,133900849,371696299,5,0,1,12288,11,2601844467
9599,237818189,133878456,371696645,0,0,1,512,10,2106629138
9600,237827209,134160470,371987679,0,0,1,39936,10,9530414840
9601,237869429,134118273,371987702,0,0,1,5632,10,1061602759
9602,237870179,134117546,371987725,0,0,1,2048,10,4714459529
9603,237912979,134074769,371987748,0,0,1,18432,10,2383113928
9604,237917560,100795014,338712574,3,0,0,57344,3,5075178441
9605,237941850,100837293,338779143,3,0,0,23040,3,6961672956
9606,237957241,134518776,372476017,9,0,1,73728,17,6064120492
9607,237974129,134571705,372545834,0,0,1,17408,10,8863939155
9608,237982640,134638908,372621548,5,0,1,38912,11,71127613
9609,237999499,135266112,373265611,4,0,1,42496,2,4609517852
9610,238005679,135390573,373396252,4,0,1,21504,2,1271701913
9611,238063240,135333035,373396275,2,0,1,16896,4,1079891796
9612,238122520,135339720,373462240,2,0,1,5120,4,10736583394
9613,238201949,135319705,373521654,4,0,1,5120,2,1819872678
9614,238235170,135286507,373521677,5,0,1,512,11,7484269153
9615,238236759,135284941,373521700,0,0,1,11264,10,6423698041
9616,238275499,135433314,373708813,0,0,1,55296,10,4674593598
9617,238293530,101100775,339394305,6,0,0,414208,7,5836776478
9618,238300129,135408707,373708836,1,0,1,26112,5,5185707775
9619,238335500,135587594,373923094,2,0,1,24064,4,203186464
9620,238342510,135580607,373923117,5,0,1,12288,11,10180242905
9621,238397490,135677172,374074662,2,0,1,17920,4,1351941401
9622,238440069,135634632,374074701,0,0,1,1024,10,9972414734
9623,238444690,135630034,374074724,2,0,1,4608,4,1025901407
9624,238490360,101511761,340002121,6,0,0,300032,7,10697166219
9625,238511420,101299640,339811060,6,0,0,28160,7,2844724345
9626,238517550,101524836,340042386,6,0,0,25600,7,2703391582
9627,238519020,135555727,374074747,2,0,1,12288,4,4231754133
9628,238589559,135538164,374127723,4,0,1,40448,2,643614651
9629,238676380,135451382,374127762,2,0,1,37888,4,42236168
9630,238691369,135479223,374170592,4,0,1,1024,2,7724990698
9631,238740790,101564240,340305030,1,0,0,75776,5,1298716604
9632,238766359,135464833,374231192,0,0,1,31232,10,7479538004
9633,238797670,101721337,340519007,3,0,0,88064,3,5998049958
9634,238859370,101836858,340696228,1,0,0,133632,5,8224779069
9635,238872329,135536675,374409004,0,0,1,69120,10,8979696227
9636,238920319,135488708,374409027,1,0,1,7168,5,6306158799
9637,238941019,135468031,374409050,4,0,1,10240,2,342309243
9638,238987490,101805368,340792858,6,0,0,28160,7,4330486115
9639,238994899,135414174,374409073,0,0,1,26624,10,4036942272
9640,239030610,102054657,341085267,6,0,0,152576,7,1478856848
9641,239055009,135590899,374645908,1,0,1,81920,5,315084666
9642,239073739,135572192,374645931,0,0,1,31744,10,663062133
9643,239110100,102283595,341393695,6,0,0,77312,7,10329612863
9644,239122250,103298148,342420398,3,0,0,483328,3,8443992761
9645,239204469,135467271,374671740,0,0,1,19968,10,3430503256
9646,239267460,102743152,342010612,6,0,0,529920,7,8482417621
9647,239430940,102646885,342077825,3,0,0,86016,3,4187680367
9648,239456080,102795982,342252062,1,0,0,92160,5,8067049855
9649,239466340,102382789,341849129,6,0,0,45056,7,3127247643
9650,239548160,103127834,342675994,1,0,0,308224,5,2624846624
9651,239579590,102940561,342520151,3,0,0,167424,3,5164015430
9652,239597110,102871983,342469093,6,0,0,159744,7,5754534547
9653,239622639,135049303,374671942,1,0,1,1536,5,4738674027
9654,239644959,135027006,374671965,0,0,1,3072,10,10149831384
9655,239662759,135009229,374671988,0,0,1,512,10,6634358735
9656,239710170,102845416,342555586,1,0,0,116224,5,218299715
9657,239724449,134947562,374672011,0,0,1,9728,10,3980350298
9658,239727209,134966087,374693296,1,0,1,25088,5,6044568542
9659,239776180,102971620,342747800,3,0,0,235520,3,7958411300
9660,239793579,134899748,374693327,1,0,1,20480,5,7198295965
9661,239822150,102735081,342557231,6,0,0,5120,7,6070692247
9662,239836950,103037370,342874320,6,0,0,80896,7,673779453
9663,239849480,103572032,343421512,6,0,0,407552,7,5166120927
9664,239885469,134808216,374693685,0,0,1,9216,10,6292711619
9665,239945169,134748539,374693708,4,0,1,5120,2,9735408723
9666,239985149,134708582,374693731,0,0,1,10752,10,1069824305
9667,240019220,103489573,343508793,6,0,0,76288,7,371217376
9668,240027980,134665774,374693754,7,0,1,3072,16,8482423059
9669,240052649,134656426,374709075,1,0,1,46080,5,10660433026
9670,240068310,103025139,343093449,6,0,0,86016,7,4192085267
9671,240095689,134613642,374709331,0,0,1,9216,10,10235448525
9672,240165430,103097376,343262806,1,0,0,107520,5,5491593193
9673,240175930,103359406,343535336,6,0,0,87040,7,8463630087
9674,240248099,134480267,374728366,1,0,1,18944,5,1461699
9675,240274910,103210585,343485495,1,0,0,209920,5,2452848140
9676,240309409,134466787,374776196,1,0,1,10240,5,5706795117
9677,240336230,103546910,343883140,1,0,0,491520,5,1367427762
9678,240458109,134318110,374776219,1,0,1,6144,5,3245519980
9679,240513669,134262573,374776242,1,0,1,8192,5,1736665726
9680,240514290,134261975,374776265,5,0,1,14336,11,4126457334
9681,240526529,134249759,374776288,1,0,1,8704,5,6950594668
9682,240579590,103311217,343890807,6,0,0,25088,7,6994791793
9683,240623780,103382883,344006663,6,0,0,22016,7,8438471384
9684,240759089,134157512,374916601,1,0,1,83456,5,2006752076
9685,240790890,103191331,343982221,3,0,0,11264,3,9011032584
9686,240808430,103170336,343978766,6,0,0,123904,7,7056106282
9687,240818259,134103194,374921453,0,0,1,7680,10,10008666383
9688,240849359,134075320,374924679,1,0,1,5120,5,9390096221
9689,240863859,134254772,375118631,1,0,1,38912,5,530643662
9690,240895959,134273424,375169383,1,0,1,64512,5,5771319201
9691,240896650,103160605,344057255,1,0,0,11264,5,5132141661
9692,240908450,103470115,344378565,3,0,0,227840,3,5088548078
9693,240963810,103433205,344397015,1,0,0,60416,5,2995909444
9694,241008930,103201884,344210814,6,0,0,2048,7,4044798072
9695,241050970,103381012,344431982,1,0,0,46080,5,641967765
9696,241100639,134072360,375172999,1,0,1,24576,5,8408430215
9697,241160829,134036373,375197202,1,0,1,3072,5,7058482428
9698,241165240,103448963,344614203,1,0,0,260096,5,2818847920
9699,241200770,103860653,345061423,1,0,0,272384,5,9066369848
9700,241237009,133960216,375197225,1,0,1,1536,5,2229327005
9701,241259949,133937299,375197248,4,0,1,4096,2,5948530772
9702,241288480,103689928,344978408,6,0,0,147456,7,1610260566
9703,241376249,133821453,375197702,4,0,1,3072,2,4024034478
9704,241400429,133819188,375219617,4,0,1,53248,2,3399861031
9705,241424850,103422155,344847005,3,0,0,4096,3,9255550475
9706,241496900,103632174,345129074,1,0,0,27648,5,2261894689
9707,241525110,103795928,345321038,3,0,0,164864,3,4878341807
9708,241567799,133653124,375220923,1,0,1,2048,5,2054355019
9709,241675130,103832123,345507253,6,0,0,209920,7,2914064793
9710,241697570,104037380,345734950,3,0,0,4608,3,1805953980
9711,241781720,104324862,346106582,6,0,0,166400,7,6597596122
9712,241897459,133324335,375221794,1,0,1,12288,5,4776001759
9713,242054680,103630223,345684903,6,0,0,44032,7,8822157057
9714,242091499,133202640,375294139,4,0,1,16384,2,2132792824
9715,242131969,133162193,375294162,4,0,1,22016,2,2124931914
9716,242132069,133275155,375407224,4,0,1,99328,2,5039762084
9717,242234730,104840514,347075244,1,0,0,652800,5,6266125953
9718,242243130,104584739,346827869,6,0,0,739328,7,5163739733
9719,242289970,103438093,345728063,6,0,0,37888,7,412060045
9720,242305969,133103201,375409170,4,0,1,3072,2,6476138333
9721,242331339,133082337,375413676,1,0,1,7168,5,629937847
9722,242412500,133003122,375415622,8,0,1,3072,2,3291090848
9723,242424140,103694352,346118492,1,0,0,12800,5,6778691139
9724,242490499,133792843,376283342,4,0,1,48128,2,4495574154
9725,242508540,103957910,346466450,6,0,0,95744,7,3667440405
9726,242508780,103907024,346415804,6,0,0,90624,7,8147458474
9727,242536210,133747155,376283365,8,0,1,11264,2,7325061263
9728,242540010,104336242,346876252,6,0,0,158720,7,10363790179
9729,242586080,133942116,376528196,8,0,1,77312,2,5967656847
9730,242692710,134173005,376865715,8,0,1,26624,2,9732974964
9731,242839789,134063732,376903521,4,0,1,13824,2,5003791780
9732,242862489,134068846,376931335,1,0,1,5120,5,8457750078
9733,242869420,134061938,376931358,3,0,1,25600,3,738407209
9734,242874980,134073935,376948915,8,0,1,41984,2,7611873853
9735,242883230,134168993,377052223,3,0,1,97792,3,8152283178
9736,242893830,134166625,377060455,7,0,1,32768,16,10514661948
9737,242897480,135113737,378011217,3,0,1,114688,3,6822012865
9738,242906630,135297303,378203933,6,0,1,38912,7,7452406457
9739,242913610,135570176,378483786,7,0,1,79872,16,9626091398
9740,242952410,135531399,378483809,8,0,1,16896,2,2207886198
9741,242964130,104713445,347677575,3,0,0,133632,3,8390442373
9742,242972440,104373602,347346042,3,0,0,11264,3,4798531919
9743,242996950,135494705,378491655,6,0,1,15872,7,4421058324
9744,243007619,135484059,378491678,1,0,1,25600,5,4020174608
9745,243010770,104947577,347958347,6,0,0,66048,7,1695846791
9746,243016960,104808110,347825070,3,0,0,154624,3,9796345031
9747,243044940,104561905,347606845,6,0,0,154112,7,6785090905
9748,243053240,135552520,378605760,8,0,1,4096,2,7042710452
9749,243068800,104781409,347850209,3,0,0,82432,3,10509593347
9750,243168589,135437194,378605783,1,0,1,13824,5,5640132898
9751,243248219,135357611,378605830,1,0,1,3584,5,961971177
9752,243261860,135425396,378687256,6,0,1,53248,7,5255390881
9753,243292459,135449564,378742023,1,0,1,8192,5,1364176116
9754,243306920,135435769,378742689,6,0,1,11264,7,7059417991
9755,243352390,135936283,379288673,8,0,1,29184,2,813219801
9756,243390410,136370537,379760947,8,0,1,27136,2,3340129271
9757,243400950,136360020,379760970,6,0,1,18944,7,882912094
9758,243407630,136353363,379760993,8,0,1,8192,2,4541401154
9759,243416170,104748905,348165075,6,0,0,110080,7,8156475514
9760,243456059,136543059,379999118,1,0,1,52224,5,2642939807
9761,243470929,136528212,379999141,1,0,1,9728,5,8864561676
9762,243487339,136511825,379999164,1,0,1,1536,5,1312779961
9763,243523580,136497805,380021385,6,0,1,31744,7,1892321853
9764,243525520,104912340,348437860,1,0,0,103424,5,8101478354
9765,243559970,104846355,348406325,3,0,0,91136,3,9618615824
9766,243570139,136451269,380021408,0,0,1,4608,10,4439977903
9767,243587929,136433502,380021431,1,0,1,2048,5,5387206403
9768,243591010,105184513,348775523,1,0,0,367104,5,244834852
9769,243634370,105029278,348663648,3,0,0,90112,3,5270149928
9770,243643009,136378445,380021454,1,0,1,2048,5,2801488534
9771,243667680,136353797,380021477,8,0,1,6144,2,3705315119
9772,243688830,105325810,349014640,1,0,0,445952,5,6485177241
9773,243734160,136287348,380021508,8,0,1,8192,2,5592386166
9774,243794420,136356793,380151213,2,0,1,46080,4,5422469264
9775,243811109,136340127,380151236,1,0,1,10240,5,2448633091
9776,243824060,105200431,349024491,6,0,0,32256,7,6654953443
9777,243866429,136289845,380156274,1,0,1,16896,5,6444695816
9778,243868910,136287387,380156297,2,0,1,33280,4,6377261123
9779,243904470,105121916,349026386,3,0,0,6144,3,3093746138
9780,243919930,105179656,349099586,6,0,0,129536,7,5551569640
9781,243934870,136221450,380156320,2,0,1,39424,4,6468079466
9782,243971710,105912161,349883871,3,0,0,464384,3,4275364781
9783,244005900,105896870,349902770,6,0,0,61952,7,7368921168
9784,244048610,105569921,349618531,1,0,0,41472,5,2392501869
9785,244048630,136107713,380156343,8,0,1,32256,2,2408988543
9786,244065890,136090476,380156366,2,0,1,2048,4,9456765962
9787,244079780,136223006,380302786,2,0,1,38912,4,7655603247
9788,244082710,136220099,380302809,8,0,1,3584,2,5739649989
9789,244127530,105532118,349659648,6,0,0,67072,7,5426044171
9790,244245500,105300343,349545843,6,0,0,53248,7,8774210468
9791,244281149,136021683,380302832,1,0,1,7680,5,10368502637
9792,244292239,136010616,380302855,1,0,1,11264,5,10440295018
9793,244323020,105615231,349938251,3,0,0,115712,3,1832507651
9794,244339030,105156377,349495407,6,0,0,8704,7,5498059939
9795,244339120,136006416,380345536,5,0,1,34816,11,6186983627
9796,244340559,136014547,380355106,1,0,1,23040,5,1660639648
9797,244421850,135933279,380355129,8,0,1,1536,2,10471760395
9798,244441370,135913782,380355152,2,0,1,6144,4,34658661
9799,244447120,135908055,380355175,2,0,1,23552,4,2743463714
9800,244484200,135870998,380355198,2,0,1,30208,4,3698404350
9801,244517970,105384979,349902949,3,0,0,512,3,3386303745
9802,244637900,135717321,380355221,8,0,1,7680,2,2187030565
9803,244643750,135711494,380355244,8,0,1,26624,2,4111704168
9804,244644990,135780734,380425724,2,0,1,132096,4,1540095178
9805,244652820,135797465,380450285,2,0,1,64000,4,9151787345
9806,244655940,135794368,380450308,2,0,1,512,4,5869265534
9807,244671409,135778922,380450331,0,0,1,11264,10,6015047891
9808,244743650,105257711,350001361,3,0,0,57344,3,7527137732
9809,244772459,135677895,380450354,1,0,1,13312,5,9501648372
9810,244800649,135649728,380450377,0,0,1,1024,10,796259750
9811,244819680,105263201,350082881,6,0,0,3584,7,467860773
9812,244822050,135630169,380452219,8,0,1,44544,2,2883964051
9813,244826249,135625993,380452242,1,0,1,4608,5,8946359179
9814,244890100,105765292,350655392,6,0,0,66560,7,7192514432
9815,244899790,135592895,380492685,2,0,1,50688,4,4363864771
9816,244967410,135538192,380505602,8,0,1,23552,2,6976051366
9817,245069229,135437653,380506882,1,0,1,14336,5,2728495530
9818,245134490,105100123,350234613,1,0,0,35328,5,5198574609
9819,245138289,135499730,380638019,1,0,1,45568,5,596547538
9820,245199179,135439967,380639146,1,0,1,21504,5,187481096
9821,245206550,105346191,350552741,6,0,0,252928,7,1135877587
9822,245216280,135448177,380664457,8,0,1,26112,2,6487324894
9823,245231840,135454186,380686026,2,0,1,7680,4,7719351496
9824,245231940,135456032,380687972,2,0,1,3072,4,7468496408
9825,245255960,105018160,350274120,1,0,0,84480,5,3839057169
9826,245275940,135418395,380694335,2,0,1,30208,4,4616107261
9827,245303509,135488898,380792407,0,0,1,5632,10,2530459371
9828,245316510,135493126,380809636,2,0,1,7168,4,1013675076
9829,245323299,135486360,380809659,1,0,1,3072,5,577776378
9830,245378530,135493973,380872503,8,0,1,35328,2,1159622783
9831,245404960,105400668,350805628,1,0,0,121856,5,4279800810
9832,245411840,105145292,350557132,1,0,0,14336,5,9139946028
9833,245477770,135394756,380872526,8,0,1,18944,2,5889380368
9834,245525950,135347714,380873664,8,0,1,28160,2,10728827232
9835,245562390,135812654,381375044,2,0,1,262656,4,1394282800
9836,245594499,135851179,381445678,1,0,1,24064,5,9163639752
9837,245612790,105499037,351111827,1,0,0,471040,5,698224497
9838,245653290,105483878,351137168,1,0,0,82944,5,5474769245
9839,245670539,135796662,381467201,4,0,1,3072,2,2350420839
9840,245711150,136124864,381836014,8,0,1,18432,2,7574773814
9841,245716629,136119408,381836037,1,0,1,8704,5,5185180410
9842,245770050,104989769,350759819,1,0,0,119808,5,5518700237
9843,245796829,136230695,382027524,4,0,1,87040,2,3752435882
9844,245994490,136188305,382182795,3,0,1,128512,3,10727028409
9845,245998680,136194723,382193403,5,0,1,24064,11,7010651775
9846,246000640,136254547,382255187,3,0,1,32256,3,3650507016
9847,246002900,136602478,382605378,3,0,1,429568,3,6010934663
9848,246010870,136594531,382605401,2,0,1,4608,4,85913056
9849,246036939,136568485,382605424,4,0,1,16384,2,6973105218
9850,246104900,104791325,350896225,1,0,0,102400,5,4281367378
9851,246113810,136491637,382605447,8,0,1,2048,2,4630655817
9852,246118370,136553423,382671793,3,0,1,6144,3,6640379572
9853,246145880,136525936,382671816,6,0,1,2048,7,37052073
9854,246200199,136471640,382671839,4,0,1,10752,2,5968681748
9855,246254660,136417234,382671894,8,0,1,32768,2,2489551019
9856,246378650,136300250,382678900,3,0,1,66048,3,1611685878
9857,246411849,136719313,383131162,4,0,1,45568,2,2265676999
9858,246427490,104755166,351182656,1,0,0,148992,5,8000859044
9859,246436570,136699098,383135668,8,0,1,7168,2,10319902978
9860,246517300,136919228,383436528,8,0,1,23552,2,4492496406
9861,246535719,136900832,383436551,4,0,1,17920,2,400193259
9862,246562970,136873604,383436574,8,0,1,13824,2,4033531824
9863,246666060,104586193,351252253,1,0,0,138752,5,9002833178
9864,246692420,137436258,384128678,3,0,1,653312,3,3613641535
9865,246696849,137462281,384159130,4,0,1,28160,2,2900558409
9866,246714180,137447856,384162036,5,0,1,4608,11,1281888608
9867,246810889,137405849,384216738,4,0,1,1024,2,3034239499
9868,246834959,137381802,384216761,4,0,1,3584,2,625027044
9869,246840269,137376515,384216784,4,0,1,38912,2,4367068288
9870,246857729,137535911,384393640,4,0,1,45056,2,7903481193
9871,246866350,137527313,384393663,7,0,1,26112,16,7844847844
9872,246902390,137491296,384393686,8,0,1,24576,2,5605430578
9873,246914980,137478729,384393709,8,0,1,512,2,4646455963
9874,246966099,137439980,384406079,4,0,1,38400,2,5307619928
9875,247022070,104604486,351626556,1,0,0,239104,5,9242177729
9876,247047980,104632166,351680146,6,0,0,30720,7,1726495260
9877,247208860,104244899,351453759,1,0,0,69632,5,3870925318
9878,247263330,137179996,384443326,8,0,1,25600,2,1016443674
9879,247272150,137182819,384454969,7,0,1,10240,16,5402303028
9880,247273089,137342203,384615292,4,0,1,29696,2,9327750281
9881,247321349,137293966,384615315,4,0,1,41984,2,9344976194
9882,247340700,104786879,352127579,1,0,0,135680,5,5240413280
9883,247360139,137255199,384615338,4,0,1,6144,2,9516881434
9884,247471590,105112145,352583735,1,0,0,47616,5,569671259
9885,247479890,137335838,384815728,8,0,1,19456,2,8750044992
9886,247492930,137427116,384920046,8,0,1,51200,2,6724540519
9887,247590350,137345149,384935499,8,0,1,2560,2,5276449849
9888,247690519,137246494,384937013,4,0,1,5632,2,3563476958
9889,247751960,104084739,351836699,1,0,0,92160,5,5230272049
9890,247792231,137198028,384990259,9,0,1,48640,17,4228010107
9891,247848721,137188967,385037688,9,0,1,33792,17,5432685690
9892,247855040,103906400,351761440,1,0,0,113152,5,7920802713
9893,247896060,104522252,352418312,1,0,0,300544,5,5099880230
9894,247901299,137384332,385285631,4,0,1,54784,2,6862990620
9895,247946021,137339633,385285654,9,0,1,5120,17,4475621594
9896,247958969,137326708,385285677,4,0,1,512,2,4131379913
9897,247964850,103919296,351884146,6,0,0,155648,7,1544037826
9898,247976020,137309680,385285700,8,0,1,6144,2,8516212382
9899,247986850,104245428,352232278,1,0,0,343552,5,8369743213
9900,248021251,137264472,385285723,9,0,1,53760,17,4687924587
9901,248062740,137223006,385285746,8,0,1,10240,2,10092865128
9902,248121670,137164099,385285769,8,0,1,14336,2,9988565251
9903,248140971,137144821,385285792,9,0,1,7168,17,5244462046
9904,248207471,137078344,385285815,9,0,1,5120,17,4175320818
9905,248210530,137075308,385285838,6,0,1,23552,7,9581327531
9906,248247910,137037951,385285861,8,0,1,15872,2,4894985775
9907,248256430,137075873,385332303,7,0,1,12288,16,474218900
9908,248276139,137056187,385332326,4,0,1,20992,2,2426575697
9909,248298060,137073308,385371368,7,0,1,7680,16,8004708642
9910,248337929,137178742,385516671,4,0,1,34816,2,8500716812
9911,248401311,137115383,385516694,9,0,1,4096,17,6476521219
9912,248404310,104116609,352520919,6,0,0,51200,7,6293579137
9913,248429341,137087376,385516717,9,0,1,8192,17,3572869693
9914,248431331,137085409,385516740,9,0,1,52224,17,5975215899
9915,248458820,103852417,352311237,9,0,0,259072,17,6190535288
9916,248469900,105214358,353684258,6,0,0,1055744,7,766715557
9917,248476969,137039794,385516763,4,0,1,24576,2,10558019785
9918,248488950,137053363,385542313,5,0,1,9216,11,2100220792
9919,248537760,104406288,352944048,6,0,0,65536,7,4983077607
9920,248544290,104416343,352960633,1,0,0,16896,5,9093579571
9921,248603629,136954341,385557970,4,0,1,20992,2,2919119335
9922,248609220,104647988,353257208,9,0,0,410112,17,10068030449
9923,248626149,136932807,385558956,4,0,1,1536,2,7608257525
9924,248664950,104254575,352919525,9,0,0,437760,17,4146046005
9925,248666070,105120396,353786466,1,0,0,284672,5,6046996363
9926,248695070,136870299,385565369,5,0,1,22528,11,6867583921
9927,248732110,105086249,353818359,9,0,0,104448,17,5775831013
9928,248755750,105087359,353843109,6,0,0,80896,7,3523491691
9929,248768610,136806634,385575244,5,0,1,18944,11,8052099691
9930,248771350,137780671,386552021,2,0,1,542208,4,1097224182
9931,248777939,137874668,386652607,4,0,1,53760,2,10541071232
9932,248789760,138349809,387139569,2,0,1,522752,4,8628690362
9933,248803340,105062880,353866220,9,0,0,75776,17,4656413662
9934,248840140,104859544,353699684,1,0,0,50176,5,5419788840
9935,248862400,138277192,387139592,5,0,1,14848,11,6621656871
9936,248937950,138490411,387428361,2,0,1,653824,4,5638055419
9937,248970599,138469141,387439740,4,0,1,2560,2,3116744335
9938,249024850,138596900,387621750,2,0,1,451584,4,163198575
9939,249026449,138613261,387639710,4,0,1,53760,2,7723403065
9940,249048931,138594005,387642936,9,0,1,17408,17,9931453216
9941,249106079,138592612,387698691,4,0,1,90112,2,4718418969
9942,249162730,104739409,353902139,6,0,0,117760,7,9724184867
9943,249184871,138517686,387702557,9,0,1,6144,17,7768510060
9944,249189199,138525953,387715152,4,0,1,17920,2,9006722050
9945,249206760,104881276,354088036,1,0,0,458752,5,1610655156
9946,249222141,138493997,387716138,9,0,1,1536,17,5305207221
9947,249224781,138494059,387718840,9,0,1,15872,17,4941723588
9948,249246840,104863706,354110546,6,0,0,73728,7,3643785150
9949,249247720,138471376,387719096,5,0,1,9216,11,3863248809
9950,249326391,138399530,387725921,9,0,1,19456,17,1533054243
9951,249346811,138381696,387728507,9,0,1,4096,17,8254059701
9952,249367249,138372224,387739473,4,0,1,35328,2,2653171098
9953,249383429,138361843,387745272,4,0,1,19456,2,5570395346
9954,249425019,138337713,387762732,4,0,1,41472,2,8388073796
9955,249451580,104459388,353910968,9,0,0,28672,17,24539520
9956,249483979,138284552,387768531,4,0,1,19456,2,10061316176
9957,249521389,138252624,387774013,4,0,1,15360,2,8254124883
9958,249549790,104993045,354542835,9,0,0,232448,17,9721493855
9959,249586331,138189400,387775731,9,0,1,9728,17,2130836778
9960,249608920,138171957,387780877,6,0,1,8192,7,4956148538
9961,249611560,138173227,387784787,6,0,1,1536,7,6309936397
9962,249656020,138130073,387786093,5,0,1,2048,11,6341320782
9963,249672910,138119494,387792404,6,0,1,22016,7,8303944172
9964,249774290,138020060,387794350,6,0,1,3072,7,5182494217
9965,249779280,104513834,354293114,9,0,0,14848,17,6323406345
9966,249790500,138004836,387795336,6,0,1,1536,7,8999319788
9967,249800950,104559769,354360719,6,0,0,183296,7,8882721668
9968,249875370,104585358,354460728,6,0,0,108544,7,6669625427
9969,249923550,104504083,354427633,9,0,0,85504,17,10729182738
9970,249927310,137872212,387799522,5,0,1,6656,11,5823074117
9971,250063801,137736707,387800508,9,0,1,1536,17,7267995651
9972,250064920,137735934,387800854,5,0,1,512,11,6768885492
9973,250101201,137703199,387804400,9,0,1,5632,17,2591642526
9974,250118780,104597189,354715969,6,0,0,328192,7,3497843244
9975,250221171,137590961,387812132,9,0,1,12288,17,4291751988
9976,250232650,104349676,354582326,6,0,0,129536,7,4358386442
9977,250251110,137561368,387812478,5,0,1,512,11,2828747663
9978,250293990,137526448,387820438,5,0,1,15360,11,7318992322
9979,250457630,104281762,354739392,1,0,0,76800,5,3594360778
9980,250538779,137288879,387827658,4,0,1,20992,2,4154666138
9981,250554199,137284424,387838623,4,0,1,24064,2,8410846464
9982,250562441,137293269,387855710,9,0,1,14336,17,4258341858
9983,250574760,104376451,354951211,9,0,0,347648,17,3340402512
9984,250586151,137274385,387860536,9,0,1,7680,17,6193884165
9985,250609030,104743630,355352660,6,0,0,61952,7,10062164111
9986,250614520,137246477,387860997,5,0,1,10240,11,6222575438
9987,250638520,137253597,387892117,5,0,1,76800,11,8428512810
9988,250686210,104538406,355224616,7,0,0,206848,16,8752041400
9989,250707170,104937255,355644425,9,0,0,175104,17,2235263137
9990,250764881,137143248,387908129,9,0,1,25088,17,7286641337
9991,250789299,137134614,387923913,4,0,1,37376,2,2155607516
9992,250790791,137156866,387947657,9,0,1,42496,17,4625245943
9993,250800449,137150265,387950714,4,0,1,13824,2,10481916902
9994,250807669,137190916,387998585,4,0,1,57856,2,689126319
9995,250819710,104916593,355736303,9,0,0,173056,17,10228876118
9996,250864941,137139456,388004397,9,0,1,9216,17,5233047247
9997,250936160,105190827,356126987,1,0,0,470016,5,5157817270
9998,250940231,137066752,388006983,9,0,1,4096,17,7325667879
9999,250942241,137203697,388145938,9,0,1,88064,17,3113910797
10000,251002961,137144501,388147462,9,0,1,14336,17,4125027197
10001,251021489,137183094,388204583,4,0,1,14336,2,10249436368
10002,251088310,105374943,356463253,1,0,0,188928,5,10229933723
10003,251102901,137102352,388205253,9,0,1,4096,17,8497886455
10004,251155059,137079494,388234553,4,0,1,13824,2,7550800940
10005,251213580,104928094,356141674,9,0,0,48128,17,4328508810
10006,251238210,105066947,356305157,6,0,0,253440,7,4883276358
10007,251342960,104835879,356178839,6,0,0,28160,7,7386267161
10008,251348560,136981297,388329857,3,0,1,44032,3,4562794595
10009,251433509,136936130,388369639,4,0,1,8192,2,2131047318
10010,251479660,137449249,388928909,6,0,1,52224,7,9700624983
10011,251482780,137506701,388989481,2,0,1,109056,4,813070137
10012,251494160,137703782,389197942,2,0,1,120832,4,10546719047
10013,251541140,137656825,389197965,5,0,1,1024,11,5530315300
10014,251655619,137542369,389197988,0,0,1,6656,10,7972772877
10015,251702240,104822968,356525208,6,0,0,203264,7,1431654208
10016,251708710,104635686,356344396,6,0,0,70656,7,7302281450
10017,251746270,105030121,356776391,1,0,0,577024,5,10575855204
10018,251788640,137607701,389396341,2,0,1,126464,4,9887451627
10019,251799290,137725843,389525133,2,0,1,71168,4,4738662250
10020,251801130,137735749,389536879,2,0,1,46592,4,1323645627
10021,251840860,138356886,390197746,2,0,1,325632,4,9379989517
10022,251881840,104705877,356587717,1,0,0,1024,5,670352267
10023,251920939,138279255,390200194,4,0,1,3072,2,8479602796
10024,252060910,138631851,390692761,2,0,1,368640,4,3106914220
10025,252075070,138617714,390692784,5,0,1,8192,11,2418627242
10026,252085151,138607656,390692807,9,0,1,9728,17,1738503149
10027,252098981,138593857,390692838,9,0,1,11264,17,4895938239
10028,252142330,138550531,390692861,5,0,1,14336,11,9709434383
10029,252148730,104634223,356782953,9,0,0,20480,17,3148596978
10030,252182080,138510804,390692884,2,0,1,12288,4,889554018
10031,252196730,105129796,357326526,9,0,0,450048,17,10617514255
10032,252300100,138400006,390700106,5,0,1,13312,11,8219475545
10033,252334600,105039123,357373723,1,0,0,3072,5,10161475691
10034,252353540,104537942,356891482,1,0,0,4608,5,10261949250
10035,252392500,138307637,390700137,5,0,1,5120,11,5964696075
10036,252410820,105006629,357417449,9,0,0,76288,17,248435909
10037,252475430,105153651,357629081,6,0,0,413696,7,6792976983
10038,252508270,104937898,357446168,9,0,0,6656,17,8282598233
10039,252511870,105211862,357723732,6,0,0,179200,7,7559697782
10040,252556490,104816258,357372748,9,0,0,150016,17,3985403648
10041,252632150,104390636,357022786,6,0,0,18432,7,7285973735
10042,252639850,104687167,357327017,1,0,0,1536,5,5718490743
10043,252653480,105219635,357873115,9,0,0,180736,17,3946029194
10044,252702860,104926579,357629439,1,0,0,1024,5,10524306187
10045,252758830,137941330,390700160,5,0,1,19456,11,2792950628
10046,252759280,105058682,357817962,9,0,0,150016,17,535172469
10047,252793660,104600522,357394182,6,0,0,67072,7,9872619831
10048,252810370,104960730,357771100,6,0,0,57856,7,6293384089
10049,252870020,104883398,357753418,9,0,0,97280,17,1064808753
10050,253038140,137662043,390700183,7,0,1,1024,16,5027030507
10051,253040280,137659926,390700206,5,0,1,512,11,2793645791
10052,253074900,137625329,390700229,5,0,1,43008,11,4479007357
10053,253115300,137584952,390700252,5,0,1,38912,11,7030401712
10054,253160900,104508186,357669086,6,0,0,130048,7,3375683214
10055,253171800,104330343,357502143,1,0,0,512,5,9584883619
10056,253175650,137565676,390741326,5,0,1,18432,11,1600257942
10057,253182430,137558919,390741349,7,0,1,10240,16,4748219751
10058,253183980,137561723,390745703,5,0,1,72192,11,7497157513
10059,253185301,137577919,390763220,9,0,1,27648,17,2245248499
10060,253327309,137436884,390764193,4,0,1,12800,2,8977243229
10061,253329590,137440300,390769890,7,0,1,18944,16,2536839152
10062,253330500,137440324,390770824,7,0,1,10752,16,8985174846
10063,253339200,137442799,390781999,7,0,1,18944,16,6856633940
10064,253345150,137510838,390855988,7,0,1,17408,16,6302738502
10065,253397691,137641814,391039505,9,0,1,123904,17,3853273812
10066,253431391,137897989,391329380,9,0,1,24576,17,4937344361
10067,253538941,137793180,391332121,9,0,1,1536,17,6203260858
10068,253552350,137780117,391332467,7,0,1,512,16,5730496489
10069,253564240,137897023,391461263,7,0,1,26112,16,5952972385
10070,253568400,104324238,357892638,9,0,0,64000,17,9148330674
10071,253578110,104360223,357938333,6,0,0,97280,7,5861291331
10072,253644910,104127305,357772215,1,0,0,3584,5,4792976458
10073,253654141,137820527,391474668,9,0,1,14336,17,4277465974
10074,253730471,137867701,391598172,9,0,1,17920,17,1602726394
10075,253772300,137866002,391638302,7,0,1,4608,16,8773204764
10076,253780950,104298448,358079398,6,0,0,3584,7,7929580148
10077,253788720,104175472,357964192,1,0,0,512,5,7492597069
10078,253789650,104471542,358261192,6,0,0,210944,7,5466749065
10079,253831371,137808404,391639775,9,0,1,1024,17,7675764166
10080,253841450,104751742,358593192,3,0,0,460288,3,3821286029
10081,253860561,137795758,391656319,9,0,1,36352,17,8184354748
10082,253863020,137872322,391735342,8,0,1,15872,2,12944908
10083,253888770,137846595,391735365,7,0,1,3072,16,8890724125
10084,253889260,104459972,358349232,3,0,0,59904,3,9993552681
10085,254020200,104018127,358038327,9,0,0,10752,17,4006586025
10086,254027790,137733932,391761722,5,0,1,16896,11,9522813242
10087,254071390,137763818,391835208,6,0,1,9216,7,5661149673
10088,254127640,137733276,391860916,8,0,1,11776,2,2673979237
10089,254236090,104397248,358633338,6,0,0,116224,7,6893046021
10090,254267610,103994853,358262463,1,0,0,4096,5,8504590742
10091,254314980,137628844,391943824,7,0,1,40448,16,9752820652
10092,254331190,104083024,358414214,0,0,0,124416,10,10098512314
10093,254331320,104121605,358452925,3,0,0,126976,3,4683908546
10094,254332410,137677152,392009562,5,0,1,15872,11,5828191274
10095,254345770,137693213,392038983,8,0,1,12288,2,7458582953
10096,254383960,104274673,358658633,6,0,0,82944,7,1049086792
10097,254476990,137562147,392039137,5,0,1,8704,11,2703361368
10098,254542870,137508897,392051767,7,0,1,3584,16,73232705
10099,254580050,137481928,392061978,6,0,1,8704,7,9413795604
10100,254583640,104176893,358760533,6,0,0,76800,7,7686353434
10101,254589070,104008833,358597903,9,0,0,15360,17,2400839470
10102,254598411,137489881,392088292,9,0,1,12800,17,5112204360
10103,254602340,104166507,358768847,6,0,0,27136,7,807779968
10104,254639460,137756687,392396147,5,0,1,37888,11,2401317199
10105,254640710,137821159,392461869,5,0,1,18432,11,9960675702
10106,254654280,137962320,392616600,7,0,1,1024,16,4511760933
10107,254654510,104618043,359272553,0,0,0,19968,10,1867183685
10108,254657130,138310163,392967293,7,0,1,71680,16,7185521762
10109,254659820,104815398,359475218,6,0,0,461824,7,1980084045
10110,254668670,104832894,359501564,9,0,0,86016,17,5404965948
10111,254684360,104179919,358864279,1,0,0,5120,5,10582013490
10112,254705040,138262276,392967316,6,0,1,41984,7,1592421729
10113,254706180,138283841,392990021,5,0,1,70144,11,7832417777
10114,254721880,104323537,359045417,6,0,0,25088,7,1666683766
10115,254758780,138231272,392990052,7,0,1,3584,16,2560613424
10116,254781060,104767373,359548433,6,0,0,103424,7,4951420530
10117,254783760,104423891,359207651,0,0,0,9728,10,3696998712
10118,254815740,138387289,393203029,3,0,1,100352,3,1723831849
10119,254818400,138384652,393203052,7,0,1,45568,16,10680041604
10120,254827830,105168568,359996398,9,0,0,11264,17,9428238991
10121,254830390,138490995,393321385,5,0,1,67072,11,6272454162
10122,254933899,138387509,393321408,4,0,1,30208,2,344943383
10123,254935150,104242584,359177734,0,0,0,4096,10,3562085036
10124,254975920,104540978,359516898,6,0,0,50176,7,3812588409
10125,255018870,138302561,393321431,5,0,1,4096,11,1307749977
10126,255085710,104488697,359574407,6,0,0,72704,7,315865042
10127,255089420,104462780,359552200,3,0,0,12288,3,10080647199
10128,255111690,138262233,393373923,5,0,1,12288,11,9650748645
10129,255152240,104500839,359653079,1,0,0,2048,5,8408747659
10130,255169900,105049254,360219154,0,0,0,239616,10,3148368592
10131,255183039,138193470,393376509,4,0,1,4096,2,9936043987
10132,255185469,138191296,393376765,0,0,1,9216,10,409344811
10133,255214370,105080848,360295218,3,0,0,117248,3,3053035290
10134,255302010,104777988,360079998,6,0,0,25600,7,2785383207
10135,255331270,138076949,393408219,8,0,1,17408,2,2293172503
10136,255344100,104521580,359865680,3,0,0,108032,3,5986603386
10137,255360560,138097107,393457667,5,0,1,47616,11,7252566376
10138,255372020,105216368,360588388,6,0,0,260096,7,2270433139
10139,255385890,138129528,393515418,8,0,1,6656,2,3337169404
10140,255407839,138107602,393515441,4,0,1,7680,2,9592626966
10141,255429510,138085954,393515464,8,0,1,29184,2,7791812847
10142,255431229,138084258,393515487,4,0,1,21504,2,4288207791
10143,255440640,104867962,360308602,0,0,0,6656,10,7762399650
10144,255465340,138147093,393612433,8,0,1,55808,2,6882765227
10145,255474690,104526874,360001564,0,0,0,6656,10,9874828640
10146,255481540,104776036,360257576,3,0,0,29696,3,3642860337
10147,255481840,138130616,393612456,8,0,1,3072,2,1130903062
10148,255488310,104771161,360259471,1,0,0,6144,5,8086256454
10149,255512360,104736145,360248505,0,0,0,96256,10,8563982372
10150,255515820,104569635,360085455,1,0,0,2560,5,8047017671
10151,255548089,105081841,360629930,5,0,0,126464,11,4509696065
10152,255589120,138023538,393612658,8,0,1,8704,2,2894878837
10153,255593790,104834627,360428417,9,0,0,147968,17,5692519185
10154,255609300,138003381,393612681,5,0,1,9216,11,3482594585
10155,255629069,137983635,393612704,4,0,1,8704,2,5770017770
10156,255736590,104695282,360431872,9,0,0,11264,17,3079073020
10157,255749819,137979463,393729282,4,0,1,15872,2,5690602093
10158,255797389,137931916,393729305,4,0,1,5120,2,2379397269
10159,255897440,137831888,393729328,8,0,1,9728,2,5253004634
10160,255954250,104696459,360650709,6,0,0,68096,7,7580834067
10161,255974190,104617185,360591375,1,0,0,9728,5,3355436686
10162,256013750,104668658,360682408,3,0,0,103936,3,5763542585
10163,256013920,105072791,361086711,6,0,0,391680,7,66472270
10164,256058710,137670641,393729351,5,0,1,27648,11,3150053658
10165,256068670,137811624,393880294,2,0,1,218624,4,8279875213
10166,256080320,105006570,361086890,1,0,0,512,5,65993501
10167,256097559,137919643,394017202,4,0,1,29184,2,1691208967
10168,256121610,137936693,394058303,8,0,1,6656,2,8437841159
10169,256144020,105003646,361147666,0,0,0,165888,10,1621226194
10170,256164459,138036063,394200522,0,0,1,33280,10,10159326866
10171,256174900,104736668,360911568,1,0,0,11264,5,7553532641
10172,256184200,138032845,394217045,8,0,1,7168,2,6391673101
10173,256214960,104873669,361088629,1,0,0,5632,5,8064353113
10174,256219430,105002892,361222322,3,0,0,108032,3,6460581137
10175,256265580,104831496,361097076,0,0,0,27648,10,871043970
10176,256280049,137942142,394222191,0,0,1,8192,10,3543246356
10177,256284669,137975054,394259723,0,0,1,40960,10,9860170702
10178,256291970,105173469,361465439,3,0,0,348160,3,6690053252
10179,256292109,138316453,394608562,4,0,1,40448,2,5029725822
10180,256364709,138243876,394608585,0,0,1,2048,10,9388171445
10181,256411090,105087240,361498330,0,0,0,7168,10,3956129043
10182,256435449,138173159,394608608,0,0,1,13312,10,2592611195
10183,256437000,138171631,394608631,8,0,1,3584,2,362178724
10184,256524979,138083675,394608654,0,0,1,3584,10,5710770264
10185,256554469,138054208,394608677,0,0,1,2560,10,10159547906
10186,256618819,137989881,394608700,0,0,1,15872,10,2042701918
10187,256721770,105027701,361749471,6,0,0,141312,7,5212643874
10188,256753429,137855294,394608723,0,0,1,15360,10,4229591233
10189,256794030,105202147,361996177,6,0,0,455680,7,2624315648
10190,256848100,137761785,394609885,8,0,1,38400,2,617355777
10191,256883280,104932501,361815781,0,0,0,73216,10,6701558614
10192,256884649,137777565,394662214,0,0,1,46080,10,9121626799
10193,256914519,137747718,394662237,0,0,1,8192,10,2248851038
10194,256923940,105535927,362459867,3,0,0,99840,3,7302082773
10195,256947610,137716077,394663687,5,0,1,10752,11,9430064473
10196,256956660,105065280,362021940,3,0,0,84480,3,9259277007
10197,256970830,105057378,362028208,9,0,0,19968,17,10632473522
10198,257013690,105767303,362780993,9,0,0,441856,17,5276908021
10199,257032290,137631420,394663710,5,0,1,4608,11,305870202
10200,257102009,137561724,394663733,0,0,1,13312,10,3304919730
10201,257129580,106013742,363143322,9,0,0,431104,17,5468718338
10202,257178079,137485677,394663756,0,0,1,2560,10,1052888681
10203,257269090,105040675,362309765,3,0,0,1536,3,1416387367
10204,257295570,105615413,362910983,0,0,0,312832,10,1245009428
10205,257342910,105228691,362571601,1,0,0,512,5,10383911401
10206,257390929,137314245,394705174,0,0,1,60928,10,8184218282
10207,257411990,105370430,362782420,1,0,0,4608,5,3042673400
10208,257421860,105056126,362477986,3,0,0,59392,3,6043830081
10209,257432949,137272248,394705197,0,0,1,27648,10,8982094541
10210,257451850,105482244,362934094,3,0,0,75776,3,4606238967
10211,257506300,106170962,363677262,0,0,0,1077248,10,2652714588
10212,257593510,137777854,395371364,2,0,1,657920,4,4756565692
10213,257617080,106204285,363821365,3,0,0,105984,3,9591726856
10214,257711530,137659857,395371387,2,0,1,512,4,10303305609
10215,257813370,137638626,395451996,2,0,1,36352,4,9511364787
10216,257818399,137640743,395459142,0,0,1,16384,10,7264298200
10217,257825380,137672883,395498263,2,0,1,48128,4,6848434201
10218,257886080,138240874,396126954,2,0,1,275456,4,10073685673
10219,257908519,138248040,396156559,0,0,1,31232,10,7535921866
10220,257914300,105841320,363755620,3,0,0,257024,3,6124041526
10221,257955830,138225761,396181591,5,0,1,12800,11,6997838811
10222,257984450,104992113,362976563,1,0,0,512,5,6765964150
10223,258056389,138160649,396217038,1,0,1,31232,5,3352305312
10224,258073140,105715575,363788715,3,0,0,108544,3,5352079812
10225,258097710,105046883,363144593,1,0,0,4096,5,7297211476
10226,258134330,105766493,363900823,9,0,0,221184,17,6011088618
10227,258135600,138115466,396251066,2,0,1,59904,4,8379023526
10228,258187140,105900758,364087898,9,0,0,216576,17,5349862233
10229,258216819,138049233,396266052,0,0,1,16896,10,8438336958
10230,258228679,138038999,396267678,1,0,1,2560,5,10598894022
10231,258242870,105998639,364241509,3,0,0,30720,3,1275687409
10232,258267219,138032202,396299421,1,0,1,46080,5,5418785958
10233,258267510,105754166,364021676,3,0,0,252416,3,6503992094
10234,258269880,105947725,364217605,9,0,0,154112,17,2262066781
10235,258315430,105517978,363833408,3,0,0,39424,3,8237119977
10236,258317900,105471150,363789050,1,0,0,1024,5,6509813878
10237,258343050,138189469,396532519,2,0,1,142848,4,7253620156
10238,258343329,138189213,396532542,1,0,1,17920,5,724830672
10239,258376189,138156376,396532565,0,0,1,27136,10,890254907
10240,258422589,138125466,396548055,0,0,1,27648,10,5692444305
10241,258427319,138120759,396548078,1,0,1,41984,5,4913069319
10242,258436650,105971870,364408520,0,0,0,153088,10,939862491
10243,258458859,138089242,396548101,0,0,1,14848,10,3083407099
10244,258476949,138071175,396548124,0,0,1,13824,10,3577177009
10245,258503590,105745542,364249132,1,0,0,5120,5,2325537342
10246,258557039,137991108,396548147,0,0,1,40448,10,3992584553
10247,258564180,106267154,364831334,0,0,0,759296,10,1559552211
10248,258566549,137981621,396548170,1,0,1,12288,5,10495441253
10249,258570680,138124220,396694900,2,0,1,379904,4,6757021539
10250,258580529,138130844,396711373,0,0,1,26112,10,4385869165
10251,258645340,105636376,364281716,1,0,0,512,5,950867676
10252,258647750,138066529,396714279,7,0,1,4608,16,6767474539
10253,258663980,138066126,396730106,7,0,1,34304,16,8360830863
10254,258667610,106172639,364840249,9,0,0,29184,17,2733466182
10255,258720440,138177363,396897803,2,0,1,68096,4,6820819816
10256,258778959,138119358,396898317,4,0,1,12800,2,6836508176
10257,258787940,106094304,364882244,9,0,0,137728,17,922941913
10258,258802250,138287381,397089631,2,0,1,217600,4,5541198820
10259,258809309,138314364,397123673,4,0,1,27136,2,6118890774
10260,258814589,138372809,397187398,0,0,1,62464,10,918168897
10261,258865760,138473214,397338974,2,0,1,208384,4,6465863104
10262,258866609,138472396,397339005,4,0,1,45056,2,8582300079
10263,258875580,106362345,365237925,1,0,0,1024,5,1746550054
10264,258877609,138550303,397427912,4,0,1,26624,2,2201931035
10265,258893859,138534076,397427935,1,0,1,27648,5,4502219374
10266,258903500,138783831,397687331,2,0,1,323584,4,5987357798
10267,258908110,106676658,365584768,0,0,0,61952,10,8435786774
10268,258909399,138777955,397687354,1,0,1,3072,5,5283905217
10269,258937600,106191630,365129230,3,0,0,74752,3,3108191716
10270,259001329,138686048,397687377,4,0,1,31744,2,9529192066
10271,259046719,138640681,397687400,1,0,1,14848,5,9530890612
10272,259134549,138572351,397706900,4,0,1,25600,2,2465699246
10273,259171079,138544014,397715093,1,0,1,29696,5,3753027630
10274,259200490,107046576,366247066,3,0,0,505856,3,10268960138
10275,259241279,138477360,397718639,0,0,1,5632,10,8868647872
10276,259248170,106162490,365410660,3,0,0,27136,3,2535912169
10277,259284120,106453503,365737623,1,0,0,1024,5,5117003463
10278,259374759,138474537,397849296,4,0,1,57856,2,5520179847
10279,259399929,138539551,397939480,1,0,1,4608,5,8839132521
10280,259421340,106211074,365632414,0,0,0,43008,10,6746634426
10281,259511700,106332238,365843938,9,0,0,339456,17,8984113770
10282,259523109,138416394,397939503,1,0,1,1024,5,5374186692
10283,259612669,138326857,397939526,1,0,1,4096,5,1385480169
10284,259660900,106198661,365859561,9,0,0,51200,17,4520722812
10285,259663529,138276020,397939549,0,0,1,10240,10,10508900070
10286,259674499,138265073,397939572,0,0,1,12288,10,889290209
10287,259688679,138250916,397939595,4,0,1,9216,2,2420748295
10288,259754390,138309999,398064389,3,0,1,180736,3,2940034404
10289,259766110,106147242,365913352,1,0,0,1536,5,9052106392
10290,259770709,138319599,398090308,1,0,1,47104,5,10169715113
10291,259819179,138275138,398094317,4,0,1,16384,2,9374727493
10292,259842239,138254196,398096435,0,0,1,18944,10,1852769196
10293,260059090,106960511,367019601,0,0,0,385536,10,1485478461
10294,260120240,106655533,366775773,0,0,0,361472,10,10377913247
10295,260189089,106845713,367034802,8,0,0,49664,2,699288266
10296,260196120,105451713,365647833,1,0,0,8192,5,3738169886
10297,260220020,106567507,366787527,0,0,0,36864,10,1015282653
10298,260234969,106068436,366303405,8,0,0,184832,2,1859061928
10299,260336290,106329301,366665591,3,0,0,635904,3,8347439739
10300,260342430,106433834,366776264,1,0,0,1536,5,10076875764
10301,260365380,106906299,367271679,9,0,0,370688,17,10066865811
10302,260398940,107040493,367439433,9,0,0,531968,17,4236842347
10303,260403140,138101858,398504998,2,0,1,409088,4,6939112426
10304,260479979,138025042,398505021,1,0,1,16384,5,7359979719
10305,260532789,107032858,367565647,8,0,0,185856,2,7080583533
10306,260548440,106489661,367038101,9,0,0,10752,17,7221857018
10307,260663370,137841853,398505223,6,0,1,46080,7,1695700490
10308,260695239,106154954,366850193,8,0,0,84480,2,4191061553
10309,260707240,106347116,367054356,9,0,0,53248,17,2365460096
10310,260715089,137790157,398505246,1,0,1,32256,5,77724456
10311,260722350,137810710,398533060,6,0,1,17408,7,2278171224
10312,260811520,106948384,367759904,3,0,0,324608,3,4504988501
10313,260814940,137718143,398533083,6,0,1,25088,7,4925869203
10314,260901010,137632136,398533146,6,0,1,7680,7,6746148587
10315,260908639,137624530,398533169,1,0,1,13824,5,1713692860
10316,260958429,137584802,398543231,1,0,1,14848,5,4429472397
10317,260988830,137555707,398544537,8,0,1,2048,2,3324848355
10318,260991910,106517040,367508950,3,0,0,210432,3,7087259176
10319,261007100,137539703,398546803,8,0,1,3584,2,4823932411
10320,261015350,106137702,367153052,1,0,0,2048,5,9014383724
10321,261021449,137533086,398554535,1,0,1,12288,5,8411290032
10322,261047340,137512341,398559681,6,0,1,8192,7,4666845769
10323,261091780,137473073,398564853,8,0,1,8192,2,6132616175
10324,261092749,137482781,398575530,1,0,1,42496,5,5446773643
10325,261117149,106520827,367637976,8,0,0,138752,2,4254302993
10326,261122750,106321946,367444696,0,0,0,16896,10,9717558
10327,261144690,106516264,367660954,9,0,0,75264,17,5219929502
10328,261160850,137438576,398599426,8,0,1,57344,2,2817720229
10329,261195419,106684212,367879631,8,0,0,212992,2,1897042474
10330,261226030,137388730,398614760,6,0,1,27648,7,10603171485
10331,261238870,137376556,398615426,8,0,1,1024,2,6890702746
10332,261244840,106350782,367595622,0,0,0,98304,10,9280056527
10333,261258420,106769779,368028199,0,0,0,66560,10,8696517341
10334,261271870,106542842,367814712,0,0,0,46080,10,10702496631
10335,261272470,106491636,367764106,9,0,0,13312,17,3163659623
10336,261284789,107145520,368430309,8,0,0,193536,2,9309292086
10337,261286320,137333241,398619561,6,0,1,16384,7,7173849729
10338,261302300,137323816,398626116,6,0,1,22016,7,6796598419
10339,261307950,137322672,398630622,8,0,1,7168,2,763448910
10340,261368810,137284085,398652895,8,0,1,45056,2,8487256645
10341,261374719,137282682,398657401,1,0,1,7168,5,10467056648
10342,261435819,106825702,368261521,8,0,0,78336,2,1347264235
10343,261450990,107248467,368699457,0,0,0,19968,10,7297415755
10344,261459770,106435640,367895410,0,0,0,51712,10,3678277940
10345,261467200,107714076,369181276,9,0,0,265216,17,3591714541
10346,261482520,106649327,368131847,1,0,0,1536,5,2118216958
10347,261514149,137147118,398661267,1,0,1,6144,5,8020619424
10348,261565979,137115077,398681056,1,0,1,67584,5,10048738642
10349,261601669,107374340,368976009,8,0,0,220672,2,7924691023
10350,261619220,106618410,368237630,3,0,0,90624,3,4273820095
10351,261650419,137067322,398717741,1,0,1,32768,5,8917630347
10352,261666290,137051707,398717997,6,0,1,9216,7,7988905657
10353,261699050,106963271,368662321,0,0,0,151040,10,1251727048
10354,261703999,106271581,367975580,8,0,0,80384,2,7095935736
10355,261705990,107171997,368877987,3,0,0,55296,3,8511112939
10356,261838070,106238785,368076855,1,0,0,7168,5,10263950691
10357,261840900,106649942,368490842,3,0,0,27136,3,9371288699
10358,261886899,136831817,398718716,1,0,1,10240,5,2027824075
10359,261893799,136829743,398723542,1,0,1,7680,5,5907361177
10360,261924579,136821666,398746245,1,0,1,26624,5,2967154341
10361,261927440,107056704,368984144,4,0,0,26624,2,2686841030
10362,261937439,106678839,368616278,8,0,0,287232,2,5031840316
10363,261944050,106383494,368327544,1,0,0,5632,5,6735177383
10364,261964300,106809935,368774235,3,0,0,109056,3,1724761045
10365,261982860,106447940,368430800,1,0,0,1536,5,4842851041
10366,262038080,107814393,369852473,0,0,0,202240,10,8994840284
10367,262065650,107203502,369269152,9,0,0,138240,17,6187865411
10368,262079469,107510797,369590266,8,0,0,101888,2,5017391218
10369,262082210,136670223,398752433,7,0,1,512,16,10574674361
10370,262122780,108005787,370128567,1,0,0,3072,5,5976551915
10371,262215659,107868215,370083874,8,0,0,216064,2,5649949042
10372,262252640,106969687,369222327,3,0,0,134656,3,3158852942
10373,262386299,107240993,369627292,8,0,0,46080,2,4621169973
10374,262404210,106419981,368824191,3,0,0,14848,3,8015100452
10375,262444440,136311219,398755659,6,0,1,5120,7,381812668
10376,262448950,106079789,368528739,9,0,0,49664,17,8763910378
10377,262488519,106881809,369370328,8,0,0,49664,2,4895475304
10378,262509130,107949048,370458178,9,0,0,315904,17,10525449438
10379,262535299,107243998,369779297,8,0,0,123392,2,9816370693
10380,262553000,107574608,370127608,9,0,0,139264,17,10157737782
10381,262561640,136194365,398756005,7,0,1,512,16,4110845586
10382,262595380,107766523,370361903,9,0,0,363520,17,5684716274
10383,262611510,107938644,370550154,3,0,0,47616,3,428173216
10384,262635620,107382399,370018019,9,0,0,351232,17,3629988264
10385,262665820,106415791,369081611,1,0,0,1536,5,6661866513
10386,262699230,136063246,398762476,8,0,1,4608,2,3195280427
10387,262700510,105963550,368664060,1,0,0,5632,5,3323775328
10388,262706559,107827013,370533572,8,0,0,190976,2,3911677565
10389,262799910,107417874,370217784,3,0,0,158720,3,2883740252
10390,262838160,106717995,369556155,0,0,0,2048,10,9573512759
10391,262848019,107917612,370765631,8,0,0,199168,2,2644255782
10392,262885410,107956840,370842250,9,0,0,251392,17,3822861988
10393,262916680,107956021,370872701,9,0,0,99840,17,1103729010
10394,262948389,107947891,370896280,8,0,0,77312,2,2155007820
10395,262980420,107555203,370535623,3,0,0,6656,3,8924864032
10396,262986700,108105590,371092290,3,0,0,193024,3,546152910
10397,263132730,107880853,371013583,9,0,0,29696,17,4436639811
10398,263132770,106334720,369467490,1,0,0,3584,5,7507574709
10399,263144810,108178246,371323056,3,0,0,394752,3,8236095617
10400,263163300,107496565,370659865,9,0,0,47616,17,5042932638
10401,263170780,108317282,371488062,9,0,0,395776,17,3335932073
10402,263185009,108771892,371956901,8,0,0,721408,2,120860047
10403,263212119,107263242,370475361,8,0,0,56320,2,6562000950
10404,263250450,106834703,370085153,1,0,0,4096,5,906684561
10405,263254900,108314552,371569452,1,0,0,4608,5,8215127796
10406,263318910,106413323,369732233,1,0,0,512,5,2147463626
10407,263328040,107850164,371178204,0,0,0,92672,10,6278784003
10408,263344280,108872990,372217270,9,0,0,460800,17,4250502346
10409,263411650,106807717,370219367,1,0,0,5120,5,5808362241
10410,263422670,108654177,372076847,9,0,0,292352,17,4329236074
10411,263469270,108875755,372345025,9,0,0,234496,17,6832195726
10412,263502720,135585993,399088713,2,0,1,128512,4,4168950833
10413,263504300,108961843,372466143,0,0,0,395264,10,461833218
10414,263626460,108849534,372475994,3,0,0,32256,3,5839540325
10415,263636050,135499977,399136027,2,0,1,40960,4,1526758955
10416,263675560,108670128,372345688,1,0,0,2048,5,8855682604
10417,263685030,108860781,372545811,0,0,0,200192,10,62270000
10418,263734230,107590877,371325107,3,0,0,6656,3,3463126061
10419,263782860,108915323,372698183,0,0,0,251392,10,10289031718
10420,263844269,108777256,372621525,8,0,0,248320,2,3944045880
10421,263918980,108838077,372757057,0,0,0,145920,10,2591579570
10422,263973210,108850669,372823879,3,0,0,214016,3,4447707277
10423,263990390,108768258,372758648,1,0,0,5120,5,6477674773
10424,264035760,107609832,371645592,3,0,0,93184,3,10338528459
10425,264175550,107155375,371330925,0,0,0,18944,10,6204431369
10426,264260030,107228679,371488709,1,0,0,2048,5,3197529655
10427,264316610,108563809,372880419,3,0,0,47104,3,9224753552
10428,264320691,134859538,399180229,9,0,1,4608,17,6019366694
10429,264333389,107938270,372271659,8,0,0,17408,2,5602790250
10430,264340830,107646826,371987656,0,0,0,100864,10,8050119604
10431,264371961,134808291,399180252,9,0,1,4608,17,9634383926
10432,264389449,109132182,373521631,5,0,0,62464,11,8940241580
10433,264404720,108718579,373123299,0,0,0,231424,10,8790751610
10434,264416210,107231433,371647643,1,0,0,6656,5,4882106143
10435,264423850,108958917,373382767,0,0,0,239104,10,5508561763
10436,264444200,107822100,372266300,3,0,0,110592,3,1092306918
10437,264549960,108682837,373232797,0,0,0,136192,10,4813212772
10438,264557031,134623244,399180275,9,0,1,17920,17,7031173102
10439,264588601,134591697,399180298,9,0,1,29696,17,298753099
10440,264602171,134578150,399180321,9,0,1,8704,17,5678810242
10441,264626080,106960944,371587024,1,0,0,1536,5,7637818283
10442,264703211,134477133,399180344,9,0,1,4608,17,6412376436
10443,264723810,108738407,373462217,0,0,0,172544,10,9650518383
10444,264771710,108937080,373708790,0,0,0,124928,10,4384521277
10445,264795801,134384582,399180383,9,0,1,12288,17,5899771728
10446,264807450,107466104,372273554,1,0,0,6144,5,7237733106
10447,264825309,108071981,372897290,8,0,0,55296,2,4574336811
10448,264857080,109269794,374126874,0,0,0,171008,10,6507496788
10449,264936979,107295602,372232581,8,0,0,50176,2,3041086919
10450,264940910,108247932,373188842,0,0,0,215040,10,9198266356
10451,264951320,108541423,373492743,1,0,0,512,5,1533529554
10452,264965420,109265749,374231169,0,0,0,186368,10,256160393
10453,264987890,109043670,374031560,4,0,0,355840,2,5199608603
10454,264992040,108583768,373575808,3,0,0,51200,3,10211923501
10455,265090650,134134239,399224889,6,0,1,27136,7,1832892571
10456,265119181,134105731,399224912,9,0,1,20992,17,9854710267
10457,265139180,134085795,399224975,6,0,1,1536,7,8779433153
10458,265148191,134076807,399224998,9,0,1,7680,17,2753842761
10459,265159760,107552798,372712558,0,0,0,47104,10,10461272195
10460,265185160,107299616,372484776,0,0,0,28672,10,8406510480
10461,265188400,134603110,399791510,2,0,1,411648,4,2435396466
10462,265202871,134659739,399862610,9,0,1,38912,17,9858132060
10463,265251971,134641205,399893176,9,0,1,26112,17,9831790991
10464,265279660,108578484,373858144,3,0,0,120832,3,10130051646
10465,265300880,134596802,399897682,6,0,1,7168,7,6575160113
10466,265352271,134546717,399898988,9,0,1,2048,17,6584680643
10467,265354550,134555435,399909985,6,0,1,25600,7,1014712339
10468,265399350,109009631,374408981,3,0,0,242176,3,2257174230
10469,265459550,107593214,373052764,3,0,0,190464,3,1818280892
10470,265464121,134447170,399911291,9,0,1,2048,17,5093070087
10471,265503349,134413088,399916437,1,0,1,8192,5,5760129190
10472,265539930,107725650,373265580,0,0,0,107520,10,497455196
10473,265571740,108724286,374296026,3,0,0,181760,3,7998120260
10474,265580720,108069345,373650065,0,0,0,93184,10,2803141640
10475,265653269,108926715,374579984,8,0,0,539136,2,6351893043
10476,265658390,134259993,399918383,6,0,1,3072,7,10247674339
10477,265667450,134414001,400081451,2,0,1,48640,4,3381274360
10478,265692420,134389054,400081474,6,0,1,20480,7,8134658738
10479,265723589,134357908,400081497,1,0,1,5632,5,8913083303
10480,265731200,134350320,400081520,5,0,1,41472,11,144805926
10481,265742591,134338952,400081543,9,0,1,15872,17,1846019396
10482,265743210,108928172,374671382,3,0,0,83456,3,9188126272
10483,265744180,107652049,373396229,3,0,0,28160,3,8864392263
10484,265751460,107636166,373387626,0,0,0,15872,10,2309566910
10485,265791240,107398561,373189801,0,0,0,3072,10,2114350339
10486,265827709,134359804,400187513,1,0,1,14848,5,1590997387
10487,265829150,134358410,400187560,2,0,1,58368,4,3536779021
10488,265846140,107927128,373773268,1,0,0,3584,5,10235251155
10489,265850389,108840989,374691378,8,0,0,63488,2,5685436412
10490,265901680,108226020,374127700,1,0,0,1024,5,4141036392
10491,265979090,107943973,373923063,3,0,0,212992,3,6771471987
10492,266040170,134147413,400187583,5,0,1,45568,11,2357473091
10493,266106790,134082867,400189657,5,0,1,24064,11,715346991
10494,266112739,107961900,374074639,8,0,0,141312,2,1769407421
10495,266200570,133996713,400197283,5,0,1,4096,11,857442721
10496,266208460,133992049,400200509,5,0,1,5120,11,8147769872
10497,266218400,133982775,400201175,5,0,1,11264,11,9227334139
10498,266226431,134012391,400238822,9,0,1,5632,17,6721432713
10499,266245070,107925475,374170545,0,0,0,140288,10,8006772490
10500,266252030,133992489,400244519,6,0,1,18944,7,7568677592
10501,266276580,134012355,400288935,6,0,1,37888,7,3609087260
10502,266302199,108337556,374639755,8,0,0,196096,2,9379508400
10503,266306630,108335488,374642118,1,0,0,7680,5,4916677580
10504,266314581,133979060,400293641,9,0,1,17408,17,9032164692
10505,266340490,133958048,400298538,8,0,1,13312,2,586862575
10506,266354060,108317657,374671717,1,0,0,1024,5,8040236685
10507,266406910,108286363,374693273,1,0,0,6144,5,3573530595
10508,266411721,133918413,400330134,9,0,1,23552,17,2821103974
10509,266428641,133910271,400338912,9,0,1,19456,17,2122837191
10510,266439390,133899676,400339066,6,0,1,8704,7,10414325620
10511,266454170,107673195,374127365,1,0,0,1536,5,7853793131
10512,266457310,108214609,374671919,1,0,0,512,5,10415596247
10513,266486930,134010957,400497887,6,0,1,28672,7,6648457903
10514,266503580,108390823,374894403,0,0,0,387584,10,2769740026
10515,266559060,134033056,400592116,5,0,1,27136,11,1491497918
10516,266580050,134012089,400592139,6,0,1,11776,7,5350138822
10517,266598580,107811140,374409720,1,0,0,2048,5,10582270315
10518,266612590,134031704,400644294,5,0,1,31232,11,9983129858
10519,266643031,134007311,400650342,9,0,1,19968,17,8311986226
10520,266681109,108095064,374776173,8,0,0,138752,2,6341669212
10521,266683360,133967648,400651008,6,0,1,11264,7,9024079558
10522,266691080,134172478,400863558,6,0,1,84992,7,8454666328
10523,266727840,134135741,400863581,5,0,1,5632,11,4269301324
10524,266773860,134157338,400931198,6,0,1,26624,7,3728857452
10525,266802609,134128612,400931221,1,0,1,23552,5,5456821383
10526,266803639,107842246,374645885,8,0,0,12288,2,3393611953
10527,266826240,134105004,400931244,5,0,1,29184,11,10472569095
10528,266832500,134098767,400931267,5,0,1,512,11,8934440905
10529,266859600,134071690,400931290,6,0,1,13312,7,3383543437
10530,266872711,134058602,400931313,9,0,1,23552,17,10613027133
10531,266928930,134018871,400947801,8,0,1,107008,2,7228112098
10532,266931000,107965142,374896142,1,0,0,5632,5,4136670257
10533,266954899,108163709,375118608,8,0,0,265216,2,1724014914
10534,266976340,107717322,374693662,0,0,0,1024,10,1112526879
10535,267019970,107701685,374721655,3,0,0,31744,3,703391739
10536,267074500,107620885,374695385,1,0,0,5120,5,2408978537
10537,267076511,133912240,400988751,9,0,1,41984,17,1533859555
10538,267079200,133910422,400989622,8,0,1,12288,2,375595923
10539,267120429,133907062,401027491,1,0,1,46592,5,8706303775
10540,267149690,108493299,375642989,0,0,0,157184,10,1137247835
10541,267179820,108017359,375197179,3,0,0,47104,3,8399520259
10542,267220880,108073236,375294116,3,0,0,145920,3,4210551939
10543,267232770,107805007,375037777,0,0,0,143360,10,6038859456
10544,267233341,133810401,401043742,9,0,1,7168,17,5871503940
10545,267250949,133847066,401098015,1,0,1,23552,5,10666097138
10546,267264300,107861842,375126142,3,0,0,24576,3,760156351
10547,267317010,108079781,375396791,1,0,0,5632,5,5520695513
10548,267329530,133768508,401098038,5,0,1,1536,11,9133002282
10549,267345970,133752091,401098061,5,0,1,30208,11,10124383167
10550,267359581,133738503,401098084,9,0,1,512,17,4430881389
10551,267361341,107616396,374977737,2,0,0,1536,4,3756337763
10552,267378309,133719798,401098107,1,0,1,18944,5,9201215745
10553,267442360,133733645,401176005,8,0,1,116736,2,4309316648
10554,267484499,133960694,401445193,1,0,1,100864,5,5665763076
10555,267484799,107646202,375131001,8,0,0,15872,2,5773849206
10556,267495220,107635960,375131180,1,0,0,512,5,877255446
10557,267580110,133969050,401549160,8,0,1,157184,2,4151786845
10558,267581540,134564883,402146423,8,0,1,668160,2,4904652440
10559,267581830,134679520,402261350,8,0,1,290816,2,3182204323
10560,267599750,134667732,402267482,6,0,1,9728,7,2687790938
10561,267612280,107637353,375249633,3,0,0,70144,3,9904573596
10562,267614721,134653632,402268353,9,0,1,12288,17,1918372008
10563,267618420,108026932,375645352,1,0,0,7680,5,2788440570
10564,267623310,134666569,402289879,6,0,1,33792,7,6317656495
10565,267630970,134661087,402292057,5,0,1,3072,11,6979052109
10566,267631969,134669748,402301717,1,0,1,17920,5,3952774054
10567,267634141,134706096,402340237,9,0,1,30720,17,9042630212
10568,267679200,109029955,376709155,3,0,0,551424,3,1990838160
10569,267698600,108584711,376283311,0,0,0,50176,10,1876151977
10570,267724000,134619783,402343783,5,0,1,5632,11,4135615500
10571,267747979,108227947,375975926,8,0,0,161280,2,3789323528
10572,267932210,107843086,375775296,3,0,0,114688,3,9454956927
10573,267939649,108092194,376031843,8,0,0,156160,2,6149744283
10574,267942449,134406119,402348568,1,0,1,10752,5,2097399881
10575,268028131,107317216,375345347,2,0,0,1024,4,8914673005
10576,268032190,134318004,402350194,6,0,1,2560,7,6160148580
10577,268097860,134743927,402841787,8,0,1,481792,2,2713851958
10578,268106919,108633014,376739933,8,0,0,92160,2,9807523502
10579,268113789,107751518,375865307,8,0,0,260608,2,10709543831
10580,268122000,108193215,376315215,1,0,0,1024,5,3055930929
10581,268122770,108145230,376268000,3,0,0,165376,3,6950625104
10582,268131530,134710280,402841810,6,0,1,26112,7,3638053473
10583,268175109,107809131,375984240,8,0,0,26112,2,8744422855
10584,268175209,108042380,376217589,8,0,0,281088,2,582484678
10585,268187000,134809837,402996837,8,0,1,228864,2,4720909036
10586,268218220,108910565,377128785,0,0,0,141824,10,9523401856
10587,268229690,108717603,376947293,0,0,0,52224,10,8015238058
10588,268245371,107786815,376032186,2,0,0,1024,4,8176149111
10589,268256430,108609262,376865692,0,0,0,412672,10,553443359
10590,268304040,134747807,403051847,2,0,1,12288,4,903954479
10591,268308249,134748744,403056993,1,0,1,8192,5,3464993153
10592,268377519,134720979,403098498,1,0,1,18432,5,9254741060
10593,268395899,134783146,403179045,4,0,1,51712,2,3823931419
10594,268408189,134771215,403179404,1,0,1,9728,5,3397191116
10595,268439009,134747276,403186285,1,0,1,20992,5,8672025974
10596,268473780,107835001,376308781,1,0,0,512,5,4958801260
10597,268489879,134709054,403198933,1,0,1,19456,5,1315060931
10598,268524499,108406813,376931312,8,0,0,91136,2,5815673616
10599,268532609,134667707,403200316,1,0,1,14848,5,1163772695
10600,268535519,108516681,377052200,8,0,0,239104,2,9707222879
10601,268542349,134717551,403259900,4,0,1,19456,2,5178414821
10602,268545391,107430870,375976261,2,0,0,1024,4,10626037631
10603,268549469,134719638,403269107,1,0,1,22528,5,1364378104
10604,268555939,134726382,403282321,4,0,1,14336,2,152554384
10605,268556931,107750314,376307245,2,0,0,512,4,4507713657
10606,268586299,134697328,403283627,1,0,1,2048,5,7139579582
10607,268586971,108124859,376711830,2,0,0,8704,4,3893524532
10608,268605570,108297928,376903498,0,0,0,123904,10,7901682890
10609,268709700,108478700,377188400,3,0,0,195584,3,442029533
10610,268842840,134772904,403615744,2,0,1,65024,4,7424730798
10611,268853971,108094905,376948876,2,0,0,5120,4,1980758909
10612,268880969,134778540,403659509,4,0,1,65536,2,987885853
10613,268887259,108064019,376951278,8,0,0,7680,2,6166795504
10614,268903730,134762862,403666592,2,0,1,19968,4,7709020453
10615,268942609,134743412,403686021,4,0,1,16384,2,6732165752
10616,269017290,108641814,377659104,0,0,0,56320,10,9687908812
10617,269028090,108161425,377189515,1,0,0,3584,5,1555938554
10618,269043749,134651630,403695379,4,0,1,6144,2,3169127397
10619,269082200,134695154,403777354,2,0,1,15360,4,2824208590
10620,269163310,108402116,377565426,0,0,0,460800,10,2965159866
10621,269176410,107775203,376951613,1,0,0,1024,5,10718831594
10622,269260560,134636812,403897372,8,0,1,129536,2,1966625579
10623,269296209,134787203,404083412,4,0,1,25600,2,6915369292
10624,269310340,107892458,377202798,0,0,0,43520,10,8763215803
10625,269329310,108800927,378130237,3,0,0,333824,3,856173892
10626,269386310,108350505,377736815,0,0,0,254976,10,6823661054
10627,269437849,134645586,404083435,4,0,1,11264,2,1175595214
10628,269445450,134638008,404083458,6,0,1,11776,7,2393033751
10629,269461540,108410838,377872378,0,0,0,5632,10,3359662161
10630,269486580,134596901,404083481,2,0,1,3072,4,1873333796
10631,269607529,108876234,378483763,8,0,0,413696,2,3061890858
10632,269681550,108924187,378605737,3,0,0,374272,3,3165288855
10633,269729449,108610958,378340407,8,0,0,357888,2,10174827953
10634,269759730,107632575,377392305,1,0,0,3584,5,7760425611
10635,269772619,134310885,404083504,4,0,1,48128,2,1202115721
10636,269825590,134257937,404083527,2,0,1,10240,4,5210105556
10637,269839159,134261730,404100889,4,0,1,41984,2,824656942
10638,269864740,108291803,378156543,1,0,0,3072,5,9215696842
10639,269865650,108030398,377896048,1,0,0,1536,5,5361706841
10640,269937620,109319175,379256795,3,0,0,377856,3,3985343671
10641,270000630,108230710,378231340,0,0,0,81408,10,6569905070
10642,270024700,108110084,378134784,0,0,0,14848,10,10280592242
10643,270029479,109731445,379760924,8,0,0,786432,2,4161371981
10644,270071440,108074131,378145571,0,0,0,35328,10,4926149438
10645,270092880,108398752,378491632,0,0,0,25600,10,10137061854
10646,270093639,109195003,379288642,8,0,0,104448,2,7575862211
10647,270123370,108218464,378341834,1,0,0,4608,5,1202732425
10648,270163001,108003413,378166414,2,0,0,512,4,7353610848
10649,270212890,133888022,404100912,7,0,1,55808,16,334317988
10650,270233701,108516072,378749773,2,0,0,2048,4,3610947061
10651,270247859,133853076,404100935,4,0,1,26112,2,1042423149
10652,270303409,133797549,404100958,4,0,1,10240,2,10200585988
10653,270348749,108496293,378845042,8,0,0,114176,2,2893124663
10654,270355569,108501820,378857389,8,0,0,40448,2,4151695574
10655,270373779,108954040,379327819,8,0,0,112128,2,4566419100
10656,270385949,133715032,404100981,4,0,1,15360,2,9614037302
10657,270420479,133680525,404101004,4,0,1,2560,2,8880847014
10658,270423950,108717694,379141644,0,0,0,299520,10,265259540
10659,270444700,108304426,378749126,1,0,0,1024,5,7249565737
10660,270487720,133613307,404101027,2,0,1,512,4,1297573215
10661,270499559,133601491,404101050,1,0,1,1536,5,4033221825
10662,270500859,108968638,379469497,8,0,0,44544,2,5622003051
10663,270511699,133589374,404101073,1,0,1,11776,5,2050147428
10664,270525470,109625720,380151190,8,0,0,421888,2,5297995676
10665,270544979,133556117,404101096,4,0,1,3584,2,4599107116
10666,270594640,109404455,379999095,3,0,0,780800,3,2297176241
10667,270607350,133493769,404101119,2,0,1,16384,4,5786595162
10668,270614079,109707387,380321466,8,0,0,60928,2,10495185086
10669,270669729,133431413,404101142,1,0,1,27648,5,10585044798
10670,270686050,109596075,380282125,0,0,0,412672,10,2551069194
10671,270757760,133343405,404101165,2,0,1,16896,4,3744841222
10672,270793120,109561963,380355083,3,0,0,31232,3,7661786352
10673,270805381,109217242,380022623,2,0,0,3584,4,10669790209
10674,270840639,133260581,404101220,0,0,1,15360,10,2355488730
10675,270852880,109168303,380021183,3,0,0,72192,3,473445483
10676,270854530,109568340,380422870,0,0,0,219648,10,6157304970
10677,270880940,109140422,380021362,1,0,0,512,5,978513698
10678,270889519,133211724,404101243,0,0,1,13824,10,3234337826
10679,270916651,108844521,379761172,2,0,0,512,4,4756828706
10680,270965940,133184286,404150226,2,0,1,49152,4,2473468975
10681,270980860,109467195,380448055,3,0,0,73216,3,5407130470
10682,271009630,109292642,380302272,8,0,0,66048,2,459271329
10683,271013140,109143111,380156251,0,0,0,16384,10,8182504618
10684,271022351,109280412,380302763,2,0,0,1536,4,3630139691
10685,271117920,109350881,380468801,0,0,0,54272,10,5765845917
10686,271143379,133047778,404191157,0,0,1,32768,10,2487602893
10687,271192820,109152693,380345513,3,0,0,78848,3,4884267842
10688,271206130,109458304,380664434,3,0,0,46592,3,571854015
10689,271256340,132935483,404191823,2,0,1,1024,4,6476877324
10690,271281400,132917835,404199235,2,0,1,11776,4,6799438255
10691,271311679,109799037,381110716,8,0,0,108032,2,4011594659
10692,271321920,132919603,404241523,2,0,1,27648,4,6530210069
10693,271384000,109470477,380854477,8,0,0,132096,2,457274683
10694,271419051,109184608,380603659,2,0,0,4096,4,7250851147
10695,271448041,109002221,380450262,2,0,0,7168,4,3347379559
10696,271477670,109314379,380792049,0,0,0,185856,10,5615314390
10697,271488900,108866991,380355891,1,0,0,2048,5,1388597691
10698,271648360,109306226,380954586,0,0,0,197120,10,9079067288
10699,271662460,132585262,404247722,5,0,1,16384,11,7554782929
10700,271674280,108928084,380602364,3,0,0,116224,3,8237351284
10701,271752470,108673231,380425701,1,0,0,9216,5,1930683451
10702,271756631,108695565,380452196,2,0,0,5632,4,6783726653
10703,271781670,109105354,380887024,1,0,0,1536,5,8944867294
10704,271842780,132518852,404361632,7,0,1,7680,16,6917962388
10705,271862259,109295377,381157636,8,0,0,47104,2,7832097526
10706,271866420,108941454,380807874,3,0,0,50688,3,8927720463
10707,271884620,132657634,404542254,5,0,1,38400,11,364561081
10708,271949360,108552986,380502346,1,0,0,2560,5,9903102251
10709,271969750,132584513,404554263,7,0,1,1024,16,7336552168
10710,272074960,132615476,404690436,8,0,1,109056,2,8892236530
10711,272100370,108515588,380615958,1,0,0,1024,5,5949007437
10712,272131741,108487683,380619424,2,0,0,2560,4,6969986073
10713,272133500,132568304,404701804,7,0,1,26624,16,7190067230
10714,272234310,108579896,380814206,0,0,0,14848,10,8275719095
10715,272478680,132247129,404725809,7,0,1,27136,16,10367764436
10716,272502111,108453334,380955445,2,0,0,2560,4,4274955261
10717,272502160,132239880,404742040,7,0,1,1536,16,7833017376
10718,272506020,108286364,380792384,1,0,0,1024,5,3309063484
10719,272533721,108339920,380873641,2,0,0,3584,4,6794692963
10720,272544670,132266064,404810734,7,0,1,44032,16,9152944262
10721,272547189,132263568,404810757,0,0,1,47104,10,59791487
10722,272570440,132240340,404810780,7,0,1,35840,16,9436867295
10723,272632480,132289130,404921610,2,0,1,34304,4,2341109223
10724,272662929,132258704,404921633,4,0,1,7168,2,5984180229
10725,272678110,132243546,404921656,7,0,1,21504,16,1577477226
10726,272843260,132079066,404922326,7,0,1,19968,16,4976565127
10727,272844320,107965293,380809613,1,0,0,5632,5,4532587411
10728,272848829,107778241,380627070,8,0,0,13312,2,3840144467
10729,272868349,108125031,380993380,8,0,0,45568,2,6109993619
10730,272892289,132030060,404922349,4,0,1,29696,2,8096139602
10731,272893190,132029182,404922372,7,0,1,60928,16,8299766681
10732,272941879,131991626,404933505,4,0,1,19456,2,672891467
10733,273029940,107842500,380872440,3,0,0,58880,3,1653370965
10734,273162620,107721363,380883983,0,0,0,33792,10,6567444015
10735,273235100,131751866,404986966,7,0,1,55296,16,7316347302
10736,273335071,107549403,380884474,2,0,0,1536,4,6387695391
10737,273365280,131668098,405033378,7,0,1,18944,16,1716422306
10738,273372019,131664905,405036924,4,0,1,5632,2,10171160904
10739,273393130,131645740,405038870,7,0,1,3072,16,3919052820
10740,273429189,107816822,381246011,8,0,0,116224,2,10601917065
10741,273471620,107782046,381253666,3,0,0,13312,3,3574241530
10742,273566599,131475177,405041776,4,0,1,4608,2,7845745282
10743,273587499,131476246,405063745,0,0,1,34304,10,129905743
10744,273618829,131477467,405096296,4,0,1,12800,2,2629822419
10745,273620701,107676929,381297630,2,0,0,1024,4,2001332975
10746,273623289,131479813,405103102,0,0,1,12800,10,4176996285
10747,273661079,131448980,405110059,0,0,1,2048,10,9228715091
10748,273688950,131515025,405203975,7,0,1,18944,16,10543060535
10749,273701190,107185335,380886525,1,0,0,6656,5,918884107
10750,273729850,131474148,405203998,7,0,1,12288,16,3767998644
10751,273752519,131451502,405204021,0,0,1,18432,10,2541617937
10752,273752869,131451175,405204044,4,0,1,512,2,2708820002
10753,273753011,107604421,381357432,2,0,0,4608,4,1049502202
10754,273757960,107827586,381585546,3,0,0,197632,3,6305168305
10755,273763880,108073116,381836996,1,0,0,3072,5,9969312090
10756,273796420,131407647,405204067,6,0,1,4608,7,9282793048
10757,273822510,131381580,405204090,6,0,1,15360,7,9653586242
10758,273857909,131351719,405209628,4,0,1,5632,2,3622940919
10759,273868829,108144913,382013742,8,0,0,370688,2,3746690277
10760,273871319,131363695,405235014,4,0,1,33280,2,5364425950
10761,273880269,131453434,405333703,4,0,1,15872,2,1391096677
10762,273909759,131425890,405335649,4,0,1,3072,2,5178608373
10763,273912289,107890763,381803052,8,0,0,355840,2,6855480068
10764,273921759,108105734,382027493,8,0,0,45056,2,10188357877
10765,273958980,131457641,405416621,6,0,1,32768,7,10010877034
10766,273968330,131452503,405420833,6,0,1,6656,7,6040717844
10767,273971561,107655257,381626818,2,0,0,10752,4,7872041968
10768,273980569,131505387,405485956,0,0,1,27648,10,9953746105
10769,273992141,107255453,381247594,2,0,0,5120,4,2562541716
10770,274044070,131822640,405866710,3,0,1,367616,3,882962049
10771,274057929,131876039,405933968,4,0,1,76288,2,9425335497
10772,274062640,131872634,405935274,7,0,1,2048,16,7653576972
10773,274150360,131792481,405942841,7,0,1,31744,16,6787145731
10774,274156889,131786618,405943507,0,0,1,1024,10,2758111368
10775,274157410,131787403,405944813,7,0,1,2048,16,5736815156
10776,274170460,131785048,405955508,7,0,1,29184,16,10347715830
10777,274172370,107928017,382100387,0,0,0,136704,10,1414083632
10778,274174489,131868108,406042597,4,0,1,25088,2,6915471422
10779,274179350,107656641,381835991,0,0,0,108032,10,8635314949
10780,274187361,107239821,381427182,2,0,0,512,4,7503856353
10781,274200269,131842351,406042620,0,0,1,83456,10,3266958878
10782,274204960,107977812,382182772,0,0,0,94720,10,3971100902
10783,274229229,131813414,406042643,1,0,1,14848,5,8353472669
10784,274237010,108366902,382603912,3,0,0,345600,3,4165983334
10785,274243109,108245918,382489027,8,0,0,704512,2,7812497610
10786,274249720,131794787,406044507,7,0,1,5632,16,1416231890
10787,274251971,108353384,382605355,2,0,0,4608,4,8752584684
10788,274269580,131776233,406045813,6,0,1,2048,7,6200101718
10789,274271139,131774828,406045967,0,0,1,8704,10,5118405546
10790,274294650,131778082,406072732,6,0,1,17920,7,5025904625
10791,274302929,131771429,406074358,1,0,1,2560,5,6068674938
10792,274306321,107587457,381893778,2,0,0,1536,4,3731559060
10793,274321120,131778392,406099512,7,0,1,52736,16,74439499
10794,274346920,108151334,382498254,3,0,0,30208,3,5172414293
10795,274350570,107763844,382114414,1,0,0,8192,5,2869947723
10796,274381060,108290710,382671770,0,0,0,217600,10,4093244821
10797,274396560,131710730,406107290,7,0,1,19456,16,9028430350
10798,274414190,131744709,406158899,7,0,1,60928,16,1782389880
10799,274450789,131710402,406161191,0,0,1,13824,10,10465131126
10800,274469329,131730647,406199976,1,0,1,36864,5,3524216937
10801,274480450,108018139,382498589,1,0,0,1024,5,5955153527
10802,274484499,131715500,406199999,1,0,1,5120,5,7747465854
10803,274490580,131716957,406207537,7,0,1,27648,16,826661993
10804,274502540,131884988,406387528,6,0,1,48640,7,1782540177
10805,274516089,132258159,406774248,1,0,1,59392,5,6395927542
10806,274531090,132247024,406778114,6,0,1,6144,7,9647117289
10807,274560049,132253935,406813984,0,0,1,40960,10,3285403014
10808,274587860,132504580,407092440,7,0,1,40960,16,3060715836
10809,274596620,108839550,383436170,0,0,0,824320,10,7802365777
10810,274612549,132479914,407092463,0,0,1,7680,10,7076288347
10811,274639869,132452617,407092486,0,0,1,512,10,3605642466
10812,274674780,132417729,407092509,7,0,1,55296,16,2276931517
10813,274715410,108356551,383071961,3,0,0,45568,3,2670848177
10814,274808670,108812388,383621058,0,0,0,43520,10,8592262886
10815,274822790,132269742,407092532,6,0,1,3072,7,347613854
10816,274838619,132264411,407103030,0,0,1,31232,10,7180968343
10817,274849089,132318415,407167504,0,0,1,77312,10,1736381198
10818,274849270,132318257,407167527,6,0,1,16896,7,8864522569
10819,274873210,108732491,383605701,0,0,0,555008,10,7459012123
10820,274883769,132283781,407167550,4,0,1,5120,2,7726550619
10821,274905209,108838067,383743276,8,0,0,312832,2,4874530501
10822,274940770,108230605,383171375,3,0,0,3584,3,7379666253
10823,274940931,108495574,383436505,2,0,0,1024,4,8435993808
10824,274946879,132233369,407180248,0,0,1,32256,10,4555860388
10825,274974051,108633389,383607440,2,0,0,5632,4,9325918955
10826,275017270,108630667,383647937,3,0,0,88064,3,3047571597
10827,275025411,108582364,383607775,2,0,0,1024,4,7620905546
10828,275083930,108659993,383743923,1,0,0,2048,5,626433257
10829,275133539,132046732,407180271,1,0,1,13824,5,7873772266
10830,275164869,132015425,407180294,0,0,1,23040,10,4091948657
10831,275166129,132014188,407180317,0,0,1,6144,10,2677511976
10832,275178900,108705331,383884231,3,0,0,211456,3,9840921883
10833,275215881,108771282,383987163,2,0,0,2048,4,982674133
10834,275261631,108833254,384094885,2,0,0,8704,4,9064657337
10835,275299899,109093718,384393617,8,0,0,495104,2,4284848340
10836,275338880,108702973,384041853,1,0,0,1536,5,1139509844
10837,275440269,108776446,384216715,8,0,0,140288,2,2351666391
10838,275451119,108954937,384406056,8,0,0,40448,2,666168037
10839,275485300,132723975,408209275,3,0,1,437760,3,8643531711
10840,275510979,132704047,408215026,0,0,1,24064,10,7069688781
10841,275511670,109103591,384615261,0,0,0,389120,10,10568053200
10842,275512690,108983988,384496678,3,0,0,76288,3,6977804340
10843,275562280,132660662,408222942,6,0,1,7680,7,7810543546
10844,275628059,132624073,408252132,0,0,1,3584,10,2910175768
10845,275635799,132616356,408252155,0,0,1,23040,10,8109384159
10846,275667610,109120350,384787960,3,0,0,213504,3,5823631473
10847,275674550,132577628,408252178,6,0,1,16384,7,5564553170
10848,275695670,109092937,384788607,3,0,0,2048,3,6735200308
10849,275698959,132738806,408437765,0,0,1,29696,10,4587383010
10850,275729850,132707938,408437788,6,0,1,46080,7,9615251791
10851,275750350,132724791,408475141,6,0,1,23552,7,2442457237
10852,275829391,132700552,408529943,9,0,1,6656,17,8068609304
10853,275848309,132681665,408529974,0,0,1,19456,10,7546408303
10854,275851400,109480816,385332216,3,0,0,152064,3,62035994
10855,275907880,109376145,385284025,0,0,0,666112,10,5488785967
10856,275935941,109052623,384988564,2,0,0,2560,4,8872140970
10857,275942651,132587346,408529997,9,0,1,10240,17,2536828708
10858,275983110,108952366,384935476,3,0,0,14848,3,8532988556
10859,276044230,132485790,408530020,6,0,1,25600,7,1025729237
10860,276044580,132486446,408531026,6,0,1,96256,7,6413740667
10861,276081881,132461070,408542951,9,0,1,55296,17,9148904601
10862,276091871,132468323,408560194,9,0,1,9216,17,450266584
10863,276118199,132457765,408575964,0,0,1,27648,10,1677587962
10864,276142481,132437461,408579942,9,0,1,6144,17,140945237
10865,276163801,132416807,408580608,9,0,1,1024,17,6915839406
10866,276190739,109473297,385664036,8,0,0,225280,2,1458538380
10867,276249820,109602466,385852286,0,0,0,171520,10,4035499776
10868,276268630,109248018,385516648,3,0,0,326656,3,6045835477
10869,276276309,109752343,386028652,8,0,0,137216,2,3586048483
10870,276301411,108984197,385285608,2,0,0,5120,4,7275467115
10871,276354130,132232533,408586663,7,0,1,18432,16,8092683386
10872,276447560,132251970,408699530,7,0,1,93184,16,7912508899
10873,276456160,132306286,408762446,7,0,1,38912,16,9706090663
10874,276463320,132299149,408762469,7,0,1,15360,16,8865971933
10875,276485509,132276983,408762492,0,0,1,2048,10,9835149448
10876,276531171,132245095,408776266,9,0,1,14336,17,7290806833
10877,276548011,132228286,408776297,9,0,1,16384,17,5208986640
10878,276599939,109699496,386299435,8,0,0,289280,2,973469979
10879,276603900,109535847,386139747,0,0,0,364544,10,10425200447
10880,276621611,108906909,385528520,2,0,0,5120,4,1782114729
10881,276654941,132121379,408776320,9,0,1,10240,17,2385830492
10882,276693931,108971376,385665307,2,0,0,4096,4,4186937599
10883,276703300,132073043,408776343,6,0,1,1536,7,4586274121
10884,276717021,132161207,408878228,9,0,1,17408,17,7734877502
10885,276720120,109423862,386143982,3,0,0,13824,3,3883086388
10886,276737850,132201896,408939746,7,0,1,29184,16,4651336047
10887,276786170,132155061,408941231,2,0,1,15360,4,4352644757
10888,276797390,132158340,408955730,6,0,1,19968,7,4336438692
10889,276822580,132776080,409598660,7,0,1,32768,16,8762858357
10890,276832229,109485013,386317242,8,0,0,58368,2,565272748
10891,276840050,109052309,385892359,3,0,0,34304,3,3165695783
10892,276861070,109790711,386651781,0,0,0,131072,10,9482907772
10893,276871501,132737760,409609261,9,0,1,13824,17,5680103920
10894,276879050,132909574,409788624,7,0,1,38400,16,6399474454
10895,276888430,132927741,409816171,2,0,1,19456,4,8636419243
10896,276908841,132912797,409821638,9,0,1,16384,17,759634549
10897,276909790,132913794,409823584,2,0,1,3072,4,9857413360
10898,276981691,132902251,409883942,9,0,1,19456,17,8713205192
10899,277074251,132809714,409883965,9,0,1,1536,17,1509602998
10900,277074619,132809369,409883988,4,0,1,33792,2,23849943
10901,277124900,133037654,410162554,3,0,1,207360,3,1092900550
10902,277126720,133035857,410162577,7,0,1,2048,16,688922295
10903,277132200,108854621,385986821,9,0,0,97280,17,6081935997
10904,277177840,133140315,410318155,2,0,1,60928,4,747152234
10905,277193920,133150801,410344721,7,0,1,40448,16,9011135703
10906,277221740,133130827,410352567,7,0,1,512,16,6483867455
10907,277248940,109879803,387128743,3,0,0,484864,3,5820616979
10908,277265370,109937653,387203023,3,0,0,84992,3,244432941
10909,277265629,109344358,386609987,8,0,0,155648,2,7377143370
10910,277270250,109382334,386652584,3,0,0,2560,3,4618977279
10911,277271850,109193381,386465231,3,0,0,6144,3,5420545360
10912,277288120,109502851,386790971,0,0,0,202752,10,10675697288
10913,277299240,109423723,386722963,3,0,0,1024,3,3703350366
10914,277308240,110035885,387344125,0,0,0,294912,10,37499551
10915,277340800,133011790,410352590,2,0,1,37888,4,5481384650
10916,277360830,109619667,386980497,0,0,0,31232,10,8306151402
10917,277373809,109592743,386966552,8,0,0,45056,2,857753236
10918,277396130,109395644,386791774,3,0,0,2560,3,6257186996
10919,277483950,109401369,386885319,3,0,0,2560,3,10459003056
10920,277486379,132866250,410352629,4,0,1,20480,2,5403989867
10921,277489749,109718464,387208213,8,0,0,5120,2,815289050
10922,277511921,109469067,386980988,2,0,0,1536,4,3314259862
10923,277537210,109602336,387139546,0,0,0,35328,10,4319588091
10924,277576329,132776323,410352652,4,0,1,2560,2,7705894673
10925,277692940,132659735,410352675,7,0,1,3584,16,10176174052
10926,277693399,132707925,410401324,4,0,1,52224,2,7636888520
10927,277846430,132655885,410502315,7,0,1,34304,16,7600664969
10928,277852210,132650128,410502338,5,0,1,15360,11,9015100884
10929,277889661,109458566,387348227,2,0,0,8704,4,9279531105
10930,277899250,109446302,387345552,3,0,0,4608,3,850703807
10931,277922169,132580192,410502361,4,0,1,26112,2,7508656008
10932,277930260,109523778,387454038,3,0,0,4096,3,1231713618
10933,277932101,132605190,410537291,9,0,1,7168,17,4083922326
10934,277947780,132657274,410605054,7,0,1,23552,16,7402713661
10935,277996920,132614036,410610956,7,0,1,20992,16,9032514146
10936,278022280,109668320,387690600,3,0,0,4608,3,6869457637
10937,278060990,132688781,410749771,7,0,1,8704,16,9156054351
10938,278063140,132893419,410956559,7,0,1,8704,16,9710051096
10939,278066461,133084471,411150932,9,0,1,37888,17,5811640640
10940,278075751,133075204,411150955,9,0,1,1024,17,1579547141
10941,278145049,133005929,411150978,4,0,1,2048,2,2344962285
10942,278169370,109700141,387869511,3,0,0,10752,3,4579323539
10943,278253830,132897171,411151001,7,0,1,6144,16,9950606968
10944,278272571,109767317,388039888,2,0,0,1536,4,670113857
10945,278275420,133171564,411446984,3,0,1,263680,3,7333709870
10946,278283810,133163688,411447498,7,0,1,59392,16,2208024535
10947,278308860,109695379,388004239,3,0,0,4096,3,7499836262
10948,278316961,109733380,388050341,2,0,0,1536,4,7212384141
10949,278330020,133117501,411447521,7,0,1,1024,16,7447635428
10950,278345631,133101913,411447544,9,0,1,7680,17,4483507591
10951,278355170,133109143,411464313,7,0,1,34304,16,2394380673
10952,278368710,133095626,411464336,7,0,1,11264,16,5197074250
10953,278421250,133043109,411464359,7,0,1,20992,16,10329793085
10954,278445871,109675414,388121285,2,0,0,1536,4,1219204565
10955,278495021,132969393,411464414,9,0,1,33280,17,5183056113
10956,278496589,110077913,388574502,8,0,0,60928,2,1608353931
10957,278547760,109514996,388062756,3,0,0,4096,3,8715936190
10958,278559250,132905187,411464437,7,0,1,10752,16,7385700989
10959,278568689,109635871,388204560,8,0,0,169472,2,6542949977
10960,278625480,109665030,388290510,0,0,0,144384,10,7161492949
10961,278662919,109666915,388329834,8,0,0,112128,2,8507080668
10962,278670970,132925285,411596255,3,0,1,225792,3,10064123906
10963,278677549,109657791,388335340,8,0,0,17920,2,3902072325
10964,278685390,110055584,388740974,0,0,0,36352,10,7784326067
10965,278690979,109798204,388489183,8,0,0,26112,2,9751061018
10966,278705391,132911315,411616706,9,0,1,22016,17,1049471981
10967,278713821,109529231,388243052,2,0,0,3584,4,10718209980
10968,278766840,132869064,411635904,6,0,1,35840,7,320225544
10969,278795951,132841259,411637210,9,0,1,2048,17,10349094274
10970,278835560,109995016,388830576,0,0,0,189440,10,731355016
10971,278860520,109780613,388641133,0,0,0,9216,10,9683569623
10972,278890620,132751096,411641716,6,0,1,7168,7,629093788
10973,278950310,133310866,412261176,3,0,1,186880,3,3520398010
10974,278962010,133299197,412261207,5,0,1,31744,11,2327764540
10975,278965530,109539913,388505443,0,0,0,3584,10,6297939687
10976,278971001,109234229,388205230,2,0,0,2048,4,5992220873
10977,278984390,133276840,412261230,3,0,1,26624,3,3181492991
10978,278991160,133376907,412368067,6,0,1,22528,7,3737227929
10979,278992919,109727678,388720597,8,0,0,235008,2,9270850956
10980,279047540,110200703,389248243,6,0,0,164864,7,6346622708
10981,279073910,133294180,412368090,6,0,1,9728,7,5935618581
10982,279142911,109626388,388769299,2,0,0,512,4,1053537596
10983,279157280,109424577,388581857,0,0,0,24064,10,9859053987
10984,279199660,133168461,412368121,6,0,1,13312,7,7728403391
10985,279214950,109824744,389039694,0,0,0,90112,10,198480941
10986,279259510,133163881,412423391,3,0,1,101376,3,2620089938
10987,279285050,133146565,412431615,3,0,1,91136,3,1577455868
10988,279296120,133270219,412566339,6,0,1,6144,7,2073802522
10989,279297101,109344467,388641568,2,0,0,1024,4,9528902309
10990,279297450,109900469,389197919,0,0,0,237056,10,3236868583
10991,279355429,110040889,389396318,8,0,0,485888,2,5649370432
10992,279392760,133173602,412566362,6,0,1,13312,7,6861777484
10993,279453430,133114070,412567500,3,0,1,175616,3,5586358781
10994,279494300,133073223,412567523,3,0,1,59904,3,5031414178
10995,279645130,132934276,412579406,3,0,1,37888,3,4493121876
10996,279713440,132895030,412608470,6,0,1,27136,7,5163733374
10997,279726430,132885586,412612016,6,0,1,5632,7,6148380652
10998,279737211,109787408,389524619,2,0,0,1536,4,9961847239
10999,279770150,132923096,412693246,3,0,1,89600,3,906696266
11000,279853430,132903074,412756504,3,0,1,86016,3,7790172758
11001,279947009,109577119,389524128,8,0,0,419328,2,3836040205
11002,279960790,132799260,412760050,6,0,1,5632,7,7007963306
11003,279978040,132899199,412877239,2,0,1,10752,4,9093948849
11004,279979840,133598912,413578752,3,0,1,342528,3,736523534
11005,279988299,109588562,389576861,8,0,0,21504,2,8753914978
11006,280087939,109448917,389536856,8,0,0,38400,2,3437187636
11007,280184990,133490840,413675830,5,0,1,9728,11,9115918197
11008,280215790,133460063,413675853,3,0,1,29184,3,4689478233
11009,280217960,133457916,413675876,6,0,1,16896,7,921616914
11010,280255680,133420219,413675899,5,0,1,29696,11,4328126711
11011,280389911,109135199,389525110,2,0,0,1536,4,9078298838
11012,280393199,109544895,389938094,8,0,0,117760,2,9423233980
11013,280430909,109396744,389827653,8,0,0,209920,2,7960359815
11014,280433340,133242582,413675922,6,0,1,3072,7,7914434977
11015,280462739,109980417,390443156,8,0,0,475648,2,7266767527
11016,280508450,133167495,413675945,6,0,1,7168,7,3225541826
11017,280524239,109362296,389886535,8,0,0,124928,2,9124674088
11018,280532899,109037387,389570286,8,0,0,109568,2,8345789018
11019,280549441,109391640,389941081,2,0,0,9728,4,8486828823
11020,280564910,109576369,390141279,0,0,0,70656,10,8073505717
11021,280588990,110088905,390677895,0,0,0,350208,10,9280033674
11022,280616061,133059907,413675968,9,0,1,6144,17,5441104364
11023,280681970,132994021,413675991,2,0,1,13824,4,2233811219
11024,280691680,110008403,390700083,0,0,0,23552,10,2993877676
11025,280730471,109019912,389750383,2,0,0,3072,4,5043101047
11026,280730920,109805391,390536311,0,0,0,305664,10,5077780735
11027,280755060,132920954,413676014,6,0,1,31232,7,8262360710
11028,280761891,109182489,389944380,2,0,0,10752,4,428560738
11029,280806041,110044507,390850548,2,0,0,2048,4,3740112606
11030,280822260,132853777,413676037,2,0,1,18944,4,2629957217
11031,280861160,132814900,413676060,7,0,1,4096,16,5876865730
11032,280881550,132794533,413676083,2,0,1,512,4,10637179694
11033,280884431,109652995,390537426,2,0,0,3584,4,2418666006
11034,280995369,109575799,390571168,8,0,0,105472,2,3789798863
11035,281013490,132662616,413676106,2,0,1,7168,4,1551404944
11036,281015231,109523778,390539009,2,0,0,5120,4,7863742619
11037,281043099,109649639,390692738,8,0,0,48640,2,10302098292
11038,281067740,109673563,390741303,0,0,0,134656,10,3128163155
11039,281160639,109878843,391039482,8,0,0,258048,2,3258398405
11040,281214119,109889704,391103823,8,0,0,206848,2,6770866909
11041,281247470,132428659,413676129,6,0,1,7168,7,8186720240
11042,281257449,110150346,391407795,8,0,0,233472,2,906618624
11043,281286680,132389472,413676152,2,0,1,37376,4,9489544847
11044,281291999,110469663,391761662,8,0,0,36352,2,2227950826
11045,281330959,111065157,392396116,8,0,0,999936,2,5087737683
11046,281346680,132329495,413676175,6,0,1,7680,7,3576541500
11047,281442260,132242612,413684872,5,0,1,18944,11,1426380114
11048,281451540,109784662,391236202,0,0,0,119296,10,5138492739
11049,281469510,110474291,391943801,0,0,0,175104,10,2629981499
11050,281503510,132182668,413686178,2,0,1,2048,4,1628553418
11051,281559570,132128093,413687663,6,0,1,15360,7,3090744545
11052,281576609,132113640,413690249,1,0,1,4096,5,3059718419
11053,281607660,132083895,413691555,6,0,1,2048,7,1325260639
11054,281616430,132076751,413693181,5,0,1,2560,11,8805912943
11055,281635780,132062547,413698327,6,0,1,8192,7,3392998589
11056,281638360,132061043,413699403,5,0,1,13312,11,6111231450
11057,281652101,109609585,391261686,2,0,0,2048,4,6471688156
11058,281688341,109985628,391673969,2,0,0,8192,4,9752246091
11059,281694220,132008102,413702322,5,0,1,15872,11,9892997059
11060,281732070,109801804,391533874,0,0,0,70656,10,5042454883
11061,281735740,131966736,413702476,6,0,1,8704,7,4092386015
11062,281761461,109279315,391040776,2,0,0,4096,4,9743542988
11063,281802429,110659417,392461846,8,0,0,215552,2,9414221405
11064,281836479,131870183,413706662,1,0,1,6656,5,7719041886
11065,281864031,110200105,392064136,2,0,0,2048,4,5938419160
11066,281902231,108995002,390897233,2,0,0,3584,4,1589919405
11067,281923610,131807399,413731009,2,0,1,40960,4,156332133
11068,281927339,131809252,413736591,1,0,1,15872,5,8631054785
11069,281984931,109972894,391957825,2,0,0,5632,4,5662356865
11070,282013780,109721539,391735319,0,0,0,41472,10,9631051945
11071,282048610,131688327,413736937,6,0,1,512,7,6503066655
11072,282048800,131689763,413738563,2,0,1,2560,4,5049527037
11073,282054680,110441064,392495744,0,0,0,111104,10,6483246842
11074,282086509,131654957,413741466,1,0,1,20992,5,4435028493
11075,282121440,131622893,413744333,6,0,1,11264,7,2543695591
11076,282133119,131618957,413752076,1,0,1,2048,5,5922957824
11077,282249360,110332706,392582066,0,0,0,273920,10,3920624507
11078,282255029,131499953,413754982,1,0,1,4608,5,8560009104
11079,282346370,131445970,413792340,2,0,1,37376,4,4927417677
11080,282361220,131438859,413800079,6,0,1,6656,7,5620939079
11081,282466710,131349699,413816409,2,0,1,31744,4,6985077500
11082,282494029,110473241,392967270,8,0,0,295936,2,8489504571
11083,282535820,110279908,392815728,0,0,0,349184,10,797148823
11084,282552370,131358724,413911094,2,0,1,57856,4,10358146596
11085,282649060,110192431,392841491,0,0,0,84480,10,4983633130
11086,282683510,132248240,414931750,6,0,1,136704,7,9269930033
11087,282687759,110385155,393072914,8,0,0,160256,2,230916045
11088,282694879,110181735,392876614,8,0,0,115200,2,2888676236
11089,282722279,132209494,414931773,1,0,1,3072,5,5489725947
11090,282728021,109244161,391972182,2,0,0,6144,4,6071808340
11091,282730240,132241998,414972238,2,0,1,34304,4,1972922073
11092,282801250,132176868,414978118,3,0,1,2048,3,210783591
11093,282844561,109654022,392498583,2,0,0,9216,4,7125816806
11094,282950601,132032955,414983556,9,0,1,10240,17,5061345002
11095,282967509,110234998,393202507,8,0,0,282112,2,9841373346
11096,282967779,132036756,415004535,1,0,1,11264,5,1105613263
11097,282979970,110535425,393515395,0,0,0,185856,10,3211920324
11098,283011459,110105069,393116528,8,0,0,19456,2,4862892647
11099,283021829,131982729,415004558,1,0,1,9728,5,3635218441
11100,283040671,131965132,415005803,9,0,1,4096,17,8238088797
11101,283060371,110142635,393203006,2,0,0,1536,4,6430398166
11102,283096570,110632689,393729259,0,0,0,382464,10,2000938655
11103,283111899,110194448,393306347,8,0,0,338944,2,2615866735
11104,283127500,132010296,415137796,3,0,1,32256,3,963679815
11105,283130770,132007826,415138596,3,0,1,115200,3,2427276151
11106,283150769,132146294,415297063,0,0,1,17408,10,5310357378
11107,283161020,109827379,392988399,0,0,0,69120,10,10477401562
11108,283171909,132125177,415297086,1,0,1,1536,5,4279467513
11109,283190579,110130783,393321362,8,0,0,49152,2,5538510182
11110,283258381,110162684,393421065,2,0,0,512,4,3703906656
11111,283281461,109708521,392989982,2,0,0,5120,4,9880026713
11112,283284140,132015199,415299339,3,0,1,43520,3,5638248797
11113,283315720,131983642,415299362,6,0,1,1024,7,6474526518
11114,283354350,131945035,415299385,6,0,1,15360,7,2159450419
11115,283367459,110437395,393804854,8,0,0,167424,2,6195289689
11116,283367970,131994666,415362636,6,0,1,37888,7,4536011802
11117,283439320,131923339,415362659,6,0,1,8704,7,75371158
11118,283464240,131943739,415407979,6,0,1,77824,7,2288942463
11119,283477679,131948187,415425866,0,0,1,7680,10,2456724715
11120,283486279,132095700,415581979,0,0,1,44032,10,10527422477
11121,283511459,110100927,393612386,8,0,0,317952,2,3138522675
11122,283590620,131991382,415582002,5,0,1,5632,11,1671691746
11123,283600240,131981785,415582025,6,0,1,4608,7,2749093586
11124,283613469,131968579,415582048,1,0,1,20992,5,5986430040
11125,283634570,131979752,415614322,3,0,1,88064,3,8947343165
11126,283693180,131937788,415630968,3,0,1,64512,3,2148026518
11127,283754460,131894869,415649329,2,0,1,7168,4,8327756595
11128,283766650,132021241,415787891,3,0,1,116224,3,5806221121
11129,283806649,131981265,415787914,0,0,1,2048,10,8496681384
11130,283864661,109484757,393349418,2,0,0,512,4,4345187614
11131,283884611,109844919,393729530,2,0,0,512,4,1692234706
11132,283932349,131855588,415787937,0,0,1,23040,10,6170589332
11133,283950699,131837261,415787960,0,0,1,11264,10,450568243
11134,284126600,131661383,415787983,5,0,1,36352,11,5447964409
11135,284144519,109600478,393744997,8,0,0,50688,2,9672568844
11136,284163741,109590038,393753779,2,0,0,16896,4,5066025814
11137,284184890,131603116,415788006,3,0,1,41984,3,7411375289
11138,284201620,131616456,415818076,3,0,1,107008,3,360509157
11139,284210529,131634172,415844701,0,0,1,28672,10,9680583516
11140,284215269,131658185,415873454,0,0,1,17920,10,2036927040
11141,284286851,109325784,393612635,2,0,0,512,4,1946880423
11142,284305480,109443128,393748608,0,0,0,11776,10,9608324770
11143,284334910,131540170,415875080,5,0,1,2560,11,976026909
11144,284374850,131609795,415984645,3,0,1,195584,3,1876313477
11145,284376109,131733486,416109595,0,0,1,40448,10,3232715587
11146,284377341,109598900,393976241,2,0,0,4096,4,5926504646
11147,284393760,110214779,394608539,0,0,0,779264,10,9620486314
11148,284419250,131825084,416244334,3,0,1,121344,3,2044157333
11149,284445429,109925655,394371084,8,0,0,260096,2,7823441110
11150,284459690,131787870,416247560,5,0,1,5120,11,3872274747
11151,284515939,131733247,416249186,1,0,1,2560,5,2599688829
11152,284565420,131846160,416411580,3,0,1,190976,3,2034659868
11153,284573330,131838273,416411603,3,0,1,29696,3,3343732105
11154,284576901,110086763,394663664,2,0,0,4608,4,9629009649
11155,284612860,132093726,416706586,8,0,1,659968,2,4272617959
11156,284634350,132074808,416709158,5,0,1,3584,11,8062219711
11157,284666309,109995882,394662191,8,0,0,135680,2,5963380238
11158,284714690,109571847,394286537,0,0,0,37888,10,10720077833
11159,284721011,109342661,394063672,2,0,0,3072,4,729197740
11160,284770801,131939433,416710234,9,0,1,13312,17,10419454359
11161,284812380,109808448,394620828,0,0,0,35840,10,9881697679
11162,284827211,109782627,394609838,2,0,0,3584,4,4643735551
11163,284834719,109870400,394705119,8,0,0,135680,2,9509443652
11164,284838680,131904015,416742695,5,0,1,17408,11,9164651316
11165,284841211,131905297,416746508,9,0,1,18432,17,7155812694
11166,284945340,132061084,417006424,3,0,1,579072,3,9676114784
11167,284980551,132107967,417088518,9,0,1,68096,17,1309489894
11168,285003729,109816665,394820394,8,0,0,211968,2,10612041092
11169,285007081,132119854,417126935,9,0,1,36864,17,4642758053
11170,285026131,132102430,417128561,9,0,1,2560,17,6996700994
11171,285131170,109624617,394755787,0,0,0,165376,10,10335637588
11172,285169720,132211242,417380962,8,0,1,376320,2,2619425143
11173,285184010,132196975,417380985,3,0,1,124416,3,2041511191
11174,285194670,132231493,417426163,3,0,1,118272,3,7632046353
11175,285205560,132315553,417521113,3,0,1,221184,3,3942680739
11176,285236680,132415657,417652337,8,0,1,324096,2,5588509054
11177,285268231,109437145,394705376,2,0,0,512,4,2434400333
11178,285294510,132608483,417902993,8,0,1,568320,2,10692813838
11179,285310870,132597615,417908485,5,0,1,17920,11,7307837106
11180,285340130,132682566,418022696,3,0,1,276480,3,3675273442
11181,285363639,110007702,395371341,8,0,0,217088,2,8487232509
11182,285375019,110601558,395976577,8,0,0,101376,2,3306793584
11183,285401549,109534554,394936103,8,0,0,1024,2,7549584469
11184,285427780,132597637,418025417,5,0,1,3072,11,1838234043
11185,285443079,109492689,394935768,8,0,0,72704,2,9668392113
11186,285491120,110304034,395795154,0,0,0,195584,10,9713788319
11187,285503969,111028527,396532496,8,0,0,492032,2,3065630130
11188,285557309,110569538,396126847,8,0,0,30720,2,6370719931
11189,285591769,109613411,395205180,8,0,0,82944,2,5861511506
11190,285591801,109972733,395564534,2,0,0,1024,4,7384636992
11191,285592180,132446800,418038980,2,0,1,25600,4,8222965527
11192,285598210,132443676,418041886,5,0,1,4608,11,3860435688
11193,285605360,132438274,418043634,2,0,1,9216,4,9536883705
11194,285608100,132445186,418053286,2,0,1,15360,4,7900169038
11195,285615249,109648755,395264004,8,0,0,23552,2,5325209046
11196,285685530,132368986,418054516,3,0,1,22016,3,1961926863
11197,285749450,132308574,418058024,2,0,1,14336,4,8935236212
11198,285773570,110864223,396637793,0,0,0,238080,10,4515624451
11199,285824999,132251475,418076474,1,0,1,33792,5,6341682977
11200,285881821,109943595,395825416,2,0,0,1024,4,4124452848
11201,285997540,132082045,418079585,2,0,1,17920,4,2453514170
11202,286043791,132054439,418098230,9,0,1,30720,17,4798371251
11203,286065439,109668136,395733575,8,0,0,43520,2,1975448891
11204,286071550,132050735,418122285,5,0,1,37888,11,5796332451
11205,286075780,132047273,418123053,5,0,1,11776,11,7641953965
11206,286075879,132054906,418130785,1,0,1,12288,5,9685476908
11207,286083460,132049271,418132731,2,0,1,25600,4,7444688614
11208,286113910,110783870,396897780,0,0,0,534528,10,7046636285
11209,286122879,111056395,397179274,8,0,0,178176,2,8646189212
11210,286123510,132011950,418135460,2,0,1,11264,4,6896036923
11211,286144760,110944808,397089568,0,0,0,487936,10,6317839
11212,286158520,132046047,418204567,3,0,1,139264,3,7952156753
11213,286165331,132040721,418206052,9,0,1,15360,17,1233168002
11214,286165631,132046476,418212107,9,0,1,18432,17,7246000603
11215,286165780,110382252,396548032,0,0,0,50688,10,7005406791
11216,286249750,131976168,418225918,5,0,1,49152,11,1919481881
11217,286250090,132070095,418320185,3,0,1,162304,3,5617117086
11218,286283050,132170670,418453720,3,0,1,136192,3,1050549646
11219,286341491,132126540,418468031,9,0,1,7680,17,2417561238
11220,286345050,132125875,418470925,5,0,1,17920,11,6335233374
11221,286353911,132126624,418480535,9,0,1,27648,17,7086030492
11222,286367631,132115779,418483410,9,0,1,9216,17,4962751746
11223,286389790,132104342,418494132,2,0,1,29184,4,6473381895
11224,286429651,132065352,418495003,9,0,1,12288,17,1342115038
11225,286508590,131993286,418501876,5,0,1,4096,11,852494251
11226,286513870,131993152,418507022,2,0,1,8192,4,5016470492
11227,286577719,110761232,397338951,8,0,0,198656,2,2370622836
11228,286604480,132010861,418615341,3,0,1,98304,3,9358417839
11229,286619050,132232257,418851307,3,0,1,330752,3,3125298706
11230,286622840,132228490,418851330,5,0,1,11776,11,2724494385
11231,286657109,110935931,397593040,8,0,0,278016,2,5692736354
11232,286663991,110234303,396898294,2,0,0,1536,4,4378477293
11233,286704310,132147043,418851353,3,0,1,44032,3,6250527754
11234,286737320,110372792,397110112,0,0,0,17920,10,6530141233
11235,286834530,132036957,418871487,3,0,1,70656,3,222243803
11236,286843189,110584700,397427889,8,0,0,257536,2,9617279377
11237,286865981,132006492,418872473,9,0,1,1536,17,5783580600
11238,286933540,132076143,419009683,3,0,1,333312,3,2557369557
11239,286940870,110323965,397264835,0,0,0,107520,10,4947199709
11240,286960041,132067532,419027573,9,0,1,35328,17,5751651295
11241,287007020,132324673,419331693,3,0,1,651776,3,97222920
11242,287030280,132310244,419340524,3,0,1,19968,3,2117541320
11243,287032111,132314180,419346291,9,0,1,23040,17,7117146694
11244,287112221,132248623,419360844,9,0,1,16896,17,5602764405
11245,287127660,132240276,419367936,5,0,1,22528,11,9440634163
11246,287134610,132233672,419368282,5,0,1,512,11,942113634
11247,287149340,132240534,419389874,3,0,1,77824,3,8075875997
11248,287180320,132310730,419491050,3,0,1,199168,3,9963916259
11249,287199500,110487808,397687308,0,0,0,93184,10,1520319585
11250,287206330,132291275,419497605,3,0,1,22016,3,5047097076
11251,287214750,132292645,419507395,6,0,1,23040,7,519337558
11252,287289679,110649778,397939457,8,0,0,272384,2,8865378351
11253,287302569,110310462,397613031,8,0,0,65536,2,1379568473
11254,287306051,132206170,419512221,9,0,1,7680,17,4551534016
11255,287313331,110300043,397613374,2,0,0,1024,4,8915199304
11256,287319200,132220390,419539590,3,0,1,53248,3,5416460844
11257,287328350,111100108,398428458,0,0,0,201728,10,9808125830
11258,287329790,110733948,398063738,0,0,0,135168,10,5687524688
11259,287338569,110507744,397846313,8,0,0,128000,2,6196373114
11260,287342611,132222972,419565583,9,0,1,70656,17,3090212092
11261,287374020,132192229,419566249,5,0,1,1024,11,9412400257
11262,287378940,132198578,419577518,6,0,1,17408,7,9453955104
11263,287379710,132206473,419586183,6,0,1,4608,7,882559710
11264,287381640,132205926,419587566,6,0,1,14848,7,226639083
11265,287461601,132145460,419607061,9,0,1,35328,17,5107510142
11266,287570960,132039327,419610287,5,0,1,5120,11,8153333764
11267,287592220,132046988,419639208,3,0,1,70144,3,8356023873
11268,287599080,132045313,419644393,5,0,1,16384,11,1552756622
11269,287601910,132042637,419644547,3,0,1,8704,3,10673628103
11270,287605360,132343123,419948483,3,0,1,650752,3,5254260503
11271,287607809,110925228,398533037,8,0,0,91136,2,6933814835
11272,287643750,132306999,419950749,5,0,1,3584,11,7523296434
11273,287647340,132544320,420191660,3,0,1,568832,3,4441237093
11274,287666169,110794627,398460796,8,0,0,23552,2,1144483176
11275,287684620,132531209,420215829,6,0,1,48640,7,444053086
11276,287707780,132557460,420265240,3,0,1,90624,3,4677041436
11277,287740670,110764305,398504975,0,0,0,144896,10,5450425099
11278,287783380,132483282,420266662,5,0,1,13824,11,8151388258
11279,287821210,110632387,398453597,0,0,0,82432,10,7961400129
11280,287861491,110643709,398505200,2,0,0,512,4,8279583621
11281,287881360,132475332,420356692,3,0,1,212480,3,229745408
11282,287896111,132479698,420375809,9,0,1,29184,17,5044124656
11283,287908780,132468015,420376795,5,0,1,1536,11,2301610560
11284,287949379,110369243,398318622,8,0,0,2560,2,8487641790
11285,287986390,132391993,420378383,5,0,1,15872,11,8962362747
11286,288008690,132370039,420378729,5,0,1,512,11,3169361643
11287,288077200,111058804,399136004,0,0,0,155136,10,6549614818
11288,288120490,110625732,398746222,0,0,0,41984,10,4302740251
11289,288121961,132263313,420385274,9,0,1,17408,17,6901267661
11290,288146170,132244304,420390474,5,0,1,18944,11,228726604
11291,288152630,132261128,420413758,6,0,1,16896,7,4945435723
11292,288169231,110764649,398933880,2,0,0,1536,4,8499752842
11293,288257001,132164528,420421529,9,0,1,32768,17,9550349432
11294,288264490,132172243,420436733,6,0,1,27136,7,2416468780
11295,288281201,110591688,398872889,2,0,0,4608,4,4840306013
11296,288295490,132151514,420447004,6,0,1,12288,7,9544161350
11297,288317190,110771500,399088690,0,0,0,228864,10,138471040
11298,288332810,110892056,399224866,0,0,0,145920,10,1886147418
11299,288349190,132098275,420447465,2,0,1,10240,4,8947221126
11300,288373281,110594102,398967383,2,0,0,1536,4,7382740421
11301,288413700,132055999,420469699,5,0,1,48128,11,4963129301
11302,288440130,132031323,420471453,5,0,1,13312,11,3575804648
11303,288473430,132003720,420477150,5,0,1,19968,11,6177878990
11304,288485489,110694717,399180206,8,0,0,144896,2,4322175868
11305,288509110,131972866,420481976,6,0,1,7680,7,5345889099
11306,288523561,110740033,399263594,2,0,0,15360,4,3085788025
11307,288588171,131897351,420485522,9,0,1,5632,17,2020712276
11308,288608050,131881018,420489068,5,0,1,5632,11,4255536313
11309,288634290,131866899,420501189,5,0,1,23552,11,10059534676
11310,288676280,131832344,420508624,6,0,1,512,7,5793733292
11311,288697040,131914362,420611402,3,0,1,221184,3,6305217324
11312,288709661,110650583,399360244,2,0,0,5120,4,7658601898
11313,288719171,131894607,420613778,9,0,1,14336,17,27737123
11314,288734890,131959608,420694498,3,0,1,172544,3,10615525827
11315,288830659,110698426,399529085,8,0,0,135680,2,4863067030
11316,288847530,131872361,420719891,3,0,1,41472,3,2207209847
11317,288854210,131872403,420726613,6,0,1,39936,7,6512282403
11318,288870660,131861739,420732399,6,0,1,21504,7,1572978436
11319,288895919,110833164,399729083,8,0,0,261632,2,7631862938
11320,288931900,110620140,399552040,0,0,0,75264,10,9501267340
11321,289017031,131726045,420743076,9,0,1,25088,17,3849881040
11322,289054550,131730575,420785125,6,0,1,70144,7,4987077861
11323,289061710,131771264,420832974,8,0,1,102400,2,8874668378
11324,289064581,131772291,420836872,9,0,1,5120,17,7597406907
11325,289105450,131780276,420885726,3,0,1,114176,3,7044461054
11326,289106120,131779862,420885982,6,0,1,9216,7,1192673690
11327,289110290,131801726,420912016,6,0,1,42496,7,10299883313
11328,289117950,131795039,420912989,6,0,1,12800,7,2634742659
11329,289124480,131794871,420919351,3,0,1,30208,3,240465980
11330,289130461,110599425,399729886,2,0,0,2560,4,1872040381
11331,289153121,131776271,420929392,9,0,1,1536,17,2288357592
11332,289201251,131728295,420929546,9,0,1,8704,17,395753298
11333,289231490,131703202,420934692,6,0,1,8192,7,1407885992
11334,289278750,131689473,420968223,3,0,1,83968,3,10303348398
11335,289296399,110558912,399855311,8,0,0,121344,2,3294957219
11336,289311480,131677972,420989452,6,0,1,26112,7,6282803982
11337,289368561,110062839,399431400,2,0,0,512,4,3928200630
11338,289370431,131624652,420995083,9,0,1,25088,17,8801081995
11339,289374330,131631913,421006243,5,0,1,10752,11,10333089474
11340,289412920,131602634,421015554,6,0,1,15360,7,8577314882
11341,289423421,110007800,399431221,2,0,0,6144,4,3370683619
11342,289431430,131632733,421064163,3,0,1,78336,3,5645183278
11343,289435979,110203342,399639321,8,0,0,10752,2,4362299250
11344,289436311,131628211,421064522,9,0,1,9728,17,2307020430
11345,289509839,110819797,400329636,8,0,0,79872,2,5467974504
11346,289512370,110569058,400081428,0,0,0,360960,10,4098466652
11347,289543480,131525894,421069374,6,0,1,7680,7,9192846997
11348,289575270,110612220,400187490,0,0,0,347648,10,2970259406
11349,289630020,131442516,421072536,3,0,1,13824,3,170586606
11350,289636450,131447133,421083583,5,0,1,28160,11,8628328181
11351,289697430,131391747,421089177,5,0,1,18432,11,7750716057
11352,289720530,131499439,421219969,3,0,1,169472,3,10257628956
11353,289724871,110464763,400189634,2,0,0,6656,4,1943857878
11354,289759701,131460832,421220533,9,0,1,10752,17,8744694394
11355,289781830,131462587,421244417,5,0,1,16896,11,3992702211
11356,289826529,110671335,400497864,8,0,0,203264,2,9361625824
11357,289878811,131374359,421253170,9,0,1,18432,17,9956181190
11358,289897150,131359745,421256895,5,0,1,5632,11,7281548649
11359,289898620,110692335,400590955,0,0,0,187392,10,317881659
11360,289939849,131318711,421258560,0,0,1,25088,10,9436527560
11361,289940350,131326672,421267022,6,0,1,26112,7,2107482194
11362,290029160,131286638,421315798,3,0,1,99840,3,9606858682
11363,290048890,131268393,421317283,3,0,1,15360,3,6354134450
11364,290087191,110198458,400285649,2,0,0,1024,4,612576519
11365,290132670,131405871,421538541,3,0,1,422400,3,4760427128
11366,290141551,110449739,400591290,2,0,0,1024,4,10099999426
11367,290194190,110736806,400930996,0,0,0,221184,10,570276972
11368,290219230,131344561,421563791,3,0,1,78848,3,2752548676
11369,290219609,110639535,400859144,8,0,0,507904,2,1786093920
11370,290227540,131339797,421567337,6,0,1,5632,7,9492515846
11371,290231380,131338903,421570283,5,0,1,9216,11,9843444471
11372,290249009,131321397,421570406,0,0,1,1024,10,596769206
11373,290360719,131210673,421571392,0,0,1,1536,10,4594713319
11374,290397070,131191905,421588975,6,0,1,48640,7,10573043832
11375,290441799,110150294,400592093,8,0,0,2560,2,2289366985
11376,290483360,131197763,421681123,3,0,1,208896,3,4873987558
11377,290507489,131180213,421687702,0,0,1,10240,10,4174192677
11378,290532769,131156515,421689284,0,0,1,1024,10,7525259682
11379,290574420,131313751,421888171,3,0,1,426496,3,9592192447
11380,290575110,131313625,421888735,6,0,1,10752,7,2212156160
11381,290605080,110258455,400863535,0,0,0,14336,10,10087534610
11382,290609181,109998311,400607492,2,0,0,4608,4,5946665408
11383,290649390,131245797,421895187,6,0,1,10240,7,3461158480
11384,290714081,110289005,401003086,2,0,0,6144,4,6923074651
11385,290804770,131100108,421904878,6,0,1,23552,7,9274276654
11386,290813709,131095035,421908744,0,0,1,6144,10,5151042581
11387,290856150,131072436,421928586,2,0,1,39936,4,9790271025
11388,290860770,110237214,401097984,0,0,0,168960,10,6123546548
11389,290861100,131074822,421935922,2,0,1,43008,4,6098478911
11390,290865451,109796644,400662095,2,0,0,2048,4,7084291174
11391,290894929,131048463,421943392,0,0,1,10752,10,5027753635
11392,290986580,130960602,421947182,2,0,1,3584,4,7074180642
11393,291049811,109881364,400931175,2,0,0,512,4,612615889
11394,291083121,109848527,400931648,2,0,0,1024,4,5700501688
11395,291194330,130765842,421960172,2,0,1,25088,4,10493223365
11396,291249320,130729429,421978749,5,0,1,52736,11,7944198345
11397,291260469,130727464,421987933,0,0,1,22528,10,6328422353
11398,291262320,109979768,401242088,0,0,0,128512,10,713643996
11399,291264561,109669138,400933699,2,0,0,6656,4,6870911607
11400,291331899,130656700,421988599,0,0,1,1024,10,7865360134
11401,291361180,130637371,421998551,2,0,1,31232,4,1530397963
11402,291401909,130612175,422014084,0,0,1,30720,10,4849542551
11403,291448369,110100768,401549137,8,0,0,132096,2,3977064708
11404,291475790,130561158,422036948,2,0,1,45056,4,8011823055
11405,291483920,130564464,422048384,2,0,1,24576,4,2067143480
11406,291505019,130559015,422064034,1,0,1,32256,5,9953511006
11407,291532071,109494373,401026444,2,0,0,1024,4,8574735731
11408,291559439,109871050,401430489,8,0,0,105984,2,4235445190
11409,291593349,130486226,422079575,0,0,1,21504,10,4539340350
11410,291608500,130476657,422085157,2,0,1,20480,4,3473085009
11411,291702989,110022396,401725385,8,0,0,242688,2,8433819433
11412,291708259,109645211,401353470,8,0,0,76288,2,10373471152
11413,291715751,130379586,422095337,9,0,1,512,17,6268358111
11414,291734159,109465528,401199687,8,0,0,60416,2,10560662229
11415,291773600,130322608,422096208,2,0,1,12288,4,9082287811
11416,291809349,130291391,422100740,0,0,1,7168,10,8084339216
11417,291843911,109609745,401453656,2,0,0,1536,4,1161072354
11418,291856159,109587925,401444084,8,0,0,44544,2,9072110111
11419,291863491,130238017,422101508,9,0,1,11776,17,5619671228
11420,291872260,130237531,422109791,2,0,1,15360,4,2892685889
11421,291880820,130233630,422114450,6,0,1,11264,7,4015125053
11422,291909810,130248151,422157961,2,0,1,73216,4,6837586169
11423,291958281,130219447,422177728,9,0,1,55808,17,2275521877
11424,291980529,130197865,422178394,0,0,1,11264,10,1536066356
11425,291986920,130192140,422179060,2,0,1,11264,4,1830156977
11426,292001191,130187652,422188843,9,0,1,30208,17,6447330613
11427,292063569,130125763,422189332,0,0,1,9728,10,3197084166
11428,292145420,130057989,422203409,2,0,1,5632,4,5066857758
11429,292170459,130033616,422204075,0,0,1,11264,10,39285380
11430,292206760,109654642,401861402,0,0,0,277504,10,1159857041
11431,292210790,130000344,422211134,2,0,1,3584,4,1131351002
11432,292240030,129971770,422211800,6,0,1,11264,7,10135619990
11433,292260780,109761126,402021906,0,0,0,59904,10,4867955281
11434,292267919,109629074,401896993,8,0,0,116736,2,6650194039
11435,292282319,109807158,402089477,8,0,0,221696,2,8438283619
11436,292286280,129940031,422226311,2,0,1,6656,4,3730634047
11437,292293320,129934374,422227694,6,0,1,14848,7,6011401141
11438,292309151,109588021,401897172,2,0,0,512,4,5733669286
11439,292314261,129926414,422240675,9,0,1,53760,17,10006200591
11440,292346651,129913996,422260647,9,0,1,20992,17,3975275549
11441,292356939,129904054,422260993,0,0,1,512,10,4726195818
11442,292368801,109740602,402109403,2,0,0,512,4,8999023067
11443,292377229,129884430,422261659,0,0,1,1024,10,7779968526
11444,292406480,110448457,402854937,0,0,0,43008,10,2240847016
11445,292469039,110489401,402958440,8,0,0,133120,2,1860607918
11446,292481629,110051988,402533617,8,0,0,293888,2,3431260310
11447,292582420,129694739,422277159,6,0,1,35840,7,4659922975
11448,292623529,129654017,422277546,0,0,1,1536,10,7129226960
11449,292636839,110340500,402977339,8,0,0,61952,2,8608747184
11450,292689820,110121470,402811290,0,0,0,128512,10,8018201073
11451,292696519,110144278,402840797,8,0,0,96768,2,7943163706
11452,292739229,129544308,422283537,0,0,1,22528,10,6889699807
11453,292770561,109952010,402722571,2,0,0,512,4,7769724041
11454,292777841,110135738,402913579,2,0,0,8192,4,5288083322
11455,292815099,129483744,422298843,0,0,1,17920,10,1593441228
11456,292818050,129481139,422299189,6,0,1,512,7,746572264
11457,292830959,110330959,403161918,8,0,0,83968,2,5944667468
11458,292862261,109979495,402841756,2,0,0,3072,4,6052078596
11459,292894791,110277930,403172721,2,0,0,1024,4,6119469012
11460,292971401,129332074,422303475,9,0,1,6144,17,4147173218
11461,292972680,110192381,403165061,0,0,0,10240,10,8627664393
11462,292973760,110822992,403796752,0,0,0,24064,10,6835455841
11463,292994819,110415232,403410051,8,0,0,390656,2,8017576926
11464,292999059,129307322,422306381,0,0,1,4608,10,1891388993
11465,293031460,129283166,422314626,6,0,1,29696,7,8652403595
11466,293067570,110709761,403777331,0,0,0,215552,10,9211652211
11467,293087109,129232663,422319772,0,0,1,8192,10,7214586382
11468,293096311,129224447,422320758,9,0,1,1536,17,5635866039
11469,293151761,129196138,422347899,9,0,1,48640,17,4574252141
11470,293156319,110927070,404083389,8,0,0,604160,2,6417703403
11471,293171119,129210618,422381737,4,0,1,38400,2,858624094
11472,293171121,129220614,422391735,9,0,1,25088,17,5223388283
11473,293173971,129239590,422413561,9,0,1,36864,17,9924672817
11474,293255691,129185414,422441105,9,0,1,62464,17,9972220262
11475,293283461,110205322,403488783,2,0,0,1536,4,269404112
11476,293289910,110593744,403883654,0,0,0,109568,10,2961833277
11477,293313290,129171985,422485275,6,0,1,62464,7,8297173702
11478,293333380,129155761,422489141,6,0,1,6144,7,538908019
11479,293446370,110265262,403711632,0,0,0,40448,10,9357451509
11480,293489011,129003356,422492367,9,0,1,5120,17,9597499115
11481,293588460,128905533,422493993,6,0,1,2560,7,3387512103
11482,293721169,110129078,403850247,8,0,0,24576,2,900001526
11483,293721780,110379086,404100866,0,0,0,56832,10,4589424242
11484,293806011,128740980,422546991,9,0,1,93696,17,913981940
11485,293823640,110537969,404361609,0,0,0,155136,10,10052003566
11486,293850820,109938577,403789397,0,0,0,39424,10,2287728914
11487,293868201,128680672,422548873,9,0,1,11776,17,8088923658
11488,293886730,128699879,422586609,6,0,1,68608,7,6106585957
11489,293951891,128650772,422602663,9,0,1,53760,17,70061701
11490,293977599,128626447,422604046,4,0,1,14848,2,7485696270
11491,293978799,128625913,422604712,4,0,1,11264,2,9534650461
11492,293992131,128640077,422632208,9,0,1,16896,17,2510873585
11493,293999040,110430334,404429374,0,0,0,7680,10,6414597241
11494,294007701,128653186,422660887,9,0,1,44032,17,678626327
11495,294023459,128641837,422665296,4,0,1,1024,2,5523091820
11496,294025430,110664172,404689602,0,0,0,309760,10,5913006973
11497,294042009,110768702,404810711,8,0,0,220672,2,10507744005
11498,294067479,128606525,422674004,1,0,1,10240,5,385998158
11499,294076051,128598939,422674990,9,0,1,1536,17,1429167235
11500,294134491,128566442,422700933,9,0,1,47616,17,10607005607
11501,294143819,110334694,404478513,8,0,0,119296,2,5665298003
11502,294149910,128553035,422702945,6,0,1,2560,7,7454080253
11503,294173059,110552727,404725786,8,0,0,47104,2,10623181523
11504,294180770,128528947,422709717,8,0,1,32256,2,2475040376
11505,294211420,110273044,404484464,0,0,0,19456,10,2839140699
11506,294226520,128551837,422778357,6,0,1,4608,7,7156866493
11507,294263840,128529147,422792987,6,0,1,27648,7,7285915472
11508,294295489,128510671,422806160,0,0,1,4096,10,6488450619
11509,294323351,128505540,422828891,9,0,1,38400,17,2331159652
11510,294382439,128461661,422844100,0,0,1,25600,10,7536183353
11511,294407201,110283204,404690405,2,0,0,2560,4,127353492
11512,294470879,128419974,422890853,4,0,1,11264,2,6492395088
11513,294483850,110437713,404921563,0,0,0,363520,10,2807027022
11514,294498401,128440607,422939008,9,0,1,25088,17,9392495406
11515,294502619,128436850,422939469,0,0,1,10240,10,8181741115
11516,294542949,128466138,423009087,0,0,1,71168,10,2853717934
11517,294563061,110029914,404592975,2,0,0,1024,4,2867338417
11518,294565050,110421893,404986943,0,0,0,114176,10,6727106999
11519,294600199,128490992,423091191,1,0,1,68608,5,7946585700
11520,294614579,128493023,423107602,0,0,1,512,10,6006240631
11521,294677931,128430977,423108908,9,0,1,2048,17,6168533584
11522,294680191,128434260,423114451,9,0,1,26112,17,4752492093
11523,294683891,110008692,404692583,2,0,0,1024,4,9999445887
11524,294691991,109889164,404581155,2,0,0,2560,4,10595308212
11525,294699671,128529912,423229583,9,0,1,96768,17,3487579203
11526,294754730,128474876,423229606,6,0,1,19456,7,9370018421
11527,294758671,128573403,423332074,9,0,1,25600,17,5688750491
11528,294801829,128530268,423332097,0,0,1,2048,10,7353103654
11529,294849669,128482451,423332120,4,0,1,17408,2,2600785803
11530,294885099,128447044,423332143,4,0,1,3584,2,289237254
11531,294888139,128444027,423332166,0,0,1,8192,10,2634353261
11532,294889289,128442900,423332189,4,0,1,15872,2,10174523446
11533,294947679,128452437,423400116,0,0,1,37376,10,7789335449
11534,294947820,128485267,423433087,6,0,1,44544,7,841025237
11535,294960850,128983696,423944546,3,0,1,354816,3,9684551387
11536,294972399,110091007,405063406,8,0,0,66048,2,1664919296
11537,294981611,129032822,424014433,9,0,1,11776,17,3468775344
11538,294983240,110220712,405203952,0,0,0,204800,10,3116911295
11539,294999661,129014795,424014456,9,0,1,28160,17,9595934116
11540,295004959,110480974,405485933,8,0,0,212480,2,5483594584
11541,295011301,109911002,404922303,2,0,0,2048,4,4084456398
11542,295056599,128957880,424014479,0,0,1,13824,10,1119738355
11543,295067749,128974267,424042016,4,0,1,1536,2,3694116333
11544,295084509,128957968,424042477,0,0,1,10240,10,4347578309
11545,295121221,128938655,424059876,9,0,1,6144,17,5423330380
11546,295158431,110046271,405204702,2,0,0,1024,4,9342966360
11547,295226841,128851888,424078729,9,0,1,7680,17,477019772
11548,295250971,128832802,424083773,9,0,1,19968,17,5047642066
11549,295272649,128815950,424088599,4,0,1,7680,2,10526166997
11550,295276579,128830372,424106951,1,0,1,42496,5,5946658533
11551,295277841,128911511,424189352,9,0,1,59904,17,359403243
11552,295297339,128892036,424189375,0,0,1,48640,10,8064336442
11553,295338449,128936455,424274904,1,0,1,20480,5,8135480613
11554,295413380,110184764,405598144,0,0,0,34816,10,663059087
11555,295475749,110176706,405652455,8,0,0,178176,2,3896032351
11556,295488881,109997574,405486455,2,0,0,1536,4,4876724691
11557,295540879,110046634,405587513,8,0,0,223232,2,2787032467
11558,295572299,128775030,424347329,1,0,1,39936,5,6797646118
11559,295573630,128773722,424347352,5,0,1,18432,11,3168050192
11560,295587761,128809432,424397193,9,0,1,5120,17,328680732
11561,295614599,110221599,405836198,8,0,0,223232,2,6365797054
11562,295644300,128758734,424403034,2,0,1,36864,4,8512937024
11563,295652191,128751714,424403905,9,0,1,12288,17,750574062
11564,295710611,128778764,424489375,9,0,1,44544,17,3166592562
11565,295718151,128771738,424489889,9,0,1,46080,17,299111868
11566,295731990,110126383,405858373,0,0,0,72704,10,4399635872
11567,295757429,128799043,424556472,1,0,1,50688,5,2462464476
11568,295758449,128798369,424556818,4,0,1,512,2,7309303845
11569,295778871,109629472,405408343,2,0,0,512,4,6012517722
11570,295802169,110240405,406042574,8,0,0,38912,2,426814365
11571,295803871,128757453,424561324,9,0,1,7168,17,10533200775
11572,295807371,128859699,424667070,9,0,1,77312,17,8627886561
11573,295838581,128828512,424667093,9,0,1,17408,17,963247559
11574,295846889,128820227,424667116,1,0,1,3584,5,5040393817
11575,295876909,128790230,424667139,1,0,1,11264,5,3793551238
11576,295896701,128772512,424669213,9,0,1,18944,17,6448099228
11577,296020539,128655246,424675785,0,0,1,8704,10,3276847856
11578,296022149,109844359,405866508,8,0,0,26624,2,7190528996
11579,296025670,110005025,406030695,0,0,0,230400,10,5738428873
11580,296029359,128665833,424695192,1,0,1,16896,5,7438407832
11581,296030369,109730435,405760804,8,0,0,20992,2,2040186753
11582,296036601,109729155,405765756,2,0,0,1024,4,10536836621
11583,296082409,128642393,424724802,0,0,1,34816,10,2693921723
11584,296109501,128618847,424728348,9,0,1,5632,17,8811666367
11585,296126521,109604476,405730997,2,0,0,10240,4,10389587477
11586,296126780,128605754,424732534,2,0,1,6656,4,2639690602
11587,296157511,128607005,424764516,9,0,1,75264,17,4707178306
11588,296176331,109690356,405866687,2,0,0,512,4,8095115083
11589,296183319,128587495,424770814,0,0,1,26112,10,9459597723
11590,296202619,128634579,424837198,1,0,1,25600,5,2484262459
11591,296215810,128621411,424837221,2,0,1,6144,4,3698521482
11592,296223211,128614033,424837244,9,0,1,2560,17,5020945600
11593,296225911,128611535,424837446,9,0,1,11776,17,6756707314
11594,296280999,109918954,406199953,8,0,0,93184,2,7650724412
11595,296287489,128549980,424837469,1,0,1,22016,5,4999036318
11596,296331370,128506122,424837492,2,0,1,32768,4,4154204413
11597,296352259,128488304,424840563,0,0,1,15360,10,10260227830
11598,296363251,128542102,424905353,9,0,1,2048,17,9666547693
11599,296422939,128483080,424906019,0,0,1,1024,10,3060564289
11600,296467909,128445944,424913853,0,0,1,27648,10,4277423162
11601,296496360,109963058,406459418,0,0,0,165376,10,3072943941
11602,296535320,128427316,424962636,2,0,1,10752,4,8517819257
11603,296577510,109758422,406335932,0,0,0,13312,10,9572127210
11604,296582239,110597970,407180209,8,0,0,41472,2,8370474558
11605,296656059,110436358,407092417,8,0,0,719872,2,2716205729
11606,296660970,110506511,407167481,0,0,0,211456,10,711675614
11607,296675079,128294724,424969803,0,0,1,512,10,7994233054
11608,296693459,128317256,425010715,1,0,1,31232,5,5812447946
11609,296708080,128302658,425010738,2,0,1,4608,4,6800998181
11610,296710419,110392588,407103007,8,0,0,34304,2,6442417538
11611,296728411,110008493,406736904,2,0,0,7168,4,10662260778
11612,296748810,110565711,407314521,0,0,0,253952,10,4584468315
11613,296758269,128266271,425024540,0,0,1,27648,10,9680050893
11614,296769610,128335590,425105200,2,0,1,76800,4,8580521754
11615,296774970,128426448,425201418,2,0,1,27136,4,6318767244
11616,296823349,128411749,425235098,0,0,1,35328,10,8731361719
11617,296873200,128365643,425238843,2,0,1,3072,4,491221552
11618,296886749,128389642,425276391,1,0,1,54784,5,4550179515
11619,296944299,128352687,425296986,0,0,1,26624,10,9748023785
11620,296961689,110574730,407536419,8,0,0,431616,2,2138924898
11621,296995429,128303503,425298932,0,0,1,3072,10,4216884059
11622,297001859,128380127,425381986,1,0,1,60416,5,9339680855
11623,297017291,128405092,425422383,9,0,1,28672,17,2046175901
11624,297023949,128420959,425444908,1,0,1,512,5,9177704195
11625,297028109,128419214,425447323,0,0,1,10752,10,7626357643
11626,297063590,128384360,425447950,2,0,1,10240,4,9895293708
11627,297069560,110598773,407668333,7,0,0,89088,16,5944706140
11628,297076831,128417952,425494783,9,0,1,43008,17,8705496173
11629,297082820,128413909,425496729,2,0,1,3072,4,4047238320
11630,297086121,110667473,407753594,2,0,0,105472,4,5322211696
11631,297110810,128512051,425622861,2,0,1,4096,4,2779917060
11632,297137811,110681950,407819761,2,0,0,217088,4,880836481
11633,297144620,128478599,425623219,2,0,1,26624,4,7672187894
11634,297192799,110651009,407843808,8,0,0,78848,2,167220784
11635,297211880,110429286,407641166,0,0,0,231936,10,1597491182
11636,297235839,110973413,408209252,8,0,0,129024,2,6886470815
11637,297242359,110927558,408169917,8,0,0,122368,2,7398515625
11638,297269160,128356133,425625293,2,0,1,39424,4,7776396945
11639,297274359,110821523,408095882,8,0,0,137728,2,4002746598
11640,297294150,111235770,408529920,0,0,0,179712,10,585689243
11641,297371350,110880759,408252109,7,0,0,83456,16,6353298970
11642,297392209,110979990,408372199,8,0,0,388608,2,6218635255
11643,297407810,128217506,425625316,2,0,1,512,4,1490983999
11644,297436190,111001552,408437742,7,0,0,215040,16,9254157690
11645,297436610,110669279,408105889,0,0,0,32768,10,6170355613
11646,297471441,128153898,425625339,9,0,1,26624,17,10191596384
11647,297530611,110944507,408475118,2,0,0,20992,4,8576905639
11648,297548580,128076782,425625362,2,0,1,19456,4,10503448648
11649,297562090,128064924,425627014,2,0,1,26624,4,7935583050
11650,297562781,128064256,425627037,9,0,1,9216,17,1648680219
11651,297578960,110958017,408536977,7,0,0,19456,16,3286506010
11652,297591500,128035560,425627060,2,0,1,16896,4,7724167077
11653,297591829,110876870,408468699,8,0,0,101376,2,352435041
11654,297629340,110913588,408542928,7,0,0,19456,16,75855794
11655,297698929,127928154,425627083,0,0,1,22016,10,4472493775
11656,297709801,110856886,408566687,2,0,0,16384,4,7798547546
11657,297740769,110790210,408530979,8,0,0,3072,2,6768125913
11658,297747190,111029053,408776243,7,0,0,45056,16,1700680215
11659,297761489,127866888,425628377,1,0,1,3072,5,3991208849
11660,297835181,111253594,409088775,2,0,0,164352,4,5160116772
11661,297839661,127788739,425628400,9,0,1,8704,17,4696645678
11662,297842060,110920363,408762423,7,0,0,123904,16,6818090061
11663,297901130,127727587,425628717,2,0,1,9216,4,5319173461
11664,297955321,127674369,425629690,9,0,1,12800,17,967699059
11665,297961960,127678487,425640447,2,0,1,7680,4,1890883205
11666,298016681,127627952,425644633,9,0,1,6656,17,7846556087
11667,298054931,110825071,408880002,2,0,0,1536,4,8145134033
11668,298065319,127608801,425674120,1,0,1,20992,5,2599711037
11669,298067780,127614072,425681852,6,0,1,12288,7,4386002385
11670,298098351,110697347,408795698,2,0,0,5120,4,8140149412
11671,298118499,110797477,408915976,8,0,0,4608,2,3798450904
11672,298157410,127525108,425682518,6,0,1,11264,7,2314892884
11673,298226799,111147664,409374463,8,0,0,68096,2,7349882979
11674,298261690,127428266,425689956,6,0,1,29184,7,5603396139
11675,298377711,110213249,408590960,2,0,0,512,4,9417329053
11676,298449220,127289328,425738548,6,0,1,40960,7,7057223789
11677,298528270,110825422,409353692,0,0,0,193536,10,9040018974
11678,298537799,110929582,409467381,8,0,0,138240,2,6954355213
11679,298571660,110723041,409294701,7,0,0,440832,16,2903596573
11680,298637190,127167843,425805033,2,0,1,68608,4,2744541534
11681,298639571,110252505,408892076,2,0,0,8192,4,6828706824
11682,298642490,111506244,410148734,7,0,0,744448,16,504104553
11683,298647660,127183358,425831018,2,0,1,14848,4,6765020738
11684,298654139,110238116,408892255,8,0,0,512,2,4032648673
11685,298739420,127105372,425844792,2,0,1,26112,4,4614528985
11686,298785230,127064891,425850121,2,0,1,22528,4,2781146957
11687,298813420,127100053,425913473,6,0,1,33280,7,1070291161
11688,298863360,127147514,426010874,2,0,1,30720,4,9476764917
11689,298868320,127159980,426028300,2,0,1,14336,4,1124713015
11690,298882329,111435803,410318132,8,0,0,510464,2,7639773587
11691,298936221,110787378,409723599,2,0,0,1024,4,1999369126
11692,298984589,111177295,410161884,8,0,0,42496,2,10732739836
11693,299058750,127015866,426074616,6,0,1,15872,7,10416434966
11694,299068980,127007902,426076882,2,0,1,3584,4,2177158839
11695,299101099,127021388,426122487,4,0,1,19456,2,8520678096
11696,299103311,110781012,409884323,2,0,0,1024,4,6887395042
11697,299118061,110632192,409750253,2,0,0,4096,4,2870197107
11698,299232930,110650989,409883919,7,0,0,158208,16,6005615339
11699,299239931,110353725,409593656,2,0,0,2048,4,9262280096
11700,299322091,110840440,410162531,2,0,0,2048,4,5581110425
11701,299380970,126742187,426123157,2,0,1,2048,4,1775900115
11702,299425610,126747981,426173591,2,0,1,10752,4,711615639
11703,299428500,110950118,410378618,7,0,0,84992,16,2323338225
11704,299442951,110705962,410148913,2,0,0,512,4,8106340520
11705,299471270,126702344,426173614,2,0,1,9216,4,9082134783
11706,299519080,110229902,409748982,7,0,0,19968,16,9507241470
11707,299547921,110172606,409720527,2,0,0,1024,4,3483724469
11708,299594569,126579068,426173637,1,0,1,3072,5,8033990929
11709,299611539,110733159,410344698,8,0,0,87040,2,1868323840
11710,299628749,126575737,426204486,1,0,1,11776,5,9185871439
11711,299638051,110064477,409702528,2,0,0,512,4,4714757877
11712,299654039,126550806,426204845,1,0,1,9728,5,6269393961
11713,299675260,126540460,426215720,2,0,1,6656,4,10311868463
11714,299678129,126558934,426237063,1,0,1,49152,5,5048854800
11715,299758480,110594064,410352544,7,0,0,25600,16,8589393548
11716,299790400,126468817,426259217,2,0,1,12288,4,10610694813
11717,299792119,126480498,426272617,1,0,1,1024,5,5701950151
11718,299864959,126408004,426272963,1,0,1,512,5,2598147185
11719,299955600,110445669,410401269,7,0,0,74240,16,4335648858
11720,299957210,126316726,426273936,2,0,1,12800,4,2504554896
11721,299957959,126325810,426283769,1,0,1,23552,5,1602929423
11722,299958599,110543685,410502284,8,0,0,297984,2,5561975772
11723,299959009,126420621,426379630,1,0,1,13312,5,10309927395
11724,299994481,110755267,410749748,2,0,0,11264,4,5014603111
11725,300001499,110744794,410746293,8,0,0,379904,2,1741587845
11726,300010620,126370188,426380808,2,0,1,13824,4,10325586964
11727,300081859,126317317,426399176,1,0,1,31744,5,8450309449
11728,300089589,110866947,410956536,8,0,0,340480,2,3933125011
11729,300141630,110395638,410537268,6,0,0,50688,7,9732131883
11730,300181620,126224483,426406103,2,0,1,40960,4,10130257002
11731,300183400,126347294,426530694,2,0,1,34304,4,1654385686
11732,300265029,126265688,426530717,1,0,1,5120,5,9065048976
11733,300303149,110285728,410588877,8,0,0,24576,2,5674333001
11734,300306011,126370271,426676282,9,0,1,16896,17,5699452221
11735,300345689,126338363,426684052,1,0,1,31744,5,825890416
11736,300349659,111063069,411412728,8,0,0,398336,2,147958070
11737,300351400,126356850,426708250,2,0,1,12288,4,1673830662
11738,300372460,110845355,411217815,7,0,0,106496,16,5482223073
11739,300388511,126375331,426763842,9,0,1,24576,17,7931564005
11740,300430461,126409008,426839469,9,0,1,23552,17,1164010813
11741,300445140,126400577,426845717,7,0,1,7680,16,8456863475
11742,300482649,110639845,411122494,8,0,0,295424,2,9428552550
11743,300489780,110695564,411185344,6,0,0,112640,7,8172727166
11744,300521130,126339902,426861032,2,0,1,19968,4,8429109788
11745,300523719,110627190,411150909,8,0,0,93184,2,4229935295
11746,300567149,110879165,411446314,8,0,0,109568,2,4094339927
11747,300567419,126304902,426872321,1,0,1,20992,5,3370269117
11748,300569499,126578103,427147602,1,0,1,57344,5,5710705267
11749,300574579,126665828,427240407,0,0,1,46592,10,304872919
11750,300580460,110418970,410999430,6,0,0,13824,7,3329458610
11751,300606030,126718810,427324840,2,0,1,11776,4,6886101193
11752,300609310,126762765,427372075,2,0,1,5120,4,1263454681
11753,300660670,126711428,427372098,7,0,1,4096,16,3450288378
11754,300667350,126781413,427448763,2,0,1,5120,4,5964389071
11755,300677519,126808776,427486295,0,0,1,24064,10,6240194620
11756,300739341,110708134,411447475,2,0,0,1536,4,4836358427
11757,300761440,110201382,410962822,7,0,0,20480,16,4518721290
11758,300765189,126758413,427523602,1,0,1,15360,5,1196067151
11759,300805429,126792773,427598202,0,0,1,10240,10,2735928716
11760,300823480,126810937,427634417,7,0,1,24064,16,3136422141
11761,300869310,126818695,427688005,7,0,1,16896,16,3285154586
11762,300877989,126810039,427688028,0,0,1,8704,10,3488418011
11763,300918380,127125487,428043867,8,0,1,168448,2,829794239
11764,300920970,110543312,411464282,7,0,0,53760,16,8318848512
11765,300951121,110495840,411446961,2,0,0,2048,4,4922799811
11766,300975781,110472098,411447879,2,0,0,1024,4,2041189604
11767,300978200,110499832,411478032,6,0,0,44544,7,4669675562
11768,300983470,127061780,428045250,7,0,1,14848,16,4925866866
11769,301003550,127080901,428084451,2,0,1,39424,4,2104828440
11770,301004821,110408086,411412907,2,0,0,512,4,10361392180
11771,301021031,127064086,428085117,9,0,1,11264,17,5871463413
11772,301048331,127037742,428086073,9,0,1,512,17,7857290317
11773,301081311,110702911,411784222,2,0,0,1536,4,4797311241
11774,301151019,126936360,428087379,0,0,1,2048,10,427953950
11775,301195470,126905723,428101193,5,0,1,7168,11,5633127283
11776,301236319,111024834,412261153,8,0,0,257024,2,2748526624
11777,301240069,111326247,412566316,8,0,0,430592,2,311124558
11778,301240530,126861534,428102064,7,0,1,12288,16,2648615227
11779,301244360,127008840,428253200,5,0,1,8704,11,1941312666
11780,301276500,126976723,428253223,7,0,1,5120,16,8249589784
11781,301301840,111066204,412368044,7,0,0,348160,16,9584200001
11782,301302610,111120758,412423368,6,0,0,181248,7,7709953110
11783,301334509,110848309,412182818,8,0,0,203264,2,544483404
11784,301345581,126907665,428253246,9,0,1,59904,17,4312665504
11785,301381380,126871897,428253277,5,0,1,47616,11,1107686407
11786,301397301,126855999,428253300,9,0,1,1536,17,9190623082
11787,301413050,126840273,428253323,5,0,1,4608,11,3780297580
11788,301440541,126817298,428257839,9,0,1,46592,17,8159786722
11789,301452709,126805386,428258095,1,0,1,9216,5,5396571544
11790,301460870,126866945,428327815,7,0,1,13312,16,5352739741
11791,301490640,126837198,428327838,5,0,1,512,11,6947779524
11792,301505261,126853066,428358327,9,0,1,39936,17,8894716329
11793,301513670,126844680,428358350,2,0,1,1536,4,562668142
11794,301514069,126844304,428358373,1,0,1,12800,5,1556238405
11795,301533429,126824983,428358412,1,0,1,22528,5,9008240047
11796,301543790,126865556,428409346,5,0,1,41984,11,4747593212
11797,301564901,111002576,412567477,2,0,0,3584,4,9883652956
11798,301565991,126927412,428493403,9,0,1,76288,17,3932535158
11799,301604950,111272266,412877216,6,0,0,264192,7,8030106432
11800,301607440,126885986,428493426,5,0,1,8704,11,9701460855
11801,301626390,126872411,428498801,7,0,1,18944,16,8401220788
11802,301634339,126884557,428518896,0,0,1,3072,10,1416197318
11803,301640331,126917248,428557579,9,0,1,26624,17,2176777015
11804,301650891,111245131,412896022,2,0,0,6656,4,390941639
11805,301650949,127051915,428702864,1,0,1,26112,5,2183152813
11806,301652380,127050507,428702887,2,0,1,6144,4,3556487853
11807,301674771,111205923,412880694,2,0,0,11264,4,7966948243
11808,301773869,126929758,428703627,0,0,1,20992,10,9076172551
11809,301787920,111790801,413578721,7,0,0,723456,16,6551202965
11810,301790130,111006016,412796146,7,0,0,39424,16,1199656640
11811,301810499,111151527,412962026,8,0,0,163328,2,5025169217
11812,301810539,126920502,428731041,1,0,1,24064,5,3495319746
11813,301831170,126917948,428749118,7,0,1,2048,16,302599987
11814,301837210,126983816,428821026,7,0,1,35840,16,5377526958
11815,301861170,126975417,428836587,5,0,1,38400,11,5789478023
11816,301913790,126925089,428838879,7,0,1,25600,16,6147018087
11817,301933840,127031452,428965292,5,0,1,54784,11,7060027410
11818,301934689,111741118,413675807,8,0,0,318464,2,10426372926
11819,301940980,111321325,413262305,7,0,0,40448,16,186978350
11820,301968320,127520023,429488343,5,0,1,68608,11,3320277809
11821,301973920,127518995,429492915,2,0,1,7168,4,7676465008
11822,302018440,111311741,413330181,7,0,0,44544,16,6966879285
11823,302033890,111324380,413358270,6,0,0,59392,7,9686667676
11824,302077860,111605046,413682906,7,0,0,22016,16,6735064370
11825,302092830,127570309,429663139,2,0,1,67584,4,3073591503
11826,302109231,127553931,429663162,9,0,1,4608,17,1848399258
11827,302113790,127549395,429663185,2,0,1,41984,4,381272392
11828,302116081,127547127,429663208,9,0,1,12800,17,1020249568
11829,302164310,111628007,413792317,7,0,0,63488,16,10699184631
11830,302216701,111613734,413830435,2,0,0,1536,4,2236974502
11831,302218300,112919473,415137773,6,0,0,84480,7,8916557457
11832,302232140,111931187,414163327,6,0,0,93696,7,9976226736
11833,302239429,112066692,414306121,8,0,0,49664,2,7489243592
11834,302331020,111640805,413971825,6,0,0,76288,7,6031426183
11835,302433210,127230021,429663231,7,0,1,10240,16,6401664189
11836,302437229,111884800,414322029,8,0,0,1536,2,919630341
11837,302475530,111815436,414290966,6,0,0,270336,7,10655065473
11838,302519401,127143853,429663254,9,0,1,5632,17,9535344200
11839,302538529,127124748,429663277,4,0,1,24576,2,3740385281
11840,302565760,127148995,429714755,7,0,1,72704,16,6696330237
11841,302602230,111816566,414418796,7,0,0,139264,16,148530466
11842,302602680,127115192,429717872,7,0,1,19456,16,7464311985
11843,302604119,127119496,429723615,1,0,1,6656,5,4223710402
11844,302655850,111829102,414484952,7,0,0,195072,16,9871915613
11845,302665779,111918887,414584666,8,0,0,128000,2,4642256736
11846,302687531,112611785,415299316,2,0,0,5632,4,2910914236
11847,302723710,127000251,429723961,5,0,1,512,11,8826727275
11848,302732720,111949281,414682001,6,0,0,5120,7,6546608982
11849,302751870,126973717,429725587,7,0,1,2560,16,5954439327
11850,302770231,112002686,414772917,2,0,0,2048,4,6655425762
11851,302780601,127020475,429801076,9,0,1,46080,17,1980922636
11852,302795780,111950842,414746622,7,0,0,121856,16,10149225236
11853,302824179,126976936,429801115,1,0,1,1024,5,7635295294
11854,302859429,112252581,415112010,8,0,0,271360,2,8868100308
11855,302913381,126887757,429801138,9,0,1,7680,17,461078455
11856,302946930,126854231,429801161,7,0,1,32256,16,4997677837
11857,302946970,126854214,429801184,5,0,1,5120,11,4455721338
11858,302953710,111354150,414307860,6,0,0,5632,7,5824022993
11859,302996299,126804908,429801207,1,0,1,1024,5,9516971052
11860,303016240,111914840,414931080,7,0,0,190976,16,2655299119
11861,303065081,126736149,429801230,9,0,1,1024,17,3377163133
11862,303099809,112482147,415581956,8,0,0,400384,2,521845104
11863,303153910,126647343,429801253,7,0,1,17920,16,10612844622
11864,303236369,126564907,429801276,1,0,1,7680,5,5913099831
11865,303283189,112124629,415407818,8,0,0,56832,2,2614159116
11866,303286379,126540480,429826859,1,0,1,9728,5,6806782923
11867,303345251,111586476,414931727,2,0,0,2048,4,10108202823
11868,303379859,126448178,429828037,1,0,1,13824,5,1950657344
11869,303394239,126480760,429874999,4,0,1,41984,2,1090977871
11870,303403519,111893513,415297032,8,0,0,479232,2,2949902564
11871,303404549,112196109,415600658,8,0,0,53248,2,818299443
11872,303428861,126446292,429875153,9,0,1,8704,17,8070023585
11873,303483961,126398582,429882543,9,0,1,10240,17,1516678018
11874,303496680,112291180,415787860,7,0,0,404992,16,720100190
11875,303583200,110902087,414485287,6,0,0,1024,7,2812602862
11876,303584630,111041118,414625748,6,0,0,4608,7,2659842522
11877,303598169,126286320,429884489,1,0,1,3072,5,2528964669
11878,303609620,111394892,415004512,7,0,0,18432,16,3986321425
11879,303620400,111992160,415612560,6,0,0,512,7,1407633995
11880,303631609,126263747,429895356,1,0,1,22528,5,1959921954
11881,303671390,126297321,429968711,5,0,1,2048,11,7200188791
11882,303744041,126224693,429968734,9,0,1,1536,17,9302648557
11883,303765450,126203307,429968757,5,0,1,12800,11,2799778103
11884,303767220,111595393,415362613,7,0,0,77312,16,4445647026
11885,303774011,126272097,430046108,9,0,1,30720,17,7302395699
11886,303809330,126241092,430050422,5,0,1,512,11,3391016725
11887,303815859,126300354,430116213,1,0,1,34304,5,8106036849
11888,303844201,111453376,415297577,2,0,0,1536,4,8698537994
11889,303863981,126878058,430742039,9,0,1,71680,17,8663237983
11890,303927751,111219768,415147519,2,0,0,512,4,8079441782
11891,303930590,111393466,415324056,7,0,0,72704,16,2572981716
11892,303931970,126828030,430760000,3,0,1,78336,3,5233955593
11893,303956041,126852484,430808525,9,0,1,30720,17,10342939475
11894,303991789,126833148,430824937,1,0,1,10240,5,71219818
11895,304038509,126918117,430956626,1,0,1,12800,5,5546371446
11896,304087649,126894554,430982203,1,0,1,46080,5,6920245203
11897,304120590,111491791,415612381,7,0,0,38400,16,7617077688
11898,304127811,126874813,431002624,9,0,1,8704,17,5694543263
11899,304130641,111453770,415584411,2,0,0,7680,4,5969476851
11900,304168809,126847351,431016160,1,0,1,1024,5,1928281093
11901,304171709,126844474,431016183,0,0,1,27136,10,3865604775
11902,304222049,126850283,431072332,1,0,1,38400,5,5689088125
11903,304235350,126864735,431100085,5,0,1,9728,11,7508920024
11904,304235620,127069110,431304730,3,0,1,49152,3,1271434462
11905,304252650,111378231,415630881,7,0,0,54272,16,836108510
11906,304295400,127009353,431304753,2,0,1,1536,4,9993899923
11907,304296820,111317479,415614299,6,0,0,5632,7,2848785303
11908,304353640,127252475,431606115,3,0,1,122880,3,60769299
11909,304375959,127230179,431606138,0,0,1,4608,10,3092908537
11910,304449420,127156741,431606161,5,0,1,18432,11,6998892591
11911,304478379,127127805,431606184,0,0,1,2560,10,5313850589
11912,304510439,127135114,431645553,0,0,1,63488,10,8046802221
11913,304512270,127460972,431973242,5,0,1,62464,11,7777706041
11914,304570539,127460831,432031370,0,0,1,24064,10,977978433
11915,304602919,127493488,432096407,0,0,1,26624,10,6674356627
11916,304612450,111196171,415808621,7,0,0,67584,16,7198867261
11917,304616330,127516163,432132493,6,0,1,20480,7,688800421
11918,304617281,111194040,415811321,2,0,0,3584,4,10289726350
11919,304661029,127472450,432133479,0,0,1,1536,10,5048374995
11920,304677841,127455792,432133633,9,0,1,8704,17,1681717963
11921,304709389,127482665,432192054,0,0,1,46080,10,2070661876
11922,304716679,127486068,432202747,1,0,1,41472,5,5369580341
11923,304763801,111048450,415812251,2,0,0,2048,4,10257949694
11924,304777910,127427743,432205653,5,0,1,4608,11,10415142421
11925,304798640,111363419,416162059,6,0,0,5120,7,6217650862
11926,304872691,127334268,432206959,9,0,1,2048,17,4893670106
11927,304923570,127285015,432208585,5,0,1,2560,11,3986839234
11928,304932890,111176682,416109572,7,0,0,85504,16,2117329040
11929,304966169,127334438,432300607,1,0,1,60416,5,8909947734
11930,304966719,127364170,432330889,0,0,1,33792,10,8187967058
11931,304974739,127385062,432359801,1,0,1,17408,5,2210481501
11932,305022000,111389557,416411557,7,0,0,434688,16,7192965602
11933,305067820,110948110,416015930,6,0,0,6144,7,7645953198
11934,305069710,111040688,416110398,6,0,0,2560,7,8744282469
11935,305112161,127284780,432396941,9,0,1,9728,17,5491043783
11936,305119979,127315980,432435959,1,0,1,58880,5,1027795684
11937,305126209,127317048,432443257,1,0,1,9728,5,6093169519
11938,305132850,111278932,416411782,6,0,0,512,7,9758075814
11939,305140290,127306833,432447123,5,0,1,6144,11,259239938
11940,305142999,127321398,432464397,1,0,1,7168,5,6437924158
11941,305162321,127305302,432467623,9,0,1,5120,17,3880348855
11942,305276700,127193251,432469951,5,0,1,9728,11,5339641612
11943,305341760,127163240,432505000,6,0,1,48640,7,7568709014
11944,305384220,110849485,416233705,6,0,0,2560,7,10528384742
11945,305392590,127248195,432640785,5,0,1,14336,11,4352719687
11946,305408910,127378374,432787284,6,0,1,27648,7,6297217956
11947,305418829,127739437,433158266,1,0,1,68608,5,9981742384
11948,305446619,127711670,433158289,0,0,1,512,10,8158389383
11949,305462290,110965941,416428231,7,0,0,48128,16,3419057724
11950,305468730,110944323,416413053,6,0,0,4096,7,6231609707
11951,305557160,127601152,433158312,5,0,1,24576,11,3678339043
11952,305570289,127661241,433231530,0,0,1,4608,10,7051808344
11953,305595540,110910764,416506304,6,0,0,512,7,1454044421
11954,305654961,127576608,433231569,9,0,1,8192,17,1877506730
11955,305659009,127572583,433231592,1,0,1,5120,5,4905185392
11956,305696050,110717494,416413544,6,0,0,1536,7,4965763523
11957,305785570,127452487,433238057,5,0,1,13824,11,6799733291
11958,305789870,127448210,433238080,6,0,1,31232,7,3712247790
11959,305809621,127428482,433238103,9,0,1,1536,17,7037452555
11960,305817861,127420265,433238126,9,0,1,2560,17,3849839270
11961,305822900,127415249,433238149,5,0,1,512,11,1721218178
11962,305823620,127416960,433240580,6,0,1,19456,7,4906475271
11963,305853740,110780275,416634015,7,0,0,29184,16,5722957293
11964,305859209,127522116,433381325,0,0,1,31232,10,8448958584
11965,305893000,127533782,433426782,7,0,1,3584,16,2548543936
11966,305903450,111477489,417380939,7,0,0,298496,16,6868830939
11967,305928000,127539143,433467143,5,0,1,18432,11,7878098917
11968,305965459,127510134,433475593,1,0,1,16896,5,10371487857
11969,305969869,127535894,433505763,1,0,1,4096,5,8851544552
11970,306016910,127748785,433765695,7,0,1,21504,16,6754454434
11971,306057120,127708598,433765718,5,0,1,13312,11,8537587994
11972,306078169,127709169,433787338,1,0,1,10240,5,10320974537
11973,306089290,127698071,433787361,5,0,1,26112,11,3497276768
11974,306106880,127749393,433856273,6,0,1,24576,7,7784661972
11975,306112931,127763224,433876155,9,0,1,35328,17,6207728450
11976,306160350,127716023,433876373,7,0,1,11264,16,262280449
11977,306173671,127702725,433876396,9,0,1,2560,17,10018872412
11978,306205890,127697236,433903126,2,0,1,2560,4,5687119578
11979,306213099,127690050,433903149,1,0,1,4096,5,1410364487
11980,306254880,127673314,433928194,6,0,1,30208,7,10325150063
11981,306297190,127633910,433931100,7,0,1,4608,16,4911146321
11982,306300120,127809709,434109829,7,0,1,11776,16,1973312311
11983,306308769,127801083,434109852,1,0,1,4608,5,7680148223
11984,306309710,127924479,434234189,2,0,1,68096,4,3932478205
11985,306321709,127918657,434240366,4,0,1,32768,2,955979945
11986,306342111,128063476,434405587,9,0,1,55296,17,5972557882
11987,306360670,128044940,434405610,2,0,1,7680,4,3356487602
11988,306367550,128055526,434423076,2,0,1,40448,4,5758485990
11989,306391800,112041957,418433757,6,0,0,5120,7,2850941960
11990,306396470,128096264,434492734,5,0,1,7680,11,3932813362
11991,306413680,112201638,418615318,7,0,0,209408,16,7511746365
11992,306540660,127954340,434495000,2,0,1,3584,4,6436276549
11993,306740580,111957940,418698520,7,0,0,93184,16,431699007
11994,306754961,127752682,434507643,9,0,1,11264,17,2823289301
11995,306818129,127689860,434507989,1,0,1,512,5,6221472190
11996,306846510,127771896,434618406,5,0,1,49152,11,8166592802
11997,306852160,128225180,435077340,2,0,1,35840,4,561234151
11998,306864240,128213123,435077363,6,0,1,11776,7,125271920
11999,306865600,111985684,418851284,7,0,0,191488,16,10258878087
12000,306869200,128208186,435077386,2,0,1,512,4,173628279
12001,306935530,128141879,435077409,2,0,1,9216,4,8860545416
12002,306954990,128133203,435088193,6,0,1,8192,7,8540783512
12003,306960960,128233930,435194890,2,0,1,29696,4,2485931472
12004,306963150,128232886,435196036,5,0,1,3072,11,6710916725
12005,307020941,128339768,435360709,9,0,1,45056,17,3434984623
12006,307044450,128316282,435360732,5,0,1,10752,11,4367145400
12007,307065570,128295185,435360755,5,0,1,11264,11,606933558
12008,307114461,128246317,435360778,9,0,1,2048,17,9596487964
12009,307129689,128231112,435360801,1,0,1,7680,5,5509208763
12010,307147390,111551933,418699323,7,0,0,2560,16,627156100
12011,307174650,111525632,418700282,6,0,0,3072,7,10047434062
12012,307212170,128148654,435360824,2,0,1,3072,4,4768339032
12013,307222470,111685037,418907507,7,0,0,4096,16,9609231089
12014,307243261,111633321,418876582,2,0,0,1536,4,1682278239
12015,307249100,128111747,435360847,3,0,1,25088,3,387721747
12016,307267591,128093279,435360870,9,0,1,12288,17,6905861510
12017,307293530,128067363,435360893,2,0,1,3072,4,3054049451
12018,307395210,128012997,435408207,3,0,1,45056,3,303544470
12019,307414610,111672900,419087510,6,0,0,2048,7,6647422781
12020,307424240,111764589,419188829,6,0,0,9728,7,3109318911
12021,307441880,111624692,419066572,6,0,0,512,7,812183730
12022,307442270,127966303,435408573,2,0,1,60416,4,10118537601
12023,307455080,111723441,419178521,6,0,0,6144,7,3794773711
12024,307501621,127906999,435408620,9,0,1,15360,17,2470353145
12025,307516720,128100525,435617245,3,0,1,178688,3,5830739693
12026,307519800,128097468,435617268,2,0,1,33280,4,3260301749
12027,307546589,128070702,435617291,1,0,1,13824,5,2406813653
12028,307616741,111712665,419329406,2,0,0,7680,4,3474463619
12029,307630380,128063085,435693465,5,0,1,29184,11,5609641076
12030,307653720,111683504,419337224,7,0,0,3584,16,6394215280
12031,307660810,128032678,435693488,3,0,1,133120,3,5939456410
12032,307663770,128029741,435693511,2,0,1,5632,4,5433838533
12033,307715751,128005947,435721698,9,0,1,41472,17,4564672311
12034,307716190,128011123,435727313,5,0,1,512,11,8907622656
12035,307757319,127973540,435730859,1,0,1,5632,5,7889612104
12036,307770920,128533824,436304744,3,0,1,49152,3,5209357457
12037,307772030,128813140,436585170,5,0,1,10752,11,5620164765
12038,307848661,111609747,419458408,2,0,0,12288,4,9927819744
12039,307864769,128986313,436851082,1,0,1,16384,5,7824000770
12040,307902500,111717049,419619549,6,0,0,3072,7,9420179088
12041,307912940,129894506,437807446,3,0,1,120832,3,5396576788
12042,307950010,129857459,437807469,6,0,1,29696,7,7339787667
12043,308069310,130218699,438288009,3,0,1,357376,3,619681484
12044,308131641,111742476,419874117,2,0,0,1536,4,10233745138
12045,308168380,130119652,438288032,5,0,1,17920,11,9915611820
12046,308247060,130040995,438288055,5,0,1,26624,11,3889972870
12047,308265841,111723234,419989075,2,0,0,512,4,5406190276
12048,308287950,111633429,419921379,7,0,0,1024,16,2078657567
12049,308313829,129974249,438288078,1,0,1,15872,5,10005058842
12050,308377880,129923812,438301692,5,0,1,12288,11,1502874228
12051,308391599,129911719,438303318,1,0,1,2560,5,3427999116
12052,308397319,129908265,438305584,1,0,1,3584,5,3475518941
12053,308401980,111443777,419845757,7,0,0,2048,16,6217582934
12054,308487580,111578578,420066158,7,0,0,9216,16,4554771675
12055,308487779,130109325,438597104,1,0,1,54784,5,4365872069
12056,308490380,111584797,420075177,6,0,0,4608,7,6456905903
12057,308570120,111589868,420159988,6,0,0,3072,7,4366402009
12058,308655980,130762178,439418158,3,0,1,443392,3,3371638089
12059,308676140,111494756,420170896,7,0,0,3584,16,10310969824
12060,308813480,111302953,420116433,6,0,0,512,7,4709327831
12061,308814250,130963106,439777356,3,0,1,153600,3,8338158664
12062,308892329,130885050,439777379,4,0,1,2560,2,5952813838
12063,308922070,111339802,420261872,7,0,0,2048,16,6363419018
12064,308930941,111420317,420351258,2,0,0,1024,4,10559603063
12065,308941640,130835762,439777402,2,0,1,9216,4,586961540
12066,308951501,111292813,420244314,2,0,0,512,4,6949355179
12067,309031789,130745636,439777425,1,0,1,1536,5,3393471672
12068,309068781,130708667,439777448,9,0,1,5632,17,3158236116
12069,309099500,111350939,420450439,7,0,0,1024,16,5520692722
12070,309107130,111422298,420529428,7,0,0,512,16,9103133716
12071,309117740,111281921,420399661,6,0,0,3584,7,9768700854
12072,309232471,130545000,439777471,9,0,1,3584,17,6515732144
12073,309241419,130536075,439777494,1,0,1,3072,5,5305271582
12074,309252011,130525506,439777517,9,0,1,512,17,5384668363
12075,309253299,130524241,439777540,1,0,1,19456,5,4999161736
12076,309351621,130446401,439798022,9,0,1,4096,17,10577463830
12077,309381981,130416064,439798045,9,0,1,60416,17,5778321573
12078,309385350,130412718,439798068,5,0,1,13824,11,5551963313
12079,309396560,111238701,420635261,6,0,0,5632,7,5823748825
12080,309424881,130385261,439810142,9,0,1,47104,17,3898108855
12081,309435540,130409336,439844876,5,0,1,112640,11,2210423279
12082,309508240,130340528,439848768,3,0,1,38400,3,9287719346
12083,309520140,111196258,420716398,6,0,0,6656,7,41417295
12084,309520150,111120447,420640597,6,0,0,6144,7,2688353187
12085,309559840,131339325,440899165,3,0,1,539648,3,1940403906
12086,309576360,131342195,440918555,2,0,1,66560,4,5311438971
12087,309589690,131430735,441020425,3,0,1,203776,3,5502399654
12088,309602210,131504359,441106569,3,0,1,104960,3,1448860114
12089,309681530,111201059,420882589,7,0,0,2048,16,5263103707
12090,309685111,131427564,441112675,9,0,1,20992,17,2112613071
12091,309704740,111082340,420787080,6,0,0,1024,7,4468204920
12092,309725280,111342424,421067704,6,0,0,4608,7,951555839
12093,309761741,131379643,441141384,9,0,1,6144,17,3739088047
12094,309837140,131409413,441246553,3,0,1,164864,3,9860838042
12095,309867881,111131852,420999733,2,0,0,3072,4,5621263338
12096,309870380,131523425,441393805,3,0,1,148992,3,4725250172
12097,309901990,131520814,441422804,5,0,1,29184,11,10073566683
12098,309903650,110859525,420763175,6,0,0,1024,7,8190033047
12099,310036401,110997925,421034326,2,0,0,2048,4,10543184894
12100,310054370,131469263,441523633,5,0,1,29184,11,2318041718
12101,310223720,131490983,441714703,3,0,1,204800,3,3309936660
12102,310225340,131489824,441715164,3,0,1,10240,3,10182698639
12103,310252000,111318260,421570260,6,0,0,3072,7,5235005550
12104,310269860,110971524,421241384,7,0,0,2560,16,9579698809
12105,310270780,110847058,421117838,6,0,0,5632,7,5301629240
12106,310311450,131404789,441716239,5,0,1,12288,11,8671317548
12107,310322490,131426132,441748622,5,0,1,32256,11,1171183070
12108,310341540,110883337,421224877,6,0,0,1536,7,3664162032
12109,310409880,110600761,421010641,7,0,0,3584,16,4919030756
12110,310447510,131338561,441786071,3,0,1,88064,3,9007725003
12111,310481641,110600503,421082144,2,0,0,512,4,1238549043
12112,310489880,110676683,421166563,6,0,0,2048,7,3741175815
12113,310507320,131291442,441798762,5,0,1,5632,11,3562386486
12114,310581600,110806816,421388416,7,0,0,12800,16,2588241010
12115,310718981,110371381,421090362,2,0,0,512,4,6596649844
12116,310754870,131045172,441800042,5,0,1,14336,11,4606991865
12117,310760100,110314232,421074332,7,0,0,5632,16,9477858391
12118,310780021,110370365,421150386,2,0,0,1024,4,3812374044
12119,310806020,110229898,421035918,6,0,0,512,7,9509197927
12120,310820330,130993617,441813947,5,0,1,14336,11,8497692485
12121,310830820,131113808,441944628,7,0,1,8704,16,7371108588
12122,310865511,110378477,421243988,2,0,0,1024,4,6543385196
12123,310878890,110338943,421217833,6,0,0,1024,7,2728630850
12124,310880260,131087346,441967606,3,0,1,196096,3,5011505529
12125,310917891,110280379,421198270,2,0,0,2048,4,6384513245
12126,311031390,130936239,441967629,5,0,1,13824,11,1062149518
12127,311057941,110287088,421345029,2,0,0,6144,4,340004384
12128,311074870,130892782,441967652,7,0,1,512,16,6519491031
12129,311097140,110010078,421107218,7,0,0,1024,16,8108562996
12130,311123710,110091348,421215058,6,0,0,1024,7,5171754889
12131,311133700,130833991,441967691,2,0,1,7680,4,2501552407
12132,311151620,130816094,441967714,7,0,1,16896,16,7690990071
12133,311152571,110307831,421460402,2,0,0,1024,4,8800180880
12134,311155410,130812327,441967737,7,0,1,3072,16,2882951564
12135,311176099,130791661,441967760,0,0,1,5632,10,9798222472
12136,311178980,110093132,421272112,6,0,0,5632,7,2000489013
12137,311190210,131121922,442312132,3,0,1,387584,3,6358760849
12138,311321240,131152471,442473711,2,0,1,80896,4,6611994857
12139,311358320,131390062,442748382,3,0,1,259072,3,2407973228
12140,311365440,131433064,442798504,2,0,1,40448,4,3788227619
12141,311371131,109885741,421256872,2,0,0,1024,4,2711645840
12142,311396141,110176801,421572942,2,0,0,4096,4,9243595407
12143,311435730,131383576,442819306,5,0,1,88576,11,9292659646
12144,311445180,131459973,442905153,3,0,1,206336,3,3487836879
12145,311445850,131492697,442938547,5,0,1,41984,11,4008226623
12146,311470680,131511127,442981807,2,0,1,133120,4,1654725970
12147,311494390,110198072,421692462,7,0,0,6656,16,7627287390
12148,311512260,131470533,442982793,6,0,1,1536,7,5459504900
12149,311515420,131473223,442988643,5,0,1,27648,11,4989639420
12150,311554419,131442393,442996812,4,0,1,26624,2,10155562951
12151,311660430,131346415,443006845,5,0,1,26112,11,6046661994
12152,311730350,131284770,443015120,7,0,1,5120,16,6989294996
12153,311773010,131242264,443015274,7,0,1,8704,16,10031921932
12154,311812320,131203620,443015940,5,0,1,1024,11,8387374271
12155,311864290,131181649,443045939,2,0,1,46592,4,5876910113
12156,311880080,131176815,443056895,7,0,1,15872,16,6493221899
12157,311903230,131154331,443057561,2,0,1,1024,4,2226150692
12158,311935310,109897366,421832676,7,0,0,1536,16,10641050050
12159,311991130,131067417,443058547,5,0,1,1536,11,2059061277
12160,312022530,131038923,443061453,2,0,1,4608,4,218665802
12161,312122070,131049503,443171573,8,0,1,118272,2,846496461
12162,312123201,109547790,421670991,2,0,0,1024,4,6044018874
12163,312197450,109426421,421623871,7,0,0,8192,16,6750715702
12164,312204310,130967286,443171596,5,0,1,3584,11,1135985965
12165,312226040,131148153,443374193,7,0,1,34304,16,1548705918
12166,312249870,131204239,443454109,8,0,1,39936,2,3943366308
12167,312325580,109407413,421732993,7,0,0,7680,16,2471467471
12168,312355830,131233525,443589355,2,0,1,42496,4,6282431063
12169,312368170,131222171,443590341,6,0,1,1536,7,2707942715
12170,312371910,131245023,443616933,8,0,1,69632,2,9431536292
12171,312379520,131278924,443658444,7,0,1,31744,16,10360210365
12172,312386880,131286557,443673437,5,0,1,19456,11,6372690849
12173,312459790,131218153,443677943,5,0,1,7168,11,10347378501
12174,312472440,131205759,443678199,6,0,1,9216,7,3525380362
12175,312516300,132564168,445080468,8,0,1,487936,2,6395538866
12176,312529780,132837890,445367670,8,0,1,415744,2,10550199061
12177,312535340,132832353,445367693,2,0,1,17920,4,5904372226
12178,312581780,109446958,422028738,7,0,0,3072,16,3678583466
12179,312591760,132775956,445367716,2,0,1,6144,4,13544392
12180,312618330,132749409,445367739,2,0,1,27648,4,6725450144
12181,312626230,132741532,445367762,2,0,1,73216,4,1179680460
12182,312659260,132708525,445367785,2,0,1,1024,4,6674512351
12183,312678080,132701839,445379919,2,0,1,158208,4,2283661816
12184,312719480,132671786,445391266,6,0,1,39424,7,845922598
12185,312802670,132606627,445409297,2,0,1,12800,4,2357556250
12186,312804110,132621417,445425527,2,0,1,42496,4,1595854687
12187,312855670,132570933,445426603,2,0,1,13312,4,1194244280
12188,312866480,109357542,422224022,7,0,0,9728,16,9994652686
12189,312874380,132556089,445430469,5,0,1,6144,11,2774954570
12190,312883400,132549975,445433375,5,0,1,4608,11,8768831883
12191,312892780,132577176,445469956,7,0,1,62464,16,2649291037
12192,312914220,132592474,445506694,6,0,1,35840,7,2038258207
12193,312933100,132573748,445506848,7,0,1,8704,16,1997209760
12194,312944400,132566954,445511354,6,0,1,7168,7,1109243107
12195,312966990,109222319,422189309,6,0,0,512,7,86801550
12196,312971070,132540630,445511700,7,0,1,512,16,8934276365
12197,312983790,109245572,422229362,7,0,0,2048,16,6572785940
12198,312990090,132529637,445519727,6,0,1,26112,7,4512748623
12199,313085960,109191176,422277136,7,0,0,5120,16,5562619723
12200,313095360,132429654,445525014,7,0,1,16896,16,9118631684
12201,313117481,109224211,422341692,2,0,0,3584,4,9069516556
12202,313121710,132403920,445525630,6,0,1,9728,7,10103563792
12203,313165300,132361956,445527256,5,0,1,2560,11,5507499120
12204,313178850,132377020,445555870,5,0,1,8704,11,7239299180
12205,313179430,132376463,445555893,6,0,1,6144,7,969762901
12206,313180480,109376986,422557466,7,0,0,9216,16,2193138450
12207,313200070,109200452,422400522,7,0,0,1024,16,3442006051
12208,313284660,132271256,445555916,5,0,1,27648,11,8857895768
12209,313359720,132204710,445564430,6,0,1,18944,7,4981121405
12210,313387320,132188967,445576287,6,0,1,31232,7,8326959639
12211,313392480,133349509,446741989,6,0,1,27136,7,6003282243
12212,313427190,133477623,446904813,7,0,1,6144,16,5671426829
12213,313488740,133418636,446907376,6,0,1,4096,7,4662174379
12214,313505900,133406865,446912765,5,0,1,17408,11,4947890424
12215,313549610,134290970,447840580,2,0,1,44544,4,4753056899
12216,313561790,134278813,447840603,2,0,1,2560,4,4089884077
12217,313563421,108988089,422551510,2,0,0,1024,4,1079727315
12218,313608971,108775477,422384448,2,0,0,512,4,3820725261
12219,313638900,134218909,447857809,6,0,1,26624,7,4485156168
12220,313661031,109010022,422671053,2,0,0,6656,4,7150685459
12221,313687461,134183030,447870491,9,0,1,10240,17,10700495992
12222,313716700,134550652,448267352,5,0,1,75264,11,8090730938
12223,313723030,134545948,448268978,5,0,1,2560,11,6152470421
12224,313725300,134607372,448332672,5,0,1,34304,11,9152100198
12225,313746720,134652345,448399065,5,0,1,19456,11,3024988594
12226,313752070,134647018,448399088,7,0,1,3584,16,9246687684
12227,313767050,134922142,448689192,5,0,1,1024,11,3460906879
12228,313774479,134914736,448689215,4,0,1,7680,2,4093618391
12229,313784480,108719083,422503563,7,0,0,5120,16,2881712610
12230,313785990,134903248,448689238,6,0,1,4096,7,7059732883
12231,313818040,135094370,448912410,7,0,1,75776,16,1507003026
12232,313832590,135147281,448979871,5,0,1,50176,11,963912344
12233,313838610,135142103,448980713,7,0,1,6144,16,3019857793
12234,313862310,135118426,448980736,5,0,1,3584,11,7544370720
12235,313880180,135100579,448980759,7,0,1,31232,16,385717459
12236,313949730,135031060,448980790,6,0,1,4096,7,7883208745
12237,314014191,108878736,422892927,2,0,0,1024,4,8205390666
12238,314040810,108428054,422468864,7,0,0,4096,16,7374678439
12239,314045740,134955918,449001658,7,0,1,37376,16,5623060711
12240,314046720,134955604,449002324,6,0,1,1024,7,1049922719
12241,314081930,108995846,423077776,0,0,0,32768,10,6103058161
12242,314092140,134911157,449003297,6,0,1,12800,7,3938423415
12243,314113750,108577820,422691570,0,0,0,47616,10,4200289044
12244,314117400,135014576,449131976,6,0,1,11776,7,1366637361
12245,314237580,134894459,449132039,7,0,1,41984,16,9681295740
12246,314245630,134944376,449190006,6,0,1,44544,7,10664826258
12247,314254580,108638012,422892592,7,0,0,5632,16,2552534293
12248,314354870,108180444,422535314,7,0,0,2048,16,9104908558
12249,314378250,108456615,422834865,0,0,0,15872,10,9829244906
12250,314501560,108389270,422890830,0,0,0,147968,10,7753198505
12251,314514480,134704791,449219271,3,0,1,7680,3,324466869
12252,314535880,108292988,422828868,0,0,0,65024,10,5424478274
12253,314568831,108261175,422830006,2,0,0,3584,4,2908777790
12254,314595020,135818753,450413773,3,0,1,420352,3,2614081372
12255,314664040,135749756,450413796,2,0,1,36864,4,2287444227
12256,314699800,135714019,450413819,2,0,1,7680,4,5587082359
12257,314703621,108225591,422929212,2,0,0,3072,4,3930235178
12258,314716230,135697612,450413842,6,0,1,9728,7,2862420833
12259,314717639,135696226,450413865,4,0,1,8192,2,4131079594
12260,314739550,108592501,423332051,9,0,0,243200,17,4509633850
12261,314746900,135879171,450626071,7,0,1,22016,16,4269452425
12262,314767011,135859091,450626102,9,0,1,9728,17,5399304182
12263,314799630,135885509,450685139,2,0,1,4608,4,4214538784
12264,314847720,135837442,450685162,7,0,1,2048,16,2920136357
12265,314852150,135833035,450685185,2,0,1,3584,4,6827136329
12266,314918670,135766538,450685208,2,0,1,4608,4,6584908100
12267,314919809,135765422,450685231,4,0,1,6656,2,10302479575
12268,314977680,135707574,450685254,2,0,1,4096,4,9578120068
12269,315006960,135678317,450685277,6,0,1,2560,7,2838404892
12270,315020600,135664700,450685300,3,0,1,155648,3,2188408198
12271,315032149,108197411,423229560,5,0,0,168960,11,3714948827
12272,315041960,135643363,450685323,2,0,1,11264,4,1714357930
12273,315048919,135637074,450685993,4,0,1,41984,2,9530916417
12274,315055610,108344483,423400093,9,0,0,212480,17,2084994717
12275,315069449,135616567,450686016,4,0,1,5120,2,6928013126
12276,315072510,136982638,452055148,3,0,1,655360,3,9626392209
12277,315111309,108745031,423856340,5,0,0,105984,11,4094587105
12278,315147630,136927411,452075041,3,0,1,27136,3,5835865776
12279,315167420,136953641,452121061,6,0,1,3072,7,6608892261
12280,315220511,108180876,423401387,2,0,0,4096,4,9090986315
12281,315228550,137250835,452479385,3,0,1,381952,3,6638711109
12282,315230169,137308412,452538581,4,0,1,14848,2,5312198654
12283,315237880,137300724,452538604,7,0,1,8704,16,480108043
12284,315239300,137299327,452538627,2,0,1,8704,4,3063042379
12285,315271860,108140626,423412486,9,0,0,36352,17,1410766627
12286,315280900,137296305,452577205,7,0,1,4096,16,7177350916
12287,315291379,108815549,424106928,5,0,0,55296,11,3804155824
12288,315314351,108158328,423472679,2,0,0,7680,4,878979738
12289,315316500,137260744,452577244,7,0,1,12800,16,2903171496
12290,315330580,137301529,452632109,6,0,1,45568,7,6521422214
12291,315338980,137781813,453120793,3,0,1,150528,3,7623461649
12292,315383109,108631301,424014410,5,0,0,193024,11,4258725058
12293,315399170,108160175,423559345,9,0,0,129536,17,10139793873
12294,315411760,108337166,423748926,0,0,0,8192,10,1298451658
12295,315424870,108850011,424274881,0,0,0,240128,10,3316003717
12296,315429369,137833646,453263015,4,0,1,33280,2,7999962658
12297,315444620,137880018,453324638,7,0,1,53248,16,9755071681
12298,315457430,108889876,424347306,9,0,0,226304,17,3641332623
12299,315474080,108321587,423795667,7,0,0,2560,16,10535527971
12300,315479610,137891840,453371450,2,0,1,89600,4,2937472110
12301,315493341,108106367,423599708,2,0,0,6144,4,8772479611
12302,315503669,108451906,423955575,5,0,0,7168,11,3615783486
12303,315508570,137878048,453386618,2,0,1,1536,4,8002834138
12304,315521579,137865193,453386772,4,0,1,8704,2,8996468559
12305,315547430,137841608,453389038,7,0,1,3584,16,4114364225
12306,315547500,108247364,423794864,0,0,0,65536,10,5137840116
12307,315556020,137834004,453390024,2,0,1,1536,4,8459652839
12308,315558449,108630880,424189329,5,0,0,215552,11,6946523828
12309,315637041,108852311,424489352,2,0,0,1536,4,1130837023
12310,315639450,137762327,453401777,3,0,1,55808,3,3996757230
12311,315687610,137967771,453655381,6,0,1,9728,7,7249144624
12312,315718911,108137920,423856831,2,0,0,1536,4,8414931441
12313,315724391,108291166,424015557,2,0,0,512,4,830927109
12314,315731250,108757611,424488861,9,0,0,204800,17,3646025581
12315,315747190,138381719,454128909,6,0,1,33792,7,738870486
12316,315750059,138384866,454134925,1,0,1,2048,5,2658457167
12317,315753109,138480101,454233210,4,0,1,28672,2,3602337928
12318,315777389,138456167,454233556,4,0,1,512,2,1512736481
12319,315792560,108604602,424397162,0,0,0,87040,10,2343932358
12320,315793369,138442133,454235502,1,0,1,3072,5,1640077441
12321,315800629,108569990,424370619,5,0,0,76288,11,1721676289
12322,315802879,138437449,454240328,1,0,1,7680,5,3897622994
12323,315813540,138634958,454448498,2,0,1,31232,4,971390649
12324,315828639,138749564,454578203,4,0,1,31232,2,7414872008
12325,315850260,138729401,454579661,2,0,1,17408,4,7198464804
12326,315860169,138719523,454579692,1,0,1,13312,5,1523875425
12327,315884060,108953115,424837175,0,0,0,150016,10,9606372563
12328,315884290,138845506,454729796,6,0,1,13312,7,6148286219
12329,315921690,138849032,454770722,6,0,1,18944,7,10176966820
12330,315927440,138901951,454829391,7,0,1,6656,16,7058447418
12331,315928420,108599150,424527570,7,0,0,2048,16,4780824095
12332,315998619,138876011,454874630,1,0,1,51200,5,7212553701
12333,316005879,138869827,454875706,4,0,1,13312,2,8656913265
12334,316051629,139054734,455106363,1,0,1,17408,5,5106109042
12335,316052509,108614530,424667039,5,0,0,185344,11,4952749023
12336,316068319,139130956,455199275,1,0,1,56320,5,7567133503
12337,316068950,139145971,455214921,2,0,1,21504,4,6921727935
12338,316120310,108369556,424489866,7,0,0,1536,16,8354745233
12339,316140700,139150262,455290962,2,0,1,35328,4,2251954619
12340,316153361,108358719,424512080,2,0,0,1536,4,10501109999
12341,316328570,138962415,455290985,2,0,1,26112,4,5861930344
12342,316337349,138953659,455291008,1,0,1,29184,5,2152358499
12343,316380989,139064396,455445385,1,0,1,22528,5,16006964
12344,316393160,108617532,425010692,0,0,0,81920,10,7648257524
12345,316420531,108248659,424669190,2,0,0,6656,4,522701104
12346,316426410,139582399,456008809,3,0,1,433152,3,6815493752
12347,316466310,108296462,424762772,7,0,0,1024,16,5208100221
12348,316467541,108668029,425135570,2,0,0,3584,4,7069442743
12349,316523431,139567948,456091379,9,0,1,2048,17,6752925101
12350,316528810,108182694,424711504,6,0,0,512,7,3921192690
12351,316532899,108436881,424969780,5,0,0,6144,11,7016243264
12352,316535269,108390634,424925903,5,0,0,25600,11,7938794697
12353,316568239,139523171,456091410,1,0,1,4096,5,3238927026
12354,316570470,108534707,425105177,0,0,0,154112,10,8899127638
12355,316577900,108335153,424913053,7,0,0,1536,16,4823593476
12356,316592900,108347199,424940099,7,0,0,6656,16,2283631563
12357,316600790,108675578,425276368,0,0,0,91136,10,1312700350
12358,316602291,108313522,424915813,2,0,0,512,4,7627654405
12359,316613550,108620128,425233678,0,0,0,29696,10,3520276618
12360,316631611,108205812,424837423,2,0,0,512,4,3168311645
12361,316648940,139502606,456151546,8,0,1,267264,2,9610706391
12362,316671600,139495825,456167425,3,0,1,43520,3,9084753102
12363,316680460,108701503,425381963,7,0,0,7168,16,7140687618
12364,316816539,139362820,456179359,1,0,1,1024,5,10659976952
12365,316833609,139348016,456181625,1,0,1,3584,5,5131906569
12366,317000719,139181982,456182701,1,0,1,13312,5,3906643556
12367,317022151,108453790,425475941,2,0,0,1536,4,9645041744
12368,317047240,139151865,456199105,8,0,1,45056,2,3212072162
12369,317131260,139076047,456207307,8,0,1,9728,2,7645923669
12370,317195190,108389382,425584572,0,0,0,283136,10,4843270372
12371,317203210,139008923,456212133,3,0,1,7680,3,4611684438
12372,317253460,108126296,425379756,0,0,0,161280,10,7289549926
12373,317272900,138993282,456266182,8,0,1,155648,2,58903588
12374,317280381,108345963,425626344,2,0,0,1536,4,2456193249
12375,317285441,108008936,425294377,2,0,0,9216,4,10536405558
12376,317296080,139005762,456301842,8,0,1,54272,2,8323782240
12377,317312760,139003447,456316207,7,0,1,40448,16,9410958118
12378,317336949,138992742,456329691,1,0,1,15360,5,6395061707
12379,317423280,139379259,456802539,3,0,1,176128,3,1051200722
12380,317427139,108017746,425444885,5,0,0,32768,11,273886837
12381,317438840,139507613,456946453,3,0,1,100352,3,9195952652
12382,317500310,139650437,457150747,8,0,1,141824,2,8315038002
12383,317510670,139861142,457371812,3,0,1,617472,3,7250502057
12384,317548431,107873929,425422360,2,0,0,6656,4,7794147612
12385,317569170,139803312,457372482,8,0,1,27136,2,149964255
12386,317577290,139880284,457457574,3,0,1,163840,3,2658205916
12387,317581930,140013992,457595922,8,0,1,293376,2,10562450103
12388,317593129,108029218,425622347,5,0,0,123904,11,6616365087
12389,317614360,140035287,457649647,3,0,1,114688,3,3425297951
12390,317616410,140036463,457652873,8,0,1,5120,2,4510790290
12391,317682630,140101026,457783656,3,0,1,195584,3,5744218259
12392,317743720,108429848,426173568,0,0,0,165376,10,6124561367
12393,317799750,140064393,457864143,8,0,1,202240,2,10059948544
12394,317805140,140120707,457925847,3,0,1,133120,3,8462704595
12395,317808510,140119283,457927793,8,0,1,3072,2,3678848165
12396,317814380,140120287,457934667,3,0,1,32768,3,379322004
12397,317846490,140167153,458013643,3,0,1,107520,3,5380572245
12398,317883511,107739685,425623196,2,0,0,1024,4,1308519937
12399,317904840,107717998,425622838,7,0,0,1536,16,931797135
12400,318006671,107620320,425626991,2,0,0,2048,4,3028344432
12401,318029410,139984256,458013666,3,0,1,28672,3,8242148094
12402,318128300,107496970,425625270,7,0,0,6656,16,8272902749
12403,318142910,139891405,458034315,3,0,1,28160,3,6744026508
12404,318167271,139915798,458083069,9,0,1,53760,17,5550975012
12405,318234700,107678750,425913450,0,0,0,145408,10,3099472413
12406,318236161,139850134,458086295,9,0,1,5120,17,3823720351
12407,318290830,107337524,425628354,7,0,0,4096,16,2747340970
12408,318292610,107706331,425998941,0,0,0,204800,10,5032577533
12409,318318140,107307713,425625853,7,0,0,1536,16,371640162
12410,318327640,139850948,458178588,3,0,1,230912,3,7656198404
12411,318395750,107436791,425832541,7,0,0,1024,16,3626584842
12412,318469361,139715231,458184592,9,0,1,20480,17,965619799
12413,318480920,108266964,426747884,0,0,0,121856,10,8174071100
12414,318500040,139687778,458187818,6,0,1,5120,7,8859934398
12415,318520249,107800425,426320674,5,0,0,116224,11,7134927238
12416,318541840,139818591,458360431,3,0,1,364544,3,5161681336
12417,318575130,139812618,458387748,6,0,1,54272,7,7101463484
12418,318579690,139900680,458480370,8,0,1,175616,2,1757320922
12419,318598040,139883610,458481650,6,0,1,14336,7,6609714926
12420,318601770,139881506,458483276,6,0,1,2560,7,7210066760
12421,318631391,139853268,458484659,9,0,1,14848,17,2752446106
12422,318646560,139844116,458490676,7,0,1,20480,16,4313310950
12423,318657829,139833833,458491662,4,0,1,1536,2,5127856682
12424,318669919,107860752,426530671,5,0,0,208896,11,9441365009
12425,318690150,139829875,458520025,3,0,1,41472,3,7312321186
12426,318778231,107344903,426123134,2,0,0,2048,4,2908369428
12427,318785020,139785798,458570818,8,0,1,89088,2,4215491894
12428,318828479,139763480,458591959,4,0,1,55808,2,8327434296
12429,318848431,139765387,458613818,9,0,1,44544,17,2432197150
12430,318888489,139725995,458614484,4,0,1,1024,2,2173315049
12431,318916770,139835402,458752172,8,0,1,262656,2,8650173207
12432,318991411,139785656,458777067,9,0,1,34304,17,3284540317
12433,319024091,107815331,426839422,2,0,0,6656,4,8852248965
12434,319045620,139732113,458777733,7,0,1,1024,16,7716009980
12435,319056170,107166625,426222795,0,0,0,512,10,5532061593
12436,319092650,107029814,426122464,0,0,0,110080,10,3677770892
12437,319099170,107513395,426612565,0,0,0,239616,10,1043135466
12438,319126521,139652838,458779359,9,0,1,2560,17,4037662777
12439,319184860,139662234,458847094,8,0,1,138240,2,7234797229
12440,319204600,139751926,458956526,8,0,1,152576,2,3850662186
12441,319204650,139773096,458977746,7,0,1,48128,16,8810277762
12442,319220171,139775280,458995451,9,0,1,9216,17,925334301
12443,319221781,139782178,459003959,9,0,1,31744,17,6410258100
12444,319231111,139775481,459006592,9,0,1,14848,17,2956765361
12445,319240580,139772323,459012903,8,0,1,22016,2,505608365
12446,319264581,107180018,426444599,2,0,0,1536,4,2177043499
12447,319276580,139737808,459014388,8,0,1,15360,2,5926644306
12448,319276790,140170607,459447397,8,0,1,529920,2,10423058428
12449,319288780,140174427,459463207,7,0,1,18432,16,1165185575
12450,319295239,107388790,426684029,5,0,0,25088,11,8047066201
12451,319295540,107944844,427240384,0,0,0,256512,10,2098000972
12452,319304591,140208751,459513342,9,0,1,41984,17,1119041524
12453,319322211,140192514,459514725,9,0,1,14848,17,8743212952
12454,319332830,140294861,459627691,8,0,1,118272,2,5957768209
12455,319355911,140271803,459627714,9,0,1,8704,17,5328709700
12456,319392199,107250653,426642852,5,0,0,99328,11,3310782122
12457,319490360,107185899,426676259,0,0,0,109568,10,7614514643
12458,319506330,140121407,459627737,7,0,1,19456,16,1230066988
12459,319508591,107405370,426913961,2,0,0,1024,4,10284207180
12460,319516720,140111040,459627760,7,0,1,4096,16,662671483
12461,319542470,106993281,426535751,0,0,0,5120,10,202861800
12462,319570890,107556184,427127074,0,0,0,208384,10,5029018841
12463,319606980,140020803,459627783,7,0,1,8704,16,10556271565
12464,319620330,140236713,459857043,8,0,1,321536,2,8223184193
12465,319649171,106754654,426403825,2,0,0,3072,4,4741197512
12466,319670250,140926016,460596266,8,0,1,134144,2,5107519408
12467,319685650,140962344,460647994,8,0,1,118784,2,697458238
12468,319804380,106959439,426763819,0,0,0,52224,10,4557111033
12469,319833791,140814226,460648017,9,0,1,14848,17,10577825921
12470,319852759,106984612,426837371,5,0,0,168448,11,2953582545
12471,319863150,106982544,426845694,0,0,0,17920,10,5436003302
12472,319894310,140753730,460648040,3,0,1,14336,3,1949578010
12473,319897291,107232013,427129304,2,0,0,2560,4,538956473
12474,319915120,140869154,460784274,7,0,1,22528,16,9549301436
12475,319933879,107540358,427474237,5,0,0,65024,11,8368752247
12476,319973699,107512573,427486272,5,0,0,39424,11,8312036496
12477,320004870,140779443,460784313,8,0,1,97280,2,10145398984
12478,320010140,140774196,460784336,7,0,1,10240,16,7191673847
12479,320054340,107093239,427147579,0,0,0,59904,10,4377550973
12480,320062889,107309163,427372052,5,0,0,144384,11,9877264239
12481,320071230,106968914,427040144,0,0,0,65536,10,8026025323
12482,320185010,140599349,460784359,7,0,1,5120,16,4586472581
12483,320199139,140613190,460812329,4,0,1,47616,2,7035403538
12484,320251440,140636790,460888230,3,0,1,90112,3,2098694995
12485,320274990,106977140,427252130,0,0,0,38400,10,999772534
12486,320387320,107032069,427419389,0,0,0,155136,10,10318192542
12487,320393890,140681328,461075218,3,0,1,146432,3,2254196324
12488,320445420,140629952,461075372,7,0,1,8704,16,6015570433
12489,320450771,106541496,426992267,2,0,0,4096,4,2182225714
12490,320451390,140660435,461111825,8,0,1,13824,2,237383272
12491,320494521,106423512,426918033,2,0,0,5632,4,7373166091
12492,320660399,106468102,427128501,5,0,0,4608,11,4679328415
12493,320683910,140498789,461182699,7,0,1,23040,16,79451322
12494,320691090,106763312,427454402,0,0,0,18432,10,4718494673
12495,320719750,106728990,427448740,0,0,0,96256,10,7494174635
12496,320743449,140443219,461186668,4,0,1,18944,2,3664282455
12497,320751769,106936213,427687982,5,0,0,151040,11,5315833868
12498,320760189,140471467,461231656,4,0,1,1536,2,7840142585
12499,320763050,140680840,461443890,3,0,1,193024,3,5883061068
12500,320777059,107069774,427846833,5,0,0,151040,11,316753606
12501,320818370,140907268,461725638,8,0,1,165376,2,6207724926
12502,320820090,140911142,461731232,7,0,1,18432,16,2004567352
12503,320852780,140882958,461735738,7,0,1,7168,16,5543677832
12504,320865180,106935610,427800790,0,0,0,350208,10,2533585967
12505,320921980,141018133,461940113,3,0,1,127488,3,3273671531
12506,320926730,141223305,462150035,3,0,1,321536,3,8705724346
12507,320968060,141181998,462150058,7,0,1,512,16,10565442735
12508,320976760,141321721,462298481,3,0,1,129024,3,3148751772
12509,320991539,141364552,462356091,4,0,1,49152,2,752512745
12510,321010030,106949172,427959202,0,0,0,143872,10,5187411213
12511,321037029,141319085,462356114,4,0,1,5632,2,5171770630
12512,321078820,141284537,462363357,3,0,1,35840,3,4749395680
12513,321084140,141290178,462374318,7,0,1,25088,16,1463923815
12514,321090270,106823408,427913678,0,0,0,159744,10,727776473
12515,321104839,141278197,462383036,4,0,1,23040,2,3733120092
12516,321113531,106736445,427849976,2,0,0,10240,4,478932109
12517,321117370,142276146,463393516,3,0,1,436736,3,5533453102
12518,321136370,142434220,463570590,8,0,1,366592,2,8714553637
12519,321138970,142431966,463570936,8,0,1,512,2,6294156410
12520,321141659,107111518,428253177,5,0,0,281088,11,5950782296
12521,321176669,142395547,463572216,4,0,1,14336,2,9941105050
12522,321179001,106735028,427914029,2,0,0,1024,4,5987910237
12523,321208780,142420790,463629570,3,0,1,49152,3,10477315710
12524,321208950,106656025,427864975,0,0,0,49152,10,2338448584
12525,321373399,142256517,463629916,4,0,1,512,2,9977672269
12526,321428739,142205389,463634128,4,0,1,6656,2,1120644510
12527,321430020,142228531,463658551,5,0,1,41472,11,6694584503
12528,321439650,142219247,463658897,3,0,1,512,3,5678518220
12529,321448210,142257891,463706101,8,0,1,76800,2,8946531805
12530,321451529,106715965,428167494,5,0,0,214016,11,8868093063
12531,321465019,142253500,463718519,4,0,1,36352,2,7092099004
12532,321480849,142287630,463768479,4,0,1,34304,2,10167708246
12533,321496361,106539843,428036204,2,0,0,2048,4,8278451954
12534,321594800,106730145,428324945,0,0,0,206336,10,8194472146
12535,321664641,106305404,427970045,2,0,0,8704,4,2957006152
12536,321678059,142090443,463768502,4,0,1,4096,2,4916820647
12537,321806309,106521483,428327792,5,0,0,9216,11,9638909555
12538,321904480,141864692,463769172,7,0,1,4608,16,433525559
12539,321911910,141857285,463769195,7,0,1,20480,16,1054007152
12540,321914800,141854418,463769218,3,0,1,40448,3,1063280832
12541,321946060,106412244,428358304,0,0,0,44032,10,9742244957
12542,321951159,106393706,428344865,5,0,0,55808,11,9754256249
12543,321962290,141811086,463773376,7,0,1,11776,16,2946747888
12544,321981940,141794982,463776922,7,0,1,5632,16,7780386363
12545,322020590,141768609,463789199,5,0,1,27648,11,1591893782
12546,322024900,106462217,428487117,0,0,0,96256,10,9687627083
12547,322054480,106492940,428547420,0,0,0,38912,10,6196865150
12548,322066509,106426871,428493380,5,0,0,20480,11,4725967936
12549,322072769,141735467,463808236,1,0,1,59904,5,2047318256
12550,322097610,106570762,428668372,0,0,0,124928,10,171459058
12551,322104669,141704233,463808902,4,0,1,11264,2,8163073912
12552,322176619,141666524,463843143,4,0,1,76288,2,2481096860
12553,322187380,141664378,463851758,3,0,1,22528,3,10544066777
12554,322199760,141658830,463858590,3,0,1,22528,3,4563848883
12555,322205099,106497563,428702662,5,0,0,54784,11,10173566113
12556,322240179,106785001,429025180,5,0,0,118784,11,988170720
12557,322241390,107309964,429551354,0,0,0,64512,10,1358270013
12558,322256921,106236996,428493917,2,0,0,1536,4,6251421977
12559,322292740,141599086,463891826,7,0,1,37888,16,8830911720
12560,322352910,141577622,463930532,3,0,1,40960,3,5577454105
12561,322354819,141591448,463946267,4,0,1,54272,2,795879189
12562,322427710,141529771,463957481,3,0,1,25600,3,3929775700
12563,322432169,106791329,429223498,5,0,0,214016,11,5071152940
12564,322491309,106338632,428829941,5,0,0,29184,11,10405746958
12565,322498710,141498840,463997550,3,0,1,39936,3,2481681862
12566,322518651,106184190,428702841,2,0,0,512,4,922655972
12567,322564799,141433827,463998626,4,0,1,13312,2,3664293860
12568,322645710,141376024,464021734,3,0,1,40960,3,5751190247
12569,322649560,141381954,464031514,3,0,1,4096,3,7101889961
12570,322653040,106061441,428714481,3,0,0,2560,3,5566998046
12571,322681469,106139534,428821003,5,0,0,169472,11,10057897424
12572,322683600,141649409,464333009,3,0,1,17408,3,6749415564
12573,322689801,106169332,428859133,2,0,0,6144,4,5973343752
12574,322718350,141620868,464339218,3,0,1,21504,3,7749292208
12575,322750549,141714566,464465115,4,0,1,9728,2,320101260
12576,322821029,142521202,465342231,4,0,1,22016,2,6053177821
12577,322821589,142687732,465509321,4,0,1,52736,2,2512773681
12578,322823679,142835617,465659296,4,0,1,33280,2,6202923564
12579,323022509,106640607,429663116,5,0,0,339456,11,9613255352
12580,323025649,142633670,465659319,1,0,1,4096,5,2538696807
12581,323077201,105664646,428741847,2,0,0,512,4,10469426478
12582,323088849,142570493,465659342,4,0,1,9728,2,5651966379
12583,323142489,105899406,429041895,5,0,0,54784,11,6455320426
12584,323166201,105739683,428905884,2,0,0,4608,4,4521298671
12585,323226849,106261283,429488132,5,0,0,151552,11,8954748888
12586,323245849,142442354,465688203,1,0,1,4608,5,5699786343
12587,323252999,142530359,465783358,1,0,1,41984,5,7192325707
12588,323305329,106361559,429666888,5,0,0,11776,11,8892878503
12589,323310639,106490414,429801053,5,0,0,224768,11,112661118
12590,323322589,142534535,465857124,1,0,1,4096,5,5346064628
12591,323339859,142522654,465862513,4,0,1,17408,2,7318424880
12592,323349860,106091738,429441598,0,0,0,173056,10,8996708645
12593,323352699,142707219,466059918,1,0,1,18944,5,9949892195
12594,323405049,142654892,466059941,4,0,1,9728,2,1407507052
12595,323430970,142628994,466059964,6,0,1,51200,7,197036779
12596,323444570,106973500,430418070,0,0,0,545280,10,875970122
12597,323452210,142607777,466059987,6,0,1,4608,7,9381561063
12598,323456601,106258131,429714732,2,0,0,11776,4,9041085957
12599,323495900,142564110,466060010,5,0,1,8192,11,1006280002
12600,323509750,142606617,466116367,6,0,1,60416,7,4622346041
12601,323605580,142511453,466117033,6,0,1,1024,7,368327147
12602,323616491,105825442,429441933,2,0,0,1024,4,7297339681
12603,323619139,142510450,466129589,1,0,1,28672,5,8995675946
12604,323673310,142779943,466453253,5,0,1,45568,11,9677067675
12605,323742099,142711177,466453276,1,0,1,9216,5,10066989956
12606,323758990,142694309,466453299,5,0,1,22016,11,3514798449
12607,323772671,106070205,429842876,2,0,0,8192,4,1530684950
12608,323845820,106122868,429968688,0,0,0,218112,10,10047261756
12609,323899049,142555232,466454281,4,0,1,24576,2,3703951397
12610,323906479,106803222,430709701,5,0,0,384000,11,10685534350
12611,323925101,106043991,429969092,2,0,0,1024,4,5435554931
12612,323955810,142635201,466591011,6,0,1,48640,7,9316811358
12613,323988260,142763976,466752236,5,0,1,39936,11,2749614806
12614,324014780,106727236,430742016,0,0,0,105984,10,9254805477
12615,324053350,142699712,466753062,6,0,1,5632,7,8841207482
12616,324115020,142641410,466756430,5,0,1,14336,11,3749117838
12617,324116890,142639563,466756453,6,0,1,16896,7,2529177845
12618,324137871,106400740,430538611,2,0,0,1024,4,802699732
12619,324185299,142573251,466758550,1,0,1,28672,5,6219062515
12620,324244409,142777913,467022322,4,0,1,84992,2,4763038201
12621,324293300,142729045,467022345,6,0,1,18432,7,8641743940
12622,324301429,143546508,467847937,4,0,1,53248,2,10623842492
12623,324307260,106231016,430538276,0,0,0,266240,10,4556977680
12624,324360539,107124678,431485217,5,0,0,368128,11,936724193
12625,324395349,143452611,467847960,1,0,1,7680,5,7289617049
12626,324430430,106502438,430932868,0,0,0,299008,10,2389882104
12627,324435710,106384226,430819936,0,0,0,37376,10,7800470803
12628,324490179,143419464,467909643,1,0,1,33280,5,3261610992
12629,324514540,106442063,430956603,0,0,0,77824,10,6217855941
12630,324540229,143408717,467948946,4,0,1,7680,2,4077120112
12631,324565839,143388253,467954092,4,0,1,8192,2,5260883332
12632,324587779,143608453,468196232,4,0,1,75264,2,822700043
12633,324607019,143589236,468196255,4,0,1,25600,2,786782108
12634,324653669,143579372,468233041,4,0,1,13824,2,8320494116
12635,324661040,143573307,468234347,6,0,1,2048,7,6460430471
12636,324681411,106275394,430956805,2,0,0,512,4,3205971793
12637,324713610,106372091,431085701,0,0,0,22016,10,10398927201
12638,324754520,143497348,468251868,6,0,1,16384,7,3931270246
12639,324758269,143496185,468254454,1,0,1,4096,5,296133607
12640,324767339,143489701,468257040,1,0,1,4096,5,1353800535
12641,324774319,106034183,430808502,5,0,0,130048,11,5430302448
12642,324865799,106167756,431033555,5,0,0,53760,11,8010556545
12643,324866669,106438038,431304707,5,0,0,467456,11,4051318202
12644,324919390,143344218,468263608,5,0,1,31232,11,6920795738
12645,324919509,143602719,468522228,4,0,1,30720,2,6959856034
12646,324935720,106583551,431519271,0,0,0,29184,10,904364608
12647,324946280,143575971,468522251,6,0,1,1536,7,10733930543
12648,324965790,143556508,468522298,6,0,1,27136,7,3895095878
12649,324966340,106360276,431326616,0,0,0,71680,10,5186431808
12650,324971609,143550720,468522329,1,0,1,7680,5,772072888
12651,324977720,143544632,468522352,6,0,1,8704,7,9314381704
12652,325090300,106420056,431510356,0,0,0,82432,10,5924837003
12653,325105160,143435669,468540829,5,0,1,16896,11,3537620301
12654,325200189,105815948,431016137,5,0,0,34304,11,877281983
12655,325225471,143330380,468555851,9,0,1,27648,17,3971436898
12656,325226790,143360307,468587097,5,0,1,8192,11,5185417016
12657,325234770,106111369,431346139,0,0,0,64000,10,7898027707
12658,325345540,143241580,468587120,5,0,1,13312,11,7599977095
12659,325516429,106045765,431562194,5,0,0,140800,11,7447135734
12660,325715349,142871794,468587143,4,0,1,24576,2,2671975218
12661,325734639,142852527,468587166,4,0,1,31744,2,4371500051
12662,325750889,105855195,431606084,5,0,0,72704,11,2374116216
12663,325809400,142777797,468587197,5,0,1,11776,11,5840003971
12664,325875059,142844636,468719695,4,0,1,4608,2,3348031317
12665,325892861,105909206,431802067,2,0,0,8704,4,1075118013
12666,325906860,106066359,431973219,0,0,0,402432,10,10409545311
12667,325929560,106081578,432011138,0,0,0,92672,10,9226740657
12668,325982699,142738174,468720873,4,0,1,13824,2,1341651223
12669,325994329,106241926,432236255,5,0,0,45056,11,10437786578
12670,326003449,143451180,469454629,4,0,1,49664,2,9177708336
12671,326042849,143467591,469510440,4,0,1,512,2,8150277716
12672,326051330,105532579,431583909,0,0,0,71168,10,1969237347
12673,326199710,105991338,432191048,0,0,0,184832,10,7547884026
12674,326272440,143238023,469510463,5,0,1,1024,11,5979753775
12675,326274440,106512821,432787261,0,0,0,329216,10,5782937813
12676,326294560,143215926,469510486,5,0,1,10240,11,6089531424
12677,326319050,106321704,432640754,0,0,0,183296,10,7379066122
12678,326446729,143124861,469571590,4,0,1,20480,2,335850460
12679,326569450,105180411,431749861,0,0,0,19968,10,3454785187
12680,326607900,105786967,432394867,0,0,0,68096,10,7880977119
12681,326659369,142912244,469571613,4,0,1,17408,2,2318860767
12682,326683059,106319716,433002775,5,0,0,324608,11,10337246786
12683,326684699,142886937,469571636,4,0,1,8704,2,5114913756
12684,326763601,105358707,432122308,2,0,0,3072,4,9918054061
12685,326846310,105738573,432584883,0,0,0,91648,10,5894251179
12686,326869880,143310391,470180271,8,0,1,87040,2,2731031562
12687,326882630,143614830,470497460,8,0,1,8704,2,7481240369
12688,326885050,106273193,433158243,0,0,0,24064,10,9543749369
12689,326888611,105123330,432011941,2,0,0,2560,4,1407021194
12690,326964990,144123817,471088807,8,0,1,176128,2,9307673255
12691,327009129,144079701,471088830,4,0,1,18432,2,1506168095
12692,327034171,105626426,432660597,2,0,0,16384,4,2152636969
12693,327044330,144111938,471156268,8,0,1,32768,2,3211608759
12694,327131130,144223537,471354667,8,0,1,61952,2,6197413355
12695,327134060,105739987,432874047,0,0,0,161280,10,7135411249
12696,327161119,144245909,471407028,4,0,1,23552,2,1348050183
12697,327202901,104989130,432192031,2,0,0,3072,4,6006583164
12698,327212700,144340996,471553696,8,0,1,157696,2,2039589233
12699,327222469,144337513,471559982,4,0,1,31232,2,9323907223
12700,327241680,105155238,432396918,0,0,0,6656,10,5507116696
12701,327244510,144361873,471606383,7,0,1,7680,16,6153949837
12702,327256659,144349747,471606406,4,0,1,25088,2,3908580567
12703,327373300,105864734,433238034,0,0,0,17920,10,7766496717
12704,327403509,105747379,433150888,5,0,0,146944,11,7736114296
12705,327457679,144167511,471625190,4,0,1,24064,2,10494441853
12706,327484959,144161325,471646284,4,0,1,9216,2,1329318688
12707,327499590,144190249,471689839,7,0,1,35328,16,872427508
12708,327511010,144381291,471892301,8,0,1,125952,2,7959017415
12709,327512219,105719280,433231499,5,0,0,240128,11,7395558256
12710,327517289,105588804,433106093,5,0,0,335872,11,10540231743
12711,327588429,144303895,471892324,1,0,1,25088,5,9262423254
12712,327627759,144264588,471892347,4,0,1,6656,2,442523032
12713,327629829,106135664,433765493,5,0,0,667648,11,3087768977
12714,327745000,144147370,471892370,3,0,1,37888,3,1029682810
12715,327801991,105963681,433765672,2,0,0,512,4,9450192625
12716,327896500,143995893,471892393,7,0,1,35328,16,1546285664
12717,328195670,143696746,471892416,7,0,1,16384,16,4182009313
12718,328219260,144159243,472378503,8,0,1,354304,2,3045965135
12719,328252680,105103636,433356316,0,0,0,8704,10,6597775270
12720,328258170,144165591,472423761,7,0,1,34816,16,4142852256
12721,328288290,144137417,472425707,7,0,1,3072,16,5165104711
12722,328288309,105499006,433787315,5,0,0,56320,11,4363243746
12723,328297910,144138990,472436900,7,0,1,22528,16,3615022042
12724,328358560,144078363,472436923,8,0,1,15360,2,4685646728
12725,328391951,104611783,433003734,2,0,0,3072,4,2565126463
12726,328478729,105361851,433840580,5,0,0,174592,11,2669322619
12727,328540810,143995317,472536127,8,0,1,87552,2,5137114023
12728,328550960,143989578,472540538,7,0,1,1024,16,9515246710
12729,328739019,104493532,433232551,5,0,0,3072,11,7837954690
12730,328890670,105267143,434157813,0,0,0,146432,10,61720173
12731,328969959,105139847,434109806,5,0,0,492032,11,3267836183
12732,328983279,104919824,433903103,5,0,0,87552,11,8362644738
12733,329001161,105110586,434111747,2,0,0,6144,4,5181515354
12734,329004270,143539174,472543444,7,0,1,4608,16,7082221402
12735,329077890,143498757,472576647,7,0,1,18432,16,1043324382
12736,329124929,104751195,433876124,5,0,0,65024,11,1849446404
12737,329184739,105097036,434281775,5,0,0,11776,11,7380522587
12738,329195300,143384573,472579873,2,0,1,5120,4,7020861197
12739,329197151,104568902,433766053,2,0,0,1024,4,4036601040
12740,329199839,105078146,434277985,5,0,0,123392,11,7964787880
12741,329233160,143408502,472641662,7,0,1,41472,16,1466428532
12742,329257710,104597401,433855111,0,0,0,47616,10,5395155653
12743,329267031,104846143,434113174,2,0,0,4608,4,9268668833
12744,329269490,143389685,472659175,6,0,1,31744,7,1098683482
12745,329458189,104726167,434184356,5,0,0,87040,11,1378682818
12746,329498620,104735546,434234166,0,0,0,155136,10,3589946680
12747,329527521,104328705,433856226,2,0,0,3584,4,10540528837
12748,329528960,143192568,472721528,6,0,1,22016,7,10514052403
12749,329577701,104704269,434281970,2,0,0,512,4,8672559935
12750,329595740,143126659,472722399,7,0,1,12288,16,6320278449
12751,329631790,104138342,433770132,0,0,0,13312,10,5148864555
12752,329636820,143326361,472963181,7,0,1,16384,16,1039188744
12753,329805210,143157994,472963204,6,0,1,10752,7,3110977671
12754,329838410,104567154,434405564,0,0,0,158720,10,8155360589
12755,329857770,143701249,473559019,7,0,1,57344,16,8046565731
12756,329887351,103988983,433876334,2,0,0,512,4,8421829944
12757,329901941,104332583,434234524,2,0,0,1024,4,5859924207
12758,330034430,143745716,473780146,2,0,1,26112,4,8713198199
12759,330047450,143732719,473780169,6,0,1,11264,7,6753420120
12760,330057740,143722452,473780192,6,0,1,3584,7,3074654560
12761,330085951,103860425,433946376,2,0,0,5120,4,956139009
12762,330126131,103777221,433903352,2,0,0,512,4,2640796905
12763,330151671,104126493,434278164,2,0,0,512,4,7851218940
12764,330164250,143615965,473780215,7,0,1,11264,16,7629605280
12765,330178050,143814121,473992171,2,0,1,20480,4,9911829953
12766,330221740,143770454,473992194,7,0,1,10752,16,5422736684
12767,330239120,143753097,473992217,2,0,1,5120,4,7264674123
12768,330277330,143714910,473992240,2,0,1,2560,4,2588735054
12769,330288230,144055420,474343650,2,0,1,42496,4,8199683265
12770,330296189,103890686,434186875,5,0,0,8192,11,5932727403
12771,330398550,144050641,474449191,7,0,1,10240,16,4993173717
12772,330402599,104303026,434705625,5,0,0,141824,11,8237410140
12773,330520210,143990335,474510545,7,0,1,30208,16,6770205959
12774,330558600,143962911,474521511,7,0,1,20992,16,4173656795
12775,330579580,143954880,474534460,7,0,1,48128,16,312631709
12776,330588600,143972434,474561034,7,0,1,512,16,1938103591
12777,330730201,103510118,434240319,2,0,0,18944,4,7560187809
12778,330743200,143817988,474561188,7,0,1,8704,16,9669009718
12779,330784720,104575942,435360662,0,0,0,535552,10,9262373147
12780,330855120,104222189,435077309,0,0,0,253440,10,2771437580
12781,330889410,143679138,474568548,7,0,1,2048,16,5392257763
12782,330890220,104304647,435194867,0,0,0,140288,10,2682044209
12783,330893690,143676036,474569726,7,0,1,13824,16,6045326977
12784,330902259,104505925,435408184,5,0,0,155136,11,8485215021
12785,330973610,143617435,474591045,5,0,1,31232,11,5646619013
12786,331033590,143612883,474646473,2,0,1,18944,4,3240859928
12787,331067851,103430417,434498268,2,0,0,1024,4,6499681520
12788,331097550,143557364,474654914,7,0,1,15360,16,9157260313
12789,331099130,103612914,434712044,0,0,0,20992,10,1121868390
12790,331107120,103510662,434617782,0,0,0,29184,10,9837199804
12791,331122660,143965326,475087986,7,0,1,10752,16,2836216687
12792,331130340,103869726,435000066,0,0,0,183808,10,1898292418
12793,331131849,103445215,434577064,5,0,0,22528,11,3183490626
12794,331157700,103735568,434893268,0,0,0,35840,10,2860868998
12795,331191370,143896639,475088009,7,0,1,2560,16,9863001575
12796,331234850,104215289,435450139,0,0,0,136192,10,1037696700
12797,331332001,103407111,434739112,2,0,0,1024,4,6277903228
12798,331335560,143761855,475097415,2,0,1,18944,4,944949069
12799,331371479,143725959,475097438,1,0,1,11264,5,1176481165
12800,331455620,143641841,475097461,2,0,1,4608,4,3095620281
12801,331503979,104189463,435693442,5,0,0,249856,11,3097274575
12802,331528900,104088322,435617222,0,0,0,291840,10,7678946802
12803,331535019,103617081,435152100,5,0,0,174592,11,7402752146
12804,331542329,143555155,475097484,1,0,1,16896,5,362140404
12805,331547429,143617715,475165144,0,0,1,15360,10,6409581993
12806,331565709,143637709,475203418,1,0,1,36352,5,3023314902
12807,331686269,143532682,475218951,1,0,1,8192,5,6401040967
12808,331717180,143503256,475220436,2,0,1,15360,4,2431457339
12809,331758750,143513912,475272662,2,0,1,6144,4,5389153230
12810,331852489,143421479,475273968,1,0,1,2048,5,943828334
12811,331881201,103314804,435196005,2,0,0,3584,4,6167307673
12812,331890250,103812176,435702426,0,0,0,29184,10,1570266013
12813,331908309,143406077,475314386,0,0,1,37376,10,643499868
12814,331944019,143372313,475316332,1,0,1,3072,5,7516094837
12815,331964479,143413002,475377481,1,0,1,17408,5,7286233267
12816,331985280,103423262,435408542,0,0,0,1024,10,3964950437
12817,332005379,103192084,435197463,5,0,0,4608,11,9586904301
12818,332017999,143359505,475377504,1,0,1,7680,5,5251620225
12819,332019790,103477804,435497594,0,0,0,155648,10,9739267497
12820,332033669,143343858,475377527,1,0,1,11776,5,3537793852
12821,332125680,143254189,475379869,2,0,1,6656,4,5735996146
12822,332168159,143216536,475384695,1,0,1,7680,5,5857033962
12823,332178560,143327915,475506475,2,0,1,36864,4,6321622084
12824,332246159,103556957,435803116,5,0,0,54272,11,1996053168
12825,332296079,143304289,475600368,1,0,1,25600,5,8049362451
12826,332357591,103529972,435887563,2,0,0,1024,4,8052327365
12827,332401690,143377113,475778803,2,0,1,13312,4,6682907211
12828,332420300,143358526,475778826,2,0,1,17920,4,7600764361
12829,332453139,143670317,476123456,1,0,1,26112,5,10366434456
12830,332473050,143651072,476124122,2,0,1,1024,4,2014894308
12831,332669479,103317554,435987033,5,0,0,47104,11,4379452625
12832,332675180,143462060,476137240,2,0,1,22016,4,3425340985
12833,332704279,103356930,436061209,5,0,0,141312,11,4432838102
12834,332767651,102935110,435702761,2,0,0,1024,4,3349444297
12835,332804310,103045651,435849961,0,0,0,14848,10,6882883780
12836,332920120,103750693,436670813,0,0,0,226304,10,9765009585
12837,332960730,103100658,436061388,7,0,0,512,16,10306968032
12838,332963241,102867689,435830930,2,0,0,2048,4,4133102377
12839,332963770,143177336,476141106,3,0,1,6144,3,9946797802
12840,332969221,102856281,435825502,2,0,0,5632,4,9974057901
12841,332988301,102714959,435703260,2,0,0,1536,4,4851008111
12842,332991689,103313032,436304721,5,0,0,68608,11,6972184825
12843,333045780,103409998,436455778,0,0,0,54784,10,4991090061
12844,333200710,103238353,436439063,0,0,0,338944,10,9828018474
12845,333216329,103865279,437081608,5,0,0,64000,11,9887287794
12846,333223170,103478210,436701380,0,0,0,76288,10,5449082805
12847,333335339,103515720,436851059,5,0,0,267264,11,8343127859
12848,333364990,103697095,437062085,0,0,0,353792,10,6598161173
12849,333408950,103809921,437218871,0,0,0,206848,10,7080158880
12850,333664351,102324733,435989084,2,0,0,6656,4,5147479305
12851,333696481,104110942,437807423,2,0,0,657408,4,4138005085
12852,333708670,143352161,477060831,5,0,1,5120,11,8745217527
12853,333782240,103719915,437502155,0,0,0,391680,10,4406000960
12854,333833000,143340254,477173254,5,0,1,11776,11,8440989995
12855,333854020,102234353,436088373,0,0,0,37376,10,4212919621
12856,333861401,103387289,437248690,2,0,0,97792,4,4700480385
12857,333866350,143306927,477173277,5,0,1,19968,11,4016310052
12858,333907529,103689550,437597079,5,0,0,78848,11,2018757420
12859,333943099,104075180,438018279,5,0,0,371200,11,4967725493
12860,333957009,143216291,477173300,0,0,1,1536,10,2169949062
12861,333986640,143186683,477173323,5,0,1,6144,11,8323151443
12862,333993141,104167300,438160441,2,0,0,293888,4,5356379545
12863,333998110,143246083,477244193,3,0,1,14848,3,10616959757
12864,333999729,104214875,438214604,5,0,0,177664,11,7607873623
12865,334102510,103802638,437905148,0,0,0,320512,10,2394082127
12866,334230300,143079825,477310125,5,0,1,12800,11,6755964408
12867,334236400,143110705,477347105,5,0,1,3072,11,1385431481
12868,334247680,143099448,477347128,5,0,1,7168,11,2183453279
12869,334266540,143130500,477397040,5,0,1,2048,11,10068925652
12870,334355730,143210321,477566051,5,0,1,1536,11,3103137681
12871,334459139,103611735,438070874,5,0,0,172544,11,739395381
12872,334488889,103785174,438274063,5,0,0,195072,11,2754711144
12873,334638629,103896653,438535282,5,0,0,544768,11,7870197706
12874,334663890,143578143,478242033,5,0,1,34304,11,3315590814
12875,334748020,143565546,478313566,5,0,1,57344,11,5539078663
12876,334760390,143553199,478313589,5,0,1,20992,11,4314865832
12877,334768609,103969702,438738311,5,0,0,53248,11,10360698511
12878,334801461,103486517,438287978,2,0,0,45568,4,5765599974
12879,334850331,143579212,478429543,9,0,1,3584,17,755497852
12880,334887810,143541756,478429566,6,0,1,25600,7,3511649131
12881,334927560,143502029,478429589,5,0,1,1536,11,376176502
12882,334948049,103649032,438597081,5,0,0,202752,11,7941269374
12883,334969319,143460293,478429612,0,0,1,19456,10,1080093718
12884,335024929,103612290,438637219,5,0,0,131584,11,7492411199
12885,335048301,103950296,438998597,2,0,0,195584,4,4645579686
12886,335048770,143380873,478429643,5,0,1,11776,11,625038749
12887,335083820,143402832,478486652,5,0,1,29184,11,7291658447
12888,335116971,104218384,439335355,2,0,0,340992,4,8927379294
12889,335158379,103869881,439028260,5,0,0,97280,11,4365461133
12890,335241779,143244912,478486691,0,0,1,11776,10,9663862185
12891,335271999,143214715,478486714,0,0,1,5120,10,10512141597
12892,335310459,143176278,478486737,0,0,1,11264,10,4759470888
12893,335335880,143198951,478534831,6,0,1,5120,7,6027354584
12894,335343110,143191744,478534854,6,0,1,512,7,3822451664
12895,335345020,143189857,478534877,6,0,1,1536,7,33268985
12896,335385269,143149655,478534924,0,0,1,53248,10,3738861887
12897,335476029,103174161,438650190,5,0,0,42496,11,5701997105
12898,335556261,103675175,439231436,2,0,0,232960,4,7806467641
12899,335566709,103840000,439406709,5,0,0,145408,11,2786528977
12900,335593699,142941248,478534947,0,0,1,11776,10,10442858720
12901,335594709,103144717,438739426,5,0,0,3584,11,4109142280
12902,335738269,103951814,439690083,5,0,0,717312,11,8512080355
12903,335749420,103411013,439160433,0,0,0,41472,10,3544107250
12904,335820159,142714811,478534970,0,0,1,6144,10,8439182925
12905,335857859,142677134,478534993,0,0,1,10240,10,5026450397
12906,335904070,103458304,439362374,0,0,0,88576,10,8626620711
12907,335954369,142580647,478535016,0,0,1,27136,10,4576005286
12908,335978450,103798883,439777333,0,0,0,270848,10,1016236538
12909,335996779,103474725,439471504,5,0,0,112128,11,448663808
12910,336030241,103664545,439694786,2,0,0,15360,4,2032252080
12911,336047909,142591088,478638997,0,0,1,30208,10,7319435852
12912,336051539,142587497,478639036,0,0,1,8192,10,6530380621
12913,336155350,103642649,439797999,0,0,0,67072,10,4717066014
12914,336268541,103541578,439810119,2,0,0,39424,4,9777784351
12915,336273731,103571090,439844821,2,0,0,113664,4,1449813676
12916,336287971,103611033,439899004,2,0,0,16896,4,4971046879
12917,336332960,142306099,478639059,6,0,1,21504,7,3861992706
12918,336368279,142270803,478639082,0,0,1,16384,10,6845783413
12919,336396289,143024987,479421276,0,0,1,122368,10,4314470699
12920,336463391,103839719,440303110,2,0,0,89600,4,7266599848
12921,336500450,104322650,440823100,9,0,0,113152,17,1308398664
12922,336512601,103843202,440355803,2,0,0,14336,4,1541804755
12923,336538981,103525651,440064632,2,0,0,4096,4,5108990647
12924,336545920,143299927,479845847,7,0,1,1536,16,5051441967
12925,336577291,104131867,440709158,2,0,0,259584,4,6638994684
12926,336591620,143254791,479846411,5,0,1,10752,11,7458441908
12927,336627909,103435452,440063361,5,0,0,26624,11,6857706711
12928,336652330,103976286,440628616,0,0,0,546816,10,6404687989
12929,336659040,143359076,480018116,5,0,1,56320,11,3454215893
12930,336687851,103713329,440401180,2,0,0,145408,4,2052404292
12931,336690320,143331022,480021342,5,0,1,5120,11,4435468211
12932,336692449,103725121,440417570,5,0,0,9728,11,965775765
12933,336736539,143303236,480039775,0,0,1,24576,10,9709218496
12934,336749950,143407040,480156990,7,0,1,47616,16,5894304955
12935,336761190,143762795,480523985,5,0,1,8704,11,8181843142
12936,336783729,143784490,480568219,0,0,1,6144,10,9975703981
12937,336796610,104102516,440899126,9,0,0,165888,17,9535022362
12938,336818621,103969980,440788601,2,0,0,260608,4,206026322
12939,336851830,143838995,480690825,3,0,1,5632,3,5325401666
12940,336870219,103978340,440848559,5,0,0,83456,11,6906133265
12941,336905389,103724654,440630043,5,0,0,4608,11,7751336140
12942,336943260,143802811,480746071,7,0,1,512,16,4912039530
12943,336951240,143822648,480773888,7,0,1,39424,16,4082576547
12944,336989671,103928861,440918532,2,0,0,63488,4,5732929397
12945,336998820,143850235,480849055,2,0,1,24576,4,10221889756
12946,337004590,144144893,481149483,5,0,1,50688,11,9867634683
12947,337012270,144137236,481149506,2,0,1,10752,4,7946602540
12948,337024440,144396200,481420640,7,0,1,82432,16,9134551175
12949,337038600,144382063,481420663,5,0,1,10240,11,8199404012
12950,337048660,104180415,441229075,0,0,0,200704,10,5410076982
12951,337173360,103985317,441158677,9,0,0,41472,17,8659788193
12952,337235769,144184917,481420686,4,0,1,10240,2,9828100996
12953,337238169,104285441,441523610,5,0,0,297984,11,455510145
12954,337285450,104075307,441360757,0,0,0,4608,10,680064779
12955,337314571,104108210,441422781,2,0,0,23552,4,9805830930
12956,337315900,144106400,481422300,7,0,1,17920,16,7292031633
12957,337323091,144099232,481422323,9,0,1,6144,17,3740190603
12958,337327470,104066312,441393782,0,0,0,3072,10,272804780
12959,337396710,104547895,441944605,9,0,0,428544,17,7938914393
12960,337421940,144000406,481422346,5,0,1,33280,11,8247183859
12961,337455769,144255336,481711105,0,0,1,51200,10,8414289615
12962,337496001,104471582,441967583,2,0,0,75264,4,2758722527
12963,337514989,144235318,481750307,0,0,1,5120,10,8510814522
12964,337524020,144226318,481750338,7,0,1,19456,16,913933859
12965,337545920,144204441,481750361,7,0,1,18944,16,7642200837
12966,337595809,144162242,481758051,4,0,1,18432,2,5161491909
12967,337605229,144152845,481758074,4,0,1,6144,2,7769516349
12968,337634099,144123998,481758097,0,0,1,42496,10,174503703
12969,337638140,104582425,442220565,0,0,0,5632,10,3391402713
12970,337639670,104562414,442202084,9,0,0,138240,17,4341561039
12971,337651030,144107090,481758120,7,0,1,8704,16,7466009874
12972,337671929,104705609,442377538,5,0,0,172544,11,10709008188
12973,337718970,104327461,442046431,0,0,0,14848,10,6441612314
12974,337799409,104428979,442228388,5,0,0,25600,11,3176685149
12975,337814641,104933710,442748351,2,0,0,238592,4,899228736
12976,337823799,144025216,481849015,4,0,1,19968,2,8465726873
12977,337832759,144039234,481871993,0,0,1,17408,10,1247586254
12978,337845070,144135748,481980818,5,0,1,2048,11,9825496051
12979,337879320,144101521,481980841,7,0,1,26624,16,6972061905
12980,337882240,144098624,481980864,5,0,1,6144,11,4569573771
12981,337907030,104391468,442298498,9,0,0,120832,17,3173038374
12982,337914500,144335032,482249532,5,0,1,44032,11,6160598272
12983,337975040,144350549,482325589,7,0,1,2048,16,8814217710
12984,337983789,144341823,482325612,1,0,1,3584,5,8066568590
12985,337985781,104487907,442473688,2,0,0,98816,4,8235806440
12986,337987479,104811002,442798481,5,0,0,164352,11,599306187
12987,338007771,104667861,442675632,2,0,0,158208,4,4734182406
12988,338068200,144257435,482325635,7,0,1,2560,16,4799169442
12989,338079759,144364473,482444232,4,0,1,50688,2,7580625201
12990,338097590,104724251,442821841,0,0,0,8192,10,891337795
12991,338110729,104708554,442819283,5,0,0,68096,11,9709086327
12992,338116310,144351407,482467717,7,0,1,9728,16,5301586210
12993,338134769,144339497,482474266,1,0,1,3584,5,10070298763
12994,338144239,144336044,482480283,1,0,1,32256,5,6959544938
12995,338152890,104740406,442893296,0,0,0,1536,10,9206361294
12996,338166889,144315660,482482549,1,0,1,3584,5,10159003950
12997,338180140,105079702,443259842,0,0,0,5632,10,9652371558
12998,338180779,144375714,482556493,1,0,1,51712,5,4059518187
12999,338187959,144376685,482564644,1,0,1,17920,5,8209159336
13000,338196529,144379716,482576245,0,0,1,19968,10,6329006388
13001,338200189,144384891,482585080,0,0,1,14848,10,9203849808
13002,338248640,105306930,443555570,9,0,0,99328,17,7789413997
13003,338278021,104893529,443171550,2,0,0,140288,4,8002275471
13004,338292221,105658953,443951174,2,0,0,276480,4,1645910041
13005,338311129,145335094,483646223,4,0,1,40960,2,6435396523
13006,338315129,145406906,483722035,1,0,1,31744,5,10195699624
13007,338334350,105532561,443866911,9,0,0,445440,17,4596221722
13008,338334870,105119216,443454086,9,0,0,61440,17,8226818866
13009,338383840,105191680,443575520,0,0,0,512,10,7786698492
13010,338434070,104914159,443348229,0,0,0,1024,10,4288857978
13011,338444259,145457886,483902145,4,0,1,2048,2,6462797331
13012,338469049,145433119,483902168,4,0,1,3584,2,10230141452
13013,338482159,145420032,483902191,0,0,1,512,10,1116099607
13014,338507780,104890673,443398453,0,0,0,9216,10,1082763641
13015,338507819,145539411,484047230,1,0,1,52224,5,3007787264
13016,338550430,105040596,443591026,0,0,0,1536,10,8403942472
13017,338574650,104896001,443470651,0,0,0,3072,10,3356495237
13018,338594250,105065153,443659403,0,0,0,3072,10,2180970893
13019,338594679,145470537,484065216,4,0,1,34304,2,2463962672
13020,338612040,105046381,443658421,9,0,0,35328,17,6249158244
13021,338622390,105108778,443731168,9,0,0,72192,17,10222518283
13022,338649090,105303823,443952913,0,0,0,5632,10,7181352737
13023,338697119,145368144,484065263,0,0,1,10752,10,7604852298
13024,338741079,105858726,444599805,5,0,0,281088,11,10643484325
13025,338747279,145318007,484065286,0,0,1,2048,10,2166216350
13026,338756411,105586456,444342867,2,0,0,173056,4,4956522517
13027,338802029,145263280,484065309,0,0,1,8704,10,571377122
13028,338814079,145251253,484065332,0,0,1,17920,10,5883190856
13029,338819880,105316846,444136726,9,0,0,320000,17,2921922471
13030,338823909,106118890,444942799,5,0,0,288256,11,10607327659
13031,338908769,145156586,484065355,0,0,1,20480,10,5212281365
13032,338967000,104986092,443953092,0,0,0,512,10,1296108018
13033,338971830,105686061,444657891,0,0,0,16896,10,3358817227
13034,338984380,145173241,484157621,7,0,1,46592,16,9028948551
13035,338987289,105386529,444373818,5,0,0,61440,11,5505202896
13036,339052740,105714512,444767252,9,0,0,138240,17,8037509909
13037,339108309,145049335,484157644,0,0,1,1536,10,9926690290
13038,339111381,105516527,444627908,2,0,0,92160,4,5725235955
13039,339162079,144995588,484157667,0,0,1,16384,10,4109564569
13040,339167170,105913267,445080437,9,0,0,236544,17,1662497455
13041,339210880,105169345,444380225,0,0,0,6656,10,10459619597
13042,339219780,105036010,444255790,0,0,0,4608,10,3939425
13043,339289131,106030710,445319841,2,0,0,377856,4,6529437840
13044,339311639,105696703,445008342,5,0,0,215040,11,3748291776
13045,339341389,144846559,484187948,0,0,1,17920,10,10546327204
13046,339345820,105317554,444663374,9,0,0,17920,17,3445702834
13047,339438999,144749410,484188409,0,0,1,10240,10,2842547440
13048,339484511,144735406,484219917,9,0,1,1536,17,5891468090
13049,339526310,144694593,484220903,5,0,1,1536,11,3702104569
13050,339581580,105755148,445336728,9,0,0,55296,17,7733084200
13051,339637321,105567369,445204690,2,0,0,386560,4,10258287735
13052,339665469,144556420,484221889,0,0,1,1536,10,6505582729
13053,339689569,105397318,445086887,5,0,0,20992,11,8540661157
13054,339722879,144517724,484240603,0,0,1,40960,10,256711461
13055,339759060,144489506,484248566,6,0,1,2560,7,3956859107
13056,339761960,105605687,445367647,9,0,0,101376,17,3480977612
13057,339766339,144544227,484310566,0,0,1,10752,10,9802739747
13058,339846201,105623732,445469933,2,0,0,24576,4,2918583473
13059,339848870,144462834,484311704,6,0,1,25088,7,3840581937
13060,339872411,105683436,445555847,2,0,0,93696,4,2893344837
13061,339949780,144361947,484311727,6,0,1,13824,7,10279894379
13062,339965289,144346461,484311750,0,0,1,6656,10,9186394931
13063,340040080,105816349,445856429,0,0,0,3072,10,4444094712
13064,340043221,105606336,445649557,2,0,0,116224,4,8425753912
13065,340043910,106306839,446350749,9,0,0,104448,17,4765047146
13066,340051279,105932090,445983369,8,0,0,207360,2,292372304
13067,340070201,106671765,446741966,2,0,0,153600,4,5781699557
13068,340139651,144206532,484346183,9,0,1,12288,17,237936754
13069,340142429,106606603,446749032,5,0,0,23040,11,1694880350
13070,340154010,105831098,445985108,0,0,0,5632,10,2706068025
13071,340221699,106473444,446695143,5,0,0,593408,11,9498914343
13072,340230919,144116544,484347463,0,0,1,14336,10,6413856108
13073,340241060,105811463,446052523,9,0,0,221184,17,4789005207
13074,340268911,144119975,484388886,9,0,1,7680,17,7070656597
13075,340289489,144675508,484964997,0,0,1,51712,10,5778925018
13076,340293421,144698654,484992075,9,0,1,10752,17,8833995498
13077,340302059,144885113,485187172,0,0,1,34304,10,2402043779
13078,340303671,144886979,485190650,9,0,1,12288,17,1904304569
13079,340353711,144913518,485267229,9,0,1,20992,17,4701971843
13080,340388301,144938160,485326461,9,0,1,27136,17,4472152512
13081,340427629,106735982,447163611,5,0,0,69632,11,10656582845
13082,340535409,105844196,446379605,8,0,0,24064,2,10435150302
13083,340544579,107313207,447857786,5,0,0,56320,11,1501595295
13084,340560919,107062885,447623804,5,0,0,434688,11,8921936811
13085,340602199,106889138,447491337,5,0,0,309760,11,209906172
13086,340619961,106284829,446904790,2,0,0,65536,4,6592324408
13087,340623049,106191994,446815043,8,0,0,216576,2,3221181291
13088,340763231,144595881,485359112,9,0,1,16384,17,573049289
13089,340800071,144586829,485386900,9,0,1,26112,17,5102082861
13090,340881830,107062679,447944509,9,0,0,86528,17,8905638629
13091,340936849,106460085,447396934,8,0,0,161792,2,5489647344
13092,340989329,105895470,446884799,8,0,0,100864,2,3256971216
13093,340999551,106308765,447308316,2,0,0,15872,4,7697444539
13094,341050461,106847197,447897658,2,0,0,89088,4,6673577635
13095,341055529,106785028,447840557,8,0,0,625152,2,4358204658
13096,341072040,105402556,446474596,0,0,0,8704,10,6554589243
13097,341115661,107139221,448254882,2,0,0,126464,4,9398566598
13098,341219180,105596666,446815846,0,0,0,2560,10,915166504
13099,341219629,105794013,447013642,5,0,0,65536,11,9266033913
13100,341272271,107339780,448612051,2,0,0,698880,4,5406777363
13101,341437239,106212484,447649723,8,0,0,84992,2,12822972
13102,341511190,105320198,446831388,0,0,0,1536,10,6131748809
13103,341534839,107213546,448748385,8,0,0,194048,2,3605178083
13104,341566929,107122240,448689169,5,0,0,230400,11,6606484087
13105,341578979,106422470,448001449,8,0,0,112640,2,7316975807
13106,341588900,106061158,447650058,0,0,0,1024,10,1110525397
13107,341589150,107322270,448911420,9,0,0,509952,17,7640340348
13108,341631780,106388625,448020405,0,0,0,2560,10,4558493974
13109,341656341,106742701,448399042,2,0,0,95744,4,3329714396
13110,341667020,106203448,447870468,9,0,0,41472,17,6153072515
13111,341717279,107035060,448752339,8,0,0,12288,2,6241732875
13112,341728270,107356860,449085130,9,0,0,163840,17,2302286530
13113,341729499,107751481,449480980,8,0,0,128512,2,4097416331
13114,341742620,107536262,449278882,9,0,0,177152,17,5395986402
13115,341756319,143636473,485392792,4,0,1,14336,2,4255025692
13116,341806081,107229106,449035187,2,0,0,58880,4,2726726930
13117,341836390,107132827,448969217,9,0,0,186368,17,9521780628
13118,341848990,107932515,449781505,9,0,0,77824,17,6469088662
13119,341858320,107273633,449131953,9,0,0,153600,17,30670108
13120,341862129,108086239,449948368,5,0,0,77312,11,10243858323
13121,341868990,107043389,448912379,0,0,0,3072,10,1187730042
13122,341893349,106191964,448085313,5,0,0,54272,11,4357557965
13123,341948819,107808951,449757770,5,0,0,251904,11,3169780538
13124,341974830,107237157,449211987,9,0,0,66560,17,5854209959
13125,342120250,107265119,449385369,9,0,0,150528,17,222314764
13126,342135550,105866546,448002096,0,0,0,2048,10,9618078136
13127,342201619,143218368,485419987,1,0,1,34304,5,2257186188
13128,342213079,143261995,485475074,1,0,1,512,5,10510427585
13129,342217611,143281742,485499353,9,0,1,30208,17,10691646252
13130,342292519,143218393,485510912,1,0,1,4608,5,5663429976
13131,342308090,106310848,448618938,0,0,0,22528,10,7670789039
13132,342310709,107560221,449870930,5,0,0,219136,11,2143845
13133,342481879,143107710,485589589,0,0,1,27648,10,8943115220
13134,342485641,107137276,449622917,2,0,0,245248,4,10277942410
13135,342498360,106250212,448748572,0,0,0,512,10,4924128001
13136,342551570,143565936,486117506,8,0,1,80896,2,1593225450
13137,342618739,107059737,449678476,5,0,0,182272,11,9738510595
13138,342650300,107724887,450375187,9,0,0,246272,17,4500084891
13139,342672770,107008225,449680995,0,0,0,8192,10,7126877739
13140,342686279,106308007,448994286,5,0,0,2048,11,2641181386
13141,342724480,143822884,486547364,8,0,1,239104,2,1117206937
13142,342732489,106247359,448979848,8,0,0,34816,2,5177214604
13143,342745850,143892414,486638264,7,0,1,50688,16,8350144419
13144,342747231,106233459,448980690,2,0,0,2560,4,9031850129
13145,342751921,107661821,450413742,2,0,0,126464,4,5954575638
13146,342781419,106361251,449142670,8,0,0,34816,2,6041490554
13147,342836749,143859648,486696397,1,0,1,60928,5,3324071669
13148,342879220,106649945,449529165,0,0,0,1536,10,2057621352
13149,342923440,143833922,486757362,3,0,1,18432,3,10421220477
13150,342968049,107687560,450655609,8,0,0,96768,2,2674826068
13151,342973030,143808566,486781596,3,0,1,22528,3,2591256511
13152,343149650,106156765,449306415,0,0,0,2560,10,10576345464
13153,343175750,143609187,486784937,5,0,1,3584,11,2185431381
13154,343224860,143567361,486792221,3,0,1,34816,3,8905156079
13155,343258679,143607426,486866105,1,0,1,61952,5,6361020588
13156,343273610,107352438,450626048,9,0,0,696320,17,1986208989
13157,343277809,143589612,486867421,1,0,1,24576,5,8799851331
13158,343305399,144547772,487853171,1,0,1,18944,5,4025371706
13159,343306570,144728769,488035339,3,0,1,19968,3,10709435097
13160,343319060,145013106,488332166,8,0,1,50688,2,4930433238
13161,343336209,145020050,488356259,1,0,1,53760,5,8132418026
13162,343372040,145129022,488501062,7,0,1,41984,16,3654155181
13163,343410180,145091458,488501638,5,0,1,12800,11,6469796027
13164,343429720,145455402,488885122,7,0,1,55296,16,4653082516
13165,343452230,145537737,488989967,7,0,1,8704,16,5955231188
13166,343468980,145521010,488989990,5,0,1,3584,11,340110863
13167,343565670,107190725,450756395,9,0,0,230912,17,3292906249
13168,343574030,145415983,488990013,3,0,1,8192,3,8099223566
13169,343577760,145506117,489083877,8,0,1,46592,2,3734037650
13170,343586980,145496920,489083900,3,0,1,12800,3,2928915583
13171,343599610,145484313,489083923,3,0,1,512,3,1723074665
13172,343633440,145450506,489083946,5,0,1,5120,11,9387274412
13173,343647110,145436859,489083969,7,0,1,20480,16,408968481
13174,343648340,145531303,489179643,7,0,1,48128,16,9045994274
13175,343682380,106617748,450300128,9,0,0,259072,17,8763071331
13176,343694560,107139180,450833740,9,0,0,208896,17,3847423927
13177,343756740,145422934,489179674,3,0,1,28672,3,4477923813
13178,343769699,106999879,450769578,5,0,0,43008,11,5146504372
13179,343796200,107149685,450945885,9,0,0,2560,17,4036196616
13180,343815610,145566761,489382371,3,0,1,32256,3,9712736550
13181,343821100,107376960,451198060,9,0,0,274944,17,5592066116
13182,343872749,106812367,450685116,5,0,0,96768,11,739778466
13183,343877500,106808470,450685970,9,0,0,2048,17,10135813423
13184,343908111,107112188,451020299,2,0,0,143872,4,823371215
13185,343945190,145437204,489382394,5,0,1,5120,11,7910726076
13186,343976489,106244680,450221169,5,0,0,33792,11,7130652812
13187,343978200,146593671,490571871,3,0,1,15872,3,8386711943
13188,343978390,107067516,451045906,9,0,0,83968,17,925897719
13189,343982100,146643481,490625581,7,0,1,14336,16,8518128101
13190,343984439,107525359,451509798,8,0,0,123904,2,8751399572
13191,344001560,106768509,450770069,0,0,0,1536,10,1591590418
13192,344026330,146599274,490625604,7,0,1,9216,16,6636279204
13193,344071381,107180522,451251903,2,0,0,176640,4,1755281338
13194,344079139,107271723,451350862,5,0,0,64512,11,23364276
13195,344115130,106719257,450834387,0,0,0,2048,10,236590036
13196,344121309,106823773,450945082,5,0,0,2048,11,7332154616
13197,344150661,107588789,451739450,2,0,0,425472,4,6531998101
13198,344181490,107190280,451371770,9,0,0,65536,17,9728691561
13199,344195171,108164042,452359213,2,0,0,327680,4,1410750876
13200,344244580,146571307,490815887,3,0,1,74752,3,102074538
13201,344245270,146883788,491129058,7,0,1,18432,16,407439684
13202,344266310,146862771,491129081,3,0,1,5120,3,5345434659
13203,344294970,146834134,491129104,3,0,1,14848,3,4238141624
13204,344322980,107105817,451428797,0,0,0,7168,10,1920983535
13205,344373100,107402900,451776000,9,0,0,94720,17,10496417050
13206,344417939,107495291,451913230,8,0,0,79360,2,1156524080
13207,344458260,146670867,491129127,5,0,1,12288,11,7862054189
13208,344468129,146741063,491209192,4,0,1,45568,2,4730775256
13209,344471180,106986192,451457372,0,0,0,2560,10,1916574135
13210,344480920,106618781,451099701,0,0,0,3072,10,8813564782
13211,344482791,107485998,451968789,2,0,0,182272,4,4316383267
13212,344523910,107458950,451982860,9,0,0,46080,17,5049773529
13213,344564829,146676615,491241444,4,0,1,13312,2,6027935942
13214,344574360,107964198,452538558,9,0,0,185856,17,10566686751
13215,344597191,108165654,452762845,2,0,0,370176,4,5680932269
13216,344643150,107477888,452121038,9,0,0,139776,17,9693749857
13217,344668379,108231375,452899754,8,0,0,125440,2,2132491474
13218,344708130,146676643,491384773,3,0,1,6144,3,6475229319
13219,344727110,146883347,491610457,7,0,1,23040,16,1795456627
13220,344737050,146873430,491610480,3,0,1,3072,3,3665940859
13221,344771930,146957655,491729585,5,0,1,27648,11,134776303
13222,344787910,146941698,491729608,7,0,1,3072,16,4188093778
13223,344789549,106957568,451747117,8,0,0,25088,2,162898831
13224,344792560,108181749,452974309,0,0,0,1536,10,3087799496
13225,344830249,146926416,491756665,1,0,1,44544,5,1098953357
13226,344831890,107532494,452364384,9,0,0,16896,17,10438917066
13227,344852520,146904168,491756688,7,0,1,4096,16,9791888840
13228,344862400,146894311,491756711,3,0,1,14848,3,142065833
13229,344880090,146876644,491756734,3,0,1,512,3,9765388185
13230,344932069,146824688,491756757,1,0,1,22528,5,2111425809
13231,344946009,106934717,451880726,5,0,0,2048,11,2446852696
13232,344953509,108306746,453260255,8,0,0,338944,2,1253321324
13233,344972820,146783968,491756788,3,0,1,1024,3,6723458139
13234,344976060,146780751,491756811,3,0,1,13312,3,1262880020
13235,344980369,146776465,491756834,1,0,1,3584,5,9761536056
13236,345012890,107368833,452381723,9,0,0,56832,17,2222144039
13237,345115661,107285741,452401402,2,0,0,64512,4,4689091891
13238,345125789,108340983,453466772,5,0,0,158720,11,9797736288
13239,345134520,146622337,491756857,7,0,1,14848,16,241732816
13240,345146919,146609961,491756880,1,0,1,9728,5,8781792826
13241,345176680,107400502,452577182,9,0,0,126464,17,10612771155
13242,345227561,108427797,453655358,2,0,0,307712,4,1590033028
13243,345240340,146712273,491952613,8,0,1,97792,2,4381636616
13244,345302670,146649966,491952636,2,0,1,3584,4,2286577613
13245,345465179,108362324,453827503,8,0,0,387072,2,1116253731
13246,345498991,107657969,453156960,2,0,0,53760,4,1755158042
13247,345502220,146722714,492224934,8,0,1,301568,2,817490505
13248,345518650,108470344,453988994,9,0,0,296448,17,4780763196
13249,345532990,107776913,453309903,9,0,0,69632,17,10053321523
13250,345551659,146673941,492225600,1,0,1,1024,5,3591581948
13251,345557669,107934554,453492223,5,0,0,83456,11,119899179
13252,345578959,107491439,453070398,8,0,0,174080,2,1326922295
13253,345613240,107457493,453070733,0,0,0,1024,10,2978169826
13254,345626670,107445654,453072324,0,0,0,5120,10,6297559638
13255,345655849,108053687,453709536,5,0,0,177664,11,3922681226
13256,345731661,146533366,492265027,9,0,1,17920,17,9777276826
13257,345783259,146482639,492265898,1,0,1,12288,5,5048000668
13258,345789609,146525805,492315414,1,0,1,14336,5,204851478
13259,345812279,108636196,454448475,8,0,0,564224,2,4898094430
13260,345826739,107527827,453354566,5,0,0,18432,11,751376822
13261,345850370,108001812,453852182,9,0,0,80896,17,6736444264
13262,345851189,108170744,454021933,5,0,0,108032,11,1090518097
13263,345882919,108694458,454577377,8,0,0,422912,2,3988855948
13264,346003631,146332221,492335852,9,0,1,8704,17,2305338217
13265,346006731,146339993,492346724,9,0,1,18432,17,7452887893
13266,346097060,109009280,455106340,9,0,0,751616,17,226963017
13267,346127459,108585496,454712955,5,0,0,315904,11,4207102964
13268,346205999,146159909,492365908,1,0,1,18432,5,2240827177
13269,346226780,108352850,454579630,0,0,0,4608,10,7033270580
13270,346254420,146379102,492633522,2,0,1,26624,4,1556835158
13271,346255449,146379379,492634828,1,0,1,2048,5,1334308960
13272,346280191,146451890,492732081,9,0,1,1024,17,1485843978
13273,346352970,146379134,492732104,3,0,1,30720,3,6022163551
13274,346353950,146379136,492733086,3,0,1,20992,3,5020637551
13275,346379640,146358197,492737837,3,0,1,6656,3,7599126607
13276,346403509,146436265,492839774,1,0,1,21504,5,3531302522
13277,346406431,108206769,454613200,2,0,0,97280,4,3354303462
13278,346408450,146431347,492839797,3,0,1,1024,3,9254104750
13279,346422220,146417600,492839820,3,0,1,1024,3,2831950817
13280,346445090,146394753,492839843,3,0,1,3584,3,2756214789
13281,346450709,108747428,455198137,8,0,0,296960,2,2760420585
13282,346452360,108336913,454789273,0,0,0,1024,10,1464661993
13283,346453589,108837350,455290939,8,0,0,210944,2,2149291136
13284,346497279,146409568,492906847,1,0,1,27648,5,1326528728
13285,346500430,108328062,454828492,0,0,0,1024,10,9977535175
13286,346500521,108944833,455445354,2,0,0,419328,4,2386466822
13287,346506960,108071220,454578180,0,0,0,2560,10,1626791492
13288,346525159,146411912,492937071,1,0,1,18432,5,8090574077
13289,346532031,108785528,455317559,2,0,0,87040,4,1299543754
13290,346567919,108304633,454872552,5,0,0,1024,11,8777140321
13291,346574059,146417771,492991830,1,0,1,33792,5,6108224767
13292,346596790,146415085,493011875,3,0,1,25088,3,1168996517
13293,346663519,108535733,455199252,5,0,0,3584,11,1168507187
13294,346878389,107835213,454713602,5,0,0,2048,11,7366384057
13295,346976539,108250105,455226644,8,0,0,38400,2,3769922819
13296,347009321,108205577,455214898,2,0,0,51200,4,8421713252
13297,347013360,108543322,455556682,9,0,0,102400,17,3297952191
13298,347039550,108631743,455671293,9,0,0,80896,17,6715022206
13299,347059120,145973017,493032137,6,0,1,31232,7,9536278771
13300,347113859,107993775,455107634,5,0,0,4096,11,3499285313
13301,347134549,108390910,455525459,8,0,0,198144,2,553181457
13302,347144809,145930772,493075581,1,0,1,9728,5,6311192040
13303,347149959,145925645,493075604,1,0,1,512,5,9938084339
13304,347153529,108405399,455558928,5,0,0,6144,11,8083183761
13305,347176259,145997268,493173527,1,0,1,59392,5,6181416134
13306,347187451,108277613,455465064,2,0,0,64512,4,3726670144
13307,347187711,108705636,455893347,2,0,0,390144,4,6786234617
13308,347205160,108886196,456091356,9,0,0,270848,17,8489134297
13309,347221949,108337626,455559575,5,0,0,2048,11,8524322121
13310,347232610,108439642,455672252,0,0,0,3072,10,10571525834
13311,347256940,108942142,456199082,9,0,0,47616,17,2715181441
13312,347294329,145946688,493241017,1,0,1,13312,5,935746
13313,347306399,108587439,455893838,5,0,0,1536,11,6088888714
13314,347310030,108246987,455557017,0,0,0,1024,10,3904265514
13315,347313049,145960082,493273131,1,0,1,43008,5,7388053241
13316,347331809,108358221,455690030,5,0,0,1536,11,541835953
13317,347337419,145938938,493276357,1,0,1,5120,5,4990126865
13318,347361760,108251397,455613157,0,0,0,1024,10,2534909570
13319,347406779,108601999,456008778,8,0,0,103424,2,1306178163
13320,347456390,108683130,456139520,9,0,0,114688,17,6137786681
13321,347466810,108453103,455919913,9,0,0,85504,17,5226456880
13322,347522839,145753774,493276613,0,0,1,9216,10,3635278561
13323,347523601,108453634,455977235,2,0,0,69632,4,3632988673
13324,347591019,145688820,493279839,1,0,1,5120,5,6270412302
13325,347631059,145824788,493455847,1,0,1,18432,5,2704226111
13326,347633879,145821991,493455870,1,0,1,512,5,6024366178
13327,347638391,145819397,493457788,9,0,1,56320,17,9762254730
13328,347688561,108415976,456104537,2,0,0,43008,4,269065624
13329,347757020,108198968,455955988,9,0,0,118272,17,9695770545
13330,347765510,145692301,493457811,2,0,1,6144,4,6175981194
13331,347834161,145753443,493587604,9,0,1,36864,17,9788423510
13332,347858321,145729306,493587627,9,0,1,3072,17,6552656705
13333,347899559,145748697,493648256,1,0,1,27136,5,9250108405
13334,347919419,145728860,493648279,0,0,1,11776,10,10597430490
13335,347983579,145934538,493918117,0,0,1,18432,10,2804145788
13336,348117399,145801282,493918681,0,0,1,10752,10,8649957429
13337,348144579,145886388,494030967,1,0,1,5120,5,5814320192
13338,348161559,145869431,494030990,1,0,1,18432,5,2220500091
13339,348167171,146130390,494297561,9,0,1,74752,17,7024399363
13340,348171420,108094016,456265436,0,0,0,5120,10,7852127785
13341,348190519,146109754,494300273,0,0,1,15360,10,5504183345
13342,348192881,146203123,494396004,9,0,1,14336,17,1802502854
13343,348201990,108468100,456670090,9,0,0,228864,17,9385333456
13344,348277321,146118706,494396027,9,0,1,15360,17,5620554736
13345,348295640,146159721,494455361,2,0,1,1024,4,1520651951
13346,348313930,146232589,494546519,2,0,1,18944,4,8030731063
13347,348331819,108415937,456747756,5,0,0,512,11,4034581898
13348,348334651,146213162,494547813,9,0,1,8704,17,8230632675
13349,348336399,108840423,457176822,8,0,0,85504,2,8381725431
13350,348340349,108810375,457150724,8,0,0,608768,2,8232560158
13351,348350670,146197166,494547836,6,0,1,25088,7,9802349869
13352,348378329,108869340,457247669,8,0,0,232448,2,9535360027
13353,348460970,108411661,456872631,0,0,0,12288,10,3521662973
13354,348462100,146085759,494547859,6,0,1,3584,7,5285722762
13355,348482071,108832535,457314606,2,0,0,145920,4,8648938373
13356,348489851,146058031,494547882,9,0,1,28672,17,5037836934
13357,348496429,146075367,494571796,0,0,1,3584,10,2000103503
13358,348500700,146071127,494571827,2,0,1,2560,4,421268202
13359,348513529,146058321,494571850,0,0,1,3584,10,4606454258
13360,348518330,146053543,494571873,6,0,1,11264,7,332024975
13361,348561021,108810768,457371789,2,0,0,110592,4,2758114225
13362,348621579,145950317,494571896,1,0,1,9728,5,3198677018
13363,348644370,145927549,494571919,6,0,1,8704,7,388497544
13364,348660809,145911133,494571942,1,0,1,1024,5,8477039022
13365,348728221,108911629,457639850,2,0,0,70656,4,10540802477
13366,348787950,108740917,457528867,0,0,0,7168,10,8949065955
13367,348790090,108582369,457372459,9,0,0,2048,17,10329282400
13368,348803050,145784811,494587861,5,0,1,44544,11,10284688096
13369,348806399,145869026,494675425,1,0,1,50688,5,277184539
13370,348806940,146052463,494859403,2,0,1,13312,4,7879118900
13371,348818830,146040596,494859426,6,0,1,9216,7,5125916540
13372,348827660,108955973,457783633,9,0,0,68096,17,4209759802
13373,348833750,146025699,494859449,5,0,1,4096,11,6060327096
13374,348875120,108819348,457694468,0,0,0,512,10,1530619174
13375,348902969,145956503,494859472,1,0,1,1536,5,1538948049
13376,348922670,108923472,457846142,7,0,0,7680,16,8876159609
13377,348924520,145934983,494859503,2,0,1,17920,4,3088762552
13378,348927060,146097884,495024944,8,0,1,144384,2,8927292457
13379,348963040,109050580,458013620,9,0,0,122368,17,311678410
13380,348971560,146054562,495026122,5,0,1,13824,11,8238222460
13381,348977500,146185581,495163081,2,0,1,40448,4,1328672017
13382,348981160,146217050,495198210,5,0,1,13824,11,3083622054
13383,348988039,109071584,458059623,5,0,0,1024,11,7319290998
13384,348999479,146387791,495387270,1,0,1,22528,5,2763970679
13385,349007369,146457059,495464428,0,0,1,3072,10,8621716724
13386,349030909,109318886,458349795,8,0,0,62464,2,3586507083
13387,349045310,146419149,495464459,5,0,1,5632,11,5417009494
13388,349066420,146442854,495509274,5,0,1,41984,11,4287398341
13389,349087910,146513736,495601646,2,0,1,21504,4,10701307668
13390,349089120,146617274,495706394,7,0,1,68096,16,759684657
13391,349103580,146605951,495709531,6,0,1,15872,7,2798700248
13392,349111369,109353540,458464909,5,0,0,5120,11,5806591382
13393,349151229,146760033,495911262,0,0,1,6656,10,6617068334
13394,349169620,146768886,495938506,6,0,1,69632,7,3184997344
13395,349174490,146799825,495974315,2,0,1,41984,4,1344658669
13396,349208590,109098894,458307484,7,0,0,512,16,9553601262
13397,349262509,146711829,495974338,0,0,1,2560,10,2903748526
13398,349284550,109466484,458751034,9,0,0,114688,17,6458040590
13399,349291520,146682841,495974361,2,0,1,11264,4,429524961
13400,349308100,109322825,458630925,9,0,0,20480,17,9332163989
13401,349330070,146644322,495974392,5,0,1,2048,11,4483906078
13402,349344930,109407219,458752149,0,0,0,3584,10,3008604752
13403,349348929,146633511,495982440,0,0,1,41472,10,1660763490
13404,349359209,109343201,458702410,8,0,0,30720,2,3797957123
13405,349359590,109447061,458806651,7,0,0,1536,16,5785460121
13406,349368390,146780898,496149288,6,0,1,37888,7,4736086797
13407,349370970,146778341,496149311,2,0,1,49152,4,10662032370
13408,349374419,146795709,496170128,0,0,1,61952,10,8151453851
13409,349389539,109490427,458879966,8,0,0,75776,2,3379045574
13410,349403110,146767041,496170151,5,0,1,19456,11,3061466659
13411,349434860,109540020,458974880,7,0,0,512,16,5627720644
13412,349454630,109470939,458925569,9,0,0,7168,17,1197465525
13413,349459820,109384641,458844461,0,0,0,512,10,813931190
13414,349471959,146751778,496223737,0,0,1,38400,10,8536413251
13415,349477339,146746421,496223760,1,0,1,6144,5,3182888453
13416,349498729,109538714,459037443,5,0,0,16384,11,4564613967
13417,349517819,146705964,496223783,1,0,1,6144,5,9659280956
13418,349520700,146711427,496232127,5,0,1,24064,11,4923727875
13419,349616650,146619951,496236601,6,0,1,4608,7,6123503887
13420,349653880,109446613,459100493,7,0,0,2560,16,1077534436
13421,349659960,146634543,496294503,2,0,1,61952,4,2832173322
13422,349672030,146627299,496299329,5,0,1,7680,11,2279020990
13423,349679279,109310290,458989569,5,0,0,1536,11,9610860107
13424,349687280,146695881,496383161,2,0,1,13312,4,6145600809
13425,349694190,146704163,496398353,2,0,1,31232,4,3431882476
13426,349713200,146686741,496399941,6,0,1,15872,7,4043955579
13427,349720540,109641686,459362226,9,0,0,48128,17,3164838055
13428,349742830,109674674,459417504,7,0,0,512,16,9483958519
13429,349750521,109666796,459417317,2,0,0,180736,4,3077813030
13430,349834239,146619672,496453911,0,0,1,1024,10,1831775607
13431,349834830,109475474,459310304,0,0,0,512,10,8610279313
13432,349919790,109707878,459627668,9,0,0,277504,17,2793558955
13433,349942640,146511294,496453934,7,0,1,38912,16,4576388835
13434,349952980,146547668,496500648,7,0,1,30208,16,299767904
13435,349964260,109722461,459686721,9,0,0,45568,17,9557087793
13436,349991290,109312181,459303471,0,0,0,512,10,6800016232
13437,350016410,109259949,459276359,0,0,0,6656,10,5522188051
13438,350099729,146479345,496579074,0,0,1,49152,10,629494273
13439,350138841,109603125,459741966,2,0,0,123904,4,8725750893
13440,350147030,146437190,496584220,7,0,1,8192,16,6333404033
13441,350211120,147009284,497220404,7,0,1,68096,16,6551087683
13442,350225790,147063924,497289714,6,0,1,13312,7,1348231082
13443,350326320,146963433,497289753,7,0,1,33280,16,396502194
13444,350339001,109291457,459630458,2,0,0,8704,4,4653187021
13445,350341931,109609731,459951662,2,0,0,126976,4,1260753450
13446,350376669,110219574,460596243,8,0,0,600064,2,628417450
13447,350412759,109756027,460168786,8,0,0,257536,2,2663746773
13448,350429429,146860994,497290423,1,0,1,4096,5,986057141
13449,350436401,110347850,460784251,2,0,0,446976,4,7911525672
13450,350438440,109870128,460308568,9,0,0,75776,17,1773993509
13451,350461430,146829016,497290446,7,0,1,23040,16,7546193756
13452,350471480,146818989,497290469,6,0,1,512,7,6415978250
13453,350487800,146802692,497290492,6,0,1,21504,7,8973324902
13454,350500389,110096212,460596601,5,0,0,1024,11,9617868907
13455,350520710,110127261,460647971,9,0,0,147456,17,5236337463
13456,350524199,110364008,460888207,5,0,0,512,11,2083423434
13457,350535591,110067429,460603020,2,0,0,20992,4,4205944036
13458,350585071,110227235,460812306,2,0,0,91648,4,8040579582
13459,350603501,110284527,460888028,2,0,0,214016,4,7355736337
13460,350606480,146684035,497290515,7,0,1,4608,16,1258955528
13461,350633469,110478333,461111802,8,0,0,84992,2,2353809238
13462,350651180,110989627,461640807,9,0,0,216576,17,5443340243
13463,350669630,110784990,461454620,7,0,0,1024,16,4582428764
13464,350670440,110620199,461290639,7,0,0,3072,16,1590283972
13465,350671559,110316006,460987565,5,0,0,3072,11,1261771560
13466,350683830,146736390,497420220,7,0,1,31744,16,3773398109
13467,350728250,146740260,497468510,7,0,1,34816,16,9251359135
13468,350764411,110634763,461399174,2,0,0,246784,4,2705951373
13469,350794960,110238761,461033721,0,0,0,2560,10,9965180798
13470,350801841,110611708,461413549,2,0,0,47104,4,10406624758
13471,350822539,110406082,461228621,5,0,0,512,11,607920931
13472,350844580,146623953,497468533,6,0,1,19456,7,297617368
13473,350848040,110595819,461443859,9,0,0,98304,17,3796592247
13474,350849959,110677426,461527385,5,0,0,2048,11,3340783370
13475,350894391,110994260,461888651,2,0,0,335872,4,212513872
13476,350898750,146569806,497468556,6,0,1,10752,7,457908264
13477,350925790,146565908,497491698,6,0,1,32256,7,6776679045
13478,350958820,110321823,461280643,7,0,0,512,16,9452677589
13479,350983509,146508212,497491721,4,0,1,27136,2,9927444541
13480,350987560,110426324,461413884,0,0,0,1024,10,6676324859
13481,351030280,110248827,461279107,0,0,0,512,10,8132757697
13482,351057101,111389962,462447063,2,0,0,177664,4,6982410412
13483,351173470,110740678,461914148,9,0,0,22016,17,10485023654
13484,351180180,146395749,497575929,6,0,1,17920,7,1020916006
13485,351223820,111074638,462298458,9,0,0,242688,17,10393336654
13486,351244080,146331888,497575968,6,0,1,10240,7,3594416756
13487,351258119,146667236,497925355,0,0,1,140800,10,5179933899
13488,351259310,110204239,461463549,7,0,0,10240,16,5296589473
13489,351309170,110581532,461890702,7,0,0,6656,16,5261725685
13490,351390120,110069077,461459197,0,0,0,512,10,4434999906
13491,351430979,146494399,497925378,0,0,1,12800,10,6335291554
13492,351498980,146426421,497925401,6,0,1,4608,7,10572394503
13493,351518669,110599933,462118602,8,0,0,173568,2,9965764928
13494,351551520,110112987,461664507,7,0,0,4096,16,1173019270
13495,351586430,146338994,497925424,6,0,1,10752,7,5145994117
13496,351601999,110338091,461940090,8,0,0,83456,2,2711527804
13497,351604740,110175688,461780428,7,0,0,7168,16,4267681472
13498,351632989,110064116,461697105,5,0,0,4096,11,8728858755
13499,351635531,110271886,461907417,2,0,0,54784,4,42739068
13500,351660939,110281233,461942172,5,0,0,6656,11,2027009806
13501,351673759,146375602,498049361,0,0,1,29184,10,9164909555
13502,351703660,110444917,462148577,9,0,0,98304,17,1211774915
13503,351703899,146346909,498050808,0,0,1,11776,10,10167281031
13504,351703930,110446082,462150012,0,0,0,4608,10,10063414539
13505,351704680,110209959,461914639,0,0,0,1536,10,8849647929
13506,351832700,110135898,461968598,7,0,0,512,16,9207174236
13507,351833249,146221361,498054610,0,0,1,14848,10,3710862740
13508,351847650,110666137,462513787,9,0,0,206848,17,5316663833
13509,351865169,146192027,498057196,0,0,1,4096,10,7855999945
13510,351873739,146357091,498230830,0,0,1,63488,10,7818718823
13511,351933179,146512136,498445315,0,0,1,37376,10,6624608933
13512,351950499,110405569,462356068,8,0,0,188928,2,2408265242
13513,351980470,146622440,498602910,8,0,1,63488,2,2249077935
13514,351998749,146604184,498602933,0,0,1,5632,10,364763037
13515,352031550,109988387,462019937,0,0,0,512,10,1184069230
13516,352068819,110592980,462661799,8,0,0,144384,2,8680245385
13517,352079021,110500096,462579117,2,0,0,30208,4,3537079771
13518,352108129,146494827,498602956,0,0,1,8192,10,3087908624
13519,352122749,111086695,463209444,8,0,0,155648,2,465472519
13520,352131209,110405159,462536368,5,0,0,2560,11,9303674998
13521,352149079,110993528,463142607,8,0,0,446464,2,5413939443
13522,352161709,110730557,462892266,8,0,0,303616,2,8031224134
13523,352164290,111131422,463295712,7,0,0,3072,16,10654495929
13524,352181430,110481016,462662446,7,0,0,2048,16,6783744721
13525,352267119,146335860,498602979,0,0,1,7680,10,596921776
13526,352275350,110452579,462727929,9,0,0,6144,17,2668229398
13527,352275419,146327583,498603002,0,0,1,34816,10,8299845172
13528,352310590,110640771,462951361,0,0,0,46592,10,9022533120
13529,352325350,110836647,463161997,7,0,0,2560,16,2862931062
13530,352374579,110786615,463161194,8,0,0,60928,2,747553571
13531,352440590,110772309,463212899,7,0,0,11264,16,6096512804
13532,352450699,146152326,498603025,0,0,1,1024,10,9878423661
13533,352468041,111045494,463513535,2,0,0,198144,4,10711643301
13534,352494611,110739995,463234606,2,0,0,71168,4,4082933821
13535,352497459,110896034,463393493,8,0,0,197120,2,4097658794
13536,352502050,110475800,462977850,9,0,0,26624,17,4116985054
13537,352512030,146091018,498603048,6,0,1,512,7,7400290688
13538,352547350,111014724,463562074,0,0,0,159232,10,5497478668
13539,352548660,146126078,498674738,2,0,1,17920,4,2465598695
13540,352584349,146090412,498674761,0,0,1,2560,10,7484641895
13541,352584491,111183965,463768456,2,0,0,144896,4,153076611
13542,352627420,110793717,463421137,7,0,0,2048,16,688227781
13543,352634320,146040464,498674784,6,0,1,1024,7,8553355413
13544,352652559,146054095,498706654,0,0,1,31744,10,9522619148
13545,352689269,146017416,498706685,0,0,1,22016,10,4105991075
13546,352702460,110940183,463642643,7,0,0,1024,16,8232930495
13547,352775450,146008380,498783830,6,0,1,60416,7,7468170805
13548,352794000,146052284,498846284,2,0,1,8704,4,10223308276
13549,352799200,146047107,498846307,2,0,1,6656,4,9709092133
13550,352800879,146045451,498846330,0,0,1,32256,10,8552095465
13551,352804000,146042353,498846353,2,0,1,24576,4,3959196937
13552,352807870,110909902,463717772,7,0,0,2048,16,10678717918
13553,352828740,110940409,463769149,7,0,0,2048,16,10370762231
13554,352838439,111128546,463966985,5,0,0,2048,11,8050552214
13555,352870700,110933934,463804634,7,0,0,1536,16,10421508177
13556,352908599,110872209,463780808,5,0,0,5120,11,80490827
13557,352945119,110915401,463860520,5,0,0,3072,11,678925677
13558,352949260,110968532,463917792,7,0,0,1024,16,8965896030
13559,353015959,145890672,498906631,0,0,1,17920,10,1857620931
13560,353037149,145869505,498906654,0,0,1,20480,10,5847492737
13561,353117579,145789098,498906677,0,0,1,18944,10,3872787034
13562,353124610,110756833,463881443,7,0,0,6656,16,1152610749
13563,353151149,145763232,498914381,0,0,1,8704,10,2524468762
13564,353172230,111311593,464483823,7,0,0,4608,16,7833886044
13565,353178099,145748487,498926586,0,0,1,10240,10,1808123474
13566,353179890,110766354,463946244,0,0,0,8704,10,2821073512
13567,353202069,111304239,464506308,8,0,0,51200,2,7740313643
13568,353239969,111889918,465129887,5,0,0,4096,11,327974846
13569,353294049,145635763,498929812,0,0,1,5120,10,10458940495
13570,353348880,111040521,464389401,9,0,0,129536,17,9869725640
13571,353371179,110655855,464027034,5,0,0,512,11,9494501238
13572,353373940,111650391,465024331,9,0,0,192512,17,1610662275
13573,353380600,110783419,464164019,7,0,0,5120,16,8626323338
13574,353418029,145548051,498966080,0,0,1,9216,10,3834034121
13575,353422139,145663827,499085966,0,0,1,25600,10,9128823221
13576,353429409,111535908,464965317,8,0,0,872960,2,9445265117
13577,353481100,111647017,465128117,9,0,0,123904,17,1683953427
13578,353507780,111179340,464687120,7,0,0,2048,16,2702894957
13579,353534309,111431343,464965652,5,0,0,1024,11,449853163
13580,353538290,110782639,464320929,0,0,0,5632,10,9835364042
13581,353560139,145531012,499091151,0,0,1,16384,10,9911187708
13582,353570860,146042040,499612900,2,0,1,26624,4,9604921142
13583,353724100,110592937,464317037,6,0,0,1536,7,851316963
13584,353731621,111927652,465659273,2,0,0,96768,4,145932466
13585,353744119,145973026,499717145,0,0,1,16384,10,3313121933
13586,353792079,145960674,499752753,0,0,1,8704,10,8963299583
13587,353819210,111313999,465133209,9,0,0,9216,17,10558962808
13588,353822159,111306449,465128608,5,0,0,1536,11,663013904
13589,353854079,111556714,465410793,8,0,0,41984,2,9348297849
13590,353859399,147063376,500922775,0,0,1,36352,10,9393506463
13591,353879411,110807062,464686473,2,0,0,18432,4,9811305667
13592,353903669,111226709,465130378,5,0,0,1536,11,5927582425
13593,353923670,111166672,465090342,9,0,0,216576,17,4008171020
13594,353925830,111385297,465311127,9,0,0,184832,17,10442222806
13595,353999731,111205893,465205624,2,0,0,69120,4,5774118713
13596,354007980,111621786,465629766,0,0,0,337408,10,9443282193
13597,354040299,111741141,465781440,8,0,0,279552,2,719693848
13598,354051091,112008157,466059248,2,0,0,550912,4,8133626434
13599,354113860,112299232,466413092,9,0,0,770560,17,5485688597
13600,354140010,110996026,465136036,7,0,0,2048,16,3535701330
13601,354160450,111524253,465684703,7,0,0,2560,16,10173554016
13602,354173299,146829131,501002430,0,0,1,18944,10,3602295167
13603,354219481,112272754,466492235,2,0,0,120832,4,7671009064
13604,354249400,111069622,465319022,7,0,0,512,16,8656991994
13605,354266449,112185666,466452115,8,0,0,128000,2,779185609
13606,354290089,111555380,465845469,8,0,0,45056,2,898344658
13607,354336070,112252867,466588937,9,0,0,198144,17,1787604917
13608,354342120,112185619,466527739,9,0,0,102912,17,5557801870
13609,354342229,146704146,501046375,0,0,1,19968,10,1274145147
13610,354357259,146735179,501092438,0,0,1,17920,10,6627901023
13611,354413790,111107851,465521641,7,0,0,3072,16,2892706846
13612,354424699,146791982,501216681,0,0,1,33792,10,5510147240
13613,354446119,112049594,466495713,5,0,0,4608,11,384463175
13614,354460630,111599265,466059895,6,0,0,2048,7,6970231170
13615,354499619,112252594,466752213,8,0,0,292352,2,5974067858
13616,354512119,111642410,466154529,5,0,0,2560,11,5578486321
13617,354544060,111327657,465871717,7,0,0,512,16,21484162
13618,354563969,146652735,501216704,0,0,1,4608,10,2957187823
13619,354589369,146627358,501216727,0,0,1,12800,10,4135406557
13620,354639179,146634113,501273292,0,0,1,26624,10,9539565743
13621,354654559,111476620,466131179,5,0,0,512,11,6302127126
13622,354664689,112132416,466797105,8,0,0,126464,2,8593199633
13623,354681809,111911908,466593717,5,0,0,1536,11,2039880576
13624,354707610,111075725,465783335,6,0,0,6144,7,1019788268
13625,354711540,111108109,465819649,7,0,0,1024,16,2337935501
13626,354735580,147798542,502534122,8,0,1,719872,2,3845186192
13627,354784691,111709595,466494286,2,0,0,6656,4,9218042127
13628,354788089,111708271,466496360,5,0,0,2048,11,1217189997
13629,354795089,111798129,466593218,5,0,0,7168,11,10521663845
13630,354820620,111634776,466455396,7,0,0,3584,16,3877889739
13631,354887330,147798798,502686128,8,0,1,125440,2,38560580
13632,354925010,112114494,467039504,7,0,0,2560,16,8261436932
13633,354930360,111598182,466528542,7,0,0,2560,16,2757398216
13634,354932090,111231655,466163745,7,0,0,2560,16,698660129
13635,354950910,147764132,502715042,8,0,1,172544,2,2085868241
13636,354981939,111471291,466453230,5,0,0,3584,11,5599438264
13637,355006919,111747102,466754021,5,0,0,3072,11,658865272
13638,355096879,147636434,502733313,0,0,1,61952,10,7238026368
13639,355106630,148092121,503198751,8,0,1,330240,2,673680690
13640,355132789,111805019,466937808,8,0,0,75776,2,1679322802
13641,355139851,111770877,466910728,2,0,0,372736,4,9002347240
13642,355169349,111852303,467021652,8,0,0,144384,2,2713403618
13643,355253639,111684668,466938307,5,0,0,1536,11,5192577197
13644,355278459,111175799,466454258,5,0,0,3072,11,3385398719
13645,355295389,147903564,503198953,0,0,1,18944,10,7144351582
13646,355307120,111447704,466754824,7,0,0,2560,16,7868412663
13647,355329760,111423279,466753039,7,0,0,2560,16,2084045631
13648,355353229,147845747,503198976,0,0,1,17408,10,3161613756
13649,355354440,112108538,467462978,0,0,0,327168,10,5378329091
13650,355358529,111399195,466757724,5,0,0,4096,11,6667607479
13651,355408160,111182828,466590988,7,0,0,6656,16,4066904427
13652,355408900,111774512,467183412,6,0,0,2560,7,9009447008
13653,355419630,112044463,467464093,7,0,0,3584,16,1080259930
13654,355454929,147744070,503198999,0,0,1,17920,10,952648370
13655,355512969,111245558,466758527,5,0,0,2560,11,599576614
13656,355531589,111382929,466914518,5,0,0,11264,11,8144766431
13657,355576659,111086455,466663114,5,0,0,8704,11,3479575683
13658,355581660,111174747,466756407,7,0,0,5120,16,385252051
13659,355616180,111407436,467023616,6,0,0,4096,7,7498392722
13660,355639270,111451315,467090585,6,0,0,11776,7,1958295468
13661,355699669,111211394,466911063,5,0,0,1024,11,10465044737
13662,355749000,147450201,503199201,8,0,1,45568,2,6816754681
13663,355766770,147474479,503241249,8,0,1,63488,2,4797085369
13664,355876679,111971235,467847914,8,0,0,282624,2,10072122939
13665,355936880,111192454,467129334,7,0,0,7680,16,10388019808
13666,355970650,147641357,503612007,8,0,1,282112,2,4882005271
13667,355972280,111724803,467697083,7,0,0,2560,16,5946917725
13668,355988560,111626836,467615396,0,0,0,231424,10,1342269953
13669,355993709,110920988,466914697,5,0,0,512,11,4986723751
13670,356037119,111296239,467333358,8,0,0,34816,2,9863537491
13671,356039020,147716006,503755026,8,0,1,44544,2,2462956948
13672,356078610,112232926,468311536,9,0,0,149504,17,6502145185
13673,356124920,112022407,468147327,6,0,0,76800,7,5785980787
13674,356142969,111335343,467478312,8,0,0,46592,2,6112554634
13675,356148061,111794225,467942286,2,0,0,94208,4,4256416436
13676,356178620,111813253,467991873,6,0,0,41984,7,3346283244
13677,356182390,110794913,466977303,7,0,0,8192,16,767923975
13678,356213009,110809290,467022299,5,0,0,2048,11,178093070
13679,356230609,111669478,467900087,8,0,0,171008,2,5590861968
13680,356246950,147830636,504077586,8,0,1,230400,2,6292805542
13681,356270330,110893894,467164224,7,0,0,5120,16,1497374312
13682,356289349,147788260,504077609,0,0,1,24576,10,10013923427
13683,356330950,147748421,504079371,8,0,1,55808,2,8584090630
13684,356331009,147777112,504108121,0,0,1,9728,10,8121553073
13685,356339509,111856201,468195710,8,0,0,158720,2,136409215
13686,356343420,112017591,468361011,6,0,0,162304,7,1036473968
13687,356371340,111352410,467723750,0,0,0,44032,10,5843688069
13688,356378000,147734389,504112389,8,0,1,153600,2,7707734380
13689,356383090,112139115,468522205,9,0,0,527872,17,2202944154
13690,356430209,112156865,468587074,8,0,0,102400,2,1869954176
13691,356457320,111021327,467478647,7,0,0,1024,16,4996927118
13692,356458890,111665014,468123904,9,0,0,136704,17,2438365469
13693,356583469,147537229,504120698,4,0,1,2048,2,6208279237
13694,356609460,112302867,468912327,9,0,0,335360,17,5518976427
13695,356651691,111883320,468535011,2,0,0,41472,4,3078785877
13696,356660100,111895728,468555828,0,0,0,49152,10,10607249485
13697,356681809,147483421,504165230,0,0,1,65536,10,4411321612
13698,356691690,111940236,468631926,0,0,0,46592,10,1388709401
13699,356748739,147426181,504174920,4,0,1,26624,2,4905664524
13700,356786040,147395473,504181513,8,0,1,27136,2,1597150511
13701,356790230,112185689,468975919,0,0,0,2560,10,10574722864
13702,356834079,111375779,468209858,8,0,0,44544,2,4285892841
13703,356837350,112340061,469177411,0,0,0,142848,10,7918719238
13704,356866429,112410653,469277082,8,0,0,57344,2,862998002
13705,356888870,147298493,504187363,8,0,1,27648,2,8681116794
13706,356891840,111304361,468196201,7,0,0,1536,16,2236484650
13707,356954740,147256163,504210903,2,0,1,59392,4,5841066540
13708,356959200,111850908,468810108,0,0,0,167936,10,5841308297
13709,356963809,112546608,469510417,8,0,0,93184,2,8313403937
13710,356969150,111961795,468930945,7,0,0,2048,16,6255290631
13711,356972209,111263856,468236065,5,0,0,4608,11,6714338149
13712,356987949,111942341,468930290,8,0,0,58880,2,3296121682
13713,356988879,147226210,504215089,0,0,1,6656,10,6130488353
13714,356992079,147223164,504215243,4,0,1,8704,2,6543278363
13715,357011969,147216983,504228952,4,0,1,32256,2,5834741823
13716,357041920,111561203,468603123,6,0,0,38912,7,1737195455
13717,357102730,111438076,468540806,6,0,0,18944,7,2491926219
13718,357110239,147126202,504236441,4,0,1,35840,2,7061229618
13719,357140049,111221297,468361346,5,0,0,1024,11,4740912992
13720,357146540,147952245,505098785,8,0,1,505344,2,4130873219
13721,357171420,147927388,505098808,2,0,1,512,4,5468230385
13722,357193960,111938009,469131969,9,0,0,279040,17,1704393281
13723,357235620,111739496,468975116,9,0,0,144896,17,3045415053
13724,357249759,147931307,505181066,4,0,1,57344,2,8078645145
13725,357277820,112287757,469565577,0,0,0,180736,10,382045845
13726,357285800,112456631,469742431,9,0,0,364544,17,1133563201
13727,357285840,147895249,505181089,7,0,1,5120,16,4146677763
13728,357300699,112265073,469565772,5,0,0,512,11,3942813911
13729,357314620,111819244,469133864,7,0,0,6144,16,9972111386
13730,357323790,147868109,505191899,3,0,1,24576,3,9866960281
13731,357328499,112563365,469891864,8,0,0,465920,2,2724178858
13732,357339219,111637051,468976270,5,0,0,1024,11,9098403301
13733,357350551,112931319,470281870,2,0,0,162304,4,1036574200
13734,357352030,112611636,469963666,9,0,0,123392,17,4895949844
13735,357366380,112667684,470034064,0,0,0,60928,10,9117743526
13736,357405470,147786452,505191922,2,0,1,35328,4,3970490573
13737,357420690,147771279,505191969,8,0,1,4608,2,9762915087
13738,357436209,113100274,470536483,8,0,0,128000,2,10723849855
13739,357442040,112918344,470360384,6,0,0,139776,7,4522120338
13740,357458530,147739101,505197631,3,0,1,75776,3,2429130650
13741,357461190,112964768,470425958,6,0,0,127488,7,1344898330
13742,357469210,147824095,505293305,5,0,1,22016,11,9130909374
13743,357471499,112443674,469915173,5,0,0,4608,11,7758038450
13744,357485060,147809259,505294319,2,0,1,99840,4,1719614833
13745,357498941,112072626,469571567,2,0,0,18944,4,372813636
13746,357505429,147788913,505294342,4,0,1,8704,2,730110473
13747,357520319,147774046,505294365,1,0,1,31744,5,5383839811
13748,357531370,147963313,505494683,8,0,1,265728,2,4201237606
13749,357591480,112300563,469892043,7,0,0,512,16,4861040772
13750,357594750,113051483,470646233,6,0,0,322048,7,5261828577
13751,357663000,148051513,505714513,3,0,1,29184,3,6998515713
13752,357672440,112824997,470497437,9,0,0,234496,17,7075916753
13753,357680660,148071029,505751689,3,0,1,56832,3,10559257692
13754,357732921,113046809,470779730,2,0,0,210944,4,373811539
13755,357761890,111535743,469297633,9,0,0,6144,17,302487812
13756,357768809,148019152,505787961,0,0,1,32256,10,9648849303
13757,357817830,147988724,505806554,2,0,1,1024,4,3464540969
13758,357824999,148119033,505944032,0,0,1,33792,10,9532893876
13759,357835000,113063895,470898895,6,0,0,118272,7,4626917239
13760,357848730,148095325,505944055,7,0,1,23552,16,1141720999
13761,357856260,148165117,506021377,8,0,1,309760,2,8660751413
13762,357893699,113194407,471088106,8,0,0,378880,2,10668923532
13763,357944711,113211534,471156245,2,0,0,221184,4,4515950378
13764,357950050,112437041,470387091,6,0,0,87552,7,5257055603
13765,357959150,148221227,506180377,2,0,1,18432,4,362468584
13766,358001689,148292592,506294281,4,0,1,57856,2,8563104219
13767,358015160,112803156,470818316,9,0,0,123904,17,9332117124
13768,358019129,112520037,470539166,8,0,0,8704,2,1097803546
13769,358027770,148277911,506305681,5,0,1,4096,11,7880295568
13770,358065910,112883441,470949351,0,0,0,17920,10,7168806020
13771,358086809,148312184,506398993,4,0,1,38400,2,5021527401
13772,358100560,112679981,470780541,6,0,0,2560,7,3505983416
13773,358107630,148309157,506416787,2,0,1,16896,4,8226465267
13774,358112400,112603035,470715435,0,0,0,99840,10,5687550306
13775,358114021,113292952,471406973,2,0,0,153088,4,9025822155
13776,358129390,113230916,471360306,0,0,0,18432,10,9840141032
13777,358140120,113130059,471270179,6,0,0,353280,7,3859555837
13778,358161900,112155873,470317773,6,0,0,117760,7,4197398990
13779,358165459,148473496,506638955,4,0,1,52736,2,4467498250
13780,358198510,113127875,471326385,6,0,0,174592,7,8635468915
13781,358208739,148481323,506690062,1,0,1,29696,5,10484373720
13782,358227840,112625139,470852979,6,0,0,113664,7,5064490417
13783,358289499,112365270,470654769,5,0,0,3584,11,6925194594
13784,358315810,112656833,470972643,9,0,0,69632,17,5307200899
13785,358330931,113205091,471536022,2,0,0,318464,4,5718359705
13786,358334119,148418580,506752699,0,0,1,40960,10,3246671911
13787,358337190,148538944,506876134,5,0,1,8192,11,5607072530
13788,358339730,148536427,506876157,5,0,1,3072,11,3857671532
13789,358344219,113261026,471605245,8,0,0,148480,2,2960232162
13790,358381360,148494820,506876180,5,0,1,5120,11,4297327970
13791,358395300,112693484,471088784,6,0,0,1536,7,4701945964
13792,358438350,113251466,471689816,6,0,0,118784,7,3038039841
13793,358463990,148412213,506876203,2,0,1,9216,4,6170916654
13794,358495850,112182302,470678152,9,0,0,8192,17,5898300112
13795,358499580,113392698,471892278,0,0,0,464384,10,2446324798
13796,358515211,113565713,472080924,2,0,0,184832,4,3487854371
13797,358542930,148333296,506876226,3,0,1,5632,3,2094280461
13798,358546020,148330229,506876249,3,0,1,11776,3,5451773598
13799,358550569,112804075,471354644,8,0,0,92672,2,1947744347
13800,358552380,148361823,506914203,3,0,1,36352,3,481395752
13801,358593449,148418628,507012077,4,0,1,6144,2,8431067665
13802,358598540,112489745,471088285,7,0,0,512,16,7163107106
13803,358601710,112671456,471273166,7,0,0,9728,16,5271050979
13804,358634659,148377441,507012100,0,0,1,6144,10,8253220160
13805,358664570,113359910,472024480,0,0,0,58880,10,83126891
13806,358690829,148321294,507012123,0,0,1,18432,10,5977619613
13807,358704980,148307166,507012146,3,0,1,40960,3,7795459230
13808,358735420,148302687,507038107,8,0,1,126464,2,1115002963
13809,358752849,112853511,471606360,5,0,0,3584,11,9666757822
13810,358759450,149464364,508223814,8,0,1,580608,2,5323847377
13811,358769220,112642199,471411419,9,0,0,14336,17,6916285100
13812,358770569,149453268,508223837,4,0,1,5632,2,3837390262
13813,358782340,112771333,471553673,9,0,0,57856,17,5655415541
13814,358795240,112764719,471559959,9,0,0,20480,17,3124062347
13815,358836330,149982653,508818983,8,0,1,351744,2,7938442330
13816,358867760,112841206,471708966,6,0,0,24064,7,3535911432
13817,358873360,150128425,509001785,8,0,1,221184,2,6510144906
13818,358886980,150114828,509001808,5,0,1,85504,11,2485722042
13819,359011370,149990461,509001831,5,0,1,4608,11,7437299045
13820,359019180,112634421,471653601,7,0,0,3072,16,4277595136
13821,359021860,113115343,472137203,9,0,0,134144,17,8193308235
13822,359038800,150019633,509058433,7,0,1,51712,16,10513925981
13823,359061370,150009639,509071009,3,0,1,4608,3,5698607190
13824,359071230,150005168,509076398,7,0,1,25600,16,9691404709
13825,359078171,150048473,509126644,9,0,1,28160,17,7269503911
13826,359083270,113066904,472150174,0,0,0,42496,10,8906986257
13827,359085770,113607541,472693311,9,0,0,76288,17,5393762258
13828,359093610,113086535,472180145,9,0,0,47104,17,4399940227
13829,359094680,150036207,509130887,5,0,1,15872,11,6276748170
13830,359097850,150033601,509131451,5,0,1,10752,11,81161451
13831,359105670,150071428,509177098,3,0,1,25088,3,9026723104
13832,359115659,112966536,472082195,5,0,0,4096,11,5562048418
13833,359140010,113112386,472252396,9,0,0,237056,17,786370694
13834,359173570,113242623,472416193,0,0,0,109056,10,10388807400
13835,359198770,113337334,472536104,9,0,0,112128,17,8954580423
13836,359230209,113718528,472948737,8,0,0,328704,2,4663185072
13837,359233640,150119650,509353290,7,0,1,22528,16,5811551790
13838,359234820,150213411,509448231,7,0,1,75776,16,7917324967
13839,359241249,113721262,472962511,5,0,0,2560,11,5209531453
13840,359245401,113097683,472343084,2,0,0,28160,4,8576869253
13841,359250200,150404408,509654608,7,0,1,38400,16,9875557559
13842,359270819,150439937,509710756,4,0,1,2048,2,3961283638
13843,359277039,150473604,509750643,4,0,1,17920,2,770594178
13844,359278740,150577544,509856284,3,0,1,33280,3,3570881622
13845,359306579,113387379,472693958,5,0,0,2048,11,860216980
13846,359332370,150523937,509856307,5,0,1,1024,11,10253672227
13847,359341451,113095426,472436877,2,0,0,28672,4,7277041413
13848,359341930,150518815,509860745,8,0,1,26624,2,3514858063
13849,359352850,113725571,473078421,6,0,0,192512,7,2593129125
13850,359357350,150558423,509915773,5,0,1,6144,11,5792079564
13851,359368621,113914694,473283315,2,0,0,248832,4,2440553266
13852,359382809,150537790,509920599,0,0,1,7680,10,7490900179
13853,359384709,150547463,509932172,0,0,1,33280,10,5779551976
13854,359425050,150527657,509952707,7,0,1,10752,16,10631146000
13855,359452439,150507327,509959766,0,0,1,28672,10,4375230457
13856,359455950,150509355,509965305,5,0,1,16896,11,5742934416
13857,359458240,113279597,472737837,7,0,0,9728,16,1264743020
13858,359465629,113496079,472961708,8,0,0,42496,2,10197332021
13859,359506990,113072749,472579739,7,0,0,2560,16,2861006491
13860,359534410,150454372,509988782,3,0,1,30208,3,2114322445
13861,359565960,151114545,510680505,8,0,1,300544,2,1919470439
13862,359571199,113974179,473545378,8,0,0,427520,2,4772330979
13863,359580940,151342664,510923604,8,0,1,225792,2,10336389032
13864,359593220,151393454,510986674,5,0,1,1536,11,2089513078
13865,359604420,113358738,472963158,7,0,0,2048,16,9657259042
13866,359627410,113343937,472971347,6,0,0,26624,7,7572082367
13867,359637169,114020751,473657920,8,0,0,180736,2,7385990298
13868,359683810,113875186,473558996,9,0,0,37888,17,10243163326
13869,359722490,151286382,511008872,7,0,1,36864,16,3996564455
13870,359725291,113822138,473547429,2,0,0,6656,4,4341767584
13871,359742809,114368529,474111338,8,0,0,218624,2,7242808252
13872,359772019,114069082,473841101,5,0,0,5632,11,4967160950
13873,359787320,114204812,473992132,9,0,0,495616,17,3499136350
13874,359788601,113991522,473780123,2,0,0,325120,4,6369613363
13875,359799940,151208963,511008903,5,0,1,58368,11,5099391794
13876,359835589,114209090,474044679,5,0,0,172032,11,7780828822
13877,359845160,114665362,474510522,0,0,0,201216,10,6090280456
13878,359869850,151139076,511008926,7,0,1,3584,16,2763833822
13879,359901849,151107116,511008965,0,0,1,40448,10,5625643007
13880,359967100,113872262,473839362,9,0,0,194048,17,8869432461
13881,359975660,151090020,511065680,7,0,1,134144,16,979042865
13882,359978760,151092753,511071513,7,0,1,3072,16,556292329
13883,360013171,114328405,474341576,2,0,0,319488,4,8777490142
13884,360059930,151020642,511080572,7,0,1,29184,16,4990023524
13885,360063810,114983258,475047068,6,0,0,823296,7,10400463753
13886,360085060,114268285,474353345,9,0,0,31744,17,8064545071
13887,360092040,114357112,474449152,0,0,0,314368,10,2764265061
13888,360110310,114233317,474343627,7,0,0,6656,16,7555998877
13889,360120850,150961725,511082575,5,0,1,13312,11,1134254374
13890,360191050,114330438,474521488,9,0,0,35840,17,5642017662
13891,360203000,114884963,475087963,9,0,0,134144,17,7148582282
13892,360205570,151196103,511401673,8,0,1,478720,2,938502913
13893,360235690,114929431,475165121,6,0,0,146432,7,5240633483
13894,360266220,151145451,511411671,7,0,1,12288,16,7279202526
13895,360274840,151321144,511595984,5,0,1,52736,11,9912845696
13896,360311830,151284177,511596007,7,0,1,16384,16,576757325
13897,360364731,114732661,475097392,2,0,0,30720,4,4163682579
13898,360383480,114822457,475205937,0,0,0,8192,10,5761962430
13899,360392060,151203970,511596030,2,0,1,67584,4,8407055712
13900,360400770,114825242,475226012,7,0,0,5632,16,2036564954
13901,360406629,115188882,475595511,8,0,0,178176,2,4462719147
13902,360412059,151183994,511596053,0,0,1,2048,10,1096445349
13903,360412080,151183996,511596076,2,0,1,2560,4,6325778400
13904,360421339,115357441,475778780,8,0,0,303104,2,7398726072
13905,360450879,114752508,475203387,8,0,0,125440,2,7003764536
13906,360452540,151143559,511596099,8,0,1,35840,2,6352586008
13907,360517590,114859868,475377458,9,0,0,128512,17,2843714021
13908,360538689,115147716,475686405,5,0,0,223744,11,5711024939
13909,360568750,151027372,511596122,2,0,1,4096,4,7415541511
13910,360596260,150999885,511596145,7,0,1,20480,16,2484625700
13911,360623500,150972668,511596168,7,0,1,9728,16,4898198062
13912,360626911,115315028,475941939,2,0,0,339968,4,6309284207
13913,360634349,150961842,511596191,0,0,1,18944,10,9807869879
13914,360673239,115372361,476045600,5,0,0,141312,11,6396704211
13915,360694069,150911372,511605441,0,0,1,44544,10,1546110785
13916,360732760,150872704,511605464,2,0,1,3072,4,9794070312
13917,360740480,150870100,511610580,2,0,1,74240,4,9557445467
13918,360752090,114697506,475449596,7,0,0,11264,16,673106152
13919,360771500,115406959,476178459,7,0,0,86016,16,8738442816
13920,360817440,115668023,476485463,7,0,0,68608,16,995346170
13921,360850359,114630594,475480953,8,0,0,24576,2,10026849871
13922,360896590,115946286,476842876,9,0,0,160768,17,846237427
13923,360910270,115690086,476600356,0,0,0,86528,10,5716070398
13924,360940000,150724565,511664565,2,0,1,38912,4,4096289288
13925,360950699,150715725,511666424,0,0,1,10240,10,1603273246
13926,360960270,115682697,476642967,7,0,0,139776,16,6187804154
13927,360984680,115479856,476464536,9,0,0,152064,17,4518105001
13928,361034990,150634340,511669330,2,0,1,4608,4,3512808005
13929,361068240,150611373,511679613,2,0,1,27136,4,7447946533
13930,361070330,150752015,511822345,2,0,1,110592,4,4985003404
13931,361157330,115828771,476986101,0,0,0,150016,10,8097400411
13932,361170969,150651399,511822368,0,0,1,25088,10,10268231029
13933,361174520,115613242,476787762,9,0,0,29184,17,985141905
13934,361244249,115329712,476573961,8,0,0,85504,2,5524112723
13935,361247140,114246305,475493445,6,0,0,5632,7,2221016500
13936,361253329,150600920,511854249,0,0,1,58368,10,9472918494
13937,361260779,114336159,475596938,5,0,0,4608,11,9511945694
13938,361271469,114530312,475801781,5,0,0,75264,11,1997693342
13939,361272380,115788428,477060808,7,0,0,48128,16,1922521854
13940,361284640,150574794,511859434,2,0,1,16384,4,1135753621
13941,361307919,150623480,511931399,0,0,1,13824,10,8802675242
13942,361330700,150603605,511934305,3,0,1,4608,3,6254236638
13943,361331261,114671252,476002513,2,0,0,168448,4,7033062176
13944,361343699,114905617,476249316,5,0,0,128512,11,9578093550
13945,361383780,150553751,511937531,2,0,1,5120,4,7578721478
13946,361448250,115828935,477277185,0,0,0,104960,10,4681364591
13947,361485850,114465316,475951166,9,0,0,30208,17,6184174401
13948,361504660,115842422,477347082,6,0,0,45568,7,9076664931
13949,361509770,150433150,511942920,3,0,1,17408,3,7530406444
13950,361535740,150415251,511950991,3,0,1,4608,3,2567944026
13951,361591600,150360364,511951964,3,0,1,12800,3,1196629237
13952,361612531,114750047,476362578,2,0,0,100864,4,6655116149
13953,361613549,115952479,477566028,5,0,0,181248,11,4582399967
13954,361623360,115170509,476793869,0,0,0,19968,10,3038005353
13955,361656199,114891687,476547886,5,0,0,204800,11,9733730521
13956,361755420,115288026,477043446,9,0,0,512,17,7850532220
13957,361778010,115925413,477703423,0,0,0,283136,10,5628040985
13958,361783300,114930206,476713506,7,0,0,141312,16,5439683265
13959,361816099,115227168,477043267,5,0,0,153088,11,4566861174
13960,361822710,150814017,512636727,3,0,1,40448,3,3630836125
13961,361853561,114804405,476657966,2,0,0,49152,4,3319373000
13962,361901969,116144005,478045974,8,0,0,641024,2,9906011913
13963,361924209,114832059,476756268,8,0,0,41984,2,2550156879
13964,362039870,114832309,476872179,9,0,0,4096,17,7565545693
13965,362090919,114955202,477046121,8,0,0,8704,2,442184728
13966,362120880,150550920,512671800,6,0,1,3584,7,2907250571
13967,362125290,115047941,477173231,6,0,0,50176,7,9639427372
13968,362129750,116112252,478242002,0,0,0,464896,10,5913896437
13969,362148000,115362781,477510781,7,0,0,252416,16,733754313
13970,362159360,150835168,512994528,2,0,1,78848,4,3019024967
13971,362168350,116261170,478429520,6,0,0,380416,7,7655779537
13972,362179469,116355339,478534808,5,0,0,157696,11,5229153388
13973,362251470,150743081,512994551,6,0,1,10240,7,2659144317
13974,362265270,115535671,477800941,7,0,0,239616,16,2234453117
13975,362285450,114992694,477278144,9,0,0,3072,17,4167710281
13976,362303730,115796601,478100331,6,0,0,36352,7,5467927232
13977,362362540,150660694,513023234,2,0,1,20992,4,7619617338
13978,362378960,150686792,513065752,8,0,1,48640,2,9547020833
13979,362408769,116230205,478638974,5,0,0,131072,11,2012740539
13980,362438471,115650761,478089232,2,0,0,53760,4,9117250504
13981,362451510,115862033,478313543,7,0,0,176640,16,6927683277
13982,362473789,115143343,477617132,8,0,0,73216,2,4580415145
13983,362480020,150593745,513073765,2,0,1,10240,4,1916212721
13984,362498030,150586019,513084049,2,0,1,24576,4,888486566
13985,362498599,116539047,479037646,5,0,0,78848,11,4553180637
13986,362500960,115984710,478485670,0,0,0,183808,10,3849692346
13987,362525380,116170688,478696068,0,0,0,162304,10,8444240553
13988,362543100,150546104,513089204,2,0,1,7168,4,7178742778
13989,362555699,115930930,478486629,5,0,0,3072,11,4231719614
13990,362559580,150530290,513089870,2,0,1,1024,4,5089909142
13991,362612299,116318879,478931178,8,0,0,48640,2,5908281823
13992,362658549,115940466,478599015,5,0,0,209920,11,4607978172
13993,362659439,150435625,513095064,0,0,1,11776,10,1992655924
13994,362673359,150495821,513169180,4,0,1,38912,2,5249899976
13995,362705660,115367169,478072829,0,0,0,88064,10,10660307546
13996,362718450,150457093,513175543,2,0,1,30208,4,4686081878
13997,362720229,150676767,513396996,4,0,1,27648,2,10730276490
13998,362725560,116492608,479218168,7,0,0,80384,16,3867699416
13999,362780839,150616180,513397019,4,0,1,32768,2,636000374
14000,362812360,115447340,478259700,6,0,0,57856,7,6352375000
14001,362830350,116516961,479347311,0,0,0,54784,10,7312556740
14002,362852050,150545000,513397050,6,0,1,39936,7,4077262640
14003,362854639,150542434,513397073,4,0,1,15360,2,8867823005
14004,362880091,115766502,478646593,2,0,0,24576,4,642342040
14005,362886589,116401334,479287923,8,0,0,228864,2,8732986749
14006,362900500,150498023,513398523,6,0,1,34816,7,7568424334
14007,362907500,150491046,513398546,2,0,1,18432,4,2656283031
14008,362970229,116602823,479573052,5,0,0,120320,11,1156200353
14009,362988600,150518256,513506856,2,0,1,34816,4,8279677708
14010,362997300,150546418,513543718,6,0,1,16896,7,7863642695
14011,363000170,150543571,513543741,6,0,1,3072,7,645051571
14012,363004979,116976222,479981201,5,0,0,139264,11,6177625755
14013,363008339,116930407,479938746,8,0,0,69120,2,6515537502
14014,363035401,115869927,478905328,2,0,0,38912,4,2188514694
14015,363044999,150503624,513548623,4,0,1,2048,2,2412548935
14016,363061620,150487401,513549021,6,0,1,10240,7,6267343936
14017,363062490,116051675,479114165,6,0,0,199168,7,5894471378
14018,363074689,150474355,513549044,1,0,1,41984,5,6177828516
14019,363083431,116246666,479330097,2,0,0,48640,4,7078308420
14020,363124339,116190907,479315246,8,0,0,89600,2,3680864761
14021,363165090,150383977,513549067,6,0,1,4096,7,452186345
14022,363204780,116952187,480156967,7,0,0,202240,16,1749995483
14023,363241000,150308090,513549090,2,0,1,4608,4,6589531884
14024,363248559,150300554,513549113,1,0,1,5120,5,2487977445
14025,363249610,117149223,480398833,7,0,0,445440,16,5191821615
14026,363257240,150342619,513599859,6,0,1,22528,7,10484363579
14027,363298770,150301112,513599882,2,0,1,31744,4,10582751684
14028,363313479,116771067,480084546,5,0,0,22528,11,5458051835
14029,363315579,117750710,481066289,8,0,0,188416,2,2494118098
14030,363323840,116570163,479894003,7,0,0,155648,16,2012484934
14031,363336510,150264534,513601044,3,0,1,15360,3,10280209072
14032,363346630,117132464,480479094,7,0,0,24064,16,7538243344
14033,363347009,116415754,479762763,5,0,0,111616,11,8519841287
14034,363372229,116206618,479578847,8,0,0,18944,2,221376058
14035,363380840,115949748,479330588,9,0,0,1536,17,276477671
14036,363406069,117274956,480681025,8,0,0,43520,2,531026902
14037,363428920,117562131,480991051,6,0,0,344064,7,5532075923
14038,363454140,115242107,478696247,9,0,0,512,17,5041644989
14039,363471189,150131381,513602570,1,0,1,39424,5,7404216596
14040,363477750,115872876,479350626,7,0,0,10752,16,6155632805
14041,363493431,116235301,479728732,2,0,0,109568,4,6087967883
14042,363507679,150111556,513619235,0,0,1,16384,10,7114534166
14043,363511009,150114230,513625239,4,0,1,20480,2,4843275216
14044,363511510,116500758,480012268,0,0,0,101888,10,149898831
14045,363519040,150129333,513648373,6,0,1,29696,7,7988057479
14046,363533830,115581606,479115436,9,0,0,4096,17,8998717217
14047,363544120,150104714,513648834,6,0,1,10240,7,10304165236
14048,363552389,150099351,513651740,0,0,1,4608,10,3987452545
14049,363559779,150093267,513653046,4,0,1,2048,2,3931044111
14050,363573630,116897610,480471240,6,0,0,237568,7,8709366967
14051,363607639,117401219,481008858,8,0,0,58368,2,3704677473
14052,363641539,118069543,481711082,8,0,0,580608,2,4563239336
14053,363668509,116546165,480214674,8,0,0,126976,2,8088780220
14054,363682941,117590951,481273892,2,0,0,396800,4,1554798255
14055,363687359,149966046,513653405,4,0,1,9728,2,9345791881
14056,363690839,149966401,513657240,1,0,1,3584,5,4200230529
14057,363766119,149914880,513680999,1,0,1,35328,5,7691331542
14058,363766139,149924502,513690641,4,0,1,24064,2,5419411788
14059,363776039,149944052,513720091,4,0,1,56832,2,9117277256
14060,363781000,150863196,514644196,2,0,1,114688,4,840851349
14061,363781660,117367800,481149460,0,0,0,272896,10,10728780204
14062,363812000,151478471,515290471,2,0,1,58880,4,6337944849
14063,363850271,117498859,481349130,2,0,0,212480,4,1002458268
14064,363866340,151424154,515290494,2,0,1,10752,4,8592919622
14065,363871200,117413167,481284367,0,0,0,34304,10,1049660732
14066,363877070,116594661,480471731,9,0,0,1536,17,632728404
14067,363904209,151509604,515413813,0,0,1,8192,10,4559323333
14068,363914199,117836085,481750284,8,0,0,128512,2,2149629678
14069,363920231,117500386,481420617,2,0,0,234496,4,8118095293
14070,363996970,117530142,481527112,0,0,0,217600,10,10275978012
14071,363998010,117154951,481152961,9,0,0,11264,17,8510392168
14072,364004399,151409437,515413836,4,0,1,6144,2,981992045
14073,364019530,117960750,481980280,6,0,0,355328,7,7237011879
14074,364023571,118225938,482249509,2,0,0,378368,4,8141463931
14075,364028800,151451405,515480205,6,0,1,18432,7,2092131504
14076,364037609,152086877,516124486,0,0,1,45568,10,7999924608
14077,364039310,152148066,516187376,6,0,1,10752,7,1134166870
14078,364054009,152133623,516187632,0,0,1,9216,10,10065703102
14079,364060909,152292929,516353838,1,0,1,1536,5,10623640940
14080,364068150,152286202,516354352,2,0,1,60928,4,3223655235
14081,364082420,152271955,516354375,6,0,1,13312,7,2625807971
14082,364089200,152468171,516557371,2,0,1,70656,4,9981353021
14083,364128370,118197196,482325566,0,0,0,168960,10,6816024171
14084,364142701,117279576,481422277,2,0,0,5120,4,3495530396
14085,364148830,152462311,516611141,2,0,1,29184,4,4917987234
14086,364154400,152750027,516904427,2,0,1,70656,4,7231887000
14087,364176830,117581198,481758028,7,0,0,25088,16,5783682001
14088,364181500,117667492,481848992,7,0,0,190976,16,9938386296
14089,364236340,152685472,516921812,6,0,1,74240,7,5950995263
14090,364243789,117871514,482115303,5,0,0,361984,11,5222652659
14091,364254970,152666865,516921835,2,0,1,1536,4,2240421767
14092,364274439,117259716,481534155,8,0,0,23040,2,7886042921
14093,364275129,152646729,516921858,4,0,1,10240,2,909262247
14094,364277839,117996224,482274063,8,0,0,80384,2,6525815001
14095,364279641,118130132,482409773,2,0,0,92672,4,10515196631
14096,364289450,152632431,516921881,2,0,1,2560,4,901020651
14097,364301170,152620734,516921904,6,0,1,5632,7,6093385989
14098,364304089,117567881,481871970,8,0,0,75264,2,6083172786
14099,364323380,117657415,481980795,9,0,0,1536,17,4356790469
14100,364342649,152579278,516921927,1,0,1,18944,5,3375765790
14101,364347720,118062396,482410116,9,0,0,1024,17,942137367
14102,364352080,152569870,516921950,2,0,1,22528,4,6271539850
14103,364378510,152543479,516921989,2,0,1,12800,4,2976541613
14104,364390020,118054181,482444201,0,0,0,26624,10,6667204326
14105,364392609,117988905,482381514,8,0,0,183296,2,14639123
14106,364408531,117725671,482134202,2,0,0,61952,4,7545911627
14107,364430659,118090341,482521000,5,0,0,34304,11,5445559243
14108,364458890,152463130,516922020,6,0,1,5632,7,9166817456
14109,364495090,118169568,482664658,6,0,0,232448,7,2252504468
14110,364512659,152452294,516964953,1,0,1,43520,5,16025144
14111,364555769,117880297,482436066,8,0,0,82944,2,6247625758
14112,364563120,118518298,483081418,0,0,0,423424,10,1474092339
14113,364563779,152401840,516965619,1,0,1,11264,5,1976792884
14114,364578329,152387546,516965875,1,0,1,9216,5,1547990938
14115,364595539,152427263,517022802,1,0,1,32768,5,7243600580
14116,364610119,152508201,517118320,4,0,1,26624,2,8737179766
14117,364620449,118258127,482878576,5,0,0,313344,11,8703572336
14118,364683389,152434970,517118359,1,0,1,27136,5,9698717355
14119,364719590,152424555,517144145,2,0,1,10240,4,7912813583
14120,364736789,152407379,517144168,4,0,1,16896,2,8339561978
14121,364861750,152282441,517144191,2,0,1,17920,4,3842358550
14122,364866060,152373961,517240021,2,0,1,4096,4,8977192820
14123,364918060,117994235,482912295,7,0,0,110592,16,8445645611
14124,364927550,152318360,517245910,2,0,1,36352,4,5415702173
14125,364928070,152317863,517245933,6,0,1,3072,7,3587548946
14126,364941119,152304837,517245956,1,0,1,23040,5,3963866153
14127,364962639,117511604,482474243,8,0,0,19968,2,158679659
14128,365023520,117387243,482410763,9,0,0,2048,17,3445954413
14129,365025220,152329202,517354422,2,0,1,18944,4,412213151
14130,365031060,152338072,517369132,2,0,1,19456,4,3907116447
14131,365091240,152287946,517379186,6,0,1,3584,7,2158082281
14132,365157929,117782313,482940242,5,0,0,91648,11,745070780
14133,365228169,152151851,517380020,1,0,1,42496,5,6861180393
14134,365254621,117411932,482666553,2,0,0,6144,4,2224720471
14135,365300120,118602002,483902122,6,0,0,561664,7,5919323527
14136,365302179,118343507,483645686,5,0,0,26624,11,3244085018
14137,365316349,152063694,517380043,1,0,1,6144,5,8579492928
14138,365321459,117810058,483131517,5,0,0,164352,11,3273155532
14139,365329140,152275488,517604628,2,0,1,100352,4,7290252616
14140,365347511,118810063,484157574,2,0,0,302592,4,8049968598
14141,365397340,152222029,517619369,6,0,1,8192,7,9119398673
14142,365413861,118633346,484047207,2,0,0,108032,4,8779149449
14143,365414510,118221926,483636436,0,0,0,856576,10,7403562732
14144,365430690,118565927,483996617,0,0,0,251904,10,6056083893
14145,365443140,152176252,517619392,6,0,1,82944,7,8198589666
14146,365455390,152164025,517619415,6,0,1,20992,7,7373276586
14147,365493441,118152759,483646200,2,0,0,1024,4,115873059
14148,365536660,152082778,517619438,6,0,1,16896,7,8787051118
14149,365560139,152059322,517619461,1,0,1,16384,5,7227301062
14150,365569960,118075905,483645865,9,0,0,512,17,2528048314
14151,365575611,118595651,484171262,2,0,0,44544,4,2473343184
14152,365646860,118367408,484014268,7,0,0,57856,16,5462612047
14153,365659040,118260802,483919842,7,0,0,57856,16,7887703346
14154,365726100,151948787,517674887,6,0,1,21504,7,2602206474
14155,365746220,118318973,484065193,6,0,0,58880,7,2182148526
14156,365772709,151902201,517674910,1,0,1,28672,5,4965872920
14157,365844830,117792721,483637551,9,0,0,3584,17,10584041415
14158,365852900,118774232,484627132,0,0,0,364032,10,5545741669
14159,365879930,118536416,484416346,6,0,0,66560,7,5127440754
14160,365902080,118486783,484388863,7,0,0,109056,16,3922751758
14161,366031729,151729714,517761443,1,0,1,89600,5,7329541620
14162,366042509,118468600,484511109,5,0,0,31232,11,5207659017
14163,366079221,118231322,484310543,2,0,0,192512,4,4946141140
14164,366163509,151597957,517761466,1,0,1,4608,5,1580714212
14165,366191600,151575840,517767440,3,0,1,39936,3,3078683808
14166,366271369,151496094,517767463,1,0,1,9728,5,2255823387
14167,366272519,151522157,517794676,1,0,1,23552,5,4838529628
14168,366281679,151513199,517794878,1,0,1,7168,5,7259621334
14169,366294810,152747381,519042191,8,0,1,487936,2,6087512908
14170,366296890,118497629,484794519,0,0,0,107520,10,6112514590
14171,366316671,118445065,484761736,2,0,0,20480,4,2351677750
14172,366326179,152719878,519046057,1,0,1,6144,5,10264146677
14173,366342419,152732916,519075335,1,0,1,13824,5,7485814695
14174,366345869,118291426,484637295,5,0,0,33280,11,8592134400
14175,366373471,152701887,519075358,9,0,1,6656,17,2828373645
14176,366422341,118079229,484501570,2,0,0,10240,4,10645810844
14177,366453950,118044477,484498427,7,0,0,120320,16,6461420761
14178,366473870,117837811,484311681,9,0,0,3584,17,8899673761
14179,366476099,118631303,485107402,5,0,0,202752,11,4135770351
14180,366517639,118237834,484755473,8,0,0,144896,2,2833445659
14181,366517819,117911186,484429005,8,0,0,41472,2,10117900864
14182,366521910,118115564,484637474,9,0,0,512,17,7019198978
14183,366532510,153059215,519591725,8,0,1,417280,2,995696451
14184,366536749,153079706,519616455,1,0,1,18432,5,9971305833
14185,366541340,153163360,519704700,8,0,1,48128,2,4115097266
14186,366546839,153157884,519704723,1,0,1,68608,5,7871329777
14187,366559589,118707617,485267206,8,0,0,179200,2,10724035915
14188,366562600,118261582,484824182,7,0,0,97280,16,8196781429
14189,366589941,118817208,485407149,2,0,0,43008,4,1996205508
14190,366603330,118723100,485326430,9,0,0,1536,17,6786014553
14191,366605880,118051905,484657785,6,0,0,66560,7,8374358227
14192,366641469,153063277,519704746,1,0,1,31744,5,5678664296
14193,366670759,118670857,485341616,8,0,0,49664,2,3992296545
14194,366686329,118525271,485211600,8,0,0,60928,2,8195056479
14195,366733970,118591969,485325939,6,0,0,56832,7,2884863662
14196,366735039,117702072,484437111,8,0,0,3584,2,8099295412
14197,366791039,118173935,484964974,5,0,0,130048,11,2259715873
14198,366801189,118784454,485585643,8,0,0,231424,2,5772436705
14199,366808390,118378751,485187141,6,0,0,261632,7,2096698825
14200,366814649,152890120,519704769,1,0,1,9216,5,10478399035
14201,366823480,118369533,485193013,0,0,0,7680,10,9476848220
14202,366916431,118503533,485419964,2,0,0,41984,4,10436982586
14203,366921309,117906373,484827682,8,0,0,2048,2,10389904020
14204,366923859,118384741,485308600,8,0,0,135680,2,1584777658
14205,366946880,118508998,485455878,9,0,0,3072,17,5743235078
14206,367049459,117931032,484980491,5,0,0,5120,11,2820347404
14207,367097940,118244955,485342895,9,0,0,4096,17,3774683993
14208,367161430,118051129,485212559,9,0,0,3072,17,10256414257
14209,367197149,152507643,519704792,1,0,1,6656,5,2804520570
14210,367200440,118158649,485359089,7,0,0,43520,16,5096624576
14211,367232760,118552614,485785374,6,0,0,189952,7,723419205
14212,367252520,152456327,519708847,3,0,1,34816,3,3857304216
14213,367264410,117560747,484825157,9,0,0,3072,17,3533594051
14214,367278379,152437650,519716029,1,0,1,34304,5,8626469358
14215,367282000,118332572,485614572,0,0,0,81920,10,46085278
14216,367290899,152445746,519736645,1,0,1,13312,5,10329919139
14217,367369790,118263525,485633315,7,0,0,61440,16,8645675533
14218,367377280,118278405,485655685,9,0,0,7680,17,8791724013
14219,367417779,152334818,519752597,1,0,1,26624,5,4174024303
14220,367424950,152683418,520108368,8,0,1,116736,2,10329548215
14221,367499510,152608881,520108391,5,0,1,17920,11,8026726709
14222,367529440,152865003,520394443,3,0,1,28672,3,744476219
14223,367561601,117629026,485190627,2,0,0,11264,4,7083902727
14224,367607701,118101850,485709551,2,0,0,102912,4,3839916921
14225,367660290,152734176,520394466,3,0,1,2560,3,8252306296
14226,367664731,152741949,520406680,9,0,1,18944,17,3857763288
14227,367670520,152743070,520413590,3,0,1,3072,3,7772460901
14228,367707521,152706092,520413613,9,0,1,13312,17,8536963336
14229,367741920,117936252,485678172,0,0,0,73728,10,4518707717
14230,367765259,152648377,520413636,1,0,1,1536,5,1565471078
14231,367816630,152597029,520413659,7,0,1,10240,16,9294196378
14232,367842629,152571053,520413682,4,0,1,24576,2,6202442295
14233,367891569,118042874,485934443,8,0,0,39936,2,10383421676
14234,367892490,118029762,485922252,7,0,0,88576,16,2863816126
14235,367949959,152541145,520491104,1,0,1,20480,5,9385064764
14236,368000170,117589396,485589566,6,0,0,12800,7,4699662750
14237,368008109,152483018,520491127,1,0,1,34816,5,5941392534
14238,368039109,152452041,520491150,1,0,1,22016,5,1746547066
14239,368039559,117613763,485653322,8,0,0,65536,2,3801027169
14240,368085030,118132756,486217786,6,0,0,176128,7,8547984142
14241,368085379,152405794,520491173,1,0,1,11264,5,1974366362
14242,368099230,118037120,486136350,7,0,0,44032,16,199096806
14243,368124980,117855628,485980608,0,0,0,118784,10,9589242339
14244,368179589,152311607,520491196,1,0,1,28160,5,4270104135
14245,368195630,152295637,520491267,7,0,1,15360,16,1491867237
14246,368199621,118071852,486271473,2,0,0,176128,4,2871837577
14247,368219609,152271681,520491290,0,0,1,5632,10,10057457872
14248,368227229,117886333,486113562,8,0,0,130560,2,750699613
14249,368267140,152224173,520491313,3,0,1,16896,3,8638843207
14250,368275160,118077890,486353050,0,0,0,148992,10,925511518
14251,368279590,152211746,520491336,7,0,1,2560,16,5108682805
14252,368284001,118130746,486414747,2,0,0,101376,4,10691555148
14253,368293280,152198079,520491359,3,0,1,2560,3,5020150275
14254,368320699,118037366,486358065,8,0,0,16384,2,3811520261
14255,368350260,117665230,486015490,6,0,0,5120,7,9997171125
14256,368360240,152131142,520491382,7,0,1,9216,16,6951373369
14257,368368280,152123125,520491405,7,0,1,17408,16,7168773440
14258,368373880,118041522,486415402,9,0,0,2048,17,1048560934
14259,368380461,118166880,486547341,2,0,0,266240,4,2488041836
14260,368383720,118254521,486638241,9,0,0,1536,17,343680543
14261,368385490,118065500,486450990,6,0,0,73728,7,5042186591
14262,368401579,153192660,521594239,1,0,1,89088,5,7796325495
14263,368416769,117967059,486383828,5,0,0,84480,11,4361930254
14264,368437499,118200251,486637750,5,0,0,227328,11,10377231371
14265,368470920,118180627,486651547,0,0,0,43520,10,5617121683
14266,368484230,153110747,521594977,7,0,1,14848,16,10544430737
14267,368492190,153226675,521718865,3,0,1,8704,3,7348929982
14268,368499260,117953469,486452729,9,0,0,5632,17,6968447812
14269,368506760,118250579,486757339,6,0,0,113664,7,10562137065
14270,368518540,153326309,521844849,3,0,1,13824,3,6667224746
14271,368540671,118027776,486568447,2,0,0,69120,4,7544177046
14272,368544910,118236655,486781565,6,0,0,79360,7,4106710973
14273,368547310,118318772,486866082,7,0,0,111616,16,8998609776
14274,368573369,153271511,521844880,1,0,1,41984,5,6436719656
14275,368609650,153380493,521990143,7,0,1,12288,16,2838755764
14276,368653280,118178771,486832051,6,0,0,129024,7,4792228559
14277,368654080,153459360,522113440,6,0,1,6656,7,5981144411
14278,368677250,118105929,486783179,9,0,0,5120,17,8529677
14279,368711971,118193328,486905299,2,0,0,44544,4,4071742260
14280,368714920,118068594,486783514,9,0,0,1024,17,10417771004
14281,368752230,153746620,522498850,7,0,1,46592,16,5895900782
14282,368754390,154581600,523335990,8,0,1,286720,2,8318385137
14283,368773890,118132524,486906414,9,0,0,3584,17,3087029721
14284,368779461,118204881,486984342,2,0,0,130560,4,2709930648
14285,368786769,118208360,486995129,5,0,0,35328,11,1369785129
14286,368829509,118351807,487181316,5,0,0,70144,11,9273451979
14287,368833440,118837887,487671327,0,0,0,332800,10,5346116526
14288,368835800,118322728,487158528,9,0,0,156672,17,10346084643
14289,368909360,154525424,523434784,7,0,1,26624,16,4896296851
14290,368921090,119025313,487946403,9,0,0,1024,17,2489991424
14291,368922771,118810505,487733276,2,0,0,16896,4,4377357707
14292,368949780,118996288,487946068,7,0,0,263168,16,6008253918
14293,369041960,119158294,488200254,7,0,0,541184,16,9646571466
14294,369047880,118649121,487697001,0,0,0,2560,10,2094625050
14295,369087060,154347747,523434807,6,0,1,8704,7,4003880223
14296,369108930,118848348,487957278,7,0,0,28160,16,1694741522
14297,369153700,119175924,488329624,7,0,0,394240,16,10354246240
14298,369155380,119465807,488621187,0,0,0,214016,10,3150604568
14299,369186799,118848517,488035316,8,0,0,115712,2,7729176892
14300,369199650,154235180,523434830,6,0,1,3584,7,3298416233
14301,369219209,119609052,488828261,8,0,0,568320,2,6205418891
14302,369237210,154261938,523499148,6,0,1,8704,7,6434908412
14303,369259950,119127852,488387802,9,0,0,103424,17,8595392521
14304,369263100,154236071,523499171,6,0,1,20992,7,1362908417
14305,369275110,154224084,523499194,6,0,1,1536,7,1208837498
14306,369279059,154274991,523554050,1,0,1,76800,5,1900094462
14307,369283739,119048404,488332143,5,0,0,8192,11,9090893935
14308,369322360,119027769,488350129,0,0,0,58880,10,7040599676
14309,369363249,118992987,488356236,5,0,0,19968,11,9891488350
14310,369375230,118834251,488209481,7,0,0,30208,16,3508303497
14311,369399470,119255600,488655070,6,0,0,111104,7,5373803621
14312,369409359,119531189,488940548,5,0,0,180224,11,2200221879
14313,369417850,119083189,488501039,9,0,0,218112,17,6896009319
14314,369423640,119409488,488833128,7,0,0,15872,16,2873407394
14315,369496801,119557819,489054620,2,0,0,211968,4,9267669841
14316,369536710,119348389,488885099,9,0,0,170496,17,6807015389
14317,369552890,119003066,488555956,0,0,0,67584,10,5759730506
14318,369553640,119427670,488981310,6,0,0,54784,7,10038901289
14319,369553670,119410925,488964595,0,0,0,78848,10,3334707131
14320,369575061,153979012,523554073,9,0,1,14336,17,6900555287
14321,369575380,119414229,488989609,0,0,0,27136,10,4795446030
14322,369580869,119502798,489083667,8,0,0,95232,2,8862682412
14323,369589321,153966046,523555367,9,0,1,17920,17,1196841632
14324,369592880,119586740,489179620,0,0,0,313856,10,4492941226
14325,369606170,119279443,488885613,6,0,0,1536,7,9071700201
14326,369628540,119361404,488989944,6,0,0,1024,7,10463916852
14327,369663381,153892009,523555390,9,0,1,11776,17,10734458182
14328,369712070,153843343,523555413,6,0,1,15360,7,6375042951
14329,369731701,153894621,523626322,9,0,1,8704,17,1364673356
14330,369735350,153890995,523626345,6,0,1,2560,7,6422617778
14331,369738109,119768601,489506710,5,0,0,242176,11,10081030803
14332,369748530,153877838,523626368,6,0,1,5632,7,3452112325
14333,369769659,119314187,489083846,8,0,0,512,2,8375248707
14334,369773681,119608667,489382348,2,0,0,190976,4,593772900
14335,369797070,119418351,489215421,9,0,0,117248,17,9239484566
14336,369828280,153798111,523626391,6,0,1,4096,7,6358897189
14337,369889880,119697185,489587065,9,0,0,46080,17,4053116161
14338,369891411,153735003,523626414,9,0,1,37888,17,1540915532
14339,369903229,119956197,489859426,5,0,0,397312,11,10307906751
14340,369904240,119606393,489510633,7,0,0,12800,16,556195914
14341,369907881,119500853,489408734,2,0,0,34304,4,3609029183
14342,369954389,119694134,489648523,8,0,0,9728,2,389710126
14343,370003330,119989734,489993064,0,0,0,194560,10,2673949263
14344,370047009,120236397,490283406,8,0,0,79360,2,6366524079
14345,370056740,119940247,489996987,6,0,0,12800,7,9724759359
14346,370060819,120336591,490397410,8,0,0,272384,2,4657003866
14347,370088860,153652642,523741502,2,0,1,50176,4,6906162354
14348,370146810,119965510,490112320,0,0,0,48640,10,8522982611
14349,370172810,120065838,490238648,0,0,0,81408,10,2608545330
14350,370181199,120032622,490213821,8,0,0,48640,2,3234320055
14351,370262610,120439165,490701775,0,0,0,67072,10,3713321524
14352,370266941,153474592,523741533,9,0,1,23552,17,8339509392
14353,370291110,120280738,490571848,0,0,0,253952,10,4237106591
14354,370349439,120276119,490625558,5,0,0,176128,11,3124102805
14355,370370599,119828379,490198978,8,0,0,239104,2,10721329887
14356,370427320,120701715,491129035,7,0,0,368128,16,39830824
14357,370526410,119877442,490403852,6,0,0,4096,7,2394802992
14358,370568960,119833621,490402581,7,0,0,16896,16,2962460689
14359,370580310,120383924,490964234,7,0,0,367616,16,7180430241
14360,370594110,153147446,523741556,5,0,1,2048,11,9916858802
14361,370604470,120102427,490706897,6,0,0,1024,7,5310840027
14362,370615960,120983827,491599787,0,0,0,669696,10,1814058990
14363,370639240,153102339,523741579,5,0,1,9728,11,3820600827
14364,370641750,120335018,490976768,6,0,0,2560,7,6889607585
14365,370680070,120704680,491384750,7,0,0,400384,16,7175485628
14366,370709820,153032741,523742561,6,0,1,13312,7,4041261314
14367,370746680,152996551,523743231,6,0,1,4608,7,7801638282
14368,370754811,153780526,524535337,9,0,1,39936,17,957962524
14369,370758140,153939401,524697541,5,0,1,34816,11,7461315091
14370,370760981,154178528,524939509,9,0,1,512,17,8767004069
14371,370814371,120929144,491743515,2,0,0,45568,4,5361475302
14372,370818360,120195094,491013454,6,0,0,512,7,9409907728
14373,370819590,120156375,490975965,9,0,0,38400,17,1667541004
14374,370846159,120549557,491395716,5,0,0,35840,11,6624213122
14375,370963800,120792842,491756642,9,0,0,43008,17,1621137876
14376,370963810,120765752,491729562,9,0,0,103424,17,4571769141
14377,371008199,119844004,490852203,8,0,0,34304,2,8779493551
14378,371016011,120682016,491698027,2,0,0,287232,4,8652458593
14379,371067631,153871901,524939532,9,0,1,12288,17,9334623609
14380,371075500,153864055,524939555,6,0,1,17920,7,3171055925
14381,371089890,153849688,524939578,6,0,1,2048,7,6582041968
14382,371091910,120045267,491137177,6,0,0,512,7,8582969408
14383,371093561,153846040,524939601,9,0,1,3072,17,7623857080
14384,371183360,154200594,525383954,5,0,1,55808,11,5756766920
14385,371204010,120681125,491885135,7,0,0,420864,16,4891155714
14386,371215749,120394669,491610418,5,0,0,34816,11,10311740751
14387,371252990,120699576,491952566,9,0,0,221184,17,4865569228
14388,371256821,154258718,525515539,9,0,1,2560,17,5437316638
14389,371277110,154624089,525901199,5,0,1,74240,11,9643370343
14390,371300541,154745843,526046384,9,0,1,57344,17,9296193916
14391,371393400,154653007,526046407,3,0,1,11264,3,7279979184
14392,371412220,154634210,526046430,3,0,1,9728,3,8280774369
14393,371431010,120573620,492004630,9,0,0,169984,17,181406878
14394,371447580,154624736,526072316,5,0,1,512,11,6298627508
14395,371450111,154704404,526154515,9,0,1,46080,17,9196754893
14396,371489100,154665438,526154538,6,0,1,512,7,4398370972
14397,371516880,154637681,526154561,5,0,1,14336,11,3238795930
14398,371537800,154618278,526156078,6,0,1,38912,7,8794159214
14399,371573150,154608444,526181594,3,0,1,4608,3,4702409545
14400,371580750,120461351,492042101,7,0,0,122880,16,1611820089
14401,371583480,120460532,492044012,6,0,0,6144,7,10287084606
14402,371583510,120559098,492142608,0,0,0,81920,10,1888471418
14403,371597570,120355245,491952815,6,0,0,512,7,10440109450
14404,371620580,121116419,492736999,6,0,0,512,7,2044817453
14405,371642820,120474787,492117607,9,0,0,1024,17,10467181832
14406,371684621,154508268,526192889,9,0,1,8192,17,6934469518
14407,371700370,154501928,526202298,3,0,1,23040,3,6254447082
14408,371708780,120336035,492044815,6,0,0,2560,7,5840054528
14409,371716480,121015578,492732058,7,0,0,272896,16,8379659991
14410,371725470,154984753,526710223,6,0,1,41984,7,5411678191
14411,371728190,155013955,526742145,6,0,1,24576,7,4165289179
14412,371730111,120333933,492064044,2,0,0,512,4,2610808715
14413,371770430,120402982,492173412,6,0,0,1536,7,3810859461
14414,371803359,120794986,492598345,5,0,0,103424,11,6322276115
14415,371840450,120968702,492809152,9,0,0,131584,17,2079149956
14416,371862960,121148393,493011353,7,0,0,64000,16,2096978984
14417,371872701,154889213,526761914,9,0,1,16384,17,4069801062
14418,371908409,120997300,492905709,5,0,0,147968,11,2560244724
14419,371951670,154810910,526762580,6,0,1,1024,7,7736828551
14420,371962930,121114257,493077187,6,0,0,5120,7,4872478948
14421,371964200,154802475,526766675,7,0,1,19968,16,7793156551
14422,371999841,121564317,493564158,2,0,0,283136,4,3211234945
14423,372003640,155061764,527065404,5,0,1,2560,11,9993536108
14424,372006470,121069088,493075558,0,0,0,66560,10,70648538
14425,372035590,120804161,492839751,7,0,0,100352,16,8661245285
14426,372071120,120835704,492906824,6,0,0,3584,7,4463547917
14427,372080790,154984637,527065427,3,0,1,20992,3,9351822972
14428,372089630,120225761,492315391,9,0,0,92160,17,3182283110
14429,372105690,121350126,493455816,0,0,0,573952,10,9463094091
14430,372142609,120878499,493021108,8,0,0,6144,2,444908353
14431,372207160,154859873,527067033,6,0,1,31232,7,8539358510
14432,372231690,154835366,527067056,5,0,1,24576,11,4361496495
14433,372240520,154826559,527067079,6,0,1,512,7,9516527100
14434,372257720,154809382,527067102,6,0,1,12288,7,4035849334
14435,372270340,154796785,527067125,6,0,1,22528,7,8272901644
14436,372282360,154904151,527186511,3,0,1,5120,3,5470784386
14437,372287900,154898634,527186534,6,0,1,6144,7,2667792661
14438,372290439,120701368,492991807,8,0,0,158208,2,6044458104
14439,372309260,154877297,527186557,5,0,1,512,11,1022622501
14440,372311080,120421983,492733063,6,0,0,3072,7,2040341045
14441,372311801,154874779,527186580,9,0,1,10240,17,9462165079
14442,372312020,154874583,527186603,5,0,1,10240,11,3456436747
14443,372318570,154868056,527186626,6,0,1,7680,7,1338627139
14444,372395090,120696717,493091807,6,0,0,3072,7,10690014924
14445,372409940,120771728,493181668,6,0,0,1536,7,8495777616
14446,372420980,121220802,493641782,7,0,0,177664,16,2604899998
14447,372437250,121255164,493692414,9,0,0,6144,17,9370984225
14448,372445359,120779840,493225199,8,0,0,126976,2,8557613332
14449,372450859,120560993,493011852,8,0,0,1536,2,5812453637
14450,372466050,120634189,493100239,9,0,0,4608,17,6538064532
14451,372488239,120665494,493153733,5,0,0,78848,11,183751845
14452,372510439,120646335,493156774,8,0,0,6656,2,5691207504
14453,372524300,154662349,527186649,5,0,1,23552,11,3543407770
14454,372540011,154646685,527186696,9,0,1,72704,17,10255229923
14455,372563819,120594850,493158669,5,0,0,6144,11,10443439110
14456,372574320,154665930,527240250,3,0,1,26624,3,2665823777
14457,372609970,120631024,493240994,9,0,0,51712,17,7702698303
14458,372621840,154618433,527240273,6,0,1,43008,7,10274373722
14459,372642590,154691400,527333990,3,0,1,17920,3,4131617123
14460,372683299,120575183,493258482,8,0,0,512,2,8684068221
14461,372709500,121025567,493735067,7,0,0,95744,16,6504348389
14462,372710941,154623072,527334013,9,0,1,6144,17,9659984621
14463,372724990,155094162,527819152,8,0,1,234496,2,4998877518
14464,372731349,120726416,493457765,8,0,0,6144,2,9896648580
14465,372764230,155197880,527962110,3,0,1,22528,3,4661011227
14466,372785251,155176882,527962133,9,0,1,512,17,8419783826
14467,372807010,120780571,493587581,0,0,0,76800,10,10302226715
14468,372819460,120828741,493648201,7,0,0,20992,16,9819833671
14469,372832420,155130383,527962803,5,0,1,55808,11,2139057629
14470,372858079,155104747,527962826,1,0,1,19968,5,372014748
14471,372858750,120898286,493757036,6,0,0,15872,7,10247791589
14472,372886230,121010464,493896694,6,0,0,3584,7,9301792395
14473,372888150,155844902,528733052,8,0,1,325120,2,4043719215
14474,372889529,121141415,494030944,5,0,0,227328,11,3577579052
14475,372891390,155843147,528734537,8,0,1,15360,2,10500527694
14476,372915750,156120212,529035962,3,0,1,47616,3,8049948241
14477,372922179,121624309,494546488,5,0,0,299008,11,4933853131
14478,372989921,120750317,493740238,2,0,0,16896,4,1166422470
14479,373002110,156033875,529035985,7,0,1,15872,16,8103067094
14480,373039291,156031372,529070663,9,0,1,33280,17,1609355399
14481,373093270,155977416,529070686,5,0,1,7168,11,1355153619
14482,373130069,120831588,493961657,5,0,0,127488,11,1397254110
14483,373165881,155904828,529070709,9,0,1,12288,17,3107518299
14484,373212741,155870338,529083079,9,0,1,5632,17,3750959980
14485,373226740,155856362,529083102,3,0,1,22016,3,7093459947
14486,373282290,155800835,529083125,6,0,1,19456,7,8692693944
14487,373294931,155788217,529083148,9,0,1,1024,17,326374479
14488,373302360,120943192,494245552,9,0,0,58880,17,2787881032
14489,373305739,120740259,494045998,8,0,0,3072,2,2848207011
14490,373311780,155772506,529084286,6,0,1,32256,7,6067698618
14491,373319720,121539660,494859380,9,0,0,603648,17,9388024509
14492,373322230,121551648,494873878,0,0,0,47104,10,413784773
14493,373345111,155739198,529084309,9,0,1,7680,17,6957062213
14494,373361710,155796356,529158066,8,0,1,55296,2,2182872916
14495,373378009,121013269,494391278,5,0,0,295424,11,1005177934
14496,373391390,155766699,529158089,5,0,1,5120,11,911217532
14497,373438030,155752085,529190115,8,0,1,1536,2,1960600105
14498,373439421,121015909,494455330,2,0,0,194560,4,5328386524
14499,373481831,121193571,494675402,2,0,0,214016,4,2191760495
14500,373499080,155708315,529207395,3,0,1,29696,3,950133332
14501,373510551,121436048,494946599,2,0,0,57344,4,5754435811
14502,373512020,120588962,494100982,6,0,0,2048,7,6444269745
14503,373540950,121030823,494571773,9,0,0,78336,17,7223037687
14504,373570510,155645403,529215913,5,0,1,25088,11,9176315791
14505,373635589,120912201,494547790,8,0,0,4096,2,979627339
14506,373646220,155576874,529223094,5,0,1,17920,11,10591324436
14507,373650109,121512949,495163058,5,0,0,80896,11,4971133533
14508,373651020,120744961,494395981,0,0,0,15360,10,6407253315
14509,373658541,121221834,494880375,2,0,0,15872,4,6420773327
14510,373667940,155577335,529245275,5,0,1,4608,11,8511993969
14511,373683350,155573262,529256612,3,0,1,11776,3,9871714574
14512,373693641,155563125,529256766,9,0,1,8704,17,6702637013
14513,373700059,121174934,494874993,8,0,0,3584,2,10501225853
14514,373701150,155578969,529280119,8,0,1,15360,2,6013407657
14515,373704110,121396227,495100337,9,0,0,112128,17,3330569111
14516,373713320,155588884,529302204,7,0,1,15872,16,2768077295
14517,373722260,155580290,529302550,7,0,1,512,16,6825056765
14518,373738770,155569592,529308362,7,0,1,9216,16,785621936
14519,373769831,121831792,495601623,2,0,0,171008,4,7597571455
14520,373778410,121097074,494875484,6,0,0,1536,7,7900897007
14521,373784700,121458266,495242966,0,0,0,82944,10,6457125341
14522,373801070,155509558,529310628,3,0,1,3584,3,10634539589
14523,373811200,121653205,495464405,0,0,0,142848,10,6667246827
14524,373818580,155510794,529329374,5,0,1,41984,11,4263318502
14525,373822109,121547500,495369609,8,0,0,512,2,3100145455
14526,373843430,155928683,529772113,6,0,1,39424,7,4900533804
14527,373845680,156220195,530065875,7,0,1,74240,16,9663432829
14528,373859710,156206188,530065898,6,0,1,35328,7,1069315725
14529,373881310,156184611,530065921,6,0,1,1024,7,3171730516
14530,373881880,156186115,530067995,7,0,1,2560,16,9093445995
14531,373883811,122090465,495974276,2,0,0,116224,4,2161110638
14532,373896310,121524548,495420858,9,0,0,104960,17,2760497929
14533,373910580,121571218,495481798,7,0,0,56832,16,2028877669
14534,373934700,121976539,495911239,7,0,0,441856,16,1139275767
14535,373964250,121003931,494968181,6,0,0,1024,7,10569041437
14536,373965510,156102999,530068509,7,0,1,16896,16,2626559991
14537,373994230,121270131,495264361,7,0,0,70144,16,8805216157
14538,374009030,156059502,530068532,5,0,1,14848,11,133878009
14539,374009440,156070524,530079964,6,0,1,7168,7,4980447053
14540,374017829,121531667,495549496,5,0,0,61952,11,4691656469
14541,374026400,122120323,496146723,9,0,0,349696,17,6824200404
14542,374060471,156020978,530081449,9,0,1,15360,17,1629539840
14543,374064200,121544497,495608697,9,0,0,23040,17,9947193317
14544,374071630,156040593,530112223,3,0,1,18944,3,829555706
14545,374078020,121698568,495776588,9,0,0,200704,17,8963121984
14546,374099860,156014004,530113864,6,0,1,1024,7,4639131222
14547,374142320,155976945,530119265,6,0,1,25600,7,294362114
14548,374153621,155987826,530141447,9,0,1,30720,17,2166997434
14549,374161470,156014484,530175954,3,0,1,16384,3,6774120770
14550,374176409,120925199,495101608,8,0,0,4096,2,2168808935
14551,374180509,121084967,495265476,8,0,0,3584,2,9274105241
14552,374193449,156022998,530216447,1,0,1,68096,5,5360918098
14553,374198441,156020638,530219079,9,0,1,3584,17,146617794
14554,374239910,155983240,530223150,3,0,1,19456,3,8299234430
14555,374244221,121979461,496223682,2,0,0,175616,4,8451204571
14556,374256950,156026650,530283600,8,0,1,32256,2,3544423637
14557,374262060,122121070,496383130,0,0,0,253952,10,3914977911
14558,374266800,156360086,530626886,8,0,1,50176,2,1799264084
14559,374267811,156359098,530626909,9,0,1,8704,17,2772066999
14560,374283190,156343742,530626932,3,0,1,6144,3,2930678815
14561,374381930,121555594,495937524,7,0,0,74240,16,4599092037
14562,374424410,121558007,495982417,6,0,0,5120,7,5854080035
14563,374426180,122027708,496453888,0,0,0,137216,10,4853237576
14564,374427389,121742716,496170105,5,0,0,61952,11,7905176992
14565,374433350,156193605,530626955,6,0,1,4096,7,968185987
14566,374448859,121466022,495914881,5,0,0,11776,11,5471394319
14567,374464150,156209273,530673423,5,0,1,38400,11,8416847746
14568,374464520,121474321,495938841,6,0,0,1024,7,10484053294
14569,374470300,121757672,496227972,6,0,0,6656,7,3836977133
14570,374472860,121465623,495938483,6,0,0,3072,7,6340276194
14571,374506070,156287936,530794006,7,0,1,16384,16,5123310292
14572,374507780,121472719,495980499,9,0,0,19968,17,7357343751
14573,374510680,156368507,530879187,3,0,1,44544,3,4963306991
14574,374513100,156368353,530881453,8,0,1,3584,2,4311320105
14575,374571529,121409305,495980834,8,0,0,1024,2,8310888466
14576,374574530,156479146,531053676,2,0,1,35328,4,2004334191
14577,374579191,156590003,531169194,9,0,1,23040,17,2648812835
14578,374588431,122037931,496626362,2,0,0,46592,4,8194166186
14579,374592250,156596056,531188306,2,0,1,8704,4,2615966705
14580,374593030,156647728,531240758,6,0,1,25088,7,8056504817
14581,374598029,121553177,496151206,5,0,0,6144,11,5916816017
14582,374617280,121631451,496248731,7,0,0,33280,16,2564245954
14583,374617779,121529279,496147058,8,0,0,1024,2,5097833837
14584,374628200,156742063,531370263,2,0,1,67584,4,1824910216
14585,374629220,121917692,496546912,7,0,0,64512,16,5616871304
14586,374657250,121492015,496149265,6,0,0,7168,7,4284057010
14587,374662250,121562359,496224609,6,0,0,2048,7,4245292331
14588,374678510,156693955,531372465,8,0,1,13312,2,10492177874
14589,374681861,121542101,496223962,2,0,0,512,4,2960985192
14590,374689670,156817333,531507003,2,0,1,64000,4,2885485093
14591,374690851,121809750,496500601,2,0,0,153088,4,3482731844
14592,374698970,156808056,531507026,7,0,1,9728,16,5924257594
14593,374713420,122106736,496820156,0,0,0,126976,10,4266201886
14594,374848720,122242770,497091490,0,0,0,62464,10,2555137429
14595,374867429,121980587,496848016,8,0,0,2048,2,2622903150
14596,374888140,122067815,496955955,0,0,0,68608,10,8789046741
14597,374904001,122112730,497016731,2,0,0,180224,4,3786128170
14598,374907370,156863015,531770385,6,0,1,71680,7,7971877407
14599,374915260,156861616,531776876,5,0,1,16384,11,5065141717
14600,374933901,156926922,531860823,9,0,1,29184,17,8425774236
14601,374945379,121720258,496665637,8,0,0,1024,2,5792178108
14602,374970200,156960875,531931075,7,0,1,55296,16,3143949719
14603,374985760,156989399,531975159,7,0,1,11776,16,6961699638
14604,374990390,156994331,531984721,7,0,1,3072,16,895583101
14605,375017830,121819697,496837527,0,0,0,2560,10,1930151905
14606,375022350,122197540,497219890,9,0,0,322560,17,1900427336
14607,375057620,156927460,531985080,6,0,1,9728,7,1048061028
14608,375078060,122342137,497420197,0,0,0,146944,10,8912516291
14609,375102690,156961087,532063777,2,0,1,4096,4,4330441964
14610,375102811,156970551,532073362,9,0,1,26624,17,4260095849
14611,375128211,156945665,532073876,9,0,1,45568,17,5891893241
14612,375192809,122096882,497289691,5,0,0,227328,11,9939700602
14613,375196190,122179212,497375402,7,0,0,278528,16,4456875272
14614,375212589,157035006,532247595,4,0,1,87552,2,4555092383
14615,375214490,121627070,496841560,6,0,0,1024,7,5895240553
14616,375222170,121471925,496694095,6,0,0,2560,7,9361510067
14617,375257269,122318605,497575874,5,0,0,180736,11,9014364507
14618,375278621,156968997,532247618,9,0,1,4608,17,7299433488
14619,375317800,156929841,532247641,6,0,1,4096,7,9840488104
14620,375368730,156878934,532247664,6,0,1,2560,7,359955920
14621,375402650,156846776,532249426,6,0,1,32256,7,3998723676
14622,375413509,121876891,497290400,8,0,0,2048,2,6066360231
14623,375428779,121663514,497092293,8,0,0,2560,2,3090256957
14624,375456920,156806459,532263379,7,0,1,46080,16,3083825971
14625,375464541,122003946,497468487,2,0,0,158208,4,7307853070
14626,375475390,156788012,532263402,6,0,1,32768,7,6684545030
14627,375529230,121357231,496886461,9,0,0,7680,17,8585554848
14628,375555560,156707865,532263425,2,0,1,12288,4,4246432643
14629,375568841,156733850,532302691,9,0,1,18432,17,3361240612
14630,375575630,156727084,532302714,6,0,1,4096,7,6274198097
14631,375591899,156710838,532302737,4,0,1,2048,2,7522480432
14632,375603429,156699331,532302760,4,0,1,1024,2,9248820565
14633,375608511,156694272,532302783,9,0,1,512,17,6069026467
14634,375613159,121907624,497520783,8,0,0,3072,2,3225853630
14635,375613259,121607122,497220381,8,0,0,1536,2,4887214582
14636,375621809,121898015,497519824,5,0,0,92160,11,1861159700
14637,375632720,156670086,532302806,2,0,1,24064,4,1469615300
14638,375654230,121837437,497491667,6,0,0,75776,7,4575126613
14639,375675580,122249752,497925332,7,0,0,234496,16,397915562
14640,375683240,156640359,532323599,2,0,1,14848,4,9259878579
14641,375704640,156628734,532333374,2,0,1,16384,4,1231404926
14642,375707200,122630359,498337559,0,0,0,294400,10,9580009833
14643,375753599,122921076,498674675,5,0,0,235008,11,5768338393
14644,375812380,122790507,498602887,9,0,0,242688,17,8412990758
14645,375815130,156600871,532416001,7,0,1,64000,16,8248250172
14646,375831220,156600750,532431970,7,0,1,7680,16,3430690118
14647,375833331,156614832,532448163,9,0,1,4608,17,5472427886
14648,375852610,156599419,532452029,7,0,1,6144,16,2070529086
14649,375880700,122254399,498135099,6,0,0,157696,7,7926040736
14650,375939369,156568005,532507374,4,0,1,62976,2,529702465
14651,375943471,122501813,498445284,2,0,0,250880,4,2343269100
14652,375965020,122551709,498516729,0,0,0,77824,10,7678911521
14653,375985010,156905229,532890239,8,0,1,53248,2,8734992812
14654,376019269,157032861,533052130,4,0,1,18432,2,4705783299
14655,376034830,122494090,498528920,7,0,0,39936,16,1621142027
14656,376035150,157019246,533054396,2,0,1,3584,4,2466032285
14657,376046810,157009212,533056022,8,0,1,2560,2,6852791919
14658,376052831,157267276,533320107,9,0,1,60928,17,5619613985
14659,376092580,122614051,498706631,0,0,0,104448,10,4088535862
14660,376094250,157251877,533346127,7,0,1,11776,16,5578254208
14661,376134430,157232882,533367312,7,0,1,23552,16,11368700
14662,376151020,121815597,497966617,0,0,0,79872,10,6630556459
14663,376184380,157388739,533573119,8,0,1,7168,2,440156854
14664,376319530,157253612,533573142,2,0,1,10752,4,6039826887
14665,376380790,121972704,498353494,9,0,0,52224,17,3688124808
14666,376390761,121978044,498368805,2,0,0,50176,4,4968082161
14667,376464220,157108945,533573165,2,0,1,5120,4,635578618
14668,376464740,122005246,498469986,9,0,0,80896,17,1770148668
14669,376476611,157129828,533606439,9,0,1,48128,17,6341924803
14670,376511320,122334933,498846253,7,0,0,204800,16,8102023141
14671,376532341,157074121,533606462,9,0,1,10240,17,9425121211
14672,376554051,157166361,533720412,9,0,1,33280,17,9056335991
14673,376556911,122349681,498906592,2,0,0,197632,4,2476699479
14674,376579130,157141321,533720451,2,0,1,5632,4,5187236232
14675,376595860,122181909,498777769,0,0,0,43520,10,4998827393
14676,376635221,157123496,533758717,9,0,1,24064,17,9321632133
14677,376651890,157107497,533759387,7,0,1,24576,16,189402659
14678,376653351,157106059,533759410,9,0,1,6144,17,6783320207
14679,376681390,157078043,533759433,2,0,1,16384,4,7556255438
14680,376713460,157045996,533759456,8,0,1,3072,2,2712957920
14681,376756989,122367886,499124875,8,0,0,7680,2,5744326497
14682,376780540,122280048,499060588,7,0,0,226304,16,3824224459
14683,376782550,122322049,499104599,0,0,0,14336,10,5920364314
14684,376794701,122171356,498966057,2,0,0,66048,4,9087172777
14685,376795430,121988377,498783807,0,0,0,10752,10,4611408111
14686,376839600,122526349,499365949,9,0,0,147456,17,8784610478
14687,376844471,156915008,533759479,9,0,1,11264,17,6996889976
14688,376864609,122363416,499228025,5,0,0,156160,11,1817791218
14689,376936901,156822601,533759502,9,0,1,1024,17,9090881634
14690,376998680,122434060,499432740,7,0,0,219136,16,7991579278
14691,377002310,156767534,533769844,6,0,1,9216,7,9967073491
14692,377026860,156743186,533770046,7,0,1,39936,16,4972540539
14693,377042081,156827181,533869262,9,0,1,24064,17,10243031830
14694,377074011,156809002,533883013,9,0,1,1024,17,1013017776
14695,377125250,156762909,533888159,7,0,1,8192,16,2204571424
14696,377134761,156941760,534076521,9,0,1,1536,17,8126845843
14697,377176150,122540972,499717122,0,0,0,196608,10,3533187179
14698,377278460,122019982,499298442,6,0,0,54784,7,7740099214
14699,377281329,121651320,498932649,8,0,0,4096,2,5438172624
14700,377313129,122291115,499604244,8,0,0,4608,2,119611047
14701,377329449,121732254,499061703,8,0,0,3584,2,8154051906
14702,377341599,121720907,499062506,8,0,0,2560,2,1928959747
14703,377421491,156833963,534255454,9,0,1,4608,17,7596263339
14704,377473181,157218494,534691675,9,0,1,23552,17,2356748954
14705,377476949,121971749,499448698,8,0,0,1536,2,671388625
14706,377501730,122144422,499646152,0,0,0,26112,10,7386582973
14707,377503711,157187987,534691698,9,0,1,12288,17,6109924480
14708,377518561,122727675,500246236,2,0,0,332800,4,5628857428
14709,377528460,122486700,500015160,0,0,0,226816,10,8949154121
14710,377535580,122797218,500332798,9,0,0,15872,17,10146100326
14711,377550900,122342120,499893020,0,0,0,61440,10,6337982179
14712,377572220,122160080,499732300,6,0,0,49664,7,10338029615
14713,377654349,121477880,499132229,8,0,0,3072,2,1123710722
14714,377661549,122233834,499895383,8,0,0,7680,2,8637936405
14715,377671941,121923728,499595669,2,0,0,59904,4,681249774
14716,377688930,121759277,499448207,6,0,0,50688,7,282136009
14717,377696130,122088828,499784958,7,0,0,47104,16,3369490308
14718,377713301,157062886,534776187,9,0,1,58368,17,2377767770
14719,377788449,122937277,500725726,5,0,0,168960,11,9150766654
14720,377815921,156960289,534776210,9,0,1,18432,17,5106021453
14721,377821649,122012513,499834162,5,0,0,117760,11,9154118876
14722,377849200,122905097,500754297,9,0,0,93696,17,7396735338
14723,377874801,122758795,500633596,2,0,0,477696,4,10733462074
14724,377908361,157056677,534965038,9,0,1,22528,17,4561284310
14725,377941651,157023410,534965061,9,0,1,21504,17,7108653667
14726,377948200,122335834,500284034,9,0,0,54784,17,3207341835
14727,377979290,123113125,501092415,9,0,0,61440,17,9395978055
14728,378008599,122861184,500869783,8,0,0,7168,2,1553563508
14729,378024601,122859401,500884002,2,0,0,46592,4,3938327385
14730,378090221,122206004,500296225,2,0,0,39936,4,5823797776
14731,378182700,122684876,500867576,9,0,0,371712,17,2203212986
14732,378188841,157311144,535499985,9,0,1,70144,17,8780075453
14733,378224439,122992219,501216658,5,0,0,187904,11,6977732880
14734,378232860,122689892,500922752,0,0,0,57856,10,10513466352
14735,378287721,157328601,535616322,9,0,1,30208,17,4154258822
14736,378290720,121976599,500267319,7,0,0,69120,16,7866605499
14737,378336870,122931204,501268074,6,0,0,168448,7,10294076021
14738,378351180,123017514,501368694,9,0,0,202752,17,6670749223
14739,378422661,157200279,535622940,9,0,1,23552,17,7593311950
14740,378445709,123719020,502164729,5,0,0,479232,11,3527090819
14741,378487970,123789890,502277860,0,0,0,371200,10,4244993975
14742,378496400,123370277,501866677,0,0,0,466432,10,1542377225
14743,378504761,123084082,501588843,2,0,0,262144,4,4480746966
14744,378536939,122097460,500634399,8,0,0,2560,2,6141273076
14745,378542281,122362820,500905101,2,0,0,69120,4,4209249033
14746,378600259,122417214,501017473,5,0,0,11264,11,4581081966
14747,378602349,157087372,535689721,1,0,1,30208,5,2014815809
14748,378616169,157253782,535869951,1,0,1,3584,5,4606877951
14749,378624569,123688437,502313006,5,0,0,91136,11,9468673707
14750,378645199,157224775,535869974,1,0,1,4096,5,6991363223
14751,378665830,157205282,535871112,5,0,1,53760,11,5437421580
14752,378688089,157183046,535871135,1,0,1,1536,5,752730460
14753,378736699,122380389,501117088,8,0,0,6656,2,7667400737
14754,378756170,123579643,502335813,7,0,0,74752,16,4989415785
14755,378770200,157100958,535871158,6,0,1,13824,7,3563958634
14756,378779480,157092036,535871516,6,0,1,51712,7,6241266904
14757,378848790,157426025,536274815,5,0,1,22016,11,3975171187
14758,378893421,122379848,501273269,2,0,0,16896,4,2620779154
14759,378907650,123574755,502482405,9,0,0,130560,17,6436260370
14760,378949939,157423760,536373699,1,0,1,39936,5,9773017206
14761,378965109,157410216,536375325,1,0,1,2560,5,3421789007
14762,378967080,122512537,501479617,9,0,0,33792,17,8626285993
14763,378994650,123024040,502018690,7,0,0,246272,16,4208122657
14764,379006569,122406594,501413163,8,0,0,8192,2,9918515779
14765,379022430,122571740,501594170,0,0,0,17408,10,4443120373
14766,379065879,122834361,501900240,5,0,0,110080,11,8783309830
14767,379079911,122863720,501943631,2,0,0,142336,4,4239047455
14768,379105790,157271597,536377387,5,0,1,14848,11,1227144390
14769,379132429,157482540,536614969,1,0,1,39936,5,5405744177
14770,379147750,157605223,536752973,6,0,1,92160,7,701683882
14771,379183419,123492009,502675428,5,0,0,439296,11,2236017720
14772,379185121,123780926,502966047,2,0,0,238080,4,7245119196
14773,379192840,157560351,536753191,5,0,1,11776,11,2076694029
14774,379194189,123486121,502680310,8,0,0,6656,2,4667303605
14775,379229891,157523323,536753214,9,0,1,25600,17,10351752958
14776,379269860,157483377,536753237,5,0,1,8704,11,7265923013
14777,379290430,123133151,502423581,7,0,0,98816,16,706851093
14778,379296470,122988745,502285215,9,0,0,24064,17,3215181183
14779,379301319,123413692,502715011,5,0,0,94720,11,2617590822
14780,379315329,123400984,502716313,8,0,0,4096,2,5031099679
14781,379347909,123850819,503198728,5,0,0,366080,11,1627284233
14782,379351891,157401369,536753260,9,0,1,33792,17,669844387
14783,379357419,123328686,502686105,8,0,0,18944,2,9154519693
14784,379361020,157392263,536753283,6,0,1,4096,7,9750212065
14785,379368111,123310148,502678259,2,0,0,9216,4,8662783389
14786,379387879,157365435,536753314,1,0,1,29696,5,5783101227
14787,379406190,123113970,502520160,7,0,0,3584,16,3267891915
14788,379414031,157483785,536897816,9,0,1,19968,17,6670644192
14789,379414760,157483079,536897839,5,0,1,7168,11,10679615213
14790,379442619,157455243,536897862,1,0,1,11776,5,6848109475
14791,379481969,123502977,502984946,5,0,0,61952,11,1014005061
14792,379482791,157415094,536897885,9,0,1,9216,17,1313302477
14793,379496390,123744836,503241226,6,0,0,57344,7,4308648225
14794,379499330,123550528,503049858,9,0,0,160768,17,7777535499
14795,379543570,123655608,503199178,7,0,0,512,16,6103094236
14796,379549280,123291158,502840438,7,0,0,512,16,4633600638
14797,379567421,123519744,503087165,2,0,0,122368,4,8926957798
14798,379587569,123611361,503198930,8,0,0,512,2,1863359304
14799,379637609,157262990,536900599,1,0,1,1024,5,6674538384
14800,379677239,157223399,536900638,1,0,1,34816,5,10451005513
14801,379706201,123832197,503538398,2,0,0,154624,4,2788467694
14802,379716950,124007275,503724225,6,0,0,358912,7,6712503716
14803,379726440,123812137,503538577,7,0,0,512,16,427382073
14804,379767109,124045527,503812636,5,0,0,113152,11,9537488812
14805,379817339,123960798,503778137,5,0,0,75776,11,881296511
14806,379875660,123597997,503473657,7,0,0,2048,16,1023661302
14807,379895260,123496718,503391978,7,0,0,1536,16,9836087762
14808,379924739,123800445,503725184,8,0,0,3072,2,3993503009
14809,379975521,156925148,536900669,9,0,1,6144,17,10726090853
14810,380003920,156932675,536936595,5,0,1,9216,11,10090708085
14811,380007519,123805484,503813003,8,0,0,1024,2,8279499018
14812,380031470,123723533,503755003,9,0,0,97792,17,4329778255
14813,380032200,123864930,503897130,6,0,0,123904,7,4302808385
14814,380044130,156892488,536936618,5,0,1,6144,11,4351986876
14815,380135840,156800801,536936641,8,0,1,1024,2,2060366076
14816,380174930,123902633,504077563,6,0,0,347136,7,9448949886
14817,380183820,156759075,536942895,8,0,1,25600,2,10319400911
14818,380213800,123641440,503855240,7,0,0,1536,16,10095551221
14819,380250609,123857489,504108098,5,0,0,94208,11,198016869
14820,380251540,156720658,536972198,6,0,1,12800,7,6955217382
14821,380255499,158012596,538268095,1,0,1,102912,5,9410523325
14822,380294499,157974262,538268761,1,0,1,1024,5,1314420229
14823,380300380,123778968,504079348,7,0,0,5632,16,5641903181
14824,380327260,157943767,538271027,6,0,1,3584,7,4042593171
14825,380330540,158371466,538702006,5,0,1,37376,11,635377310
14826,380335399,123812068,504147467,8,0,0,5120,2,3209920881
14827,380348761,158507271,538856032,9,0,1,512,17,9639802133
14828,380370779,158485276,538856055,4,0,1,20992,2,570381660
14829,380377390,158478688,538856078,5,0,1,11264,11,8624843356
14830,380410091,124686308,505096399,2,0,0,585216,4,5728105654
14831,380414571,158441530,538856101,9,0,1,4096,17,4357171517
14832,380427949,124866347,505294296,8,0,0,3072,2,4732208382
14833,380428090,124324909,504752999,9,0,0,75264,17,6245660608
14834,380457910,158695153,539153063,6,0,1,31232,7,1534177295
14835,380546729,158613712,539160441,4,0,1,5120,2,3800987018
14836,380560381,124620662,505181043,2,0,0,269824,4,10258981472
14837,380600879,158559585,539160464,1,0,1,5632,5,1840886871
14838,380611099,158553981,539165080,4,0,1,44032,2,4381536003
14839,380648419,124644863,505293282,5,0,0,313856,11,5284646594
14840,380648699,158626008,539274707,4,0,1,27648,2,7132065126
14841,380653600,124544008,505197608,6,0,0,18432,7,6202252672
14842,380692359,124406403,505098762,8,0,0,7680,2,9085292354
14843,380695691,124865111,505560802,2,0,0,206848,4,5436545944
14844,380717039,123972545,504689584,8,0,0,512,2,9908444014
14845,380742880,124650191,505393071,0,0,0,42496,10,8989466212
14846,380757710,158552790,539310500,6,0,1,17408,7,2229022074
14847,380809649,158533232,539342881,4,0,1,70144,2,10217937020
14848,380822029,124500150,505322179,5,0,0,90112,11,8504814210
14849,380841480,124350396,505191876,0,0,0,35328,10,9793479538
14850,380902231,158446551,539348782,9,0,1,19968,17,5903645301
14851,380906150,124502743,505408893,6,0,0,2560,7,5824107145
14852,380907251,159355004,540262255,9,0,1,22528,17,5548809463
14853,380917121,159877994,540795115,9,0,1,20992,17,4095918959
14854,380930670,159864468,540795138,6,0,1,15360,7,5524025291
14855,380933570,124779337,505712907,9,0,0,232960,17,7611388864
14856,380952400,124991609,505944009,9,0,0,440832,17,4599094090
14857,380955271,159839890,540795161,9,0,1,9216,17,6826927942
14858,380987140,159809003,540796143,6,0,1,2048,7,8544200969
14859,380997480,124790458,505787938,9,0,0,79872,17,3081220197
14860,381001999,160001872,541003871,1,0,1,50176,5,1586984421
14861,381038810,124700485,505739295,6,0,0,8704,7,4709729053
14862,381045869,124248831,505294700,8,0,0,1024,2,8436437867
14863,381051199,159952695,541003894,4,0,1,7680,2,6186274926
14864,381060110,160000169,541060279,6,0,1,72192,7,4664393972
14865,381067190,160156186,541223376,6,0,1,28160,7,1794913550
14866,381096559,160154631,541251190,1,0,1,14848,5,6075091600
14867,381121049,124593441,505714490,8,0,0,5120,2,131018454
14868,381127939,124832409,505960348,5,0,0,45056,11,6984282410
14869,381162500,160088713,541251213,6,0,1,24064,7,3811380863
14870,381211621,160039615,541251236,9,0,1,25600,17,717474950
14871,381213019,124733578,505946597,8,0,0,2560,2,1338938769
14872,381227089,124512385,505739474,8,0,0,512,2,1867358738
14873,381227810,160023449,541251259,6,0,1,14848,7,19158165
14874,381240059,160011231,541251290,1,0,1,43520,5,7151753947
14875,381283190,159968123,541251313,6,0,1,38400,7,3520907311
14876,381302669,124643125,505945794,8,0,0,5632,2,10209700313
14877,381389529,159861823,541251352,1,0,1,19456,5,4265899469
14878,381393100,124601086,505994186,7,0,0,5120,16,9805580958
14879,381433840,124790730,506224570,9,0,0,132096,17,3241378574
14880,381435990,159815385,541251375,6,0,1,19456,7,2324471803
14881,381436720,159887865,541324585,6,0,1,3584,7,8338727359
14882,381438910,124598956,506037866,0,0,0,17408,10,3106061975
14883,381456539,125156770,506613309,5,0,0,546816,11,8331253285
14884,381457509,159867099,541324608,1,0,1,16896,5,9571566221
14885,381459909,159864722,541324631,1,0,1,6144,5,7111096545
14886,381463949,159860705,541324654,1,0,1,17408,5,5779937783
14887,381470780,125336044,506806824,9,0,0,163328,17,3444428626
14888,381474021,159850656,541324677,9,0,1,1536,17,7433953525
14889,381487139,159838364,541325503,1,0,1,8704,5,1645604828
14890,381510709,159814817,541325526,4,0,1,9216,2,5534441892
14891,381521449,124925229,506446678,8,0,0,10752,2,926805898
14892,381528861,125483177,507012038,2,0,0,321024,4,5547883805
14893,381541480,125097444,506638924,9,0,0,83968,17,4587542963
14894,381565719,125310392,506876111,5,0,0,227328,11,1231539232
14895,381705949,159663802,541369751,1,0,1,59392,5,2513428311
14896,381728450,125185730,506914180,9,0,0,124416,17,4656971730
14897,381736471,159633303,541369774,9,0,1,11264,17,8891580795
14898,381741319,125438518,507179837,8,0,0,230400,2,923645137
14899,381770480,125466163,507236643,9,0,0,72192,17,8276784682
14900,381803849,159565948,541369797,1,0,1,13824,5,3159168155
14901,381832991,159536837,541369828,9,0,1,12288,17,205489190
14902,381851011,159606403,541457414,9,0,1,24576,17,10606836028
14903,381869470,125223356,507092826,6,0,0,3584,7,1436997841
14904,381913619,159543818,541457437,1,0,1,9216,5,8810390489
14905,381950659,125531266,507481925,5,0,0,271872,11,2206597525
14906,381962439,125098206,507060645,5,0,0,19968,11,10581795964
14907,382003210,125710484,507713694,0,0,0,209920,10,6871375992
14908,382059859,159397617,541457476,1,0,1,22016,5,1858186962
14909,382067130,124945351,507012481,7,0,0,1024,16,5829503478
14910,382108460,125238832,507347292,7,0,0,512,16,5546417269
14911,382114479,125852421,507966900,5,0,0,266752,11,1217527211
14912,382134690,159322809,541457499,3,0,1,6656,3,5788798539
14913,382143850,125036166,507180016,7,0,0,512,16,5047548490
14914,382163699,126431062,508594761,8,0,0,232448,2,4142465461
14915,382204650,125333952,507538602,9,0,0,93184,17,6819171155
14916,382205890,159251632,541457522,3,0,1,1536,3,9589532767
14917,382214441,125782746,507997187,2,0,0,99328,4,9969523372
14918,382254300,125229075,507483375,6,0,0,1536,7,7295448550
14919,382266070,125731296,507997366,7,0,0,512,16,9462874344
14920,382290300,125192584,507482884,7,0,0,3072,16,2169786983
14921,382298060,125921184,508219244,0,0,0,550400,10,10125896881
14922,382343500,126028374,508371874,9,0,0,51200,17,5620938833
14923,382354751,125941417,508296168,2,0,0,229888,4,6732823634
14924,382362741,125993510,508356251,2,0,0,197120,4,4467869897
14925,382394350,159074302,541468652,3,0,1,38400,3,8278462975
14926,382409290,159059385,541468675,3,0,1,1024,3,2758964860
14927,382423040,125576221,507999261,7,0,0,6144,16,3525980232
14928,382454761,159068568,541523329,9,0,1,23040,17,3828956928
14929,382454770,125769021,508223791,0,0,0,14848,10,2681827764
14930,382461970,159061382,541523352,6,0,1,14336,7,1358798059
14931,382471011,159114810,541585821,9,0,1,8704,17,6566472767
14932,382476490,159109354,541585844,3,0,1,34816,3,6289628473
14933,382499450,126319502,508818952,0,0,0,84992,10,9210801060
14934,382499459,126269481,508768940,8,0,0,464896,2,3345762548
14935,382528261,126087324,508615585,2,0,0,59392,4,9552163000
14936,382539500,126292766,508832266,0,0,0,43520,10,104289791
14937,382609780,125762273,508372053,7,0,0,512,16,5272278259
14938,382641299,126360463,509001762,5,0,0,323072,11,8818864954
14939,382648200,126122190,508770390,6,0,0,4096,7,10699641224
14940,382651400,158934467,541585867,3,0,1,7680,3,10066848647
14941,382672790,126206884,508879674,7,0,0,4096,16,1386202370
14942,382698720,126070399,508769119,7,0,0,512,16,8029214635
14943,382699879,126093154,508793033,5,0,0,74240,11,4756186277
14944,382733660,126134038,508867698,6,0,0,5120,7,5557722624
14945,382762669,158823221,541585890,0,0,1,6144,10,8488052638
14946,382775001,159874698,542649699,9,0,1,40448,17,9912071598
14947,382776261,160021051,542797312,9,0,1,16896,17,266775658
14948,382778280,126394778,509173058,7,0,0,512,16,8685810008
14949,382789819,160155804,542945623,0,0,1,8704,10,10608475532
14950,382809639,126543628,509353267,5,0,0,492544,11,6066006890
14951,382814100,126280097,509094197,7,0,0,1024,16,10181498164
14952,382814590,126851358,509665948,6,0,0,2560,7,2368731387
14953,382855410,160738833,543594243,3,0,1,110592,3,8710581868
14954,382858759,126291142,509149901,8,0,0,3584,2,711827827
14955,382865209,126518836,509384045,5,0,0,100864,11,7828851631
14956,382868940,160824261,543693201,3,0,1,48128,3,3613835109
14957,382877460,160815764,543693224,3,0,1,19456,3,4932831893
14958,382900330,126301057,509201387,7,0,0,1024,16,3722133016
14959,382911729,126944197,509855926,8,0,0,317440,2,7744285867
14960,382914920,160808146,543723066,3,0,1,26112,3,8459700199
14961,382917400,160805689,543723089,3,0,1,2048,3,4245744688
14962,382928500,126778032,509706532,9,0,0,115712,17,2942083689
14963,382937069,127146094,510083163,5,0,0,290816,11,8395018260
14964,382945020,126805600,509750620,0,0,0,83968,10,9162984505
14965,382957409,127180221,510137630,5,0,0,178688,11,6325406958
14966,382971610,127202515,510174125,6,0,0,2048,7,585588223
14967,383024920,127158947,510183867,7,0,0,512,16,5216938948
14968,383063919,127261831,510325750,8,0,0,68096,2,3462776563
14969,383076920,160646192,543723112,3,0,1,10752,3,6888034822
14970,383077310,127602584,510679894,9,0,0,270336,17,5812635610
14971,383081159,127465241,510546400,5,0,0,241664,11,4751573591
14972,383100780,126843549,509944329,7,0,0,1536,16,171021711
14973,383105049,160618086,543723135,0,0,1,6144,10,1438345966
14974,383149150,126707111,509856261,6,0,0,1024,7,756943657
14975,383156179,160566979,543723158,0,0,1,11264,10,8595141775
14976,383166680,160661223,543827903,6,0,1,6656,7,2359628049
14977,383186950,160640976,543827926,5,0,1,6656,11,253576931
14978,383197321,160630628,543827949,9,0,1,7680,17,7922168066
14979,383201230,160626742,543827972,5,0,1,13824,11,649893561
14980,383225119,127698454,510923573,5,0,0,153600,11,6742086042
14981,383238639,160606399,543845038,0,0,1,22528,10,9875775493
14982,383249229,127627521,510876750,8,0,0,358400,2,6367559853
14983,383272070,160572991,543845061,5,0,1,4608,11,5602239893
14984,383297710,127148882,510446592,6,0,0,1024,7,3755649978
14985,383311340,126826937,510138277,6,0,0,2048,7,9150576235
14986,383315040,160530044,543845084,6,0,1,67072,7,9328885917
14987,383327009,127681840,511008849,5,0,0,72704,11,7673195804
14988,383336710,127842772,511179482,9,0,0,203776,17,6781965267
14989,383390330,160454777,543845107,6,0,1,7680,7,8002712203
14990,383409440,161247557,544656997,6,0,1,7168,7,164811774
14991,383422920,127563731,510986651,0,0,0,206848,10,9402858571
14992,383459211,126927677,510386888,2,0,0,24576,4,5852378816
14993,383466550,161272418,544738968,6,0,1,3584,7,1936801396
14994,383467321,162065417,545532738,9,0,1,52224,17,8734681455
14995,383497910,127050932,510548842,6,0,0,1536,7,1561622551
14996,383498450,162034311,545532761,3,0,1,27136,3,5762306388
14997,383499291,128096662,511595953,2,0,0,500224,4,7595798158
14998,383507709,162026346,545534055,0,0,1,1024,10,5643730789
14999,383519461,162014617,545534078,9,0,1,7680,17,5243333800
15000,383525260,128081631,511606891,6,0,0,4608,7,3217030922
15001,383538730,161995371,545534101,3,0,1,7168,3,4344343273
15002,383560270,127462281,511022551,7,0,0,1536,16,897315378
15003,383562650,161988992,545551642,5,0,1,21504,11,1022032606
15004,383586210,162154646,545740856,5,0,1,64000,11,7995022631
15005,383635440,162107362,545742802,5,0,1,3072,11,10198489280
15006,383662570,162080796,545743366,5,0,1,10752,11,2612101063
15007,383671831,162167160,545838991,9,0,1,19968,17,479030211
15008,383712540,162133735,545846275,5,0,1,34816,11,2216316660
15009,383768209,127837209,511605418,8,0,0,30208,2,544274292
15010,383773270,162088056,545861326,6,0,1,6144,7,7359318839
15011,383791990,162071922,545863912,6,0,1,4096,7,1236494165
15012,383792630,128222891,512015521,9,0,0,53248,17,1307421839
15013,383794839,128027483,511822322,5,0,0,243712,11,4215143069
15014,383796159,162411904,546208063,0,0,1,26112,10,6294992267
15015,383812819,127630699,511443518,5,0,0,75264,11,2370661732
15016,383822110,163174378,546996488,3,0,1,27648,3,2792894629
15017,383834839,163545749,547380588,0,0,1,35328,10,7101459259
15018,383859050,163521897,547380947,5,0,1,9728,11,9385256098
15019,383870690,163635315,547506005,6,0,1,18432,7,3786694979
15020,383875590,127509487,511385077,7,0,0,5632,16,1511057797
15021,383876750,128046540,511923290,0,0,0,109056,10,4249852890
15022,383959430,163547241,547506671,6,0,1,1024,7,4618063271
15023,383961890,163559286,547521176,6,0,1,5120,7,8609430027
15024,383999920,127663170,511663090,6,0,0,9216,7,8297454442
15025,384018799,128377674,512396473,8,0,0,403968,2,2590850746
15026,384047180,163499182,547546362,6,0,1,22016,7,2434796852
15027,384047670,128155808,512203478,9,0,0,40960,17,6633602141
15028,384068550,127811177,511879727,6,0,0,512,7,2948875351
15029,384070599,163499041,547569640,0,0,1,4096,10,7647677205
15030,384074980,127747567,511822547,6,0,0,512,7,7683657270
15031,384089170,163647947,547737117,8,0,1,31232,2,8126058667
15032,384145271,128358474,512503745,2,0,0,36864,4,7041214389
15033,384149720,163606615,547756335,6,0,1,39936,7,2578955745
15034,384155401,163627171,547782572,9,0,1,7680,17,3033175022
15035,384165759,128499850,512665609,8,0,0,34816,2,1659274435
15036,384178430,163653907,547832337,5,0,1,28160,11,6342968779
15037,384183160,127698459,511881619,7,0,0,3072,16,2207155917
15038,384201500,163711223,547912723,6,0,1,28160,7,875110146
15039,384228810,127962165,512190975,9,0,0,84480,17,5830352712
15040,384233779,128006294,512240073,5,0,0,32768,11,1248425897
15041,384244641,163668113,547912754,9,0,1,7168,17,5254094207
15042,384246750,128201249,512447999,0,0,0,165888,10,7422323712
15043,384248100,128244390,512492490,0,0,0,145920,10,8419253131
15044,384250379,163662398,547912777,0,0,1,16896,10,6841393813
15045,384281750,165137039,549418789,6,0,1,77312,7,5874976676
15046,384302619,128642956,512945575,5,0,0,312320,11,6256045567
15047,384321760,165307395,549629155,3,0,1,20992,3,7166993473
15048,384326280,127893105,512219385,7,0,0,10240,16,10224403425
15049,384361770,165512447,549874217,5,0,1,30208,11,9533749851
15050,384370020,128908659,513278679,0,0,0,312832,10,9403455872
15051,384371740,128025692,512397432,7,0,0,3072,16,6081574305
15052,384374791,165499449,549874240,9,0,1,16896,17,5224367127
15053,384380659,165848096,550228755,0,0,1,25600,10,7590834581
15054,384423790,165897215,550321005,5,0,1,18432,11,5432918502
15055,384428400,165892628,550321028,6,0,1,15872,7,1966501712
15056,384473369,165847682,550321051,4,0,1,16384,2,1551691092
15057,384505130,128115662,512620792,0,0,0,20480,10,9368718915
15058,384541161,128089326,512630487,2,0,0,31744,4,5633393880
15059,384541981,128964852,513506833,2,0,0,355328,4,281431994
15060,384656009,128338496,512994505,5,0,0,116736,11,7205029171
15061,384666991,165654083,550321074,9,0,1,23552,17,7806652332
15062,384695859,128327352,513023211,8,0,0,75264,2,968111894
15063,384742230,165578867,550321097,3,0,1,10752,3,3057288222
15064,384752641,128636821,513389462,2,0,0,363520,4,9139663931
15065,384772289,128387969,513160258,8,0,0,110592,2,7986991099
15066,384806030,128253619,513059649,7,0,0,5632,16,3012871138
15067,384842610,128103300,512945910,6,0,0,1024,7,2221482879
15068,384843400,165502859,550346259,5,0,1,3584,11,3166013508
15069,384855569,128767165,513622734,8,0,0,3072,2,7582634505
15070,384860751,128739085,513599836,2,0,0,166400,4,6553078219
15071,384871250,128809726,513680976,0,0,0,67072,10,2751753095
15072,384890719,128885339,513776058,5,0,0,60416,11,1966618383
15073,384894980,128653986,513548966,6,0,0,1024,7,4271822526
15074,384923020,128203519,513126539,7,0,0,7168,16,4620794173
15075,384968329,165377953,550346282,0,0,1,13312,10,7648925017
15076,384975289,128568406,513543695,8,0,0,120832,2,6605919023
15077,384990581,165490063,550480644,9,0,1,40448,17,5437161011
15078,384991221,128405752,513396973,2,0,0,24576,4,2547626595
15079,385029990,165450677,550480667,3,0,1,4096,3,4524024067
15080,385049500,165431190,550480690,5,0,1,19456,11,6907585115
15081,385069760,129023905,514093665,9,0,0,92672,17,10392227888
15082,385071710,165409003,550480713,6,0,1,16384,7,1203269559
15083,385075880,165529383,550605263,3,0,1,41472,3,9259756774
15084,385095800,165509502,550605302,3,0,1,32768,3,3803688501
15085,385100999,165504326,550605325,0,0,1,9216,10,7689264772
15086,385102681,129252986,514355667,2,0,0,240640,4,9969910578
15087,385108251,128290249,513398500,2,0,0,4608,4,6436717678
15088,385112531,165559795,550672326,9,0,1,6656,17,7105362772
15089,385120531,165551834,550672365,9,0,1,14848,17,9848545521
15090,385145810,165688964,550834774,6,0,1,7168,7,6685242906
15091,385165220,128383380,513548600,0,0,0,15872,10,9215413275
15092,385165670,128515664,513681334,7,0,0,1024,16,151788459
15093,385166801,166152004,551318805,9,0,1,72192,17,3524901667
15094,385197600,166121228,551318828,8,0,1,512,2,262760375
15095,385202030,129351704,514553734,0,0,0,48640,10,7226152613
15096,385212209,166306873,551519082,1,0,1,43520,5,182857466
15097,385216320,128384701,513601021,7,0,0,3584,16,1927009283
15098,385234009,128723403,513957412,8,0,0,86016,2,1102630109
15099,385234450,128422767,513657217,6,0,0,6144,7,6445838510
15100,385243989,166365848,551609837,0,0,1,3584,10,169246909
15101,385251870,166458755,551710625,3,0,1,80384,3,5435595322
15102,385254299,166480106,551734405,1,0,1,32256,5,4845738008
15103,385282610,166457557,551740167,3,0,1,1024,3,6701662045
15104,385286010,166502277,551788287,2,0,1,35328,4,9497997219
15105,385290319,128818551,514108870,8,0,0,47616,2,9762945385
15106,385300590,128677429,513978019,7,0,0,2048,16,5236902821
15107,385339271,129951169,515290440,2,0,0,123904,4,3147976792
15108,385420860,130034183,515455043,0,0,0,135168,10,8555094830
15109,385448520,166729975,552178495,3,0,1,13824,3,1337302657
15110,385461680,129484805,514946485,7,0,0,512,16,7926316631
15111,385480139,166859102,552339241,1,0,1,2560,5,3982349098
15112,385506319,167016727,552523046,1,0,1,5632,5,7869912290
15113,385527869,130554896,516082765,8,0,0,362496,2,2922289680
15114,385537160,128208256,513745416,6,0,0,1024,7,7905207448
15115,385554441,129859349,515413790,2,0,0,215040,4,7777333521
15116,385555280,130332143,515887423,9,0,0,377856,17,8631098647
15117,385555499,128882065,514437564,8,0,0,9728,2,2833826165
15118,385560429,166962640,552523069,1,0,1,28160,5,5787663979
15119,385569879,130044934,515614813,8,0,0,195072,2,9523595004
15120,385572109,129055830,514627939,8,0,0,52224,2,1211279933
15121,385606620,128351127,513957747,7,0,0,1024,16,7259855393
15122,385627241,128762587,514389828,2,0,0,52736,4,9606249493
15123,385636220,166910295,552546515,3,0,1,14336,3,2220829354
15124,385640880,129611785,515252665,0,0,0,365056,10,354407459
15125,385648420,129035096,514683516,6,0,0,3072,7,6955006353
15126,385690571,131052618,516743189,2,0,0,289280,4,155513228
15127,385710640,166835898,552546538,3,0,1,2048,3,5384524524
15128,385719730,166826831,552546561,3,0,1,13312,3,2606180474
15129,385743469,129102984,514846453,8,0,0,294400,2,595383352
15130,385756100,128685446,514441546,7,0,0,3072,16,6405402046
15131,385759920,128365104,514125024,7,0,0,2560,16,9047569929
15132,385780569,130573246,516353815,5,0,0,540160,11,6427693875
15133,385788090,129303042,515091132,0,0,0,12800,10,10394600570
15134,385802740,130713266,516516006,9,0,0,231424,17,7259037949
15135,385859540,129862401,515721941,6,0,0,2048,7,4445095246
15136,385860140,166686444,552546584,8,0,1,10240,2,7087727734
15137,385861200,130529078,516390278,0,0,0,117760,10,2227384301
15138,385861600,129598056,515459656,7,0,0,1536,16,5695811699
15139,385898719,166733548,552632267,1,0,1,41472,5,4385313633
15140,385901639,129779298,515680937,8,0,0,47104,2,3563378334
15141,385918270,166719911,552638181,8,0,1,41472,2,9336553616
15142,385942440,166717409,552659849,8,0,1,9728,2,1052133208
15143,385964590,128627780,514592370,7,0,0,512,16,10717085206
15144,386003469,166688204,552691673,1,0,1,46080,5,4399702539
15145,386036950,130867454,516904404,9,0,0,453120,17,8761397557
15146,386043950,129572134,515616084,7,0,0,4096,16,6536258657
15147,386045599,166825476,552871075,0,0,1,37376,10,4595627653
15148,386050209,129875301,515925510,5,0,0,124928,11,8870779035
15149,386078050,130843739,516921789,0,0,0,49152,10,1958378377
15150,386082889,166788209,552871098,1,0,1,5120,5,807381484
15151,386143251,130975046,517118297,2,0,0,313344,4,795048586
15152,386161129,166832408,552993537,1,0,1,5632,5,1524729270
15153,386164529,129959934,516124463,5,0,0,54784,11,10065397417
15154,386171470,166822090,552993560,3,0,1,22016,3,1149497832
15155,386176499,166817084,552993583,1,0,1,1536,5,3245110592
15156,386192210,166827224,553019434,8,0,1,27648,2,6263162261
15157,386207659,167094443,553302102,1,0,1,89088,5,7972681050
15158,386237369,131002629,517239998,5,0,0,314368,11,5710670155
15159,386246560,129861188,516107748,0,0,0,81920,10,50359282
15160,386307050,166995075,553302125,2,0,1,512,4,6326691044
15161,386307970,131296627,517604597,0,0,0,709632,10,2542274394
15162,386336420,131017979,517354399,9,0,0,355840,17,5586133664
15163,386353790,130076619,516430409,0,0,0,131584,10,3088998883
15164,386389330,166912818,553302148,3,0,1,18432,3,4679330520
15165,386424220,166986033,553410253,2,0,1,15872,4,419354106
15166,386461119,167282346,553743465,1,0,1,43008,5,9690863256
15167,386482709,131192155,517674864,5,0,0,181760,11,6386288936
15168,386497859,167245629,553743488,0,0,1,4608,10,598413591
15169,386543799,167199712,553743511,1,0,1,2560,5,8990356365
15170,386544729,167198805,553743534,0,0,1,512,10,5402331385
15171,386576951,131042395,517619346,2,0,0,45568,4,2868522124
15172,386583169,167418416,554001585,1,0,1,57344,5,6347343748
15173,386586769,130436010,517022779,8,0,0,145920,2,10142684825
15174,386596529,168350212,554946741,0,0,1,17920,10,6824358272
15175,386607690,129746639,516354329,7,0,0,1536,16,2797444031
15176,386609620,131151768,517761388,0,0,0,282624,10,6894903658
15177,386612080,131182775,517794855,6,0,0,512,7,3944098884
15178,386641599,131211183,517852782,5,0,0,147456,11,8077552292
15179,386644190,168743370,555387560,3,0,1,15360,3,1846584004
15180,386666710,130702399,517369109,0,0,0,48128,10,4677490558
15181,386707980,131335008,518042988,0,0,0,216064,10,228870632
15182,386714070,168681331,555395401,3,0,1,3584,3,7034050882
15183,386720661,131489516,518210177,2,0,0,79872,4,7153157683
15184,386726400,130661934,517388334,0,0,0,27136,10,1608486191
15185,386763410,168656022,555419432,3,0,1,2560,3,4692510571
15186,386765150,130840289,517605439,7,0,0,2560,16,7495266461
15187,386788470,168642523,555430993,8,0,1,3584,2,487367794
15188,386791330,169168117,555959447,3,0,1,50176,3,8872313653
15189,386794379,169188366,555982745,0,0,1,3584,10,2805350142
15190,386826799,130079991,516906790,5,0,0,7680,11,1112361516
15191,386853369,130525786,517379155,5,0,0,32768,11,290148548
15192,386875299,130268823,517144122,5,0,0,84480,11,8149342229
15193,386878480,169104288,555982768,8,0,1,42496,2,4405692324
15194,386909150,169156500,556065650,8,0,1,10240,2,10162135288
15195,386932689,169133016,556065705,0,0,1,4096,10,2822904781
15196,386967710,130273130,517240840,6,0,0,2560,7,10113332952
15197,386994560,130680685,517675245,7,0,0,1024,16,8989841832
15198,386997239,169068489,556065728,1,0,1,10752,5,4981049044
15199,387014990,130365007,517379997,7,0,0,2560,16,6870520808
15200,387026070,130219785,517245855,7,0,0,16384,16,6720926147
15201,387032020,169033731,556065751,8,0,1,4608,2,3374750750
15202,387039209,169026565,556065774,1,0,1,512,5,6976109606
15203,387045360,169034968,556080328,6,0,1,20992,7,2243055250
15204,387073290,131318551,518391841,9,0,0,228352,17,102843152
15205,387086539,169049270,556135809,0,0,1,58880,10,3501686578
15206,387113259,169240083,556353342,0,0,1,28160,10,10707529729
15207,387128309,169225072,556353381,1,0,1,19456,5,6323103686
15208,387132910,169220494,556353404,8,0,1,3584,2,5289232518
15209,387210890,169173612,556384502,3,0,1,4608,3,5493869125
15210,387220530,169163995,556384525,6,0,1,18432,7,1224521828
15211,387252930,130514487,517767417,7,0,0,19456,16,9520527459
15212,387264319,169120229,556384548,0,0,1,11776,10,6281394878
15213,387307019,169376441,556683460,0,0,1,512,10,4153606967
15214,387311229,169530691,556841920,1,0,1,9216,5,9234498708
15215,387312030,169533436,556845466,2,0,1,5632,4,9198289323
15216,387322580,170311566,557634146,2,0,1,97792,4,6329074248
15217,387329160,170305009,557634169,2,0,1,18944,4,356458650
15218,387331910,170303709,557635619,2,0,1,26624,4,10389957459
15219,387342019,130612046,517954065,5,0,0,77312,11,1407379540
15220,387353920,170454646,557808566,3,0,1,30720,3,8912391071
15221,387358129,170450460,557808589,0,0,1,2048,10,4283840329
15222,387392850,130650629,518043479,1,0,0,1536,5,6626915164
15223,387399170,170431773,557830943,2,0,1,60928,4,2295475586
15224,387408649,130711675,518120324,5,0,0,32256,11,6086088288
15225,387408880,170422086,557830966,6,0,1,18944,7,7369909387
15226,387415930,130769888,518185818,0,0,0,204800,10,7697982523
15227,387421970,170502993,557924963,2,0,1,70656,4,8737978130
15228,387446170,130484316,517930486,7,0,0,189952,16,10199279243
15229,387447919,170555292,558003211,1,0,1,36352,5,7178903380
15230,387452080,130318526,517770606,6,0,0,10240,7,8538942859
15231,387456889,130337764,517794653,5,0,0,78848,11,3492595481
15232,387464969,131080793,518545762,5,0,0,19456,11,515872574
15233,387475400,170527842,558003242,6,0,1,30720,7,589171273
15234,387481309,170521956,558003265,1,0,1,17920,5,970839626
15235,387524880,170478408,558003288,6,0,1,62464,7,9229126590
15236,387538779,131035242,518574021,8,0,0,92672,2,7979593833
15237,387543411,131118083,518661494,2,0,0,150528,4,8282006392
15238,387632570,171105671,558738241,5,0,1,62976,11,6316701547
15239,387657510,171193740,558851250,2,0,1,10240,4,7402487629
15240,387657880,171289366,558947246,5,0,1,27136,11,7005457357
15241,387661470,130863064,518524534,0,0,0,111104,10,1385675169
15242,387700789,130734489,518435278,8,0,0,61440,2,9305547670
15243,387730930,171216339,558947269,5,0,1,7680,11,6104540269
15244,387747510,131021398,518768908,0,0,0,201216,10,10338613982
15245,387759380,130930115,518689495,1,0,0,10752,5,3427155808
15246,387793620,130258042,518051662,6,0,0,3584,7,3251110774
15247,387832590,131051017,518883607,0,0,0,307712,10,371617870
15248,387859840,130555892,518415732,0,0,0,78336,10,9988890016
15249,387860381,130738779,518599160,2,0,0,82432,4,8892382366
15250,387863580,131083074,518946654,0,0,0,206848,10,10014269219
15251,387871260,130545275,518416535,6,0,0,2560,7,8219037792
15252,387874500,171087822,558962322,2,0,1,2048,4,7021014229
15253,387890209,130795979,518686188,8,0,0,48640,2,6893239711
15254,387895590,171066755,558962345,5,0,1,17408,11,3855313466
15255,387898540,171063828,558962368,6,0,1,2048,7,8082819157
15256,387916559,171050967,558967526,4,0,1,4608,2,3822040427
15257,387927920,171110813,559038733,5,0,1,2560,11,4694199889
15258,387935410,171103346,559038756,5,0,1,14336,11,448642938
15259,387942311,131038553,518980864,2,0,0,106496,4,1012858474
15260,387949019,171097665,559046684,4,0,1,11776,2,3616342400
15261,387954920,171098912,559053832,2,0,1,512,4,4529590854
15262,387965510,130812001,518777511,0,0,0,28160,10,8265509996
15263,387967730,171143636,559111366,5,0,1,13824,11,7157583075
15264,388009350,171102039,559111389,3,0,1,1024,3,8436510660
15265,388096451,131103517,519199968,2,0,0,304640,4,10112391946
15266,388099170,131229877,519329047,9,0,0,250368,17,5823838241
15267,388107379,171004033,559111412,4,0,1,18944,2,9563490167
15268,388108570,130562775,518671345,9,0,0,32256,17,3693866533
15269,388109461,171064251,559173712,9,0,1,17920,17,5659211136
15270,388111480,171481344,559592824,2,0,1,56320,4,6913386922
15271,388119390,171493749,559613139,6,0,1,17920,7,7756889345
15272,388130430,171560242,559690672,3,0,1,8704,3,6814772796
15273,388143699,171599976,559743675,4,0,1,3584,2,6176888333
15274,388146569,130801824,518948393,5,0,0,5632,11,4031590658
15275,388148250,171670039,559818289,3,0,1,19456,3,379021478
15276,388151180,171667132,559818312,5,0,1,6144,11,916842563
15277,388154350,171663985,559818335,3,0,1,47104,3,1887922231
15278,388157490,131340955,519498445,9,0,0,95232,17,9483837153
15279,388175361,130899951,519075312,2,0,0,56832,4,7273638938
15280,388180439,130814504,518994943,5,0,0,46080,11,2851007717
15281,388180770,130844541,519025311,6,0,0,5632,7,8032178471
15282,388202610,131266796,519469406,9,0,0,290304,17,4317553244
15283,388258620,171741530,560000150,2,0,1,7680,4,9531281464
15284,388260250,171852717,560112967,3,0,1,81408,3,6546538732
15285,388263680,171876997,560140677,2,0,1,19968,4,8297960489
15286,388277310,171863390,560140700,3,0,1,12288,3,3211419877
15287,388338880,131190952,519529832,7,0,0,102912,16,7471496302
15288,388377620,171763103,560140723,3,0,1,9728,3,8393295133
15289,388416560,171736362,560152922,2,0,1,3072,4,2915384781
15290,388466290,131238387,519704677,4,0,0,209920,2,7454407741
15291,388474960,171868203,560343163,3,0,1,93184,3,7851919463
15292,388478740,172025900,560504640,5,0,1,18944,11,7141452923
15293,388482020,131084395,519566415,0,0,0,3072,10,685072301
15294,388484450,172024376,560508826,5,0,1,6656,11,1151502453
15295,388486520,172026326,560512846,6,0,1,14848,7,4813035282
15296,388499220,131609125,520108345,0,0,0,206848,10,2599445900
15297,388515560,131392577,519908137,6,0,0,4608,7,6781930577
15298,388549990,131802287,520352277,9,0,0,484864,17,9290383715
15299,388550670,172531558,561082228,5,0,1,19456,11,870042048
15300,388552109,131938972,520491081,5,0,0,253952,11,6197985618
15301,388623139,131783518,520406657,8,0,0,39936,2,5952987419
15302,388646520,172440145,561086665,6,0,1,7168,7,2188503113
15303,388680310,172406378,561086688,2,0,1,1536,4,9559797304
15304,388698300,172388590,561086890,2,0,1,4096,4,5581436203
15305,388711170,131493159,520204329,9,0,0,17408,17,8399561328
15306,388720250,172395858,561116108,3,0,1,2560,3,6690389608
15307,388730909,131663511,520394420,8,0,0,138240,2,2689259979
15308,388731060,131682507,520413567,4,0,0,22528,2,5968927905
15309,388753820,172579352,561333172,2,0,1,3072,4,8854740666
15310,388810449,172524485,561334934,0,0,1,3072,10,8158275512
15311,388814000,131707848,520521848,0,0,0,99840,10,10333404306
15312,388847690,132079565,520927255,9,0,0,134656,17,3887933176
15313,388853070,132153924,521006994,4,0,0,261632,2,3664904178
15314,388871660,131862408,520734068,1,0,0,3584,5,10525926566
15315,388958860,172376097,561334957,2,0,1,1536,4,7970805245
15316,388973959,132870867,521844826,5,0,0,220160,11,7162167545
15317,388974949,132181063,521156012,5,0,0,55296,11,1383032930
15318,389005949,132546694,521552643,8,0,0,217600,2,4964672498
15319,389014600,132456112,521470712,6,0,0,3072,7,10724454433
15320,389027939,172340811,561368750,0,0,1,19456,10,6046866222
15321,389049610,172361945,561411555,3,0,1,1024,3,3998512672
15322,389080610,172331291,561411901,3,0,1,512,3,5197440908
15323,389086591,132383162,521469753,2,0,0,621568,4,9157877144
15324,389133269,172332133,561465402,0,0,1,33280,10,6591950068
15325,389141750,172328158,561469908,3,0,1,7168,3,4480761150
15326,389151981,132934669,522086650,2,0,0,254976,4,1936198796
15327,389159780,173458087,562617867,3,0,1,7168,3,9393932234
15328,389162790,132425132,521587922,0,0,0,115712,10,9481972491
15329,389199959,132518883,521718842,8,0,0,244736,2,9462984705
15330,389211880,132382328,521594208,4,0,0,5632,2,1935520651
15331,389232270,133732187,522964457,0,0,0,708608,10,2472481265
15332,389235969,133868177,523104146,5,0,0,368128,11,5479742350
15333,389242890,173653722,562896612,2,0,1,21504,4,9639489858
15334,389262800,131822381,521085181,1,0,0,1536,5,2215505009
15335,389279499,173926731,563206230,0,0,1,72192,10,7705521216
15336,389282520,132309949,521592469,7,0,0,14848,16,10592632323
15337,389287560,132699830,521987390,6,0,0,8192,7,2828023298
15338,389300420,173933320,563233740,2,0,1,36352,4,7990429253
15339,389315889,132461834,521777723,5,0,0,19456,11,10553225324
15340,389322361,132937743,522260104,2,0,0,223232,4,5100212984
15341,389343549,132428223,521771772,5,0,0,173568,11,4621245724
15342,389382330,174154224,563536554,2,0,1,43520,4,2101843084
15343,389408570,132494238,521902808,6,0,0,4096,7,9654812875
15344,389421021,132753947,522174968,2,0,0,138752,4,5930757633
15345,389424289,174112288,563536577,0,0,1,20992,10,420077521
15346,389432199,133275888,522708087,5,0,0,52224,11,8321180072
15347,389454110,133829551,523283661,0,0,0,212480,10,6232152817
15348,389517540,132595793,522113333,0,0,0,5120,10,10144712052
15349,389522610,174027392,563550002,3,0,1,13824,3,485417040
15350,389532060,133800140,523332200,4,0,0,159232,2,2826045218
15351,389535960,132553053,522089013,1,0,0,7680,5,3128764751
15352,389596830,133837931,523434761,7,0,0,324096,16,4028398246
15353,389604650,133949369,523554019,6,0,0,1024,7,3921846094
15354,389635890,132624393,522260283,1,0,0,512,5,9262283927
15355,389641249,132689780,522331029,5,0,0,27136,11,4791959939
15356,389650410,133340122,522990532,4,0,0,85504,2,2222174068
15357,389666200,133832925,523499125,7,0,0,210944,16,6443958940
15358,389723441,173828187,563551628,9,0,1,2560,17,7015953796
15359,389729320,132935519,522664839,6,0,0,1024,7,10546818569
15360,389756170,132619848,522376018,4,0,0,7680,2,2988076089
15361,389776179,173792681,563568860,0,0,1,10240,10,8812578773
15362,389791139,132866964,522658103,5,0,0,17408,11,8835500987
15363,389799319,133419088,523218407,5,0,0,40960,11,4510871749
15364,389852929,133326276,523179205,5,0,0,246272,11,1708875484
15365,389864270,132519049,522383319,6,0,0,1024,7,4302355628
15366,389883900,173695422,563579322,2,0,1,20480,4,6088847307
15367,389889410,133664274,523553684,4,0,0,101376,2,2843406704
15368,389890931,133314973,523205904,2,0,0,87552,4,8660596700
15369,389899400,133879757,523779157,9,0,0,115200,17,8463045210
15370,389907540,133769129,523676669,7,0,0,164864,16,3279536905
15371,389914750,133711533,523626283,4,0,0,138240,2,1829019350
15372,389926070,133065889,522991959,1,0,0,4608,5,1300983332
15373,389978780,133357187,523335967,1,0,0,12288,5,1118969781
15374,389980610,133574734,523555344,6,0,0,4096,7,4024543418
15375,389989240,133533533,523522773,0,0,0,77312,10,126234427
15376,389989960,133594180,523584140,7,0,0,94208,16,8711526524
15377,389994920,133223978,523218898,6,0,0,1536,7,4265731604
15378,390007769,133733710,523741479,5,0,0,210432,11,6265668313
15379,390008981,133925086,523934067,2,0,0,82432,4,10115271487
15380,390078929,133976284,524055213,5,0,0,196608,11,360965343
15381,390083720,133659488,523743208,6,0,0,2048,7,7412527553
15382,390087480,133699048,523786528,4,0,0,24064,2,2728979347
15383,390115250,133627288,523742538,6,0,0,3072,7,478800381
15384,390130550,134294239,524424789,9,0,0,283136,17,9474495755
15385,390138970,134116121,524255091,9,0,0,296960,17,4054505379
15386,390164340,133512984,523677324,6,0,0,2048,7,7570038502
15387,390168910,133693831,523862741,7,0,0,7168,16,1299819780
15388,390194329,173452073,563646402,4,0,1,14336,2,2555830202
15389,390230170,133513864,523744034,6,0,0,2560,7,7473009204
15390,390230819,134708176,524938995,8,0,0,603136,2,7195403482
15391,390237420,173409005,563646425,2,0,1,7680,4,3086758570
15392,390252269,173394179,563646448,0,0,1,10752,10,3193182993
15393,390252329,134466968,524719297,5,0,0,51712,11,4395457993
15394,390255350,133592414,523847764,4,0,0,40448,2,2381244792
15395,390270671,134007733,524278404,2,0,0,4608,4,9601133697
15396,390297070,134199346,524496416,4,0,0,235008,2,7370260127
15397,390326550,133742761,524069311,6,0,0,1024,7,7711608608
15398,390338920,134619892,524958812,0,0,0,62976,10,1406238746
15399,390348951,134186363,524535314,2,0,0,62464,4,9556086424
15400,390366039,173280432,563646471,0,0,1,2048,10,7878490283
15401,390370509,133906468,524276977,5,0,0,70144,11,7758644857
15402,390371669,133786851,524158520,8,0,0,6144,2,8305480335
15403,390402309,173253100,563655409,0,0,1,2560,10,719992490
15404,390447010,134069241,524516251,0,0,0,65024,10,5367259460
15405,390450429,173205003,563655432,4,0,1,3584,2,495565345
15406,390454669,133800913,524255582,8,0,0,1536,2,2026354134
15407,390458890,133603721,524062611,6,0,0,3584,7,1786971303
15408,390468400,134083983,524552383,1,0,0,4096,5,10208907551
15409,390475949,134734660,525210609,5,0,0,74240,11,22587468
15410,390555740,134567035,525122775,7,0,0,302592,16,10512038865
15411,390566300,134373186,524939486,1,0,0,1536,5,7092280493
15412,390570219,173085236,563655455,4,0,1,14848,2,8685506887
15413,390582919,134096283,524679202,8,0,0,1536,2,4463760114
15414,390615320,133702283,524317603,6,0,0,2048,7,9733872166
15415,390645720,134613608,525259328,9,0,0,159744,17,9917091698
15416,390665159,133284094,523949253,8,0,0,5120,2,510093646
15417,390670899,173142712,563813611,0,0,1,43008,10,10180549656
15418,390677831,134510127,525187958,2,0,0,2048,4,7663411892
15419,390720849,134267805,524988654,5,0,0,81920,11,3749178001
15420,390725400,134443597,525168997,9,0,0,43520,17,10029452784
15421,390734780,134717198,525451978,9,0,0,208896,17,5755160038
15422,390760070,134755267,525515337,4,0,0,207872,2,4049728615
15423,390761249,134202422,524963671,5,0,0,15872,11,495648955
15424,390773440,134382274,525155714,9,0,0,108032,17,8120393247
15425,390804230,173009404,563813634,2,0,1,1536,4,8972842154
15426,390808530,133853751,524662281,4,0,0,82944,2,3080333946
15427,390809369,134215918,525025287,8,0,0,5632,2,8545785770
15428,390821420,172992237,563813657,2,0,1,3072,4,8283976729
15429,390864620,135036556,525901176,7,0,0,215552,16,1954728607
15430,390867589,173014450,563882039,0,0,1,55808,10,10046202322
15431,390883799,133741088,524624887,8,0,0,1024,2,4875215979
15432,390911020,134614526,525525546,4,0,0,32768,2,10342356069
15433,390919050,134268253,525187303,1,0,0,4096,5,7472177100
15434,390952170,134563346,525515516,9,0,0,512,17,6991001021
15435,390959570,172922500,563882070,2,0,1,22016,4,5752702090
15436,390985630,134639145,525624775,7,0,0,51712,16,1992402632
15437,390989549,134196475,525186024,8,0,0,55808,2,5393692599
15438,391006110,135130263,526136373,9,0,0,134144,17,7724584685
15439,391043029,135263171,526306200,5,0,0,20480,11,9110601760
15440,391053480,172828613,563882093,7,0,1,10240,16,3647707948
15441,391075740,172806376,563882116,7,0,1,2560,16,10683308653
15442,391079570,173153549,564233119,7,0,1,4608,16,6394420549
15443,391085599,173267526,564353125,0,0,1,20992,10,2314316201
15444,391101020,173252128,564353148,2,0,1,512,4,8046735044
15445,391118210,173824448,564942658,2,0,1,59392,4,5034964413
15446,391136040,173806641,564942681,7,0,1,14848,16,2753198388
15447,391153301,134674496,525827797,2,0,0,101888,4,444943003
15448,391174310,134114837,525289147,9,0,0,97792,17,6331459602
15449,391203369,135861833,527065202,5,0,0,960512,11,3563972743
15450,391237130,135829880,527067010,1,0,0,5120,5,63241287
15451,391240880,134913612,526154492,4,0,0,59392,2,8727532373
15452,391284489,134750773,526035262,8,0,0,216576,2,8899587284
15453,391291980,173669935,564961915,2,0,1,19968,4,3040800498
15454,391295459,173716180,565011639,0,0,1,3584,10,5021435613
15455,391299721,135000208,526299929,2,0,0,75776,4,8048652413
15456,391314660,134371894,525686554,6,0,0,3584,7,10373917820
15457,391324229,134581517,525905746,5,0,0,14848,11,4527166837
15458,391327190,134501722,525828912,1,0,0,3584,5,1988710413
15459,391352931,134921680,526274611,2,0,0,77824,4,7619047977
15460,391356790,173654880,565011670,7,0,1,44544,16,4343058203
15461,391408609,173603084,565011693,0,0,1,3584,10,3389458447
15462,391410040,134511330,525921370,4,0,0,4096,2,676581540
15463,391412150,173599566,565011716,7,0,1,7168,16,5437603987
15464,391414980,173596759,565011739,8,0,1,5120,2,9492748253
15465,391442499,173582668,565025167,4,0,1,35840,2,1499794871
15466,391445119,173595903,565041022,4,0,1,512,2,7455969664
15467,391482779,173607797,565090576,0,0,1,11264,10,4042442309
15468,391488010,173688576,565176586,8,0,1,12800,2,9655809482
15469,391489999,173686610,565176609,0,0,1,5632,10,5463280501
15470,391492090,135694398,527186488,4,0,0,391680,2,2616873270
15471,391502161,134748715,526250876,2,0,0,114688,4,8822462027
15472,391505820,134127714,525633534,9,0,0,28672,17,3352814464
15473,391512269,173664363,565176632,4,0,1,6656,2,8954869501
15474,391526720,134750098,526276818,9,0,0,7168,17,8878823645
15475,391527109,173649546,565176655,4,0,1,4608,2,705699385
15476,391539100,173637586,565176686,2,0,1,27648,4,4642030186
15477,391571630,173605079,565176709,7,0,1,23040,16,4801266055
15478,391585869,173625590,565211459,0,0,1,10752,10,9315332994
15479,391588851,134457510,526046361,2,0,0,36352,4,8579529005
15480,391591090,135649137,527240227,4,0,0,175616,2,10522968209
15481,391613490,173682127,565295617,5,0,1,11776,11,8702381730
15482,391618850,174850476,566469326,8,0,1,25088,2,3386857688
15483,391630729,174925800,566556529,4,0,1,53760,2,1625781891
15484,391635819,174920733,566556552,4,0,1,14848,2,1827603338
15485,391696671,136094286,527790957,2,0,0,500736,4,4988914160
15486,391709420,135561140,527270560,4,0,0,99328,2,2999990421
15487,391720709,136241362,527962071,8,0,0,468992,2,4605878644
15488,391748130,174808445,566556575,8,0,1,1536,2,6094499217
15489,391799960,174818075,566618035,7,0,1,55296,16,6715489361
15490,391803380,174825363,566628743,7,0,1,1024,16,1079851981
15491,391821790,174833573,566655363,7,0,1,17920,16,7764991973
15492,391834049,136240878,528074927,8,0,0,258560,2,3245849449
15493,391834059,135499860,527333919,5,0,0,207872,11,2698648451
15494,391846599,135515415,527362014,8,0,0,7168,2,1118273175
15495,391868360,135197021,527065381,1,0,0,512,5,7995926637
15496,391870820,136428635,528299455,4,0,0,107520,2,3947522146
15497,391877649,174778380,566656029,0,0,1,1024,10,8246405949
15498,391900869,174763115,566663984,4,0,1,7680,2,10199900275
15499,391910040,136199094,528109134,1,0,0,512,5,1900194852
15500,391918349,174889209,566807558,0,0,1,38912,10,8641048434
15501,391933580,136287232,528220812,9,0,0,159232,17,7862542120
15502,391936970,174870611,566807581,8,0,1,25600,2,5280478610
15503,391938630,174909097,566847727,5,0,1,38400,11,8983865536
15504,391948559,174899191,566847750,0,0,1,16384,10,4149441502
15505,391989650,174933494,566923144,2,0,1,28160,4,3544387269
15506,391999310,136432403,528431713,7,0,0,36352,16,484705322
15507,392000509,174942961,566943470,4,0,1,12800,2,1575120492
15508,392002350,135796118,527798468,7,0,0,24576,16,4237375957
15509,392029740,174913761,566943501,8,0,1,52736,2,4377798513
15510,392041269,174975473,567016742,4,0,1,27648,2,6265880801
15511,392073199,174943574,567016773,4,0,1,50688,2,4028122315
15512,392108300,135251499,527359799,7,0,0,83456,16,9349147881
15513,392129640,135204708,527334348,4,0,0,1024,2,2679457344
15514,392142699,135450902,527593601,5,0,0,56320,11,9340573912
15515,392144591,136891348,529035939,2,0,0,875520,4,6595219194
15516,392204669,174832617,567037286,4,0,1,77312,2,2437470082
15517,392233959,135989684,528223643,8,0,0,9216,2,5867153082
15518,392235650,135727130,527962780,6,0,0,2048,7,9913512879
15519,392246590,135837431,528084021,9,0,0,29184,17,4415916081
15520,392251100,174786209,567037309,7,0,1,35328,16,9996290823
15521,392265869,175282003,567547872,4,0,1,56320,2,8708962262
15522,392273030,135896728,528169758,4,0,0,128000,2,4628745906
15523,392300359,175247536,567547895,0,0,1,8704,10,10128520120
15524,392315280,136363882,528679162,4,0,0,190976,2,4109425226
15525,392325050,175236798,567561848,8,0,1,22016,2,7853614651
15526,392333530,175228341,567561871,7,0,1,6144,16,10254368998
15527,392365090,136112974,528478064,7,0,0,109056,16,4073860703
15528,392375259,175186659,567561918,4,0,1,33792,2,933294958
15529,392385960,175308667,567694627,5,0,1,49664,11,9658251259
15530,392406570,175288080,567694650,5,0,1,2048,11,3530280520
15531,392437589,136183362,528620951,5,0,0,161792,11,6458975200
15532,392440159,135358488,527798647,8,0,0,512,2,6350934327
15533,392463549,135640167,528103716,5,0,0,64512,11,5873042357
15534,392480560,135640106,528120666,6,0,0,3072,7,5876880162
15535,392490790,175215302,567706092,5,0,1,17408,11,1163778570
15536,392518990,175187125,567706115,2,0,1,9728,4,8124319404
15537,392541860,136000169,528542029,7,0,0,75776,16,1193815528
15538,392559589,135259540,527819129,8,0,0,512,2,5167912326
15539,392565120,136133253,528698373,7,0,0,62976,16,23734392
15540,392566500,175142226,567708726,2,0,1,19456,4,9667388187
15541,392589820,135229130,527818950,7,0,0,66560,16,1296466653
15542,392604799,175115610,567720409,4,0,1,12288,2,4814382987
15543,392616430,136541613,529158043,1,0,0,512,5,1965484074
15544,392629950,136527858,529157808,4,0,0,241152,2,4959970951
15545,392641350,135433756,528075106,6,0,0,512,7,567108122
15546,392646669,175162772,567809441,4,0,1,30720,2,4273007277
15547,392652730,175158299,567811029,7,0,1,15872,16,2326864788
15548,392662350,136408290,529070640,7,0,0,113664,16,6500856690
15549,392671920,175147808,567819728,7,0,1,13312,16,1838096752
15550,392748130,175143274,567891404,7,0,1,27648,16,7267527574
15551,392781980,136408112,529190092,9,0,0,104960,17,8383931228
15552,392790540,175121078,567911618,8,0,1,38400,2,624288447
15553,392801160,175111738,567912898,3,0,1,14336,3,285483907
15554,392820981,136664590,529485571,2,0,0,205312,4,7364160512
15555,392832170,175085327,567917497,3,0,1,3072,3,5458120773
15556,392836810,175140011,567976821,7,0,1,68608,16,7201244272
15557,392853380,136909327,529762707,7,0,0,261120,16,638527817
15558,392891160,175101036,567992196,2,0,1,30208,4,6700331860
15559,392924080,175092048,568016128,8,0,1,21504,2,6015559128
15560,392935950,135776806,528712756,7,0,0,47104,16,3608514625
15561,392959611,135770507,528730118,2,0,0,3072,4,2211386445
15562,393013770,175023627,568037397,7,0,1,2048,16,5136953835
15563,393017120,135712039,528729159,9,0,0,53760,17,4635744654
15564,393026760,136791045,529817805,9,0,0,47616,17,4180350978
15565,393107890,135976373,529084263,1,0,0,3584,5,4525854443
15566,393122640,174921222,568043862,2,0,1,30720,4,9959559317
15567,393137811,135945245,529083056,2,0,0,40448,4,2165934260
15568,393169870,174880851,568050721,3,0,1,5632,3,7101792685
15569,393174140,136248852,529422992,9,0,0,239616,17,6596410735
15570,393178741,136887111,530065852,2,0,0,320000,4,5564047077
15571,393179500,174872399,568051899,8,0,1,13824,2,9946859647
15572,393207020,136308214,529515234,9,0,0,97280,17,1282290407
15573,393213439,174840517,568053956,4,0,1,15872,2,3077928533
15574,393234011,136538079,529772090,2,0,0,30720,4,5684710206
15575,393269640,174790501,568060141,2,0,1,4608,4,7115681660
15576,393281769,136045775,529327544,8,0,0,2560,2,2903694610
15577,393285430,174775582,568061012,2,0,1,12288,4,5025563467
15578,393285680,175760124,569045804,7,0,1,27648,16,8749051119
15579,393304300,175742068,569046368,2,0,1,10752,4,9294281309
15580,393357181,136270036,529627217,2,0,0,5120,4,787304081
15581,393361150,135897894,529259044,6,0,0,5120,7,10030542012
15582,393396441,136771511,530167952,2,0,0,61952,4,4020759482
15583,393412809,136127104,529539913,5,0,0,80896,11,906349333
15584,393418560,175718870,569137430,8,0,1,38400,2,7205650763
15585,393442890,175705514,569148404,2,0,1,9728,4,9388434610
15586,393458750,135816375,529275125,6,0,0,11264,7,4703318913
15587,393465370,137002319,530467689,9,0,0,573440,17,3543569170
15588,393480429,175784709,569265138,4,0,1,15872,2,6429970096
15589,393481920,137014184,530496104,4,0,0,93184,2,5920878639
15590,393491500,175773677,569265177,2,0,1,1536,4,540244951
15591,393618040,175647168,569265208,7,0,1,7680,16,2633640209
15592,393623409,136271050,529894459,8,0,0,7168,2,5933693166
15593,393637749,175627482,569265231,4,0,1,12800,2,979362511
15594,393652480,175612774,569265254,2,0,1,24576,4,4798454564
15595,393668829,175596448,569265277,4,0,1,7168,2,10736835673
15596,393677740,175593979,569271719,3,0,1,24064,3,3677788100
15597,393686809,175584933,569271742,4,0,1,14848,2,4064622180
15598,393722510,136169742,529892252,7,0,0,22016,16,6913254231
15599,393772640,136112881,529885521,7,0,0,108544,16,9023088296
15600,393802540,136824315,530626855,4,0,0,429056,2,5620497289
15601,393804660,136303712,530108372,1,0,0,3072,5,1420567290
15602,393823590,175448175,569271765,8,0,1,1024,2,4343913666
15603,393887860,136027453,529915313,6,0,0,2560,7,8161342844
15604,393900920,175370868,569271788,2,0,1,6656,4,1388285695
15605,393916990,175372160,569289150,2,0,1,17408,4,251446604
15606,393946580,175342593,569289173,3,0,1,6144,3,9927800163
15607,393946799,136801875,530748674,5,0,0,139264,11,460293623
15608,393956419,175361850,569318269,4,0,1,28160,2,2026077235
15609,394000300,136068186,530068486,6,0,0,1536,7,1042113983
15610,394039459,175290857,569330316,4,0,1,2048,2,2166601295
15611,394081749,135987586,530069335,8,0,0,2560,2,3041997332
15612,394101520,135989271,530090791,6,0,0,2048,7,7533431804
15613,394108960,175225222,569334182,6,0,1,6144,7,1064588144
15614,394111140,136064791,530175931,7,0,0,26112,16,3852743519
15615,394122250,175214838,569337088,8,0,1,4608,2,4965735080
15616,394127400,135940572,530067972,9,0,0,6656,17,7929861234
15617,394144890,175195744,569340634,8,0,1,5632,2,5863716164
15618,394147920,175349460,569497380,3,0,1,17920,3,7038801948
15619,394185960,175311443,569497403,8,0,1,2560,2,6603360072
15620,394188699,136641077,530829776,8,0,0,1024,2,4534735903
15621,394277190,175220236,569497426,8,0,1,32768,2,1227266680
15622,394279880,175351596,569631476,3,0,1,12800,3,688628183
15623,394390459,135790358,530180817,8,0,0,512,2,1162733745
15624,394444509,176544439,570988948,0,0,1,32768,10,6869422618
15625,394444610,135769765,530214375,6,0,0,8704,7,7130960786
15626,394490321,136672275,531162596,2,0,0,299520,4,2012465866
15627,394520080,135744464,530264544,7,0,0,27136,16,4015268297
15628,394545080,176445630,570990710,6,0,1,4096,7,2699138125
15629,394586250,176489010,571075260,6,0,1,20992,7,9506287831
15630,394594500,136397042,530991542,9,0,0,293888,17,4999928435
15631,394598799,176476484,571075283,1,0,1,36864,5,388007668
15632,394604199,136097850,530702049,5,0,0,16384,11,10723323224
15633,394622720,176637797,571260517,3,0,1,11264,3,10159341461
15634,394627140,136166843,530793983,4,0,0,139776,2,10168705941
15635,394699219,176561321,571260540,4,0,1,31744,2,10397706661
15636,394734680,176525883,571260563,8,0,1,15872,2,1548502437
15637,394740009,176520577,571260586,0,0,1,6656,10,5508101674
15638,394745689,176635667,571381356,1,0,1,35840,5,1707584371
15639,394778581,135972791,530751372,2,0,0,8192,4,7929868732
15640,394878431,176502948,571381379,9,0,1,4608,17,10636070430
15641,394888019,176514399,571402418,4,0,1,1024,2,195258727
15642,394915790,136137863,531053653,7,0,0,203776,16,10224402666
15643,394931600,136237571,531169171,9,0,0,21504,17,6922437272
15644,394949339,176490246,571439585,1,0,1,24064,5,4013616887
15645,394962340,136544149,531506489,7,0,0,295936,16,2283502
15646,394972709,135776144,530748853,8,0,0,512,2,10528539359
15647,394980829,136081785,531062614,5,0,0,25088,11,9145765316
15648,394983320,176521707,571505027,3,0,1,17920,3,9972381386
15649,395007160,176576682,571583842,3,0,1,31232,3,9836038411
15650,395013300,176570888,571584188,3,0,1,512,3,8088114157
15651,395019150,136164419,531183569,4,0,0,47104,2,832524169
15652,395034881,176565680,571600561,9,0,1,31232,17,4432175379
15653,395043470,136322371,531365841,7,0,0,91136,16,6935857435
15654,395093630,176531118,571624748,8,0,1,19968,2,5725038568
15655,395130481,135940832,531071313,2,0,0,2560,4,10454172119
15656,395138659,176521505,571660164,0,0,1,14848,10,1685371543
15657,395146409,176904437,572050846,1,0,1,25088,5,8110101110
15658,395158979,177066105,572225084,0,0,1,9728,10,5162949015
15659,395165140,135889807,531054947,1,0,0,4096,5,6253611370
15660,395177780,136523818,531701598,7,0,0,508928,16,9072997073
15661,395184870,136231412,531416282,7,0,0,133632,16,1195259121
15662,395189019,135999025,531188044,8,0,0,2048,2,5822397286
15663,395237509,177008911,572246420,1,0,1,17920,5,2311120983
15664,395251669,177171534,572423203,0,0,1,8704,10,8367989243
15665,395261290,136108942,531370232,4,0,0,14336,2,1172955052
15666,395263289,177159937,572423226,1,0,1,2560,5,6012898753
15667,395266550,177244852,572511402,6,0,1,35328,7,10667376362
15668,395292550,136030318,531322868,6,0,0,4608,7,1916280538
15669,395300460,135993966,531294426,9,0,0,48640,17,4422054173
15670,395309849,136236662,531546511,5,0,0,58880,11,8873742752
15671,395322830,136447532,531770362,9,0,0,61440,17,4206283799
15672,395340769,177172103,572512872,0,0,1,1536,10,3647712538
15673,395348400,136363860,531712260,7,0,0,30720,16,641941053
15674,395350419,177214842,572565261,1,0,1,20992,5,361564510
15675,395352970,136154010,531506980,6,0,0,1536,7,7062073393
15676,395354640,136156777,531511417,4,0,0,14336,2,9880258356
15677,395356281,136707473,532063754,2,0,0,203264,4,3038329446
15678,395362829,177213552,572576381,1,0,1,14336,5,8139250507
15679,395368641,177239898,572608539,9,0,1,45568,17,43289331
15680,395398021,136353574,531751595,2,0,0,129024,4,10734550186
15681,395404350,136298527,531702877,1,0,0,4096,5,5307768838
15682,395409159,136834490,532243649,5,0,0,398336,11,792681254
15683,395426580,177181982,572608562,8,0,1,512,2,8374378267
15684,395436440,136494612,531931052,7,0,0,155136,16,7701324331
15685,395439289,177219804,572659093,1,0,1,22528,5,10201417113
15686,395458560,136613976,532072536,4,0,0,28672,2,10529818228
15687,395461471,177197645,572659116,9,0,1,35328,17,2515426261
15688,395498229,177162328,572660557,0,0,1,10752,10,9046618838
15689,395513311,136468551,531981862,2,0,0,6656,4,6548180304
15690,395536559,136536780,532073339,8,0,0,2560,2,8081506745
15691,395539149,177509091,573048240,1,0,1,84992,5,55994340
15692,395566479,136696877,532263356,5,0,0,44032,11,3149489932
15693,395580791,136797597,532378388,2,0,0,54784,4,3531523879
15694,395589479,136713165,532302644,8,0,0,128512,2,2917987424
15695,395600730,177661078,573261808,8,0,1,36864,2,5270769730
15696,395609079,177874714,573483793,0,0,1,64512,10,6821617805
15697,395625899,177857917,573483816,1,0,1,27648,5,1819891228
15698,395636150,177847689,573483839,8,0,1,3584,2,731276307
15699,395654240,136593332,532247572,7,0,0,12800,16,5643590396
15700,395669010,136580393,532249403,1,0,0,5632,5,4184026781
15701,395678480,136769640,532448120,4,0,0,21504,2,9359551528
15702,395696130,136377723,532073853,1,0,0,1536,5,8829806458
15703,395700850,177783012,573483862,3,0,1,24064,3,7369413890
15704,395701910,136548007,532249917,1,0,0,1536,5,8494368015
15705,395756059,177811988,573568047,1,0,1,41472,5,1603031628
15706,395791679,177776391,573568070,0,0,1,4608,10,5730325905
15707,395793049,136834402,532627451,8,0,0,100864,2,5356402081
15708,395797230,177770863,573568093,3,0,1,8192,3,8690667105
15709,395800560,136750316,532550876,4,0,0,38912,2,3975959271
15710,395814870,136736809,532551679,1,0,0,2560,5,815546495
15711,395830350,177920005,573750355,3,0,1,74752,3,9535352211
15712,395845720,136970902,532816622,4,0,0,199168,2,3221157815
15713,395848349,136747856,532596205,8,0,0,111104,2,7689289662
15714,395853379,177897031,573750410,1,0,1,49152,5,3670038470
15715,395873901,177876532,573750433,9,0,1,13824,17,2252188644
15716,395879591,177870865,573750456,9,0,1,5120,17,7860909848
15717,395896270,177879348,573775618,3,0,1,28160,3,8699663033
15718,395898720,136729238,532627958,6,0,0,1536,7,3277131314
15719,395905360,177913056,573818416,8,0,1,60928,2,5736749706
15720,395912991,137219963,533132954,2,0,0,100864,4,8937521200
15721,395913130,177905309,573818439,3,0,1,2560,3,1460047196
15722,395919399,177899063,573818462,0,0,1,7680,10,9789356624
15723,395930199,177888286,573818485,1,0,1,1024,5,4921467008
15724,395994480,137280644,533275124,7,0,0,119296,16,639093873
15725,396006820,136732923,532739743,1,0,0,1536,5,8189477793
15726,396007210,177877193,573884403,3,0,1,8704,3,8328401398
15727,396073459,137165286,533238745,8,0,0,347136,2,8944284290
15728,396075459,177808967,573884426,1,0,1,19968,5,10006835280
15729,396080719,177803762,573884481,1,0,1,47616,5,372863077
15730,396081939,177802565,573884504,1,0,1,23040,5,1850493915
15731,396082871,137013711,533096582,2,0,0,41984,4,10240071716
15732,396083450,177804273,573887723,8,0,1,26112,2,3508915389
15733,396089500,177801769,573891269,6,0,1,5632,7,8120330275
15734,396106900,177786315,573893215,3,0,1,3072,3,2587630667
15735,396113859,177780944,573894803,0,0,1,15872,10,5465382928
15736,396143430,136453266,532596696,1,0,0,1536,5,3032396639
15737,396178801,137393640,533572441,2,0,0,511488,4,9929138605
15738,396196179,137103335,533299514,5,0,0,41984,11,339494716
15739,396213139,137073552,533286691,8,0,0,37888,2,2885872398
15740,396225670,177680294,573905964,3,0,1,7680,3,5645415204
15741,396231801,137184773,533416574,2,0,0,110592,4,613372118
15742,396233770,177802672,574036442,3,0,1,9216,3,7533797045
15743,396237889,177798584,574036473,1,0,1,26624,5,8686306990
15744,396254671,177781825,574036496,9,0,1,2048,17,8746423333
15745,396264770,177822628,574087398,8,0,1,59392,2,8914986513
15746,396265539,137454826,533720365,5,0,0,373760,11,7180872360
15747,396285790,137287306,533573096,6,0,0,2048,7,8544142207
15748,396287160,177800261,574087421,3,0,1,3584,3,378162512
15749,396291420,177796040,574087460,6,0,1,15360,7,6321049692
15750,396303999,137454695,533758694,5,0,0,125440,11,5435488291
15751,396304380,137302036,533606416,4,0,0,109056,2,6792844466
15752,396316100,177807228,574123328,8,0,1,34304,2,1260510955
15753,396339879,136967614,533307493,8,0,0,26112,2,1284924392
15754,396408620,137460555,533869175,4,0,0,119296,2,3359294296
15755,396411640,177711711,574123351,8,0,1,12800,2,2084255338
15756,396422119,137410685,533832804,5,0,0,144896,11,7850473988
15757,396422880,137625210,534048090,7,0,0,54272,16,1408694834
15758,396454200,177686997,574141197,8,0,1,20992,2,2225879939
15759,396457499,177701812,574159311,1,0,1,13824,5,1735237444
15760,396482831,177783023,574265854,9,0,1,62976,17,10521363498
15761,396492530,137266834,533759364,6,0,0,2048,7,5915875984
15762,396534319,137254314,533788633,5,0,0,60928,11,1564825322
15763,396550060,137219963,533770023,1,0,0,512,5,4692936825
15764,396553850,177712027,574265877,3,0,1,12800,3,6703235409
15765,396592480,137293817,533886297,1,0,0,5632,5,647852054
15766,396592501,137177320,533769821,2,0,0,33792,4,2019396224
15767,396606570,177713665,574320235,3,0,1,12288,3,2282067052
15768,396643251,177719306,574362557,9,0,1,12288,17,4497156077
15769,396683630,177678950,574362580,6,0,1,3072,7,981973999
15770,396689541,177827786,574517327,9,0,1,57856,17,531055649
15771,396696190,137963771,534659961,7,0,0,206848,16,2416370120
15772,396700021,177825812,574525833,9,0,1,14848,17,4285421895
15773,396716220,137880694,534596914,7,0,0,502272,16,2174856029
15774,396726561,177923277,574649838,9,0,1,18432,17,7933659584
15775,396783860,178114570,574898430,6,0,1,77312,7,1472191352
15776,396794009,137267356,534061365,5,0,0,18432,11,7856366687
15777,396796229,137559386,534355615,5,0,0,121856,11,4023494220
15778,396797969,137320702,534118671,5,0,0,79360,11,3191500784
15779,396819660,178093184,574912844,3,0,1,16384,3,146431470
15780,396836279,138337750,535174029,5,0,0,258560,11,4599578101
15781,396851460,178099699,574951159,6,0,1,6656,7,6422174674
15782,396859000,137832652,534691652,4,0,0,103936,2,8885085298
15783,396864630,138100385,534965015,4,0,0,88064,2,7346076163
15784,396874190,137300360,534174550,6,0,0,512,7,7078676007
15785,396886860,178214298,575101158,8,0,1,8704,2,1559672945
15786,396886929,138051231,534938160,5,0,0,387584,11,6851278375
15787,396916020,178229289,575145309,6,0,1,47104,7,8705016347
15788,396916449,137859691,534776140,5,0,0,211456,11,10613966105
15789,396918571,137793118,534711689,2,0,0,65536,4,10116836410
15790,396922719,178298873,575221592,1,0,1,25088,5,4857473670
15791,396975370,178247208,575222578,2,0,1,1536,4,4579680620
15792,396978220,178249184,575227404,2,0,1,7680,4,4655670700
15793,396986850,178353320,575340170,3,0,1,35328,3,7894219203
15794,397147330,138236678,535384008,7,0,0,427008,16,3762986893
15795,397164300,137253235,534417535,7,0,0,27648,16,2563620708
15796,397237341,137736635,534973976,2,0,0,29184,4,8786736700
15797,397240090,178100103,575340193,3,0,1,15360,3,10079923785
15798,397280499,137509797,534790296,8,0,0,40960,2,2875327671
15799,397290889,137710914,535001803,5,0,0,18944,11,10621326151
15800,397339539,178000677,575340216,1,0,1,4608,5,903290372
15801,397350490,137671888,535022378,1,0,0,3584,5,6197090046
15802,397351201,138148761,535499962,2,0,0,247296,4,567674997
15803,397358999,177981240,575340239,1,0,1,3584,5,9697379936
15804,397371449,177977260,575348709,1,0,1,23040,5,7169956533
15805,397371990,177982725,575354715,3,0,1,23040,3,9000472179
15806,397377100,177982852,575359952,6,0,1,9216,7,7220211755
15807,397457180,137320613,534777793,6,0,0,5120,7,6007046647
15808,397460619,138409309,535869928,8,0,0,524288,2,3612801558
15809,397465590,138083517,535549107,7,0,0,69632,16,5748943480
15810,397486290,177909189,575395479,2,0,1,53760,4,5787921950
15811,397496760,178100166,575596926,6,0,1,47616,7,8409597888
15812,397536520,137664679,535201199,6,0,0,2560,7,2399485145
15813,397539950,178056999,575596949,8,0,1,6656,2,6727666032
15814,397543970,137880621,535424591,7,0,0,133120,16,7453734326
15815,397546970,138324523,535871493,1,0,0,1024,5,1748943244
15816,397555260,178156551,575711811,2,0,1,49152,4,9514751451
15817,397557720,178184557,575742277,3,0,1,28672,3,2120478457
15818,397565319,139024777,536590096,5,0,0,375808,11,6904045829
15819,397586360,139112716,536699076,7,0,0,275968,16,3661194445
15820,397604960,178138939,575743899,8,0,1,7168,2,7162583498
15821,397653519,138036179,535689698,8,0,0,117760,2,5166156771
15822,397658540,178112549,575771089,6,0,1,65024,7,3652909065
15823,397687770,178083342,575771112,2,0,1,6144,4,5613080006
15824,397702130,138175656,535877786,4,0,0,4096,2,839681061
15825,397702550,178097780,575800330,8,0,1,31744,2,3878971345
15826,397713320,138521449,536234769,4,0,0,68608,2,3223492107
15827,397745540,137889894,535635434,6,0,0,6656,7,8455083899
15828,397772920,138098169,535871089,6,0,0,3584,7,4971213912
15829,397783420,137912020,535695440,4,0,0,6656,2,7286993197
15830,397798750,138676819,536475569,7,0,0,290816,16,8878027978
15831,397853590,177953026,575806616,6,0,1,32256,7,5801793767
15832,397861451,138331325,536192776,2,0,0,119808,4,6825723057
15833,397875799,177930840,575806639,1,0,1,10752,5,10624003677
15834,397887619,139010174,536897793,5,0,0,474112,11,2668234068
15835,397910820,138841795,536752615,7,0,0,175616,16,9318749372
15836,397932611,138682335,536614946,2,0,0,63488,4,7369800075
15837,397939280,138410504,536349784,7,0,0,37888,16,1773290294
15838,397952591,138261112,536213703,2,0,0,68608,4,2472504380
15839,397959950,177846712,575806662,2,0,1,3584,4,9485124385
15840,397963280,177843453,575806733,2,0,1,68608,4,1498432731
15841,397972220,177834536,575806756,6,0,1,11776,7,10719508993
15842,398030700,177806896,575837596,2,0,1,9216,4,8739097305
15843,398035260,177833357,575868617,3,0,1,31744,3,9440166009
15844,398062479,139168851,537231330,5,0,0,6144,11,3261435554
15845,398080811,138514768,536595579,2,0,0,17920,4,1325503806
15846,398083040,177924635,576007675,3,0,1,38400,3,2948141625
15847,398104270,138648680,536752950,6,0,0,1024,7,3777782311
15848,398114831,139055725,537170556,2,0,0,417792,4,3835807020
15849,398118690,138844714,536963404,6,0,0,512,7,896431768
15850,398132540,177875596,576008136,3,0,1,10240,3,2198318489
15851,398134500,138802072,536936572,4,0,0,117760,2,945020454
15852,398135180,139276480,537411660,4,0,0,32256,2,5980961633
15853,398136680,177970485,576107165,3,0,1,20480,3,5802943777
15854,398138120,177969068,576107188,3,0,1,9728,3,4457221380
15855,398179770,138720790,536900560,1,0,0,8704,5,7139167816
15856,398216950,138536202,536753152,6,0,0,512,7,2731188170
15857,398239929,177867282,576107211,1,0,1,12800,5,3441972924
15858,398250519,139539957,537790476,5,0,0,189440,11,8677182882
15859,398264441,139378705,537643146,2,0,0,387584,4,729192645
15860,398310439,178370381,576680820,1,0,1,33792,5,7861416556
15861,398322790,178752873,577075663,3,0,1,22528,3,9828203781
15862,398346219,178758558,577104777,0,0,1,11264,10,4581749922
15863,398457679,178660759,577118438,1,0,1,2560,5,5924850907
15864,398479880,178739762,577219642,6,0,1,25600,7,6091613046
15865,398480480,138490979,536971459,6,0,0,1536,7,3085446389
15866,398495340,179192457,577687797,6,0,1,59392,7,9353027222
15867,398524830,179162990,577687820,6,0,1,10240,7,1841213320
15868,398530140,138641843,537171983,1,0,0,4608,5,971593676
15869,398551670,138427808,536979478,6,0,0,2560,7,4758458821
15870,398554150,138618636,537172786,6,0,0,2560,7,7346855571
15871,398587850,138408333,536996183,1,0,0,3584,5,10303362388
15872,398595660,179324669,577920329,3,0,1,62976,3,133088010
15873,398597980,179322372,577920352,3,0,1,30208,3,3840574617
15874,398619239,139453879,538073118,5,0,0,480768,11,5602683609
15875,398627400,138649139,537276539,6,0,0,2560,7,3654887939
15876,398629899,138563306,537193205,5,0,0,18944,11,8171997260
15877,398678930,179241445,577920375,3,0,1,1024,3,3952691267
15878,398710710,179209688,577920398,2,0,1,7680,4,3763271975
15879,398723059,139828284,538551343,8,0,0,749568,2,6366487671
15880,398726440,138612522,537338962,1,0,0,512,5,3149723599
15881,398736830,179183591,577920421,6,0,1,30208,7,7362182477
15882,398777981,140078020,538856001,2,0,0,505344,4,10369932347
15883,398824510,138651860,537476370,1,0,0,1536,5,7832786856
15884,398853890,139816550,538670440,7,0,0,190976,16,1478046112
15885,398877770,139252490,538130260,4,0,0,185344,2,3139037230
15886,398928720,178991724,577920444,3,0,1,15360,3,5799297474
15887,398938881,139994032,538932913,2,0,0,208896,4,5189974701
15888,398963170,178957297,577920467,3,0,1,3584,3,3930216950
15889,398983060,178995196,577978256,7,0,1,20480,16,10092154470
15890,398983459,139155248,538138707,5,0,0,27648,11,6551136146
15891,398993810,139079955,538073765,1,0,0,2048,5,9435694016
15892,398995700,139143342,538139042,6,0,0,1024,7,636136983
15893,399079500,139532729,538612229,4,0,0,198144,2,6295239234
15894,399080470,178897809,577978279,6,0,1,24064,7,3487576744
15895,399085530,139217121,538302651,6,0,0,1024,7,9579711447
15896,399085760,139216556,538302316,4,0,0,100864,2,2390947207
15897,399111009,178867317,577978326,1,0,1,9728,5,4220341375
15898,399124249,139577734,538701983,5,0,0,103424,11,2416772429
15899,399151450,178846734,577998184,6,0,1,19456,7,1925805971
15900,399291320,139260514,538551834,6,0,0,1536,7,1270028957
15901,399316430,139836610,539153040,4,0,0,334336,2,9219042727
15902,399356859,139916398,539273257,5,0,0,342528,11,2922502
15903,399360020,139691129,539051149,7,0,0,200192,16,7437559555
15904,399403370,140421857,539825227,4,0,0,174592,2,5527017268
15905,399431771,140302081,539733852,2,0,0,97792,4,4063510611
15906,399508501,139905390,539413891,2,0,0,92160,4,3987205788
15907,399534449,140169584,539704033,5,0,0,475648,11,6047468828
15908,399552660,139389349,538942009,6,0,0,512,7,2746655513
15909,399617100,139657584,539274684,1,0,0,4608,5,3422956808
15910,399704710,139456245,539160955,6,0,0,1536,7,8174744159
15911,399725430,139439627,539165057,7,0,0,11264,16,8490471626
15912,399732081,139578396,539310477,2,0,0,103424,4,9446746020
15913,399754630,178243585,577998215,8,0,1,4608,2,8448011258
15914,399756691,139403727,539160418,2,0,0,24064,4,673111354
15915,399756970,139404632,539161602,1,0,0,2048,5,8137387601
15916,399800841,140259724,540060565,2,0,0,73728,4,10570160736
15917,399825020,139609954,539434974,7,0,0,69120,16,5307462287
15918,399842080,178164293,578006373,6,0,1,16896,7,7315002965
15919,399862409,139696677,539559086,8,0,0,56832,2,5525706277
15920,399877780,139401162,539278942,7,0,0,13824,16,5278198622
15921,399882779,139949959,539832738,5,0,0,24576,11,6155706774
15922,399885210,139849468,539734678,1,0,0,1024,5,7235807115
15923,399901980,140075090,539977070,7,0,0,115712,16,5988815998
15924,399902470,178103926,578006396,8,0,1,49664,2,9603842245
15925,399919860,178086559,578006419,6,0,1,1536,7,8820344200
15926,399925030,139911007,539836037,1,0,0,10752,5,1090457609
15927,399929700,178158096,578087796,8,0,1,211456,2,10060149520
15928,399939620,178148199,578087819,6,0,1,32256,7,3246308036
15929,399943339,141019926,540963265,5,0,0,499200,11,10670064632
15930,399956519,140423461,540379980,8,0,0,19456,2,1676646914
15931,399968660,178119182,578087842,6,0,1,16384,7,9582737408
15932,400016260,178071605,578087865,8,0,1,2560,2,1140131644
15933,400021351,141229816,541251167,2,0,0,91136,4,4756515646
15934,400031250,140763842,540795092,4,0,0,1013248,2,6509203047
15935,400038940,178048948,578087888,3,0,1,5120,3,10383898841
15936,400053450,140742670,540796120,1,0,0,3072,5,1295773204
15937,400061930,139966569,540028499,1,0,0,3072,5,9430528064
15938,400079840,140924008,541003848,4,0,0,133120,2,4139721312
15939,400121299,140689843,540811142,5,0,0,49152,11,1630849547
15940,400123130,140363215,540486345,7,0,0,265216,16,6111375785
15941,400135210,139599133,539734343,6,0,0,1536,7,6381520350
15942,400157840,177930071,578087911,8,0,1,19968,2,7722258248
15943,400162940,177925002,578087942,8,0,1,4608,2,7528361845
15944,400221450,139710055,539931505,1,0,0,4608,5,4323712872
15945,400223830,140050381,540274211,1,0,0,1024,5,1003639251
15946,400231650,140967960,541199610,4,0,0,457216,2,10551718799
15947,400239060,141086420,541325480,6,0,0,2560,7,9327410584
15948,400250750,177837255,578088005,8,0,1,63488,2,7547447551
15949,400300350,177797841,578098191,3,0,1,37376,3,5585223527
15950,400324810,140999752,541324562,4,0,0,240128,2,2529399065
15951,400333110,140028810,540361920,6,0,0,512,7,9656676666
15952,400404600,177693614,578098214,3,0,1,8192,3,6950216859
15953,400477910,177620327,578098237,8,0,1,12288,2,5751750920
15954,400483821,140576435,541060256,2,0,0,113152,4,7785688728
15955,400502971,140522786,541025757,2,0,0,71680,4,6807710948
15956,400560180,177538080,578098260,3,0,1,6144,3,200617501
15957,400565800,177532483,578098283,8,0,1,7168,2,4651887302
15958,400659070,140564275,541223345,4,0,0,77824,2,7261223895
15959,400659710,177438612,578098322,3,0,1,50688,3,843228422
15960,400663400,177434977,578098377,8,0,1,7168,2,2707285365
15961,400675700,177432251,578107951,8,0,1,40960,2,3031218863
15962,400683551,140773840,541457391,2,0,0,287232,4,7935040674
15963,400721790,140746839,541468629,4,0,0,36352,2,221828965
15964,400734899,140634829,541369728,5,0,0,122368,11,3945223030
15965,400740790,140845008,541585798,1,0,0,1024,5,1415641652
15966,400751500,140771798,541523298,7,0,0,179200,16,7495796988
15967,400800090,177313673,578113763,8,0,1,9216,2,1204848433
15968,400810509,140521912,541332421,8,0,0,22528,2,7203947615
15969,400834489,140750974,541585463,5,0,0,203776,11,146700419
15970,400861209,177264831,578126040,0,0,1,27648,10,8205533390
15971,400872549,140716336,541588885,5,0,0,9728,11,2333803181
15972,400904900,177221499,578126399,6,0,1,9728,7,10124165090
15973,400910550,177267098,578177648,8,0,1,28672,2,2165420396
15974,400919829,140768355,541688184,8,0,0,59392,2,8008373286
15975,400997990,177204421,578202411,8,0,1,24576,2,517663428
15976,401013701,140753157,541766858,2,0,0,67072,4,286193234
15977,401019469,141231185,542250654,5,0,0,12288,11,868896305
15978,401020399,141179760,542200159,8,0,0,11776,2,4846941012
15979,401038380,178535400,579573780,6,0,1,1024,7,6785431208
15980,401083160,141566508,542649668,7,0,0,83968,16,6244356361
15981,401143470,140714408,541857878,9,0,0,10752,17,6751435991
15982,401175539,140679032,541854571,8,0,0,75776,2,9903243122
15983,401190030,178388576,579578606,6,0,1,7680,7,4900493329
15984,401205780,179192057,580397837,8,0,1,79872,2,991916235
15985,401212109,179212926,580425035,4,0,1,38400,2,5351536193
15986,401260139,140660085,541920224,5,0,0,75264,11,5490921545
15987,401262731,140856231,542118962,2,0,0,161792,4,8741814531
15988,401428809,140750548,542179357,8,0,0,198144,2,10059174271
15989,401446150,179032751,580478901,8,0,1,24064,2,9500502504
15990,401464860,141932544,543397404,7,0,0,209920,16,4086250140
15991,401485360,140970922,542456282,9,0,0,204800,17,7783344959
15992,401499550,140331910,541831460,9,0,0,79360,17,6944210271
15993,401527911,141728247,543256158,2,0,0,296960,4,477249426
15994,401563270,140302130,541865400,6,0,0,3584,7,8518712957
15995,401674969,140636038,542311007,8,0,0,151552,2,6117456550
15996,401676490,178802434,580478924,5,0,1,12288,11,285648890
15997,401687860,140853688,542541548,7,0,0,15872,16,3439828669
15998,401695830,178783117,580478947,8,0,1,19968,2,9678847808
15999,401697040,178781930,580478970,8,0,1,3584,2,4061725832
16000,401698460,140498080,542196540,4,0,0,56320,2,585955147
16001,401705489,141091800,542797289,5,0,0,125952,11,364563187
16002,401712611,141189387,542901998,2,0,0,226816,4,3983215276
16003,401724649,140750376,542475025,5,0,0,61440,11,5710417865
16004,401742630,141549899,543292529,4,0,0,119296,2,3390467829
16005,401746710,178732283,580478993,7,0,1,5632,16,5034992928
16006,401761580,141274348,543035928,4,0,0,114688,2,2200414678
16007,401766740,141745994,543512734,4,0,0,179200,2,10315379756
16008,401796100,140725300,542521400,6,0,0,6144,7,10091271464
16009,401797300,178681716,580479016,7,0,1,28160,16,3681768036
16010,401799310,140080226,541879536,1,0,0,4608,5,3694331021
16011,401858189,141666268,543524457,5,0,0,38400,11,2825625954
16012,401920109,140326770,542246879,5,0,0,102400,11,4594317729
16013,401920200,141200303,543120503,9,0,0,277504,17,1391984783
16014,401925920,178553119,580479039,8,0,1,7680,2,7967561218
16015,401944139,141513972,543458111,5,0,0,199168,11,7960232000
16016,401945190,140534561,542479751,9,0,0,14848,17,8818185954
16017,401974510,140500694,542475204,1,0,0,512,5,7770786531
16018,401978820,178608903,580587723,8,0,1,33792,2,3695225733
16019,402004510,141688668,543693178,7,0,0,324608,16,3521994636
16020,402189939,178397807,580587746,0,0,1,20992,10,6822484673
16021,402226139,140104391,542330530,5,0,0,64000,11,4349205779
16022,402252470,140869928,543122398,6,0,0,6144,7,8600772743
16023,402259859,141544910,543804769,8,0,0,267776,2,3635976351
16024,402324740,140969528,543294268,9,0,0,5632,17,4676511425
16025,402342939,178244862,580587801,4,0,1,50176,2,4046913818
16026,402344210,178243622,580587832,8,0,1,30720,2,8494548961
16027,402353220,178234635,580587855,7,0,1,4608,16,7632818145
16028,402356640,141237580,543594220,7,0,0,228864,16,996915491
16029,402375109,140248952,542624061,5,0,0,41984,11,4238006720
16030,402377750,140748486,543126236,1,0,0,512,5,5781210666
16031,402387570,178533746,580921316,7,0,1,69632,16,7269430191
16032,402406360,141506638,543912998,9,0,0,222720,17,940439651
16033,402416299,141411581,543827880,8,0,0,75776,2,10182769421
16034,402424990,178496349,580921339,7,0,1,9216,16,6048899806
16035,402433219,178613047,581046266,0,0,1,7680,10,208800456
16036,402450139,178596150,581046289,0,0,1,19968,10,10114417914
16037,402456420,178713334,581169754,7,0,1,47104,16,3237532170
16038,402459340,178710437,581169777,7,0,1,6144,16,55769580
16039,402470780,178699020,581169800,7,0,1,2048,16,1640442440
16040,402510090,141468178,543978268,7,0,0,178176,16,7116278779
16041,402514520,141208523,543723043,7,0,0,97792,16,1870071683
16042,402526699,178740663,581267362,1,0,1,48640,5,10369719237
16043,402528249,141499706,544027955,5,0,0,55808,11,56032322
16044,402528730,178738655,581267385,8,0,1,2560,2,4576903632
16045,402621160,178646248,581267408,8,0,1,3584,2,1448800606
16046,402662260,140460317,543122577,6,0,0,512,7,7675305594
16047,402669959,141584562,544254521,8,0,0,82432,2,8269985851
16048,402689459,178675073,581364532,0,0,1,9728,10,10510371680
16049,402695070,178669485,581364555,7,0,1,11264,16,10619702737
16050,402715380,141129619,543844999,4,0,0,55808,2,6716352272
16051,402745569,178619009,581364578,0,0,1,27648,10,9848553528
16052,402755259,141168698,543923957,8,0,0,35840,2,9209085489
16053,402772570,141206189,543978759,1,0,0,1536,5,7685858467
16054,402788250,141311165,544099415,4,0,0,129024,2,8786610497
16055,402830371,178534230,581364601,9,0,1,10240,17,7491735946
16056,402933930,141478373,544412303,9,0,0,49664,17,8721696883
16057,402936010,141520893,544456903,6,0,0,3072,7,1567446234
16058,402946849,141168345,544115194,8,0,0,51712,2,6493279784
16059,402949489,141056518,544006007,8,0,0,59392,2,8401423226
16060,402971960,178410066,581382026,8,0,1,47616,2,8928701012
16061,402984079,142177710,545161789,5,0,0,836096,11,8566830733
16062,402995370,141760085,544755455,1,0,0,4096,5,8146888091
16063,403005539,178376534,581382073,0,0,1,49664,10,20716061
16064,403012149,141603308,544615457,5,0,0,95232,11,1195780433
16065,403041549,141655375,544696924,8,0,0,28160,2,5862865496
16066,403064970,141351703,544416673,6,0,0,13312,7,8938184219
16067,403073980,142290279,545364259,4,0,0,5120,2,9548128846
16068,403077500,141579474,544656974,7,0,0,44032,16,7402216825
16069,403096020,140890153,543986173,6,0,0,512,7,8517720097
16070,403103960,142261882,545365842,7,0,0,5120,16,9036759239
16071,403171299,141273065,544444364,5,0,0,78336,11,4004083456
16072,403180319,178201777,581382096,0,0,1,13312,10,3147818862
16073,403237760,178144359,581382119,7,0,1,512,16,9042161697
16074,403262540,142008940,545271480,7,0,0,359936,16,9763531015
16075,403277329,178111232,581388561,0,0,1,6144,10,1602215232
16076,403281440,142071830,545353270,4,0,0,260608,2,5721214129
16077,403283170,142394493,545677663,7,0,0,155648,16,8399390676
16078,403348370,178061017,581409387,8,0,1,52224,2,10304921362
16079,403356630,142192626,545549256,7,0,0,49664,16,854096992
16080,403361060,142155813,545516873,9,0,0,495616,17,3969713136
16081,403373850,142177769,545551619,6,0,0,7680,7,7149528249
16082,403441330,177980295,581421625,8,0,1,45568,2,9549288575
16083,403516620,141837297,545353917,1,0,0,2048,5,4527730624
16084,403537760,141996272,545534032,1,0,0,4096,5,841478755
16085,403594339,141768337,545362676,5,0,0,28672,11,5706061558
16086,403603970,177826850,581430820,8,0,1,29696,2,9230374262
16087,403606309,142445140,546051449,5,0,0,524288,11,492722568
16088,403626370,141647473,545273843,1,0,0,7680,5,921545546
16089,403656740,177795018,581451758,8,0,1,20480,2,5219148305
16090,403722280,177756987,581479267,7,0,1,16384,16,1774005121
16091,403726809,141088977,544815786,8,0,0,1536,2,5684767982
16092,403749700,177755258,581504958,8,0,1,24064,2,10736184390
16093,403780350,142386163,546166513,9,0,0,307200,17,2523094911
16094,403797000,141733008,545530008,7,0,0,43008,16,7696890926
16095,403845809,141722364,545568173,5,0,0,4096,11,1207825312
16096,403903859,142169031,546072890,5,0,0,54784,11,8580136766
16097,403931860,142276180,546208040,7,0,0,136192,16,4479742377
16098,403933339,141927652,545860991,8,0,0,1536,2,4804442506
16099,403942230,141590469,545532699,6,0,0,8704,7,1646304221
16100,403963089,141667127,545630216,5,0,0,112128,11,10449662674
16101,403966540,142089635,546056175,9,0,0,13312,17,8368550920
16102,403975870,177635342,581611212,8,0,1,53248,2,5361290655
16103,404002290,142611089,546613379,7,0,0,409600,16,6623651780
16104,404007729,142229841,546237570,5,0,0,96768,11,4663216361
16105,404021529,177630169,581651698,0,0,1,18432,10,7150557539
16106,404052119,142803978,546856097,5,0,0,316416,11,9397099051
16107,404101070,142268973,546370043,4,0,0,180224,2,442585215
16108,404102069,177571216,581673285,0,0,1,1536,10,7290593290
16109,404136799,142104561,546241360,8,0,0,9728,2,7262049812
16110,404166599,177557896,581724495,0,0,1,38400,10,558449169
16111,404206600,177739905,581946505,8,0,1,142336,2,2403835630
16112,404240110,177706418,581946528,8,0,1,12800,2,10367352916
16113,404250899,177695652,581946551,0,0,1,4608,10,10300782627
16114,404260529,141791567,546052096,8,0,0,2048,2,3260191794
16115,404300000,142070846,546370846,4,0,0,2560,2,594288779
16116,404301330,142619295,546920625,6,0,0,78336,7,4350387438
16117,404380969,177565605,581946574,0,0,1,7680,10,7931501484
16118,404406750,142851938,547258688,9,0,0,147456,17,10621652808
16119,404443819,141827006,546270825,8,0,0,2048,2,1085265088
16120,404451490,142762231,547213721,4,0,0,181760,2,4473621126
16121,404468980,142179885,546648865,1,0,0,2048,5,8240662952
16122,404495470,142662848,547158318,9,0,0,116736,17,8818939590
16123,404506480,142253186,546759666,4,0,0,248832,2,5761512300
16124,404508910,177437687,581946597,8,0,1,2048,2,10491507448
16125,404521580,142601147,547122727,7,0,0,230400,16,9666133401
16126,404562680,141695536,546258216,4,0,0,18432,2,10587782957
16127,404565000,142298140,546863140,4,0,0,23040,2,1714859944
16128,404584600,177362020,581946620,8,0,1,31232,2,5561211745
16129,404595049,177469339,582064388,0,0,1,95744,10,6565711764
16130,404611310,142285424,546896734,7,0,0,102912,16,4728016519
16131,404649030,142790207,547439237,7,0,0,34304,16,7275862607
16132,404694790,142608694,547303484,6,0,0,99328,7,8174023480
16133,404733800,143308962,548042762,7,0,0,352768,16,3044500035
16134,404777640,143054674,547832314,7,0,0,123392,16,6791869828
16135,404825040,143087660,547912700,7,0,0,263680,16,3623117553
16136,404839490,141398883,546238373,1,0,0,2560,5,4804556551
16137,404847479,142888344,547735823,5,0,0,416768,11,5187194499
16138,404887450,143450368,548337818,4,0,0,401408,2,6749595607
16139,404915730,142866819,547782549,7,0,0,82944,16,6125740722
16140,404932130,142401173,547333303,9,0,0,97792,17,10271091953
16141,404937550,177196202,582133752,8,0,1,25600,2,4052643021
16142,404948530,143396822,548345352,9,0,0,24064,17,4634495266
16143,405000040,143079093,548079133,6,0,0,119296,7,10516748636
16144,405006740,142435581,547442321,1,0,0,4096,5,1108410514
16145,405017860,177116238,582134098,6,0,1,512,7,7719466081
16146,405061870,143115731,548177601,9,0,0,197632,17,7661444912
16147,405118640,143314262,548432902,9,0,0,194560,17,4209878953
16148,405150460,141714895,546865355,6,0,0,7168,7,223893866
16149,405187400,142549694,547737094,1,0,0,4096,5,1184651389
16150,405286390,143343281,548629671,7,0,0,229376,16,8825067750
16151,405297680,143543233,548840913,9,0,0,247808,17,8084719919
16152,405399659,142121494,547521153,5,0,0,44032,11,4147418084
16153,405427189,176710609,582137798,1,0,1,14336,5,8209464619
16154,405428160,176763537,582191697,6,0,1,46080,7,2249514258
16155,405436600,142301476,547738076,1,0,0,3072,5,10575097669
16156,405455950,176787783,582243733,6,0,1,64512,7,8204931388
16157,405477510,176793864,582271374,6,0,1,19456,7,10276530144
16158,405518960,176765239,582284199,8,0,1,14336,2,407521859
16159,405530470,142583514,548113984,1,0,0,4096,5,10313250169
16160,405564650,176736062,582300712,8,0,1,7680,2,7545574172
16161,405571230,176730455,582301685,6,0,1,12800,7,2950454944
16162,405609429,176700890,582310319,0,0,1,14336,10,3474154710
16163,405621599,176705512,582327111,0,0,1,11776,10,5689140015
16164,405692610,143361308,549053918,4,0,0,110592,2,2644876786
16165,405704460,143243332,548947792,7,0,0,177152,16,8320407348
16166,405704910,176622867,582327777,2,0,1,1024,4,2785831107
16167,405716590,176717771,582434361,8,0,1,72704,2,2872727569
16168,405748550,176685834,582434384,8,0,1,41984,2,8134499594
16169,405801859,176632548,582434407,0,0,1,27136,10,940265736
16170,405811149,176651072,582462221,0,0,1,15872,10,4958498402
16171,405839119,143432295,549271414,5,0,0,527360,11,6951857827
16172,405845240,141901730,547746970,1,0,0,4608,5,1453308186
16173,405862370,142776551,548638921,9,0,0,19968,17,7526615670
16174,405867560,142692200,548559760,7,0,0,224768,16,7333229264
16175,405894960,176567284,582462244,8,0,1,23040,2,9492654831
16176,405899390,142438607,548337997,1,0,0,512,5,6194147761
16177,405929829,142702985,548632814,5,0,0,10240,11,6321446858
16178,406034300,142411105,548445405,9,0,0,40960,17,146464363
16179,406058850,143358957,549417807,6,0,0,317952,7,9771642851
16180,406086890,143189071,549275961,6,0,0,14848,7,1942546281
16181,406140609,176321658,582462267,0,0,1,9728,10,4499515363
16182,406145640,142735735,548881375,4,0,0,29696,2,6679792855
16183,406181880,176280410,582462290,8,0,1,5632,2,2922432590
16184,406185379,176297717,582483096,0,0,1,56320,10,4046260987
16185,406188909,176348645,582537554,0,0,1,71168,10,9723039605
16186,406255450,142764749,549020199,7,0,0,237568,16,6072001169
16187,406265059,143363894,549628953,5,0,0,299008,11,6638355138
16188,406265380,143608814,549874194,7,0,0,385024,16,1644323010
16189,406271220,143485639,549756859,7,0,0,180224,16,133952559
16190,406285720,143787053,550072773,6,0,0,528384,7,6856406600
16191,406288769,176251348,582540117,0,0,1,3072,10,2375432059
16192,406330079,142542225,548872304,5,0,0,32768,11,4403504595
16193,406359960,176185303,582545263,6,0,1,8192,7,5564231070
16194,406374130,143946852,550320982,4,0,0,302592,2,1222982803
16195,406483860,176072848,582556708,8,0,1,35840,2,3697119451
16196,406488990,143739742,550228732,9,0,0,299520,17,3883487098
16197,406497430,143983191,550480621,6,0,0,440832,7,1155072338
16198,406500550,143634848,550135398,7,0,0,44032,16,6882897514
16199,406518669,143603111,550121780,5,0,0,160768,11,1344204276
16200,406569180,142849586,549418766,1,0,0,3072,5,3692742265
16201,406591419,176086302,582677721,0,0,1,79360,10,9155110228
16202,406616790,143988870,550605660,1,0,0,1024,5,8189299108
16203,406619380,142799588,549418968,1,0,0,512,5,2909012823
16204,406639500,176049325,582688825,6,0,1,9216,7,10198887375
16205,406659890,144127227,550787117,6,0,0,102912,7,886898911
16206,406689930,142939202,549629132,1,0,0,512,5,3482405755
16207,406720770,143625466,550346236,9,0,0,82432,17,627567798
16208,406768630,142765418,549534048,9,0,0,24064,17,8662382298
16209,406780800,175929555,582710355,6,0,1,29184,7,7003311893
16210,406814930,143307029,550121959,1,0,0,512,5,10611449288
16211,406817770,143787470,550605240,6,0,0,408576,7,9987263294
16212,406917430,175801552,582718982,6,0,1,7168,7,5499848745
16213,406923119,175797143,582720262,0,0,1,14336,10,10488091230
16214,407001060,143671243,550672303,9,0,0,218624,17,5392555328
16215,407026040,176078625,583104665,8,0,1,11264,2,6738260848
16216,407037170,176530990,583568160,6,0,1,94720,7,9026688070
16217,407058030,176690052,583748082,6,0,1,33792,7,1631445479
16218,407061900,143895312,550957212,7,0,0,330752,16,10018195905
16219,407075229,176672876,583748105,0,0,1,15360,10,10043335502
16220,407081910,143055539,550137449,1,0,0,6656,5,1714689755
16221,407127600,143571247,550698847,7,0,0,11776,16,1774373074
16222,407144159,176603969,583748128,0,0,1,5120,10,855784309
16223,407184340,176563811,583748151,6,0,1,36352,7,7289291821
16224,407227940,176520234,583748174,8,0,1,9216,2,5862793345
16225,407234110,143600633,550834743,9,0,0,150016,17,351189575
16226,407248500,143720123,550968623,6,0,0,37376,7,3436623794
16227,407271580,143906864,551178444,9,0,0,85504,17,4055395881
16228,407304159,143451579,550755738,5,0,0,126464,11,3858809857
16229,407309270,144169240,551478510,6,0,0,358400,7,10204067666
16230,407316600,143754654,551071254,6,0,0,294400,7,10683417888
16231,407339390,144226565,551565955,6,0,0,102912,7,6675969800
16232,407364860,176544554,583909414,6,0,1,44544,7,6693710615
16233,407422800,144203650,551626450,1,0,0,9728,5,6951348084
16234,407425110,143893672,551318782,9,0,0,177152,17,7202250937
16235,407427119,176536527,583963646,0,0,1,25600,10,6209686331
16236,407432209,143809435,551241644,5,0,0,24576,11,8201674934
16237,407457390,176506279,583963669,8,0,1,30208,2,7287266654
16238,407515250,144192865,551708115,1,0,0,1024,5,350551194
16239,407517430,176446262,583963692,6,0,1,2048,7,10069666280
16240,407567100,143505269,551072369,1,0,0,3584,5,3767775811
16241,407570780,144598357,552169137,9,0,0,58880,17,10684747162
16242,407654020,143134992,550789012,1,0,0,6144,5,6418316037
16243,407658010,176305705,583963715,6,0,1,12800,7,9108025829
16244,407718830,143645381,551364211,4,0,0,8192,2,6251029492
16245,407729269,176234469,583963738,0,0,1,9728,10,5194918035
16246,407764010,144176263,551940273,7,0,0,368640,16,3371477989
16247,407766100,176203456,583969556,8,0,1,26624,2,3343314945
16248,407784310,143838974,551623284,9,0,0,44032,17,1297427438
16249,407825410,143709166,551534576,7,0,0,46080,16,2133339024
16250,407828770,144260921,552089691,6,0,0,353792,7,7972914826
16251,407846740,143791121,551637861,4,0,0,37376,2,8692583827
16252,407892180,143717634,551609814,4,0,0,143872,2,595697335
16253,407961820,144670424,552632244,4,0,0,1024,2,5648863874
16254,407977830,176205889,584183719,8,0,1,22528,2,4400023846
16255,407993530,144529493,552523023,9,0,0,508416,17,8407803284
16256,408018830,176184769,584203599,5,0,1,9216,11,3078600934
16257,408021861,176182814,584204675,9,0,1,13312,17,994297757
16258,408024210,176473591,584497801,2,0,1,8704,4,1161651515
16259,408051890,143571573,551623463,1,0,0,512,5,7686335115
16260,408071409,176572173,584643582,0,0,1,7168,10,9473226837
16261,408087880,143391901,551479781,1,0,0,4096,5,9347417614
16262,408094260,176549681,584643941,8,0,1,9728,2,2561438658
16263,408125591,176524251,584649842,9,0,1,19968,17,1094434829
16264,408137180,143973594,552110774,9,0,0,69120,17,426495297
16265,408166290,176550541,584716831,8,0,1,16896,2,4172386766
16266,408169710,144552279,552721989,7,0,0,30720,16,1841779824
16267,408176630,176635492,584812122,2,0,1,39424,4,231810475
16268,408235909,176588024,584823933,0,0,1,10752,10,6603047313
16269,408237609,176783462,585021071,0,0,1,24064,10,10695087527
16270,408259041,176772840,585031881,9,0,1,20992,17,8160143185
16271,408269340,144020520,552289860,9,0,0,339968,17,2702022281
16272,408295420,144627551,552922971,4,0,0,169984,2,10385037698
16273,408301001,176743718,585044719,9,0,1,12288,17,856485481
16274,408326040,143992859,552318899,9,0,0,95232,17,44863351
16275,408392540,144837989,553230529,6,0,0,429568,7,9785056286
16276,408467179,144526327,552993506,5,0,0,231424,11,887563530
16277,408489920,144381132,552871052,9,0,0,357888,17,10122860962
16278,408547771,176498634,585046405,9,0,1,28672,17,5382150056
16279,408580170,144051739,552631909,4,0,0,131584,2,9847782633
16280,408634280,144631699,553265979,4,0,0,93696,2,1798309976
16281,408671250,176375411,585046661,7,0,1,9216,16,1332918036
16282,408721419,176378776,585100195,1,0,1,16384,5,1809299727
16283,408781480,143765012,552546492,4,0,0,76800,2,175986555
16284,408788459,176311759,585100218,1,0,1,21504,5,2730023955
16285,408791409,176516759,585308168,1,0,1,17920,5,8731379588
16286,408795910,176512281,585308191,7,0,1,7168,16,10614942547
16287,408806721,176501501,585308222,9,0,1,33280,17,9264594115
16288,408814570,144620675,553435245,7,0,0,53248,16,433112176
16289,408847381,176460864,585308245,9,0,1,512,17,1464903678
16290,408868790,176439478,585308268,2,0,1,18944,4,3254935213
16291,408872129,176560135,585432264,4,0,1,27648,2,6129742071
16292,408886251,176546597,585432848,9,0,1,6656,17,10463337451
16293,408894540,144205082,553099622,4,0,0,25088,2,7383547877
16294,408921749,176512379,585434128,1,0,1,14336,5,9014756312
16295,408942360,144454942,553397302,9,0,0,78848,17,2961219511
16296,408978170,145532450,554510620,9,0,0,261632,17,9040485622
16297,408990299,144646190,553636489,5,0,0,276480,11,3603028493
16298,409002829,176493732,585496561,1,0,1,23552,5,2310835233
16299,409077600,144222428,553300028,7,0,0,41472,16,9546082538
16300,409081320,143917122,552998442,4,0,0,15872,2,4565460949
16301,409107151,176389433,585496584,9,0,1,5632,17,5981279578
16302,409117800,176378807,585496607,2,0,1,1024,4,4263616295
16303,409123880,144761588,553885468,6,0,0,225792,7,5882236810
16304,409137350,144606092,553743442,6,0,0,244736,7,10506998623
16305,409167950,176328680,585496630,2,0,1,9728,4,1311614238
16306,409174330,144477314,553651644,9,0,0,49664,17,6445568887
16307,409180170,144302476,553482646,1,0,0,1024,5,3486766602
16308,409183319,144118760,553302079,5,0,0,6656,11,2869960886
16309,409230929,176266851,585497780,1,0,1,20992,5,4483520336
16310,409276910,144253453,553530363,6,0,0,143872,7,10429675547
16311,409290340,176213322,585503662,7,0,1,10752,16,5883377993
16312,409312330,144607325,553919655,6,0,0,112128,7,1887987951
16313,409363971,176248423,585612394,9,0,1,43520,17,10352574207
16314,409375160,144027469,553402629,7,0,0,17408,16,5132804452
16315,409409960,144348729,553758689,7,0,0,49664,16,1384565839
16316,409415271,176250131,585665402,9,0,1,39936,17,1363915777
16317,409428559,176285405,585713964,1,0,1,8192,5,9881730825
16318,409445620,144106606,553552226,7,0,0,71680,16,8153731026
16319,409458340,144350323,553808663,4,0,0,29696,2,1233918753
16320,409467800,144491034,553958834,6,0,0,128512,7,3924415777
16321,409487109,145146889,554633998,5,0,0,65536,11,8252443206
16322,409506180,144151571,553657751,9,0,0,19968,17,5767662370
16323,409544700,144254884,553799584,4,0,0,134144,2,34333411
16324,409563279,144545848,554109127,5,0,0,128512,11,6490847197
16325,409618701,176095286,585713987,9,0,1,10752,17,8169575113
16326,409668679,144401269,554069948,5,0,0,76800,11,368075924
16327,409686620,176027390,585714010,7,0,1,28160,16,6657826475
16328,409687120,144575290,554262410,6,0,0,102400,7,2564389324
16329,409688200,144422830,554111030,7,0,0,6144,16,8157309668
16330,409690440,145225060,554915500,9,0,0,277504,17,3837555553
16331,409692100,144421917,554114017,9,0,0,9728,17,5412172188
16332,409733740,144678808,554412548,7,0,0,44544,16,9662766315
16333,409771590,144240079,554011669,1,0,0,1536,5,5542271531
16334,409775210,144895939,554671149,6,0,0,121856,7,4316487284
16335,409786370,144608616,554394986,6,0,0,26112,7,4832927251
16336,409799490,145354513,555154003,6,0,0,206848,7,5873457039
16337,409828750,175885283,585714033,7,0,1,11264,16,5083666494
16338,409854560,145186898,555041458,7,0,0,271360,16,1575306970
16339,409869009,145450321,555319330,5,0,0,127488,11,6037806432
16340,409873630,144637949,554511579,1,0,0,3072,5,1807320498
16341,409887379,145203577,555090956,5,0,0,77312,11,7919689789
16342,409892850,144404371,554297221,9,0,0,44032,17,389116255
16343,409904330,144614916,554519246,6,0,0,25088,7,8052026218
16344,409916820,145150557,555067377,6,0,0,84992,7,2468414835
16345,409950629,175927718,585878347,0,0,1,19968,10,7867206054
16346,409954510,175984287,585938797,7,0,1,4096,16,4846072606
16347,410000900,175937920,585938820,7,0,1,50176,16,9224261108
16348,410018580,176405766,586424346,7,0,1,31232,16,1044397558
16349,410031789,176532436,586564225,1,0,1,36864,5,8670607583
16350,410108009,176456239,586564248,1,0,1,512,5,512234630
16351,410109639,145582777,555692416,5,0,0,840192,11,1848780773
16352,410129190,145709935,555839125,4,0,0,421376,2,7566100069
16353,410145839,145813585,555959424,5,0,0,394752,11,2909026136
16354,410165590,145817132,555982722,4,0,0,76288,2,410265189
16355,410228231,176345954,586574185,9,0,1,6144,17,10260627413
16356,410253239,176342542,586595781,1,0,1,16896,5,57683848
16357,410255350,145455364,555710714,1,0,0,2560,5,9903099523
16358,410392449,176210527,586602976,1,0,1,23040,5,4801840884
16359,410400350,145735404,556135754,1,0,0,2560,5,9411059855
16360,410428589,176351657,586780246,1,0,1,30720,5,6858596295
16361,410492410,145573217,556065627,4,0,0,271872,2,8658532034
16362,410531390,145821929,556353319,4,0,0,429056,2,10216452499
16363,410552119,176228150,586780269,1,0,1,15360,5,6766925653
16364,410569980,145652588,556222568,9,0,0,284672,17,8888103273
16365,410579930,145129981,555709911,6,0,0,57344,7,7184468222
16366,410592809,176187483,586780292,1,0,1,3072,5,10050739264
16367,410671419,145463532,556134951,5,0,0,179200,11,8643594437
16368,410678400,176101915,586780315,7,0,1,31744,16,6050891000
16369,410701840,145842333,556544173,6,0,0,81408,7,3381353803
16370,410767589,145672062,556439651,5,0,0,158208,11,10465158622
16371,410800189,145280116,556080305,5,0,0,47616,11,7247225163
16372,410802139,145582340,556384479,5,0,0,101888,11,1887269374
16373,410841480,146227538,557069018,7,0,0,367104,16,4705998999
16374,410924469,145853158,556777627,5,0,0,135680,11,2327595193
16375,410956210,175843674,586799884,5,0,1,54784,11,7564209512
16376,410956830,146281046,557237876,7,0,0,370688,16,723308205
16377,410958699,175886939,586845638,1,0,1,2560,5,8866382846
16378,410980039,175907609,586887648,1,0,1,17920,5,8329467944
16379,411029060,175858611,586887671,5,0,1,1024,11,696044448
16380,411044860,145633296,556678156,9,0,0,57344,17,7777576049
16381,411076409,175830879,586907288,1,0,1,49664,5,10480685871
16382,411130790,145647484,556778274,1,0,0,2048,5,10062155314
16383,411150839,175756472,586907311,1,0,1,30720,5,5303978269
16384,411164030,175743304,586907334,5,0,1,5120,11,4039703564
16385,411191540,146442575,557634115,7,0,0,101376,16,6382937980
16386,411195780,146294582,557490362,7,0,0,487424,16,671549710
16387,411228499,175678858,586907357,1,0,1,15360,5,9446954282
16388,411229480,175677900,586907380,5,0,1,22528,11,2763111832
16389,411258650,146549893,557808543,9,0,0,454656,17,9694178581
16390,411310990,175606732,586917722,5,0,1,24064,11,7836909507
16391,411338340,175579405,586917745,7,0,1,25600,16,21945635
16392,411393100,146210096,557603196,6,0,0,219136,7,8891043079
16393,411418310,175543044,586961354,5,0,1,32256,11,2155518934
16394,411470330,175491047,586961377,5,0,1,10240,11,6875340882
16395,411471740,175489668,586961408,7,0,1,5632,16,5789019190
16396,411471970,175489461,586961431,2,0,1,51200,4,4428463668
16397,411476500,146059905,557536405,4,0,0,151040,2,4386097991
16398,411483080,175483014,586966094,2,0,1,80384,4,4269308379
16399,411502160,146328760,557830920,4,0,0,73216,2,8859018632
16400,411576610,175393670,586970280,2,0,1,6656,4,8640808356
16401,411584560,146339725,557924285,6,0,0,306176,7,13219802
16402,411585620,146391002,557976622,7,0,0,169472,16,2800383433
16403,411586620,175422203,587008823,2,0,1,62976,4,5128815571
16404,411594070,175417339,587011409,2,0,1,4096,4,6096744910
16405,411642920,175377960,587020880,2,0,1,13312,4,7651946701
16406,411670700,146254240,557924940,1,0,0,2048,5,4914797519
16407,411690670,146310623,558001293,6,0,0,80896,7,6961534814
16408,411738300,146589032,558327332,7,0,0,642560,16,2836261734
16409,411741760,175370999,587112759,2,0,1,13824,4,6382247397
16410,411759420,146372109,558131529,9,0,0,309760,17,5172064519
16411,411784350,145851246,557635596,1,0,0,4608,5,8371744664
16412,411850739,175274551,587125290,0,0,1,2048,10,4906146778
16413,411854080,175326521,587180601,5,0,1,22016,11,4245764244
16414,411890160,146501247,558391407,9,0,0,102912,17,10104724359
16415,411904299,175279208,587183507,0,0,1,4608,10,6100588648
16416,411947190,175259434,587206624,5,0,1,12800,11,10085290949
16417,411973249,175457143,587430392,0,0,1,34304,10,7855406872
16418,412000920,146356231,558357151,6,0,0,97792,7,7492259260
16419,412008439,145994749,558003188,5,0,0,6144,11,6463687177
16420,412012880,146469209,558482089,7,0,0,278528,16,448315127
16421,412085240,175484764,587570004,6,0,1,14848,7,3512842553
16422,412121890,146275312,558397202,1,0,0,18944,5,1280372172
16423,412129850,175591223,587721073,2,0,1,20992,4,7691947902
16424,412168090,146191291,558359381,1,0,0,6656,5,146045355
16425,412188030,146169300,558357330,6,0,0,512,7,4111664205
16426,412190700,175533919,587724619,2,0,1,5632,4,592551221
16427,412197250,146540968,558738218,4,0,0,228352,2,4256204513
16428,412219570,146140458,558360028,1,0,0,2048,5,10274927839
16429,412236590,146710633,558947223,4,0,0,257536,2,9546578342
16430,412268040,146549628,558817668,4,0,0,260608,2,8801985254
16431,412271610,146271848,558543458,1,0,0,3584,5,9220498003
16432,412275090,146393529,558668619,4,0,0,194048,2,17214452
16433,412293949,146744761,559038710,5,0,0,195072,11,9654869975
16434,412362479,147201119,559563598,5,0,0,40448,11,9348658624
16435,412425900,175415835,587841735,2,0,1,53248,4,348916545
16436,412459380,146651963,559111343,4,0,0,93696,2,596239152
16437,412490270,147102523,559592793,6,0,0,95744,7,4617043206
16438,412521999,175328998,587850997,0,0,1,28672,10,6017683996
16439,412564580,146859032,559423612,7,0,0,232448,16,2347678218
16440,412665110,175218451,587883561,2,0,1,32768,4,3480531890
16441,412666560,175252593,587919153,2,0,1,26112,4,9828044869
16442,412752289,146210002,558962291,5,0,0,45568,11,10719336241
16443,412781749,146703038,559484787,5,0,0,200704,11,1977434089
16444,412924820,146818832,559743652,7,0,0,105984,16,4681241518
16445,412942000,146006384,558948384,1,0,0,3584,5,7513260512
16446,412945999,146872267,559818266,5,0,0,244736,11,3804688186
16447,412948740,146213187,559161927,1,0,0,11264,5,6509395538
16448,412949790,147050337,560000127,9,0,0,242176,17,3985338003
16449,412967050,175043144,588010194,2,0,1,10752,4,111793466
16450,413077439,147620782,560698221,5,0,0,248320,11,3380314689
16451,413082259,147257105,560339364,5,0,0,334848,11,7844952422
16452,413129470,146958905,560088375,9,0,0,178688,17,2493323873
16453,413158540,174851677,588010217,7,0,1,19456,16,9077871608
16454,413171350,146941407,560112757,6,0,0,36352,7,8132007888
16455,413171560,174885191,588056751,7,0,1,3072,16,10206457587
16456,413279390,146206668,559486058,1,0,0,4096,5,4809040106
16457,413289550,146851104,560140654,4,0,0,69120,2,1972084771
16458,413322200,145960932,559283132,1,0,0,512,5,9638079458
16459,413340610,146888260,560228870,7,0,0,194560,16,9366641088
16460,413362099,146251017,559613116,5,0,0,57856,11,7725765579
16461,413397170,174747011,588144181,2,0,1,65024,4,4586487196
16462,413454150,146472166,559926316,4,0,0,176128,2,5484390858
16463,413462960,174681244,588144204,2,0,1,1536,4,1136283877
16464,413484080,146932184,560416264,6,0,0,29184,7,3889796058
16465,413509360,146524540,560033900,1,0,0,3584,5,6101793983
16466,413543770,174600465,588144235,2,0,1,29696,4,7802799203
16467,413547630,147165434,560713064,6,0,0,48640,7,554418836
16468,413642700,147255747,560898447,4,0,0,193536,2,7351737512
16469,413651121,174493137,588144258,9,0,1,13312,17,3914833106
16470,413675240,146357537,560032777,7,0,0,107008,16,2996823419
16471,413676460,146830686,560507146,7,0,0,7168,16,4897714833
16472,413679480,146433456,560112936,1,0,0,512,5,1011774677
16473,413742110,146495207,560237317,4,0,0,27648,2,8593343398
16474,413778670,174467681,588246351,2,0,1,49664,4,8113385865
16475,413815480,174533612,588349092,2,0,1,79872,4,5583841923
16476,413854830,174496180,588351010,2,0,1,25088,4,8654478829
16477,413877180,174473853,588351033,2,0,1,32768,4,918923304
16478,413896910,174454146,588351056,2,0,1,27136,4,7790469998
16479,413914270,174436809,588351079,5,0,1,1024,11,687558850
16480,413970080,146131578,560101658,6,0,0,43520,7,3336717537
16481,413970180,147061606,561031786,7,0,0,57856,16,9363861208
16482,414021810,146949824,560971634,4,0,0,240128,2,9934950039
16483,414075570,146683882,560759452,7,0,0,118272,16,5986889163
16484,414094550,146908018,561002568,6,0,0,62464,7,9898204011
16485,414104110,146978087,561082197,4,0,0,165376,2,8456615244
16486,414124450,146589573,560714023,1,0,0,3072,5,9266706392
16487,414148970,174202132,588351102,2,0,1,34816,4,9328098920
16488,414149760,147045831,561195591,4,0,0,163328,2,1145204169
16489,414184191,174166942,588351133,9,0,1,4096,17,10436950856
16490,414210440,174142299,588352739,5,0,1,34304,11,9635880829
16491,414237550,146745963,560983513,4,0,0,38912,2,3531616567
16492,414292530,146143101,560435631,6,0,0,63488,7,1313787145
16493,414293309,146720826,561014135,5,0,0,37888,11,3495458649
16494,414311650,147214686,561526336,9,0,0,97792,17,5124132709
16495,414324850,146935176,561260026,9,0,0,159744,17,608545753
16496,414325610,146761032,561086642,9,0,0,11776,17,9997370741
16497,414328141,174024621,588352762,9,0,1,9728,17,4566484928
16498,414379110,173973675,588352785,3,0,1,4096,3,74597984
16499,414379789,146736296,561116085,5,0,0,95744,11,9862230315
16500,414448000,173904808,588352808,7,0,1,8704,16,5705404256
16501,414465630,146867519,561333149,7,0,0,99840,16,2430242743
16502,414479770,173873061,588352831,2,0,1,7680,4,1347954138
16503,414488200,145998666,560486866,7,0,0,6144,16,7892771462
16504,414509850,146293581,560803431,9,0,0,43008,17,6557843433
16505,414532630,147059604,561592234,7,0,0,177664,16,4830912769
16506,414539840,147217867,561757707,6,0,0,481280,7,1046549788
16507,414541589,147656096,562197685,5,0,0,198144,11,9187099304
16508,414564900,147451622,562016522,6,0,0,88064,7,3850585137
16509,414597480,173755374,588352854,5,0,1,3072,11,1438998836
16510,414599051,173753826,588352877,9,0,1,4096,17,2512585168
16511,414626041,173726859,588352900,9,0,1,26624,17,7829190187
16512,414630720,147331905,561962625,9,0,0,280576,17,1120100620
16513,414641620,146445247,561086867,1,0,0,512,5,701144279
16514,414654550,146428481,561083031,1,0,0,2560,5,7822785499
16515,414682880,147807965,562490845,7,0,0,104448,16,1409794825
16516,414764500,146441973,561206473,1,0,0,1536,5,8801260645
16517,414765560,146843195,561608755,9,0,0,12800,17,6081856611
16518,414769710,147297691,562067401,6,0,0,166912,7,10049566311
16519,414813390,146521521,561334911,9,0,0,5632,17,1723543596
16520,414839449,147556154,562395603,5,0,0,24576,11,8169637365
16521,414848970,146647547,561496517,4,0,0,38912,2,795727022
16522,414893850,146644229,561538079,7,0,0,28672,16,7122682734
16523,414920241,173454389,588374630,9,0,1,8192,17,3525062895
16524,414922400,146837358,561759758,4,0,0,6656,2,1508964004
16525,414971700,146477521,561449221,4,0,0,4608,2,549844695
16526,414984651,173390082,588374733,9,0,1,55296,17,7915999201
16527,414987641,173389271,588376912,9,0,1,7168,17,4814470981
16528,414991340,146998319,561989659,4,0,0,59904,2,5224698949
16529,415018110,146953274,561971384,6,0,0,28672,7,1786662459
16530,415038690,147745524,562784214,7,0,0,100864,16,5314511828
16531,415044470,147191458,562235928,9,0,0,125440,17,2671229522
16532,415047571,173353902,588401473,9,0,1,32256,17,854076965
16533,415079090,173361276,588440366,5,0,1,33792,11,9407262005
16534,415102670,147185763,562288433,7,0,0,163328,16,8487245994
16535,415123729,147554154,562677883,5,0,0,152576,11,9348146001
16536,415124900,147929837,563054737,7,0,0,482304,16,5404076884
16537,415181911,173313075,588494986,9,0,1,18944,17,6328736783
16538,415190369,147957159,563147528,5,0,0,266240,11,4695979392
16539,415201320,173297490,588498810,2,0,1,29696,4,9746145473
16540,415210801,173305144,588515945,9,0,1,9728,17,7542285522
16541,415230709,147975498,563206207,5,0,0,192512,11,9888492968
16542,415233350,148073273,563306623,4,0,0,239104,2,1753903545
16543,415263100,148214729,563477829,6,0,0,519168,7,138416415
16544,415264730,148260702,563525432,4,0,0,156160,2,7392301199
16545,415311309,148225222,563536531,5,0,0,36352,11,4009628118
16546,415370090,173304104,588674194,2,0,1,104960,4,9772801577
16547,415385330,173444225,588829555,5,0,1,41472,11,9403955262
16548,415427820,173407809,588835629,2,0,1,15872,4,3814164232
16549,415455631,173412821,588868452,9,0,1,45568,17,7656864206
16550,415470600,147235542,562706142,4,0,0,92672,2,5707977314
16551,415484910,148161469,563646379,6,0,0,171520,7,2074526873
16552,415493900,147739809,563233709,9,0,0,90112,17,4062059572
16553,415523600,148045237,563568837,9,0,0,29184,17,9486429686
16554,415586480,173477746,589064226,2,0,1,45568,4,824934659
16555,415605600,173526392,589131992,5,0,1,9216,11,3787125523
16556,415622500,148174841,563797341,7,0,0,429056,16,10130498779
16557,415633130,148248878,563882008,7,0,0,224256,16,1135245651
16558,415642860,148353807,563996667,4,0,0,125952,2,7872526869
16559,415673891,173458124,589132015,9,0,1,5632,17,2049790207
16560,415674800,148558117,564232917,4,0,0,350720,2,6341085358
16561,415704820,147831936,563536756,1,0,0,512,5,5851355070
16562,415709500,173422538,589132038,2,0,1,4096,4,3818195101
16563,415765080,148742206,564507286,1,0,0,3072,5,1996569064
16564,415787270,173400512,589187782,2,0,1,8192,4,9593907583
16565,415834180,147220892,563055072,1,0,0,1024,5,10615113189
16566,415855920,173331885,589187805,5,0,1,22016,11,428289077
16567,415865930,147947658,563813588,9,0,0,53248,17,7208637106
16568,415894219,173293609,589187828,0,0,1,4608,10,11502633
16569,415906389,148442478,564348867,5,0,0,110080,11,3474438189
16570,415945110,148811481,564756591,7,0,0,234496,16,10578374960
16571,415966290,147689096,563655386,6,0,0,29184,7,1661160271
16572,416022660,173184641,589207301,2,0,1,13312,4,5837344179
16573,416024630,147552151,563576781,1,0,0,19968,5,5627525342
16574,416031491,173178076,589209567,9,0,1,3584,17,9028905659
16575,416060429,147480562,563540991,5,0,0,13824,11,5479468062
16576,416094979,148847656,564942635,5,0,0,36352,11,8989521374
16577,416108259,173118510,589226769,0,0,1,16384,10,9249463700
16578,416133299,148219803,564353102,5,0,0,13824,11,6949231199
16579,416193890,148039206,564233096,1,0,0,512,5,5892133254
16580,416196889,173030546,589227435,0,0,1,1024,10,4678776483
16581,416220410,148790699,565011109,7,0,0,59904,16,3742546683
16582,416231970,148123071,564355041,1,0,0,1536,5,625018379
16583,416240880,147867392,564108272,1,0,0,7680,5,1553967235
16584,416297760,149567142,565864902,7,0,0,244224,16,479190078
16585,416313260,148371860,564685120,9,0,0,50176,17,4763953990
16586,416314029,148862534,565176563,5,0,0,282112,11,10036694685
16587,416315459,148616077,564931536,5,0,0,129536,11,9093368326
16588,416348280,148151318,564499598,7,0,0,54272,16,998146660
16589,416359879,149378175,565738054,5,0,0,431616,11,8138104561
16590,416405729,148461645,564867374,5,0,0,363520,11,9798636279
16591,416407480,172820826,589228306,5,0,1,12288,11,7731742756
16592,416413720,148579114,564992834,6,0,0,101376,7,1009390535
16593,416425589,148057450,564483039,5,0,0,37376,11,5680121548
16594,416435611,172796058,589231669,9,0,1,11776,17,6091625150
16595,416445250,172828690,589273940,2,0,1,7168,4,7600357353
16596,416496869,172777430,589274299,0,0,1,9728,10,7712548628
16597,416506079,172773507,589279586,0,0,1,16896,10,6100999993
16598,416540070,172817169,589357239,2,0,1,33792,4,6483073423
16599,416558231,172907752,589465983,9,0,1,67584,17,731675764
16600,416602161,172863845,589466006,9,0,1,9216,17,6352741800
16601,416615821,172858078,589473899,9,0,1,2560,17,9694886118
16602,416633970,149363068,565997038,7,0,0,124928,16,2732158628
16603,416654140,147716333,564370473,7,0,0,16896,16,229881574
16604,416679690,148282202,564961892,4,0,0,62976,2,1748805875
16605,416686000,172897444,589583444,5,0,1,44032,11,1223125303
16606,416693030,172893640,589586670,2,0,1,5120,4,10728079824
16607,416694140,172967284,589661424,2,0,1,56832,4,6816628980
16608,416720079,148370474,565090553,5,0,0,81920,11,5746069952
16609,416795670,173050955,589846625,2,0,1,20992,4,806504023
16610,416807850,173038798,589846648,2,0,1,68608,4,9570268986
16611,416818729,148073316,564892045,5,0,0,80896,11,921642716
16612,416838800,173007871,589846671,5,0,1,39424,11,1625734956
16613,416843950,149411970,566255920,9,0,0,262656,17,156205501
16614,416883320,172977125,589860445,2,0,1,45568,4,5283142712
16615,416923021,172938758,589861779,9,0,1,35328,17,8909388295
16616,416956550,149599956,566556506,4,0,0,201216,2,3291577867
16617,416988580,173001097,589989677,2,0,1,24064,4,7613525537
16618,416994219,148071351,565065570,5,0,0,74240,11,238086471
16619,417036960,148258634,565295594,7,0,0,228864,16,9931320872
16620,417064170,172925530,589989700,2,0,1,25088,4,6286106023
16621,417097520,149261090,566358610,7,0,0,44032,16,9039375865
16622,417111860,172877863,589989723,2,0,1,17408,4,3205945856
16623,417118360,149499652,566618012,9,0,0,175104,17,9971270905
16624,417151910,149573983,566725893,7,0,0,193024,16,2907281904
16625,417154450,147857150,565011600,1,0,0,1536,5,8708976823
16626,417186440,148308350,565494790,9,0,0,6144,17,10551836183
16627,417242591,172752216,589994807,9,0,1,30720,17,3606433292
16628,417251579,148063717,565315296,5,0,0,64512,11,10614552517
16629,417283131,172884316,590167447,9,0,1,31232,17,1579324379
16630,417341770,148448697,565790467,7,0,0,17408,16,2963592609
16631,417377780,172799541,590177321,5,0,1,18944,11,5995467339
16632,417402820,148063703,565466523,6,0,0,28160,7,5144573283
16633,417417390,172759954,590177344,7,0,1,2048,16,3781647137
16634,417418830,172758537,590177367,5,0,1,2048,11,7962515407
16635,417450700,148951511,566402211,7,0,0,93184,16,3689938823
16636,417485450,149990866,567476316,6,0,0,620032,7,9815241429
16637,417500440,148365889,565866329,1,0,0,4608,5,6612035363
16638,417522669,149494042,567016711,5,0,0,239104,11,9529043406
16639,417523589,147851312,565374901,5,0,0,36352,11,7936426783
16640,417523600,149399521,566923121,6,0,0,247296,7,2065705688
16641,417530030,172647360,590177390,5,0,1,6656,11,9234367508
16642,417539440,148774894,566314334,9,0,0,1536,17,6699583704
16643,417550280,149704306,567254586,9,0,0,585728,17,7410598023
16644,417619020,172558393,590177413,7,0,1,15360,16,1289065998
16645,417643090,148650449,566293539,4,0,0,123392,2,9756553084
16646,417712370,172465066,590177436,7,0,1,8192,16,2246547489
16647,417726430,149217017,566943447,7,0,0,66560,16,919657293
16648,417735860,148165986,565901846,4,0,0,1024,2,7383034813
16649,417779071,172398388,590177459,9,0,1,18944,17,1827169176
16650,417779939,148689364,566469303,5,0,0,152064,11,3507556580
16651,417788331,172389151,590177482,9,0,1,28160,17,9885339489
16652,417803959,172373546,590177505,0,0,1,5632,10,2555995185
16653,417812820,148994715,566807535,6,0,0,248832,7,7227969932
16654,417851919,149854150,567706069,5,0,0,37376,11,3676060381
16655,417891970,148018164,565910134,4,0,0,1024,2,4410906380
16656,417892720,172284808,590177528,2,0,1,10240,4,3544834853
16657,417916720,150554824,568471544,9,0,0,249344,17,3193745713
16658,417922320,148721030,566643350,1,0,0,4608,5,3354403887
16659,417940890,149753714,567694604,9,0,0,40448,17,864694813
16660,417976439,172201112,590177551,0,0,1,10752,10,7228836671
16661,418005540,172198829,590204369,2,0,1,31744,4,4808648582
16662,418016419,149059680,567076099,5,0,0,74752,11,7051382887
16663,418047949,172235397,590283346,4,0,1,22016,2,5408395677
16664,418071170,148776534,566847704,6,0,0,131584,7,2752905500
16665,418121819,148915257,567037076,5,0,0,66560,11,7107639934
16666,418126690,148604998,566731688,7,0,0,18944,16,5966264003
16667,418147990,172135379,590283369,2,0,1,26624,4,4919450176
16668,418175520,172158863,590334383,2,0,1,48128,4,4770476169
16669,418191400,172193082,590384482,3,0,1,70656,3,9346966984
16670,418207329,172369970,590577299,4,0,1,104960,2,2277853313
16671,418224390,172352932,590577322,7,0,1,46080,16,3519150287
16672,418237739,172340900,590578639,4,0,1,29696,2,9659539748
16673,418317330,172261332,590578662,2,0,1,2048,4,1184078082
16674,418350450,172228414,590578864,2,0,1,13312,4,3138557209
16675,418411630,172170385,590582015,7,0,1,22528,16,30325884
16676,418427460,172156181,590583641,7,0,1,2560,16,7333417600
16677,418438790,172147437,590586227,6,0,1,4096,7,3499050539
16678,418475620,150001883,568477503,9,0,0,19456,17,9944238530
16679,418492680,172100639,590593319,7,0,1,11264,16,4274841556
16680,418538470,172059675,590598145,2,0,1,7680,4,6317419047
16681,418569590,172033701,590603291,6,0,1,8192,7,2866617218
16682,418601619,148685750,567287369,5,0,0,107520,11,10442071366
16683,418662321,172052959,590715280,9,0,1,46592,17,1478979160
16684,418669571,172059988,590729559,9,0,1,10752,17,7868578877
16685,418704030,148239806,566943836,1,0,0,1024,5,167596877
16686,418724010,148775105,567499115,9,0,0,74752,17,8844373656
16687,418730440,172049620,590780060,6,0,1,9728,7,8110429066
16688,418733350,148303905,567037255,1,0,0,512,5,7427658583
16689,418738050,148809799,567547849,4,0,0,154112,2,1156593525
16690,418777351,172003682,590781033,9,0,1,12800,17,4977590176
16691,418784420,172065775,590850195,7,0,1,27648,16,1641714010
16692,418787249,150237114,569024363,5,0,0,380416,11,3516320150
16693,418797290,148703572,567500862,1,0,0,5632,5,10053117580
16694,418806740,172082165,590888905,7,0,1,36352,16,9478268725
16695,418812890,149951415,568764305,4,0,0,253952,2,7888889790
16696,418829480,148852737,567682217,4,0,0,394752,2,7756624235
16697,418839980,150249949,569089929,9,0,0,28672,17,8376559037
16698,418846250,148713212,567559462,6,0,0,37888,7,4468365497
16699,418847009,172107761,590954770,4,0,1,26112,2,5480172630
16700,418851090,149962690,568813780,6,0,0,162304,7,2893514255
16701,418891290,148670535,567561825,1,0,0,7680,5,669325423
16702,418922989,172040276,590963265,0,0,1,2048,10,5095449073
16703,418925130,172041041,590966171,7,0,1,4608,16,3168089423
16704,418934710,172034687,590969397,7,0,1,5120,16,5460349456
16705,418952800,172021884,590974684,8,0,1,16896,2,8041008474
16706,418960800,172043255,591004055,2,0,1,16896,4,7243741649
16707,418965370,172042871,591008241,6,0,1,6656,7,1186003392
16708,418993980,172018447,591012427,6,0,1,6656,7,9604355383
16709,419025551,171991702,591017253,9,0,1,7680,17,9799823544
16710,419029189,172129418,591158607,0,0,1,22528,10,1048419404
16711,419043400,172115230,591158630,6,0,1,11776,7,3586810938
16712,419049790,172144610,591194400,7,0,1,29696,16,6031430774
16713,419053601,172140822,591194423,9,0,1,22528,17,2493781540
16714,419069809,172191045,591260854,0,0,1,34816,10,4306929423
16715,419076340,172187719,591264059,6,0,1,18432,7,7662316632
16716,419092970,148756163,567849133,9,0,0,75776,17,4410400888
16717,419096009,172168073,591264082,4,0,1,13824,2,9352923288
16718,419112650,148646027,567758677,1,0,0,1536,5,6726048552
16719,419178280,148923728,568102008,7,0,0,25088,16,6372770195
16720,419248409,172015696,591264105,4,0,1,5632,2,3805673153
16721,419251320,172012808,591264128,2,0,1,26624,4,1812535262
16722,419255340,148704766,567960106,7,0,0,43520,16,10432447072
16723,419281220,171982931,591264151,2,0,1,4608,4,7686458015
16724,419336580,171927929,591264509,7,0,1,9216,16,6434560368
16725,419343370,148506254,567849624,1,0,0,1536,5,7423551785
16726,419362550,150268903,569631453,6,0,0,439808,7,465346697
16727,419380920,171883612,591264532,7,0,1,1536,16,5725812560
16728,419405130,171881296,591286426,7,0,1,33792,16,147297916
16729,419413640,148981909,568395549,6,0,0,112128,7,4842999876
16730,419417329,171869120,591286449,0,0,1,2560,10,10674334372
16731,419456909,148702390,568159299,5,0,0,18432,11,7523365156
16732,419467170,149644154,569111324,7,0,0,70144,16,5108950024
16733,419489039,171826879,591315918,4,0,1,14848,2,5739387495
16734,419539979,171775962,591315941,4,0,1,2560,2,10501771594
16735,419545340,149952017,569497357,7,0,0,503296,16,8010575344
16736,419592640,149672475,569265115,4,0,0,382976,2,8964574115
16737,419594789,149542610,569137399,5,0,0,85504,11,9116669215
16738,419621349,150177226,569798575,5,0,0,548352,11,2097641668
16739,419680250,171635714,591315964,7,0,1,7680,16,4903940170
16740,419693760,150238569,569932329,4,0,0,58880,2,779258355
16741,419730349,171585943,591316292,4,0,1,32256,2,8332008692
16742,419736389,171582221,591318610,4,0,1,2048,2,6394052263
16743,419759020,171566012,591325032,7,0,1,26624,16,6621453895
16744,419765469,149382912,569148381,5,0,0,35840,11,5743731268
16745,419786409,171572729,591359138,0,0,1,3584,10,2800908894
16746,419800840,171558644,591359484,6,0,1,512,7,1244534238
16747,419843849,171532757,591376606,0,0,1,32256,10,7624285801
16748,419875010,149414117,569289127,6,0,0,56832,7,2984340835
16749,419924579,171476714,591401293,4,0,1,18432,2,8760297932
16750,419966350,149305346,569271696,9,0,0,20992,17,8389756567
16751,419981299,171421029,591402328,4,0,1,8704,2,8340890153
16752,419998700,171413600,591412300,6,0,1,15872,7,6722064302
16753,420053170,171362996,591416166,7,0,1,6144,16,4187159715
16754,420055230,149940839,569996069,1,0,0,5632,5,3459213014
16755,420086800,149827558,569914358,4,0,0,379904,2,757684744
16756,420087150,149886565,569973715,4,0,0,125440,2,1874293180
16757,420112279,171321188,591433467,0,0,1,22528,10,4404659446
16758,420133479,171306760,591440239,4,0,1,10752,2,5169121297
16759,420143931,171321079,591465010,9,0,1,31744,17,1734578046
16760,420174780,149836920,570011700,4,0,0,51200,2,425689516
16761,420212359,171255877,591468236,4,0,1,5120,2,8909644088
16762,420216071,171258066,591474137,9,0,1,19968,17,5642246097
16763,420255651,171252966,591508617,9,0,1,32256,17,9508296951
16764,420257001,171272670,591529671,9,0,1,18944,17,8142192980
16765,420258250,149892843,570151093,4,0,0,148992,2,1831475477
16766,420293781,171333092,591626873,9,0,1,40960,17,4096990263
16767,420297020,149733119,570030139,9,0,0,60416,17,9767555203
16768,420315830,150004223,570320053,4,0,0,542208,2,3228871578
16769,420327070,149608402,569935472,9,0,0,10240,17,5392844801
16770,420335820,149658510,569994330,6,0,0,67584,7,9067188935
16771,420347520,171283987,591631507,7,0,1,17920,16,4509743335
16772,420351179,171526906,591878085,4,0,1,20992,2,307326906
16773,420406960,171472575,591879535,6,0,1,15360,7,1278777095
16774,420417101,171462457,591879558,9,0,1,2560,17,3186018264
16775,420446021,171553033,591999054,9,0,1,6656,17,5876137735
16776,420462180,171536897,591999077,7,0,1,10240,16,3210736706
16777,420469190,171529910,591999100,7,0,1,1536,16,8444236759
16778,420553930,150359312,570913242,9,0,0,197632,17,6084257844
16779,420571150,150281853,570853003,4,0,0,412672,2,1115125958
16780,420601519,171745294,592346813,4,0,1,19456,2,9992411056
16781,420611839,171734997,592346836,4,0,1,7680,2,10646617922
16782,420681030,149829876,570510906,9,0,0,67584,17,10191117225
16783,420697659,171710312,592407971,4,0,1,28160,2,314769927
16784,420706410,150368827,571075237,6,0,0,268800,7,9113316500
16785,420713149,171896263,592609412,4,0,1,67072,2,2863172349
16786,420722429,149920352,570642781,5,0,0,333824,11,4275869064
16787,420730791,171878644,592609435,9,0,1,10240,17,2242405138
16788,420747579,150633754,571381333,5,0,0,313344,11,5149863198
16789,420785710,150474768,571260478,7,0,0,607744,16,8431012705
16790,420788180,150200745,570988925,4,0,0,248320,2,10087418978
16791,420799311,171810147,592609458,9,0,1,4608,17,868370525
16792,420811120,150813605,571624725,4,0,0,57856,2,3785221538
16793,420832970,151071193,571904163,4,0,0,288256,2,1020973241
16794,420857819,171751662,592609481,4,0,1,5632,2,477182472
16795,420884840,151479295,572364135,7,0,0,227840,16,435131536
16796,420891190,171810088,592701278,7,0,1,30720,16,9557286657
16797,420913069,151311992,572225061,5,0,0,483328,11,7740016741
16798,420953980,150706161,571660141,7,0,0,60928,16,10663536233
16799,420957039,171744270,592701309,4,0,1,18944,2,10417612930
16800,420970640,171730911,592701551,5,0,1,17920,11,518989553
16801,421004479,171700105,592704584,4,0,1,20480,2,2448980997
16802,421007150,171697457,592704607,5,0,1,39424,11,1035919920
16803,421056280,171648350,592704630,7,0,1,19968,16,28546825
16804,421068421,171658727,592727148,9,0,1,22016,17,5808113689
16805,421074790,149915897,570990687,9,0,0,5632,17,7163415077
16806,421094810,150842604,571937414,4,0,0,109056,2,1072980432
16807,421116760,150288147,571404907,1,0,0,7680,5,3549009853
16808,421124200,171604901,592729101,7,0,1,10240,16,7336016766
16809,421213080,150526969,571740049,7,0,0,15360,16,10116730523
16810,421266340,151290626,572556966,6,0,0,54784,7,7761955798
16811,421269840,151597176,572867016,9,0,0,360448,17,584089230
16812,421303721,171425534,592729255,9,0,1,8704,17,5898375647
16813,421353860,150360879,571714739,7,0,0,74752,16,4031013049
16814,421393459,171349279,592742738,4,0,1,2560,2,4905473100
16815,421394170,150073102,571467272,6,0,0,1024,7,4521905686
16816,421398530,150065934,571464464,1,0,0,9216,5,8470771005
16817,421434670,151457874,572892544,1,0,0,2560,5,6997944286
16818,421457510,151590707,573048217,7,0,0,291328,16,8875130046
16819,421478780,150556817,572035597,7,0,0,5120,16,8447955604
16820,421479200,150211493,571690693,1,0,0,4608,5,3416618407
16821,421552691,171245157,592797848,9,0,1,87552,17,5632031219
16822,421564690,171243737,592808427,7,0,1,31744,16,5620574970
16823,421661680,150750393,572412073,7,0,0,148480,16,8189941090
16824,421662890,150837163,572500053,7,0,0,118272,16,2494189176
16825,421666430,171187201,592853631,6,0,1,56320,7,9819741319
16826,421704210,150662600,572366810,1,0,0,8704,5,1307671221
16827,421718190,151511425,573229615,6,0,0,250368,7,7129442839
16828,421718330,150094445,571812775,4,0,0,11264,2,794617733
16829,421834600,151649170,573483770,6,0,0,416768,7,4762661857
16830,421842179,150581001,572423180,5,0,0,36352,11,7143102249
16831,421849450,150808349,572657799,7,0,0,101376,16,8595045992
16832,421876300,150782770,572659070,1,0,0,4096,5,9117487233
16833,422052470,151697854,573750324,6,0,0,598016,7,1536524832
16834,422081510,170818832,592900342,7,0,1,31232,16,769994519
16835,422086990,170871515,592958505,5,0,1,19456,11,6788637002
16836,422105170,170958527,593063697,5,0,1,100352,11,1398968144
16837,422108570,171013041,593121611,5,0,1,32768,11,9652057133
16838,422113130,171012667,593125797,7,0,1,6656,16,1299031325
16839,422127390,171040615,593168005,5,0,1,18432,11,10601205653
16840,422129360,171038668,593168028,7,0,1,3584,16,3806205068
16841,422136170,171111990,593248160,5,0,1,8704,11,6642439680
16842,422139479,150469037,572608516,5,0,0,45568,11,6971165199
16843,422192079,151583516,573775595,5,0,0,82432,11,10369962451
16844,422196890,171083067,593279957,5,0,1,23040,11,769179629
16845,422215291,171176655,593391946,9,0,1,9728,17,4167395713
16846,422221540,171372160,593593700,7,0,1,13824,16,7090371845
16847,422254130,150470492,572724622,1,0,0,2048,5,2782789663
16848,422314520,171279203,593593723,7,0,1,1024,16,4065547563
16849,422392480,171201266,593593746,7,0,1,27648,16,5812618399
16850,422430620,150511462,572942082,6,0,0,139264,7,9965432122
16851,422457469,150433906,572891375,5,0,0,79872,11,5197462958
16852,422462449,150844307,573306756,5,0,0,57344,11,5134599379
16853,422466880,150424853,572891733,1,0,0,512,5,1158303486
16854,422545761,171053265,593599026,9,0,1,28672,17,5229252484
16855,422546420,150345134,572891554,1,0,0,512,5,9522337420
16856,422550549,151014924,573565473,5,0,0,267776,11,705579307
16857,422563480,171036942,593600422,5,0,1,10752,11,1118790866
16858,422579680,171023648,593603328,7,0,1,4608,16,8476047603
16859,422585229,171121735,593706964,4,0,1,10240,2,7829612490
16860,422602940,151215445,573818385,6,0,0,140288,7,9515715738
16861,422618250,171168164,593786414,7,0,1,42496,16,499550942
16862,422660620,151223760,573884380,4,0,0,216064,2,1137818244
16863,422680201,171106236,593786437,9,0,1,3584,17,6084217828
16864,422684900,150371007,573055907,6,0,0,25088,7,6100302676
16865,422714851,171073044,593787895,9,0,1,9728,17,9904656772
16866,422722549,150522533,573245082,5,0,0,50688,11,8866771348
16867,422790809,171020844,593811653,4,0,1,19968,2,8857375174
16868,422820810,170990866,593811676,7,0,1,4608,16,1798519734
16869,422826611,171051630,593878241,9,0,1,77824,17,8794448755
16870,422858169,171020095,593878264,1,0,1,31744,5,8774003723
16871,422863489,151172914,574036403,5,0,0,425472,11,3066590446
16872,422884239,171009199,593893438,1,0,1,10752,5,2284747108
16873,422889950,151197425,574087375,6,0,0,166912,7,7150185364
16874,422902091,171020463,593922554,9,0,1,22528,17,9171901581
16875,422990230,151097721,574087951,1,0,0,1536,5,9202965736
16876,422998399,170932886,593931285,4,0,1,512,2,7068427072
16877,423004450,150563574,573568024,1,0,0,8192,5,8575906661
16878,423121300,151002005,574123305,4,0,0,60416,2,6184758120
16879,423162951,170769410,593932361,9,0,1,13312,17,8318196961
16880,423186670,170803936,593990606,7,0,1,20992,16,4351915586
16881,423207669,151030215,574237884,5,0,0,182272,11,3057383771
16882,423218250,170910815,594129065,5,0,1,74752,11,961356559
16883,423236100,170895551,594131651,5,0,1,4096,11,4699040974
16884,423259200,170907969,594167169,8,0,1,33792,2,2959302107
16885,423274030,170948104,594222134,7,0,1,34816,16,6699751717
16886,423277010,170951137,594228147,8,0,1,9216,2,2129278514
16887,423298911,170931079,594229990,9,0,1,3584,17,9270492707
16888,423329319,170902605,594231924,1,0,1,16384,5,2161624448
16889,423395301,170954329,594349630,9,0,1,73728,17,703213212
16890,423443940,170925206,594369146,5,0,1,5120,11,757381711
16891,423495520,150867014,574362534,4,0,0,138752,2,5452916421
16892,423524949,170973090,594498039,1,0,1,46080,5,2454421075
16893,423546420,170951821,594498241,7,0,1,17920,16,3427145044
16894,423630160,170868559,594498719,5,0,1,7168,11,1801420831
16895,423649500,170918880,594568380,7,0,1,53248,16,2905952957
16896,423662460,170923384,594585844,5,0,1,47104,11,8106363449
16897,423675779,170970145,594645924,1,0,1,16384,5,1829045716
16898,423683230,150636958,574320188,4,0,0,178176,2,1533268237
16899,423718550,170927397,594645947,5,0,1,31232,11,7850476124
16900,423750599,170913334,594663933,1,0,1,24064,5,9065583453
16901,423815440,170848516,594663956,8,0,1,12800,2,35689155
16902,423837630,170846512,594684142,8,0,1,26624,2,7297027256
16903,423843700,170840489,594684189,5,0,1,14848,11,6705030792
16904,423861879,150403952,574265831,5,0,0,91648,11,2718728227
16905,423874500,170830153,594704653,5,0,1,56320,11,7167553511
16906,423952720,170869042,594821762,7,0,1,59392,16,806839815
16907,423965790,170855995,594821785,5,0,1,5120,11,9656579773
16908,423981930,150667885,574649815,4,0,0,179200,2,1405829801
16909,423982550,150490475,574473025,4,0,0,154624,2,5508317416
16910,424001850,150896557,574898407,4,0,0,241152,2,1894461475
16911,424026979,150490325,574517304,5,0,0,73728,11,7778084791
16912,424074050,170747758,594821808,8,0,1,6656,2,7323275863
16913,424087119,150652173,574739292,5,0,0,33792,11,152729591
16914,424134930,150644443,574779373,4,0,0,23552,2,1294284761
16915,424174640,170647191,594821831,5,0,1,2048,11,8334021799
16916,424196730,170625124,594821854,7,0,1,17920,16,4753838259
16917,424237780,170596444,594834224,8,0,1,7680,2,3207270376
16918,424295190,150511934,574807124,4,0,0,51200,2,6303305151
16919,424334230,170508772,594843002,8,0,1,47104,2,1977558297
16920,424399500,170482794,594882294,7,0,1,9216,16,10130268909
16921,424403550,170479730,594883280,8,0,1,1536,2,2558084114
16922,424420810,170486043,594906853,7,0,1,39424,16,9747815418
16923,424613250,150299555,574912805,7,0,0,47104,16,10583638659
16924,424640629,150460506,575101135,5,0,0,122880,11,10488527961
16925,424699330,150640817,575340147,7,0,0,324096,16,7478981218
16926,424720270,170187966,594908236,8,0,1,14848,2,10198695964
16927,424725070,150412832,575137902,4,0,0,27648,2,8356714233
16928,424743290,170188867,594932157,3,0,1,5632,3,1297084993
16929,424811400,170204591,595015991,7,0,1,75264,16,3011393365
16930,424811990,170268631,595080621,8,0,1,41984,2,1961864484
16931,424821790,150720623,575542413,7,0,0,311296,16,4869759373
16932,424835880,150906374,575742254,7,0,0,99840,16,10338438349
16933,424840170,170293525,595133695,8,0,1,25088,2,9861111234
16934,424908940,170224778,595133718,7,0,1,1024,16,3684525205
16935,424910270,150219185,575129455,7,0,0,69632,16,5604473459
16936,424912650,170221091,595133741,8,0,1,15360,2,2474815348
16937,424940240,170323541,595263781,8,0,1,37888,2,1488826940
16938,424942790,170321014,595263804,7,0,1,20992,16,9462152586
16939,424979699,150368987,575348686,5,0,0,27648,11,8398539786
16940,425018180,170245647,595263827,5,0,1,12800,11,2341612404
16941,425023260,170240590,595263850,8,0,1,3072,2,1817952651
16942,425045220,150666568,575711788,4,0,0,376832,2,9480488035
16943,425051900,170229647,595281547,8,0,1,32256,2,9159521011
16944,425052559,150302101,575354660,5,0,0,19456,11,5554094227
16945,425104380,170751214,595855594,5,0,1,9728,11,47625170
16946,425177099,170839164,596016263,4,0,1,21504,2,8736056978
16947,425226990,170838950,596065940,6,0,1,7680,7,3002493510
16948,425238879,149926004,575164883,5,0,0,9216,11,4866401671
16949,425271520,170919929,596191449,7,0,1,20992,16,8886134809
16950,425349399,150450908,575800307,5,0,0,95744,11,10191078460
16951,425359239,150191933,575551172,5,0,0,28672,11,9151675485
16952,425466420,170725052,596191472,5,0,1,4608,11,10137253544
16953,425484660,170834745,596319405,7,0,1,53248,16,2166061158
16954,425505990,150090913,575596903,4,0,0,150016,2,1077553639
16955,425517710,170805665,596323375,5,0,1,33280,11,5908947851
16956,425541610,150229456,575771066,7,0,0,89088,16,8917902768
16957,425565500,170757922,596323422,8,0,1,6144,2,1593483666
16958,425618040,170717760,596335800,5,0,1,55296,11,2494661740
16959,425641260,170701376,596342636,5,0,1,512,11,8237383579
16960,425655710,170690152,596345862,8,0,1,5120,2,9360870012
16961,425660059,170757763,596417822,0,0,1,70144,10,9894649332
16962,425696540,170722358,596418898,7,0,1,13312,16,6712180670
16963,425712680,150031196,575743876,7,0,0,5120,16,9421837151
16964,425744919,150061674,575806593,5,0,0,20480,11,2503748783
16965,425756420,170841236,596597656,7,0,1,9216,16,10177369762
16966,425772760,170824919,596597679,5,0,1,55296,11,6192460197
16967,425777010,170820692,596597702,5,0,1,19968,11,8165058513
16968,425804920,170820035,596624955,5,0,1,40960,11,3581567404
16969,425815320,170831318,596646638,8,0,1,2560,2,670876662
16970,425882210,150357505,576239715,4,0,0,197632,2,1161977618
16971,425886930,150362636,576249566,4,0,0,32256,2,10043228889
16972,425914360,170732624,596646984,7,0,1,512,16,10214762611
16973,425921700,150185442,576107142,4,0,0,318976,2,1625011469
16974,425976710,170678966,596655676,5,0,1,13824,11,4027335855
16975,426068900,150710783,576779683,4,0,0,164352,2,10093229788
16976,426069289,150196841,576266130,5,0,0,11776,11,84294048
16977,426083180,170573162,596656342,7,0,1,11264,16,4657523937
16978,426117590,170558191,596675781,7,0,1,10752,16,4530502610
16979,426166390,170511977,596678367,8,0,1,4096,2,7928595526
16980,426195230,170503224,596698454,8,0,1,34816,2,4860611331
16981,426212540,170486900,596699440,5,0,1,1536,11,9718847445
16982,426244930,170459016,596703946,7,0,1,7168,16,8173435287
16983,426310659,150050086,576360745,5,0,0,153600,11,3645519141
16984,426324780,170380472,596705252,8,0,1,2048,2,8995605312
16985,426341370,170383868,596725238,7,0,1,22528,16,503836244
16986,426342470,170441876,596784346,8,0,1,25088,2,3205762257
16987,426439070,170345622,596784692,8,0,1,512,2,3122054263
16988,426444289,150631343,577075632,5,0,0,39424,11,4715555976
16989,426448350,150010935,576459285,4,0,0,206336,2,10622425041
16990,426458620,151229154,577687774,7,0,0,905216,16,6180682551
16991,426469830,150370486,576840316,7,0,0,163840,16,587248815
16992,426490500,150573089,577063589,4,0,0,327680,2,6720100986
16993,426505609,150054192,576559801,5,0,0,154624,11,7020579028
16994,426556549,150407177,576963726,5,0,0,121856,11,3999529296
16995,426593070,170206693,596799763,5,0,1,24064,11,2348026140
16996,426606480,170216622,596823102,7,0,1,20992,16,10052255394
16997,426667800,150551819,577219619,7,0,0,84992,16,3396623553
16998,426871280,151049026,577920306,7,0,0,646144,16,4490354768
16999,426930781,169992877,596923658,9,0,1,58880,17,1552528245
17000,426961701,150761710,577723411,2,0,0,116736,4,3847376113
17001,426978640,169963163,596941803,2,0,1,25088,4,1424107248
17002,426982609,169968467,596951076,1,0,1,16896,5,676648492
17003,426983820,150994413,577978233,7,0,0,171520,16,6539860264
17004,426984020,169977712,596961732,3,0,1,17408,3,6520471231
17005,427032280,169984264,597016544,5,0,1,45568,11,2393729627
17006,427043260,150882690,577925950,4,0,0,17920,2,9065755185
17007,427057870,150948480,578006350,4,0,0,26624,2,2251409111
17008,427058520,150939641,577998161,4,0,0,65024,2,4982245869
17009,427063130,169953437,597016567,3,0,1,13312,3,6678068152
17010,427093730,169922860,597016590,3,0,1,20992,3,484808152
17011,427105960,169910653,597016613,3,0,1,8192,3,6911388602
17012,427106189,169910447,597016636,0,0,1,9216,10,4741029632
17013,427153550,150916696,578070246,7,0,0,209408,16,1497251325
17014,427160729,150927036,578087765,5,0,0,57344,11,5011246004
17015,427166109,169863550,597029659,0,0,1,35328,10,3216708480
17016,427203600,169831346,597034946,3,0,1,16896,3,3569139860
17017,427225059,169900256,597125315,4,0,1,1536,2,9117681194
17018,427279949,169845389,597125338,0,0,1,8192,10,483039929
17019,427286160,169840316,597126476,3,0,1,13312,3,840163190
17020,427326520,169799979,597126499,7,0,1,4096,16,4457375396
17021,427350270,150747898,578098168,7,0,0,33280,16,3149638894
17022,427376579,151720255,579096834,5,0,0,236544,11,2865955103
17023,427380860,150885716,578266576,4,0,0,32768,2,2304335845
17024,427399559,169726963,597126522,0,0,1,4608,10,3616706555
17025,427442569,169683976,597126545,1,0,1,15360,5,7615365064
17026,427454970,150722631,578177601,4,0,0,82944,2,10206234760
17027,427456799,169669769,597126568,1,0,1,2560,5,4611790407
17028,427459779,150972190,578431969,5,0,0,72192,11,3237005986
17029,427477439,169649152,597126591,1,0,1,8192,5,6469604986
17030,427483819,151694501,579178320,5,0,0,169984,11,2965528607
17031,427492390,151215495,578707885,3,0,0,2560,3,7290086434
17032,427501540,152783931,580285471,4,0,0,199680,2,2785339225
17033,427502719,169623895,597126614,1,0,1,512,5,6850337073
17034,427517380,169609460,597126840,7,0,1,27136,16,3156628073
17035,427529429,169597925,597127354,1,0,1,28160,5,1500943324
17036,427547639,169579738,597127377,1,0,1,47616,5,7840597171
17037,427555960,169571440,597127400,7,0,1,512,16,6238325778
17038,427570119,151454620,579024739,5,0,0,547328,11,1537293833
17039,427573179,151553318,579126497,5,0,0,97280,11,4622520158
17040,427598230,169563789,597162019,3,0,1,33792,3,5145106961
17041,427600109,169562064,597162173,0,0,1,8704,10,7832671882
17042,427604319,169560048,597164367,1,0,1,11264,5,6960163805
17043,427652580,169524993,597177573,7,0,1,1024,16,10399897705
17044,427712219,152685595,580397814,5,0,0,368640,11,9730549315
17045,427840799,169375729,597216528,1,0,1,34816,5,3013336451
17046,427843839,152635039,580478878,5,0,0,176640,11,205338883
17047,427858980,169377756,597236736,3,0,1,31744,3,8224122871
17048,427872389,150826367,578698756,5,0,0,7168,11,3532837395
17049,427877449,169377149,597254598,0,0,1,7168,10,1683108819
17050,427899030,169482403,597381433,3,0,1,89088,3,4780300193
17051,427899420,152056167,579955587,7,0,0,1166848,16,1168185476
17052,427942580,152282028,580224608,4,0,0,14848,2,8872337863
17053,428002159,152217902,580220061,5,0,0,340992,11,8289492994
17054,428008739,169582116,597590855,1,0,1,27648,5,5628467065
17055,428012150,169624706,597636856,3,0,1,20992,3,4160184684
17056,428019900,169636177,597656077,3,0,1,2560,3,5046271796
17057,428042079,169887731,597929810,0,0,1,39424,10,3565860572
17058,428072260,152043874,580116134,4,0,0,526848,2,10263216793
17059,428086089,169846130,597932219,4,0,1,7168,2,10275864969
17060,428101680,169862455,597964135,3,0,1,2048,3,6399477897
17061,428126459,169837699,597964158,1,0,1,512,5,4874844523
17062,428196420,152391264,580587684,4,0,0,7168,2,4444403473
17063,428211819,169752362,597964181,1,0,1,4608,5,2938552180
17064,428263719,152293655,580557374,5,0,0,257024,11,7923145917
17065,428282820,152302657,580585477,7,0,0,92160,16,1497890420
17066,428311079,152113925,580425004,5,0,0,89088,11,6473336327
17067,428326679,169637525,597964204,4,0,1,27136,2,5737181688
17068,428328590,169635661,597964251,7,0,1,32768,16,9068561400
17069,428330680,169633594,597964274,7,0,1,39936,16,7184906310
17070,428344849,169704242,598049091,4,0,1,38400,2,732350819
17071,428388140,169724696,598112836,7,0,1,66560,16,9307185491
17072,428389889,152473193,580863082,5,0,0,309248,11,2788091820
17073,428404570,169800373,598204943,3,0,1,9216,3,1660845712
17074,428465009,170417231,598882240,4,0,1,28672,2,4949440050
17075,428506240,152660660,581166900,7,0,0,395776,16,4645734913
17076,428548510,170741783,599290293,3,0,1,9728,3,2065509474
17077,428578710,152342583,580921293,4,0,0,190976,2,7117684345
17078,428615980,152068700,580684680,7,0,0,24576,16,4567406170
17079,428631949,170658367,599290316,4,0,1,512,2,1794208272
17080,428638260,152629079,581267339,4,0,0,320000,2,1933566283
17081,428654839,152700443,581355282,5,0,0,275968,11,1864524779
17082,428693709,152352534,581046243,5,0,0,359936,11,6783826165
17083,428724209,170739678,599463887,0,0,1,32256,10,8759196177
17084,428731919,170764304,599496223,0,0,1,3072,10,6019623259
17085,428739049,171015871,599754920,4,0,1,37376,2,6827807275
17086,428782009,170972934,599754943,0,0,1,1024,10,6797072395
17087,428844969,152519540,581364509,5,0,0,30208,11,897115591
17088,428850170,152571432,581421602,7,0,0,39936,16,432606445
17089,428887090,152384085,581271175,4,0,0,12288,2,9452314783
17090,428892619,170862838,599755457,0,0,1,57344,10,1302861774
17091,428963849,152205882,581169731,5,0,0,9216,11,8373110967
17092,428988140,170909556,599897696,8,0,1,39936,2,97351294
17093,429035650,170862069,599897719,8,0,1,4608,2,3546542200
17094,429047149,170918962,599966111,4,0,1,44544,2,7360281584
17095,429053730,170912404,599966134,7,0,1,46080,16,10664696365
17096,429057320,152352044,581409364,4,0,0,68096,2,9384501826
17097,429132030,170834127,599966157,8,0,1,15872,2,3707464375
17098,429180960,152191036,581371996,7,0,0,24064,16,3758880593
17099,429192940,170785749,599978689,7,0,1,512,16,8088623197
17100,429196759,152185244,581382003,5,0,0,32768,11,7926200518
17101,429204640,170922145,600126785,8,0,1,39936,2,9695909173
17102,429238149,152150389,581388538,5,0,0,20992,11,5308040132
17103,429238290,152372899,581611189,7,0,0,337920,16,6227653424
17104,429256260,170882115,600138375,8,0,1,44544,2,6337733407
17105,429260210,170878188,600138398,7,0,1,9728,16,5748907722
17106,429304989,152356370,581661359,5,0,0,9728,11,8184590302
17107,429313870,170879704,600193574,8,0,1,74752,2,2332004121
17108,429335280,170858317,600193597,7,0,1,8704,16,9599450539
17109,429381920,170813283,600195203,7,0,1,17920,16,8801668576
17110,429386719,170808998,600195717,4,0,1,12800,2,5150730932
17111,429407049,170799354,600206403,0,0,1,20992,10,5591891435
17112,429466389,170743491,600209880,4,0,1,9728,2,792715287
17113,429502560,170758898,600261458,7,0,1,15872,16,6559493588
17114,429600880,170660601,600261481,7,0,1,14848,16,7879402601
17115,429633269,170628235,600261504,0,0,1,3072,10,5727933364
17116,429650360,152292355,581942715,4,0,0,244224,2,9554043364
17117,429685090,170578142,600263232,7,0,1,6144,16,4755677135
17118,429703620,151948055,581651675,4,0,0,73728,2,10039559023
17119,429717830,170547143,600264973,7,0,1,24576,16,5759249770
17120,429765409,170514694,600280103,0,0,1,2560,10,6277687816
17121,429773830,170514108,600287938,8,0,1,24064,2,4456249972
17122,429775340,152031747,581807087,6,0,0,165376,7,4459731643
17123,429784040,152208841,581992881,4,0,0,125440,2,5112586442
17124,429792970,170529815,600322785,7,0,1,53248,16,1339808427
17125,429797000,170727006,600524006,8,0,1,21504,2,6055909665
17126,429806729,170769230,600575959,0,0,1,74240,10,4056768219
17127,429818760,170757222,600575982,7,0,1,3584,16,8988318983
17128,429838349,170737656,600576005,0,0,1,2560,10,7433745895
17129,429851090,170725608,600576698,2,0,1,46592,4,4879140780
17130,429865989,170711067,600577056,4,0,1,6656,2,1053295629
17131,429885849,170779430,600665279,4,0,1,80896,2,9666347321
17132,429902360,170763121,600665481,7,0,1,11264,16,5123318123
17133,429923230,170742274,600665504,7,0,1,1536,16,634964969
17134,429932179,170745022,600677201,4,0,1,10240,2,1943555327
17135,429932820,152013662,581946482,4,0,0,12288,2,3287593716
17136,429952420,152167968,582120388,7,0,0,143360,16,9299466539
17137,429957779,170721010,600678789,0,0,1,15872,10,1800730457
17138,429962950,170718570,600681520,8,0,1,512,2,5410483092
17139,429973519,151884541,581858060,5,0,0,34304,11,2661291365
17140,430110359,170738851,600849210,4,0,1,42496,2,2197731248
17141,430132480,170716753,600849233,7,0,1,6656,16,5669928807
17142,430216759,152217579,582434338,5,0,0,293888,11,6334770578
17143,430270830,170578426,600849256,7,0,1,9728,16,10539230981
17144,430273510,170597834,600871344,7,0,1,69120,16,359715955
17145,430352850,152264529,582617379,4,0,0,172032,2,9966327609
17146,430427260,170481189,600908449,8,0,1,52736,2,5083091098
17147,430428430,170494584,600923014,7,0,1,27136,16,5456245923
17148,430428779,170500946,600929725,0,0,1,13312,10,479402925
17149,430490959,170441352,600932311,0,0,1,4096,10,8844707934
17150,430575139,170360078,600935217,0,0,1,4608,10,4873553330
17151,430589010,170351379,600940389,8,0,1,8192,2,7987910291
17152,430623989,170363470,600987459,0,0,1,67584,10,1255107613
17153,430642520,170347845,600990365,7,0,1,4608,16,8995644059
17154,430655149,151807049,582462198,5,0,0,91136,11,6201929070
17155,430663250,170350284,601013534,8,0,1,34816,2,10060128455
17156,430854710,170168593,601023303,8,0,1,6656,2,7028817687
17157,430858110,170184545,601042655,8,0,1,40960,2,5281129235
17158,430932809,170116093,601048902,0,0,1,20480,10,10535056852
17159,431023420,170034522,601057942,3,0,1,32768,3,8847963002
17160,431050020,170016585,601066605,8,0,1,15872,2,5816511610
17161,431053670,170027869,601081539,8,0,1,9216,2,7506610730
17162,431065649,170024155,601089804,0,0,1,3584,10,6139486751
17163,431170540,169923348,601093888,8,0,1,18432,2,5395076579
17164,431184010,169915482,601099492,8,0,1,13824,2,7142906355
17165,431188890,170827110,602016000,8,0,1,100864,2,736292567
17166,431324199,170738203,602062402,1,0,1,11264,5,9670675036
17167,431410099,170769051,602179150,0,0,1,33792,10,2008499342
17168,431418160,151333782,582751942,7,0,0,56832,16,6302152538
17169,431425390,151667217,583092607,4,0,0,228864,2,2944300783
17170,431434310,170827460,602261770,8,0,1,41984,2,1540627100
17171,431449529,151568349,583017878,5,0,0,67584,11,5356054135
17172,431449609,170944133,602393742,0,0,1,28160,10,6622673993
17173,431473460,152435931,583909391,7,0,0,326656,16,8710697767
17174,431503119,152244932,583748051,5,0,0,590336,11,2074371568
17175,431513849,151677867,583191716,5,0,0,52224,11,8784842942
17176,431539899,151724014,583263913,5,0,0,230400,11,4216982760
17177,431540129,152028008,583568137,5,0,0,137728,11,3694217002
17178,431545219,170870877,602416096,1,0,1,7168,5,10342268117
17179,431681319,170813291,602494610,1,0,1,3072,5,643251548
17180,431687700,152111821,583799521,7,0,0,168448,16,309876261
17181,431700011,170794622,602494633,9,0,1,1024,17,2605565795
17182,431701449,171180300,602881749,1,0,1,73728,5,2208160697
17183,431725310,152234234,583959544,7,0,0,94208,16,3103913182
17184,431826930,152136693,583963623,4,0,0,13312,2,9117319287
17185,431985720,151434825,583420545,4,0,0,36864,2,7211858845
17186,432037060,170938039,602975099,8,0,1,15872,2,10399723427
17187,432342209,151687906,584030115,5,0,0,198656,11,7401731848
17188,432366210,170836085,603202295,7,0,1,74240,16,8584310220
17189,432414050,151709470,584123520,7,0,0,145408,16,2462624814
17190,432434810,151742830,584177640,4,0,0,121344,2,4801808991
17191,432438449,150860559,583299008,5,0,0,25088,11,6245021902
17192,432445620,150659022,583104642,7,0,0,39424,16,437010903
17193,432502960,151306880,583809840,4,0,0,33792,2,893656865
17194,432513680,151982508,584496188,4,0,0,180224,2,1292292611
17195,432945100,151024433,583969533,7,0,0,18944,16,3700103355
17196,432974320,151365134,584339454,7,0,0,96768,16,5947479564
17197,433041509,151236777,584278286,5,0,0,35840,11,7962193490
17198,433134389,170067929,603202318,4,0,1,9216,2,8773068096
17199,433185629,151409829,584595458,5,0,0,107008,11,7057868467
17200,433274510,150656307,583930817,7,0,0,70144,16,6033336673
17201,433291111,169911230,603202341,9,0,1,16896,17,6394412539
17202,433335709,151680012,585015721,5,0,0,524288,11,1360156343
17203,433369189,169833191,603202380,4,0,1,21504,2,826408339
17204,433398490,151701682,585100172,4,0,0,161792,2,5785325491
17205,433398840,151277304,584676144,7,0,0,43520,16,5739943049
17206,433432119,151995200,585427319,5,0,0,390656,11,10325440021
17207,433441090,151603606,585044696,4,0,0,41984,2,8168870339
17208,433584629,151447229,585031858,5,0,0,35328,11,1312328296
17209,433700499,151084924,584785423,5,0,0,6656,11,8900267668
17210,433700750,169502144,603202894,3,0,1,27648,3,4662208906
17211,433730350,151577795,585308145,4,0,0,297472,2,6740906027
17212,433763120,151454366,585217486,7,0,0,166912,16,8917319467
17213,433773360,151007493,584780853,4,0,0,8704,2,1759222506
17214,434036819,169166098,603202917,0,0,1,14336,10,7522366952
17215,434093099,151519256,585612355,5,0,0,89600,11,2814274296
17216,434147779,151018828,585166607,5,0,0,77312,11,622092251
17217,434149249,150871799,585021048,5,0,0,17408,11,6480434850
17218,434266350,151271352,585537702,4,0,0,109056,2,2359417981
17219,434346989,151149549,585496538,5,0,0,49664,11,2866111311
17220,434368630,168834310,603202940,3,0,1,37888,3,4364056266
17221,434512870,168709506,603222376,3,0,1,4096,3,4410756248
17222,434564529,168657870,603222399,0,0,1,2048,10,913129796
17223,434592090,168652062,603244152,3,0,1,10752,3,3723869606
17224,434655780,168588395,603244175,3,0,1,29696,3,4177142223
17225,435002129,150876195,585878324,5,0,0,539136,11,7125378245
17226,435014609,168229589,603244198,0,0,1,11776,10,1554085056
17227,435153659,150277583,585431242,5,0,0,12800,11,7309822722
17228,435160490,168139610,603300100,3,0,1,2048,3,7207688571
17229,435163849,150774893,585938742,5,0,0,198144,11,4815174502
17230,435294740,168007130,603301870,3,0,1,18944,3,2972502850
17231,435302039,150282985,585585024,5,0,0,16896,11,5445388873
17232,435314769,167989675,603304444,0,0,1,25088,10,5107749652
17233,435380960,167923523,603304483,6,0,1,8192,7,10309316869
17234,435451140,167853366,603304506,6,0,1,27648,7,4723813862
17235,435452610,167852722,603305332,6,0,1,22016,7,5515183199
17236,435495120,167811431,603306551,5,0,1,31232,11,9933374837
17237,435505070,167871321,603376391,6,0,1,38400,7,3643674366
17238,435537900,167838514,603376414,5,0,1,19456,11,8829336959
17239,435597400,167810313,603407713,5,0,1,32768,11,10048377926
17240,435650170,167758529,603408699,3,0,1,1536,3,2005929806
17241,435655050,167758795,603413845,6,0,1,8192,7,4874915995
17242,435670010,167794374,603464384,6,0,1,32768,7,1979749769
17243,435704620,167762427,603467047,5,0,1,29184,11,1696197220
17244,435734510,149930869,585665379,4,0,0,101376,2,9959148330
17245,435785790,169179067,604964857,6,0,1,27136,7,9388476530
17246,435812040,169152840,604964880,6,0,1,4608,7,2394381310
17247,435821540,169276017,605097557,5,0,1,28672,11,6616510421
17248,435829330,149602911,585432241,3,0,0,3072,3,943468033
17249,435888070,169235936,605124006,3,0,1,75264,3,5519950669
17250,435897710,149816231,585713941,4,0,0,159232,2,7722439486
17251,435996070,169226208,605222278,5,0,1,52736,11,9907333765
17252,436037689,149582684,585620373,5,0,0,26112,11,1732223299
17253,436092820,169130124,605222944,3,0,1,11264,3,8687388381
17254,436119860,169149463,605269323,3,0,1,7680,3,6711925826
17255,436145710,149434135,585579845,6,0,0,138240,7,7304720430
17256,436164760,149792366,585957126,4,0,0,22016,2,2631678610
17257,436165980,169326602,605492582,2,0,1,34816,4,3935921255
17258,436188300,149762087,585950387,4,0,0,37888,2,7227867744
17259,436224310,169268295,605492605,3,0,1,35840,3,10054701127
17260,436259599,169233029,605492628,0,0,1,11776,10,1738219947
17261,436317050,169175780,605492830,5,0,1,35328,11,2161228889
17262,436380680,169121439,605502119,5,0,1,4608,11,2220838519
17263,436397609,169212120,605609729,0,0,1,17408,10,237441289
17264,436404419,149957766,586362185,5,0,0,201216,11,10276064889
17265,436457330,149642361,586099691,4,0,0,112128,2,1008353857
17266,436531560,169082035,605613595,5,0,1,6144,11,10678410511
17267,436565970,169848885,606414855,3,0,1,64512,3,1608561409
17268,436574720,149490784,586065504,4,0,0,58880,2,5444607551
17269,436621150,169913774,606534924,5,0,1,6656,11,1759196523
17270,436630650,169904297,606534947,3,0,1,8192,3,5863213178
17271,436638680,170079432,606718112,3,0,1,45056,3,5774147017
17272,436648290,170069845,606718135,5,0,1,1024,11,6171284671
17273,436655080,170063078,606718158,2,0,1,3072,4,5858878185
17274,436698040,149866162,586564202,4,0,0,420864,2,280040218
17275,436781680,169940112,606721792,5,0,1,16384,11,4441972830
17276,436787340,149513514,586300854,4,0,0,236032,2,8435560059
17277,436799010,169922805,606721815,3,0,1,13312,3,2009350430
17278,436803950,170200185,607004135,8,0,1,38912,2,462337418
17279,436806120,170244017,607050137,3,0,1,16384,3,7947794377
17280,436843430,170206730,607050160,7,0,1,9216,16,8269195919
17281,436860490,170189693,607050183,7,0,1,12800,16,5903377368
17282,436864890,170325427,607190317,8,0,1,20480,2,701112163
17283,436877300,150010325,586887625,4,0,0,137728,2,4153768339
17284,436879159,149901064,586780223,8,0,0,2048,2,1839540671
17285,436886350,149893226,586779576,4,0,0,516608,2,10002484753
17286,436901920,170288452,607190372,8,0,1,37376,2,2670228273
17287,436905120,170286390,607191510,8,0,1,16896,2,7074557040
17288,436905409,170286615,607192024,0,0,1,11264,10,5472513922
17289,436922450,170368819,607291269,3,0,1,27648,3,4840315364
17290,436942220,170502366,607444586,7,0,1,22528,16,3702791076
17291,436952100,149893515,586845615,4,0,0,150016,2,2339888613
17292,436967790,171088037,608055827,8,0,1,20480,2,6030183579
17293,436995619,149803595,586799214,5,0,0,61952,11,6750014398
17294,437025819,149339688,586365507,8,0,0,10240,2,9639501045
17295,437032939,149329425,586362364,8,0,0,512,2,4984528939
17296,437064150,171228835,608292985,3,0,1,53248,3,5953156178
17297,437087159,149820058,586907217,5,0,0,36864,11,8495764446
17298,437090650,149868778,586959428,4,0,0,136704,2,9199912199
17299,437111160,149806539,586917699,4,0,0,33792,2,2560620861
17300,437186510,171189775,608376285,2,0,1,2560,4,782980429
17301,437196020,171193734,608389754,3,0,1,4608,3,10047152012
17302,437225770,149574091,586799861,4,0,0,2048,2,8576567174
17303,437227940,171287527,608515467,7,0,1,26112,16,6328731070
17304,437236600,149724731,586961331,3,0,0,6144,3,8377169502
17305,437238950,171276540,608515490,7,0,1,48640,16,1454046428
17306,437275070,149620892,586895962,4,0,0,27136,2,1841245792
17307,437304770,171294347,608599117,3,0,1,48128,3,4087481792
17308,437359390,171326466,608685856,2,0,1,22016,4,7173304984
17309,437388490,171346950,608735440,7,0,1,55296,16,6649784487
17310,437400729,149614236,587014965,8,0,0,1024,2,8699125823
17311,437406650,171415691,608822341,7,0,1,50688,16,8079656454
17312,437417270,171409385,608826655,5,0,1,17408,11,5533503175
17313,437440799,150400913,587841712,5,0,0,224256,11,2519810175
17314,437457260,171649109,609106369,5,0,1,47616,11,2148592816
17315,437485230,171714269,609199499,8,0,1,18432,2,4972776747
17316,437505170,171762117,609267287,2,0,1,14336,4,639682355
17317,437509040,150547688,588056728,4,0,0,152576,2,8861991146
17318,437537550,171739352,609276902,2,0,1,33280,4,3398278483
17319,437576179,149993802,587569981,5,0,0,401920,11,9543819131
17320,437582339,150292687,587875026,5,0,0,75264,11,7859158107
17321,437585170,171797699,609382869,2,0,1,16896,4,2559188284
17322,437597099,150094125,587691224,5,0,0,197632,11,324972478
17323,437604209,149743910,587348119,5,0,0,59392,11,1950067243
17324,437621240,171809418,609430658,5,0,1,27648,11,10539198620
17325,437627340,171902402,609529742,2,0,1,66048,4,8559580884
17326,437660700,171944735,609605435,3,0,1,23552,3,9001135805
17327,437678470,171926988,609605458,8,0,1,37888,2,5401198120
17328,437681980,171923501,609605481,3,0,1,17920,3,6995505772
17329,437683080,150563248,588246328,4,0,0,271360,2,7524272536
17330,437693130,172043950,609737080,7,0,1,49664,16,5695999465
17331,437698570,172038533,609737103,2,0,1,3072,4,4049125115
17332,437795730,171986035,609781765,3,0,1,45568,3,975878317
17333,437863180,171918608,609781788,8,0,1,15360,2,3742346317
17334,437873360,171913154,609786514,2,0,1,4096,4,10714103019
17335,437891929,150252229,588144158,5,0,0,286720,11,3184725843
17336,437908740,171877797,609786537,7,0,1,15360,16,7177199117
17337,438005630,171780930,609786560,2,0,1,20480,4,86359282
17338,438067859,149819122,587886981,8,0,0,1536,2,10150946021
17339,438076340,171710243,609786583,8,0,1,40960,2,2358025559
17340,438107539,149810235,587917774,8,0,0,512,2,4530040279
17341,438131890,171654716,609786606,8,0,1,14848,2,5418446125
17342,438175929,149226940,587402869,8,0,0,1024,2,5709378398
17343,438179790,150169279,588349069,4,0,0,265728,2,2777320505
17344,438200840,171637791,609838631,8,0,1,28672,2,4327223990
17345,438205090,171633564,609838654,2,0,1,2048,4,5063628873
17346,438206589,149957036,588163625,5,0,0,63488,11,4324530007
17347,438249020,171589657,609838677,2,0,1,21504,4,5656717437
17348,438278410,171560290,609838700,7,0,1,22016,16,5664357125
17349,438337020,171501727,609838747,7,0,1,20992,16,9232710827
17350,438405560,149604611,588010171,4,0,0,126464,2,7652138307
17351,438414319,149960288,588374607,5,0,0,71168,11,3065190564
17352,438476670,171455723,609932393,3,0,1,10752,3,6879480349
17353,438491109,149388007,587879116,8,0,0,512,2,508689825
17354,438509170,171423278,609932448,2,0,1,9728,4,1649670878
17355,438549740,171386686,609936426,6,0,1,45056,7,1500252472
17356,438552349,149715733,588268082,5,0,0,71168,11,7748346419
17357,438616140,171320800,609936940,7,0,1,31232,16,10090661688
17358,438620230,171316733,609936963,6,0,1,6144,7,5059645909
17359,438627720,171309266,609936986,2,0,1,1536,4,4588095118
17360,438647330,171331313,609978643,6,0,1,52736,7,10436558136
17361,438674490,171305433,609979923,7,0,1,14336,16,6160276885
17362,438728749,149622238,588350987,8,0,0,6144,2,1482939425
17363,438747600,171239656,609987256,3,0,1,4096,3,4092696634
17364,438794580,171251459,610046039,6,0,1,7680,7,4177503933
17365,438800200,171245862,610046062,6,0,1,15360,7,8462198906
17366,438808949,149823566,588632515,5,0,0,45056,11,2786395514
17367,438811130,171234955,610046085,5,0,1,1536,11,8572971948
17368,438829110,171217006,610046116,3,0,1,36352,3,8565823453
17369,438855161,171195224,610050385,6,0,1,9728,7,5263621335
17370,438856580,171238275,610094855,3,0,1,73216,3,7277519336
17371,438865379,149487337,588352716,8,0,0,5120,2,1164014928
17372,438868121,171227093,610095214,6,0,1,9728,7,1676870148
17373,438870120,171267367,610137487,3,0,1,24064,3,3920568545
17374,438910290,171236086,610146376,7,0,1,4608,16,4801983538
17375,438952819,149596962,588549781,8,0,0,15360,2,4976232680
17376,438963079,171215044,610178123,4,0,1,25600,2,9882264690
17377,439025219,149708695,588733914,5,0,0,20480,11,5408289475
17378,439034529,149794512,588829041,5,0,0,190976,11,10077196397
17379,439074909,149357151,588432060,8,0,0,3584,2,2163794724
17380,439086290,149825484,588911774,4,0,0,61952,2,7022530939
17381,439103050,171117219,610220269,2,0,1,3072,4,443282257
17382,439170560,149961409,589131969,4,0,0,215040,2,10218183973
17383,439229459,149470540,588699999,8,0,0,1536,2,1196692757
17384,439260670,170987856,610248526,2,0,1,31232,4,6618865486
17385,439269690,171719309,610988999,3,0,1,3072,3,4664916460
17386,439347400,171664990,611012390,3,0,1,9216,3,3408178196
17387,439394489,149449725,588844214,5,0,0,1536,11,7476504749
17388,439438640,171672580,611111220,2,0,1,27648,4,1198841602
17389,439480609,149554907,589035516,5,0,0,293376,11,6871753855
17390,439542189,149996559,589538748,8,0,0,2560,2,5405930761
17391,439563099,171866275,611429374,1,0,1,15360,5,6776303751
17392,439569879,149617880,589187759,5,0,0,180224,11,5771154444
17393,439580420,171848977,611429397,6,0,1,15872,7,4725386347
17394,439584730,171844690,611429420,3,0,1,18944,3,6279368565
17395,439639879,149094838,588734717,5,0,0,2560,11,10178896436
17396,439642990,171879007,611521997,3,0,1,1024,3,5628984136
17397,439649739,171904471,611554210,1,0,1,53248,5,698190897
17398,439659469,171894764,611554233,1,0,1,1536,5,1825858413
17399,439677529,149358478,589036007,8,0,0,1536,2,4271437110
17400,439737270,149727731,589465001,4,0,0,115712,2,7222574417
17401,439744211,171863287,611607498,9,0,1,20480,17,1012227132
17402,439753379,149283119,589036498,8,0,0,1536,2,2870516547
17403,439786111,171821410,611607521,9,0,1,4608,17,3310806668
17404,439845160,172067915,611913075,3,0,1,110080,3,6462012907
17405,439891670,172022173,611913843,3,0,1,11776,3,7686455336
17406,439899549,172098844,611998393,1,0,1,2048,5,5571331994
17407,439909810,172088606,611998416,3,0,1,5120,3,2439108812
17408,439921999,148991670,588913669,8,0,0,6144,2,8368514934
17409,439935171,172063268,611998439,6,0,1,8192,7,2860126094
17410,439946899,148882633,588829532,8,0,0,1536,2,7240827885
17411,440000111,171998351,611998462,9,0,1,11776,17,2563540281
17412,440030031,171968454,611998485,9,0,1,3584,17,4155889734
17413,440071220,149775382,589846602,4,0,0,593408,2,6297125612
17414,440079179,171952002,612031181,1,0,1,24064,5,6565071420
17415,440109039,149315150,589424189,8,0,0,9216,2,1789653448
17416,440114669,148938449,589053118,5,0,0,512,11,8022494818
17417,440115980,149210331,589326311,4,0,0,59904,2,7692994789
17418,440121339,149344621,589465960,5,0,0,3072,11,9562423864
17419,440151240,171897663,612048903,3,0,1,3584,3,6778637045
17420,440202409,171846517,612048926,1,0,1,9216,5,10573790550
17421,440233740,171815209,612048949,7,0,1,24576,16,4574859133
17422,440257270,171866161,612123431,3,0,1,8192,3,1669587104
17423,440264219,171970170,612234389,4,0,1,52224,2,9158493019
17424,440278799,149255858,589534657,5,0,0,1024,11,237791728
17425,440285840,171952708,612238548,3,0,1,12288,3,4442081837
17426,440291629,171947073,612238702,4,0,1,8704,2,5647990091
17427,440350871,171893528,612244399,9,0,1,18944,17,6466917654
17428,440351491,171936634,612288125,6,0,1,6656,7,6560019626
17429,440361970,149625735,589987705,4,0,0,398848,2,1043922696
17430,440394839,171962091,612356930,1,0,1,30720,5,7538380636
17431,440406179,171951824,612358003,4,0,1,16896,2,4578676884
17432,440427639,148879266,589306905,8,0,0,512,2,8203990424
17433,440459529,149106689,589566218,5,0,0,8192,11,6519503941
17434,440477919,171960385,612438304,4,0,1,61440,2,6019340755
17435,440520209,171918441,612438650,1,0,1,512,5,5832864115
17436,440529099,171913737,612442836,4,0,1,6656,2,2466034075
17437,440532200,171915681,612447881,3,0,1,10240,3,7880034909
17438,440548231,172075825,612624056,9,0,1,92160,17,10255763814
17439,440567330,172056749,612624079,6,0,1,5632,7,9973457798
17440,440577030,172065226,612642256,3,0,1,8704,3,8201174243
17441,440579961,172071115,612651076,9,0,1,23552,17,8877311128
17442,440629120,149231302,589860422,4,0,0,45056,2,4075249780
17443,440634619,172017443,612652062,4,0,1,1536,2,13960313
17444,440635519,172021689,612657208,4,0,1,8192,2,6396843394
17445,440640991,172023904,612664895,6,0,1,21504,7,2395694565
17446,440647579,148854465,589502044,8,0,0,6144,2,6942555815
17447,440649279,148968303,589617582,8,0,0,3072,2,6200938753
17448,440682640,149494658,590177298,4,0,0,32256,2,1724191125
17449,440709789,171955362,612665151,1,0,1,9216,5,3102280385
17450,440749379,172025188,612774567,1,0,1,66048,5,6753012908
17451,440749410,172133897,612883307,3,0,1,43520,3,1744784790
17452,440767619,172115711,612883330,4,0,1,3072,2,7574016957
17453,440822689,149165203,589987892,8,0,0,512,2,5055850907
17454,440830490,172053666,612884156,3,0,1,24576,3,33183065
17455,440870710,149296714,590167424,4,0,0,381440,2,4156214869
17456,440881330,172002849,612884179,6,0,1,2560,7,4208776089
17457,440887559,149102095,589989654,8,0,0,3584,2,2674476693
17458,440888390,171995812,612884202,3,0,1,2048,3,3122493730
17459,440899309,149278897,590178206,5,0,0,2048,11,3523592196
17460,440914120,171970105,612884225,3,0,1,23040,3,491708295
17461,440934230,149349093,590283323,4,0,0,241664,2,4496853687
17462,440996349,148992190,589988539,8,0,0,2048,2,884641531
17463,441049530,171864695,612914225,3,0,1,4608,3,2383671695
17464,441104160,149473116,590577276,4,0,0,348672,2,836426346
17465,441131069,171784782,612915851,1,0,1,2560,5,5369004025
17466,441248610,171681633,612930243,3,0,1,30720,3,8138276147
17467,441255259,149045890,590301149,8,0,0,6656,2,9306872198
17468,441277109,171664643,612941752,4,0,1,38400,2,9976363372
17469,441392179,171553871,612946050,1,0,1,1536,5,8993863945
17470,441399050,149228045,590627095,4,0,0,50688,2,5064852890
17471,441405739,148983276,590389015,5,0,0,1536,11,3215396420
17472,441407439,171544740,612952179,4,0,1,11776,2,10436450334
17473,441445989,171592768,613038757,1,0,1,48128,5,76187949
17474,441456779,148884514,590341293,5,0,0,8704,11,5690025977
17475,441468160,171620924,613089084,3,0,1,24064,3,7019296600
17476,441485779,149093062,590578841,5,0,0,512,11,4806927528
17477,441500179,171661547,613161726,4,0,1,20480,2,4674290986
17478,441509670,172083621,613593291,3,0,1,32256,3,10350676776
17479,441542879,149138439,590681318,8,0,0,3072,2,10662284223
17480,441550689,172042625,613593314,4,0,1,1024,2,8702964278
17481,441600889,171992448,613593337,4,0,1,5632,2,1492080486
17482,441606189,148817116,590423305,8,0,0,2048,2,5190408012
17483,441616439,148825421,590441860,5,0,0,4096,11,9031013945
17484,441670329,148907952,590578281,5,0,0,3072,11,9787751143
17485,441693850,172053645,613747495,5,0,1,61440,11,4190008020
17486,441739860,172009261,613749121,3,0,1,2560,3,1559292481
17487,441771969,148981184,590753153,5,0,0,512,11,1858509126
17488,441817250,171993389,613810639,8,0,1,18944,2,5794661104
17489,441821609,172013310,613834919,4,0,1,5120,2,616244561
17490,441836990,171997960,613834950,3,0,1,5120,3,1888836333
17491,441865449,148562092,590427541,8,0,0,4608,2,7647380361
17492,441917260,148835714,590752974,4,0,0,75776,2,6511327347
17493,441966760,149287636,591254396,4,0,0,192512,2,1858632873
17494,441984450,171850531,613834981,8,0,1,11264,2,6502859461
17495,441991719,171854896,613846615,1,0,1,10752,5,1000523472
17496,442009489,171853291,613862780,0,0,1,17408,10,6547802893
17497,442017279,148561337,590578616,5,0,0,1024,11,6233912043
17498,442032579,148690852,590723431,8,0,0,4608,2,7667242546
17499,442061419,171896251,613957670,1,0,1,31232,5,3257585308
17500,442091029,171959039,614050068,1,0,1,32768,5,5137694966
17501,442113160,149045089,591158249,4,0,0,413696,2,7444405406
17502,442151080,171899011,614050091,3,0,1,7168,3,8997956722
17503,442163849,172104679,614268528,4,0,1,44032,2,8804243299
17504,442231639,172036912,614268551,4,0,1,10240,2,1666726582
17505,442274979,171993595,614268574,1,0,1,512,5,8829349521
17506,442295619,149147725,591443344,8,0,0,3072,2,8843676081
17507,442305329,148853255,591158584,5,0,0,1024,11,5453863531
17508,442402480,171866117,614268597,2,0,1,23040,4,7952254007
17509,442440549,148755168,591195717,8,0,0,1024,2,1366175472
17510,442444669,171823951,614268620,1,0,1,512,5,209359549
17511,442446729,148391063,590837792,8,0,0,1024,2,9210788514
17512,442466709,171801934,614268643,1,0,1,7168,5,424120529
17513,442471299,148544032,591015331,8,0,0,4096,2,6991782378
17514,442477450,171848803,614326253,5,0,1,27136,11,9791229967
17515,442478870,171876484,614355354,3,0,1,15360,3,219618147
17516,442479310,148836529,591315839,4,0,0,90112,2,10123940373
17517,442483840,171872028,614355868,3,0,1,51712,3,2496358987
17518,442516960,148677417,591194377,4,0,0,117248,2,3755685181
17519,442552310,171985122,614537432,2,0,1,24064,4,8613190950
17520,442555030,172089386,614644416,5,0,1,20480,11,3191069045
17521,442562140,149047062,591609202,4,0,0,153088,2,3516413483
17522,442573530,148687285,591260815,4,0,0,20992,2,147866989
17523,442625499,172842328,615467827,4,0,1,4608,2,2107467117
17524,442646950,148639445,591286395,4,0,0,71680,2,1576601790
17525,442662019,148533363,591195382,5,0,0,3072,11,1036079393
17526,442667569,148596451,591264020,5,0,0,7680,11,9101816038
17527,442745170,172722680,615467850,5,0,1,1536,11,5057530593
17528,442853090,172614783,615467873,5,0,1,16896,11,4140035421
17529,442902569,148108616,591011185,8,0,0,1536,2,9966704780
17530,442953939,172581036,615534975,4,0,1,12800,2,5221874504
17531,442957510,172580051,615537561,6,0,1,4096,7,9379599214
17532,442961800,172577629,615539429,7,0,1,1536,16,454838852
17533,443014829,173396815,616411644,4,0,1,89600,2,6867627855
17534,443022789,148586927,591609716,5,0,0,512,11,6533203491
17535,443054339,148318489,591372828,5,0,0,2560,11,266326639
17536,443064920,173416502,616481422,8,0,1,38400,2,8536021611
17537,443134110,173347335,616481445,3,0,1,28672,3,7698974552
17538,443141629,148122857,591264486,5,0,0,1024,11,293929357
17539,443207130,173274338,616481468,3,0,1,47104,3,240929341
17540,443207480,173274011,616481491,8,0,1,9728,2,4108686260
17541,443254489,148007168,591261657,8,0,0,2560,2,4109167875
17542,443319849,173163092,616482941,1,0,1,30720,5,9930094317
17543,443381380,148617651,591999031,4,0,0,182784,2,6461255313
17544,443426579,147861781,591288360,5,0,0,6144,11,7653086143
17545,443428219,173086427,616514646,1,0,1,19968,5,2364519295
17546,443436709,173156643,616593352,4,0,1,33792,2,10568050844
17547,443478219,173115164,616593383,1,0,1,24576,5,10017322381
17548,443481199,173117626,616598825,1,0,1,17408,5,8815178983
17549,443481509,148322648,591804157,8,0,0,3072,2,473515034
17550,443528700,148244606,591773306,4,0,0,109568,2,385877305
17551,443555780,148160543,591716323,0,0,0,114176,10,242127852
17552,443680270,172947265,616627535,8,0,1,2560,2,4908108895
17553,443686029,147833140,591519169,8,0,0,512,2,4156739961
17554,443694140,148183922,591878062,4,0,0,85504,2,2027082087
17555,443715800,172925492,616641292,8,0,1,5632,2,8456025784
17556,443721140,172920175,616641315,6,0,1,7680,7,7021935251
17557,443762539,148116973,591879512,8,0,0,4608,2,3909775815
17558,443768739,173161097,616929836,1,0,1,31744,5,4885313892
17559,443788059,173142759,616930818,1,0,1,17408,5,3516448899
17560,443794179,173136662,616930841,1,0,1,10752,5,3514528155
17561,443857560,148284589,592142149,0,0,0,101888,10,10085121169
17562,443877901,173052963,616930864,6,0,1,6144,7,7416844848
17563,443969029,147640508,591609537,5,0,0,1024,11,8697030177
17564,443979390,172951497,616930887,8,0,1,6656,2,7485286152
17565,444009069,147991497,592000566,5,0,0,3072,11,122334504
17566,444063359,148285216,592348575,8,0,0,5632,2,7259936435
17567,444122740,172808170,616930910,8,0,1,10752,2,3376596793
17568,444129590,172801343,616930933,8,0,1,8192,2,2395672218
17569,444163159,148026798,592189957,8,0,0,9728,2,130291661
17570,444191189,147892306,592083495,8,0,0,1024,2,8791073669
17571,444216950,172785633,617002583,8,0,1,26624,2,3888721585
17572,444255610,172746996,617002606,6,0,1,11264,7,8199314710
17573,444266290,172736339,617002629,8,0,1,9728,2,60157491
17574,444274160,172728492,617002652,8,0,1,18432,2,9141301241
17575,444277600,148069190,592346790,4,0,0,244736,2,7228465119
17576,444291870,148300891,592592761,0,0,0,467456,10,8194206342
17577,444295040,172836570,617131610,6,0,1,52224,7,5414872180
17578,444337980,148060429,592398409,0,0,0,129536,10,9527931987
17579,444369329,172762304,617131633,4,0,1,512,2,6962939762
17580,444393850,172754365,617148215,6,0,1,12288,7,440841143
17581,444411099,172737139,617148238,4,0,1,31232,2,7548208935
17582,444422850,147660310,592083160,0,0,0,152576,10,1331769620
17583,444426380,172721881,617148261,8,0,1,1536,2,7636740167
17584,444436240,172712044,617148284,6,0,1,9216,7,978637319
17585,444443640,172704667,617148307,8,0,1,2560,2,8566193759
17586,444462540,147945408,592407948,0,0,0,31232,10,6722563213
17587,444479450,172668880,617148330,6,0,1,6144,7,10713233211
17588,444545249,147354342,591899591,5,0,0,1536,11,5678346318
17589,444585399,172562978,617148377,0,0,1,1024,10,5263568958
17590,444607209,148001666,592608875,5,0,0,1536,11,4922104495
17591,444666540,172481860,617148400,8,0,1,2560,2,8314367593
17592,444668901,172479522,617148423,9,0,1,6656,17,9951067030
17593,444723549,147446860,592170409,8,0,0,3072,2,9910024702
17594,444775609,172372837,617148446,4,0,1,12288,2,9343903061
17595,444834469,172406329,617240798,4,0,1,101888,2,5708765631
17596,444879790,147728594,592608384,4,0,0,51200,2,3661582566
17597,444884779,147114812,591999591,5,0,0,1536,11,6192975324
17598,444960140,147741115,592701255,0,0,0,297984,10,7354880089
17599,445020031,172220790,617240821,9,0,1,2048,17,6362232392
17600,445033339,147388479,592421818,5,0,0,6656,11,6457595691
17601,445044321,172196523,617240844,9,0,1,24576,17,3736922422
17602,445076211,172164656,617240867,9,0,1,2560,17,1519591629
17603,445079141,172161757,617240898,9,0,1,24064,17,6349395583
17604,445109750,147848732,592958482,4,0,0,168448,2,937619109
17605,445132590,147568938,592701528,3,0,0,512,3,606430128
17606,445141329,147562585,592703914,8,0,0,7680,2,7630556084
17607,445159689,147248617,592408306,8,0,0,1024,2,3824819147
17608,445177341,172063580,617240921,9,0,1,4096,17,4135329867
17609,445195851,172045093,617240944,9,0,1,512,17,8036620280
17610,445196810,147601015,592797825,4,0,0,58880,2,6133275326
17611,445235060,147492057,592727117,4,0,0,73728,2,8794015225
17612,445307019,172000795,617307814,4,0,1,34304,2,4364363089
17613,445312149,147297061,592609210,5,0,0,1024,11,8065979924
17614,445353629,147350932,592704561,8,0,0,2048,2,8564770215
17615,445382269,171927307,617309576,4,0,1,10752,2,5847861252
17616,445385740,171957974,617343714,7,0,1,52736,16,3622029224
17617,445418330,147191059,592609389,3,0,0,512,3,7273233276
17618,445452350,171891518,617343868,7,0,1,8704,16,10322968483
17619,445482299,147479661,592961960,8,0,0,11264,2,3703307412
17620,445489600,172296502,617786102,7,0,1,33792,16,8305164628
17621,445521439,172756201,618277640,4,0,1,70144,2,5196643788
17622,445525290,147278622,592803912,3,0,0,2560,3,9223358174
17623,445574169,147200566,592774735,8,0,0,11776,2,7721411885
17624,445616910,146993530,592610440,4,0,0,3072,2,10310490654
17625,445617110,147446564,593063674,0,0,0,148480,10,4876326101
17626,445621810,147592782,593214592,4,0,0,93184,2,2254248954
17627,445668841,172759831,618428672,9,0,1,32768,17,1193575521
17628,445673470,147125025,592798495,3,0,0,2048,3,8249080282
17629,445674119,172754576,618428695,4,0,1,1536,2,7553178239
17630,445676750,147176858,592853608,4,0,0,52224,2,2508685622
17631,445678379,147153407,592831786,8,0,0,3072,2,4494299195
17632,445680960,172747758,618428718,5,0,1,1024,11,3019446252
17633,445733239,147005832,592739071,5,0,0,12288,11,6420521342
17634,445739541,172694640,618434181,9,0,1,37888,17,3799167427
17635,445761120,172721540,618482660,7,0,1,1024,16,7723936600
17636,445766820,172721332,618488152,7,0,1,17920,16,5606828405
17637,445810821,172736331,618547152,9,0,1,6656,17,9062156075
17638,445846270,147321712,593167982,4,0,0,37376,2,9151930155
17639,445846699,146953791,592800490,8,0,0,4096,2,3437876660
17640,445849120,147470922,593320042,3,0,0,4608,3,8984316803
17641,445979250,147263289,593242539,0,0,0,91648,10,4871024309
17642,445994729,147069303,593064032,8,0,0,1024,2,753590553
17643,446011139,172558141,618569280,4,0,1,17920,2,486449931
17644,446039761,172640736,618680497,9,0,1,39424,17,4534507322
17645,446047100,172633756,618680856,7,0,1,9728,16,2135294408
17646,446060330,147453626,593513956,0,0,0,241664,10,8459040165
17647,446064830,172778719,618843549,7,0,1,23552,16,10621778939
17648,446069991,172773589,618843580,9,0,1,2048,17,9681670322
17649,446108810,172734793,618843603,7,0,1,15872,16,7126331236
17650,446120569,172723057,618843626,4,0,1,12800,2,5901903004
17651,446125760,172774977,618900737,7,0,1,50688,16,8826267575
17652,446127220,172773540,618900760,7,0,1,18432,16,2631697467
17653,446148610,147000077,593148687,3,0,0,512,3,8445046796
17654,446153739,172747044,618900783,4,0,1,18944,2,5838633169
17655,446158310,147243039,593401349,3,0,0,512,3,4790266436
17656,446164879,172899129,619064008,4,0,1,34816,2,6891905798
17657,446167879,147076399,593244278,8,0,0,5632,2,7735268803
17658,446196499,172867532,619064031,1,0,1,8704,5,7455950004
17659,446226280,147560111,593786391,0,0,0,260608,10,5404320489
17660,446229269,172852615,619081884,4,0,1,7680,2,3899956556
17661,446246590,147346908,593593498,0,0,0,244224,10,10608009799
17662,446267990,147035859,593303849,3,0,0,4608,3,4423467208
17663,446296270,172862568,619158838,7,0,1,4096,16,10336792663
17664,446318420,147388521,593706941,0,0,0,253440,10,9119181564
17665,446343139,146990754,593333893,5,0,0,6656,11,3908131233
17666,446365620,172793241,619158861,2,0,1,2048,4,1641695518
17667,446365849,172793682,619159531,4,0,1,1536,2,4665781480
17668,446366449,172793105,619159554,4,0,1,3072,2,7269452958
17669,446367589,147226088,593593677,5,0,0,512,11,4255989256
17670,446387380,147424250,593811630,6,0,0,77824,7,6461152228
17671,446409659,147378205,593787864,5,0,0,4608,11,1504142613
17672,446426319,172733258,619159577,4,0,1,4096,2,6889823145
17673,446429731,172729893,619159624,9,0,1,31744,17,5245341382
17674,446438890,148207011,594645901,0,0,0,149504,10,171674655
17675,446469109,172690538,619159647,4,0,1,1024,2,10438663396
17676,446471700,147826121,594297821,7,0,0,200192,16,1120137253
17677,446502720,147662352,594165072,3,0,0,65024,3,259373188
17678,446512760,147365458,593878218,7,0,0,118784,16,8382214951
17679,446543750,148140369,594684119,7,0,0,66048,16,6360138743
17680,446559950,147474439,594034389,0,0,0,2048,10,4286239298
17681,446586140,172573538,619159678,7,0,1,19456,16,2124819070
17682,446587191,172583632,619170823,9,0,1,3584,17,3858068681
17683,446604600,146994403,593599003,0,0,0,6144,10,4942816478
17684,446609800,147618308,594228108,0,0,0,18944,10,6556697464
17685,446629520,147592591,594222111,4,0,0,163328,2,3581083801
17686,446671630,147824936,594496566,3,0,0,206336,3,4217494743
17687,446685529,172485317,619170846,4,0,1,5120,2,4760925124
17688,446901701,172269168,619170869,9,0,1,12800,17,896607385
17689,446902709,172510240,619412949,4,0,1,37376,2,8483450732
17690,446938460,147378278,594316738,3,0,0,48128,3,1748610049
17691,446942140,172470832,619412972,7,0,1,11264,16,8820376156
17692,446972579,147194567,594167146,8,0,0,1536,2,3180277473
17693,447051360,172361635,619412995,7,0,1,3072,16,2048052565
17694,447076269,147026954,594103223,8,0,0,512,2,8214167569
17695,447083640,172329402,619413042,8,0,1,5120,2,3767759062
17696,447093181,172319884,619413065,9,0,1,3072,17,4298335638
17697,447119279,147110550,594229829,5,0,0,1536,11,3480878615
17698,447152979,146896753,594049732,5,0,0,2560,11,9418828677
17699,447192399,147107520,594299919,5,0,0,3072,11,6398728133
17700,447199981,172235750,619435731,9,0,1,6656,17,5266583554
17701,447202329,146891931,594094260,5,0,0,3072,11,2564291120
17702,447222330,147275507,594497837,0,0,0,4096,10,5611576017
17703,447232900,147095972,594328872,4,0,0,512,2,8451136643
17704,447242409,146649389,593891798,8,0,0,512,2,2201527047
17705,447278179,146750066,594028245,5,0,0,2048,11,6529299033
17706,447281319,146940994,594222313,8,0,0,512,2,6917311993
17707,447420889,172014865,619435754,4,0,1,3072,2,2766409623
17708,447451259,146678223,594129482,8,0,0,1024,2,4209585620
17709,447474140,146650927,594125067,0,0,0,6144,10,7802819147
17710,447488189,146678466,594166655,5,0,0,5120,11,877797040
17711,447497651,171938126,619435777,9,0,1,64000,17,3816776428
17712,447514160,171959727,619473887,6,0,1,25600,7,1981788711
17713,447545640,147276099,594821739,3,0,0,333824,3,8895809152
17714,447561040,146737920,594298960,0,0,0,3584,10,6499823009
17715,447577329,171896581,619473910,4,0,1,22528,2,2700785609
17716,447659029,171814904,619473933,4,0,1,2560,2,8032093164
17717,447661791,171814216,619476007,9,0,1,21504,17,8057060860
17718,447693619,147017792,594711411,5,0,0,1536,11,8484630721
17719,447705649,171770381,619476030,4,0,1,11264,2,6390771376
17720,447710779,171765274,619476053,0,0,1,8192,10,5223213907
17721,447720480,146847877,594568357,3,0,0,56320,3,4113704349
17722,447727979,171748097,619476076,0,0,1,28672,10,10386722294
17723,447758499,171717600,619476099,4,0,1,25600,2,1180689306
17724,447791631,171723358,619514989,9,0,1,512,17,4730474522
17725,447823499,171691513,619515012,4,0,1,2048,2,6444043127
17726,447843201,171671834,619515035,6,0,1,3584,7,2003188988
17727,448001449,171513609,619515058,4,0,1,11776,2,10340200295
17728,448042419,146455597,594498016,8,0,0,512,2,2345808309
17729,448044939,171470142,619515081,0,0,1,13312,10,4327961122
17730,448074329,171440775,619515104,4,0,1,14848,2,1050671332
17731,448141969,171374117,619516086,0,0,1,4608,10,8703488903
17732,448168831,171347278,619516109,6,0,1,1536,7,1725531652
17733,448177639,171338493,619516132,4,0,1,16896,2,2389517365
17734,448211271,171354845,619566116,9,0,1,21504,17,2639013577
17735,448223561,171342578,619566139,6,0,1,1536,7,9978516193
17736,448226330,146437580,594663910,3,0,0,58880,3,9546695472
17737,448271589,146226629,594498218,8,0,0,512,2,10678091273
17738,448276711,171302430,619579141,9,0,1,54272,17,6419235914
17739,448316539,146545762,594862301,8,0,0,3584,2,5263529717
17740,448388519,171246975,619635494,0,0,1,1536,10,7905321551
17741,448403220,146507692,594910912,0,0,0,2560,10,5385601895
17742,448486130,171195018,619681148,2,0,1,42496,4,1816171789
17743,448500219,171513621,620013840,4,0,1,12288,2,7065267550
17744,448506490,146327711,594834201,3,0,0,40448,3,6418353894
17745,448516231,171814419,620330650,9,0,1,6656,17,4927287768
17746,448516319,146398631,594914950,5,0,0,4608,11,4784908498
17747,448529760,146445694,594975454,3,0,0,24576,3,9383989845
17748,448533410,171838120,620371530,2,0,1,7168,4,667409784
17749,448564151,172010791,620574942,6,0,1,82944,7,4117922087
17750,448602640,146658599,595261239,4,0,0,241152,2,3258423305
17751,448616600,171968528,620585128,2,0,1,8704,4,9054749403
17752,448621610,146511259,595132869,3,0,0,139264,3,7260808893
17753,448632109,146813398,595445507,5,0,0,1024,11,3129194082
17754,448647189,172238072,620885261,4,0,1,34304,2,9481931132
17755,448650959,172250774,620901733,4,0,1,35328,2,2157352971
17756,448658779,172242977,620901756,0,0,1,8704,10,6559281350
17757,448756071,172145708,620901779,9,0,1,3072,17,273093809
17758,448776399,172131822,620908221,4,0,1,20992,2,9022711412
17759,448816121,172092123,620908244,6,0,1,10240,7,4127673573
17760,448833370,146354370,595187740,3,0,0,177152,3,8970188864
17761,448843951,172079479,620923430,9,0,1,7680,17,2652441854
17762,448871189,145963214,594834403,5,0,0,512,11,9256320781
17763,448877059,172143193,621020252,4,0,1,24064,2,9029883648
17764,448890031,172130244,621020275,6,0,1,18944,7,6299064406
17765,448930011,172200012,621130023,9,0,1,68096,17,10433017709
17766,448938420,172199450,621137870,2,0,1,17920,4,5044445136
17767,448943841,172204698,621148539,6,0,1,8192,7,886796894
17768,448959671,172372063,621331734,9,0,1,26624,17,9685987932
17769,449087899,146175859,595263758,8,0,0,8192,2,9027183108
17770,449142709,172239854,621382563,0,0,1,38912,10,480196243
17771,449198370,146503679,595702049,3,0,0,131072,3,4192795302
17772,449210650,145923022,595133672,0,0,0,2560,10,2781770819
17773,449220599,172296331,621516930,4,0,1,38400,2,9535043379
17774,449255361,172261592,621516953,6,0,1,5120,7,5998120165
17775,449449199,145908617,595357816,5,0,0,1536,11,770553339
17776,449477169,172039807,621516976,4,0,1,2560,2,5726507779
17777,449518799,172083422,621602221,4,0,1,39936,2,5893163893
17778,449632459,145700696,595333155,8,0,0,3584,2,6476932250
17779,449636030,145644379,595280409,3,0,0,54272,3,2357435760
17780,449655449,145626075,595281524,8,0,0,3584,2,2984725438
17781,449678690,171923554,621602244,2,0,1,3072,4,4605912133
17782,449683931,171928234,621612165,6,0,1,96256,7,2943258638
17783,449716400,146299840,596016240,4,0,0,507904,2,2134333049
17784,449724060,145630708,595354768,4,0,0,6656,2,7338621675
17785,449749540,146058140,595807680,3,0,0,161792,3,2950518511
17786,449782770,146399117,596181887,4,0,0,380416,2,1200344785
17787,449851860,146213878,596065738,3,0,0,162304,3,5670693368
17788,449884530,146434852,596319382,4,0,0,223744,2,5029036881
17789,449944389,145568396,595512785,5,0,0,512,11,9186329944
17790,449969609,145734335,595703944,8,0,0,6144,2,9232522471
17791,449974659,146276528,596251187,8,0,0,4096,2,4082029110
17792,449981550,146267875,596249425,3,0,0,166912,3,2365579355
17793,449983440,146339888,596323328,4,0,0,12800,2,3796930526
17794,449998290,146067627,596065917,0,0,0,512,10,9843746526
17795,450006291,171733370,621739661,6,0,1,98816,7,7365899377
17796,450011640,146324129,596335769,4,0,0,40448,2,4291723432
17797,450034160,146373520,596407680,3,0,0,148480,3,7547352758
17798,450044459,146205457,596249916,8,0,0,1536,2,8560801954
17799,450070669,171669031,621739700,4,0,1,36864,2,1808591815
17800,450122890,146068536,596191426,4,0,0,31232,2,7040606453
17801,450133429,146062122,596195551,5,0,0,13312,11,1862520911
17802,450170350,146028188,596198538,4,0,0,9728,2,6848628108
17803,450189209,171550530,621739739,1,0,1,7168,5,7576646300
17804,450197360,146345650,596543010,3,0,0,339456,3,6124560872
17805,450289829,146336226,596626055,8,0,0,1536,2,4613468912
17806,450317361,171422401,621739762,6,0,1,95232,7,2828175657
17807,450324040,146273593,596597633,3,0,0,179200,3,2174178999
17808,450381589,171386352,621767941,4,0,1,29184,2,886691675
17809,450395769,171372195,621767964,4,0,1,4608,2,5645215712
17810,450417420,171731285,622148705,6,0,1,342016,7,822168911
17811,450421500,171769023,622190523,6,0,1,155136,7,1047556198
17812,450422070,146201863,596623933,3,0,0,86016,3,10325352083
17813,450488680,146391522,596880202,4,0,0,179712,2,6269018893
17814,450491949,171703720,622195669,4,0,1,8192,2,3373369114
17815,450531589,145876582,596408171,5,0,0,1536,11,4179125086
17816,450533069,171692000,622225069,1,0,1,60416,5,8014157872
17817,450588279,171643904,622232183,1,0,1,18944,5,8026372758
17818,450662440,171687630,622350070,6,0,1,169984,7,6121880923
17819,450671659,145953233,596624892,5,0,0,3072,11,4331105300
17820,450690410,146326111,597016521,3,0,0,157696,3,3907229158
17821,450740400,171618011,622358411,3,0,1,39936,3,2544864357
17822,450761139,171637740,622398879,4,0,1,33792,2,2378978144
17823,450765959,145859487,596625446,8,0,0,1536,2,5354865617
17824,450802169,171597376,622399545,4,0,1,1024,2,10667484721
17825,450851699,145970962,596822661,8,0,0,3584,2,10134625432
17826,450879080,146246212,597125292,3,0,0,293888,3,5095173921
17827,450889059,145925370,596814429,8,0,0,512,2,262040441
17828,451059079,145739132,596798211,5,0,0,5120,11,2679163038
17829,451066720,171333389,622400109,5,0,1,10752,11,7109376238
17830,451178460,171226936,622405396,6,0,1,16896,7,6361234256
17831,451236830,171168822,622405652,6,0,1,9216,7,5374262020
17832,451267061,171288990,622556051,6,0,1,244224,7,764012030
17833,451272381,171508398,622780779,6,0,1,329216,7,10078402480
17834,451319330,145378259,596697589,0,0,0,512,10,5096082335
17835,451343130,171455328,622798458,8,0,1,34304,2,4199313581
17836,451401069,171421217,622822286,4,0,1,31744,2,6760507091
17837,451402549,171460850,622863399,4,0,1,19456,2,5234197851
17838,451412829,171454382,622867211,4,0,1,3072,2,3949172123
17839,451427049,171444668,622871717,4,0,1,7168,2,3883658872
17840,451447900,171430500,622878400,3,0,1,20480,3,8841733399
17841,451452010,171428016,622880026,3,0,1,2560,3,6994885718
17842,451454160,171437806,622891966,2,0,1,2048,4,330179644
17843,451458970,171436542,622895512,8,0,1,5632,2,6630605315
17844,451472209,171428897,622901106,4,0,1,18432,2,5655556757
17845,451480580,171422996,622903576,8,0,1,3584,2,4901587947
17846,451530500,171379396,622909896,3,0,1,35328,3,8507898538
17847,451539179,145342474,596881653,5,0,0,4608,11,4159369608
17848,451549721,171364041,622913762,6,0,1,6144,7,4992477190
17849,451569879,145325929,596895808,8,0,0,8192,2,10325846121
17850,451611480,171310476,622921956,8,0,1,33792,2,8894004895
17851,451663990,171301389,622965379,6,0,1,96768,7,831198032
17852,451664650,171305235,622969885,8,0,1,7168,2,5182959118
17853,451696289,171284431,622980720,4,0,1,15360,2,6228601967
17854,451705259,145256450,596961709,8,0,0,10752,2,7333716348
17855,451705959,145421372,597127331,8,0,0,1536,2,10504742385
17856,451728399,145299173,597027572,8,0,0,1536,2,2366175609
17857,451758331,171232585,622990916,9,0,1,31232,17,8407773041
17858,451759860,145456645,597216505,4,0,0,65536,2,1020309446
17859,451768780,171232017,623000797,3,0,1,10240,3,3834603410
17860,451808021,171505977,623313998,6,0,1,174080,7,8094529330
17861,451815910,171637675,623453585,3,0,1,36864,3,4004538504
17862,451825739,145300714,597126453,8,0,0,3584,2,4641550866
17863,451845240,171874440,623719680,3,0,1,79872,3,4076905496
17864,451848840,171870863,623719703,3,0,1,2560,3,8453932198
17865,451857219,171862507,623719726,4,0,1,6656,2,2923261218
17866,451866321,171853771,623720092,6,0,1,65024,7,9021728571
17867,451872859,145253934,597126793,8,0,0,512,2,10067286110
17868,451910340,145394485,597304825,4,0,0,56832,2,7490848534
17869,451924520,171795595,623720115,3,0,1,13824,3,8850239103
17870,451955429,171764709,623720138,1,0,1,32768,5,9550086016
17871,451988690,171731471,623720161,3,0,1,36864,3,348144671
17872,452032010,145426360,597458370,3,0,0,57344,3,448961769
17873,452066070,145126484,597192554,0,0,0,512,10,6228099825
17874,452106089,145176737,597282826,8,0,0,6144,2,4104558292
17875,452135539,145059681,597195220,5,0,0,2048,11,10629027263
17876,452140359,145102956,597243315,5,0,0,3072,11,9420637622
17877,452156041,171658275,623814316,6,0,1,215040,7,7051839444
17878,452167370,145881658,598049028,3,0,0,241152,3,8351759945
17879,452201790,171612549,623814339,3,0,1,9728,3,1017454209
17880,452202919,171627981,623830900,4,0,1,34304,2,10003129125
17881,452204330,171631067,623835397,3,0,1,512,3,156385299
17882,452240820,145723113,597963933,4,0,0,3072,2,6027465196
17883,452264889,171573734,623838623,4,0,1,5120,2,5660790085
17884,452271569,171571880,623843449,4,0,1,7680,2,7325510059
17885,452297099,145246576,597543675,5,0,0,3584,11,3315958448
17886,452346260,171503636,623849896,6,0,1,15872,7,7707009865
17887,452349230,171534205,623883435,3,0,1,64000,3,4821515579
17888,452352200,145700213,598052413,0,0,0,7680,10,5022597319
17889,452378540,145551247,597929787,3,0,0,472064,3,7300969061
17890,452404130,171485634,623889764,3,0,1,22016,3,4178866789
17891,452409949,145522247,597932196,8,0,0,6656,2,6402843385
17892,452460310,171431400,623891710,3,0,1,3072,3,10384935442
17893,452470569,145129860,597600429,5,0,0,12288,11,9963709082
17894,452489560,146026434,598515994,4,0,0,359936,2,6074913748
17895,452508300,145454674,597962974,3,0,0,100864,3,5849731963
17896,452676809,171224968,623901777,4,0,1,2048,2,5361772448
17897,452736391,171184545,623920936,6,0,1,48128,7,9832953004
17898,452794101,171171856,623965957,6,0,1,86016,7,5449823857
17899,452803271,171200210,624003481,6,0,1,47104,7,5117799210
17900,452834890,171199170,624034060,6,0,1,56320,7,5819533081
17901,452880049,145170001,598050050,5,0,0,3072,11,1886271003
17902,452886900,171272749,624159649,3,0,1,69120,3,3750492881
17903,452898599,145154484,598053083,5,0,0,512,11,8902580646
17904,452925000,145279920,598204920,4,0,0,232960,2,8434414141
17905,452956621,171353863,624310484,6,0,1,111616,7,8407515621
17906,453003270,145243505,598246775,4,0,0,128512,2,3662528436
17907,453020510,144909635,597930145,3,0,0,1024,3,8921230422
17908,453080370,144895159,597975529,4,0,0,36864,2,2551148992
17909,453108121,171268887,624377008,6,0,1,65024,7,7996184704
17910,453149449,171256625,624406074,4,0,1,11776,2,6354954482
17911,453187610,171219949,624407559,3,0,1,15360,3,2209856276
17912,453193579,145323218,598516797,5,0,0,2560,11,6012807650
17913,453228959,144871841,598100800,5,0,0,2048,11,8548143707
17914,453253780,144865003,598118783,0,0,0,1024,10,3655100075
17915,453369760,145036543,598406303,3,0,0,80384,3,9761639844
17916,453384049,144668855,598052904,5,0,0,1536,11,3392045471
17917,453422090,144542022,597964112,0,0,0,512,10,10430198770
17918,453436370,144842332,598278702,3,0,0,40448,3,9730749365
17919,453460169,170949555,624409724,4,0,1,512,2,10664866541
17920,453486619,170923669,624410288,4,0,1,10752,2,9139054003
17921,453547609,144657513,598205122,8,0,0,512,2,2919955308
17922,453559439,170852942,624412381,4,0,1,1536,2,3061032614
17923,453568990,144484280,598053270,0,0,0,512,10,4457329235
17924,453570500,145163026,598733526,4,0,0,225280,2,1328166915
17925,453583000,144795769,598378769,0,0,0,1024,10,3072648502
17926,453621670,145668600,599290270,4,0,0,639488,2,8372374437
17927,453694481,170726842,624421323,9,0,1,12800,17,4373089438
17928,453745571,170676098,624421669,9,0,1,512,17,4081367752
17929,453833020,144772386,598605406,0,0,0,7168,10,7575471038
17930,453840671,170581344,624422015,9,0,1,512,17,10542314440
17931,453879710,144680634,598560344,3,0,0,142848,3,3629694140
17932,453885019,170539582,624424601,4,0,1,4096,2,337844822
17933,453905051,170523736,624428787,9,0,1,6656,17,5642181785
17934,453936561,170510806,624447367,9,0,1,21504,17,9340535581
17935,453939830,145516754,599456584,4,0,0,332288,2,8070387360
17936,453973109,170555099,624528208,4,0,1,50688,2,9651289260
17937,453994640,144906349,598900989,0,0,0,512,10,5215994094
17938,454029551,170498680,624528231,9,0,1,512,17,2544807498
17939,454149270,145177174,599326444,4,0,0,103936,2,2542549466
17940,454209251,170319003,624528254,9,0,1,10240,17,7313464117
17941,454216870,145909892,600126762,3,0,0,389632,3,4924369178
17942,454234490,145574030,599808520,3,0,0,174080,3,2984404229
17943,454246760,145506398,599753158,4,0,0,613888,2,4038188891
17944,454257729,170270548,624528277,4,0,1,6144,2,7696858912
17945,454265100,144470945,598736045,0,0,0,8192,10,8937244210
17946,454302029,145837328,600139357,5,0,0,3072,11,1109050496
17947,454318341,170209959,624528300,9,0,1,10752,17,4965879829
17948,454327560,145570113,599897673,3,0,0,284672,3,6612595700
17949,454365539,144970518,599336057,5,0,0,512,11,7344033330
17950,454373979,144920774,599294753,8,0,0,4096,2,9612732111
17951,454374869,144666372,599041241,5,0,0,3072,11,9651374649
17952,454411409,144882073,599293482,8,0,0,5120,2,6836532426
17953,454422049,170240791,624662840,4,0,1,131072,2,1509615467
17954,454470680,170192183,624662863,3,0,1,33792,3,6038026974
17955,454479629,144977134,599456763,5,0,0,512,11,4985975159
17956,454496729,144795170,599291899,8,0,0,5120,2,10583783313
17957,454497500,146026483,600523983,4,0,0,544256,2,4810794995
17958,454521489,170144886,624666375,4,0,1,29696,2,6072929087
17959,454562620,145698636,600261256,4,0,0,107520,2,7294959726
17960,454641279,145114155,599755434,8,0,0,1536,2,10432645957
17961,454661229,145149038,599810267,8,0,0,5632,2,10301157303
17962,454669449,145085448,599754897,8,0,0,5632,2,8852504741
17963,454692060,169981830,624673890,3,0,1,23552,3,6672996211
17964,454694800,145271288,599966088,3,0,0,141312,3,7887041933
17965,454756020,169918741,624674761,3,0,1,12288,3,5209962723
17966,454771921,169953795,624725716,9,0,1,27648,17,160927035
17967,454867780,145270572,600138352,3,0,0,37888,3,8429723860
17968,454994960,169855521,624850481,8,0,1,18432,2,6424113655
17969,455041429,144769485,599810914,5,0,0,2048,11,2406662604
17970,455088010,145270122,600358132,4,0,0,115712,2,4372387686
17971,455099979,145475957,600575936,8,0,0,7680,2,3729301901
17972,455114890,145091458,600206348,3,0,0,34816,3,2526125974
17973,455124279,145071415,600195694,5,0,0,1536,11,10346230762
17974,455130379,145131056,600261435,5,0,0,512,11,5884163330
17975,455143249,170230734,625373983,4,0,1,12288,2,10305767803
17976,455158670,145409374,600568044,3,0,0,138752,3,10200267629
17977,455159290,145033918,600193208,3,0,0,176640,3,8429896179
17978,455168949,145026231,600195180,8,0,0,5120,2,5031895645
17979,455252080,145321314,600573394,0,0,0,7680,10,3920937629
17980,455289909,145286431,600576340,5,0,0,1024,11,9159687291
17981,455314309,170158379,625472688,4,0,1,4096,2,2743089916
17982,455381110,170092039,625473149,8,0,1,10240,2,1912364781
17983,455423969,170060445,625484414,4,0,1,4608,2,1267134556
17984,455439769,170049151,625488920,4,0,1,7168,2,2033442577
17985,455453109,170101713,625554822,4,0,1,11776,2,4488575369
17986,455463870,144729673,600193543,0,0,0,1024,10,8838103566
17987,455467769,170173566,625641335,4,0,1,50688,2,4696740589
17988,455488870,170156011,625644881,8,0,1,5632,2,4143963290
17989,455499249,144788191,600287440,8,0,0,1024,2,6059724357
17990,455588590,170069535,625658125,8,0,1,18944,2,9063655034
17991,455623839,144947192,600571031,8,0,0,9728,2,3629023424
17992,455638769,144886976,600525745,5,0,0,5632,11,2732334441
17993,455697119,144605907,600303026,8,0,0,512,2,9119528688
17994,455788920,169933820,625722740,8,0,1,3072,2,778605663
17995,455792130,144781443,600573573,0,0,0,512,10,6698403493
17996,455873179,170426700,626299879,4,0,1,31232,2,6068637897
17997,455876399,144900491,600776890,5,0,0,14336,11,1462709126
17998,455891309,170412436,626303745,4,0,1,6144,2,10663467712
17999,455930199,170799855,626730054,4,0,1,68608,2,3770020489
18000,455939189,144637844,600577033,5,0,0,1024,11,7207859626
18001,455966740,144698516,600665256,3,0,0,195584,3,6808332076
18002,455979630,170750447,626730077,8,0,1,11776,2,3147434496
18003,455980669,171379900,627360569,4,0,1,119808,2,8621292998
18004,455991450,144677776,600669226,3,0,0,9728,3,9015972584
18005,456053289,144612169,600665458,8,0,0,512,2,1727943326
18006,456067749,144662880,600730629,8,0,0,1024,2,1867314205
18007,456125819,144547330,600673149,5,0,0,12800,11,4421317421
18008,456134510,171226082,627360592,8,0,1,16384,2,7868928283
18009,456137279,171223336,627360615,4,0,1,22016,2,2185485804
18010,456190130,144415511,600605641,4,0,0,54784,2,2900108461
18011,456214740,171145906,627360646,8,0,1,10752,2,6035439274
18012,456273199,171087470,627360669,0,0,1,13824,10,5746129365
18013,456333339,144243336,600576675,5,0,0,1024,11,5227506427
18014,456420460,144428236,600848696,3,0,0,228352,3,2901403005
18015,456442779,144134612,600577391,8,0,0,1024,2,9869858560
18016,456568469,144141528,600709997,8,0,0,5120,2,5788811484
18017,456654699,144124398,600779097,8,0,0,7168,2,8748482617
18018,456762369,144109154,600871523,5,0,0,512,11,7917988586
18019,456843510,144027811,600871321,4,0,0,16896,2,10172914355
18020,456883840,143967155,600850995,0,0,0,5632,10,8116667143
18021,456892551,170542415,627434966,6,0,1,45568,7,3839110946
18022,456947699,143901488,600849187,5,0,0,1536,11,2198649958
18023,456957249,143745346,600702595,8,0,0,3584,2,10104014934
18024,457030969,143850850,600881819,8,0,0,1536,2,683018218
18025,457061080,143877719,600938799,0,0,0,3584,10,142777613
18026,457075760,170363072,627438832,7,0,1,6144,16,4871286789
18027,457094160,143601077,600695237,0,0,0,2048,10,7922942178
18028,457099559,143793876,600893435,5,0,0,2560,11,7251688873
18029,457101040,170429307,627530347,7,0,1,18432,16,8262193032
18030,457142289,143767815,600910104,5,0,0,512,11,2122251056
18031,457144180,170386525,627530705,8,0,1,24576,2,8409047291
18032,457170631,172074699,629245330,6,0,1,1122816,7,7637441612
18033,457187200,172058153,629245353,8,0,1,38400,2,2694768643
18034,457265090,143608172,600873262,0,0,0,5632,10,752404141
18035,457305770,143560380,600866150,3,0,0,49664,3,9668015427
18036,457338119,144331428,601669547,8,0,0,512,2,9987650150
18037,457358290,143971481,601329771,4,0,0,77312,2,7878960994
18038,457406810,171838566,629245376,8,0,1,7168,2,3101880302
18039,457474190,171771209,629245399,8,0,1,43008,2,8034968849
18040,457492550,171752872,629245422,8,0,1,9216,2,6658448221
18041,457521580,143598050,601119630,0,0,0,2560,10,5022628478
18042,457533040,144142237,601675277,0,0,0,10240,10,6395845917
18043,457574191,171671254,629245445,9,0,1,22016,17,9742893336
18044,457644180,171601288,629245468,8,0,1,10240,2,8823515350
18045,457678020,143575234,601253254,0,0,0,512,10,6151524449
18046,457697060,171548431,629245491,8,0,1,13824,2,1465282169
18047,457790979,171454535,629245514,1,0,1,43008,5,1381637782
18048,457802370,144259985,602062355,4,0,0,152064,2,2598027793
18049,457806620,171438917,629245537,5,0,1,2560,11,9076140487
18050,457871250,144623337,602494587,3,0,0,257536,3,5594225892
18051,457918129,144189884,602108013,8,0,0,118784,2,6810397163
18052,457929230,144407191,602336421,3,0,0,201216,3,5151462157
18053,457931639,171313921,629245560,1,0,1,7168,5,341243295
18054,457956810,171288773,629245583,2,0,1,46592,4,836329987
18055,458016380,171230029,629246409,8,0,1,2560,2,2804916946
18056,458067390,143822341,601889731,3,0,0,130048,3,9587219845
18057,458071749,171178913,629250662,4,0,1,30720,2,3585563750
18058,458086679,171177035,629263714,1,0,1,24576,5,5500571407
18059,458175610,143436147,601611757,0,0,0,5632,10,40603361
18060,458187799,143422219,601610018,8,0,0,100864,2,7305723987
18061,458224860,144379934,602604794,3,0,0,189440,3,10643549895
18062,458265170,143750316,602015486,3,0,0,256000,3,1094784534
18063,458331129,170963641,629294770,4,0,1,23040,2,6428507619
18064,458380789,170941469,629322258,4,0,1,28160,2,5929157249
18065,458429399,142992072,601421471,5,0,0,5120,11,9196958770
18066,458479590,143309594,601789184,3,0,0,154624,3,8766096958
18067,458507880,170814401,629322281,5,0,1,5632,11,10522230374
18068,458515440,170806864,629322304,8,0,1,1536,2,9777762746
18069,458525580,142706920,601232500,0,0,0,4096,10,6468076399
18070,458546880,142649736,601196616,0,0,0,2048,10,2765512839
18071,458550279,144057034,602607313,5,0,0,8192,11,8361826029
18072,458556679,170765648,629322327,4,0,1,16896,2,5712753391
18073,458562490,170775188,629337678,5,0,1,28160,11,7960227156
18074,458587979,142840463,601428442,5,0,0,3584,11,162641594
18075,458617870,143307087,601924957,0,0,0,2560,10,2494523964
18076,458619089,143796984,602416073,8,0,0,73216,2,9135270778
18077,458676270,144205456,602881726,3,0,0,134656,3,2828003947
18078,458697000,144524394,603221394,0,0,0,4608,10,2068840251
18079,458712010,144125788,602837798,4,0,0,402432,2,2944201977
18080,458714579,170623970,629338549,4,0,1,12288,2,4597699904
18081,458714719,144260341,602975060,8,0,0,306176,2,6443223002
18082,458743900,144096775,602840675,0,0,0,5632,10,7733747855
18083,458809290,143451819,602261109,4,0,0,43008,2,6875160188
18084,458824590,170549033,629373623,5,0,1,5120,11,7715994054
18085,458876099,170500564,629376663,4,0,1,512,2,6945691138
18086,458916620,170465330,629381950,8,0,1,25088,2,409059561
18087,458930409,144219229,603149638,8,0,0,341504,2,8470236426
18088,458944040,143553580,602497620,0,0,0,9728,10,2335249559
18089,458953890,144346187,603300077,4,0,0,183296,2,7948529944
18090,458980880,143398620,602379500,4,0,0,141312,2,8312631101
18091,459016899,143821234,602838133,5,0,0,1024,11,8676796296
18092,459058280,143335439,602393719,4,0,0,46592,2,5353189957
18093,459070950,143945044,603015994,4,0,0,134144,2,8233553771
18094,459073300,142942677,602015977,0,0,0,1536,10,632393730
18095,459145229,143471779,602617008,8,0,0,31744,2,2013273357
18096,459177680,144025191,603202871,0,0,0,1536,10,2061998922
18097,459188520,170293723,629482243,8,0,1,5120,2,5744464121
18098,459244789,144057050,603301839,8,0,0,5632,2,6655869466
18099,459295090,170187176,629482266,8,0,1,17920,2,10589699685
18100,459308330,170175386,629483716,5,0,1,36864,11,2910683928
18101,459311940,170171799,629483739,5,0,1,33280,11,6026108175
18102,459313270,170208939,629522209,5,0,1,33792,11,7772512698
18103,459315129,170207103,629522232,4,0,1,5120,2,9946730981
18104,459354520,143189278,602543798,3,0,0,122368,3,5470240356
18105,459362390,143857577,603219967,3,0,0,55808,3,7217059434
18106,459365339,170156916,629522255,4,0,1,14336,2,6808612087
18107,459410700,170112537,629523237,8,0,1,24576,2,6331889367
18108,459432639,143769625,603202264,8,0,0,171008,2,8819829880
18109,459474939,143675198,603150137,5,0,0,1536,11,930262975
18110,459475510,144113686,603589196,3,0,0,114176,3,8038896250
18111,459503370,143872982,603376352,4,0,0,204288,2,3315164982
18112,459507150,143532431,603039581,4,0,0,77312,2,5528112605
18113,459515089,143323847,602838936,5,0,0,2560,11,7057696651
18114,459534239,143511316,603045555,5,0,0,3584,11,9434831863
18115,459556920,143487520,603044440,3,0,0,15872,3,5202922693
18116,459607579,143614774,603222353,5,0,0,3072,11,8187081512
18117,459628200,169961519,629589719,8,0,1,55808,2,4199853337
18118,459680209,142984678,602664887,5,0,0,2560,11,8119245043
18119,459696510,169902402,629598912,8,0,1,14848,2,1524967417
18120,459713479,143923245,603636724,5,0,0,4096,11,7079252764
18121,459737630,143506499,603244129,0,0,0,6144,10,8584401847
18122,459759599,170004193,629763792,4,0,1,32768,2,168394506
18123,459829989,169986988,629816977,4,0,1,11776,2,3257528004
18124,459829999,143474414,603304413,5,0,0,8192,11,6778839756
18125,459832240,144009918,603842158,3,0,0,11776,3,8827942939
18126,459836010,170349948,630185958,5,0,1,37888,11,391877437
18127,459845160,170377345,630222505,5,0,1,22528,11,3153917243
18128,459852600,143389634,603242234,4,0,0,65024,2,585781445
18129,459857590,170365261,630222851,5,0,1,512,11,752855187
18130,459868330,170363623,630231953,5,0,1,35328,11,6626550880
18131,459997350,170241807,630239157,5,0,1,7680,11,9154910500
18132,460087680,170151823,630239503,8,0,1,512,2,2147137772
18133,460088290,170151559,630239849,5,0,1,512,11,7980636376
18134,460094349,143210960,603305309,5,0,0,2560,11,5928352930
18135,460112800,170159204,630272004,8,0,1,35328,2,5257241418
18136,460127980,143656068,603784048,4,0,0,119808,2,2927486432
18137,460130470,144442266,604572736,3,0,0,591360,3,4011882891
18138,460132570,143289168,603421738,0,0,0,3072,10,3936998994
18139,460195420,170225798,630421218,2,0,1,94208,4,5745656574
18140,460200759,144528781,604729540,8,0,0,14848,2,7746964278
18141,460221020,143678516,603899536,3,0,0,109568,3,5682108315
18142,460223769,143087010,603310779,5,0,0,1536,11,1439618738
18143,460264550,143520301,603784851,0,0,0,2560,10,9470605182
18144,460291580,170139271,630430851,5,0,1,13824,11,7182009041
18145,460389459,144300019,604689478,8,0,0,143360,2,2381468703
18146,460396760,143056148,603452908,4,0,0,67584,2,679847387
18147,460422450,143167081,603589531,0,0,0,1024,10,2543664005
18148,460425350,170018930,630444280,8,0,1,47104,2,6485846557
18149,460452219,169992727,630444946,4,0,1,1024,2,7689887123
18150,460462260,143604292,604066552,3,0,0,197632,3,8576497597
18151,460527200,169919052,630446252,8,0,1,2048,2,7771666737
18152,460528650,169962504,630491154,8,0,1,11776,2,9830995184
18153,460537890,169957691,630495581,7,0,1,23552,16,7713025091
18154,460602759,170030334,630633093,4,0,1,59392,2,8903926421
18155,460665530,143581748,604247278,3,0,0,78848,3,3163060402
18156,460685839,143400843,604086682,5,0,0,8192,11,590772568
18157,460694180,144277275,604971455,3,0,0,21504,3,9768988147
18158,460700240,169932876,630633116,7,0,1,20480,16,4868960936
18159,460702180,169930959,630633139,5,0,1,8192,11,1233057293
18160,460713090,143932677,604645767,4,0,0,239616,2,10465578483
18161,460720750,169912412,630633162,7,0,1,21504,16,3079413662
18162,460730249,169959587,630689836,4,0,1,13312,2,4182681916
18163,460732680,169959386,630692066,5,0,1,2560,11,3143977221
18164,460740420,143951889,604692309,0,0,0,9216,10,5681163093
18165,460759140,144338386,605097526,3,0,0,413696,3,3682430865
18166,460764369,169939980,630704349,4,0,1,41984,2,5035275500
18167,460781620,144700433,605482053,4,0,0,602112,2,8681091098
18168,460838260,145149499,605987759,4,0,0,619520,2,6735695397
18169,460866380,144232003,605098383,0,0,0,2048,10,3269351678
18170,460867340,169837032,630704372,5,0,1,1024,11,3163395359
18171,460886860,144077974,604964834,3,0,0,251392,3,9408520578
18172,460920409,169848885,630769294,4,0,1,54272,2,4697389626
18173,460934249,144813556,605747805,8,0,0,163328,2,10497240823
18174,460936370,169847726,630784096,8,0,1,18432,2,9935952170
18175,461123320,169666934,630790254,7,0,1,29184,16,5038238680
18176,461145860,143956157,605102017,0,0,0,8192,10,5841594682
18177,461184060,143574824,604758884,0,0,0,9216,10,10180834064
18178,461189200,144917188,606106388,4,0,0,109056,2,8004455330
18179,461198340,169613431,630811771,7,0,1,40448,16,5552467684
18180,461248030,169565549,630813579,7,0,1,1536,16,6324390483
18181,461262570,143498677,604761247,0,0,0,7680,10,7544009576
18182,461269800,144028774,605298574,4,0,0,75264,2,5181972052
18183,461281840,169547943,630829783,7,0,1,7168,16,3108216311
18184,461293809,143803927,605097736,5,0,0,512,11,3754113438
18185,461345620,169484186,630829806,7,0,1,4096,16,4383879470
18186,461465000,169364829,630829829,8,0,1,12800,2,8573724474
18187,461465360,143792734,605258094,3,0,0,82432,3,3878614993
18188,461467470,144605488,606072958,3,0,0,279552,3,10199906776
18189,461487960,169349950,630837910,8,0,1,16896,2,450852999
18190,461527460,143960708,605488168,4,0,0,19968,2,5078713695
18191,461544779,169320518,630865297,1,0,1,44544,5,6453741262
18192,461598349,143504159,605102508,5,0,0,1536,11,9045164255
18193,461645189,143847618,605492807,5,0,0,512,11,1577484133
18194,461660500,169213376,630873876,7,0,1,31232,16,9351200414
18195,461719109,143380389,605099498,5,0,0,3584,11,10022194247
18196,461739700,143530173,605269873,0,0,0,512,10,6468989684
18197,461786180,143406779,605192959,4,0,0,15360,2,8373077606
18198,461836800,144351846,606188646,3,0,0,269312,3,10528405007
18199,461862589,169179788,631042377,4,0,1,41472,2,2686306022
18200,461865971,169178815,631044786,9,0,1,5120,17,5587125119
18201,461994970,144723119,606718089,3,0,0,173056,3,10503535857
18202,462033119,144073448,606106567,5,0,0,512,11,10609832216
18203,462076600,144773158,606849758,4,0,0,419840,2,3045528240
18204,462082580,144410958,606493538,3,0,0,257536,3,9554230154
18205,462172420,168872389,631044809,8,0,1,2048,2,9770273675
18206,462191031,168853809,631044840,9,0,1,12800,17,9952471937
18207,462207089,143285470,605492559,8,0,0,14336,2,9331832551
18208,462209590,144016642,606226232,3,0,0,92160,3,9667353432
18209,462209850,168951295,631161145,8,0,1,15360,2,5341833036
18210,462227510,168933658,631161168,8,0,1,8704,2,3477109051
18211,462237700,143451076,605688776,0,0,0,6656,10,2416689542
18212,462240260,169186710,631426970,8,0,1,25088,2,167545074
18213,462240570,143512094,605752664,4,0,0,15872,2,6264206609
18214,462246680,169180313,631426993,8,0,1,2560,2,8569490961
18215,462267210,144398128,606665338,3,0,0,233984,3,7165926378
18216,462321659,144868635,607190294,8,0,0,459776,2,10533483070
18217,462377191,169049825,631427016,9,0,1,6144,17,3841224801
18218,462378710,143933559,606312269,0,0,0,512,10,8819241164
18219,462397531,169029508,631427039,9,0,1,3072,17,6260403150
18220,462408590,144126311,606534901,3,0,0,135680,3,6035339093
18221,462419559,143653578,606073137,5,0,0,512,11,2469976193
18222,462424180,169169259,631593439,8,0,1,18432,2,5525171791
18223,462454959,143927846,606382805,8,0,0,168448,2,3582202629
18224,462528780,144421465,606950245,3,0,0,329728,3,2980533617
18225,462530260,144063763,606594023,3,0,0,67072,3,6673398149
18226,462534259,144469853,607004112,8,0,0,176640,2,411845247
18227,462569540,143757896,606327436,0,0,0,1024,10,1537479089
18228,462589520,144132249,606721769,3,0,0,11776,3,5726127916
18229,462594699,144696547,607291246,8,0,0,159232,2,9548038742
18230,462615400,144404872,607020272,0,0,0,512,10,7631143151
18231,462622500,143688389,606310889,0,0,0,1024,10,5610091990
18232,462625540,144394553,607020093,4,0,0,26112,2,3873500194
18233,462626920,169090475,631717395,8,0,1,26112,2,4817195328
18234,462628769,144417578,607046347,8,0,0,85504,2,2418297233
18235,462691190,169030041,631721231,8,0,1,23040,2,567332492
18236,462693211,169056097,631749308,9,0,1,2560,17,198241951
18237,462733890,143802016,606535906,0,0,0,3072,10,2303077505
18238,462823150,144621413,607444563,4,0,0,225792,2,1945627264
18239,462828969,144221145,607050114,5,0,0,12288,11,9487064093
18240,462878501,169012503,631891004,9,0,1,34816,17,8254726891
18241,462886479,144650310,607536789,8,0,0,134144,2,3605936984
18242,462905380,144106734,607012114,4,0,0,26112,2,201302189
18243,462925410,168965617,631891027,8,0,1,25088,2,5622813224
18244,462929450,144829118,607758568,4,0,0,108544,2,188183986
18245,462970239,144236940,607207179,8,0,0,49664,2,9883770901
18246,462979560,145004099,607983659,4,0,0,221696,2,2994517760
18247,462997209,144472516,607469725,8,0,0,82432,2,7853758154
18248,463013829,144710529,607724358,8,0,0,86016,2,5067980113
18249,463014689,144177312,607192001,5,0,0,1536,11,10421252858
18250,463036479,144879609,607916088,8,0,0,315904,2,481570583
18251,463075680,144115807,607191487,0,0,0,3584,10,2078615900
18252,463088300,168802750,631891050,8,0,1,13824,2,3178322233
18253,463098450,168853606,631952056,8,0,1,46080,2,2955735755
18254,463113750,168944115,632057865,8,0,1,5120,2,1381793272
18255,463114920,145009587,608124507,4,0,0,154112,2,3235818254
18256,463157850,144826768,607984618,0,0,0,3072,10,222199828
18257,463339719,144325659,607665378,8,0,0,53760,2,4758394880
18258,463354380,168718385,632072765,8,0,1,33280,2,7173422895
18259,463364450,144811122,608175572,4,0,0,114176,2,1191166231
18260,463400240,168822727,632222967,8,0,1,53760,2,7012986142
18261,463427299,145088145,608515444,8,0,0,395264,2,3950014847
18262,463547710,168733469,632281179,8,0,1,13312,2,5404795904
18263,463553530,168731752,632285282,8,0,1,13312,2,5488920950
18264,463666499,144143572,607810071,8,0,0,168960,2,2913145271
18265,463683870,144007669,607691539,0,0,0,1024,10,6987337504
18266,463706499,144527826,608234325,8,0,0,79872,2,9008027243
18267,463724280,144996878,608721158,3,0,0,61952,3,8733769038
18268,463740760,144945073,608685833,4,0,0,215040,2,8477708888
18269,463762940,144825245,608588185,3,0,0,159744,3,1968553175
18270,463782100,144591683,608373783,4,0,0,207872,2,5197717986
18271,463818739,143906734,607725473,5,0,0,3584,11,8938668146
18272,463869100,168446189,632315289,5,0,1,17408,11,8705640306
18273,463933090,144442432,608375522,0,0,0,5632,10,5401385881
18274,463933139,144053374,607986513,5,0,0,6144,11,4065866383
18275,463947130,144287374,608234504,0,0,0,512,10,8366432019
18276,464068820,144990368,609059188,3,0,0,641024,3,9880308562
18277,464094410,168220902,632315312,5,0,1,11264,11,5085020247
18278,464128360,168186975,632315335,5,0,1,5632,11,4030478634
18279,464147510,168167848,632315358,5,0,1,15360,11,3654837783
18280,464149330,144619239,608768569,3,0,0,48640,3,3624933608
18281,464174330,168160888,632335218,8,0,1,25600,2,4038686799
18282,464215090,144884057,609099147,3,0,0,131072,3,10118206770
18283,464221070,144481189,608702259,4,0,0,53760,2,9407567768
18284,464226459,144936249,609162708,8,0,0,184832,2,8858415276
18285,464231930,144520196,608752126,4,0,0,22528,2,1615065030
18286,464284400,168051931,632336331,8,0,1,2560,2,6655831233
18287,464293380,144548255,608841635,0,0,0,7168,10,2997905284
18288,464299870,168048755,632348625,8,0,1,3584,2,3246768892
18289,464323180,168025468,632348648,5,0,1,10240,11,571519539
18290,464324349,144907309,609231658,8,0,0,105472,2,7613520798
18291,464329640,144439108,608768748,0,0,0,512,10,5616989892
18292,464339850,168032711,632372561,5,0,1,35328,11,9895232023
18293,464381639,144816550,609198189,8,0,0,113152,2,2230924867
18294,464392079,144714267,609106346,8,0,0,23552,2,5101749971
18295,464429050,167943665,632372715,5,0,1,8704,11,10562683077
18296,464440630,168009053,632449683,5,0,1,38400,11,6877005933
18297,464461970,167987736,632449706,5,0,1,1024,11,5812872403
18298,464558239,144804384,609362623,8,0,0,175104,2,5623075514
18299,464631110,167828179,632459289,8,0,1,28672,2,9979306633
18300,464675390,167830145,632505535,8,0,1,26624,2,860104766
18301,464729720,144469740,609199460,0,0,0,4096,10,9518781096
18302,464762520,167805752,632568272,8,0,1,8192,2,5287759288
18303,464803559,144360131,609163690,5,0,0,1536,11,7400192602
18304,464815849,144696278,609512127,8,0,0,75776,2,8672061677
18305,464850950,144930792,609781742,3,0,0,146432,3,7355860796
18306,464891259,144714153,609605412,8,0,0,232960,2,5170123685
18307,464948989,144788068,609737057,8,0,0,394752,2,10274396807
18308,464954250,167630103,632584353,5,0,1,12288,11,7013546441
18309,464982869,167630553,632613422,0,0,1,65536,10,4344388875
18310,464998169,144165030,609163199,5,0,0,1536,11,3156698058
18311,465009470,167615182,632624652,8,0,1,29696,2,10258339752
18312,465013819,167684889,632698708,0,0,1,23552,10,2993193107
18313,465093340,167609184,632702524,5,0,1,73216,11,7650097680
18314,465159419,144772951,609932370,8,0,0,307200,2,7643967798
18315,465174820,167528050,632702870,8,0,1,512,2,3593800420
18316,465177669,144225713,609403382,5,0,0,1024,11,6251451779
18317,465181450,144657158,609838608,4,0,0,168448,2,4240978624
18318,465203990,167502426,632706416,5,0,1,5632,11,4214232898
18319,465215149,167492253,632707402,1,0,1,1536,5,7603093159
18320,465243999,144692372,609936371,5,0,0,12800,11,2776742096
18321,465295990,167413678,632709668,8,0,1,3584,2,10526500884
18322,465324589,167385745,632710334,0,0,1,11264,10,4239799966
18323,465378940,167403511,632782451,8,0,1,48640,2,6325648252
18324,465399939,144536978,609936917,5,0,0,1536,11,3970493996
18325,465410329,167460072,632870401,0,0,1,12288,10,2089877813
18326,465410790,167459634,632870424,3,0,1,13312,3,7123942719
18327,465456009,167546616,633002625,0,0,1,12800,10,3875422692
18328,465473179,167533727,633006906,0,0,1,10752,10,8060045573
18329,465488550,167518714,633007264,5,0,1,14848,11,2090472097
18330,465499960,167507662,633007622,3,0,1,18944,3,2321243114
18331,465534410,144252081,609786491,3,0,0,15360,3,3644917357
18332,465549909,144237344,609787253,5,0,0,2048,11,2405056762
18333,465601530,167408657,633010187,8,0,1,23040,2,2646153639
18334,465602069,167409412,633011481,0,0,1,12800,10,1156462320
18335,465602679,167430243,633032922,4,0,1,55808,2,8244685220
18336,465605860,167434018,633039878,8,0,1,36352,2,1889398393
18337,465613609,167433424,633047033,0,0,1,6144,10,4646718879
18338,465627620,144418388,610046008,3,0,0,190976,3,2849679220
18339,465633879,167413820,633047699,0,0,1,1024,10,4015448619
18340,465703539,144254730,609958269,8,0,0,62976,2,10523305270
18341,465785279,167264046,633049325,0,0,1,2560,10,6631190015
18342,465823440,144241505,610064945,0,0,0,512,10,1285543040
18343,465847460,167227137,633074597,8,0,1,23040,2,5857588434
18344,465890449,167191732,633082181,0,0,1,19456,10,3920032838
18345,465913600,167213447,633127047,3,0,1,52736,3,1941964506
18346,465913740,144408778,610322518,0,0,0,2560,10,1972000045
18347,465922010,167205908,633127918,8,0,1,12288,2,4014428348
18348,465932150,144494525,610426675,3,0,0,110592,3,4249302078
18349,465945520,167183781,633129301,3,0,1,14848,3,9386032123
18350,465947160,167254091,633201251,8,0,1,2560,2,8675906349
18351,465960269,144242070,610202339,8,0,0,41984,2,9298305070
18352,466020390,167180884,633201274,8,0,1,7168,2,9907456908
18353,466060979,167140318,633201297,0,0,1,32768,10,1532562811
18354,466065369,167135951,633201320,0,0,1,8192,10,1082434663
18355,466080859,167120484,633201343,0,0,1,29184,10,4354877348
18356,466081250,167128719,633209969,8,0,1,50176,2,8869897688
18357,466141649,143833066,609974715,5,0,0,3072,11,4444168112
18358,466157840,145159613,611317453,3,0,0,521728,3,3552341990
18359,466238919,143898070,610136989,8,0,0,35328,2,10549747803
18360,466266890,166968723,633235613,8,0,1,31744,2,8806411846
18361,466273049,145218950,611491999,8,0,0,205312,2,6305213590
18362,466373769,144170474,610544243,8,0,0,183808,2,6613672419
18363,466381060,144392604,610773664,4,0,0,142336,2,6168183635
18364,466393620,144336653,610730273,4,0,0,147968,2,1121482509
18365,466409870,145358766,611768636,3,0,0,456704,3,10534788350
18366,466453470,143991675,610445145,0,0,0,1024,10,5162772462
18367,466524840,166722071,633246911,8,0,1,25600,2,10029880821
18368,466586070,144503737,611089807,0,0,0,2560,10,6089562133
18369,466676750,143916155,610592905,4,0,0,45056,2,6019675466
18370,466731450,144257526,610988976,3,0,0,334336,3,1537818292
18371,466779770,166513436,633293206,5,0,1,61952,11,5860904309
18372,466888600,166405477,633294077,8,0,1,12288,2,1210483141
18373,466907230,166387513,633294743,5,0,1,1024,11,2831958309
18374,466975549,144424295,611399844,8,0,0,270336,2,5795392553
18375,467022919,166310623,633333542,0,0,1,67584,10,3516491163
18376,467036570,166299238,633335808,8,0,1,3584,2,4862000446
18377,467049570,144379781,611429351,3,0,0,96768,3,2323947719
18378,467105400,166249535,633354935,5,0,1,54784,11,4208039065
18379,467125879,144676458,611802337,8,0,0,74240,2,453251663
18380,467141210,144466265,611607475,3,0,0,171520,3,5685229731
18381,467147850,144628655,611776505,0,0,0,21504,10,958393939
18382,467160330,166196692,633357022,8,0,1,12800,2,917860140
18383,467182430,145031001,612213431,4,0,0,165888,2,9046643286
18384,467200429,144350295,611550724,8,0,0,94208,2,564865073
18385,467226090,144822742,612048832,4,0,0,57856,2,10666176314
18386,467268240,145088667,612356907,3,0,0,160768,3,141056609
18387,467270980,166086708,633357688,8,0,1,1024,2,9285233943
18388,467297320,166073285,633370605,5,0,1,28672,11,7575048655
18389,467374409,143645618,611020027,5,0,0,3584,11,2451648171
18390,467375140,144146834,611521974,4,0,0,98304,2,9553513663
18391,467376249,144518942,611895191,8,0,0,6656,2,5966573882
18392,467397800,165973266,633371066,5,0,1,10240,11,8467528386
18393,467408770,165992605,633401375,5,0,1,44032,11,6437422646
18394,467417729,144136458,611554187,5,0,0,11264,11,4487138897
18395,467505590,144524586,612030176,4,0,0,103936,2,7114165816
18396,467541679,144013513,611555192,5,0,0,3072,11,3633861080
18397,467569110,165835851,633404961,8,0,1,5120,2,6191211091
18398,467650930,144119000,611769930,0,0,0,3584,10,8121308738
18399,467658330,143949542,611607872,0,0,0,1024,10,8386888419
18400,467727269,143901698,611628967,5,0,0,2560,11,1781160124
18401,467735930,144041066,611776996,0,0,0,1536,10,2338151535
18402,467927100,143681887,611608987,0,0,0,3584,10,5901196932
18403,467931840,143696324,611628164,0,0,0,6656,10,6762251231
18404,467947769,165460424,633408193,4,0,1,19968,2,1269876266
18405,467950520,144132819,612083339,4,0,0,95744,2,5901730092
18406,468032749,143736066,611768815,5,0,0,512,11,10206302960
18407,468070810,143708884,611779694,0,0,0,5120,10,2281576671
18408,468102789,143749812,611852601,5,0,0,1024,11,4124559048
18409,468115509,143915649,612031158,5,0,0,2048,11,28064473
18410,468117180,143696273,611813453,0,0,0,1536,10,10036928217
18411,468131090,143923030,612054120,3,0,0,16896,3,9599149454
18412,468147490,165261164,633408654,5,0,1,10240,11,163577515
18413,468161410,143836960,611998370,4,0,0,194048,2,1992029187
18414,468174880,165265663,633440543,8,0,1,26112,2,7187824568
18415,468186709,144436677,612623386,8,0,0,188928,2,5063646304
18416,468253900,165187923,633441823,8,0,1,14336,2,31106628
18417,468254419,143908445,612162864,5,0,0,1024,11,7378256053
18418,468306790,165140646,633447436,3,0,1,2560,3,10435930868
18419,468314219,143463892,611778111,5,0,0,3584,11,10266174211
18420,468316510,143846011,612162521,4,0,0,90112,2,5082958425
18421,468335780,143694731,612030511,0,0,0,1024,10,4355919828
18422,468352790,165182278,633535068,5,0,1,185344,11,9909719964
18423,468354880,144528404,612883284,4,0,0,269312,2,9442931196
18424,468386719,143697423,612084142,5,0,0,2560,11,6840178746
18425,468432240,144726098,613158338,3,0,0,76288,3,10506469075
18426,468438889,143795477,612234366,8,0,0,68608,2,1205844873
18427,468441910,165093876,633535786,2,0,1,19456,4,4254238761
18428,468496270,143593626,612089896,0,0,0,4608,10,3441168777
18429,468497210,165041145,633538355,8,0,1,3072,2,1223082761
18430,468518440,165048044,633566484,2,0,1,40448,4,853124473
18431,468549029,143950227,612499256,5,0,0,2048,11,2825818357
18432,468555190,143680002,612235192,0,0,0,2560,10,1900607749
18433,468562280,143816538,612378818,3,0,0,6144,3,10159623413
18434,468573490,164993762,633567252,5,0,1,11776,11,10059204541
18435,468580390,144714658,613295048,4,0,0,70144,2,6422605024
18436,468605270,164988113,633593383,2,0,1,12800,4,7068436775
18437,468624789,164972635,633597424,4,0,1,26624,2,6848969409
18438,468637371,166146866,634784237,9,0,1,18944,17,7079237538
18439,468652140,166132455,634784595,2,0,1,32768,4,8208027245
18440,468767690,166020764,634788454,5,0,1,10240,11,1070691963
18441,468773851,166048741,634822592,9,0,1,16384,17,1836986715
18442,468847510,166777219,635624729,2,0,1,15872,4,7215011653
18443,468850359,143385792,612236151,5,0,0,3072,11,10308549327
18444,468852411,167188561,636040972,9,0,1,48640,17,1638952423
18445,468875800,167297634,636173434,7,0,1,20992,16,244668337
18446,468888071,167285877,636173948,9,0,1,11264,17,10311338516
18447,468937159,143326032,612263191,8,0,0,32256,2,3464251825
18448,469027330,167169908,636197238,2,0,1,35328,4,926774586
18449,469049660,167198745,636248405,8,0,1,32256,2,2880002504
18450,469075120,167247544,636322664,2,0,1,20992,4,7420514699
18451,469089560,167259336,636348896,5,0,1,27136,11,4242666289
18452,469109059,143446499,612555558,8,0,0,161792,2,9183878333
18453,469176540,167173124,636349664,8,0,1,11776,2,5219841348
18454,469206230,144472158,613678388,4,0,0,45568,2,3872272138
18455,469263790,167283669,636547459,2,0,1,16384,4,4151463360
18456,469316180,144186738,613502918,4,0,0,40448,2,2972606289
18457,469337290,144497598,613834888,3,0,0,45568,3,3013490446
18458,469347549,143276484,612624033,5,0,0,2048,11,10607397066
18459,469364830,167184749,636549579,8,0,1,21504,2,952182259
18460,469395929,143306147,612702076,5,0,0,9728,11,8171374060
18461,469397880,167152533,636550413,2,0,1,13824,4,10419843406
18462,469408940,167141496,636550436,8,0,1,8192,2,8700652989
18463,469432930,167117529,636550459,5,0,1,13824,11,5190909878
18464,469472550,143321259,612793809,3,0,0,45056,3,5613207927
18465,469538070,167218075,636756145,2,0,1,24064,4,7769589039
18466,469575569,143198975,612774544,8,0,0,192000,2,7485532757
18467,469651410,143047679,612699089,0,0,0,7168,10,5962111609
18468,469667679,167177425,636845104,4,0,1,33792,2,2180393798
18469,469683050,167162400,636845450,2,0,1,512,4,2093592716
18470,469683409,143200724,612884133,5,0,0,2560,11,4099884722
18471,469685930,167231490,636917420,2,0,1,24064,4,5386153694
18472,469702850,167351641,637054491,2,0,1,36352,4,9073402351
18473,469704780,167388530,637093310,2,0,1,23040,4,9880708293
18474,469716140,143168888,612885028,0,0,0,2560,10,7794185730
18475,469728280,167680007,637408287,2,0,1,52224,4,10201055822
18476,469774560,144275485,614050045,4,0,0,303104,2,855671985
18477,469809530,167810628,637620158,5,0,1,1024,11,10499167452
18478,469809730,143107473,612917203,0,0,0,2560,10,4353081491
18479,469820000,167867835,637687835,2,0,1,24064,4,8232050857
18480,469830220,168054217,637884437,5,0,1,45056,11,621967195
18481,469837320,168080685,637918005,2,0,1,16896,4,3875088782
18482,469863330,168057560,637920890,8,0,1,18944,2,3855618555
18483,469901670,143122045,613023715,3,0,0,10752,3,3572612566
18484,469904420,168016493,637920913,5,0,1,10752,11,9171869568
18485,469911270,168035078,637946348,5,0,1,2560,11,9901826173
18486,469965379,143046822,613012201,5,0,0,5120,11,408734909
18487,470033090,167913281,637946371,2,0,1,3072,4,3498965074
18488,470070760,167875634,637946394,8,0,1,512,2,3695764136
18489,470086080,143325352,613411432,3,0,0,135680,3,3974861823
18490,470122710,144203520,614326230,4,0,0,188928,2,6760440906
18491,470185970,167907110,638093080,5,0,1,512,11,2421203921
18492,470201370,167952003,638153373,2,0,1,71168,4,9388360188
18493,470262680,167890716,638153396,5,0,1,8192,11,9382143075
18494,470277599,142812656,613090255,5,0,0,3072,11,9597006782
18495,470282589,143067314,613349903,5,0,0,1024,11,7421347350
18496,470310980,143646667,613957647,3,0,0,308224,3,9182141239
18497,470359260,143898286,614257546,3,0,0,377344,3,474818665
18498,470380780,167916906,638297686,2,0,1,27136,4,5667785551
18499,470408010,143992341,614400351,4,0,0,145920,2,4240974685
18500,470442480,167855229,638297709,2,0,1,512,4,4508451373
18501,470453170,167845365,638298535,8,0,1,19968,2,5134379396
18502,470458610,142955185,613413795,0,0,0,7680,10,7368562698
18503,470486000,167812558,638298558,5,0,1,5120,11,9012387768
18504,470510510,143300098,613810608,3,0,0,149504,3,3579132837
18505,470529880,143193427,613723307,4,0,0,33792,2,2474814711
18506,470543580,143049688,613593268,3,0,0,75776,3,4805963167
18507,470554430,167745133,638299563,5,0,1,8192,11,157389915
18508,470561130,143034102,613595232,0,0,0,6144,10,6719239463
18509,470569950,143533056,614103006,3,0,0,173568,3,7033713227
18510,470569979,144013567,614583546,8,0,0,136704,2,8364632663
18511,470642189,167658208,638300397,0,0,1,69632,10,2253313798
18512,470658149,143162185,613820334,8,0,0,31744,2,1413520759
18513,470664900,167880407,638545307,5,0,1,39424,11,5464573743
18514,470687869,143062732,613750601,5,0,0,2048,11,10575385181
18515,470691690,143450861,614142551,3,0,0,92672,3,2850252693
18516,470771370,143342922,614114292,4,0,0,14336,2,5134263691
18517,470783050,143037931,613820981,1,0,0,2048,5,1357919990
18518,470824410,167722347,638546757,8,0,1,15872,2,9590138533
18519,470844120,143424385,614268505,6,0,0,35840,7,4884958708
18520,470848320,143689081,614537401,4,0,0,27648,2,9180970892
18521,470908450,143446226,614354676,4,0,0,93184,2,4696132388
18522,470912340,143197553,614109893,3,0,0,22528,3,4386910809
18523,470913250,167643435,638556685,5,0,1,15360,11,7200070664
18524,470942040,167614668,638556708,8,0,1,1536,2,6885733073
18525,470951370,142911990,613863360,0,0,0,1024,10,7683741921
18526,470953010,143863597,614816607,3,0,0,486912,3,5800250356
18527,470953060,167614146,638567206,5,0,1,72704,11,1755020368
18528,470972370,167608626,638580996,3,0,1,14848,3,5038171171
18529,470977519,143849430,614826949,8,0,0,31232,2,3594940492
18530,471001870,167579149,638581019,5,0,1,14848,11,3505446199
18531,471016640,143512314,614528954,3,0,0,183296,3,10497011078
18532,471036170,167544872,638581042,3,0,1,20992,3,1464601192
18533,471079800,167502380,638582180,8,0,1,7168,2,1137368156
18534,471128990,143774440,614903430,0,0,0,9728,10,8564935510
18535,471134330,143508234,614642564,0,0,0,512,10,2878897687
18536,471200020,167382183,638582203,8,0,1,8704,2,3715417982
18537,471204750,167377476,638582226,3,0,1,2048,3,5432658581
18538,471250550,167349046,638599596,3,0,1,28160,3,5872894795
18539,471265990,167367535,638633525,8,0,1,34304,2,7765587750
18540,471281889,143073956,614355845,5,0,0,1536,11,4888414743
18541,471295360,143309425,614604785,3,0,0,69632,3,206154429
18542,471320410,167313138,638633548,3,0,1,7680,3,340305354
18543,471331540,143023783,614355323,1,0,0,2048,5,5464276844
18544,471334319,143557083,614891402,8,0,0,190976,2,308892637
18545,471341860,167291719,638633579,8,0,1,17408,2,291805537
18546,471344070,167440295,638784365,8,0,1,90624,2,8901234132
18547,471360530,143456880,614817410,0,0,0,2560,10,3985102143
18548,471372950,167411438,638784388,8,0,1,7168,2,283549609
18549,471381089,143736691,615117780,8,0,0,248320,2,10196114117
18550,471386030,167398381,638784411,5,0,1,15872,11,7578192697
18551,471431809,143737169,615168978,8,0,0,22016,2,446459446
18552,471432580,144035224,615467804,3,0,0,254464,3,5292725020
18553,471437180,167347254,638784434,2,0,1,15360,4,6604540480
18554,471538400,143288728,614827128,0,0,0,512,10,6156427134
18555,471539389,144336638,615876027,5,0,0,5632,11,1943514856
18556,471555799,144285281,615841080,8,0,0,190464,2,6341431799
18557,471565860,144217165,615783025,3,0,0,422912,3,6086638365
18558,471579299,143686266,615265565,8,0,0,316928,2,9269999661
18559,471591210,167237525,638828735,3,0,1,17920,3,3526315017
18560,471614160,167217161,638831321,5,0,1,4096,11,8541423111
18561,471631450,143661773,615293223,3,0,0,89600,3,7110119343
18562,471641790,167448116,639089906,8,0,1,55808,2,2155449036
18563,471649740,143926899,615576639,4,0,0,48640,2,4896018682
18564,471650550,167586969,639237519,5,0,1,23040,11,9482209713
18565,471693890,167543652,639237542,2,0,1,2048,4,2395936727
18566,471712740,167524825,639237565,5,0,1,2560,11,1057415316
18567,471732500,144116403,615848903,3,0,0,25600,3,6332610620
18568,471764769,144465660,616230429,8,0,0,466944,2,8232633043
18569,471823109,143646659,615469768,5,0,0,6144,11,9337255841
18570,471857170,144035366,615892536,0,0,0,512,10,2666333534
18571,471861090,167376586,639237676,2,0,1,40448,4,3473373808
18572,471875080,167379111,639254191,8,0,1,43520,2,8487859401
18573,471886560,167373315,639259875,3,0,1,20992,3,2216938001
18574,471894109,143371791,615265900,5,0,0,1024,11,568328294
18575,472028790,144564539,616593329,3,0,0,148480,3,4792590440
18576,472044659,144436740,616481399,8,0,0,228864,2,5113554031
18577,472049779,143818335,615868114,8,0,0,62976,2,9193950143
18578,472053860,144357761,616411621,4,0,0,439808,2,8437804853
18579,472084280,167178757,639263037,2,0,1,13824,4,4106922165
18580,472110929,144818884,616929813,8,0,0,805888,2,2195517820
18581,472115340,167154123,639269463,2,0,1,22528,4,4075598062
18582,472129250,167186640,639315890,8,0,1,50688,2,2656689113
18583,472176590,144306328,616482918,0,0,0,4608,10,6921757718
18584,472218450,144016994,616235444,3,0,0,16384,3,5537726938
18585,472257529,144290537,616548066,8,0,0,101888,2,5542228484
18586,472271680,167065922,639337602,8,0,1,6144,2,3745834315
18587,472287690,143988367,616276057,0,0,0,3584,10,4346419338
18588,472293580,144837951,617131531,3,0,0,422912,3,9085500638
18589,472306770,167061863,639368633,5,0,1,35840,11,7679452185
18590,472309910,167060349,639370259,3,0,1,2560,3,8746335262
18591,472335290,167100640,639435930,3,0,1,45568,3,2246073741
18592,472344390,144296879,616641269,3,0,0,40448,3,10259783135
18593,472365720,144318518,616684238,4,0,0,140800,2,9702212372
18594,472401750,167059250,639461000,3,0,1,35328,3,9851361240
18595,472426760,144200752,616627512,4,0,0,19968,2,1737071953
18596,472474860,166990800,639465660,2,0,1,28160,4,7306348225
18597,472485760,166987368,639473128,8,0,1,1024,2,6031910872
18598,472488670,166990713,639479383,5,0,1,2560,11,7124886677
18599,472489330,166991039,639480369,3,0,1,1536,3,1174686487
18600,472535240,166957603,639492843,5,0,1,23040,11,9304471747
18601,472554320,167010222,639564542,5,0,1,16384,11,8518206024
18602,472561240,144369555,616930795,0,0,0,3072,10,5138108759
18603,472568920,144433640,617002560,3,0,0,235008,3,10437650726
18604,472608970,166955931,639564901,2,0,1,9728,4,7884395850
18605,472620330,167207503,639827833,8,0,1,1536,2,5880741331
18606,472626950,144613426,617240376,4,0,0,207360,2,6050156691
18607,472631840,167325230,639957070,3,0,1,18432,3,10441725128
18608,472669540,167305710,639975250,5,0,1,5120,11,10105290073
18609,472695090,167280826,639975916,8,0,1,1024,2,4996651518
18610,472707750,167551180,640258930,2,0,1,16384,4,2576147523
18611,472747380,167905073,640652453,8,0,1,29696,2,10727638566
18612,472761040,167891436,640652476,3,0,1,512,3,6883499196
18613,472765770,144382422,617148192,3,0,0,54272,3,10419744619
18614,472775130,167877369,640652499,2,0,1,2560,4,1361877545
18615,472841509,167811013,640652522,4,0,1,5120,2,9446176127
18616,472846820,168083786,640930606,5,0,1,43008,11,6467870481
18617,472847430,168087896,640935326,2,0,1,38400,4,6868635826
18618,472854810,168088777,640943587,5,0,1,17408,11,5321880572
18619,472868469,144439322,617307791,8,0,0,184320,2,7584748911
18620,472897500,144343219,617240719,0,0,0,1024,10,10701218788
18621,472947881,168100044,641047925,6,0,1,45056,7,9527014235
18622,472959529,144217644,617177173,8,0,0,94208,2,10357867546
18623,472989270,168101738,641091008,2,0,1,1024,4,4989035454
18624,473009460,168179544,641189004,2,0,1,27136,4,3788213399
18625,473022630,168166397,641189027,8,0,1,2048,2,8750570847
18626,473060810,168128240,641189050,5,0,1,10240,11,2391178791
18627,473095190,168093883,641189073,5,0,1,19456,11,1367671095
18628,473116200,168072896,641189096,8,0,1,8704,2,6109661630
18629,473133439,144176114,617309553,5,0,0,5632,11,8186881982
18630,473154740,168034379,641189119,5,0,1,5632,11,7105113761
18631,473216599,144569480,617786079,8,0,0,176128,2,3722597089
18632,473236120,167953022,641189142,2,0,1,3584,4,2391944083
18633,473255819,144435369,617691188,8,0,0,91136,2,4722442208
18634,473265380,167994835,641260215,5,0,1,73216,11,10642441586
18635,473295480,144662613,617958093,4,0,0,99328,2,910456514
18636,473311210,167949028,641260238,8,0,1,5632,2,6128121566
18637,473327610,167940529,641268139,8,0,1,11776,2,2015794633
18638,473376210,168015191,641391401,8,0,1,36864,2,5172728528
18639,473376980,168014444,641391424,5,0,1,1024,11,906587539
18640,473387281,168004166,641391447,9,0,1,9728,17,1284470919
18641,473430530,167987380,641417910,8,0,1,22016,2,1757212504
18642,473438250,144186831,617625081,3,0,0,161280,3,7790747409
18643,473446560,167973296,641419856,8,0,1,3072,2,4240705125
18644,473452889,167996629,641449518,1,0,1,33280,5,10326413061
18645,473459039,168001336,641460375,1,0,1,6144,5,536861356
18646,473489960,144938689,618428649,3,0,0,265216,3,3677207288
18647,473512410,145261985,618774395,4,0,0,225792,2,6552205520
18648,473528100,167932941,641461041,5,0,1,1024,11,1088726058
18649,473531320,144345005,617876325,4,0,0,153600,2,7895151639
18650,473597480,144650443,618247923,4,0,0,384000,2,4042940510
18651,473628529,144266596,617895125,8,0,0,49664,2,9685611469
18652,473664849,145328406,618993255,8,0,0,95232,2,3394990109
18653,473700090,167978867,641678957,2,0,1,48128,4,2968912238
18654,473757230,168222187,641979417,5,0,1,21504,11,4675539197
18655,473785520,145384633,619170153,3,0,0,34304,3,10237039752
18656,473799010,145613908,619412918,4,0,0,111104,2,704271258
18657,473805039,145353776,619158815,8,0,0,252416,2,5695279143
18658,473813279,168215489,642028768,1,0,1,38912,5,1499925786
18659,473845169,168185187,642030356,1,0,1,15872,5,7765529716
18660,473893480,144951128,618844608,0,0,0,512,10,542363486
18661,473936119,144341498,618277617,5,0,0,92160,11,3662435769
18662,473982039,144918635,618900674,8,0,0,151040,2,6675992072
18663,473988659,144854867,618843526,8,0,0,226816,2,10016868824
18664,474000320,145378699,619379019,3,0,0,590848,3,2034048886
18665,474004340,145077186,619081526,3,0,0,57344,3,2739774604
18666,474038470,168035052,642073522,3,0,1,33280,3,847692785
18667,474068210,168101717,642169927,3,0,1,28672,3,3621512551
18668,474088670,168202107,642290777,5,0,1,1024,11,3323397147
18669,474092439,168215402,642307841,0,0,1,16896,10,2318293458
18670,474126629,168191038,642317667,1,0,1,8704,5,4476121099
18671,474155661,168173316,642328977,9,0,1,17920,17,10663712365
18672,474190820,168145875,642336695,3,0,1,2048,3,3755128220
18673,474212219,168126768,642338987,1,0,1,3584,5,6114090423
18674,474298821,168065765,642364586,9,0,1,21504,17,431476860
18675,474303650,145170214,619473864,4,0,0,124928,2,8646454872
18676,474367590,144696395,619063985,3,0,0,197120,3,2422455733
18677,474391770,144767738,619159508,0,0,0,2048,10,2318225947
18678,474416490,144538439,618954929,0,0,0,512,10,3518151964
18679,474418950,167945659,642364609,5,0,1,10240,11,2695885793
18680,474429370,168058426,642487796,5,0,1,5120,11,4786853965
18681,474447169,144407446,618854615,5,0,0,32768,11,10443178575
18682,474471049,144727923,619198972,5,0,0,92160,11,8383620211
18683,474518320,144326109,618844429,0,0,0,2560,10,7388127919
18684,474520950,168061935,642582885,3,0,1,38912,3,3418242586
18685,474524840,144910868,619435708,3,0,0,74240,3,6781854758
18686,474554979,144959987,619514966,8,0,0,127488,2,4088130778
18687,474556350,168026558,642582908,3,0,1,5120,3,531967441
18688,474651351,167951259,642602610,9,0,1,23040,17,564181194
18689,474661900,167942004,642603904,5,0,1,19456,11,3794321188
18690,474667490,167968752,642636242,7,0,1,512,16,4382463363
18691,474670800,167965465,642636265,5,0,1,3072,11,7622431266
18692,474676149,167960139,642636288,1,0,1,22016,5,7133733832
18693,474705510,167930801,642636311,5,0,1,23552,11,8500418006
18694,474711939,167924395,642636334,1,0,1,2048,5,2469373846
18695,474743390,144732594,619475984,0,0,0,6656,10,1329218816
18696,474826561,167809796,642636357,9,0,1,15360,17,844398190
18697,474852271,167936038,642788309,9,0,1,47104,17,8600452619
18698,474861281,167966238,642827519,9,0,1,54784,17,9353473366
18699,474863010,144307790,619170800,0,0,0,2048,10,6596474173
18700,474910240,167917302,642827542,7,0,1,5632,16,9034091940
18701,474936030,144145831,619081861,0,0,0,1024,10,2285816534
18702,474937861,167896435,642834296,9,0,1,29696,17,2435960492
18703,474945591,167888736,642834327,9,0,1,24064,17,8014282840
18704,474977991,167856359,642834350,9,0,1,4096,17,9475795583
18705,475030521,167803852,642834373,9,0,1,10752,17,7643778772
18706,475035289,144481078,619516367,5,0,0,512,11,6600209957
18707,475040150,167799481,642839631,3,0,1,19968,3,7475871863
18708,475041480,145061683,620103163,4,0,0,164352,2,3140740145
18709,475050020,144466043,619516063,0,0,0,3072,10,6399416825
18710,475087310,167753947,642841257,5,0,1,2560,11,6623978924
18711,475100811,167803623,642904434,9,0,1,36352,17,8051060496
18712,475129890,144449220,619579110,3,0,0,42496,3,4844406923
18713,475133719,144543417,619677136,8,0,0,2560,2,4130393922
18714,475140170,167764295,642904465,2,0,1,1536,4,2260988007
18715,475171599,144785955,619957554,5,0,0,66560,11,9628083497
18716,475214909,167691056,642905965,1,0,1,2560,5,6045524917
18717,475234850,144331243,619566093,4,0,0,27648,2,5095583617
18718,475287690,167678525,642966215,5,0,1,36352,11,4328511242
18719,475295430,145131691,620427121,3,0,0,162816,3,3608896434
18720,475301150,144256440,619557590,3,0,0,135168,3,3221113197
18721,475308000,167792989,643100989,5,0,1,73728,11,8891229344
18722,475315989,144273635,619589624,5,0,0,34304,11,479862289
18723,475342069,167831478,643173547,1,0,1,16896,5,3186049056
18724,475350240,144369778,619720018,0,0,0,1024,10,8831008085
18725,475367779,144865086,620232865,5,0,0,53248,11,8471173674
18726,475371970,145202949,620574919,3,0,0,97280,3,6258825925
18727,475375239,144535645,619910884,8,0,0,129024,2,10480355996
18728,475380071,167793499,643173570,9,0,1,23552,17,7780287823
18729,475385240,167788353,643173593,3,0,1,1024,3,6124402121
18730,475405711,167767905,643173616,9,0,1,20992,17,7730619002
18731,475407441,167792273,643199714,9,0,1,14336,17,1677718574
18732,475447730,145448006,620895736,3,0,0,34304,3,5694661571
18733,475449689,144717925,620167614,8,0,0,211456,2,6553763744
18734,475465840,167733929,643199769,2,0,1,9728,4,1308937397
18735,475470880,167728912,643199792,5,0,1,34304,11,8412399366
18736,475472179,145112926,620585105,8,0,0,33280,2,1531173205
18737,475485939,145437468,620923407,8,0,0,49664,2,984093586
18738,475524539,145383659,620908198,5,0,0,20992,11,4883057762
18739,475571171,167630023,643201194,9,0,1,14336,17,924577670
18740,475579560,167621788,643201348,5,0,1,8704,11,4659340255
18741,475579920,145185175,620765095,3,0,0,83968,3,6619625888
18742,475611510,144299553,619911063,0,0,0,512,10,9850310537
18743,475630840,167575872,643206712,7,0,1,20480,16,7049314896
18744,475642859,144890133,620532992,8,0,0,88064,2,9157193371
18745,475664729,144841408,620506137,8,0,0,231424,2,7153916940
18746,475709750,167527638,643237388,7,0,1,7680,16,1523319469
18747,475745550,167491861,643237411,5,0,1,25088,11,9686584652
18748,475758820,145126418,620885238,4,0,0,394240,2,1793781362
18749,475820740,167430974,643251714,7,0,1,48640,16,7921027419
18750,475832600,167424430,643257030,5,0,1,21504,11,2131163540
18751,475847530,167454497,643302027,7,0,1,3584,16,6657744700
18752,475853420,144842703,620696123,0,0,0,8704,10,9339774284
18753,475855121,167451499,643306620,9,0,1,38912,17,4297295231
18754,475919040,145101173,621020213,4,0,0,317440,2,306792708
18755,475923389,145408322,621331711,8,0,0,182272,2,6373793731
18756,475940140,167377857,643317997,5,0,1,23040,11,10466573652
18757,475942021,167379609,643321630,9,0,1,4096,17,1100008258
18758,475958040,167459902,643417942,7,0,1,58880,16,7314754964
18759,475963360,145151723,621115083,3,0,0,58880,3,10040844800
18760,476001100,167417508,643418608,7,0,1,11264,16,973148610
18761,476074050,145021619,621095669,3,0,0,110592,3,3986234772
18762,476098670,167677988,643776658,7,0,1,5120,16,8968898709
18763,476116810,167659871,643776681,3,0,1,14848,3,6317241896
18764,476131670,145109686,621241356,3,0,0,238080,3,4177774371
18765,476131990,167676168,643808158,3,0,1,11776,3,6514165171
18766,476160619,145092928,621253547,8,0,0,39936,2,6497118759
18767,476163370,167649934,643813304,7,0,1,8192,16,2419277946
18768,476164990,167827826,643992816,5,0,1,61952,11,8492898887
18769,476210459,144851491,621061950,8,0,0,136704,2,392609726
18770,476229511,167763328,643992839,9,0,1,34304,17,560660027
18771,476269720,144446268,620715988,0,0,0,2560,10,5978215872
18772,476288430,143985362,620273792,4,0,0,2048,2,7716233097
18773,476327459,144574072,620901531,5,0,0,18944,11,2741344333
18774,476328780,167668941,643997721,7,0,1,1024,16,6683298619
18775,476343460,167654284,643997744,7,0,1,17920,16,931052371
18776,476348049,145251786,621599835,8,0,0,271872,2,3310855813
18777,476350810,167662436,644013246,5,0,1,54784,11,6214503831
18778,476361410,144363794,620725204,4,0,0,2560,2,10538413515
18779,476364050,167654342,644018392,8,0,1,8192,2,1648185217
18780,476368880,167679908,644048788,7,0,1,1024,16,2402516652
18781,476402651,167647763,644050414,9,0,1,2560,17,4520029397
18782,476403210,167647870,644051080,2,0,1,11264,4,2478183757
18783,476410259,145106648,621516907,8,0,0,313344,2,4314041541
18784,476418570,144483140,620901710,4,0,0,512,2,4652504700
18785,476424940,167626499,644051439,3,0,1,9728,3,7472980899
18786,476467940,167611505,644079445,7,0,1,7680,16,8931971564
18787,476470620,167634869,644105489,5,0,1,37888,11,8805315442
18788,476480460,144616652,621097112,0,0,0,4608,10,1363812963
18789,476506760,144621707,621128467,4,0,0,1024,2,1814301840
18790,476526969,145212669,621739638,8,0,0,215040,2,617725332
18791,476562090,167740899,644302989,3,0,1,39424,3,8642505089
18792,476604850,167698162,644303012,7,0,1,3072,16,6550374297
18793,476671759,145001533,621673292,8,0,0,193024,2,8244080333
18794,476679069,145088849,621767918,5,0,0,89088,11,10681506819
18795,476694780,167608255,644303035,3,0,1,9728,3,4831132903
18796,476699330,144646588,621345918,3,0,0,3584,3,5055720866
18797,476717881,167585177,644303058,9,0,1,6144,17,6726105134
18798,476749060,167554021,644303081,3,0,1,28160,3,784421505
18799,476763840,144490978,621254818,0,0,0,4096,10,10375137179
18800,476774180,167528924,644303104,5,0,1,6144,11,1724299623
18801,476816191,167486936,644303127,9,0,1,3072,17,3198285598
18802,476841600,167461550,644303150,7,0,1,7680,16,8191797368
18803,476851780,144822315,621674095,0,0,0,2560,10,3912790574
18804,476857480,167445693,644303173,5,0,1,10240,11,28365372
18805,476865051,167469688,644334739,9,0,1,58880,17,9697806022
18806,476880760,167481053,644361813,5,0,1,30720,11,7949755065
18807,476884171,167510136,644394307,9,0,1,1536,17,7514021338
18808,476897740,144704458,621602198,3,0,0,7680,3,6013054395
18809,476938591,167455739,644394330,9,0,1,13312,17,968875998
18810,476942590,144669552,621612142,3,0,0,1024,3,793374040
18811,476979851,167505713,644485564,9,0,1,26112,17,408474038
18812,477031040,167454547,644485587,7,0,1,12288,16,3824081089
18813,477053049,144558758,621611807,8,0,0,31232,2,581128478
18814,477063730,167421880,644485610,5,0,1,15872,11,8123946813
18815,477070430,167542466,644612896,3,0,1,102400,3,501737648
18816,477109421,167645250,644754671,9,0,1,2048,17,6166230739
18817,477114490,167837339,644951829,5,0,1,44032,11,10384626793
18818,477122501,167829351,644951852,9,0,1,18432,17,1738786778
18819,477123821,167828062,644951883,9,0,1,12288,17,7858630210
18820,477127870,167877239,645005109,3,0,1,36864,3,5536809318
18821,477152910,167974449,645127359,8,0,1,30720,2,2070367099
18822,477172570,168094768,645267338,8,0,1,53760,2,6028053088
18823,477212560,168118495,645331055,5,0,1,37376,11,7497252350
18824,477282979,144667588,621950567,8,0,0,172544,2,3164627551
18825,477291031,168040047,645331078,9,0,1,1536,17,9409908998
18826,477303130,144715604,622018734,3,0,0,1536,3,1063016068
18827,477303140,168027961,645331101,7,0,1,15872,16,2552469183
18828,477335630,167995494,645331124,7,0,1,20480,16,1263867723
18829,477387930,168022367,645410297,7,0,1,63488,16,6746585679
18830,477391270,168096046,645487316,5,0,1,30208,11,713987567
18831,477395989,144752693,622148682,8,0,0,303104,2,2050792615
18832,477397470,168097153,645494623,3,0,1,1024,3,6385718888
18833,477426181,168090981,645517162,9,0,1,23040,17,9488823290
18834,477492100,144532121,622024221,0,0,0,4608,10,7606492005
18835,477539500,168119524,645659024,5,0,1,32256,11,7943833805
18836,477540071,168118976,645659047,9,0,1,11264,17,8457625730
18837,477543560,168196185,645739745,5,0,1,26112,11,5156123016
18838,477559481,168180287,645739768,9,0,1,4608,17,9397017744
18839,477570760,144584510,622155270,0,0,0,1536,10,3389042795
18840,477580790,144422171,622002961,0,0,0,3072,10,6869767507
18841,477616711,168123080,645739791,9,0,1,5120,17,8930597668
18842,477624740,168208877,645833617,7,0,1,38400,16,4827579288
18843,477656750,168176890,645833640,7,0,1,6144,16,143209451
18844,477664919,144733612,622398531,8,0,0,29184,2,266666118
18845,477670500,168163163,645833663,7,0,1,4096,16,6018108803
18846,477690570,168143116,645833686,3,0,1,48640,3,3071299794
18847,477699690,144630086,622329776,3,0,0,2048,3,6095687168
18848,477710810,168122899,645833709,3,0,1,22016,3,2173950500
18849,477716010,168117754,645833764,5,0,1,64000,11,9411940195
18850,477809329,144841705,622651034,8,0,0,103936,2,2806162690
18851,477817929,144799234,622617163,8,0,0,80384,2,225750435
18852,477842830,167990957,645833787,8,0,1,17408,2,667534622
18853,477904370,167948050,645852420,3,0,1,30208,3,7081583066
18854,477950630,167901813,645852443,5,0,1,25088,11,2144159182
18855,477997630,144534223,622531853,3,0,0,512,3,3735879067
18856,478005830,144566206,622572036,0,0,0,3584,10,10307694177
18857,478033740,167818726,645852466,3,0,1,22016,3,9051462024
18858,478049280,144602089,622651369,4,0,0,1024,2,1268938692
18859,478049680,167802809,645852489,3,0,1,11776,3,3808598883
18860,478063420,167818607,645882027,5,0,1,22528,11,5219289311
18861,478071140,167810926,645882066,3,0,1,57344,3,1767113483
18862,478087930,167819475,645907405,3,0,1,6656,3,10080252562
18863,478124220,144581255,622705475,4,0,0,3584,2,3518446825
18864,478124620,167789446,645914066,5,0,1,30208,11,4325740672
18865,478125110,167793143,645918253,5,0,1,5632,11,2850020669
18866,478158439,144896476,623054915,8,0,0,89088,2,4311517639
18867,478167200,167759745,645926945,5,0,1,13824,11,131628820
18868,478174760,144805190,622979950,0,0,0,3072,10,7983361405
18869,478182250,167764282,645946532,7,0,1,57344,16,9950643294
18870,478213179,144911473,623124652,5,0,0,142336,11,173135034
18871,478224050,167749362,645973412,7,0,1,44544,16,9503102322
18872,478261829,167728190,645990019,0,0,1,14336,10,3796738725
18873,478262460,145135358,623397818,4,0,0,7168,2,391919176
18874,478270170,167723075,645993245,3,0,1,5120,3,7550031934
18875,478276290,167718581,645994871,7,0,1,2560,16,6493095366
18876,478286569,144959579,623246148,8,0,0,75776,2,4725842870
18877,478292720,167730867,646023587,8,0,1,49664,2,10696019145
18878,478320740,167711027,646031767,7,0,1,22528,16,4382518426
18879,478336460,145115745,623452205,3,0,0,2048,3,6014387789
18880,478337240,167697433,646034673,3,0,1,4608,3,2834990211
18881,478443040,144584708,623027748,3,0,0,4608,3,4364553384
18882,478445820,144624416,623070236,4,0,0,2560,2,9524406156
18883,478452240,167584264,646036504,3,0,1,15872,3,3050786497
18884,478462221,167576780,646039001,9,0,1,14848,17,6437606872
18885,478471590,167591989,646063579,5,0,1,14848,11,1423727155
18886,478473109,145223125,623696234,8,0,0,353792,2,7437647421
18887,478496020,145004167,623500187,4,0,0,7168,2,2734565195
18888,478506469,145081946,623588415,8,0,0,248832,2,5766110615
18889,478514619,145205038,623719657,8,0,0,76800,2,2229985224
18890,478530640,167547316,646077956,8,0,1,16384,2,5502835078
18891,478538350,167609599,646147949,5,0,1,1536,11,5951854522
18892,478544610,167624920,646169530,5,0,1,512,11,9414213237
18893,478551180,144910436,623461616,0,0,0,1024,10,723751644
18894,478671370,144805753,623477123,3,0,0,2048,3,1391943999
18895,478690630,167483406,646174036,7,0,1,7168,16,2057843470
18896,478804860,144917531,623722391,4,0,0,3072,2,3434732614
18897,478849050,167352759,646201809,5,0,1,8704,11,10271324591
18898,478860930,144859131,623720061,0,0,0,1024,10,4076543697
18899,478865699,144948594,623814293,5,0,0,47104,11,7990195704
18900,478875200,144877630,623752830,3,0,0,6144,3,10438661842
18901,478881350,144840082,623721432,4,0,0,4096,2,4527331880
18902,478920190,167311813,646232003,5,0,1,28160,11,4383498867
18903,478920589,145363258,624283847,8,0,0,110080,2,5041082931
18904,478959850,167467503,646427353,8,0,1,5120,2,3763759991
18905,479002720,167425094,646427814,8,0,1,10240,2,4272194367
18906,479034530,167469665,646504195,8,0,1,26624,2,4322407183
18907,479035470,144834957,623870427,3,0,0,4096,3,6074627327
18908,479185090,167319128,646504218,5,0,1,5120,11,309987151
18909,479195400,167308841,646504241,5,0,1,14848,11,3546899475
18910,479205240,167299024,646504264,5,0,1,7168,11,4646935228
18911,479242810,145041372,624284182,4,0,0,1024,2,9256786388
18912,479274980,144660483,623935463,0,0,0,1024,10,4688180609
18913,479291480,167212807,646504287,5,0,1,15872,11,6594031216
18914,479314229,145212217,624526446,5,0,0,185344,11,4685841038
18915,479324510,167279605,646604115,5,0,1,12288,11,3391221301
18916,479358850,167262495,646621345,7,0,1,46080,16,4329133561
18917,479361719,145071543,624433262,5,0,0,3072,11,3282926108
18918,479363539,145299278,624662817,8,0,0,117760,2,1031584999
18919,479403990,144680366,624084356,0,0,0,1024,10,558241761
18920,479406470,167264085,646670555,7,0,1,9728,16,3770960409
18921,479421629,145205285,624626914,8,0,0,47616,2,4220053674
18922,479426419,145419579,624845998,8,0,0,363008,2,2651764041
18923,479472390,145055795,624528185,4,0,0,5632,2,4749298882
18924,479488980,144713412,624202392,4,0,0,1536,2,519281550
18925,479499880,167170698,646670578,8,0,1,16896,2,9431350120
18926,479504139,145221554,624725693,8,0,0,58368,2,3681467785
18927,479521250,144930663,624451913,3,0,0,2048,3,260422067
18928,479534830,144807522,624342352,0,0,0,512,10,7140435576
18929,479537200,167133401,646670601,8,0,1,25600,2,6094753428
18930,479568440,144716389,624284829,0,0,0,2048,10,713210421
18931,479581870,167104114,646685984,7,0,1,37376,16,5063638780
18932,479614800,167072170,646686970,5,0,1,1536,11,111540325
18933,479631429,167056412,646687841,0,0,1,12288,10,6808713534
18934,479680610,167904668,647585278,7,0,1,885760,16,7747240100
18935,479718379,145592019,625310398,5,0,0,108544,11,6920917353
18936,479803930,145044477,624848407,3,0,0,4096,3,180096157
18937,479880860,167728072,647608932,7,0,1,67584,16,67096946
18938,479886850,144960286,624847136,0,0,0,512,10,946439969
18939,479888220,144720997,624609217,4,0,0,2048,2,10420059321
18940,479908520,167837207,647745727,7,0,1,239616,16,1003368001
18941,479911440,167836873,647748313,5,0,1,4096,11,3044364384
18942,479925799,145591975,625517774,8,0,0,86016,2,3002171624
18943,479963059,146072408,626035467,8,0,0,265728,2,4826603385
18944,480002580,167751891,647754471,5,0,1,29184,11,9508770947
18945,480004130,144846328,624850458,0,0,0,6656,10,9870600757
18946,480014520,167749341,647763861,8,0,1,5120,2,9203687791
18947,480034729,145180886,625215615,8,0,0,222720,2,3469278160
18948,480120220,144766347,624886567,4,0,0,2560,2,9829979191
18949,480141440,167643326,647784766,7,0,1,40448,16,553278648
18950,480164890,145294947,625459837,3,0,0,5120,3,1705728995
18951,480199069,144790185,624989254,5,0,0,74752,11,1642780865
18952,480221710,167564427,647786137,5,0,1,2048,11,9763304963
18953,480242489,167545274,647787763,4,0,1,2560,2,10458609237
18954,480271550,167518569,647790119,8,0,1,27648,2,9313416608
18955,480303009,145557948,625860957,5,0,0,203264,11,6821515552
18956,480368029,167431010,647799039,4,0,1,7680,2,7479977832
18957,480402919,145055335,625458254,5,0,0,128000,11,2779519902
18958,480431459,146283261,626714720,8,0,0,1243648,2,8430832178
18959,480433810,144781984,625215794,3,0,0,512,3,4380445415
18960,480440970,144405987,624846957,4,0,0,3072,2,4778564639
18961,480444971,167406783,647851754,6,0,1,117248,7,9006565764
18962,480546599,145176118,625722717,8,0,0,206848,2,8253821809
18963,480554420,145756784,626311204,0,0,0,512,10,486511505
18964,480566590,144783582,625350172,0,0,0,1024,10,262854905
18965,480627580,167238498,647866078,7,0,1,47616,16,7010681544
18966,480629730,145601343,626231073,3,0,0,512,3,1872993151
18967,480642390,167236902,647879292,8,0,1,16896,2,203918313
18968,480689059,146159366,626848425,8,0,0,325120,2,8144660956
18969,480698259,146041700,626739959,5,0,0,31744,11,10482147221
18970,480710130,145388712,626098842,3,0,0,4608,3,1204650998
18971,480747290,144771131,625518421,0,0,0,2048,10,5619035828
18972,480802930,167082387,647885317,8,0,1,13824,2,7794780431
18973,480817100,167147821,647964921,7,0,1,150016,16,1765563494
18974,480827650,144896205,625723855,4,0,0,3584,2,6322140361
18975,480828260,144778237,625606497,0,0,0,512,10,9971808440
18976,480837929,146086006,626923935,8,0,0,65536,2,1299448631
18977,480867049,145862982,626730031,5,0,0,50176,11,3578614940
18978,480869330,144590686,625460016,3,0,0,512,3,10637106681
18979,480890400,167076467,647966867,8,0,1,3072,2,6417361911
18980,480890940,167082379,647973319,8,0,1,10240,2,6741058702
18981,480926380,145249079,626175459,0,0,0,5632,10,9817557078
18982,480937420,145099630,626037050,0,0,0,5120,10,1324277934
18983,480966820,167045246,648012066,7,0,1,84992,16,7661828978
18984,480969800,167046132,648015932,8,0,1,6144,2,4669268097
18985,480982470,167106402,648088872,7,0,1,150528,16,261533763
18986,481003550,146356996,627360546,3,0,0,1024,3,2363560930
18987,481070650,167084038,648154688,7,0,1,105984,16,2806692178
18988,481077150,167093810,648170960,3,0,1,53760,3,3930347184
18989,481144830,167027206,648172036,3,0,1,13312,3,41204352
18990,481162319,146145274,627307593,5,0,0,935424,11,8599217135
18991,481215560,146314764,627530324,6,0,0,267264,7,504909425
18992,481305000,166885465,648190465,7,0,1,42496,16,8439056039
18993,481320571,166915436,648236007,6,0,1,88064,7,5013680740
18994,481335711,166938750,648274461,6,0,1,86016,7,8349777650
18995,481353720,166939471,648293191,7,0,1,46592,16,6940463682
18996,481354289,145395053,626749342,5,0,0,30720,11,3511674636
18997,481391930,144815659,626207589,4,0,0,4096,2,1455768943
18998,481430140,144702546,626132686,3,0,0,512,3,5523289989
18999,481473340,145943972,627417312,6,0,0,41472,7,10523246699
19000,481485639,145872677,627358316,8,0,0,166400,2,1502548978
19001,481490070,146299998,627790068,6,0,0,358912,7,4581156608
19002,481495660,145234596,626730256,4,0,0,512,2,3748120842
19003,481497920,166797537,648295457,3,0,1,3584,3,4303967607
19004,481512570,146168119,627680689,6,0,0,178176,7,3111036945
19005,481515730,145381272,626897002,4,0,0,512,2,7319535388
19006,481539390,145820821,627360211,4,0,0,6144,2,10449250712
19007,481559631,166800466,648360097,6,0,1,138752,7,2275166962
19008,481577460,146048271,627625731,6,0,0,176128,7,9889957205
19009,481590791,166874288,648465079,6,0,1,197632,7,3268520614
19010,481699590,167257534,648957124,7,0,1,977408,16,10503702454
19011,481752569,146239836,627992405,8,0,0,555008,2,9206738355
19012,481760680,167534539,649295219,7,0,1,816640,16,10240065218
19013,481766350,145655020,627421370,0,0,0,1536,10,4831270087
19014,481768270,146051929,627820199,6,0,0,98816,7,7000575308
19015,481782410,146231554,628013964,6,0,0,70656,7,8881175269
19016,481796219,146572877,628369096,5,0,0,499712,11,287221199
19017,481817049,146318204,628135253,8,0,0,56832,2,8000942775
19018,481879499,146150758,628030257,8,0,0,48640,2,6961924490
19019,481924390,167374447,649298837,7,0,1,16896,16,289660954
19020,481971150,145395626,627366776,6,0,0,19968,7,1276819983
19021,482080320,145450362,627530682,4,0,0,1024,2,7767410792
19022,482147499,146267382,628414881,5,0,0,146432,11,7692008774
19023,482165099,146307908,628473007,5,0,0,132096,11,6643273122
19024,482200070,167135214,649335284,6,0,1,73216,7,7144051213
19025,482316020,145505808,627821828,3,0,0,4096,3,6279593993
19026,482331430,145682869,628014299,3,0,0,1024,3,3998513927
19027,482445359,145377919,627823278,8,0,0,3584,2,6871085113
19028,482476750,145345413,627822163,4,0,0,1024,2,8092229213
19029,482487399,146443344,628930743,5,0,0,64512,11,6275051013
19030,482508720,145117658,627626378,0,0,0,2048,10,2114812119
19031,482518350,145302207,627820557,3,0,0,512,3,2867400223
19032,482522539,166826315,649348854,1,0,1,39936,5,5137388888
19033,482609170,146076802,628685972,4,0,0,512,2,9486526296
19034,482623820,145196558,627820378,0,0,0,512,10,3033453896
19035,482650189,146114013,628764202,5,0,0,126464,11,7271172438
19036,482697540,145729734,628427274,4,0,0,5120,2,405320385
19037,482712440,146299443,629011883,3,0,0,1536,3,1502152570
19038,482727090,145288324,628015414,0,0,0,3584,10,440427918
19039,482732321,145385593,628117914,2,0,0,253440,4,2820138238
19040,482751679,145284685,628036364,5,0,0,19968,11,3705639771
19041,482818320,145317268,628135588,0,0,0,1024,10,7495161663
19042,482822249,146423058,629245307,8,0,0,467968,2,5501179636
19043,483043319,144996234,628039553,5,0,0,6656,11,6969083168
19044,483065370,144971329,628036699,0,0,0,1024,10,1047060651
19045,483109880,166277195,649387075,7,0,1,81920,16,10049670823
19046,483121650,145248405,628370055,0,0,0,3072,10,6779986620
19047,483185410,146060976,629246386,3,0,0,2560,3,10132276320
19048,483225430,144980528,628205958,6,0,0,25088,7,9182525371
19049,483260040,145322039,628582079,6,0,0,20480,7,643224269
19050,483266140,144771362,628037502,4,0,0,2560,2,3847085808
19051,483270460,145155231,628425691,4,0,0,512,2,6836557478
19052,483321080,146003766,629324846,3,0,0,8192,3,8999836532
19053,483407500,145019961,628427461,4,0,0,512,2,2112862709
19054,483410580,144743629,628154209,4,0,0,2048,2,7859242363
19055,483460489,145026893,628487382,8,0,0,47104,2,4459655036
19056,483492279,144933233,628425512,5,0,0,34816,11,4305229304
19057,483492350,144877892,628370242,3,0,0,512,3,6298340498
19058,483519151,165869550,649388701,9,0,1,2560,17,4404289082
19059,483544830,145408587,628953417,3,0,0,4096,3,4397821217
19060,483584091,165808156,649392247,9,0,1,5632,17,5708546557
19061,483602811,165798576,649401387,9,0,1,24064,17,6926209433
19062,483624570,165905769,649530339,7,0,1,326144,16,1762378119
19063,483647630,165926228,649573858,8,0,1,70656,2,2646205250
19064,483654301,165943036,649597337,9,0,1,37888,17,31363835
19065,483657369,145028424,628685793,8,0,0,103936,2,7557651266
19066,483684821,165913822,649598643,9,0,1,2048,17,10648732209
19067,483707059,145775161,629482220,8,0,0,325632,2,3407399936
19068,483741120,144812349,628553469,0,0,0,9216,10,8356365806
19069,483764589,145187549,628952138,8,0,0,70144,2,5382378551
19070,483768150,165877597,649645747,7,0,1,133632,16,3462174390
19071,483788359,165891904,649680263,0,0,1,66560,10,1217025654
19072,483827641,165858421,649686062,9,0,1,19456,17,8322419760
19073,483898410,165823082,649721492,7,0,1,78848,16,5897925205
19074,483932710,144899099,628831809,0,0,0,11264,10,994496394
19075,483957041,165771338,649728379,9,0,1,9728,17,4465449151
19076,483973980,165773510,649747490,7,0,1,30208,16,8748968072
19077,484005320,165872201,649877521,7,0,1,266240,16,5379649428
19078,484018299,145503863,629522162,5,0,0,125952,11,9107579746
19079,484067760,165939217,650006977,7,0,1,280064,16,10432050080
19080,484100570,165958217,650058787,7,0,1,135680,16,289715343
19081,484140320,144896328,629036648,3,0,0,1536,3,8201855302
19082,484185081,165920404,650105485,6,0,1,87040,7,10383375106
19083,484199620,145326346,629525966,4,0,0,2048,2,9718070122
19084,484207249,145517659,629724908,5,0,0,99328,11,857932629
19085,484260920,145065821,629326741,0,0,0,6144,10,9561708741
19086,484260999,145061236,629322235,5,0,0,89600,11,9203025385
19087,484287101,165823210,650110311,9,0,1,7680,17,8244250658
19088,484320450,145240732,629561182,4,0,0,512,2,10674367174
19089,484330850,165779807,650110657,7,0,1,512,16,5642828805
19090,484347339,146073856,630421195,5,0,0,131584,11,3206672735
19091,484392780,165723471,650116251,7,0,1,18432,16,6262244333
19092,484399770,145393832,629793602,4,0,0,1024,2,2285809768
19093,484416410,145333770,629750180,6,0,0,42496,7,1687570658
19094,484425721,165701680,650127401,9,0,1,28672,17,1770894936
19095,484447430,145036263,629483693,0,0,0,4608,10,5335692243
19096,484454090,145519667,629973757,3,0,0,512,3,5873861445
19097,484467350,165660397,650127747,8,0,1,512,2,1060677889
19098,484483199,145185537,629668736,8,0,0,76288,2,52385317
19099,484492001,165654373,650146374,9,0,1,51712,17,813932251
19100,484566861,165594907,650161768,9,0,1,7680,17,9637936113
19101,484580469,144942745,629523214,5,0,0,3072,11,10125184016
19102,484586880,145286779,629873659,0,0,0,4096,10,2090749041
19103,484600579,165565375,650165954,0,0,1,6656,10,8936211673
19104,484678719,145193669,629872388,5,0,0,122368,11,9119610232
19105,484684600,145107646,629792246,0,0,0,6656,10,9042397792
19106,484687580,165490170,650177750,8,0,1,23040,2,4144541855
19107,484726939,145882552,630609491,8,0,0,334848,2,5549356259
19108,484732340,145725375,630457715,0,0,0,6144,10,8933349679
19109,484738090,165442619,650180709,8,0,1,2048,2,3595828356
19110,484766270,165590324,650356594,7,0,1,432128,16,9725658168
19111,484792379,145277667,630070046,5,0,0,175104,11,165353280
19112,484814330,145875483,630689813,7,0,0,185856,16,6219965154
19113,484851730,145407544,630259274,3,0,0,2560,3,129272026
19114,484897480,165460416,650357896,8,0,1,12800,2,4439392163
19115,484905649,165460598,650366247,1,0,1,18944,5,6255695653
19116,484935091,165453285,650388376,9,0,1,37376,17,1847564577
19117,484941360,144875796,629817156,4,0,0,512,2,5529294996
19118,484997980,165391164,650389144,8,0,1,11776,2,611327480
19119,485009149,145623921,630633070,8,0,0,77312,2,2223586720
19120,485015181,165389302,650404483,9,0,1,8192,17,1666018070
19121,485057160,145366107,630423267,4,0,0,3584,2,5125343912
19122,485094741,165310088,650404829,9,0,1,512,17,9625612231
19123,485115390,165311100,650426490,8,0,1,70144,2,4544463509
19124,485115789,144887459,630003248,5,0,0,60416,11,49670526
19125,485125440,165352575,650478015,7,0,1,129536,16,1751528150
19126,485145290,165345122,650490412,7,0,1,33792,16,212960946
19127,485173279,145869075,631042354,5,0,0,539648,11,1172231758
19128,485183011,165348145,650531156,9,0,1,64512,17,3887801950
19129,485213619,145947503,631161122,8,0,0,318464,2,9306048348
19130,485227320,165336703,650564023,8,0,1,59392,2,6075831827
19131,485233380,144772159,630005539,0,0,0,1536,10,751568582
19132,485246899,165318507,650565406,1,0,1,14848,5,2636219574
19133,485251020,165337022,650588042,8,0,1,54272,2,10155814909
19134,485285740,165346605,650632345,7,0,1,116736,16,7132008516
19135,485322431,165323369,650645800,9,0,1,38400,17,6005671309
19136,485360179,145469581,630829760,8,0,0,38400,2,3725455861
19137,485381050,165267099,650648149,7,0,1,1024,16,4958664028
19138,485400630,144584187,629984817,4,0,0,2560,2,3039054894
19139,485429830,165222185,650652015,8,0,1,6144,2,10062984553
19140,485442730,145251566,630694296,0,0,0,1024,10,2748719644
19141,485459109,145604958,631064067,8,0,0,62976,2,7787278378
19142,485476920,144771051,630247971,3,0,0,3584,3,4983668105
19143,485536760,145157201,630693961,3,0,0,6144,3,8703245266
19144,485581180,144861644,630442824,3,0,0,2560,3,1789808660
19145,485607470,145161801,630769271,4,0,0,3584,2,4019195539
19146,485656269,145047566,630703835,5,0,0,31232,11,3925662051
19147,485659220,164994741,650653961,7,0,1,3072,16,6187855439
19148,485670180,165286109,650956289,7,0,1,696320,16,8821331585
19149,485710290,165303208,651013498,7,0,1,136192,16,6784969710
19150,485795930,165218261,651014191,8,0,1,10240,2,455883668
19151,485797490,165379262,651176752,7,0,1,385024,16,346156822
19152,485813811,165365860,651179671,9,0,1,15872,17,1317445767
19153,485853110,165329147,651182257,7,0,1,4096,16,7133082076
19154,485865160,144839166,630704326,0,0,0,1536,10,8507189423
19155,485878110,165331917,651210027,3,0,1,39936,3,1898002782
19156,485889769,165321026,651210795,4,0,1,11776,2,3223287076
19157,485893740,165364062,651257802,7,0,1,104448,16,2675156949
19158,485927380,144764663,630692043,4,0,0,7168,2,277011086
19159,485930810,165562520,651493330,7,0,1,551936,16,2284709529
19160,485938010,145952971,631890981,3,0,0,8704,3,5739739253
19161,485955770,165538866,651494636,8,0,1,2048,2,4082728119
19162,485958239,145635177,631593416,5,0,0,285184,11,9742494534
19163,486035089,145391858,631426947,8,0,0,233984,2,9125208141
19164,486052910,145666692,631719602,3,0,0,7168,3,7580760790
19165,486057149,145660223,631717372,8,0,0,359936,2,4650154594
19166,486065720,145669226,631734946,3,0,0,2560,3,5956664731
19167,486072541,165425641,651498182,9,0,1,5632,17,1788062290
19168,486072870,165431163,651504033,3,0,1,27648,3,5383329949
19169,486082570,145079901,631162471,0,0,0,4096,10,4333844777
19170,486099980,145619957,631719937,3,0,0,1024,3,3397308116
19171,486105690,146229505,632335195,0,0,0,4096,10,6729334766
19172,486107420,165414267,651521687,8,0,1,67584,2,10664384783
19173,486110271,165433362,651543633,9,0,1,8704,17,9117698637
19174,486173710,145547498,631721208,4,0,0,4096,2,7143908806
19175,486211831,165332161,651543992,9,0,1,9728,17,3592978880
19176,486214921,165334211,651549132,9,0,1,2560,17,2198134866
19177,486248230,144794950,631043180,0,0,0,2560,10,3122105736
19178,486261480,165381486,651642966,7,0,1,275456,16,2226515737
19179,486264701,165379443,651644144,9,0,1,13824,17,10465722527
19180,486277390,144983081,631260471,0,0,0,2560,10,8427798162
19181,486291241,165362074,651653315,9,0,1,12288,17,7732409216
19182,486298010,144864640,631162650,4,0,0,512,2,10550493475
19183,486301100,165354945,651656045,7,0,1,11776,16,8315398377
19184,486334620,144710143,631044763,3,0,0,5120,3,245187487
19185,486338399,145549907,631888306,5,0,0,380416,11,530359656
19186,486349279,145999323,632348602,5,0,0,22016,11,5869913078
19187,486366500,145731288,632097788,4,0,0,2048,2,7576278671
19188,486374789,145906367,632281156,8,0,0,189952,2,1854755045
19189,486412750,165247481,651660231,3,0,1,6656,3,10054402809
19190,486463660,145472747,631936407,0,0,0,4608,10,9517246710
19191,486470970,146091905,632562875,4,0,0,13824,2,2515178231
19192,486503019,145427384,631930403,5,0,0,25600,11,3729430611
19193,486511350,165150827,651662177,5,0,1,3072,11,1817727153
19194,486522210,165254214,651776424,7,0,1,284160,16,2993179456
19195,486540439,145904799,632445238,8,0,0,212992,2,10068914293
19196,486545180,144659318,631204498,3,0,0,1024,3,10275551140
19197,486550530,144879184,631429714,3,0,0,8704,3,5920297794
19198,486583639,165195853,651779492,0,0,1,8704,10,8906108662
19199,486604720,145589326,632194046,3,0,0,4096,3,835477741
19200,486634090,165148807,651782897,8,0,1,10752,2,4168003594
19201,486648881,165147728,651796609,9,0,1,28672,17,1620941341
19202,486669199,145646067,632315266,5,0,0,91136,11,10110800919
19203,486684029,145815473,632499502,8,0,0,120832,2,6541411914
19204,486691070,165112366,651803436,3,0,1,1024,3,3678338917
19205,486714641,165095413,651810054,9,0,1,23552,17,3105803494
19206,486733070,145160522,631893592,3,0,0,1024,3,3593843369
19207,486753830,165079220,651833050,5,0,1,20480,11,1091999419
19208,486780490,165142436,651922926,7,0,1,166912,16,1059996609
19209,486798810,165187276,651986086,7,0,1,181760,16,1299177751
19210,486821590,145146585,631968175,0,0,0,4096,10,2259886960
19211,486843630,165149624,651993254,5,0,1,6144,11,1134051832
19212,486851640,165145800,651997440,5,0,1,6656,11,9096550671
19213,486871940,165144241,652016181,5,0,1,15872,11,4792955492
19214,486881629,145817056,632698685,8,0,0,241664,2,286849092
19215,486897390,165126095,652023485,8,0,1,18432,2,7788643339
19216,486902520,145243207,632145727,3,0,0,4096,3,3764268269
19217,486925060,165101011,652026071,5,0,1,4096,11,7124620835
19218,486928250,145238200,632166450,4,0,0,4608,2,2019832491
19219,486944040,144949217,631893257,0,0,0,7168,10,627385010
19220,486950940,145236284,632187224,3,0,0,3584,3,6555974046
19221,486991570,165040505,652032075,5,0,1,20480,11,1637912753
19222,487025769,145139254,632165023,8,0,0,57344,2,1870760628
19223,487036480,164997861,652034341,8,0,1,3584,2,4975872609
19224,487049400,164994273,652043673,2,0,1,14848,4,5706835248
19225,487078570,164965974,652044544,3,0,1,12288,3,6628854779
19226,487087739,145914863,633002602,5,0,0,430592,11,3030697211
19227,487144660,164921256,652065916,2,0,1,34816,4,312892749
19228,487180390,164886192,652066582,8,0,1,1024,2,1156069367
19229,487185690,164887984,652073674,7,0,1,11264,16,676598169
19230,487230430,164845190,652075620,2,0,1,3072,4,6833772989
19231,487244489,145535264,632779753,5,0,0,98304,11,558992523
19232,487267860,164808221,652076081,3,0,1,10240,3,3432133176
19233,487284699,145751990,633036689,8,0,0,12288,2,8668580370
19234,487321930,164754919,652076849,8,0,1,11776,2,7792015651
19235,487351830,164731830,652083660,5,0,1,27136,11,4744172302
19236,487356630,145089567,632446197,4,0,0,3072,2,8007436686
19237,487377000,145634458,633011458,4,0,0,4096,2,5873459228
19238,487393120,144669606,632062726,0,0,0,1536,10,2293450584
19239,487415520,164673926,652089446,8,0,1,21504,2,1878901220
19240,487477460,145022229,632499689,4,0,0,512,2,3357775733
19241,487533850,144915810,632449660,4,0,0,11264,2,1244375509
19242,487566949,144962187,632529136,5,0,0,48640,11,8769759850
19243,487622949,144660905,632283854,8,0,0,8704,2,10371988671
19244,487643340,164449332,652092672,8,0,1,5120,2,7737200910
19245,487678500,144680547,632359047,4,0,0,5632,2,3449745072
19246,487703579,144646340,632349919,8,0,0,4096,2,129873963
19247,487768060,144762191,632530251,0,0,0,3584,10,5246526006
19248,487795129,144654756,632449885,8,0,0,512,2,8612841885
19249,487795519,145055336,632850855,5,0,0,143872,11,3049114740
19250,487842789,145028594,632871383,8,0,0,3072,2,2486869487
19251,487881540,144704837,632586377,0,0,0,1024,10,8633312431
19252,487911490,145170668,633082158,3,0,0,16896,3,4650687078
19253,487957340,164153723,652111063,8,0,1,12800,2,6046076170
19254,487972980,164144602,652117582,8,0,1,6656,2,9426127737
19255,488003890,164117238,652121128,8,0,1,5632,2,6342988509
19256,488009219,144690191,632699410,8,0,0,1024,2,683889979
19257,488061929,144945670,633007599,8,0,0,1024,2,4668190351
19258,488131880,144419241,632551121,0,0,0,1024,10,6065200679
19259,488144400,144318263,632462663,4,0,0,4608,2,3778168532
19260,488164469,145036759,633201228,5,0,0,179712,11,9819688955
19261,488173419,144379082,632552501,8,0,0,512,2,6986366776
19262,488283839,144262041,632545880,8,0,0,512,2,7088770170
19263,488304219,163824001,652128220,1,0,1,11264,5,9315872752
19264,488311310,144726806,633038116,3,0,0,4608,3,3855613326
19265,488320920,144820747,633141667,3,0,0,10240,3,1182452200
19266,488427320,163743916,652171236,2,0,1,110080,4,3080198174
19267,488457249,144241826,632699075,8,0,0,1024,2,8832365630
19268,488501200,163673173,652174373,8,0,1,15872,2,4826570711
19269,488504240,144091226,632595466,0,0,0,3072,10,5308205968
19270,488517729,144352649,632870378,5,0,0,64000,11,1236448948
19271,488594719,144412164,633006883,5,0,0,9216,11,4253511060
19272,488640950,144157467,632798417,4,0,0,3072,2,3457820756
19273,488692720,143889481,632582201,3,0,0,512,3,1281239068
19274,488805730,144201511,633007241,4,0,0,1024,2,418502564
19275,488889910,144114142,633004052,0,0,0,4608,10,5244190303
19276,488907959,163267080,652175039,1,0,1,1024,5,1038530550
19277,489008830,143773598,632782428,0,0,0,8704,10,6730388416
19278,489043840,143679049,632722889,3,0,0,2560,3,8305173843
19279,489063590,163114355,652177945,5,0,1,4608,11,8745140353
19280,489151810,163174996,652326806,7,0,1,353792,16,6431870984
19281,489255470,143819104,633074574,3,0,0,8192,3,4735640153
19282,489268250,163485263,652753513,7,0,1,896512,16,5824044964
19283,489278990,163971799,653250789,7,0,1,1173504,16,2858192736
19284,489324200,163941939,653266139,7,0,1,41984,16,1349043283
19285,489328059,143704840,633032899,5,0,0,66560,11,1039554876
19286,489334430,143875874,633210304,3,0,0,1024,3,785391753
19287,489372060,143636833,633008893,0,0,0,4096,10,1597991727
19288,489407410,163885824,653293234,7,0,1,47104,16,1208683536
19289,489463270,143546894,633010164,4,0,0,4096,2,2977652984
19290,489482849,143557006,633039855,5,0,0,5632,11,6393856805
19291,489514820,143627650,633142470,0,0,0,2560,10,3180965232
19292,489521869,143688077,633209946,5,0,0,28160,11,8310539774
19293,489595080,163799485,653394565,7,0,1,273408,16,9135008297
19294,489613490,143399106,633012596,0,0,0,3584,10,5373540839
19295,489635099,143988689,633623788,5,0,0,13824,11,7835009951
19296,489657299,144461948,634119247,5,0,0,159232,11,191702577
19297,489666590,145417374,635083964,0,0,0,2048,10,1306344905
19298,489716580,144402846,634119426,4,0,0,512,2,9374131221
19299,489769760,163666522,653436282,7,0,1,99840,16,6418462210
19300,489861600,144960969,634822569,3,0,0,3584,3,8887574273
19301,489909980,163582709,653492689,7,0,1,173056,16,6766373475
19302,490013469,144438756,634452225,5,0,0,5120,11,545214085
19303,490031620,144439984,634471604,3,0,0,3584,3,6030509795
19304,490038519,144190882,634229401,5,0,0,94720,11,3838188488
19305,490044470,163474739,653519209,7,0,1,73728,16,3150133621
19306,490058530,144210348,634268878,4,0,0,3072,2,7832668075
19307,490097790,144102081,634199871,0,0,0,1024,10,4022823238
19308,490104170,144583302,634687472,3,0,0,1536,3,5816326797
19309,490188390,144935976,635124366,0,0,0,512,10,8654649962
19310,490225170,144004566,634229736,3,0,0,1024,3,16164909
19311,490236040,145149858,635385898,0,0,0,1536,10,7812740491
19312,490370290,143674816,634045106,0,0,0,3584,10,207294689
19313,490441879,163094325,653536204,1,0,1,9728,5,8966137263
19314,490453159,163084121,653537280,1,0,1,13312,5,6183369555
19315,490495209,144182944,634678153,5,0,0,553472,11,3056848525
19316,490503610,143884240,634387850,0,0,0,2048,10,3630609897
19317,490537150,143889256,634426406,0,0,0,2048,10,3690619446
19318,490585659,162959154,653544813,1,0,1,3072,5,103672294
19319,490607989,162985876,653593865,1,0,1,136192,5,9624743664
19320,490703809,144414498,635118307,5,0,0,112640,11,1604399486
19321,490749570,143607148,634356718,9,0,0,130048,17,2184387162
19322,490788139,143999333,634787472,5,0,0,6144,11,8967169364
19323,490809519,162789192,653598711,1,0,1,12288,5,728750464
19324,490914210,142806686,633720896,0,0,0,1024,10,847311913
19325,490921490,143040930,633962420,0,0,0,512,10,5530612710
19326,490975969,144271291,635247260,5,0,0,95744,11,9001286194
19327,491145040,143655043,634800083,4,0,0,1024,2,9099847128
19328,491148810,142763390,633912200,3,0,0,1536,3,3447747129
19329,491203570,142996948,634200518,3,0,0,2048,3,4082014660
19330,491237860,143158751,634396611,3,0,0,10240,3,5031543405
19331,491246430,143173133,634419563,0,0,0,4608,10,1577795797
19332,491291260,143392890,634684150,3,0,0,12800,3,8716876000
19333,491336530,144528521,635865051,9,0,0,166400,17,3094236937
19334,491353120,162261267,653614387,5,0,1,11264,11,2655897109
19335,491355379,143951823,635307202,5,0,0,21504,11,7614236298
19336,491466790,142732746,634199536,9,0,0,159744,17,874530959
19337,491485360,162153091,653638451,3,0,1,47104,3,4372182498
19338,491509469,144143038,635652507,5,0,0,39936,11,5119629315
19339,491522880,144522861,636045741,3,0,0,3072,3,5912377497
19340,491587360,143201071,634788431,0,0,0,3072,10,2796325188
19341,491641160,162006073,653647233,3,0,1,26624,3,8142624527
19342,491744539,144051919,635796458,5,0,0,45568,11,4317073566
19343,491838340,141736030,633574370,4,0,0,6656,2,2266452547
19344,491935719,143063561,634999280,5,0,0,357888,11,2916869309
19345,491991519,143507069,635498588,5,0,0,248320,11,7174496542
19346,492078979,142705056,634784035,5,0,0,49664,11,2287567848
19347,492131700,143077924,635209624,9,0,0,85504,17,10555301012
19348,492279950,142557613,634837563,3,0,0,2048,3,5202401845
19349,492289019,161364235,653653254,1,0,1,19968,5,6239047204
19350,492334459,161326453,653660912,1,0,1,7168,5,1264843991
19351,492340960,143441591,635782551,9,0,0,369664,17,3281662624
19352,492470060,142414568,634884628,4,0,0,8192,2,10344252821
19353,492490809,161171729,653662538,1,0,1,2560,5,2736322096
19354,492528110,142151938,634680048,4,0,0,6144,2,4717685514
19355,492720350,141966631,634686981,0,0,0,9216,10,10048946747
19356,492764590,143137362,635901952,4,0,0,3072,2,9643507342
19357,492794879,142084613,634879492,5,0,0,26624,11,10004648832
19358,492859029,141400012,634259041,5,0,0,57344,11,9407123998
19359,492936830,142329584,635266414,0,0,0,3584,10,1427402420
19360,492939049,160728635,653667684,0,0,1,8192,10,9115515941
19361,492943410,141878044,634821454,9,0,0,38912,17,4219034253
19362,492957570,141811310,634768880,9,0,0,204288,17,3436447286
19363,492970930,141720514,634691444,3,0,0,3584,3,6006326281
19364,492999700,141784514,634784214,3,0,0,512,3,2084606113
19365,493031469,142483451,635514920,5,0,0,20480,11,5576890234
19366,493035420,142045690,635081110,3,0,0,5120,3,4478916619
19367,493042690,142076576,635119266,3,0,0,3072,3,2403753931
19368,493076049,142003470,635079519,5,0,0,263168,11,1893361587
19369,493114270,141323219,634437489,0,0,0,7168,10,4609371018
19370,493126019,160583126,653709145,0,0,1,80384,10,613831149
19371,493141789,160572918,653714707,0,0,1,6656,10,6295473426
19372,493143760,141653119,634796879,0,0,0,3072,10,7577338088
19373,493144420,141640978,634785398,0,0,0,2560,10,8894877038
19374,493191249,160527004,653718253,0,0,1,5632,10,4193884760
19375,493225809,160495350,653721159,1,0,1,16896,5,7911388129
19376,493231229,160494552,653725781,0,0,1,18944,10,6934169010
19377,493233889,160515474,653749363,0,0,1,74240,10,5066098369
19378,493236699,160521023,653757722,1,0,1,25600,5,5882431026
19379,493270940,141941225,635212165,0,0,0,2048,10,3626104068
19380,493283380,142916065,636199445,4,0,0,7168,2,4365322371
19381,493318189,160439879,653758068,1,0,1,512,5,456890754
19382,493331940,141453637,634785577,4,0,0,512,2,5802928820
19383,493371170,142628101,635999271,0,0,0,3072,10,6217412924
19384,493406439,160360777,653767216,1,0,1,32256,5,5710813185
19385,493424410,141255817,634680227,3,0,0,512,3,8311291891
19386,493497770,141623079,635120849,0,0,0,5120,10,900306902
19387,493536170,142400499,635936669,0,0,0,512,10,9851155195
19388,493563999,160205803,653769802,1,0,1,4096,5,4572111515
19389,493583120,160213079,653796199,3,0,1,49664,3,2314357810
19390,493586540,141662459,635248999,4,0,0,5632,2,1209484125
19391,493679800,141403517,635083317,0,0,0,7168,10,4889014287
19392,493711180,142486035,636197215,9,0,0,76288,17,8017114562
19393,493726270,141605577,635331847,4,0,0,512,2,5984527880
19394,493761780,141393397,635155177,4,0,0,1536,2,10324612884
19395,493766450,142255579,636022029,3,0,0,1024,3,6150317388
19396,493774139,160023340,653797479,1,0,1,14336,5,7648757840
19397,493820489,159996209,653816698,0,0,1,43008,10,3991444043
19398,493855409,159961853,653817262,1,0,1,10752,5,9736413588
19399,493878170,141623132,635501302,4,0,0,4096,2,1768403981
19400,493880150,142360723,636240873,0,0,0,5120,10,7616190779
19401,493887389,159954216,653841605,1,0,1,37888,5,7195404918
19402,493958290,140826282,634784572,3,0,0,1024,3,10148237684
19403,494035830,141085994,635121824,3,0,0,3072,3,10580499923
19404,494123560,142366890,636490450,9,0,0,432640,17,1027252249
19405,494148400,140975787,635124187,3,0,0,7680,3,3724443239
19406,494149939,142023472,636173411,5,0,0,363008,11,5352373462
19407,494201100,142348456,636549556,4,0,0,512,2,869978874
19408,494223560,140958498,635182058,3,0,0,2048,3,2213123430
19409,494228609,141280048,635508657,5,0,0,24064,11,6112786283
19410,494237290,142310146,636547436,3,0,0,12800,3,8088755932
19411,494307349,142480821,636788170,5,0,0,46080,11,1409329685
19412,494318319,142428796,636747115,5,0,0,468480,11,8393185389
19413,494368769,159501217,653869986,1,0,1,72704,5,2269525585
19414,494421880,141180841,635602721,9,0,0,10752,17,2943389157
19415,494429660,142847661,637277321,9,0,0,344576,17,6275324018
19416,494436070,141765582,636201652,4,0,0,7168,2,3624557635
19417,494450389,159435822,653886211,1,0,1,21504,5,385495413
19418,494452720,159599760,654052480,7,0,1,315392,16,2979702511
19419,494529880,141335506,635865386,0,0,0,1024,10,8532251435
19420,494543520,142771345,637314865,3,0,0,512,3,8065881671
19421,494556110,141310391,635866501,4,0,0,3584,2,10076557719
19422,494576130,140923885,635500015,3,0,0,4608,3,7512382980
19423,494594060,159459086,654053146,2,0,1,1024,4,4660276886
19424,494643610,159418228,654061838,2,0,1,13824,4,1514878384
19425,494676200,141918553,636594753,0,0,0,1536,10,10701802754
19426,494729980,159354288,654084268,7,0,1,81920,16,4475579059
19427,494748550,141058621,635807171,4,0,0,5120,2,9192498673
19428,494770440,159318680,654089120,2,0,1,7680,4,107579829
19429,494772289,141771224,636543513,5,0,0,174080,11,2396235840
19430,494797390,159324407,654121797,7,0,1,59392,16,4733498352
19431,494813090,141738351,636551441,4,0,0,1024,2,6726764313
19432,494839059,142780585,637619644,5,0,0,444928,11,9386346471
19433,494862240,159266859,654129099,2,0,1,15360,4,2098205899
19434,494866240,159268248,654134488,2,0,1,17408,4,7642689048
19435,494876649,141877064,636753713,5,0,0,17920,11,7778878234
19436,494885629,141708267,636593896,5,0,0,139264,11,6700848076
19437,494918050,159234889,654152939,7,0,1,63488,16,6042668568
19438,494972840,159204812,654177652,5,0,1,30208,11,10159455591
19439,495012590,141743041,636755631,3,0,0,4608,3,3294954717
19440,495075810,140721139,635796949,0,0,0,1536,10,5984651864
19441,495076360,159200406,654276766,7,0,1,245760,16,7473795597
19442,495123790,140913803,636037593,3,0,0,1536,3,10323332758
19443,495171090,141587106,636758196,4,0,0,6656,2,2735009047
19444,495193480,159088983,654282463,7,0,1,19968,16,189843784
19445,495280960,140733319,636014279,4,0,0,2048,2,5007146987
19446,495293530,159313842,654607372,7,0,1,721920,16,9950781156
19447,495332999,142340360,637673359,5,0,0,113664,11,693922188
19448,495341949,142528645,637870594,5,0,0,528384,11,8965214558
19449,495397170,159215694,654612864,2,0,1,8704,4,6069245071
19450,495410170,159246057,654656227,2,0,1,98304,4,3139608645
19451,495414710,141598431,637013141,3,0,0,7168,3,646697395
19452,495420980,141713611,637134591,9,0,0,2560,17,6414970211
19453,495474360,140323704,635798064,4,0,0,3584,2,772619023
19454,495490920,159200720,654691640,7,0,1,105472,16,3878655611
19455,495501520,141047522,636549042,9,0,0,5120,17,9636928731
19456,495503300,159195214,654698514,3,0,1,32768,3,3305206360
19457,495525840,159174395,654700235,3,0,1,2560,3,2172538877
19458,495544480,141735920,637280400,0,0,0,1024,10,10102681397
19459,495552160,159172478,654724638,2,0,1,64000,4,4610842632
19460,495697770,140546619,636244389,4,0,0,1536,2,848987185
19461,495712530,159029364,654741894,3,0,1,20992,3,9902710679
19462,495714550,159035736,654750286,2,0,1,13312,4,3774349197
19463,495778080,158976072,654754152,7,0,1,6144,16,1320304167
19464,495819499,140417210,636236709,5,0,0,1536,11,3185753631
19465,495832690,140716687,636549377,4,0,0,1024,2,7915843814
19466,495838410,140335515,636173925,9,0,0,1536,17,10061782129
19467,495843030,158912108,654755138,3,0,1,1536,3,6324856021
19468,495864850,140686256,636551106,4,0,0,2048,2,4379856511
19469,495898470,140356846,636255316,3,0,0,1536,3,1857489992
19470,495906280,140348545,636254825,3,0,0,10240,3,5211150712
19471,495935330,140820792,636756122,9,0,0,1536,17,6572612755
19472,495966740,158800524,654767264,3,0,1,54784,3,7618518662
19473,496000180,158775995,654776175,2,0,1,22528,4,10729976157
19474,496016360,158782248,654798608,3,0,1,12800,3,7769595967
19475,496057080,158747577,654804657,3,0,1,19456,3,1876842552
19476,496062410,158751627,654814037,3,0,1,4608,3,3660823259
19477,496081780,140512482,636594262,3,0,0,512,3,5737278431
19478,496084200,140687023,636771223,3,0,0,1024,3,6130560019
19479,496096680,140848216,636944896,3,0,0,1024,3,8516070035
19480,496126590,141794090,637920680,0,0,0,8704,10,5068353583
19481,496156080,140437995,636594075,4,0,0,512,2,1224596752
19482,496246880,140501350,636748230,9,0,0,3584,17,5083999576
19483,496271510,140482694,636754204,3,0,0,1536,3,5577832745
19484,496273170,140710187,636983357,4,0,0,10240,2,7685851830
19485,496281899,141811158,638093057,5,0,0,481280,11,10571746608
19486,496312669,141921745,638234414,5,0,0,262144,11,7007352130
19487,496323730,140226652,636550382,4,0,0,2560,2,5689951611
19488,496337360,140797566,637134926,4,0,0,1024,2,2816703164
19489,496444490,158371813,654816303,3,0,1,3584,3,7313187467
19490,496473540,141200466,637674006,3,0,0,2048,3,7798787367
19491,496527340,140232845,636760185,3,0,0,2048,3,8219923601
19492,496631250,158192504,654823754,3,0,1,19968,3,1292279552
19493,496675230,140604835,637280065,4,0,0,512,2,3094974734
19494,496677780,158148484,654826264,3,0,1,13824,3,3632780810
19495,496695119,140713145,637408264,5,0,0,139776,11,6430894830
19496,496717820,140714372,637432192,9,0,0,512,17,3382288861
19497,496730549,141710161,638440710,5,0,0,229376,11,624160954
19498,496760270,139998261,636758531,4,0,0,1024,2,7266665113
19499,496905810,141393730,638299540,9,0,0,2048,17,6359888193
19500,496919209,140962640,637881849,5,0,0,36864,11,5071928298
19501,496939650,140544407,637484057,0,0,0,5632,10,10649275027
19502,497086569,140800878,637887447,5,0,0,7168,11,8983705956
19503,497164100,139662731,636826831,4,0,0,2048,2,3186372617
19504,497299120,140584803,637883923,4,0,0,512,2,9717266021
19505,497324430,140035157,637359587,9,0,0,1536,17,3716202172
19506,497354970,139561606,636916576,4,0,0,1536,2,1150210243
19507,497390060,139894413,637284473,0,0,0,8192,10,8311436963
19508,497411970,139699012,637110982,9,0,0,2560,17,5628407264
19509,497421200,139498292,636919492,4,0,0,1024,2,318056925
19510,497442890,140195814,637638704,4,0,0,1024,2,6026034203
19511,497599779,140038590,637638369,5,0,0,29696,11,4361677996
19512,497722330,139899255,637621585,4,0,0,4608,2,2570986420
19513,497730170,139294989,637025159,4,0,0,2048,2,7548796481
19514,497747490,140170313,637917803,9,0,0,9728,17,1647846847
19515,497764099,140781185,638545284,5,0,0,242688,11,9278671976
19516,497898760,139564962,637463722,4,0,0,3072,2,769917981
19517,497943339,139999125,637942464,5,0,0,70656,11,2031897539
19518,497999710,139409224,637408934,9,0,0,2048,17,4861979515
19519,498050750,139226750,637277500,9,0,0,512,17,1749789389
19520,498240899,139446905,637687804,5,0,0,44032,11,7756332484
19521,498268739,140026850,638295589,5,0,0,200704,11,8231426702
19522,498273430,138803563,637076993,0,0,0,9728,10,8095002690
19523,498330640,138949246,637279886,0,0,0,6144,10,7604857564
19524,498373730,139572595,637946325,9,0,0,1536,17,2961168250
19525,498439040,139181095,637620135,0,0,0,1536,10,8306090833
19526,498442500,138835491,637277991,9,0,0,1536,17,2855311794
19527,498495069,139419747,637914816,5,0,0,86016,11,5636460901
19528,498531279,139094252,637625531,5,0,0,11776,11,6797335290
19529,498589899,156237236,654827135,1,0,1,12288,5,8073991093
19530,498609319,156219199,654828518,0,0,1,14848,10,3884193334
19531,498611169,156247655,654858824,0,0,1,55808,10,2160070678
19532,498656119,139924838,638580957,5,0,0,45056,11,269420038
19533,498813000,139280571,638093571,9,0,0,1536,17,7462427002
19534,498813900,138815398,637629298,9,0,0,12288,17,3653067088
19535,498905689,139247653,638153342,5,0,0,196096,11,3268592711
19536,499002349,139631153,638633502,5,0,0,99840,11,4849223644
19537,499116870,138826413,637943283,4,0,0,2560,2,9542129313
19538,499403920,138483862,637887782,4,0,0,1024,2,4335497667
19539,499461730,155589789,655051519,7,0,1,439808,16,1452075358
19540,499569619,138801180,638370799,5,0,0,143872,11,1302342334
19541,499619281,155438085,655057366,9,0,1,3584,17,4776524592
19542,499638070,138516449,638154519,4,0,0,3584,2,7359186284
19543,499790390,137831530,637621920,4,0,0,1024,2,9309364127
19544,499827631,155232001,655059632,9,0,1,3584,17,8015423835
19545,499866240,155195978,655062218,2,0,1,4096,4,2409211758
19546,499904980,137980260,637885240,4,0,0,2560,2,5397106084
19547,499947280,138348488,638295768,9,0,0,512,17,6304929504
19548,499971999,137912415,637884414,5,0,0,1536,11,902447645
19549,500056670,137827074,637883744,9,0,0,6144,17,337407243
19550,500090541,154980566,655071107,9,0,1,8704,17,9558773005
19551,500140620,154931473,655072093,2,0,1,1536,4,3265489330
19552,500178870,137495471,637674341,9,0,0,1024,17,3600273710
19553,500273670,137644312,637917982,9,0,0,512,17,1820815645
19554,500347930,154728349,655076279,2,0,1,6656,4,6254457157
19555,500381461,154698044,655079505,9,0,1,5120,17,8527526633
19556,500384800,138171854,638556654,9,0,0,18944,17,2520902860
19557,500397989,137928951,638326940,5,0,0,87040,11,4705400720
19558,500418000,154663771,655081771,2,0,1,3584,4,6658633985
19559,500466680,137832213,638298893,9,0,0,1024,17,9840911162
19560,500486820,154608669,655095489,2,0,1,20992,4,6371577379
19561,500520610,137367975,637888585,4,0,0,2560,2,7774799824
19562,500549250,137396584,637945834,9,0,0,8192,17,650741527
19563,500657381,154442294,655099675,9,0,1,6656,17,5028604219
19564,500678760,137619752,638298512,9,0,0,2560,17,10598149618
19565,500681640,154423424,655105064,5,0,1,17408,11,9558225898
19566,500683990,137236869,637920859,4,0,0,512,2,5616856711
19567,500834661,154281566,655116227,9,0,1,36864,17,837281866
19568,500880601,154247654,655128255,9,0,1,12800,17,6195635337
19569,500884331,154260879,655145210,9,0,1,38912,17,1045243568
19570,500962960,137603052,638566012,4,0,0,2560,2,9649634783
19571,501022401,154135457,655157858,9,0,1,16896,17,3733515122
19572,501038081,154140122,655178203,9,0,1,36352,17,7866029273
19573,501052229,137419088,638471317,5,0,0,100352,11,8358558832
19574,501067390,137479344,638546734,4,0,0,4608,2,10316942073
19575,501154540,154036133,655190673,2,0,1,51200,4,316894550
19576,501192461,154027474,655219935,9,0,1,43520,17,9722490778
19577,501306890,137243969,638550859,9,0,0,9216,17,10334231408
19578,501342630,137239527,638582157,9,0,0,3584,17,3792129507
19579,501347340,137210795,638558135,9,0,0,4608,17,723593421
19580,501468010,136829653,638297663,9,0,0,6144,17,5033255286
19581,501536370,137028831,638565201,9,0,0,3072,17,4834911394
19582,501564290,136999952,638564242,9,0,0,19968,17,6976175055
19583,501644880,137081790,638726670,9,0,0,512,17,3157840884
19584,501659660,136640714,638300374,9,0,0,2560,17,6559074048
19585,501713991,153506117,655220108,9,0,1,8704,17,3488218350
19586,501832169,136767404,638599573,5,0,0,56832,11,8246712357
19587,501847070,136720113,638567183,9,0,0,3584,17,1151959173
19588,501883000,136665028,638548028,9,0,0,4096,17,838495693
19589,501900359,136826132,638726491,5,0,0,259584,11,1052903943
19590,501943980,136846124,638790104,4,0,0,11776,2,8881345078
19591,501957411,153272440,655229851,9,0,1,38400,17,7745656008
19592,501981570,136621489,638603059,4,0,0,11264,2,1600516714
19593,502029640,153375348,655404988,7,0,1,325120,16,6942430095
19594,502043859,136603182,638647041,5,0,0,41472,11,1624837549
19595,502112759,136632030,638744789,5,0,0,59392,11,2313277851
19596,502113430,136631866,638745296,9,0,0,1536,17,1883089772
19597,502159751,153251036,655410787,9,0,1,19456,17,9725229966
19598,502315750,136470735,638786485,9,0,0,6656,17,687745753
19599,502382520,153175059,655557579,7,0,1,279040,16,4869801872
19600,502413319,136791207,639204526,5,0,0,322560,11,1245596407
19601,502456300,153273272,655729572,7,0,1,388608,16,1211217669
19602,502662150,153277236,655939386,7,0,1,420352,16,2175352690
19603,502668461,153272001,655940462,9,0,1,13312,17,5118595956
19604,502836881,153104554,655941435,9,0,1,12800,17,3573860865
19605,502862410,153110614,655973024,7,0,1,43520,16,2801942417
19606,502895129,135887786,638782915,5,0,0,123392,11,2737007015
19607,502910020,153165631,656075651,7,0,1,293376,16,7231019923
19608,502910581,153167656,656078237,9,0,1,4096,17,2041598019
19609,502927500,135856842,638784342,9,0,0,4608,17,1552726887
19610,502958621,153123738,656082359,9,0,1,15360,17,6951103601
19611,502962941,153138248,656101189,9,0,1,37888,17,8050924136
19612,502988111,153114006,656102117,9,0,1,11776,17,9178914672
19613,502988950,135645432,638634382,4,0,0,2560,2,3259928322
19614,503011040,135636336,638647376,4,0,0,1024,2,9765205392
19615,503190621,152917295,656107916,9,0,1,20480,17,3826740496
19616,503199460,153022218,656221678,7,0,1,291840,16,7545685142
19617,503200449,135617377,638817826,5,0,0,30208,11,152694276
19618,503226779,135854807,639081586,5,0,0,75264,11,971617079
19619,503346240,135542839,638889079,9,0,0,1024,17,10594179890
19620,503353000,152962468,656315468,7,0,1,204800,16,1367779432
19621,503405409,135831284,639236693,5,0,0,105472,11,4132947469
19622,503541850,135894057,639435907,4,0,0,14848,2,8701656389
19623,503587469,136231292,639818761,5,0,0,549376,11,2364591360
19624,503588340,152738037,656326377,5,0,1,32256,11,3738879763
19625,503667089,135695904,639362993,5,0,0,66048,11,8894571879
19626,503691430,152664290,656355720,7,0,1,49664,16,8836006604
19627,503733490,135323760,639057250,9,0,0,512,17,5002550603
19628,503748470,135489026,639237496,4,0,0,2560,2,2964568059
19629,503768521,152602676,656371197,9,0,1,32768,17,4517678510
19630,503781770,135463888,639245658,9,0,0,3584,17,9350843513
19631,503808231,152563632,656371863,9,0,1,1024,17,6267653449
19632,503812920,152573364,656386284,7,0,1,44544,16,2507941257
19633,503823281,152572950,656396231,9,0,1,29184,17,1349442865
19634,503843159,135984651,639827810,5,0,0,24576,11,2153214017
19635,503844789,136032831,639877620,5,0,0,163328,11,7905409804
19636,503924239,136032808,639957047,5,0,0,260608,11,10275914178
19637,503978469,152432972,656411441,4,0,1,17408,2,7970797834
19638,504024850,152469294,656494144,7,0,1,211456,16,2804721568
19639,504078700,135740240,639818940,4,0,0,512,2,6570999124
19640,504095650,152472980,656568630,7,0,1,180736,16,1233173979
19641,504216970,135221323,639438293,4,0,0,7680,2,5930874347
19642,504260469,152322434,656582903,4,0,1,42496,2,1425276460
19643,504272699,135355222,639627921,5,0,0,10752,11,4023573167
19644,504323180,135042994,639366174,4,0,0,512,2,8685845871
19645,504331100,134999328,639330428,7,0,0,7168,16,6273590407
19646,504372700,152211747,656584447,5,0,1,1024,11,9709741423
19647,504383630,134928347,639311977,4,0,0,1024,2,513152475
19648,504456990,152129100,656586090,7,0,1,23040,16,10308258915
19649,504465899,135710589,640176488,5,0,0,444416,11,8464312860
19650,504500869,152095756,656596625,1,0,1,18944,5,3105780085
19651,504560890,152053314,656614204,5,0,1,20480,11,6705192393
19652,504572830,135247405,639820235,4,0,0,4096,2,2989065169
19653,504634839,151982271,656617110,4,0,1,4608,2,410926446
19654,504660179,151966540,656626719,1,0,1,13312,5,1118114405
19655,504775080,152069840,656844920,7,0,1,514560,16,2411551711
19656,504778899,152067946,656846845,1,0,1,9728,5,10697065391
19657,504795310,135385101,640180411,9,0,0,12800,17,7004017105
19658,504802159,152044840,656846999,4,0,1,8704,2,2070077253
19659,504931739,151937921,656869660,1,0,1,22528,5,5864709410
19660,504961789,151923835,656885624,1,0,1,52224,5,4665725071
19661,504968599,151949614,656918213,4,0,1,57344,2,2467258364
19662,504973901,151956308,656930209,9,0,1,47616,17,104896484
19663,504983710,134393672,639377382,9,0,0,1024,17,5170494773
19664,504992260,134521082,639513342,9,0,0,1536,17,8717488362
19665,505011479,151921316,656932795,1,0,1,4096,5,2446628874
19666,505015460,152029289,657044749,7,0,1,223232,16,9089132300
19667,505020359,152025056,657045415,4,0,1,1024,2,8308415694
19668,505041139,135530437,640571576,5,0,0,468480,11,7442401590
19669,505050830,135654957,640705787,4,0,0,132608,2,6593789873
19670,505061609,135321691,640383300,5,0,0,23040,11,10457894336
19671,505093249,151954010,657047259,1,0,1,14848,5,1056884549
19672,505103399,151945384,657048783,4,0,1,14336,2,9184421537
19673,505172629,151877230,657049859,4,0,1,13312,2,4003901756
19674,505173019,151884636,657057655,1,0,1,37376,5,317807890
19675,505179829,151892508,657072337,1,0,1,17920,5,5771584669
19676,505183250,135165813,640349063,9,0,0,1536,17,8611029504
19677,505240199,135663061,640903260,5,0,0,300032,11,4460469183
19678,505282651,151815417,657098068,9,0,1,19968,17,5708764579
19679,505296079,151802553,657098632,4,0,1,10752,2,1140908523
19680,505301070,135351360,640652430,4,0,0,261120,2,5872737170
19681,505324049,135606534,640930583,5,0,0,89600,11,2470689777
19682,505326439,151788413,657114852,4,0,1,45568,2,6295146163
19683,505378071,151744141,657122212,9,0,1,31744,17,1972979255
19684,505418450,151784772,657203222,7,0,1,208384,16,7872919456
19685,505477559,151730433,657207992,4,0,1,9216,2,8811714820
19686,505584170,151658825,657242995,7,0,1,43008,16,6382967221
19687,505594189,151650663,657244852,4,0,1,13824,2,8924284612
19688,505708051,151537621,657245672,9,0,1,19968,17,1214650060
19689,505726249,134939111,640665360,5,0,0,40448,11,3530261946
19690,505769139,135032199,640801338,5,0,0,313344,11,9389949935
19691,505790951,151455182,657246133,9,0,1,10240,17,5655879391
19692,505811341,151456486,657267827,9,0,1,33280,17,5278728420
19693,505866280,151404340,657270620,7,0,1,12800,16,6530787305
19694,505927889,151345461,657273350,4,0,1,14336,2,125221673
19695,506002230,134809591,640811821,4,0,0,34304,2,4047696739
19696,506012300,134964847,640977147,4,0,0,90112,2,5210927352
19697,506029631,151245025,657274656,9,0,1,2048,17,7472710806
19698,506072540,134500307,640572847,4,0,0,4096,2,3733174063
19699,506112460,151226220,657338680,7,0,1,65024,16,8071454756
19700,506222580,151167730,657390310,7,0,1,169472,16,6807794371
19701,506240700,151189905,657430605,7,0,1,103936,16,5124397110
19702,506248960,151230910,657479870,7,0,1,120320,16,4048722170
19703,506250681,151233375,657484056,9,0,1,6656,17,6044662649
19704,506257101,151227109,657484210,9,0,1,8704,17,2598158342
19705,506266100,151269770,657535870,7,0,1,128512,16,5601574516
19706,506292530,151247526,657540056,5,0,1,6656,11,981713200
19707,506299159,134685655,640984814,5,0,0,25088,11,1905373720
19708,506307870,151362776,657670646,7,0,1,284672,16,10456986362
19709,506317681,151355013,657672694,9,0,1,26112,17,1299805220
19710,506388199,134729272,641117471,5,0,0,78336,11,8073033302
19711,506404300,151277724,657682024,7,0,1,6144,16,8251380101
19712,506415829,134773152,641188981,5,0,0,204288,11,1022350515
19713,506418810,134234203,640653013,9,0,0,1536,17,7475176296
19714,506421609,134626293,641047902,5,0,0,141824,11,5992198695
19715,506465169,134926030,641391199,5,0,0,255488,11,9533907442
19716,506490120,134770048,641260168,4,0,0,118272,2,138293040
19717,506491500,135306858,641798358,4,0,0,381952,2,3833627279
19718,506527650,151245015,657772665,7,0,1,246272,16,9684566095
19719,506538810,151234470,657773280,7,0,1,18944,16,9518121641
19720,506561279,151216187,657777466,4,0,1,6656,2,149555814
19721,506563140,151238317,657801457,5,0,1,20480,11,2079897989
19722,506589120,151357600,657946720,7,0,1,317440,16,8269441538
19723,506589510,151398725,657988235,7,0,1,95744,16,522554995
19724,506601150,135221723,641822873,4,0,0,80384,2,5998164223
19725,506608900,151380961,657989861,5,0,1,2560,11,3861164099
19726,506635619,134588490,641224109,5,0,0,114688,11,9279481813
19727,506647661,151360955,658008616,9,0,1,45056,17,3722731897
19728,506745841,151278209,658024050,9,0,1,13824,17,916061195
19729,506842931,151185712,658028643,9,0,1,7168,17,6155362069
19730,506844750,134677268,641522018,4,0,0,71680,2,2283531811
19731,506939849,151093428,658033277,4,0,1,17920,2,5379558311
19732,506943750,134359796,641303546,4,0,0,32768,2,2606923939
19733,506992860,134977946,641970806,4,0,0,50176,2,8075698767
19734,507054480,134838680,641893160,4,0,0,82432,2,8413001105
19735,507079090,150996521,658075611,7,0,1,99328,16,8697175972
19736,507096121,151009068,658105189,9,0,1,62464,17,6259885714
19737,507117980,134273398,641391378,9,0,0,512,17,5585820966
19738,507129380,134439289,641568669,9,0,0,2560,17,2065898854
19739,507150831,150960362,658111193,9,0,1,21504,17,2374741508
19740,507156841,150956298,658113139,9,0,1,3072,17,8371012926
19741,507175799,134930918,642106717,5,0,0,105472,11,3664025537
19742,507180661,150936024,658116685,9,0,1,5632,17,9995493937
19743,507181710,134344413,641526123,9,0,0,1024,17,2861542669
19744,507195600,135440619,642636219,4,0,0,105984,2,8736425309
19745,507235180,134934724,642169904,4,0,0,147968,2,6466812218
19746,507246850,150876569,658123419,5,0,1,24064,11,6221108030
19747,507252061,150879266,658131327,9,0,1,4608,17,8675878323
19748,507270780,134839236,642110016,9,0,0,10752,17,7346979734
19749,507287479,135200286,642487765,5,0,0,395264,11,9740128054
19750,507354809,134884434,642239243,5,0,0,169984,11,5199287949
19751,507420270,134870476,642290746,9,0,0,168960,17,7287960291
19752,507448759,134915780,642364539,5,0,0,68608,11,5504040230
19753,507581081,150553792,658134873,9,0,1,5632,17,5878589460
19754,507604360,135103687,642708047,4,0,0,93184,2,2598111035
19755,507611739,134971107,642582846,5,0,0,300032,11,10024962134
19756,507620221,150515318,658135539,9,0,1,1024,17,8347278052
19757,507643960,150499785,658143745,7,0,1,39424,16,2697265937
19758,507653930,134171850,641825780,9,0,0,9216,17,585412545
19759,507700300,150444418,658144718,5,0,1,12800,11,10621192091
19760,507717331,150440028,658157359,9,0,1,31232,17,5008778230
19761,507767820,134723587,642491407,9,0,0,11776,17,378136151
19762,507791410,134888182,642679592,9,0,0,141824,17,2082673752
19763,507820091,150344978,658165069,9,0,1,14848,17,7653523201
19764,507915920,134686667,642602587,9,0,0,64512,17,3950600621
19765,507933760,150249999,658183759,5,0,1,39424,11,1929785160
19766,507945390,150259817,658205207,5,0,1,4096,11,959481029
19767,507991431,150229968,658221399,9,0,1,44544,17,123489207
19768,508034731,150193748,658228479,9,0,1,33792,17,92944923
19769,508077269,134710985,642788254,5,0,0,263168,11,6221903315
19770,508097080,150139938,658237018,5,0,1,32256,11,1784959241
19771,508161300,134803604,642964904,4,0,0,158720,2,6168055527
19772,508248790,134578698,642827488,9,0,0,128512,17,6513595997
19773,508256081,149997779,658253860,9,0,1,8704,17,6958015218
19774,508302631,149961496,658264127,9,0,1,4608,17,6677155601
19775,508355660,149909747,658265407,5,0,1,14336,11,5966791481
19776,508407679,149863015,658270694,4,0,1,16896,2,8953570083
19777,508478719,149830341,658309060,4,0,1,62464,2,5417927242
19778,508490409,149818805,658309214,4,0,1,8704,2,5813972126
19779,508533780,134070101,642603881,9,0,0,4096,17,8265656763
19780,508547139,149767874,658315013,4,0,1,19456,2,8469268758
19781,508620791,149704899,658325690,9,0,1,25088,17,9635059860
19782,508621251,149714574,658335825,9,0,1,30720,17,6546339538
19783,508624760,149739544,658364304,5,0,1,51200,11,7153542080
19784,508644179,149736357,658380536,4,0,1,36352,2,6085457541
19785,508710859,149719473,658430332,4,0,1,66560,2,63100072
19786,508746500,149692844,658439344,2,0,1,14336,4,1089398896
19787,508777110,149663207,658440317,5,0,1,12800,11,7241369401
19788,508794981,149650725,658445706,9,0,1,17408,17,7882326259
19789,508799600,149647092,658446692,5,0,1,1536,11,165194961
19790,508840179,133994094,642834273,5,0,0,22016,11,10463165065
19791,508843259,149607645,658450904,4,0,1,6656,2,9946099002
19792,508877339,134209830,643087169,5,0,0,100352,11,7656836889
19793,508879010,149584320,658463330,2,0,1,25088,4,5640506676
19794,508917250,133987161,642904411,4,0,0,92160,2,5063769014
19795,508917689,149550467,658468156,4,0,1,7680,2,6057503927
19796,508922149,134315216,643237365,5,0,0,75776,11,1929401324
19797,508985379,149483136,658468515,4,0,1,9728,2,7861885
19798,509001689,149481590,658483279,4,0,1,8704,2,8203179690
19799,509005209,133851941,642857150,5,0,0,6144,11,220535784
19800,509012931,149480045,658492976,9,0,1,11776,17,847299352
19801,509013271,149480269,658493540,9,0,1,10752,17,9173102641
19802,509034819,149466133,658500952,4,0,1,11776,2,6694397586
19803,509038590,149464308,658502898,5,0,1,3072,11,9851592359
19804,509045060,149480316,658525376,5,0,1,28160,11,4533210321
19805,509084809,134217195,643302004,5,0,0,98816,11,2970617676
19806,509148040,149386989,658535029,2,0,1,14848,4,8157194415
19807,509153980,133850549,643004529,4,0,0,7680,2,7537723604
19808,509154379,134019145,643173524,5,0,0,157184,11,8430281006
19809,509166740,149383844,658550584,5,0,1,50176,11,10145265388
19810,509172089,134027602,643199691,5,0,0,85504,11,4290285161
19811,509176250,149409416,658585666,2,0,1,35840,4,4061251941
19812,509198781,149393536,658592317,9,0,1,19456,17,118114936
19813,509207131,149390575,658597706,9,0,1,17408,17,8398265685
19814,509231840,149376543,658608383,5,0,1,25088,11,487442130
19815,509238730,149370933,658609663,2,0,1,14336,4,9220992568
19816,509277581,149335043,658612624,9,0,1,23552,17,2970874658
19817,509288880,149331725,658620605,5,0,1,8704,11,7136419537
19818,509293920,149334509,658628429,5,0,1,4096,11,3183840199
19819,509305531,149340508,658646039,9,0,1,54784,17,8588723585
19820,509313051,149383397,658696448,9,0,1,24576,17,10594558585
19821,509316490,149383184,658699674,2,0,1,5120,4,2788824804
19822,509321300,134300803,643622103,9,0,0,14336,17,10320357693
19823,509322899,149396964,658719863,4,0,1,67072,2,6522551046
19824,509371721,149351368,658723089,9,0,1,5120,17,8428306767
19825,509405890,149317712,658723602,5,0,1,18432,11,1635438735
19826,509412939,149315515,658728454,4,0,1,17920,2,6419659911
19827,509443810,149314194,658758004,5,0,1,42496,11,477451613
19828,509519980,149241250,658761230,5,0,1,5120,11,7131559666
19829,509588919,149180824,658769743,4,0,1,22016,2,875559967
19830,509595880,134396913,643992793,4,0,0,326144,2,10567360804
19831,509637891,149138483,658776374,9,0,1,23552,17,3409976367
19832,509667059,134109576,643776635,5,0,0,374272,11,192652428
19833,509726580,149059842,658786422,5,0,1,18944,11,2446185889
19834,509727671,149086917,658814588,9,0,1,44544,17,2311253913
19835,509755619,149062515,658818134,4,0,1,5632,2,215353473
19836,509853149,148999871,658853020,4,0,1,58880,2,4370701483
19837,509979109,133894311,643873420,5,0,0,66048,11,4805477118
19838,510051769,148805253,658857022,4,0,1,3584,2,3918583708
19839,510058409,148800867,658859276,4,0,1,27136,2,4127104321
19840,510089869,148773696,658863565,4,0,1,4608,2,3384377887
19841,510094060,148773215,658867275,5,0,1,20992,11,1731115945
19842,510100669,148767592,658868261,4,0,1,1536,2,4551398838
19843,510134709,134133446,644268155,5,0,0,529408,11,4829071103
19844,510174730,148694402,658869132,5,0,1,12288,11,10265022778
19845,510205589,148691659,658897248,4,0,1,34304,2,4413170637
19846,510211430,134123278,644334708,4,0,0,103424,2,2761757231
19847,510234490,148673050,658907540,5,0,1,16384,11,1214589328
19848,510286060,133711638,643997698,4,0,0,15872,2,6502781157
19849,510291419,148618707,658910126,4,0,1,4096,2,7344198367
19850,510414029,148501359,658915388,4,0,1,19968,2,6126207696
19851,510447590,148470064,658917654,5,0,1,3584,11,7457250817
19852,510467370,148463868,658931238,5,0,1,51200,11,1883241761
19853,510491139,133811827,644302966,5,0,0,114176,11,5217562583
19854,510542240,148397316,658939556,5,0,1,24064,11,7058998473
19855,510739959,148200468,658940427,4,0,1,12288,2,1909176199
19856,510809129,148170364,658979493,4,0,1,45056,2,3479996579
19857,510886800,148094281,658981081,5,0,1,15872,11,9083190621
19858,510890580,148107844,658998424,5,0,1,13312,11,7980230596
19859,510945399,148058107,659003506,4,0,1,16896,2,9055625421
19860,510946470,133415280,644361750,4,0,0,88576,2,566473531
19861,511016119,147994121,659010240,4,0,1,25600,2,10239959270
19862,511346120,147678679,659024799,5,0,1,12800,11,1236108850
19863,511418200,147631531,659049731,5,0,1,32256,11,7578874216
19864,511513279,132881005,644394284,5,0,0,106496,11,6836887772
19865,511592169,132893372,644485541,5,0,0,133632,11,951789847
19866,511621079,132884522,644505601,5,0,0,65536,11,10006243230
19867,511733210,147321693,659054903,5,0,1,8192,11,3831036241
19868,511795770,147260119,659055889,5,0,1,1536,11,8199322200
19869,511845320,147210915,659056235,5,0,1,512,11,8175884172
19870,511855629,132756364,644611993,5,0,0,23552,11,2433338168
19871,511892490,132622181,644514671,4,0,0,16384,2,6947001602
19872,511896640,133022695,644919335,4,0,0,139264,2,6104685120
19873,512037419,132642966,644680385,5,0,0,26624,11,711818018
19874,512133370,146943860,659077230,5,0,1,59904,11,1525813594
19875,512173219,146905637,659078856,4,0,1,2560,2,324038481
19876,512207129,132744677,644951806,5,0,0,106496,11,7435914416
19877,512234599,146845883,659080482,4,0,1,14848,2,3465028963
19878,512339519,146752600,659092119,4,0,1,26624,2,4646420496
19879,512430019,146666286,659096305,4,0,1,6656,2,9062900669
19880,512438829,132899666,645338495,5,0,0,24064,11,8592492832
19881,512471749,132859283,645331032,5,0,0,89600,11,6852718699
19882,512603400,146500398,659103798,5,0,1,28160,11,9673042625
19883,512710329,132417007,645127336,5,0,0,173568,11,5237186602
19884,512734450,132133663,644868113,4,0,0,223744,2,8984452020
19885,512743390,146361375,659104765,5,0,1,11776,11,2714876124
19886,512770570,131815804,644586374,4,0,0,16896,2,2221704056
19887,512785959,146323720,659109679,4,0,1,10240,2,8957529856
19888,512797330,146327400,659124730,5,0,1,11776,11,10424966023
19889,512816610,146308684,659125294,5,0,1,10752,11,6070018173
19890,512882779,146249308,659132087,4,0,1,12288,2,1578309276
19891,512985970,131642533,644628503,4,0,0,1536,2,5018440605
19892,512986440,131741463,644727903,4,0,0,1536,2,2430911414
19893,512992469,146141244,659133713,4,0,1,2560,2,4015313272
19894,512995909,132271406,645267315,5,0,0,390656,11,2774226014
19895,513005559,146133300,659138859,4,0,1,8192,2,1738077964
19896,513299670,145841596,659141266,2,0,1,13312,4,1855126796
19897,513302789,132151498,645454287,5,0,0,24064,11,4508400453
19898,513372010,145774402,659146412,2,0,1,8192,4,10702200950
19899,513390620,145796044,659186664,5,0,1,75264,11,1816684783
19900,513439200,145767561,659206761,5,0,1,11776,11,2377389045
19901,513556320,145650787,659207107,5,0,1,512,11,4235966165
19902,513683870,145524773,659208643,5,0,1,23552,11,9839685162
19903,513700180,145512649,659212829,2,0,1,6656,4,5528361672
19904,513793270,145420327,659213597,5,0,1,11776,11,4864615450
19905,513834079,131999491,645833570,5,0,0,307712,11,4684948161
19906,513851310,145366996,659218306,5,0,1,20992,11,5540498793
19907,513956079,131347630,645303709,5,0,0,119296,11,8946955074
19908,514014110,145421265,659435375,7,0,1,419328,16,10459314450
19909,514120860,145323609,659444469,5,0,1,4608,11,7552626970
19910,514134700,145342751,659477451,2,0,1,63488,4,8985239429
19911,514147160,145332557,659479717,2,0,1,3584,4,3850779325
19912,514148909,131510092,645659001,5,0,0,299520,11,6542443674
19913,514287800,145193543,659481343,5,0,1,2560,11,5287664310
19914,514329749,131150274,645480023,5,0,0,8704,11,4546686663
19915,514404240,145083568,659487808,5,0,1,30720,11,4672861438
19916,514422179,131317543,645739722,5,0,0,264704,11,5867313319
19917,514477510,145011604,659489114,2,0,1,2048,4,10239396160
19918,514477520,145013860,659491380,5,0,1,3584,11,8619023234
19919,514633400,144861526,659494926,2,0,1,5632,4,6964116026
19920,514662160,144834072,659496232,2,0,1,2048,4,1554953656
19921,514669209,131212795,645882004,5,0,0,96768,11,3275923845
19922,514767860,144730638,659498498,2,0,1,3584,4,8731491936
19923,514777560,144744860,659522420,5,0,1,52224,11,10652115679
19924,514907070,144621149,659528219,2,0,1,19456,4,3608546001
19925,514948979,130901835,645850814,5,0,0,55808,11,892261438
19926,515070400,144462965,659533365,2,0,1,8192,4,3906028156
19927,515134830,144399508,659534338,5,0,1,12800,11,6545626646
19928,515144960,144394550,659539510,2,0,1,8192,4,3169012145
19929,515183790,144356066,659539856,5,0,1,512,11,7101700455
19930,515193340,144351342,659544682,2,0,1,7680,4,268369315
19931,515247990,144307023,659555013,5,0,1,24576,11,2424206943
19932,515317760,144238918,659556678,2,0,1,11776,4,9997489192
19933,515393799,130458598,645852397,5,0,0,5120,11,3392539752
19934,515491730,144065934,659557664,5,0,1,1536,11,7174515409
19935,515545810,144026834,659572644,2,0,1,43520,4,7388466337
19936,515551130,144043827,659594957,5,0,1,39424,11,9895092540
19937,515612710,143988712,659601422,2,0,1,20480,4,9276068630
19938,515676490,143967485,659643975,2,0,1,58880,4,2372859824
19939,515756620,143900042,659656662,2,0,1,40960,4,8684697839
19940,515807970,143849998,659657968,5,0,1,2048,11,8018697051
19941,515840650,143823271,659663921,2,0,1,28160,4,2189047199
19942,515878399,130625773,646504172,5,0,0,161792,11,9305790371
19943,515907040,143761845,659668885,5,0,1,12800,11,9750080324
19944,515965480,143708794,659674274,5,0,1,17408,11,3445865230
19945,515990199,130680325,646670524,5,0,0,161280,11,2659251821
19946,516056149,130921534,646977683,5,0,0,13312,11,4237952737
19947,516106309,130497783,646604092,5,0,0,253952,11,6531747833
19948,516118409,130220456,646338865,5,0,0,9728,11,7112301927
19949,516193549,129921546,646115095,5,0,0,22528,11,2892140646
19950,516241939,131090651,647332590,5,0,0,425984,11,3273439105
19951,516315309,130305989,646621298,5,0,0,56320,11,1679976631
19952,516319479,130498812,646818291,5,0,0,206336,11,8934643915
19953,516473100,143208649,659681749,2,0,1,8704,4,1666289084
19954,516623030,143074770,659697800,2,0,1,17920,4,7996042306
19955,517379720,142325812,659705532,7,0,1,12288,16,860485112
19956,517815630,141929750,659745380,7,0,1,76288,16,5304962754
19957,518060910,141704808,659765718,7,0,1,31232,16,3267280674
19958,518109800,141660450,659770250,7,0,1,7168,16,7794224950
19959,518334480,141437050,659771530,7,0,1,14336,16,10578390379
19960,518443460,141481674,659925134,7,0,1,302080,16,43564712
19961,518918280,141041032,659959312,7,0,1,75776,16,8677088382
19962,519050070,140997419,660047489,7,0,1,185856,16,10593166971
19963,519065190,141006556,660071746,7,0,1,44544,16,8673386153
19964,519074410,141053865,660128275,7,0,1,133632,16,9088092546
19965,519088530,141111551,660200081,7,0,1,126976,16,2056417462
19966,519105590,141261944,660367534,7,0,1,388096,16,9964449259
19967,519264380,141111981,660376361,7,0,1,29184,16,7595457804
19968,519597930,140786291,660384221,7,0,1,22016,16,3087573179
19969,519634400,140947586,660581986,7,0,1,393728,16,1294181383
19970,519951220,140689079,660640299,7,0,1,160768,16,4772288700
19971,520333490,140309449,660642939,7,0,1,1536,16,1663093948
19972,521385510,139257685,660643195,2,0,1,9216,4,7578002673
19973,521483201,125359502,646842703,2,0,0,55296,4,5771807875
19974,521719100,138948762,660667862,2,0,1,23552,4,1397635447
19975,522525921,124542400,647068321,2,0,0,240128,4,9472100761
19976,522974801,124227982,647202783,2,0,0,62976,4,1178766092
19977,523191381,124334690,647526071,2,0,0,28160,4,7339190488
19978,523239361,124178953,647418314,2,0,0,183296,4,2266793402
19979,523424671,123398003,646822674,2,0,0,14336,4,2920322288
19980,523487171,123668488,647155659,2,0,0,69632,4,8769408472
19981,523577611,123594911,647172522,2,0,0,55296,4,1878937564
19982,523739761,123343707,647083468,2,0,0,49664,4,3237080160
19983,523901481,123228646,647130127,2,0,0,153088,4,237526754
19984,524216391,123213638,647430029,2,0,0,38400,4,3789786816
19985,524757381,122068116,646825497,2,0,0,9216,4,1231716617
19986,524999850,135688412,660688262,7,0,1,51712,16,99474953
19987,526369240,134545034,660914274,7,0,1,472576,16,4275118124
19988,526437640,134519029,660956669,7,0,1,120832,16,7623799850
19989,526726890,134325862,661052752,7,0,1,194048,16,8103729617
19990,526780210,134391076,661171286,7,0,1,305152,16,9058372289
19991,526974700,134232761,661207461,7,0,1,61440,16,3038068305
19992,527003490,134283461,661286951,7,0,1,198656,16,5731558438
19993,527265050,134026727,661291777,7,0,1,7680,16,5037381191
19994,527318600,134002328,661320928,7,0,1,99328,16,4469655832
19995,527597070,134172516,661769586,7,0,1,1064960,16,8547883206
19996,527859180,133912352,661771532,7,0,1,3072,16,8237998318
19997,527952160,133848286,661800446,7,0,1,77312,16,8197978448
19998,528028370,133814658,661843028,7,0,1,89088,16,7743176666
19999,528097070,133885532,661982602,7,0,1,360448,16,2268572924
