RequestID,ArrivalTime,DelayTime,FinishTime,InitiatorID,TargetID,IOType,Size,VolumeID,Offset
0,0,137630,137630,0,0,0,15360,20,1611522013
1,1,137800,137801,3,0,0,512,28,4668802024
2,2,356539,356541,4,0,0,250880,10,464498333
3,3,2272,2275,5,0,1,2048,12,10250960899
4,4,43067,43071,6,0,1,68608,0,7776518367
5,5,48353,48358,1,0,1,25088,18,2363308396
6,6,79700,79706,7,0,0,11776,2,10369245836
7,7,183167,183174,8,0,0,2560,3,5551684527
8,8,408077,408085,9,0,0,53760,9,6729745138
9,9,49975,49984,2,0,1,2560,29,1857426458
10,26650,356504,383154,9,0,0,70144,9,3549756345
11,57920,302116,360036,7,0,0,11264,2,1796097271
12,62940,167712,230652,8,0,1,276480,3,2721279583
13,64140,744934,809074,8,0,0,1536,3,10286719833
14,70770,435073,505843,9,0,0,9216,9,1027382753
15,81330,150628,231958,2,0,1,2048,29,6991882685
16,81560,161944,243504,8,0,1,47104,3,7312279529
17,85570,274481,360051,4,0,1,286208,10,2712626437
18,91500,846773,938273,0,0,0,316416,20,3512361552
19,96550,286619,383169,4,0,1,85504,10,3386024479
20,110580,249650,360230,3,0,0,512,28,5322056006
21,113441,269743,383184,9,0,1,28160,9,9050129100
22,143670,320005,463675,7,0,0,43520,2,822101923
23,162380,220819,383199,6,0,1,24064,0,2714202352
24,188850,784616,973466,4,0,0,74752,10,10143740129
25,193750,190141,383891,2,0,1,21504,29,7103906689
26,201710,521366,723076,3,0,0,3072,28,5901112715
27,291210,260442,551652,4,0,1,292352,10,2441940179
28,292550,261688,554238,4,0,1,4096,10,5191305451
29,341470,447686,789156,7,0,0,16384,2,8885520471
30,371160,579344,950504,4,0,0,39936,10,7387233432
31,380870,173714,554584,5,0,1,512,12,449079780
32,395100,311530,706630,3,0,0,3072,28,7216075936
33,438150,127776,565926,6,0,1,37888,0,8444320523
34,465620,517214,982834,0,0,0,27136,20,5008544059
35,469710,372140,841850,4,0,0,46592,10,10268809708
36,526130,447898,974028,8,0,0,1536,3,7372411727
37,546270,25250,571520,5,0,1,18432,12,808595251
38,607070,4374,611444,5,0,1,4608,12,3665331831
39,608270,4480,612750,2,0,1,2048,29,4138919813
40,617080,333595,950675,4,0,0,512,10,5139637461
41,618830,81632,700462,4,0,1,132096,10,1282590673
42,651800,64215,716015,4,0,1,49664,10,8210719187
43,685430,30739,716169,8,0,1,8704,3,5990543217
44,692230,71249,763479,6,0,1,115200,0,10250005547
45,695910,278641,974551,3,0,0,1536,28,488833584
46,712120,62086,774206,2,0,1,34816,29,7482091613
47,780430,193075,973505,4,0,1,183296,10,7072994936
48,781190,550045,1331235,8,0,0,3072,3,8741283232
49,791540,191357,982897,5,0,1,11264,12,9130333012
50,794340,535921,1330261,9,0,0,111104,9,7790006475
51,798900,184012,982912,1,0,1,8704,18,1282641704
52,829000,153927,982927,6,0,1,1536,0,3269165210
53,838620,144595,983215,1,0,1,2560,18,9904144100
54,857240,510954,1368194,3,0,0,1536,28,10655259
55,868030,118175,986205,2,0,1,9728,29,545116835
56,874700,115456,990156,7,0,1,4608,2,1980035906
57,899660,90650,990310,7,0,1,8704,2,2511043655
58,901740,503569,1405309,7,0,0,17408,2,943625690
59,912690,110481,1023171,1,0,1,54784,18,2461902263
60,913060,113337,1026397,1,0,1,5120,18,3204315736
61,918030,315957,1233987,9,0,0,51712,9,2706253310
62,952030,96008,1048038,8,0,0,1536,3,9647063467
63,968390,510182,1478572,7,0,0,88064,2,4803690859
64,981610,47693,1029303,1,0,1,4608,18,7149107852
65,987190,59055,1046245,6,0,1,64512,0,10717566563
66,1007520,45036,1052556,4,0,1,22016,10,5630329191
67,1040310,785368,1825678,0,0,0,13312,20,7190675434
68,1061660,433187,1494847,4,0,0,7680,10,367096777
69,1084470,14117,1098587,7,0,1,24064,2,4140403690
70,1102150,154745,1256895,4,0,1,254464,10,8873167341
71,1127580,407454,1535034,4,0,0,5632,10,3210512543
72,1134580,1155359,2289939,7,0,0,343040,2,10242271474
73,1146410,120803,1267213,6,0,1,32768,0,3942364256
74,1151280,117521,1268801,1,0,1,15872,18,10564847930
75,1156310,714921,1871231,3,0,0,1024,28,7772152722
76,1177980,92306,1270286,4,0,1,15360,10,4722183564
77,1199130,501197,1700327,4,0,0,25088,10,4988009800
78,1211720,609887,1821607,9,0,0,204800,9,3655687966
79,1223540,1246387,2469927,0,0,0,59392,20,4027067967
80,1235190,303788,1538978,8,0,0,1536,3,3146216027
81,1241860,29809,1271669,8,0,1,14848,3,10262006696
82,1248770,26765,1275535,8,0,1,6144,3,4780546697
83,1266100,10741,1276841,7,0,1,2048,2,2900113307
84,1266480,11347,1277827,8,0,1,1536,3,1644621607
85,1266620,14753,1281373,5,0,1,5632,12,7573213666
86,1267170,63114,1330284,4,0,1,78336,10,4811088198
87,1269460,614104,1883564,9,0,0,26624,9,8367538736
88,1290860,1047454,2338314,0,0,0,158720,20,3253487213
89,1313280,41122,1354402,8,0,1,38400,3,2091017830
90,1337760,17718,1355478,8,0,1,13312,3,4966219279
91,1347330,9121,1356451,4,0,1,12800,10,6015829323
92,1351660,652838,2004498,3,0,0,2560,28,9095034005
93,1378090,27242,1405332,6,0,1,39936,0,10659512577
94,1393871,11476,1405347,9,0,1,8704,9,4372685956
95,1401400,5427,1406827,8,0,1,1536,3,8873989465
96,1409690,4420,1414110,7,0,1,11776,2,824359135
97,1420650,553568,1974218,0,0,0,61440,20,2314614890
98,1432800,5802,1438602,1,0,1,6144,18,4281665681
99,1434180,688116,2122296,4,0,0,125952,10,8580837860
100,1434320,603895,2038215,9,0,0,90624,9,1438017001
101,1446070,605584,2051654,4,0,0,44032,10,4708181442
102,1452230,37367,1489597,5,0,1,17920,12,10012603384
103,1477500,933338,2410838,7,0,0,50688,2,10049010427
104,1493110,590787,2083897,9,0,0,41472,9,3637300849
105,1534630,13221,1547851,4,0,1,21504,10,4767412203
106,1552160,24670,1576830,2,0,1,44544,29,7335937201
107,1571789,6347,1578136,0,0,1,2048,20,7835786864
108,1577379,3898,1581277,0,0,1,4096,20,1292294178
109,1619870,1135791,2755661,9,0,0,67072,9,8294517693
110,1641140,481795,2122935,8,0,0,2048,3,9224555646
111,1653970,326666,1980636,8,0,0,1024,3,3000732604
112,1657380,514047,2171427,3,0,0,6656,28,4889966590
113,1685750,293442,1979192,8,0,0,1024,3,6501149534
114,1693830,8007,1701837,7,0,1,1536,2,2153257926
115,1748100,1994,1750094,5,0,1,2048,12,3432968592
116,1750460,231648,1982108,3,0,0,512,28,77252968
117,1775930,52227,1828157,2,0,1,2560,29,2627849706
118,1804800,187304,1992104,8,0,0,3072,3,3362510947
119,1843380,5971,1849351,6,0,1,14848,0,1270430609
120,1858550,6754,1865304,5,0,1,7168,12,196293242
121,1864270,5454,1869724,1,0,1,13824,18,5116892191
122,1867530,4137,1871667,6,0,1,9216,0,3318731713
123,1869460,25581,1895041,6,0,1,42496,0,696812385
124,1878730,468711,2347441,0,0,0,29696,20,10386459673
125,1905290,261125,2166415,7,0,0,8704,2,1835525233
126,1932310,6754,1939064,2,0,1,7168,29,8627631012
127,1942850,6488,1949338,6,0,1,15872,0,2741612081
128,1961859,28705,1990564,0,0,1,31744,20,260029312
129,1983660,9170,1992830,1,0,1,3584,18,1297173351
130,1994200,549995,2544195,4,0,0,141824,10,3298701726
131,2000370,363658,2364028,4,0,0,25088,10,7627042979
132,2020990,788974,2809964,0,0,0,178176,20,1472373231
133,2029220,441190,2470410,8,0,0,1536,3,9011501203
134,2046290,688920,2735210,0,0,0,160256,20,5137375054
135,2069990,542754,2612744,0,0,0,157696,20,6502664416
136,2076110,47375,2123485,2,0,1,512,29,2918330982
137,2081390,728753,2810143,8,0,0,512,3,9134078013
138,2098260,900454,2998714,0,0,0,202752,20,8564543176
139,2141720,3898,2145618,5,0,1,4096,12,8082581855
140,2159890,11552,2171442,5,0,1,18944,12,8233821510
141,2171770,7706,2179476,7,0,1,8192,2,4968997511
142,2172579,10763,2183342,0,0,1,6144,20,2899107662
143,2172820,375602,2548422,9,0,0,13824,9,5846346917
144,2174080,740738,2914818,9,0,0,16384,9,8372214848
145,2232160,631234,2863394,7,0,0,28672,2,59358666
146,2247540,369692,2617232,8,0,0,1024,3,1636665379
147,2251000,394895,2645895,3,0,0,1024,28,6754737596
148,2251990,95976,2347966,2,0,1,512,29,2924888361
149,2257610,95142,2352752,2,0,1,13312,29,4285576483
150,2270420,93623,2364043,7,0,1,6144,2,9727396691
151,2271490,94043,2365533,1,0,1,19968,18,3482665434
152,2285480,344209,2629689,4,0,0,24576,10,9341125571
153,2339410,539981,2879391,0,0,0,20992,20,3651314788
154,2346349,22073,2368422,3,0,1,11776,28,8371869731
155,2351279,21540,2372819,0,0,1,13312,20,9875877777
156,2371660,7782,2379442,2,0,1,8192,29,8950582689
157,2396640,156707,2553347,8,0,0,3072,3,10482691740
158,2421620,426760,2848380,3,0,0,6144,28,10473869901
159,2437370,11533,2448903,5,0,1,18944,12,3576753940
160,2442090,175157,2617247,6,0,1,282112,0,9581291248
161,2490570,127336,2617906,7,0,1,1024,2,2631474174
162,2503750,117062,2620812,6,0,1,4608,0,3926696366
163,2509379,120325,2629704,0,0,1,5632,20,4612470659
164,2530360,374111,2904471,9,0,0,11776,9,149833079
165,2536720,494043,3030763,4,0,0,104960,10,8152775483
166,2552790,654975,3207765,7,0,0,110592,2,7119502080
167,2619950,553777,3173727,7,0,0,235520,2,10581134774
168,2663020,511034,3174054,8,0,0,1024,3,6219171697
169,2674719,1042,2675761,0,0,1,1024,20,8771371173
170,2734680,75988,2810668,5,0,1,512,12,210456154
171,2842720,7706,2850426,5,0,1,8192,12,395794319
172,2847840,4952,2852792,8,0,1,11776,3,7967236776
173,2859220,224015,3083235,8,0,0,2048,3,1711658670
174,2871330,169842,3041172,8,0,0,512,3,8666960066
175,2886860,1042,2887902,5,0,1,1024,12,4665041886
176,2905800,3387,2909187,5,0,1,9728,12,8405200527
177,2920310,78419,2998729,5,0,1,33280,12,7817181865
178,2924790,73954,2998744,5,0,1,17408,12,8034191307
179,2973150,422607,3395757,4,0,0,75776,10,8936358810
180,2973640,430112,3403752,8,0,0,512,3,5341217358
181,2980220,291728,3271948,0,0,0,125952,20,281157370
182,2995540,277671,3273211,3,0,0,4096,28,10122453661
183,3056019,566,3056585,0,0,1,512,20,7767943946
184,3071520,586511,3658031,4,0,0,224256,10,7948705106
185,3085670,208068,3293738,9,0,0,10240,9,495675410
186,3155380,399770,3555150,0,0,0,33792,20,10096469888
187,3172920,199734,3372654,9,0,0,25600,9,437046561
188,3182710,507160,3689870,9,0,0,104448,9,3870478923
189,3216719,1518,3218237,0,0,1,1536,20,2974726980
190,3233050,537423,3770473,9,0,0,121856,9,6672320502
191,3285459,10241,3295700,0,0,1,16384,20,4628016909
192,3309819,3898,3313717,0,0,1,4096,20,6825880960
193,3310510,473901,3784411,7,0,0,45568,2,8874814451
194,3313510,221372,3534882,4,0,0,2560,10,3039910862
195,3314429,2946,3317375,0,0,1,3072,20,6542756341
196,3322330,13858,3336188,8,0,1,23552,3,7855634727
197,3325090,395573,3720663,7,0,0,95232,2,2325124499
198,3329290,404024,3733314,3,0,0,41472,28,8612831815
199,3381090,310526,3691616,8,0,0,1024,3,8252748572
200,3390940,300349,3691289,8,0,0,4608,3,5250646380
201,3447980,444669,3892649,7,0,0,91136,2,1283850476
202,3448920,408467,3857387,7,0,0,74752,2,6218897924
203,3490340,514543,4004883,3,0,0,130560,28,6073057458
204,3529039,14029,3543068,0,0,1,27136,20,10369098285
205,3532560,263445,3796005,9,0,0,2048,9,6994107242
206,3544060,263539,3807599,7,0,0,37376,2,3564658369
207,3570240,487431,4057671,4,0,0,58368,10,5507937817
208,3647209,123295,3770504,0,0,1,512,20,10706274763
209,3649000,263918,3912918,7,0,0,7168,2,1983794149
210,3685070,225649,3910719,4,0,0,18432,10,10369643462
211,3718130,70614,3788744,5,0,1,4608,12,509041983
212,3724240,172074,3896314,8,0,0,9216,3,4230646543
213,3760770,315168,4075938,3,0,0,59904,28,1094719549
214,3805490,234382,4039872,4,0,0,50176,10,4314497991
215,3869950,457182,4327132,4,0,0,166912,10,1014674742
216,3910600,6472,3917072,5,0,1,11264,12,905426764
217,3983369,25897,4009266,0,0,1,4608,20,3660028447
218,3988250,235959,4224209,8,0,0,2560,3,4894723500
219,4105649,6229,4111878,0,0,1,15360,20,5430458397
220,4165959,5454,4171413,0,0,1,13824,20,4498777471
221,4200620,633029,4833649,4,0,0,309760,10,8356249318
222,4203909,6278,4210187,0,0,1,6656,20,9101156352
223,4204760,197753,4402513,8,0,0,1024,3,5350294885
224,4229460,356682,4586142,4,0,0,65024,10,10730459449
225,4256609,5802,4262411,0,0,1,6144,20,4305375059
226,4262800,324761,4587561,0,0,0,4608,20,10536799403
227,4266650,122391,4389041,6,0,1,198144,0,1903210660
228,4268229,125638,4393867,0,0,1,7680,20,5550214534
229,4281080,594860,4875940,4,0,0,138752,10,968158225
230,4295160,161583,4456743,6,0,1,202752,0,9693864849
231,4338440,574088,4912528,3,0,0,10240,28,824832309
232,4348350,124765,4473115,6,0,1,61952,0,2076682402
233,4384100,525293,4909393,4,0,0,42496,10,10616536148
234,4479250,417156,4896406,3,0,0,27648,28,1661293413
235,4505210,446817,4952027,7,0,0,129536,2,3985376481
236,4546220,581163,5127383,7,0,0,298496,2,676986614
237,4547090,340877,4887967,3,0,0,39424,28,6647159170
238,4551010,585656,5136666,7,0,0,30208,2,2808879382
239,4605720,415430,5021150,3,0,0,14336,28,3388230993
240,4630530,386237,5016767,3,0,0,96768,28,931900797
241,4695120,330257,5025377,4,0,0,13824,10,7311619086
242,4836950,427997,5264947,9,0,0,9216,9,4917351162
243,4839779,112263,4952042,0,0,1,12800,20,5683914020
244,4874480,77577,4952057,2,0,1,4608,29,2646485756
245,4920750,44294,4965044,6,0,1,25088,0,4906733007
246,4952510,21349,4973859,2,0,1,24064,29,3555994838
247,5000390,26113,5026503,6,0,1,1024,0,3438208494
248,5005620,131061,5136681,6,0,1,117760,0,1845586716
249,5005869,183719,5189588,8,0,0,1024,3,6929988661
250,5009750,128358,5138108,7,0,0,4608,2,170581207
251,5019020,330828,5349848,4,0,0,30720,10,2766099518
252,5027799,111786,5139585,0,0,1,1536,20,5847642612
253,5048140,448864,5497004,9,0,0,512,9,497961297
254,5059220,513529,5572749,0,0,0,239616,20,6896153495
255,5059950,84387,5144337,6,0,1,6144,0,4961651283
256,5068030,78253,5146283,8,0,1,3072,3,8884833908
257,5080710,68479,5149189,8,0,1,4608,3,170606809
258,5083100,69315,5152415,8,0,1,5120,3,2997528817
259,5083821,73779,5157600,9,0,1,16384,9,7010452037
260,5111470,167816,5279286,3,0,0,20992,28,6853717431
261,5133290,532931,5666221,0,0,0,139776,20,977677247
262,5134960,27786,5162746,8,0,1,8192,3,1483581001
263,5162840,1518,5164358,8,0,1,1536,3,9779178659
264,5196880,173791,5370671,6,0,1,281600,0,4374139061
265,5197210,388525,5585735,0,0,0,42496,20,6316105979
266,5208420,172978,5381398,6,0,1,34816,0,2459555532
267,5258420,124604,5383024,8,0,1,2560,3,2101587537
268,5270760,330762,5601522,3,0,0,51712,28,1980717525
269,5282740,102550,5385290,8,0,1,3584,3,2788832800
270,5311729,79872,5391601,0,0,1,22016,20,9684769974
271,5320620,73887,5394507,8,0,1,4608,3,8893729893
272,5324479,71974,5396453,0,0,1,3072,20,3505485749
273,5337690,468432,5806122,3,0,0,70144,28,3135116021
274,5364160,483473,5847633,7,0,0,136192,2,7426849505
275,5378600,531870,5910470,7,0,0,89600,2,1017423722
276,5408960,305304,5714264,9,0,0,512,9,6975896923
277,5427160,566,5427726,8,0,1,512,3,7723352954
278,5459790,557271,6017061,7,0,0,116736,2,5280422011
279,5473210,99554,5572764,6,0,1,69120,0,4689472852
280,5474950,574935,6049885,7,0,0,34304,2,10457671294
281,5477830,492807,5970637,3,0,0,53248,28,2001839824
282,5491460,379276,5870736,7,0,0,75776,2,1441677928
283,5499650,710382,6210032,8,0,0,512,3,4657987088
284,5518910,634155,6153065,7,0,0,42496,2,8643823192
285,5555150,316176,5871326,9,0,0,1536,9,2726882122
286,5561900,308851,5870751,6,0,1,318976,0,4324450235
287,5577010,293756,5870766,6,0,1,58880,0,2008068952
288,5578079,292702,5870781,0,0,1,5632,20,10709168465
289,5582840,627021,6209861,7,0,0,67584,2,8921800236
290,5590100,1108026,6698126,7,0,0,199168,2,9185361210
291,5593080,328167,5921247,9,0,0,1536,9,4193268188
292,5619179,251617,5870796,0,0,1,3584,20,7498990027
293,5620350,541630,6161980,3,0,0,29184,28,5544948288
294,5621280,405951,6027231,4,0,0,30208,10,1959025914
295,5630010,240801,5870811,6,0,1,9728,0,2013593143
296,5654720,837944,6492664,3,0,0,116736,28,6242522278
297,5657080,214261,5871341,6,0,1,122880,0,5358206213
298,5662409,208947,5871356,0,0,1,11776,20,6947016395
299,5676060,195311,5871371,6,0,1,9216,0,230523548
300,5690580,180806,5871386,6,0,1,25600,0,10196049374
301,5698200,419519,6117719,7,0,0,512,2,2810672721
302,5721070,455797,6176867,9,0,0,3072,9,6119853633
303,5761970,162233,5924203,6,0,1,206336,0,6290173458
304,5789790,228222,6018012,9,0,0,3072,9,2993901965
305,5798980,126209,5925189,8,0,1,1536,3,3207262295
306,5824310,929367,6753677,7,0,0,182272,2,10454905749
307,5831640,94932,5926572,8,0,1,14848,3,6425454458
308,5863849,64989,5928838,0,0,1,3584,20,2990581808
309,5875560,493853,6369413,0,0,0,51712,20,9413290193
310,5881680,502145,6383825,4,0,0,13312,10,2458554134
311,5905190,546561,6451751,4,0,0,13312,10,2449007414
312,5909700,524795,6434495,8,0,0,2048,3,4552273714
313,5917950,1092968,7010918,3,0,0,122880,28,843127061
314,5917969,11215,5929184,0,0,1,512,20,2527024608
315,5921160,49500,5970660,6,0,1,72192,0,7691173920
316,5958640,479604,6438244,3,0,0,8704,28,2178816383
317,5973240,664187,6637427,0,0,0,87552,20,5289282412
318,5974390,812334,6786724,9,0,0,1024,9,2905070202
319,5999900,438515,6438415,8,0,0,512,3,9658886590
320,6012250,121185,6133435,6,0,1,176640,0,1409334377
321,6042390,839930,6882320,3,0,0,197632,28,6667683848
322,6048140,458061,6506201,8,0,0,512,3,7649595566
323,6061060,149003,6210063,6,0,1,199680,0,7197210763
324,6115780,425458,6541238,3,0,0,9728,28,8643648421
325,6162920,47158,6210078,8,0,1,5632,3,5341424195
326,6178460,359799,6538259,4,0,0,33792,10,4630908142
327,6199840,554320,6754160,9,0,0,1536,9,625554308
328,6200130,716287,6916417,0,0,0,29184,20,6745329755
329,6233209,3387,6236596,0,0,1,9728,20,9657337525
330,6240560,729533,6970093,7,0,0,44032,2,3839291212
331,6264820,288437,6553257,6,0,1,471552,0,215315095
332,6276320,484498,6760818,8,0,0,1024,3,3368398955
333,6284110,476320,6760430,9,0,0,1024,9,1992996879
334,6319510,440593,6760103,4,0,0,19456,10,9901665012
335,6380440,200070,6580510,6,0,1,89600,0,8675364947
336,6397110,498203,6895313,0,0,0,42496,20,9768869084
337,6403120,184111,6587231,8,0,1,24064,3,9969782159
338,6403420,744521,7147941,4,0,0,74752,10,8089707100
339,6502070,258383,6760453,6,0,1,228864,0,4859057036
340,6503219,257249,6760468,0,0,1,9728,20,7882783230
341,6549320,400978,6950298,9,0,0,2048,9,1897636383
342,6570050,727189,7297239,8,0,0,512,3,3814459239
343,6591101,169390,6760491,9,0,1,48640,9,9120872077
344,6651349,111046,6762395,0,0,1,1536,20,1041486798
345,6662470,728085,7390555,7,0,0,92672,2,6618928314
346,6682520,199815,6882335,6,0,1,99840,0,617006915
347,6692040,758139,7450179,7,0,0,172544,2,5071071338
348,6717920,674834,7392754,7,0,0,7168,2,10616917006
349,6754050,872715,7626765,4,0,0,135168,10,1476849105
350,6778139,104211,6882350,0,0,1,12800,20,4293747600
351,6851620,510644,7362264,0,0,0,101888,20,3783011235
352,6851749,791962,7643711,3,0,0,50176,28,5224498301
353,6870450,657934,7528384,9,0,0,512,9,9909048978
354,6923220,198604,7121824,6,0,1,326656,0,2933082676
355,6933990,458959,7392949,9,0,0,512,9,3280744903
356,7040940,620882,7661822,4,0,0,59392,10,1063546821
357,7103699,19610,7123309,0,0,1,15360,20,7236350565
358,7132960,46497,7179457,6,0,1,51200,0,9728250364
359,7174099,6024,7180123,3,0,1,1024,28,2875706781
360,7174240,6344,7180584,6,0,1,10240,0,372534170
361,7210459,3645,7214104,0,0,1,10240,20,127032913
362,7211160,66434,7277594,6,0,1,104448,0,1976035627
363,7232160,314913,7547073,9,0,0,512,9,6829789198
364,7243679,34901,7278580,0,0,1,1536,20,405504058
365,7259200,369208,7628408,9,0,0,3072,9,5602644802
366,7320430,307027,7627457,9,0,0,1024,9,4121290600
367,7334540,61595,7396135,2,0,1,3584,29,10235348087
368,7334740,292390,7627130,9,0,0,1024,9,2343106965
369,7336550,113660,7450210,6,0,1,13824,0,10084867365
370,7343210,361814,7705024,9,0,0,1024,9,3966091301
371,7344530,667553,8012083,4,0,0,67072,10,4650616616
372,7371290,255490,7626780,6,0,1,233984,0,4602163709
373,7396790,230013,7626803,4,0,1,19968,10,3302674662
374,7417000,647356,8064356,7,0,0,120832,2,8564973256
375,7417480,820955,8238435,7,0,0,228864,2,7990845530
376,7484660,177185,7661845,6,0,1,144896,0,2929983146
377,7524020,1021873,8545893,9,0,0,3072,9,2666588834
378,7553910,253189,7807099,4,0,0,5632,10,8116894652
379,7554120,945597,8499717,0,0,0,237568,20,9094053122
380,7565610,979316,8544926,3,0,0,97792,28,9937306687
381,7567229,326273,7893502,3,0,0,37376,28,10052931777
382,7573069,88791,7661860,0,0,1,4096,20,8887112835
383,7594460,144167,7738627,6,0,1,129536,0,903199354
384,7670029,68944,7738973,0,0,1,512,20,3296940917
385,7684799,1066547,8751346,3,0,0,246784,28,650769359
386,7750659,5454,7756113,0,0,1,13824,20,3591237985
387,7754930,14804,7769734,4,0,1,28672,10,7871342141
388,7755750,497787,8253537,0,0,0,41984,20,4859834277
389,7781750,458980,8240730,7,0,0,7168,2,8702441462
390,7799870,147721,7947591,6,0,1,244224,0,4832901568
391,7806720,446996,8253716,9,0,0,512,9,9054296965
392,7819750,1138218,8957968,7,0,0,212992,2,7281297249
393,7832110,943360,8775470,0,0,0,51712,20,695264432
394,7832340,119437,7951777,2,0,1,6656,29,2230014648
395,7840220,122489,7962709,5,0,1,35840,12,9230159539
396,7869769,94118,7963887,0,0,1,13824,20,780631751
397,7905000,500894,8405894,8,0,0,2048,3,553919522
398,7905040,890497,8795537,9,0,0,2560,9,6912366538
399,7933990,78116,8012106,6,0,1,103936,0,6982829522
400,7949689,62432,8012121,0,0,1,12288,20,2430620090
401,7995550,68821,8064371,2,0,1,30720,29,4020000971
402,7999210,148357,8147567,4,0,1,208384,10,5927572039
403,8001880,358834,8360714,4,0,1,251392,10,5988960092
404,8006150,986941,8993091,0,0,0,115200,20,6046130887
405,8009350,366575,8375925,4,0,1,27648,10,2892381240
406,8032650,346115,8378765,7,0,1,3584,2,5079064310
407,8035550,841204,8876754,7,0,0,5632,2,5668003573
408,8052450,447282,8499732,4,0,1,94208,10,3661598544
409,8059029,440766,8499795,0,0,1,16896,20,4831421010
410,8084070,415740,8499810,5,0,1,4096,12,6721618010
411,8096960,896318,8993278,3,0,0,512,28,8148880277
412,8102980,684565,8787545,9,0,0,1536,9,7591413438
413,8114650,497755,8612405,0,0,0,24576,20,8662528272
414,8117940,633889,8751829,9,0,0,1536,9,1850518323
415,8126910,372915,8499825,5,0,1,5120,12,6644488786
416,8132930,366910,8499840,7,0,1,9728,2,9300338671
417,8176510,645437,8821947,7,0,0,31232,2,2893602933
418,8230730,269157,8499887,6,0,1,76288,0,3403352427
419,8247290,939458,9186748,4,0,0,69632,10,8065177823
420,8257520,242382,8499902,6,0,1,31744,0,4322670202
421,8269299,299611,8568910,0,0,1,21504,20,8964527796
422,8286010,879462,9165472,0,0,0,148480,20,4386064994
423,8310610,449089,8759699,8,0,0,1536,3,5031025607
424,8315510,443706,8759216,3,0,0,24064,28,2131331249
425,8321250,692482,9013732,4,0,1,342528,10,6205476359
426,8348710,669848,9018558,2,0,1,7680,29,9570750305
427,8357000,419273,8776273,8,0,0,2560,3,8227257836
428,8380620,700747,9081367,5,0,1,53760,12,1106543743
429,8403720,677662,9081382,7,0,1,5120,2,1687452464
430,8409540,671857,9081397,5,0,1,1024,12,3317734846
431,8435710,341258,8776968,8,0,0,2048,3,5264841643
432,8451640,426782,8878422,9,0,0,1024,9,8867799531
433,8463160,618252,9081412,5,0,1,11264,12,6276621154
434,8477690,603737,9081427,5,0,1,3072,12,4880808425
435,8484770,596672,9081442,7,0,1,1024,2,2286939889
436,8500040,171062,8671102,0,0,0,21504,20,9302718147
437,8501690,579662,9081352,3,0,0,199168,28,7062760775
438,8543590,537883,9081473,7,0,1,34304,2,5664869657
439,8599720,597711,9197431,3,0,0,34816,28,1330785700
440,8622390,459269,9081659,2,0,1,15872,29,501000913
441,8625300,456344,9081644,8,0,0,512,3,2477794771
442,8682700,399910,9082610,9,0,0,3072,9,3784238798
443,8683800,398825,9082625,7,0,1,3072,2,6523163891
444,8692210,390438,9082648,5,0,1,2560,12,527929788
445,8703120,677091,9380211,4,0,0,111616,10,718518233
446,8706900,375763,9082663,7,0,1,9728,2,9622840128
447,8722120,360558,9082678,2,0,1,11776,29,6102000230
448,8723970,363385,9087355,2,0,1,1024,29,6194685465
449,8729530,358901,9088431,5,0,1,13312,12,976366008
450,8745430,348147,9093577,2,0,1,8192,29,9900003731
451,8749809,415678,9165487,0,0,1,14848,20,1518698638
452,8767709,397793,9165502,0,0,1,44544,20,10191619918
453,8822500,343017,9165517,7,0,1,3072,2,6708967615
454,8823250,363513,9186763,7,0,1,18944,2,1840022445
455,8828780,357998,9186778,5,0,1,4096,12,9975674777
456,8854719,332074,9186793,0,0,1,2560,20,1151582762
457,8861090,325718,9186808,7,0,1,6144,2,9543875088
458,8891990,378669,9270659,8,0,0,2048,3,5579735902
459,8928200,273015,9201215,2,0,1,14336,29,10036065707
460,8930329,272832,9203161,0,0,1,3072,20,3749472687
461,8931400,848868,9780268,7,0,0,29696,2,2016829226
462,8940140,263687,9203827,2,0,1,1024,29,6717734476
463,8984750,687932,9672682,3,0,0,60928,28,3862893852
464,9045590,372688,9418278,9,0,0,512,9,1593079864
465,9049190,156711,9205901,7,0,1,13824,2,1192757801
466,9073700,255771,9329471,9,0,0,512,9,6261040871
467,9097710,407698,9505408,9,0,0,2048,9,2689072255
468,9164390,44097,9208487,2,0,1,4096,29,8215619640
469,9166070,525939,9692009,8,0,0,512,3,928137831
470,9167140,42525,9209665,2,0,1,13824,29,6212207414
471,9211870,4374,9216244,5,0,1,4608,12,9563140603
472,9243419,2946,9246365,3,0,1,3072,28,447361990
473,9254100,1121456,10375556,7,0,0,270336,2,843362760
474,9310480,381358,9691838,7,0,0,27648,2,9731395216
475,9315230,5971,9321201,6,0,1,14848,0,9309605073
476,9352340,804488,10156828,7,0,0,181760,2,9441447994
477,9355189,29218,9384407,3,0,1,11264,28,2643811295
478,9364210,875157,10239367,4,0,0,270848,10,3421500373
479,9395430,1085276,10480706,4,0,0,193024,10,48762011
480,9396620,5196,9401816,2,0,1,13312,29,1275869034
481,9412030,3128,9415158,6,0,1,9216,0,858360465
482,9437050,5802,9442852,6,0,1,6144,0,9482302912
483,9444380,566,9444946,7,0,1,512,2,5627601432
484,9446690,558036,10004726,4,0,0,13824,10,1973101229
485,9448620,332459,9781079,8,0,0,2560,3,227923490
486,9449270,114075,9563345,6,0,1,185344,0,7984288692
487,9455960,123552,9579512,6,0,1,60928,0,122568394
488,9500070,921769,10421839,7,0,0,142336,2,3008422471
489,9507920,785189,10293109,7,0,0,175616,2,7706768183
490,9558860,470951,10029811,3,0,0,22528,28,7841556225
491,9571210,13794,9585004,7,0,1,17920,2,1657875094
492,9579560,7070,9586630,5,0,1,2560,12,9743531289
493,9610519,566,9611085,3,0,1,512,28,7357710963
494,9629450,1057068,10686518,3,0,0,41984,28,2526440827
495,9655640,1100520,10756160,0,0,0,174080,20,4977155462
496,9663570,714878,10378448,7,0,0,9216,2,5848180290
497,9664860,574710,10239570,9,0,0,512,9,5869174141
498,9704060,5971,9710031,7,0,1,14848,2,4275585130
499,9720730,380703,10101433,7,0,0,24576,2,6823736044
500,9723370,11791,9735161,2,0,1,19456,29,319118494
501,9768780,714350,10483130,9,0,0,2560,9,385296400
502,9778260,704051,10482311,0,0,0,5120,20,3831087390
503,9778840,28677,9807517,4,0,1,48128,10,964275974
504,9792500,15581,9808081,5,0,1,10752,12,8913751374
505,9802230,107626,9909856,8,0,0,1024,3,1566091934
506,9820750,1042,9821792,5,0,1,1024,12,7681179427
507,9855640,2470,9858110,5,0,1,2560,12,8244286700
508,9871549,566,9872115,3,0,1,512,28,6546216658
509,9919790,11274,9931064,5,0,1,18432,12,8522725914
510,9954000,4850,9958850,2,0,1,5120,29,3952259363
511,9954670,14539,9969209,2,0,1,23040,29,2407443813
512,9963680,5990,9969670,5,0,1,10240,12,984123826
513,9997900,1042,9998942,5,0,1,1024,12,2449228987
514,9998370,6371,10004741,1,0,1,4608,18,4288441542
515,10039380,1042,10040422,7,0,1,1024,2,3703441551
516,10045220,10757,10055977,7,0,1,17408,2,3724000164
517,10068270,938008,11006278,8,0,0,1536,3,8444948675
518,10071910,707688,10779598,3,0,0,61440,28,82836953
519,10090630,2870,10093500,7,0,1,8704,2,244862432
520,10091430,394531,10485961,0,0,0,9216,20,2364032602
521,10111610,263969,10375579,5,0,1,2560,12,3067154763
522,10118179,929280,11047459,3,0,0,112640,28,3281647798
523,10122970,764542,10887512,7,0,0,109568,2,39852395
524,10161580,214014,10375594,5,0,1,6144,12,4618057439
525,10186589,794633,10981222,3,0,0,185856,28,2617466085
526,10189090,186527,10375617,5,0,1,14848,12,3464015083
527,10227249,446462,10673711,3,0,0,126976,28,8703917721
528,10233270,247451,10480721,5,0,1,5632,12,3797228207
529,10241489,239247,10480736,3,0,1,20480,28,252831066
530,10252970,362779,10615749,8,0,0,3072,3,5350102466
531,10267260,533934,10801194,7,0,0,6144,2,322829309
532,10302950,592456,10895406,8,0,0,5120,3,6788097184
533,10347680,897886,11245566,0,0,0,70144,20,1806076265
534,10357440,911281,11268721,8,0,0,512,3,8656947336
535,10365719,120289,10486008,3,0,1,3072,28,10670688209
536,10367650,812830,11180480,0,0,0,94720,20,617693063
537,10374640,112842,10487482,5,0,1,3584,12,7715208045
538,10375500,115286,10490786,2,0,1,15872,29,2946189832
539,10442040,171240,10613280,9,0,0,512,9,6248143887
540,10450060,310803,10760863,4,0,0,15360,10,1556414051
541,10465960,26201,10492161,5,0,1,8704,12,8768596171
542,10469890,991689,11461579,0,0,0,77824,20,9149252714
543,10481389,14452,10495841,3,0,1,4096,28,6346363362
544,10512470,2870,10515340,5,0,1,8704,12,5779691702
545,10525080,760816,11285896,9,0,0,1536,9,2857505248
546,10534610,471185,11005795,0,0,0,71680,20,221963011
547,10583890,1193386,11777276,9,0,0,1024,9,1060767871
548,10584529,13083,10597612,3,0,1,22016,28,348584165
549,10615810,973298,11589108,4,0,0,122368,10,2302143503
550,10653190,447393,11100583,8,0,0,1536,3,7206641141
551,10686210,1061278,11747488,4,0,0,400896,10,1659525609
552,10703570,80432,10784002,6,0,1,11776,0,630259314
553,10754769,733087,11487856,3,0,0,28672,28,9089700229
554,10766450,415613,11182063,9,0,0,5120,9,328624686
555,10820260,71507,10891767,6,0,1,115712,0,4118067800
556,10848430,1166449,12014879,0,0,0,15360,20,8390984851
557,10859430,914321,11773751,4,0,0,86016,10,3539358747
558,10887670,4763,10892433,7,0,1,1024,2,3645549784
559,10914390,1343781,12258171,0,0,0,421376,20,681751419
560,10919280,128194,11047474,6,0,1,162816,0,255578440
561,10928080,119409,11047489,7,0,1,11776,2,7987714364
562,10934120,544985,11479105,8,0,0,3584,3,2333008474
563,10934870,116795,11051665,6,0,1,113152,0,4099490685
564,10949300,102724,11052024,5,0,1,9728,12,7223829922
565,10951269,104621,11055890,3,0,1,6144,28,1735041986
566,10951449,526533,11477982,3,0,0,53760,28,9405136120
567,10976310,85072,11061382,7,0,1,26112,2,10661983916
568,10994000,72976,11066976,7,0,1,18432,2,1016622887
569,11050300,17240,11067540,7,0,1,10752,2,1936703075
570,11066390,1816,11068206,5,0,1,1024,12,9147590321
571,11068490,1236144,12304634,9,0,0,512,9,7167000454
572,11082830,699352,11782182,7,0,0,14848,2,5595387319
573,11097730,3904,11101634,7,0,1,10752,2,2678778035
574,11138840,2946,11141786,7,0,1,3072,2,4050824613
575,11154680,811796,11966476,7,0,0,210432,2,1270963896
576,11165360,20149,11185509,5,0,1,9728,12,8929494216
577,11168810,21126,11189936,7,0,1,5120,2,8216909685
578,11172910,435712,11608622,8,0,0,1536,3,5486369995
579,11175190,19252,11194442,7,0,1,7168,2,8746618493
580,11192840,7706,11200546,8,0,1,8192,3,7743987728
581,11226620,23312,11249932,7,0,1,4608,2,2246585789
582,11249430,2946,11252376,5,0,1,3072,12,8835969720
583,11256830,4850,11261680,8,0,1,5120,3,1507867229
584,11278920,2470,11281390,7,0,1,2560,2,3862285477
585,11283310,493312,11776622,4,0,0,9216,10,9401825640
586,11305870,471765,11777635,8,0,0,1024,3,2843701022
587,11310950,278493,11589443,9,0,0,1024,9,6975296542
588,11336700,10757,11347457,7,0,1,17408,2,5963774353
589,11392580,6278,11398858,8,0,1,6656,3,7680089604
590,11394540,382409,11776949,9,0,0,1024,9,253625341
591,11408460,4374,11412834,7,0,1,4608,2,94622934
592,11433109,574129,12007238,3,0,0,49664,28,462452999
593,11452640,35231,11487871,5,0,1,12800,12,2439251534
594,11461010,531081,11992091,0,0,0,83968,20,4335471687
595,11483140,9097,11492237,2,0,1,4608,29,2924008668
596,11562380,31922,11594302,5,0,1,5120,12,6772516554
597,11573520,230041,11803561,9,0,0,512,9,10674377172
598,11580399,16325,11596724,3,0,1,14336,28,4541900648
599,11593660,512735,12106395,7,0,0,89600,2,10610234114
600,11600480,409704,12010184,4,0,0,9216,10,7622637948
601,11601650,1042,11602692,7,0,1,1024,2,10220702710
602,11609320,3645,11612965,5,0,1,10240,12,4028120554
603,11632520,160577,11793097,6,0,1,30720,0,5770166246
604,11636270,162626,11798896,6,0,1,19456,0,7149183474
605,11649750,652662,12302412,0,0,0,141312,20,3195120379
606,11654100,605241,12259341,8,0,0,1536,3,1909590206
607,11669590,337687,12007277,6,0,1,278016,0,9046971589
608,11675340,1053742,12729082,7,0,0,184832,2,8108490996
609,11676930,330362,12007292,5,0,1,2560,12,9523171590
610,11681510,425056,12106566,8,0,0,512,3,4874954692
611,11696660,713203,12409863,0,0,0,130560,20,2604104012
612,11699370,307937,12007307,7,0,1,9728,2,8604098896
613,11710439,347651,12058090,3,0,0,10240,28,3753775898
614,11745610,261720,12007330,5,0,1,2560,12,151574287
615,11759030,742189,12501219,9,0,0,1536,9,3032954521
616,11760950,543513,12304463,9,0,0,6656,9,6023855745
617,11821980,436870,12258850,8,0,0,2048,3,6843852384
618,11832010,175343,12007353,6,0,1,8192,0,2423112784
619,11840770,217959,12058729,9,0,0,2048,9,4967350846
620,11852579,574653,12427232,3,0,0,56832,28,6541112504
621,11910870,104024,12014894,5,0,1,10240,12,1601646101
622,11912690,400799,12313489,8,0,0,3072,3,2928321906
623,11937140,490575,12427715,8,0,0,1536,3,3938912987
624,11942120,517520,12459640,0,0,0,41984,20,2759828915
625,11946479,892869,12839348,3,0,0,142336,28,2397355593
626,11963050,483735,12446785,7,0,0,62464,2,8208188211
627,11978300,378138,12356438,0,0,0,11776,20,8828345975
628,12026900,5802,12032702,5,0,1,6144,12,7242177329
629,12033270,271379,12304649,6,0,1,349184,0,10680870909
630,12044049,261651,12305700,3,0,1,1024,28,3839996099
631,12068970,250117,12319087,6,0,1,24064,0,8054345693
632,12094890,224556,12319446,5,0,1,9728,12,2256149087
633,12108510,211807,12320317,5,0,1,12288,12,5790959406
634,12140920,179743,12320663,7,0,1,512,2,8446525739
635,12171770,190596,12362366,6,0,1,70656,0,9830831403
636,12202360,322459,12524819,8,0,0,512,3,5608081203
637,12252020,709948,12961968,7,0,0,22016,2,5350808386
638,12257370,269623,12526993,8,0,0,1024,3,4853185458
639,12260150,149736,12409886,6,0,1,77824,0,8980800189
640,12270639,746448,13017087,3,0,0,74752,28,8167670964
641,12306320,103581,12409901,5,0,1,7680,12,8645813553
642,12341240,86490,12427730,7,0,1,5120,2,3981519953
643,12350330,394087,12744417,0,0,0,50176,20,4129848710
644,12351880,277890,12629770,4,0,0,12800,10,8876336749
645,12363660,892779,13256439,4,0,0,167424,10,2423113172
646,12379139,704134,13083273,3,0,0,64000,28,1906784515
647,12398070,61593,12459663,5,0,1,5120,12,5748250485
648,12406110,370089,12776199,9,0,0,512,9,7686135583
649,12408380,633378,13041758,4,0,0,80896,10,120852409
650,12418670,377295,12795965,7,0,0,28160,2,1413951450
651,12419690,479936,12899626,7,0,0,7168,2,2590994463
652,12433070,29399,12462469,5,0,1,8704,12,955814991
653,12520949,845854,13366803,3,0,0,180224,28,9249842447
654,12530140,566,12530706,7,0,1,512,2,3358803408
655,12530710,242573,12773283,9,0,0,1024,9,7877229107
656,12550340,2946,12553286,5,0,1,3072,12,7025214433
657,12572630,364668,12937298,0,0,0,7680,20,10013505738
658,12604510,1994,12606504,6,0,1,2048,0,6588072432
659,12606690,7230,12613920,6,0,1,7680,0,5742807115
660,12659580,759669,13419249,9,0,0,99840,9,2788286324
661,12677360,71203,12748563,7,0,1,11264,2,2409419042
662,12681390,158129,12839519,8,0,0,512,3,8811557552
663,12697770,691044,13388814,0,0,0,72192,20,787577598
664,12716070,398561,13114631,0,0,0,8704,20,4462389389
665,12719230,459996,13179226,7,0,0,15360,2,9249979885
666,12743430,346262,13089692,0,0,0,20992,20,1169658070
667,12743510,15138,12758648,6,0,1,17408,0,10388658043
668,12772410,5802,12778212,5,0,1,6144,12,4906568189
669,12837110,789519,13626629,0,0,0,71168,20,7716626014
670,12861130,560333,13421463,9,0,0,5120,9,6867143115
671,12872510,10757,12883267,6,0,1,17408,0,5231755125
672,12903979,845739,13749718,3,0,0,24576,28,6815958610
673,12915520,804443,13719963,0,0,0,160256,20,1417462990
674,12918120,45437,12963557,4,0,1,78336,10,3367537798
675,12952089,467799,13419888,3,0,0,2048,28,4849509131
676,12963759,641064,13604823,3,0,0,155648,28,3863845662
677,12965770,776421,13742191,0,0,0,72704,20,9217321243
678,12984909,552004,13536913,3,0,0,235008,28,480508904
679,12995110,94605,13089715,4,0,1,73728,10,71463107
680,13042020,495376,13537396,8,0,0,1536,3,1396162727
681,13071370,22734,13094104,5,0,1,11776,12,3335867735
682,13123340,6754,13130094,5,0,1,7168,12,3921643148
683,13125240,33666,13158906,4,0,1,54784,10,1759981404
684,13190690,480430,13671120,0,0,0,28160,20,8781133218
685,13216320,41671,13257991,6,0,1,1536,0,9399054405
686,13223319,37996,13261315,0,0,1,4608,20,3169074120
687,13251730,671358,13923088,0,0,0,157696,20,3306075860
688,13282300,560026,13842326,9,0,0,107520,9,614654042
689,13282330,1529,13283859,6,0,1,1536,0,872843970
690,13297060,307786,13604846,4,0,1,440832,10,6930057836
691,13299709,909727,14209436,3,0,0,174592,28,1991649336
692,13384570,399342,13783912,0,0,0,23552,20,1561482164
693,13387800,918745,14306545,4,0,0,115200,10,577565188
694,13397200,207661,13604861,6,0,1,3584,0,3378099546
695,13420820,846227,14267047,7,0,0,74240,2,9849082
696,13421320,638286,14059606,7,0,0,110592,2,5343372315
697,13437720,651313,14089033,7,0,0,35840,2,6614763246
698,13441840,902495,14344335,7,0,0,123904,2,7013633158
699,13442510,486680,13929190,7,0,0,10240,2,6016106179
700,13484580,120304,13604884,5,0,1,26624,12,8098034552
701,13506030,558443,14064473,7,0,0,15872,2,5173917143
702,13554010,50889,13604899,6,0,1,8192,0,6210278006
703,13554990,49932,13604922,4,0,1,23040,10,1950533450
704,13558860,71150,13630010,6,0,1,3584,0,884023628
705,13570000,149978,13719978,4,0,1,78336,10,1461733919
706,13584360,687070,14271430,4,0,0,14336,10,6711525751
707,13600810,843297,14444107,0,0,0,156672,20,8630086949
708,13614600,105393,13719993,6,0,1,29696,0,10479909237
709,13616630,103378,13720008,5,0,1,2048,12,2676088642
710,13631930,591405,14223335,9,0,0,45568,9,5365910844
711,13659330,1048271,14707601,0,0,0,17408,20,4615223911
712,13683090,66659,13749749,5,0,1,2048,12,7480877333
713,13685840,63924,13749764,5,0,1,9728,12,9400721426
714,13714300,36928,13751228,5,0,1,1536,12,2305733443
715,13735599,18969,13754568,3,0,1,4608,28,6715772471
716,13749730,6321,13756051,5,0,1,11776,12,8794440031
717,13763339,725765,14489104,3,0,0,26624,28,6489104524
718,13807240,310454,14117694,8,0,0,2048,3,9968853683
719,13830040,566254,14396294,7,0,0,168448,2,10539033632
720,13872630,50473,13923103,4,0,1,12288,10,4648945809
721,13927300,553677,14480977,4,0,0,113152,10,7702154434
722,13945619,10757,13956376,3,0,1,17408,28,10266908685
723,14034880,30594,14065474,6,0,1,1024,0,6420919102
724,14037170,100115,14137285,4,0,1,117760,10,230935252
725,14085620,938571,15024191,4,0,0,61440,10,966565938
726,14200250,29306,14229556,6,0,1,15360,0,9206613669
727,14225220,219089,14444309,8,0,0,512,3,4298955789
728,14232369,1518,14233887,3,0,1,1536,28,1460585388
729,14242090,64470,14306560,8,0,1,31744,3,3562314846
730,14262829,133496,14396325,3,0,1,6656,28,2363046781
731,14275500,120840,14396340,6,0,1,1024,0,25313290
732,14300790,360115,14660905,2,0,0,110080,29,2814694231
733,14302330,199287,14501617,8,0,0,2560,3,6412053703
734,14315190,816366,15131556,2,0,0,182272,29,2112668501
735,14315480,278297,14593777,2,0,0,16896,29,6134030425
736,14322780,192080,14514860,4,0,0,15360,10,6096114978
737,14332500,480499,14812999,4,0,0,92160,10,9180249078
738,14342339,101791,14444130,3,0,1,2048,28,4220833204
739,14346270,142849,14489119,5,0,1,5120,12,405184546
740,14362350,450984,14813334,8,0,0,1024,3,5477250650
741,14362790,201100,14563890,8,0,0,2048,3,1744065800
742,14419060,807096,15226156,7,0,0,190464,2,6732608310
743,14454021,40044,14494065,9,0,1,12800,9,7979614607
744,14463410,31961,14495371,5,0,1,2048,12,7304189845
745,14527219,505575,15032794,3,0,0,28160,28,6263367794
746,14634730,31017,14665747,8,0,1,5120,3,9085386462
747,14693060,7706,14700766,8,0,1,8192,3,4987598381
748,14704130,8659,14712789,6,0,1,13312,0,8505745088
749,14731280,4850,14736130,6,0,1,5120,0,967159803
750,14766010,366193,15132203,8,0,0,2048,3,516522473
751,14803230,16034,14819264,5,0,1,14848,12,1759464162
752,14839430,13341,14852771,8,0,1,22528,3,889305508
753,14887949,12825,14900774,3,0,1,21504,28,3090456688
754,14909289,6754,14916043,3,0,1,7168,28,1458540262
755,14911660,7289,14918949,6,0,1,4608,0,2603539292
756,14945709,14117,14959826,3,0,1,24064,28,10480806538
757,14952919,12399,14965318,0,0,1,17920,20,4186640494
758,14954760,12184,14966944,5,0,1,2560,12,9315074145
759,14956890,591741,15548631,2,0,0,235520,29,46550684
760,14973189,592149,15565338,3,0,0,54784,28,4457626704
761,14976269,156285,15132554,3,0,0,1024,28,9132745765
762,14990500,11016,15001516,8,0,1,17920,3,5269902368
763,15014830,559181,15574011,7,0,0,4096,2,3892045438
764,15064830,290222,15355052,2,0,0,39424,29,3670013216
765,15079759,59032,15138791,0,0,1,6656,20,2206985866
766,15103599,35538,15139137,0,0,1,512,20,8416411562
767,15117450,29038,15146488,5,0,1,19456,12,4247369687
768,15125859,21193,15147052,3,0,1,10752,28,863729839
769,15133540,439153,15572693,4,0,0,24064,10,822529079
770,15138740,9762,15148502,8,0,1,11776,3,3473634090
771,15139130,15028,15154158,2,0,1,15872,29,7736056414
772,15141810,22487,15164297,2,0,1,19456,29,6130268351
773,15142419,83752,15226171,3,0,1,7680,28,748410376
774,15154570,71616,15226186,1,0,1,3584,18,2999551304
775,15172400,59622,15232022,2,0,1,6144,29,1297050409
776,15210640,534122,15744762,2,0,0,78336,29,10199261519
777,15223550,9138,15232688,5,0,1,1024,12,2047188695
778,15226780,719922,15946702,4,0,0,97792,10,5919877974
779,15231500,2870,15234370,5,0,1,8704,12,5071146651
780,15269030,11791,15280821,2,0,1,19456,29,4481758106
781,15271279,12448,15283727,0,0,1,4608,20,3384904652
782,15271780,16773,15288553,2,0,1,7680,29,10689039360
783,15273910,642981,15916891,7,0,0,294400,2,6120551704
784,15282409,176098,15458507,3,0,0,1536,28,9509617187
785,15291329,6229,15297558,0,0,1,15360,20,5123511395
786,15308569,11274,15319843,0,0,1,18432,20,6093327608
787,15321140,373681,15694821,4,0,0,56832,10,9272656853
788,15331059,1994,15333053,3,0,1,2048,28,9523413628
789,15340929,14146,15355075,0,0,1,6144,20,5186797001
790,15346580,10007,15356587,6,0,1,1536,0,9271156148
791,15349730,8803,15358533,6,0,1,3072,0,8016124776
792,15365749,3387,15369136,3,0,1,9728,28,1669936177
793,15406130,1518,15407648,2,0,1,1536,29,7715700683
794,15420729,1518,15422247,0,0,1,1536,20,2385363498
795,15452140,4162,15456302,8,0,1,11264,3,5713174208
796,15470969,101739,15572708,0,0,1,36352,20,8026367170
797,15484570,91419,15575989,1,0,1,2048,18,260013669
798,15503639,443398,15947037,3,0,0,1024,28,9228026337
799,15506649,75676,15582325,0,0,1,8192,20,9445679718
800,15515310,68961,15584271,5,0,1,3072,12,8331395842
801,15531540,58632,15590172,1,0,1,19968,18,9176690117
802,15541690,54753,15596443,6,0,1,20480,0,1097658511
803,15564960,180285,15745245,0,0,0,1536,20,2036377935
804,15582089,22646,15604735,0,0,1,27648,20,1452308381
805,15593330,14951,15608281,7,0,1,5632,2,5343531835
806,15620810,3904,15624714,2,0,1,10752,29,7084120693
807,15628119,566,15628685,3,0,1,512,28,2365362091
808,15629070,4937,15634007,2,0,1,12800,29,6288407027
809,15652939,4679,15657618,3,0,1,12288,28,3347565966
810,15655799,5353,15661152,3,0,1,11776,28,6032092533
811,15658560,8046,15666606,6,0,1,15360,0,10538516565
812,15670769,1994,15672763,0,0,1,2048,20,2045098067
813,15691410,5873,15697283,2,0,1,2560,29,2522761822
814,15760549,278686,16039235,3,0,0,2560,28,10675275658
815,15763810,194342,15958152,2,0,0,36352,29,5783638328
816,15785190,317951,16103141,0,0,0,29696,20,3838020444
817,15798829,4374,15803203,3,0,1,4608,28,2688453155
818,15814159,293133,16107292,3,0,0,3072,28,3409794926
819,15820850,4374,15825224,7,0,1,4608,2,754639619
820,15883599,79362,15962961,0,0,1,5120,20,4489129055
821,15889150,76397,15965547,6,0,1,4096,0,1819536015
822,15890160,77653,15967813,6,0,1,3584,0,3140306249
823,15902360,303916,16206276,0,0,0,53760,20,3084926722
824,15948099,219909,16168008,3,0,0,3072,28,1886174004
825,15959810,9283,15969093,1,0,1,14336,18,5684573058
826,15973970,5971,15979941,7,0,1,14848,2,2939805960
827,15975979,116481,16092460,3,0,0,1024,28,8624746833
828,16029189,6488,16035677,3,0,1,15872,28,6553418402
829,16047260,258658,16305918,4,0,0,36864,10,6075700684
830,16049640,219278,16268918,2,0,0,95232,29,2828206574
831,16061180,10757,16071937,1,0,1,17408,18,10047740475
832,16073539,5326,16078865,3,0,1,5632,28,714623938
833,16106520,231005,16337525,4,0,0,76288,10,5996143864
834,16181419,24872,16206291,0,0,1,24064,20,1664575889
835,16226340,42593,16268933,7,0,1,29184,2,8140745679
836,16227630,41318,16268948,1,0,1,5632,18,155810026
837,16250419,254274,16504693,3,0,0,1024,28,3542695569
838,16251650,20460,16272110,6,0,1,9216,0,5004667130
839,16265860,11126,16276986,7,0,1,13312,2,1254894090
840,16283570,22363,16305933,2,0,1,24064,29,9237787107
841,16328050,21792,16349842,1,0,1,20480,18,2584762773
842,16331450,107314,16438764,7,0,0,1024,2,6217538157
843,16374360,4162,16378522,1,0,1,11264,18,4061245612
844,16375660,6085,16381745,6,0,1,10752,0,3721492634
845,16378819,9126,16387945,0,0,1,7168,20,6371419622
846,16379620,9311,16388931,2,0,1,1536,29,8576086059
847,16400259,148079,16548338,3,0,0,2560,28,3004296928
848,16445410,4420,16449830,8,0,1,11776,3,708337881
849,16457230,10499,16467729,8,0,1,16896,3,2992524674
850,16477880,471981,16949861,4,0,0,70144,10,2873135687
851,16504370,16669,16521039,8,0,1,31744,3,3256526068
852,16506190,301963,16808153,2,0,0,66048,29,8343050521
853,16523240,23983,16547223,8,0,1,39936,3,7026142817
854,16527210,21498,16548708,6,0,1,15360,0,10598913960
855,16534130,17484,16551614,8,0,1,4608,3,8185647986
856,16562049,168326,16730375,3,0,0,2560,28,1110533840
857,16570890,4850,16575740,1,0,1,5120,18,616673526
858,16625979,191723,16817702,3,0,0,2560,28,7070262142
859,16646280,242543,16888823,2,0,0,97792,29,8966021598
860,16647140,315387,16962527,4,0,0,41472,10,5140355560
861,16706109,483900,17190009,3,0,0,3584,28,815474029
862,16717820,2946,16720766,2,0,1,3072,29,5198857490
863,16723410,4679,16728089,1,0,1,12288,18,4861480131
864,16734220,257380,16991600,7,0,0,53760,2,7303736315
865,16737940,395573,17133513,7,0,0,122880,2,3742853749
866,16751470,4162,16755632,1,0,1,11264,18,10523258013
867,16755130,4850,16759980,7,0,1,5120,2,9456607198
868,16760270,2470,16762740,1,0,1,2560,18,116877441
869,16782840,307851,17090691,4,0,0,104448,10,7693290570
870,16836670,11791,16848461,7,0,1,19456,2,575751004
871,16845730,6488,16852218,6,0,1,15872,0,1441932894
872,16846359,11486,16857845,0,0,1,7680,20,9951727955
873,16887490,5745,16893235,7,0,1,11776,2,8822132072
874,16891940,8218,16900158,7,0,1,8192,2,8569905355
875,16894940,5564,16900504,7,0,1,512,2,5761789866
876,16911730,322071,17233801,7,0,0,90624,2,8836733051
877,16919220,4374,16923594,7,0,1,4608,2,313417753
878,16926550,23326,16949876,7,0,1,10752,2,5864888012
879,16967340,394831,17362171,2,0,0,70144,29,4603802110
880,16975560,22786,16998346,1,0,1,7168,18,9236165096
881,16995899,13858,17009757,0,0,1,23552,20,6052055456
882,17002500,14919,17017419,1,0,1,27648,18,2629575891
883,17015520,4805,17020325,1,0,1,4608,18,8221393114
884,17015920,12861,17028781,1,0,1,19456,18,8056950842
885,17016090,170523,17186613,2,0,0,32768,29,4950094132
886,17029170,3904,17033074,6,0,1,10752,0,3917429382
887,17059690,229372,17289062,2,0,0,19456,29,3010340593
888,17078739,13504,17092243,0,0,1,1536,20,8020303832
889,17086500,47028,17133528,1,0,1,5632,18,1865111860
890,17091300,42251,17133551,7,0,1,5120,2,4286763455
891,17099410,44351,17143761,7,0,1,16384,2,7535209864
892,17164220,313523,17477743,2,0,0,62464,29,244528005
893,17169150,3898,17173048,6,0,1,4096,0,53109094
894,17178739,271274,17450013,3,0,0,2560,28,3552574036
895,17207640,386253,17593893,7,0,0,19456,2,10396322034
896,17225579,8805,17234384,0,0,1,512,20,2845246946
897,17262320,472314,17734634,7,0,0,141312,2,5389034451
898,17263860,296137,17559997,7,0,0,111104,2,4434506331
899,17264080,1042,17265122,6,0,1,1024,0,5186069400
900,17312990,378573,17691563,2,0,0,135168,29,8599693416
901,17344360,28319,17372679,7,0,1,16896,2,9114815922
902,17361250,570288,17931538,2,0,0,17920,29,3931568766
903,17362760,10265,17373025,8,0,1,512,3,1056266424
904,17372060,13600,17385660,1,0,1,23040,18,757061053
905,17386040,6229,17392269,8,0,1,15360,3,5007984086
906,17406140,337433,17743573,2,0,0,29184,29,5620632172
907,17418240,6754,17424994,7,0,1,7168,2,916686624
908,17432530,371225,17803755,7,0,0,48640,2,5224520487
909,17464120,324792,17788912,7,0,0,59904,2,5295952169
910,17467399,100293,17567692,3,0,0,1536,28,2629703828
911,17507010,382545,17889555,7,0,0,103936,2,4516023908
912,17515970,440543,17956513,4,0,0,81920,10,2350058635
913,17519100,338764,17857864,2,0,0,69632,29,2377215965
914,17524750,290127,17814877,7,0,0,36352,2,4061254680
915,17540560,30445,17571005,8,0,1,17920,3,8811557872
916,17587019,6897,17593916,0,0,1,6656,20,10415498598
917,17591629,7106,17598735,0,0,1,5120,20,2520402775
918,17602180,4850,17607030,7,0,1,5120,2,4391414768
919,17624920,405396,18030316,4,0,0,13312,10,7166464092
920,17645970,318670,17964640,4,0,0,26624,10,8380190994
921,17653760,92900,17746660,8,0,1,9216,3,3815731546
922,17692840,421171,18114011,2,0,0,107520,29,9231210617
923,17726020,422011,18148031,4,0,0,57856,10,1586419159
924,17726080,27966,17754046,1,0,1,8192,18,8064265200
925,17755900,47870,17803770,7,0,1,53248,2,6125244908
926,17766080,236914,18002994,7,0,0,14336,2,7888939612
927,17789569,175266,17964835,3,0,0,512,28,8809254902
928,17796920,201668,17998588,4,0,0,60416,10,407859968
929,17846440,47753,17894193,8,0,1,12288,3,10690346811
930,17867409,247093,18114502,3,0,0,1536,28,1836353401
931,17870789,24070,17894859,0,0,1,1024,20,1633758571
932,17877490,19825,17897315,1,0,1,10240,18,8171614240
933,17881790,332660,18214450,7,0,0,23552,2,9888754156
934,17899680,1518,17901198,6,0,1,1536,0,6245126285
935,17920670,395075,18315745,7,0,0,31232,2,9746769648
936,17921890,361834,18283724,2,0,0,97280,29,2603105582
937,17943130,22706,17965836,4,0,1,1024,10,1701644845
938,17945930,23596,17969526,6,0,1,11776,0,5315842365
939,17954020,44583,17998603,7,0,1,27136,2,8966028284
940,17986180,353448,18339628,7,0,0,78336,2,7573154458
941,17998690,9163,18007853,4,0,1,5120,10,5972421200
942,17998719,10760,18009479,0,0,1,2560,20,3912383985
943,18029520,4686,18034206,1,0,1,4096,18,9804385538
944,18058640,10241,18068881,1,0,1,16384,18,4545033630
945,18090450,163619,18254069,2,0,0,14336,29,2872115935
946,18116080,3898,18119978,7,0,1,4096,2,3714004133
947,18127570,20476,18148046,8,0,1,28160,3,1354876732
948,18161909,66786,18228695,3,0,0,512,28,4590420698
949,18202240,13512,18215752,6,0,1,26112,0,841785763
950,18221540,357338,18578878,7,0,0,196096,2,3864411260
951,18225920,3904,18229824,8,0,1,10752,3,2511304656
952,18243550,430817,18674367,2,0,0,172032,29,2971903414
953,18245040,488777,18733817,2,0,0,26624,29,1160616429
954,18294260,3898,18298158,6,0,1,4096,0,9711342668
955,18316910,376580,18693490,2,0,0,10752,29,9667365207
956,18336929,5662,18342591,0,0,1,3072,20,11047644
957,18340550,4500,18345050,7,0,1,11776,2,10628456639
958,18341490,6164,18347654,6,0,1,9728,0,8463770260
959,18361190,1518,18362708,6,0,1,1536,0,4798281957
960,18372260,236792,18609052,4,0,0,6656,10,9109227442
961,18432070,20624,18452694,1,0,1,33280,18,6281236827
962,18449780,7740,18457520,1,0,1,7680,18,3702418928
963,18471830,456039,18927869,7,0,0,197632,2,1046385
964,18504150,309299,18813449,2,0,0,99840,29,1523662630
965,18512389,66504,18578893,0,0,1,7680,20,571838627
966,18518990,59926,18578916,7,0,1,4096,2,9064937956
967,18521380,307729,18829109,2,0,0,34816,29,10100209541
968,18594020,5196,18599216,7,0,1,13312,2,1299872717
969,18712449,23895,18736344,0,0,1,43008,20,5583888266
970,18718510,212658,18931168,2,0,0,10752,29,6401268554
971,18721500,16150,18737650,6,0,1,2048,0,7464279733
972,18734220,131627,18865847,2,0,0,53760,29,5662249227
973,18801329,130010,18931339,3,0,0,512,28,8918231542
974,18806060,8448,18814508,1,0,1,1024,18,6727567168
975,18815939,162368,18978307,3,0,0,512,28,7847294523
976,18839020,225348,19064368,7,0,0,20992,2,9414057866
977,18865409,996,18866405,0,0,1,512,20,698181876
978,18883880,174077,19057957,2,0,0,34816,29,852069960
979,18909090,138244,19047334,7,0,0,29696,2,3008095256
980,18924790,11433,18936223,7,0,1,5120,2,9447340632
981,18928730,109541,19038271,2,0,0,46080,29,6714602402
982,18952979,1042,18954021,0,0,1,1024,20,2150342291
983,18996600,321726,19318326,4,0,0,296960,10,6583833157
984,19064930,2946,19067876,1,0,1,3072,18,9167694722
985,19089180,319906,19409086,2,0,0,53248,29,630417208
986,19136900,24929,19161829,1,0,1,45056,18,6675161934
987,19258410,61919,19320329,1,0,1,2048,18,3306381575
988,19278100,90628,19368728,7,0,0,1024,2,1729486698
989,19368880,1042,19369922,7,0,1,1024,2,1633230355
990,19404249,15070,19419319,3,0,1,16384,28,5929097597
991,19409129,105401,19514530,3,0,0,1536,28,4875038568
992,19410880,103167,19514047,7,0,0,22016,2,6082532180
993,19458630,3645,19462275,1,0,1,10240,18,5826150968
994,19591970,4374,19596344,7,0,1,4608,2,9417922147
995,19601830,2470,19604300,1,0,1,2560,18,3007426690
996,19616520,5802,19622322,8,0,1,6144,3,3652581584
997,19620250,4978,19625228,7,0,1,4608,2,2310603051
998,19631800,120862,19752662,2,0,0,73216,29,2927355333
999,19653550,167567,19821117,4,0,0,70144,10,8342142203
1000,19667260,12825,19680085,7,0,1,21504,2,8369858395
1001,19684860,1042,19685902,7,0,1,1024,2,3268257028
1002,19828700,2470,19831170,7,0,1,2560,2,9218979062
1003,19873299,52364,19925663,3,0,0,3072,28,2910310611
1004,19884460,43904,19928364,4,0,0,512,10,3395225410
1005,19912360,11016,19923376,5,0,1,17920,12,7426156343
1006,19934090,11274,19945364,7,0,1,18432,2,7283911372
1007,19969860,95000,20064860,7,0,0,22016,2,2720903762
1008,19992459,45596,20038055,3,0,0,1024,28,4835647147
1009,20012749,58560,20071309,3,0,0,512,28,7779323703
1010,20066340,184334,20250674,2,0,0,67072,29,7238665876
1011,20074460,258748,20333208,4,0,0,32256,10,3460891040
1012,20108749,226190,20334939,3,0,0,5632,28,8388561116
1013,20112080,303454,20415534,4,0,0,155136,10,3274697855
1014,20146000,136357,20282357,4,0,0,103936,10,6179467243
1015,20189919,145191,20335110,3,0,0,512,28,8171619801
1016,20190010,242425,20432435,4,0,0,51712,10,2683445810
1017,20200049,167179,20367228,3,0,0,512,28,805165214
1018,20304859,111158,20416017,3,0,0,1536,28,5240860500
1019,20352340,64324,20416664,4,0,0,2048,10,3345377901
1020,20384770,201791,20586561,0,0,0,148992,20,6115462000
1021,20418940,17391,20436331,5,0,1,10752,12,4159002447
1022,20485130,101454,20586584,4,0,1,121344,10,8810453014
1023,20502860,83739,20586599,5,0,1,4608,12,8902296758
1024,20542670,173640,20716310,2,0,0,46592,29,7421209710
1025,20569290,343760,20913050,2,0,0,173056,29,3409310887
1026,20619900,150677,20770577,7,0,0,71680,2,8055283354
1027,20645999,4162,20650161,0,0,1,11264,20,69003987
1028,20677850,5196,20683046,7,0,1,13312,2,7120049106
1029,20686120,6278,20692398,5,0,1,6656,12,1269177056
1030,20690250,26075,20716325,7,0,1,24576,2,6800385510
1031,20699639,124407,20824046,3,0,0,1024,28,3659980515
1032,20728899,184421,20913320,3,0,0,512,28,930729705
1033,20775740,15321,20791061,7,0,1,29696,2,6840978889
1034,20780720,132345,20913065,4,0,1,139776,10,8110202030
1035,20805120,107960,20913080,8,0,1,13312,3,1298738782
1036,20812349,100746,20913095,0,0,1,512,20,8209508137
1037,20812959,100151,20913110,0,0,1,2560,20,4476850982
1038,20825679,87454,20913133,0,0,1,18944,20,9618108972
1039,20875450,59512,20934962,4,0,1,35328,10,10715392656
1040,20877950,234199,21112149,2,0,0,16384,29,9165251339
1041,20893589,51793,20945382,0,0,1,33280,20,795949222
1042,20912890,147758,21060648,2,0,0,35328,29,8719770695
1043,20920640,25306,20945946,2,0,1,10752,29,9261581076
1044,20952000,566,20952566,7,0,1,512,2,10075089942
1045,20956940,279611,21236551,2,0,0,73728,29,1615589391
1046,20961139,7230,20968369,0,0,1,7680,20,5814167377
1047,20999449,23983,21023432,0,0,1,39936,20,3818193559
1048,20999869,94506,21094375,3,0,0,2560,28,9064295252
1049,21017720,42951,21060671,4,0,1,68608,10,10548049994
1050,21058710,337368,21396078,7,0,0,70656,2,10695837841
1051,21069239,13253,21082492,0,0,1,25600,20,741599414
1052,21073360,9478,21082838,5,0,1,512,12,976870708
1053,21079219,7165,21086384,0,0,1,5632,20,1100504983
1054,21122690,566,21123256,8,0,1,512,3,1200732386
1055,21131110,14117,21145227,8,0,1,24064,3,427637147
1056,21229120,41960,21271080,4,0,1,60416,10,4202581907
1057,21251720,19706,21271426,6,0,1,512,0,394632881
1058,21280340,2870,21283210,8,0,1,8704,3,9959654931
1059,21346670,5802,21352472,1,0,1,6144,18,7624718560
1060,21358430,105872,21464302,2,0,0,47616,29,7386744619
1061,21375999,26300,21402299,0,0,1,15360,20,7234202752
1062,21398090,119280,21517370,4,0,1,193536,10,5379774102
1063,21402869,117727,21520596,0,0,1,5120,20,752809968
1064,21405070,141652,21546722,4,0,1,83968,10,9617757716
1065,21408060,154625,21562685,4,0,1,51712,10,1451418213
1066,21451150,122467,21573617,8,0,1,35840,3,6676487027
1067,21479199,95391,21574590,0,0,1,12800,20,10118863950
1068,21483260,97231,21580491,8,0,1,28160,3,5333750471
1069,21505500,76617,21582117,8,0,1,2560,3,3086176679
1070,21520249,62432,21582681,0,0,1,10752,20,9713385651
1071,21527480,440522,21968002,7,0,0,148992,2,2226420856
1072,21527830,324517,21852347,2,0,0,85504,29,6391983512
1073,21555789,27660,21583449,0,0,1,11776,20,8236501801
1074,21618739,3128,21621867,0,0,1,9216,20,2201382215
1075,21674589,2470,21677059,0,0,1,2560,20,36945806
1076,21695410,287435,21982845,2,0,0,48640,29,8876231317
1077,21752279,101487,21853766,3,0,0,4608,28,7306445680
1078,21903999,1994,21905993,0,0,1,2048,20,4963410961
1079,21948960,38548,21987508,8,0,1,12288,3,9658066625
1080,21964749,68760,22033509,3,0,0,2560,28,1942024330
1081,21998320,218918,22217238,7,0,0,218112,2,1959314183
1082,22019240,24412,22043652,6,0,1,44032,0,4684020801
1083,22107570,1518,22109088,8,0,1,1536,3,4035322403
1084,22119650,126094,22245744,2,0,0,51200,29,9520759215
1085,22149809,96589,22246398,3,0,0,2048,28,4096641342
1086,22195359,65775,22261134,3,0,0,512,28,686369740
1087,22227990,17769,22245759,6,0,1,9216,0,9143737085
1088,22237129,19777,22256906,0,0,1,16896,20,5115277400
1089,22238119,111316,22349435,3,0,0,512,28,7733311235
1090,22248350,351195,22599545,7,0,0,134656,2,3209396922
1091,22251430,10302,22261732,8,0,1,7680,3,6944464116
1092,22295530,1042,22296572,2,0,1,1024,29,5852927751
1093,22336430,187323,22523753,7,0,0,22016,2,4145375290
1094,22346880,324341,22671221,2,0,0,206336,29,10286007245
1095,22358949,5326,22364275,0,0,1,5632,20,343369978
1096,22375380,1042,22376422,8,0,1,1024,3,6639649497
1097,22403109,11533,22414642,0,0,1,18944,20,166232556
1098,22412130,7706,22419836,6,0,1,8192,0,3731731316
1099,22439359,23120,22462479,0,0,1,41472,20,4899706118
1100,22468530,211941,22680471,7,0,0,30208,2,4192496260
1101,22494760,1994,22496754,6,0,1,2048,0,6215559587
1102,22499860,14287,22514147,2,0,1,27648,29,4531743535
1103,22512579,2234,22514813,0,0,1,1024,20,7057012857
1104,22536149,4850,22540999,0,0,1,5120,20,7795779923
1105,22547990,4162,22552152,2,0,1,11264,29,8436656148
1106,22566690,37288,22603978,8,0,1,4608,3,4270933674
1107,22573969,33527,22607496,0,0,1,15872,20,6862032053
1108,22586539,108902,22695441,3,0,0,3072,28,7017498569
1109,22598101,73135,22671236,9,0,1,5632,9,7992214899
1110,22626390,60343,22686733,2,0,1,6656,29,3201283583
1111,22627950,110265,22738215,2,0,0,11264,29,3536774070
1112,22656160,31239,22687399,8,0,1,1024,3,7219012348
1113,22726849,144791,22871640,3,0,0,2048,28,6369999956
1114,22769670,1994,22771664,2,0,1,2048,29,8962364908
1115,22799620,100880,22900500,7,0,0,31232,2,7826598415
1116,22852900,151203,23004103,2,0,0,116736,29,1559661050
1117,22897300,5662,22902962,2,0,1,2560,29,7153814476
1118,22923240,6754,22929994,2,0,1,7168,29,8111727584
1119,22931620,4679,22936299,8,0,1,12288,3,242828162
1120,22931709,88294,23020003,3,0,0,2048,28,8225016644
1121,22967990,36128,23004118,2,0,1,14336,29,7846963605
1122,23002180,5058,23007238,6,0,1,9216,0,2549636591
1123,23009649,1994,23011643,0,0,1,2048,20,9941611054
1124,23013680,116081,23129761,7,0,0,43008,2,10724387091
1125,23136979,13512,23150491,0,0,1,26112,20,1125684327
1126,23170860,111324,23282184,7,0,0,43520,2,3109232422
1127,23296839,4850,23301689,0,0,1,5120,20,4803205843
1128,23302250,23637,23325887,8,0,1,42496,3,4095959969
1129,23325550,6754,23332304,2,0,1,7168,29,3854158961
1130,23384940,186814,23571754,7,0,0,2048,2,8974037668
1131,23392890,10499,23403389,6,0,1,16896,0,7833752576
1132,23438410,132689,23571099,2,0,0,121856,29,7763737210
1133,23441819,2470,23444289,3,0,1,2560,28,8359682002
1134,23539360,236610,23775970,7,0,0,71168,2,1075061617
1135,23552830,201441,23754271,7,0,0,34816,2,5439178042
1136,23630690,3128,23633818,2,0,1,9216,29,8769928657
1137,23689640,3422,23693062,6,0,1,3584,0,5408993966
1138,23788259,48980,23837239,3,0,0,2048,28,2351812855
1139,23836290,205568,24041858,7,0,0,213504,2,1436327490
1140,23849360,91362,23940722,2,0,0,2560,29,7788217567
1141,23877389,165108,24042497,3,0,0,2048,28,3458290203
1142,23895789,13770,23909559,0,0,1,26624,20,8735286298
1143,23913150,14287,23927437,6,0,1,27648,0,6962373013
1144,23970029,3898,23973927,0,0,1,4096,20,702108036
1145,24111500,100132,24211632,7,0,0,26624,2,6756392070
1146,24128609,4374,24132983,0,0,1,4608,20,4840888028
1147,24146290,188696,24334986,2,0,0,153088,29,2013187934
1148,24258120,78925,24337045,2,0,0,6656,29,7936434571
1149,24301420,38454,24339874,6,0,1,8704,0,7680322155
1150,24311800,138435,24450235,7,0,0,78336,2,7985154697
1151,24360719,5802,24366521,3,0,1,6144,28,2911082855
1152,24367400,14287,24381687,6,0,1,27648,0,5928863299
1153,24466949,43904,24510853,3,0,0,512,28,56625399
1154,24489110,132346,24621456,7,0,0,110592,2,5816384391
1155,24492649,6754,24499403,0,0,1,7168,20,6656298025
1156,24511750,4374,24516124,6,0,1,4608,0,3690321006
1157,24610329,14065,24624394,0,0,1,3072,20,4923207225
1158,24677500,108368,24785868,2,0,0,55808,29,1370628440
1159,24842729,57643,24900372,3,0,0,1024,28,4513194175
1160,24853789,7706,24861495,0,0,1,8192,20,9093533904
1161,24912359,3898,24916257,0,0,1,4096,20,6397408036
1162,24951250,72692,25023942,7,0,0,14336,2,5436916915
1163,24959670,200133,25159803,7,0,0,48640,2,1757927878
1164,24960110,1994,24962104,6,0,1,2048,0,1955560297
1165,24967691,21141,24988832,9,0,1,34304,9,2112397458
1166,24982750,115559,25098309,2,0,0,44544,29,4497660875
1167,25025999,165092,25191091,3,0,0,4608,28,6679570115
1168,25075500,5454,25080954,6,0,1,13824,0,8208567242
1169,25082489,15835,25098324,0,0,1,10752,20,5283118493
1170,25097770,204461,25302231,2,0,0,15872,29,8183644247
1171,25120489,155150,25275639,6,0,0,92160,0,8792990702
1172,25135060,5454,25140514,6,0,1,13824,0,9439196484
1173,25139090,2410,25141500,7,0,1,1536,2,9633342672
1174,25149761,14425,25164186,9,0,1,4608,9,2494318709
1175,25157140,12192,25169332,7,0,1,8192,2,5260699760
1176,25177939,228003,25405942,6,0,0,5632,0,2287702242
1177,25191420,119211,25310631,7,0,0,13312,2,10104372871
1178,25225430,151399,25376829,7,0,0,37888,2,2682080846
1179,25248681,29837,25278518,9,0,1,8704,9,7712633880
1180,25272749,113611,25386360,6,0,0,31232,0,359144152
1181,25317590,3898,25321488,6,0,1,4096,0,8173643873
1182,25355431,4850,25360281,9,0,1,5120,9,2923945989
1183,25360940,93464,25454404,2,0,0,22016,29,8797640238
1184,25380320,255098,25635418,2,0,0,226816,29,10595901689
1185,25389380,13600,25402980,6,0,1,23040,0,1180445673
1186,25398110,8736,25406846,4,0,1,6144,10,9273577625
1187,25494250,566,25494816,6,0,1,512,0,7661889070
1188,25526250,6754,25533004,7,0,1,7168,2,5896632218
1189,25571280,67168,25638448,7,0,1,3072,2,512017611
1190,25574199,333991,25908190,6,0,0,141312,0,3921167802
1191,25587490,277621,25865111,7,0,0,146432,2,5879496029
1192,25601950,39404,25641354,7,0,1,4608,2,5118082073
1193,25604271,40309,25644580,9,0,1,5120,9,4923713870
1194,25683050,3422,25686472,6,0,1,3584,0,7848654099
1195,25701350,7706,25709056,7,0,1,8192,2,1014388322
1196,25712730,22950,25735680,6,0,1,37888,0,376206979
1197,25731650,263390,25995040,2,0,0,49664,29,6823491808
1198,25753681,4937,25758618,9,0,1,12800,9,9673635450
1199,25763329,157842,25921171,3,0,0,512,28,1940649648
1200,25843609,106438,25950047,6,0,0,17408,0,1679400490
1201,25906699,92724,25999423,6,0,0,14336,0,5193379390
1202,25930530,10499,25941029,6,0,1,16896,0,6562502830
1203,25949630,4783,25954413,1,0,1,4608,18,7854165202
1204,25993689,205406,26199095,3,0,0,7168,28,4068126629
1205,25995789,201107,26196896,6,0,0,186880,0,3240554653
1206,26002720,316492,26319212,7,0,0,51712,2,6298055784
1207,26023440,4374,26027814,6,0,1,4608,0,8093364625
1208,26085180,4420,26089600,6,0,1,11776,0,7076505572
1209,26088930,194717,26283647,7,0,0,21504,2,5559824361
1210,26105930,331723,26437653,2,0,0,94208,29,6402366539
1211,26111760,165320,26277080,7,0,0,74752,2,8197808241
1212,26198949,265722,26464671,3,0,0,1536,28,4774648252
1213,26203800,306503,26510303,7,0,0,64512,2,2280019874
1214,26203980,3422,26207402,7,0,1,3584,2,5325253931
1215,26205089,114450,26319539,3,0,0,1024,28,5336157430
1216,26220170,244018,26464188,7,0,0,87040,2,484488789
1217,26355849,155249,26511098,3,0,0,2560,28,8490311972
1218,26428230,115505,26543735,7,0,0,5632,2,9248475318
1219,26465921,1042,26466963,9,0,1,1024,9,5442460185
1220,26520220,4937,26525157,6,0,1,12800,0,6461300325
1221,26537050,3898,26540948,5,0,1,4096,12,1836707179
1222,26550910,3645,26554555,1,0,1,10240,18,143901946
1223,26552170,335936,26888106,2,0,0,187392,29,9742190888
1224,26578859,252128,26830987,6,0,0,147968,0,89498104
1225,26603270,7706,26610976,5,0,1,8192,12,10535040567
1226,26603479,172189,26775668,3,0,0,512,28,2438748524
1227,26608560,2762,26611322,5,0,1,512,12,10454030599
1228,26623169,4850,26628019,3,0,1,5120,28,8157581843
1229,26652661,5326,26657987,9,0,1,5632,9,7582641587
1230,26654270,6943,26661213,1,0,1,5120,18,7393014871
1231,26713360,231215,26944575,7,0,0,68608,2,8081392381
1232,26714500,3904,26718404,5,0,1,10752,12,10598282977
1233,26736650,10757,26747407,5,0,1,17408,12,1898915437
1234,26810770,78337,26889107,5,0,1,1024,12,2761205801
1235,26883369,152317,27035686,3,0,0,1536,28,3116739754
1236,26901141,7230,26908371,9,0,1,7680,9,3889181542
1237,26906990,247548,27154538,2,0,0,79360,29,1405040922
1238,26914470,189898,27104368,7,0,0,130048,2,3160630587
1239,26941670,749249,27690919,7,0,0,174592,2,300241328
1240,26954600,4162,26958762,1,0,1,11264,18,10382053159
1241,26955671,9164,26964835,9,0,1,7168,9,4365989827
1242,26962711,4070,26966781,9,0,1,3072,9,5076482732
1243,26972650,478528,27451178,2,0,0,334848,29,5701289917
1244,26978410,14545,26992955,1,0,1,28160,18,8395460665
1245,26988989,601695,27590684,6,0,0,237056,0,5598940334
1246,27009499,146614,27156113,3,0,0,5120,28,10032949311
1247,27029980,188704,27218684,2,0,0,26624,29,843107651
1248,27064850,43425,27108275,1,0,1,4096,18,2411336407
1249,27074090,389911,27464001,2,0,0,41984,29,10108980773
1250,27109730,566,27110296,1,0,1,512,18,8055338406
1251,27160929,436634,27597563,6,0,0,22528,0,395873951
1252,27174260,462965,27637225,7,0,0,129024,2,135451905
1253,27303390,12566,27315956,5,0,1,20992,12,2739304150
1254,27384940,80087,27465027,5,0,1,1024,12,4652051481
1255,27389809,247899,27637708,3,0,0,1536,28,8212500216
1256,27406939,61545,27468484,0,0,1,11264,20,9559219129
1257,27463430,8222,27471652,5,0,1,4096,12,5915932431
1258,27510879,87019,27597898,3,0,0,1024,28,2181048515
1259,27545240,162090,27707330,7,0,0,53760,2,780912676
1260,27647269,219494,27866763,6,0,0,86016,0,1618120097
1261,27663449,139358,27802807,6,0,0,22016,0,9769378614
1262,27690659,126080,27816739,6,0,0,12288,0,1964240179
1263,27796449,70485,27866934,3,0,0,512,28,7122398995
1264,27854270,290776,28145046,9,0,0,290304,9,761885268
1265,27944620,225618,28170238,2,0,0,13824,29,5453479694
1266,27956790,5802,27962592,5,0,1,6144,12,4535585356
1267,27963590,1518,27965108,2,0,1,1536,29,4633621072
1268,28003190,153111,28156301,2,0,0,36864,29,8625470861
1269,28003760,161604,28165364,2,0,0,29696,29,5036997854
1270,28010819,155192,28166011,3,0,0,2048,28,1938439099
1271,28031910,1042,28032952,7,0,1,1024,2,9127017632
1272,28093281,82793,28176074,9,0,1,6144,9,5670014941
1273,28103380,76880,28180260,5,0,1,6656,12,3517675534
1274,28114360,138740,28253100,2,0,0,12288,29,9311888572
1275,28136350,49056,28185406,7,0,1,8192,2,1820176968
1276,28144670,145937,28290607,2,0,0,58880,29,5979703594
1277,28250830,5390,28256220,7,0,1,9216,2,10191942868
1278,28261360,2470,28263830,7,0,1,2560,2,8566336554
1279,28279231,14314,28293545,9,0,1,3072,9,4887792096
1280,28317619,54056,28371675,3,0,0,3584,28,1646980468
1281,28377180,5712,28382892,5,0,1,14336,12,754378947
1282,28391380,15321,28406701,5,0,1,29696,12,5948638397
1283,28394421,16786,28411207,9,0,1,7168,9,7938734923
1284,28602900,6754,28609654,7,0,1,7168,2,2381359771
1285,28631430,3422,28634852,7,0,1,3584,2,231022926
1286,28631560,99707,28731267,2,0,0,24064,29,2862774485
1287,28710911,3128,28714039,9,0,1,9216,9,81191020
1288,28813460,116480,28929940,7,0,0,82432,2,7380345274
1289,28870300,4679,28874979,5,0,1,12288,12,8261309372
1290,28943101,4850,28947951,9,0,1,5120,9,1861157789
1291,28943759,55927,28999686,3,0,0,512,28,3697189539
1292,28968309,46563,29014872,3,0,0,512,28,2273634799
1293,28984141,1994,28986135,9,0,1,2048,9,1574682098
1294,28998519,48980,29047499,3,0,0,2048,28,6025704578
1295,29066720,4850,29071570,5,0,1,5120,12,10040183946
1296,29073081,6754,29079835,9,0,1,7168,9,4680798512
1297,29087789,13083,29100872,0,0,1,22016,20,10337977855
1298,29109020,566,29109586,5,0,1,512,12,2462305682
1299,29110399,45596,29155995,3,0,0,1024,28,1668100211
1300,29196440,2470,29198910,5,0,1,2560,12,10505430884
1301,29317191,2470,29319661,9,0,1,2560,9,1309463959
1302,29338120,2946,29341066,5,0,1,3072,12,9968761570
1303,29404480,5326,29409806,7,0,1,5632,2,360873756
1304,29456050,7230,29463280,5,0,1,7680,12,1823882547
1305,29493550,3387,29496937,7,0,1,9728,2,3621341612
1306,29626269,5802,29632071,0,0,1,6144,20,3414095451
1307,29629029,3401,29632430,0,0,1,9728,20,4396584404
1308,29798750,566,29799316,5,0,1,512,12,1662347576
1309,29799199,5196,29804395,0,0,1,13312,20,352432241
1310,29835999,4937,29840936,0,0,1,12800,20,6483570294
1311,29889390,1994,29891384,7,0,1,2048,2,3204958134
1312,29928229,1994,29930223,0,0,1,2048,20,5328691040
1313,29945890,12825,29958715,7,0,1,21504,2,3595966440
1314,29951211,10090,29961301,9,0,1,4096,9,1355198222
1315,29989930,84848,30074778,7,0,0,18944,2,9171556836
1316,30017650,13858,30031508,5,0,1,23552,12,324775570
1317,30073370,2935,30076305,5,0,1,1536,12,7754861012
1318,30074090,3841,30077931,7,0,1,2560,2,1310887040
1319,30136670,263012,30399682,7,0,0,263680,2,3259199826
1320,30183240,1518,30184758,5,0,1,1536,12,7649867541
1321,30186249,213760,30400009,3,0,0,1024,28,170137385
1322,30195929,1518,30197447,0,0,1,1536,20,6487565332
1323,30258530,2946,30261476,7,0,1,3072,2,8987877382
1324,30275449,125199,30400648,3,0,0,2048,28,1452434923
1325,30291070,2470,30293540,7,0,1,2560,2,3023597128
1326,30379909,81555,30461464,3,0,0,5632,28,5058912050
1327,30414460,1994,30416454,1,0,1,2048,18,4807914235
1328,30467890,7706,30475596,5,0,1,8192,12,4387072306
1329,30482089,52364,30534453,3,0,0,3072,28,10347164228
1330,30519160,13083,30532243,5,0,1,22016,12,9518964956
1331,30533340,1518,30534858,7,0,1,1536,2,4645491101
1332,30545160,7230,30552390,7,0,1,7680,2,1562447001
1333,30578780,245092,30823872,7,0,0,245760,2,4100293508
1334,30581140,42683,30623823,7,0,1,69632,2,8481342609
1335,30613301,16116,30629417,9,0,1,18432,9,2524099053
1336,30626170,4937,30631107,7,0,1,12800,2,1355142754
1337,30642180,566,30642746,5,0,1,512,12,2044407303
1338,30679151,4374,30683525,9,0,1,4608,9,4369147486
1339,30690159,3387,30693546,0,0,1,9728,20,10688566930
1340,30698709,5971,30704680,0,0,1,14848,20,4646361407
1341,30828750,3898,30832648,5,0,1,4096,12,4011791366
1342,30840290,14545,30854835,5,0,1,28160,12,8397394398
1343,30886970,113394,31000364,7,0,0,37888,2,1872818752
1344,30965419,13858,30979277,0,0,1,23552,20,5312585295
1345,30983159,1518,30984677,0,0,1,1536,20,3628511668
1346,31008349,2946,31011295,0,0,1,3072,20,4611892755
1347,31041600,100880,31142480,7,0,0,31232,2,8736168756
1348,31042860,179062,31221922,7,0,0,27648,2,6480004836
1349,31129859,12636,31142495,0,0,1,18944,20,1592554523
1350,31203310,59424,31262734,7,0,0,3072,2,9359675928
1351,31228469,24242,31252711,0,0,1,40448,20,3258776047
1352,31284939,82969,31367908,3,0,0,4096,28,7614184907
1353,31331359,45596,31376955,3,0,0,1024,28,748266230
1354,31342679,1994,31344673,0,0,1,2048,20,4993226990
1355,31345150,5802,31350952,2,0,1,6144,29,1474508510
1356,31345609,160500,31506109,3,0,0,512,28,5375849687
1357,31348100,70976,31419076,7,0,0,8704,2,8231773797
1358,31416789,7991,31424780,0,0,1,14336,20,3546491334
1359,31423359,1767,31425126,0,0,1,512,20,10599437119
1360,31478859,43904,31522763,3,0,0,512,28,9272686177
1361,31513800,57752,31571552,8,0,0,5632,3,6656340692
1362,31569240,5326,31574566,2,0,1,5632,29,9419260571
1363,31621660,13512,31635172,2,0,1,26112,29,10126676679
1364,31662240,149919,31812159,7,0,0,65024,2,10422529864
1365,31671749,71602,31743351,3,0,0,512,28,2132931014
1366,31733850,12995,31746845,2,0,1,25088,29,915408157
1367,31795619,22810,31818429,0,0,1,6656,20,5544005275
1368,31861099,4679,31865778,0,0,1,12288,20,2582965910
1369,31910690,135974,32046664,7,0,0,108544,2,8293684385
1370,32011680,35007,32046687,2,0,1,14336,29,3265051501
1371,32014480,239381,32253861,7,0,0,196608,2,5677907089
1372,32020529,119183,32139712,3,0,0,512,28,8538195072
1373,32045630,221300,32266930,7,0,0,33792,2,706401981
1374,32069589,5196,32074785,0,0,1,13312,20,3198662101
1375,32122149,6754,32128903,0,0,1,7168,20,4493955457
1376,32192100,61776,32253876,2,0,1,8192,29,4092468646
1377,32208719,250077,32458796,3,0,0,3584,28,7893423897
1378,32248020,18925,32266945,2,0,1,13312,29,7925598986
1379,32277290,5326,32282616,8,0,1,5632,3,2608914974
1380,32328159,47288,32375447,3,0,0,1536,28,5814229074
1381,32351460,3645,32355105,1,0,1,10240,18,10445101928
1382,32413580,59132,32472712,7,0,0,5120,2,4948316465
1383,32448690,6754,32455444,8,0,1,7168,3,1585016859
1384,32519369,305623,32824992,3,0,0,233984,28,5172068046
1385,32538279,6754,32545033,0,0,1,7168,20,5846281963
1386,32590539,1518,32592057,0,0,1,1536,20,149527869
1387,32593239,1042,32594281,0,0,1,1024,20,4388666313
1388,32595110,3904,32599014,8,0,1,10752,3,3861551184
1389,32604780,5971,32610751,8,0,1,14848,3,10042653320
1390,32718340,204860,32923200,7,0,0,69120,2,5441087570
1391,32773059,156153,32929212,3,0,0,8192,28,5032295268
1392,32820459,6085,32826544,0,0,1,1536,20,10654822988
1393,32822439,7905,32830344,0,0,1,5120,20,2968906672
1394,32871350,10241,32881591,8,0,1,16384,3,5318980104
1395,32906070,104110,33010180,4,0,1,145920,10,8179920894
1396,32914920,97846,33012766,8,0,1,4096,3,711096653
1397,32945330,71622,33016952,8,0,1,6656,3,7709555332
1398,32952570,90611,33043181,4,0,1,92672,10,9598105180
1399,33011690,220189,33231879,7,0,0,148480,2,3592381022
1400,33021679,22168,33043847,0,0,1,11264,20,978921346
1401,33110450,152203,33262653,7,0,0,21504,2,2127100414
1402,33116669,12049,33128718,0,0,1,19968,20,1536876443
1403,33118439,13185,33131624,0,0,1,4608,20,6957340849
1404,33125689,7561,33133250,0,0,1,2560,20,1923888617
1405,33154381,3898,33158279,9,0,1,4096,9,1976490743
1406,33225230,11032,33236262,1,0,1,4608,18,8920182377
1407,33230110,194143,33424253,7,0,0,102400,2,5184236279
1408,33278220,246293,33524513,7,0,0,56832,2,7107374448
1409,33294040,175243,33469283,8,0,0,2048,3,8717035936
1410,33300300,71884,33372184,8,0,0,2048,3,9083519110
1411,33370759,3387,33374146,0,0,1,9728,20,4109731086
1412,33398699,38154,33436853,0,0,1,20992,20,3614776447
1413,33405480,101702,33507182,8,0,0,1536,3,1176560026
1414,33419841,17473,33437314,9,0,1,10240,9,2722733157
1415,33463170,11533,33474703,4,0,1,18944,10,8959463428
1416,33488650,5712,33494362,5,0,1,14336,12,3143761083
1417,33523520,104205,33627725,7,0,0,38912,2,3652820866
1418,33559581,1042,33560623,9,0,1,1024,9,6332104416
1419,33593741,15062,33608803,9,0,1,29184,9,7878857597
1420,33649930,10499,33660429,4,0,1,16896,10,6193542787
1421,33652169,82050,33734219,3,0,0,3584,28,10574267389
1422,33692789,566,33693355,0,0,1,512,20,6466411786
1423,33707829,2470,33710299,0,0,1,2560,20,9534091022
1424,33709461,14804,33724265,9,0,1,28672,9,74831492
1425,33741719,5326,33747045,0,0,1,5632,20,6673807016
1426,33745220,85489,33830709,8,0,0,1024,3,4623551080
1427,33780670,108368,33889038,7,0,0,55808,2,8296088264
1428,33818059,1518,33819577,3,0,1,1536,28,8273169746
1429,33830570,177771,34008341,8,0,0,512,3,5666393368
1430,33835271,566,33835837,9,0,1,512,9,8389287556
1431,33852991,1994,33854985,9,0,1,2048,9,2132094055
1432,33877009,88073,33965082,3,0,0,10240,28,3408797442
1433,33892009,4374,33896383,0,0,1,4608,20,6206810868
1434,33901610,106560,34008170,0,0,0,21504,20,9292200336
1435,33920230,23983,33944213,4,0,1,39936,10,9773835539
1436,33954409,194825,34149234,3,0,0,65536,28,590963758
1437,34058761,11274,34070035,9,0,1,18432,9,5200639667
1438,34064000,85561,34149561,8,0,0,1024,3,6113752861
1439,34078530,249520,34328050,7,0,0,110080,2,6641507089
1440,34114269,131151,34245420,3,0,0,39936,28,9392267211
1441,34236931,21047,34257978,9,0,1,20992,9,6537974973
1442,34283141,3904,34287045,9,0,1,10752,9,5653187316
1443,34303469,220000,34523469,3,0,0,32768,28,3728966332
1444,34380219,1518,34381737,0,0,1,1536,20,10258630510
1445,34388440,91395,34479835,8,0,0,2048,3,3915836136
1446,34420560,161904,34582464,7,0,0,11776,2,2935853168
1447,34436110,142751,34578861,7,0,0,53248,2,8008103040
1448,34455871,3898,34459769,9,0,1,4096,9,5705968049
1449,34498881,12995,34511876,9,0,1,25088,9,7691245557
1450,34535770,49778,34585548,8,0,0,512,3,10644579141
1451,34589360,77110,34666470,8,0,0,1536,3,4084616951
1452,34605681,5971,34611652,9,0,1,14848,9,3234163849
1453,34623110,12825,34635935,4,0,1,21504,10,3773827501
1454,34656300,49448,34705748,8,0,0,3584,3,367104508
1455,34682370,53659,34736029,8,0,0,1536,3,2554362783
1456,34689559,116857,34806416,3,0,0,34304,28,1039104701
1457,34836049,263156,35099205,3,0,0,276480,28,2331084220
1458,34996699,5971,35002670,0,0,1,14848,20,5139673379
1459,35075829,26790,35102619,0,0,1,3584,20,7844826982
1460,35120489,5802,35126291,0,0,1,6144,20,6793087343
1461,35143421,14117,35157538,9,0,1,24064,9,9559262685
1462,35201880,47288,35249168,8,0,0,1536,3,138100913
1463,35246579,52676,35299255,3,0,0,4096,28,9109134906
1464,35250719,10241,35260960,0,0,1,16384,20,5586299939
1465,35272229,5454,35277683,0,0,1,13824,20,562662000
1466,35279959,66565,35346524,3,0,0,2048,28,7731356939
1467,35287039,15321,35302360,0,0,1,29696,20,5666823736
1468,35308460,47288,35355748,8,0,0,1536,3,5798788018
1469,35364221,4374,35368595,9,0,1,4608,9,3767386619
1470,35393969,183434,35577403,3,0,0,116736,28,6474519372
1471,35480570,22691,35503261,5,0,1,37376,12,4982583405
1472,35514999,109928,35624927,3,0,0,60928,28,5404622849
1473,35578671,6278,35584949,9,0,1,6656,9,8813194283
1474,35579340,7875,35587215,1,0,1,3584,18,10503881150
1475,35590419,3422,35593841,0,0,1,3584,20,2283363428
1476,35615789,41963,35657752,0,0,1,53760,20,9154774268
1477,35620070,57862,35677932,8,0,0,5120,3,4369328634
1478,35645791,17658,35663449,9,0,1,18944,9,5668082219
1479,35713630,54752,35768382,8,0,0,512,3,1362871484
1480,35738111,7706,35745817,9,0,1,8192,9,4965235348
1481,35755051,3898,35758949,9,0,1,4096,9,6201685677
1482,35870781,3645,35874426,9,0,1,10240,9,9423854251
1483,35879830,3387,35883217,5,0,1,9728,12,8945949390
1484,35880980,24554,35905534,5,0,1,37376,12,8750701536
1485,35944009,2870,35946879,0,0,1,8704,20,3879401252
1486,36022420,115403,36137823,8,0,0,1536,3,7055000860
1487,36038320,55748,36094068,8,0,0,4096,3,4306957805
1488,36087559,4850,36092409,0,0,1,5120,20,9896679950
1489,36094341,1518,36095859,9,0,1,1536,9,10161422568
1490,36165141,6229,36171370,9,0,1,15360,9,4459469676
1491,36213511,2946,36216457,9,0,1,3072,9,811639184
1492,36246369,4850,36251219,0,0,1,5120,20,3490345257
1493,36273029,566,36273595,0,0,1,512,20,6690936619
1494,36331460,7706,36339166,5,0,1,8192,12,8223410665
1495,36348380,14117,36362497,7,0,1,24064,2,10313035575
1496,36361420,48980,36410400,8,0,0,2048,3,8975994281
1497,36392689,367590,36760279,3,0,0,378368,28,5650148744
1498,36448050,1518,36449568,6,0,1,1536,0,8786428476
1499,36498359,265749,36764108,3,0,0,11264,28,2260973634
1500,36513530,13512,36527042,5,0,1,26112,12,7353878462
1501,36513690,114207,36627897,8,0,0,1024,3,1494284304
1502,36536009,1994,36538003,0,0,1,2048,20,8588055276
1503,36567140,4420,36571560,6,0,1,11776,0,8443030754
1504,36592961,566,36593527,9,0,1,512,9,7600756513
1505,36607959,224375,36832334,3,0,0,85504,28,7528984441
1506,36620370,140275,36760645,8,0,0,1024,3,4570025776
1507,36628631,12049,36640680,9,0,1,19968,9,6172642890
1508,36642221,118089,36760310,9,0,1,33792,9,1463027472
1509,36652141,125784,36777925,9,0,1,23552,9,6359477568
1510,36655611,122980,36778591,9,0,1,1024,9,2624181288
1511,36673401,106675,36780076,9,0,1,15360,9,8740645703
1512,36691381,89791,36781172,9,0,1,12800,9,78288213
1513,36695179,86659,36781838,0,0,1,1024,20,8176673933
1514,36809150,129876,36939026,9,0,0,16896,9,180499472
1515,36817620,20057,36837677,5,0,1,5632,12,9779217152
1516,36890590,6229,36896819,8,0,1,15360,3,7096738392
1517,36916090,3645,36919735,5,0,1,10240,12,8463184157
1518,36990101,1042,36991143,9,0,1,1024,9,8657834351
1519,37009999,3422,37013421,0,0,1,3584,20,4801526493
1520,37017211,1518,37018729,9,0,1,1536,9,6880805260
1521,37046910,2870,37049780,8,0,1,8704,3,3173259230
1522,37053439,3904,37057343,0,0,1,10752,20,6878423180
1523,37114930,12825,37127755,8,0,1,21504,3,6107768304
1524,37214211,4679,37218890,9,0,1,12288,9,3472622792
1525,37220380,15579,37235959,5,0,1,30208,12,3390088554
1526,37298829,113204,37412033,3,0,0,71680,28,7158997975
1527,37318910,10499,37329409,8,0,1,16896,3,632163333
1528,37329990,10499,37340489,5,0,1,16896,12,7904103458
1529,37343370,12308,37355678,7,0,1,20480,2,4941007597
1530,37355770,6229,37361999,5,0,1,15360,12,5743158064
1531,37363000,3128,37366128,5,0,1,9216,12,7015482300
1532,37380930,31118,37412048,7,0,1,25088,2,8059239943
1533,37402030,17716,37419746,8,0,1,8192,3,1627931150
1534,37434090,1994,37436084,8,0,1,2048,3,8441833052
1535,37436070,10505,37446575,1,0,1,16896,18,9763156175
1536,37436750,12091,37448841,7,0,1,3584,2,2041166506
1537,37460741,3128,37463869,9,0,1,9216,9,5587926100
1538,37478430,5326,37483756,8,0,1,5632,3,2192135458
1539,37481060,220626,37701686,9,0,0,101888,9,8469831139
1540,37494120,1994,37496114,5,0,1,2048,12,7661969917
1541,37518470,2946,37521416,5,0,1,3072,12,5771956742
1542,37591140,10499,37601639,1,0,1,16896,18,5231360165
1543,37604580,10757,37615337,5,0,1,17408,12,5733167928
1544,37608211,12311,37620522,9,0,1,16384,9,9356842517
1545,37671631,42096,37713727,9,0,1,19968,9,8202535895
1546,37738320,3128,37741448,1,0,1,9216,18,8674933569
1547,37792560,1518,37794078,8,0,1,1536,3,5577422896
1548,37794349,204122,37998471,3,0,0,114176,28,5735217332
1549,37805250,13770,37819020,1,0,1,26624,18,8951033568
1550,37839489,288143,38127632,3,0,0,110592,28,3567851490
1551,37896331,14804,37911135,9,0,1,28672,9,3171848358
1552,37912090,216181,38128271,9,0,0,2048,9,7441122838
1553,37923990,5326,37929316,7,0,1,5632,2,2937534057
1554,38024810,177341,38202151,9,0,0,72192,9,64917271
1555,38053930,1042,38054972,8,0,1,1024,3,9325070655
1556,38086911,5802,38092713,9,0,1,6144,9,8374086757
1557,38151550,1042,38152592,5,0,1,1024,12,6168120082
1558,38168090,167206,38335296,9,0,0,119296,9,9159113770
1559,38199960,7509,38207469,6,0,1,5632,0,8916931784
1560,38205240,3215,38208455,7,0,1,1536,2,2621592815
1561,38267330,115432,38382762,9,0,0,47104,9,3892024910
1562,38299460,329652,38629112,9,0,0,74240,9,3354868803
1563,38331960,9065,38341025,8,0,1,14336,3,2368360524
1564,38390210,168336,38558546,9,0,0,35328,9,6106645821
1565,38391050,15837,38406887,8,0,1,30720,3,4702507397
1566,38391709,61114,38452823,3,0,0,3072,28,461373007
1567,38392020,17133,38409153,7,0,1,3584,2,5239271260
1568,38439591,3128,38442719,9,0,1,9216,9,8645089523
1569,38579290,78598,38657888,9,0,0,5120,9,5019981689
1570,38723409,103064,38826473,3,0,0,38400,28,8515669447
1571,38740369,102284,38842653,3,0,0,35840,28,7073898842
1572,38776380,2470,38778850,5,0,1,2560,12,4861637748
1573,38781850,3645,38785495,5,0,1,10240,12,8011374329
1574,38821000,21676,38842676,5,0,1,24576,12,5885943874
1575,38828650,17899,38846549,8,0,1,10752,3,703245192
1576,38845609,213105,39058714,3,0,0,237056,28,4226842220
1577,38849830,2946,38852776,6,0,1,3072,0,2163372538
1578,38934800,4374,38939174,5,0,1,4608,12,3929939406
1579,38934830,123899,39058729,4,0,1,97280,10,6475259083
1580,38975130,83614,39058744,7,0,1,12288,2,10513894776
1581,39042080,22110,39064190,6,0,1,13824,0,1761876031
1582,39059609,163474,39223083,3,0,0,16384,28,9310552598
1583,39103340,1518,39104858,5,0,1,1536,12,4167129302
1584,39194860,4850,39199710,8,0,1,5120,3,7320903740
1585,39225380,5326,39230706,6,0,1,5632,0,1345251997
1586,39247120,2470,39249590,5,0,1,2560,12,2269888441
1587,39356090,13341,39369431,6,0,1,22528,0,3489544306
1588,39436390,16613,39453003,6,0,1,32256,0,1946025572
1589,39475160,5196,39480356,6,0,1,13312,0,661352177
1590,39491170,7230,39498400,6,0,1,7680,0,10016296268
1591,39532300,214029,39746329,9,0,0,142848,9,3672256209
1592,39577880,1994,39579874,5,0,1,2048,12,8088502009
1593,39640959,116956,39757915,3,0,0,18432,28,6573996620
1594,39781820,3904,39785724,5,0,1,10752,12,73089772
1595,39813280,2470,39815750,6,0,1,2560,0,7478587844
1596,39835300,216883,40052183,9,0,0,186880,9,4344746387
1597,39969589,203773,40173362,3,0,0,185344,28,1334690808
1598,40090790,1518,40092308,5,0,1,1536,12,7875130410
1599,40121940,63997,40185937,5,0,1,20992,12,8885892982
1600,40133220,153207,40286427,9,0,0,71168,9,3142196335
1601,40375220,129870,40505090,9,0,0,70144,9,7085221497
1602,40404270,6488,40410758,5,0,1,15872,12,3272438955
1603,40507210,12566,40519776,5,0,1,20992,12,6664561699
1604,40530290,64076,40594366,9,0,0,11264,9,398841430
1605,40824430,100100,40924530,9,0,0,28672,9,8017717107
1606,40859790,222018,41081808,9,0,0,150528,9,9639900090
1607,40905719,217783,41123502,3,0,0,59392,28,1478328186
1608,41003050,566,41003616,8,0,1,512,3,8083094414
1609,41122979,99835,41222814,3,0,0,26112,28,526705841
1610,41229570,224645,41454215,9,0,0,180736,9,5095511705
1611,41249929,149203,41399132,3,0,0,28672,28,5943500638
1612,41285040,3898,41288938,5,0,1,4096,12,928691544
1613,41286819,174119,41460938,3,0,0,22016,28,4280698987
1614,41289820,5326,41295146,2,0,1,5632,29,4494636174
1615,41321960,6278,41328238,5,0,1,6656,12,1948206571
1616,41340740,5802,41346542,2,0,1,6144,29,9756324732
1617,41371630,1994,41373624,5,0,1,2048,12,3492466607
1618,41477660,99476,41577136,9,0,0,26624,9,6757201468
1619,41541950,6229,41548179,5,0,1,15360,12,5383451007
1620,41606590,2946,41609536,2,0,1,3072,29,9859616552
1621,41611210,4374,41615584,2,0,1,4608,29,803640530
1622,41630299,117728,41748027,3,0,0,86528,28,2704005720
1623,41687449,141590,41829039,3,0,0,52736,28,10728433366
1624,41767500,1518,41769018,5,0,1,1536,12,6860418032
1625,41823150,208556,42031706,9,0,0,145408,9,2521503188
1626,41989200,49770,42038970,2,0,1,7680,29,2871928438
1627,42025840,16996,42042836,2,0,1,6144,29,6018318993
1628,42030210,107410,42137620,9,0,0,47616,9,8716018058
1629,42069720,3898,42073618,5,0,1,4096,12,7358353516
1630,42110960,111260,42222220,9,0,0,25600,9,10449091322
1631,42328010,116012,42444022,9,0,0,50176,9,3462305885
1632,42337370,117116,42454486,9,0,0,19456,9,5371901515
1633,42371540,566,42372106,5,0,1,512,12,4019250168
1634,42430410,58566,42488976,4,0,1,77312,10,4147297072
1635,42436300,53022,42489322,5,0,1,512,12,10390155632
1636,42441790,119973,42561763,4,0,1,156160,10,6534815765
1637,42450010,114019,42564029,5,0,1,3584,12,4900688616
1638,42478399,95579,42573978,3,0,0,4608,28,5751328199
1639,42520960,49482,42570442,4,0,1,22528,10,3711290169
1640,42658180,4374,42662554,5,0,1,4608,12,9172019939
1641,42658690,84126,42742816,4,0,1,135168,10,6069158021
1642,42693570,76499,42770069,4,0,1,89600,10,9419783163
1643,42720510,65726,42786236,4,0,1,60928,10,9778038561
1644,42832249,252962,43085211,3,0,0,31232,28,1795864048
1645,42931690,11533,42943223,5,0,1,18944,12,1971014740
1646,42946690,12737,42959427,5,0,1,24576,12,4995008714
1647,42989620,4374,42993994,1,0,1,4608,18,6799257177
1648,43007710,15579,43023289,1,0,1,30208,18,8090985079
1649,43015660,7988,43023648,5,0,1,9728,12,2547237773
1650,43089851,566,43090417,9,0,1,512,9,2750922863
1651,43156380,5802,43162182,5,0,1,6144,12,10273279686
1652,43162620,1518,43164138,1,0,1,1536,18,9023374056
1653,43169180,6278,43175458,1,0,1,6656,18,3011222936
1654,43190550,10499,43201049,1,0,1,16896,18,7062437331
1655,43213070,3898,43216968,5,0,1,4096,12,1395427926
1656,43219181,6754,43225935,9,0,1,7168,9,8441044848
1657,43228760,258081,43486841,9,0,0,84992,9,7269209323
1658,43268650,12049,43280699,1,0,1,19968,18,2414722106
1659,43276159,158795,43434954,3,0,0,24064,28,4425876073
1660,43278400,2645,43281045,5,0,1,512,12,2232443155
1661,43292551,4850,43297401,9,0,1,5120,9,1125146928
1662,43315270,6278,43321548,5,0,1,6656,12,4257970416
1663,43375791,2470,43378261,9,0,1,2560,9,6541486122
1664,43386970,1518,43388488,1,0,1,1536,18,4893782489
1665,43392260,31266,43423526,4,0,1,50688,10,5760846657
1666,43393330,33102,43426432,1,0,1,4608,18,9244665785
1667,43414519,248697,43663216,3,0,0,24064,28,1738853528
1668,43440071,12566,43452637,9,0,1,20992,9,8634641596
1669,43476660,24031,43500691,5,0,1,23552,12,1695129845
1670,43487521,20824,43508345,9,0,1,27648,9,2375824743
1671,43494671,14238,43508909,9,0,1,10752,9,6583198779
1672,43540531,4374,43544905,9,0,1,4608,9,10529061048
1673,43583101,2470,43585571,9,0,1,2560,9,5637207167
1674,43623431,10757,43634188,9,0,1,17408,9,6085666662
1675,43647450,4850,43652300,1,0,1,5120,18,4937127130
1676,43668469,4850,43673319,3,0,1,5120,28,9476503681
1677,43681701,3645,43685346,9,0,1,10240,9,8493868326
1678,43684110,5134,43689244,5,0,1,4608,12,8858333054
1679,43702970,2470,43705440,2,0,1,2560,29,10243481488
1680,43707930,6278,43714208,5,0,1,6656,12,6298203383
1681,43709120,8954,43718074,6,0,1,6144,0,2913964428
1682,43730170,1042,43731212,2,0,1,1024,29,2268913284
1683,43733040,1042,43734082,2,0,1,1024,29,3513252943
1684,43736750,566,43737316,1,0,1,512,18,2308234935
1685,43795761,3387,43799148,9,0,1,9728,9,1191522620
1686,43805240,3387,43808627,2,0,1,9728,29,2140637023
1687,43810341,4374,43814715,9,0,1,4608,9,3780795781
1688,43821640,1518,43823158,1,0,1,1536,18,2323620408
1689,43843080,218310,44061390,9,0,0,157184,9,5581244096
1690,43879499,187366,44066865,3,0,0,17920,28,5757252758
1691,43885930,393577,44279507,9,0,0,205824,9,9130436688
1692,43949390,53325,44002715,4,0,1,87040,10,4279248681
1693,44024699,259535,44284234,3,0,0,15360,28,849675624
1694,44038430,29018,44067448,1,0,1,512,18,4491347030
1695,44176090,26221,44202311,4,0,1,47616,10,3401463841
1696,44191319,320299,44511618,3,0,0,82432,28,7165560538
1697,44254219,232268,44486487,3,0,0,74240,28,5619856472
1698,44261389,188477,44449866,3,0,0,5120,28,5897145339
1699,44266309,22759,44289068,0,0,1,5120,20,351001576
1700,44276999,171292,44448291,3,0,0,19456,28,747338979
1701,44277381,12033,44289414,9,0,1,512,9,6533177195
1702,44308210,23208,44331418,4,0,1,38400,10,306601961
1703,44339531,3422,44342953,9,0,1,3584,9,4445038831
1704,44437830,23378,44461208,4,0,1,41984,10,1726667900
1705,44449700,61933,44511633,1,0,1,8192,18,3845704808
1706,44450550,265761,44716311,9,0,0,81408,9,4265251438
1707,44458771,52877,44511648,9,0,1,2048,9,9887330713
1708,44493740,61012,44554752,4,0,1,73728,10,2062112446
1709,44583539,316325,44899864,3,0,0,55296,28,5650863738
1710,44645800,44145,44689945,4,0,1,75776,10,10713216795
1711,44652309,137488,44789797,3,0,0,55808,28,6299330001
1712,44701679,247955,44949634,3,0,0,146944,28,5565401264
1713,44731140,21658,44752798,4,0,1,35328,10,1655499044
1714,44817681,10757,44828438,9,0,1,17408,9,5165427754
1715,44833540,16096,44849636,4,0,1,31232,10,4163272283
1716,44910909,45964,44956873,3,0,1,7680,28,5245555068
1717,44941170,16049,44957219,1,0,1,512,18,4991466584
1718,44952140,10289,44962429,1,0,1,16384,18,660563993
1719,45057891,5971,45063862,9,0,1,14848,9,1183840900
1720,45060871,5577,45066448,9,0,1,4096,9,5671040121
1721,45113391,23208,45136599,9,0,1,38400,9,239242589
1722,45135230,4937,45140167,1,0,1,12800,18,441260979
1723,45158070,1518,45159588,1,0,1,1536,18,8127326981
1724,45235609,52364,45287973,3,0,0,3072,28,6499960043
1725,45318460,3387,45321847,1,0,1,9728,18,4675467751
1726,45363050,25187,45388237,4,0,1,45568,10,6262762207
1727,45391590,101366,45492956,4,0,1,163840,10,5583417438
1728,45423970,69652,45493622,1,0,1,1024,18,7926651112
1729,45446899,222449,45669348,3,0,0,122880,28,5309136682
1730,45524040,2870,45526910,8,0,1,8704,3,1457959344
1731,45580180,14804,45594984,1,0,1,28672,18,2843161996
1732,45587280,8268,45595548,8,0,1,10752,3,6425978024
1733,45587699,161417,45749116,3,0,0,66560,28,1084589961
1734,45634960,39359,45674319,1,0,1,12800,18,763538830
1735,45639070,148803,45787873,8,0,1,186368,3,2128480104
1736,45639380,148839,45788219,4,0,1,512,10,578681219
1737,45770270,23338,45793608,8,0,1,17408,3,7853208899
1738,45792320,3554,45795874,8,0,1,3584,3,1963365958
1739,45799740,34108,45833848,1,0,1,56320,18,2970435120
1740,45802290,88921,45891211,8,0,1,124416,3,2758596133
1741,45909279,80357,45989636,3,0,0,9728,28,2382026592
1742,46025090,23208,46048298,8,0,1,38400,3,3151655631
1743,46045290,101504,46146794,9,0,0,33280,9,5491124360
1744,46062969,4374,46067343,3,0,1,4608,28,5846049135
1745,46065500,4162,46069662,4,0,1,11264,10,2507332586
1746,46081630,5971,46087601,8,0,1,14848,3,7414760220
1747,46100010,46799,46146809,8,0,1,80896,3,2879964078
1748,46277530,108579,46386109,9,0,0,32256,9,3892305399
1749,46310010,4850,46314860,1,0,1,5120,18,115693430
1750,46388529,86672,46475201,3,0,0,14848,28,9854295129
1751,46412330,6754,46419084,1,0,1,7168,18,4250571731
1752,46478840,23983,46502823,4,0,1,39936,10,10505323126
1753,46508260,42683,46550943,4,0,1,69632,10,9758855473
1754,46524870,27558,46552428,4,0,1,15360,10,8863901660
1755,46661460,12049,46673509,1,0,1,19968,18,1523658478
1756,46717960,6754,46724714,7,0,1,7168,2,8265130616
1757,46754310,3904,46758214,7,0,1,10752,2,4858124005
1758,46755170,9695,46764865,4,0,1,7680,10,6947591471
1759,46779690,120262,46899952,9,0,0,59904,9,4553316814
1760,46828499,72256,46900755,3,0,0,2560,28,10284046992
1761,46877209,107276,46984485,3,0,0,52224,28,9822867044
1762,46886550,214282,47100832,9,0,0,198144,9,2928467923
1763,46947030,16096,46963126,1,0,1,31232,18,2836608629
1764,46998730,4850,47003580,1,0,1,5120,18,88314179
1765,47088110,13297,47101407,1,0,1,512,18,3068028896
1766,47089290,93081,47182371,4,0,1,131584,10,10297238165
1767,47169899,457957,47627856,3,0,0,402944,28,6440066060
1768,47174740,11177,47185917,1,0,1,5632,18,127871665
1769,47196891,566,47197457,9,0,1,512,9,5779812600
1770,47208471,16613,47225084,9,0,1,32256,9,5030924143
1771,47304810,200259,47505069,9,0,0,57344,9,4052130123
1772,47331430,7706,47339136,7,0,1,8192,2,7729240128
1773,47343510,6229,47349739,1,0,1,15360,18,6460653861
1774,47369550,13083,47382633,1,0,1,22016,18,3155401843
1775,47407951,5802,47413753,9,0,1,6144,9,5465525911
1776,47439490,194021,47633511,9,0,0,18432,9,2509485988
1777,47458020,22174,47480194,1,0,1,36352,18,7038046745
1778,47473339,283508,47756847,3,0,0,122368,28,4108892082
1779,47514350,124957,47639307,7,0,1,14336,2,5699206608
1780,47528119,422236,47950355,3,0,0,136704,28,5900328327
1781,47556961,93827,47650788,9,0,1,21504,9,744335753
1782,47574640,140443,47715083,9,0,0,3584,9,6991975299
1783,47593510,176263,47769773,4,0,1,203776,10,6886626901
1784,47593600,177799,47771399,7,0,1,2560,2,2296526125
1785,47605750,177400,47783150,4,0,1,39936,10,1539831034
1786,47610829,242448,47853277,3,0,0,8704,28,3653645002
1787,47628890,365735,47994625,4,0,1,445440,10,1781559937
1788,47700851,294850,47995701,9,0,1,13312,9,9047167852
1789,47730690,265472,47996162,1,0,1,10240,18,5115781707
1790,47735660,260848,47996508,1,0,1,512,18,7426810143
1791,47762990,236424,47999414,4,0,1,4608,10,863467553
1792,47793790,210911,48004701,5,0,1,25088,12,10188874667
1793,47825810,179352,48005162,4,0,1,10240,10,2578294280
1794,47896830,113926,48010756,7,0,1,26624,2,4408761509
1795,47905330,107014,48012344,7,0,1,15872,2,9341463707
1796,47965129,47561,48012690,3,0,1,512,28,9064193603
1797,47971051,42945,48013996,9,0,1,2048,9,8013218775
1798,48098850,391066,48489916,9,0,0,164864,9,247038038
1799,48124159,221490,48345649,3,0,0,84480,28,4669272412
1800,48126951,3128,48130079,9,0,1,9216,9,1238481326
1801,48155490,335541,48491031,9,0,0,3584,9,7244968878
1802,48163760,6278,48170038,7,0,1,6656,2,3096138927
1803,48166500,4204,48170704,2,0,1,1024,29,6458659510
1804,48188280,386786,48575066,9,0,0,246784,9,2579269375
1805,48269449,226909,48496358,3,0,0,17408,28,2959347988
1806,48276450,2946,48279396,4,0,1,3072,10,5417797194
1807,48379451,2870,48382321,9,0,1,8704,9,4162916180
1808,48423590,12825,48436415,2,0,1,21504,29,10215354513
1809,48441571,56740,48498311,9,0,1,2048,9,4708382514
1810,48457600,41697,48499297,4,0,1,1536,10,3707839725
1811,48546190,237980,48784170,9,0,0,194560,9,2816646462
1812,48551200,27528,48578728,7,0,1,10240,2,2471575388
1813,48590320,21141,48611461,5,0,1,34304,12,8286675502
1814,48612470,5196,48617666,5,0,1,13312,12,3369922815
1815,48619900,15321,48635221,5,0,1,29696,12,5202594316
1816,48624429,199112,48823541,3,0,0,54784,28,5817145494
1817,48625340,13747,48639087,4,0,1,6144,10,7123709775
1818,48636960,3113,48640073,4,0,1,1536,10,5383982032
1819,48748000,260740,49008740,9,0,0,79872,9,26566682
1820,48764150,20620,48784770,2,0,1,512,29,2604052051
1821,48778270,10510,48788780,1,0,1,11776,18,10449321501
1822,48810311,15692,48826003,9,0,1,2560,9,2391915728
1823,48828670,7230,48835900,5,0,1,7680,12,2466039114
1824,48856680,6278,48862958,4,0,1,6656,10,10461638922
1825,48897340,5454,48902794,5,0,1,13824,12,1131161898
1826,48907650,4850,48912500,7,0,1,5120,2,9598063981
1827,48928780,4374,48933154,4,0,1,4608,10,10504539217
1828,48958170,6278,48964448,7,0,1,6656,2,5149004943
1829,48967179,61579,49028758,3,0,0,6144,28,1912070015
1830,48973560,1042,48974602,7,0,1,1024,2,5416547752
1831,48990840,22329,49013169,2,0,1,11776,29,5977085961
1832,48998060,17922,49015982,4,0,1,10240,10,6730187134
1833,49028080,14787,49042867,7,0,1,24064,2,9926083948
1834,49045680,4420,49050100,5,0,1,11776,12,9885358040
1835,49065380,5712,49071092,7,0,1,14336,2,1525753099
1836,49076639,328881,49405520,3,0,0,92672,28,2359036243
1837,49126840,21916,49148756,4,0,1,35840,10,6233991764
1838,49134090,15742,49149832,5,0,1,13312,12,46704773
1839,49168550,4850,49173400,2,0,1,5120,29,2809775998
1840,49197610,1042,49198652,2,0,1,1024,29,10463333444
1841,49203950,566,49204516,7,0,1,512,2,524696448
1842,49211350,2946,49214296,5,0,1,3072,12,7961374932
1843,49223699,284295,49507994,3,0,0,24576,28,2323107705
1844,49243990,3387,49247377,7,0,1,9728,2,742365552
1845,49261730,365024,49626754,9,0,0,163840,9,10672638583
1846,49272561,22691,49295252,9,0,1,37376,9,8136776397
1847,49276290,297096,49573386,9,0,0,71680,9,5013274068
1848,49321100,1994,49323094,5,0,1,2048,12,2945876711
1849,49327980,6488,49334468,7,0,1,15872,2,4126340072
1850,49366430,4374,49370804,7,0,1,4608,2,5825081903
1851,49368281,37254,49405535,2,0,1,37888,29,8047386498
1852,49425570,31783,49457353,2,0,1,51712,29,2162795493
1853,49429310,28197,49457507,7,0,1,8704,2,7951730195
1854,49480260,6488,49486748,2,0,1,15872,29,1978175271
1855,49553010,73775,49626785,1,0,1,39424,18,5487540487
1856,49555690,71110,49626800,2,0,1,1536,29,1416126447
1857,49559120,67695,49626815,2,0,1,3072,29,2396496563
1858,49585240,45192,49630432,2,0,1,10240,29,7456322199
1859,49592480,50252,49642732,7,0,1,21504,2,6643066721
1860,49667660,7706,49675366,5,0,1,8192,12,2198508688
1861,49701200,112424,49813624,9,0,0,69120,9,7984799675
1862,49718860,140172,49859032,9,0,0,56832,9,2284600177
1863,49787110,4374,49791484,5,0,1,4608,12,3329698576
1864,49900110,10757,49910867,5,0,1,17408,12,3703390591
1865,49906010,9363,49915373,5,0,1,7168,12,3068499234
1866,49960250,3898,49964148,5,0,1,4096,12,6247552097
1867,49961699,326684,50288383,3,0,0,161792,28,1227144390
1868,49967480,349004,50316484,9,0,0,54272,9,8050722792
1869,50005140,4374,50009514,2,0,1,4608,29,4040577430
1870,50029109,137918,50167027,3,0,0,78848,28,5647298763
1871,50046250,2946,50049196,2,0,1,3072,29,10618766045
1872,50088330,12308,50100638,7,0,1,20480,2,2370360512
1873,50145240,34362,50179602,2,0,1,20992,29,5860543870
1874,50162600,20548,50183148,2,0,1,5632,29,9163158800
1875,50185899,132940,50318839,3,0,0,7680,28,1765232717
1876,50278640,16013,50294653,7,0,1,6656,2,314879426
1877,50401200,21916,50423116,7,0,1,35840,2,5617196628
1878,50429280,99632,50528912,9,0,0,27136,9,413588719
1879,50454029,2870,50456899,0,0,1,8704,20,5728814194
1880,50480729,3422,50484151,0,0,1,3584,20,8363990664
1881,50744620,1042,50745662,7,0,1,1024,2,8514921225
1882,50786629,1518,50788147,0,0,1,1536,20,1782023839
1883,50807200,80216,50887416,9,0,0,13824,9,8913973382
1884,50833020,7706,50840726,7,0,1,8192,2,3835198140
1885,50833609,8743,50842352,0,0,1,2560,20,4518127977
1886,50900399,7706,50908105,0,0,1,8192,20,1449623810
1887,50926689,6229,50932918,0,0,1,15360,20,6824737473
1888,50988190,123092,51111282,9,0,0,65024,9,4210048200
1889,51019749,10757,51030506,0,0,1,17408,20,9641464496
1890,51022869,8098,51030967,3,0,1,10240,28,2505617108
1891,51052260,5326,51057586,7,0,1,5632,2,7046530033
1892,51107419,345734,51453153,3,0,0,173568,28,3721506205
1893,51150639,148443,51299082,3,0,0,22016,28,1795761622
1894,51157559,10241,51167800,0,0,1,16384,20,4649270002
1895,51180410,5802,51186212,7,0,1,6144,2,3614248881
1896,51238009,12308,51250317,0,0,1,20480,20,1413209293
1897,51287129,173691,51460820,3,0,0,25088,28,9284531838
1898,51297770,15333,51313103,7,0,1,27136,2,5396415703
1899,51308969,5440,51314409,0,0,1,2048,20,7955933030
1900,51360850,25962,51386812,6,0,1,47104,0,9569928070
1901,51387920,11274,51399194,6,0,1,18432,0,8576661949
1902,51404189,59485,51463674,0,0,1,8704,20,7180002097
1903,51443020,200986,51644006,9,0,0,48640,9,1254138102
1904,51454650,118426,51573076,9,0,0,33280,9,1175281264
1905,51463059,12520,51475579,0,0,1,19968,20,6882107737
1906,51574700,70904,51645604,9,0,0,5120,9,8715382475
1907,51628439,15590,51644029,0,0,1,13824,20,4148801239
1908,51629719,155078,51784797,3,0,0,83968,28,6636664257
1909,51751039,5454,51756493,0,0,1,13824,20,3048912091
1910,51785990,12995,51798985,6,0,1,25088,0,3212083328
1911,51856670,6278,51862948,7,0,1,6656,2,7040074742
1912,51882670,3387,51886057,6,0,1,9728,0,1263514568
1913,51891080,228161,52119241,9,0,0,23552,9,4927248768
1914,51892030,180666,52072696,9,0,0,150016,9,472067543
1915,51900130,211920,52112050,9,0,0,51200,9,8989190822
1916,51901070,12566,51913636,8,0,1,20992,3,4866529597
1917,51950240,5802,51956042,7,0,1,6144,2,3144105697
1918,51958589,296754,52255343,3,0,0,33792,28,6028923510
1919,51998550,13512,52012062,6,0,1,26112,0,5323708026
1920,52015000,57727,52072727,8,0,1,47104,3,3135765593
1921,52025850,219167,52245017,9,0,0,96768,9,2414559894
1922,52034419,97881,52132300,3,0,0,5632,28,504054750
1923,52057670,19450,52077120,7,0,1,4608,2,1617577520
1924,52128499,3816,52132315,0,0,1,2560,20,1275126564
1925,52181880,63152,52245032,8,0,1,86016,3,1322674689
1926,52191829,291620,52483449,3,0,0,113152,28,665546137
1927,52205750,49608,52255358,1,0,1,22528,18,774114258
1928,52244150,16137,52260287,6,0,1,12800,0,1531836814
1929,52256780,54552,52311332,8,0,1,84480,3,1242037571
1930,52384830,23378,52408208,8,0,1,41984,3,10227946233
1931,52424430,59050,52483480,8,0,1,87552,3,9402425060
1932,52476780,30581,52507361,8,0,1,43008,3,1597364245
1933,52477850,34696,52512546,8,0,1,16384,3,8611096895
1934,52508629,129257,52637886,3,0,0,7168,28,3673972159
1935,52531650,189363,52721013,9,0,0,23552,9,9382965359
1936,52540879,11533,52552412,0,0,1,18944,20,7090180687
1937,52610930,308360,52919290,9,0,0,100864,9,10581823068
1938,52692140,194489,52886629,9,0,0,47616,9,2153083692
1939,52741140,4679,52745819,8,0,1,12288,3,9614979382
1940,52773090,99008,52872098,9,0,0,25088,9,7317269174
1941,52807120,20882,52828002,8,0,1,33792,3,9130910428
1942,52863890,465037,53328927,9,0,0,272384,9,6193291489
1943,52865690,283258,53148948,9,0,0,95232,9,4342442171
1944,52922080,323840,53245920,9,0,0,58368,9,7530916105
1945,52937710,226446,53164156,9,0,0,18944,9,4002962552
1946,52938100,101624,53039724,8,0,1,164352,3,1974851449
1947,52942140,103588,53045728,7,0,1,20480,2,10399204350
1948,53011180,359430,53370610,9,0,0,136704,9,249890674
1949,53028400,34279,53062679,8,0,1,59904,3,1670513097
1950,53190349,4850,53195199,0,0,1,5120,20,3756449488
1951,53204580,217401,53421981,9,0,0,74752,9,5439529038
1952,53233359,339613,53572972,3,0,0,89088,28,8304811995
1953,53297340,347236,53644576,8,0,1,443392,3,4381695164
1954,53331030,314852,53645882,7,0,1,2048,2,1136164799
1955,53331500,434800,53766300,9,0,0,62976,9,6628246831
1956,53439270,327045,53766315,8,0,1,332800,3,10332081859
1957,53498609,417194,53915803,3,0,0,30720,28,205099076
1958,53589430,263821,53853251,8,0,1,332288,3,9465800429
1959,53682410,187520,53869930,8,0,1,63488,3,2844433119
1960,53707000,163276,53870276,6,0,1,512,0,1683079384
1961,53719660,238133,53957793,8,0,1,279552,3,9534783147
1962,53757840,464864,54222704,9,0,0,45056,9,1229976859
1963,53799669,168544,53968213,3,0,1,41472,28,3555103716
1964,53831150,309064,54140214,3,0,0,100352,28,9887958917
1965,53846370,448278,54294648,9,0,0,28160,9,8823699494
1966,53861810,108669,53970479,6,0,1,3584,0,637512732
1967,53873910,101715,53975625,6,0,1,8192,0,1933670958
1968,53937680,38611,53976291,6,0,1,1024,0,2907984715
1969,53938940,38222,53977162,6,0,1,12288,0,4669302224
1970,53997440,51516,54048956,8,0,1,83456,3,3768120935
1971,54055189,324305,54379494,3,0,0,29696,28,10224632012
1972,54099790,255534,54355324,3,0,0,28160,28,2445967941
1973,54410290,203919,54614209,3,0,0,28672,28,5245592103
1974,54448310,1994,54450304,7,0,1,2048,2,3979031809
1975,54461809,124222,54586031,5,0,0,26624,12,1127822761
1976,54579350,192827,54772177,8,0,1,305664,3,6275669132
1977,54637020,141058,54778078,8,0,1,28160,3,8322412361
1978,54689280,320811,55010091,9,0,0,60416,9,4876078003
1979,54800110,7230,54807340,7,0,1,7680,2,192490977
1980,54814190,3128,54817318,7,0,1,9216,2,3290105835
1981,54846430,7230,54853660,7,0,1,7680,2,5579652902
1982,54942021,566,54942587,9,0,1,512,9,9727190893
1983,54946070,1994,54948064,7,0,1,2048,2,3740412717
1984,54954510,3645,54958155,7,0,1,10240,2,10489281452
1985,54977309,161881,55139190,3,0,0,66048,28,916822818
1986,54988710,219630,55208340,9,0,0,65024,9,1386664727
1987,55101020,5802,55106822,7,0,1,6144,2,8782742018
1988,55103320,84224,55187544,9,0,0,16896,9,6183372756
1989,55143540,163149,55306689,8,0,1,264192,3,6049263774
1990,55204149,103846,55307995,0,0,1,2048,20,8551028196
1991,55205340,103628,55308968,8,0,1,12800,3,10212628231
1992,55207730,132497,55340227,8,0,1,100352,3,6318196434
1993,55222460,290055,55512515,9,0,0,154624,9,7657860842
1994,55236630,199806,55436436,9,0,0,512,9,811990412
1995,55252330,91763,55344093,7,0,1,6144,2,3908844848
1996,55260530,86789,55347319,1,0,1,5120,18,4987517545
1997,55333439,304086,55637525,3,0,0,175616,28,10041072745
1998,55363560,305902,55669462,9,0,0,19456,9,10411013886
1999,55399370,4850,55404220,7,0,1,5120,2,2480992596
2000,55423930,88600,55512530,8,0,1,112128,3,2556052513
2001,55558740,91145,55649885,9,0,0,512,9,2214195007
2002,55565030,360496,55925526,9,0,0,12800,9,6151069411
2003,55575020,62520,55637540,7,0,1,77824,2,4797352270
2004,55664900,233362,55898262,9,0,0,94720,9,6000948092
2005,55669280,13282,55682562,7,0,1,22016,2,3723661550
2006,55695200,6488,55701688,7,0,1,15872,2,4551968664
2007,55707420,131741,55839161,8,0,1,212992,3,1821118422
2008,55767410,76936,55844346,8,0,1,16384,3,6785912534
2009,55832630,15902,55848532,8,0,1,6656,3,8324226361
2010,55849010,13341,55862351,8,0,1,22528,3,3472388408
2011,55864600,3387,55867987,8,0,1,9728,3,2495305953
2012,55897360,1936,55899296,2,0,1,1024,29,3305244472
2013,55947650,10241,55957891,8,0,1,16384,3,2542627117
2014,55961820,24412,55986232,7,0,1,44032,2,10659830267
2015,55975020,12518,55987538,8,0,1,2048,3,7059247432
2016,55977970,120112,56098082,9,0,0,14336,9,5649774222
2017,56022550,5712,56028262,7,0,1,14336,2,8123151194
2018,56023900,16579,56040479,7,0,1,26112,2,1142960918
2019,56031330,11735,56043065,7,0,1,4096,2,1286730925
2020,56061950,114436,56176386,9,0,0,38400,9,298657138
2021,56164770,12650,56177420,7,0,1,1024,2,9000189202
2022,56191660,12995,56204655,8,0,1,25088,3,8451275150
2023,56195270,13571,56208841,7,0,1,6656,2,4365486846
2024,56214210,41908,56256118,8,0,1,68096,3,8204453534
2025,56236760,208646,56445406,3,0,0,39424,28,2595397415
2026,56279820,13341,56293161,7,0,1,22528,2,9384133922
2027,56295530,228449,56523979,8,0,1,348160,3,1283423265
2028,56318440,205554,56523994,7,0,1,27648,2,563022113
2029,56370879,153085,56523964,3,0,0,79360,28,8687843646
2030,56445899,291108,56737007,3,0,0,109056,28,3183682701
2031,56457240,66769,56524009,7,0,1,14848,2,2492886949
2032,56612050,6754,56618804,7,0,1,7168,2,5059850372
2033,56657870,304256,56962126,9,0,0,125440,9,10451053356
2034,56702590,34432,56737022,7,0,1,3072,2,6853960631
2035,56721020,38427,56759447,8,0,1,36864,3,8165160999
2036,56769380,13083,56782463,8,0,1,22016,3,7874299002
2037,56783390,242103,57025493,9,0,0,68096,9,945824860
2038,56856720,3904,56860624,5,0,1,10752,12,8913570327
2039,56933820,295733,57229553,9,0,0,19968,9,1868946658
2040,56935090,61865,56996955,8,0,1,60928,3,47552465
2041,56949060,76448,57025508,7,0,1,36864,2,5258196874
2042,56997480,116948,57114428,9,0,0,83968,9,417637565
2043,57011960,14123,57026083,5,0,1,512,12,967412315
2044,57016590,183665,57200255,9,0,0,35840,9,9231257334
2045,57030050,5326,57035376,5,0,1,5632,12,2813034038
2046,57065769,270700,57336469,3,0,0,88064,28,9613287957
2047,57072090,277732,57349822,3,0,0,30208,28,1996457762
2048,57080559,80239,57160798,3,0,0,4096,28,3683006879
2049,57181710,127897,57309607,9,0,0,20992,9,7439751653
2050,57191950,30488,57222438,1,0,1,36352,18,5767193617
2051,57195710,33858,57229568,5,0,1,13824,12,4432854626
2052,57255139,181580,57436719,3,0,0,59392,28,879417662
2053,57272450,37172,57309622,8,0,1,55296,3,2431260246
2054,57288290,48194,57336484,1,0,1,20480,18,6940790164
2055,57288810,47697,57336507,8,0,1,45568,3,7592688431
2056,57317430,32407,57349837,7,0,1,6144,2,4906290097
2057,57327239,232269,57559508,3,0,0,101376,28,1548612354
2058,57379470,5326,57384796,1,0,1,5632,18,3217283332
2059,57428530,12860,57441390,7,0,1,12288,2,1720055459
2060,57527130,32393,57559523,7,0,1,10240,2,765928276
2061,57531350,190623,57721973,9,0,0,68096,9,3910112793
2062,57588020,136152,57724172,4,0,0,7168,10,10714709632
2063,57627610,6754,57634364,1,0,1,7168,18,5249452702
2064,57769680,105248,57874928,4,0,0,45568,10,8120806321
2065,57805950,2946,57808896,1,0,1,3072,18,8456696983
2066,57814280,204354,58018634,4,0,0,188416,10,3971807586
2067,57814480,102916,57917396,8,0,1,166912,3,5747485379
2068,57820250,98119,57918369,1,0,1,12800,18,327437119
2069,57842930,78665,57921595,1,0,1,5120,18,8088000127
2070,57864210,59651,57923861,4,0,1,3584,10,10027504632
2071,57866750,222859,58089609,9,0,0,42496,9,6305839659
2072,57880990,59346,57940336,8,0,1,54272,3,2963409291
2073,57923570,376384,58299954,4,0,0,213504,10,4390502331
2074,57935640,5157,57940797,7,0,1,10240,2,5418768689
2075,57956860,466367,58423227,4,0,0,151040,10,10239426003
2076,57967660,62899,58030559,1,0,1,19456,18,2663889146
2077,57976329,57136,58033465,3,0,1,4608,28,1449462178
2078,57987090,52481,58039571,1,0,1,20992,18,6587722486
2079,58007220,476417,58483637,9,0,0,130048,9,5844305377
2080,58008650,36310,58044960,4,0,1,17408,10,2746435509
2081,58013020,32299,58045319,4,0,1,9728,10,136491717
2082,58017030,34750,58051780,8,0,1,17920,3,2927160187
2083,58091760,409428,58501188,4,0,0,19456,10,8769116619
2084,58126240,6754,58132994,7,0,1,7168,2,10126133436
2085,58154730,289260,58443990,4,0,0,68096,10,9692099291
2086,58193320,1518,58194838,1,0,1,1536,18,6959724733
2087,58399550,89898,58489448,4,0,1,6144,10,3261814426
2088,58426270,65477,58491747,1,0,1,15360,18,1600121081
2089,58434999,114354,58549353,3,0,0,1536,28,9839993149
2090,58599180,7230,58606410,1,0,1,7680,18,1864256260
2091,58625390,109460,58734850,9,0,0,59392,9,8385170363
2092,58686830,10499,58697329,1,0,1,16896,18,4483254454
2093,58701990,10241,58712231,7,0,1,16384,2,837133158
2094,58716260,18613,58734873,7,0,1,18432,2,2999948240
2095,58724830,12482,58737312,7,0,1,2560,2,9766794999
2096,58759790,150931,58910721,3,0,0,38912,28,8228986495
2097,58767260,2946,58770206,7,0,1,3072,2,10155769291
2098,58870440,4679,58875119,1,0,1,12288,18,3459570580
2099,58918030,47288,58965318,9,0,0,1536,9,3641830797
2100,58956480,5196,58961676,1,0,1,13312,18,10512882400
2101,58960640,103844,59064484,3,0,0,40960,28,4089297272
2102,59004080,4162,59008242,7,0,1,11264,2,9358429451
2103,59006479,93399,59099878,3,0,0,14848,28,1695998066
2104,59019990,3422,59023412,7,0,1,3584,2,5775655330
2105,59036330,1042,59037372,7,0,1,1024,2,10419068455
2106,59065330,3422,59068752,7,0,1,3584,2,10733629089
2107,59143560,13512,59157072,7,0,1,26112,2,1937284487
2108,59145559,224979,59370538,3,0,0,30208,28,10531959319
2109,59166200,5196,59171396,7,0,1,13312,2,875284161
2110,59168860,65928,59234788,8,0,1,105472,3,4968092262
2111,59236690,1994,59238684,4,0,1,2048,10,2130100870
2112,59236930,4807,59241737,7,0,1,4608,2,5966274648
2113,59296509,141850,59438359,3,0,0,7680,28,8002228409
2114,59362370,21243,59383613,8,0,1,22016,3,9888214296
2115,59390530,89588,59480118,9,0,0,14336,9,7898525022
2116,59500509,206453,59706962,3,0,0,71168,28,5973950112
2117,59522270,11791,59534061,1,0,1,19456,18,4738235280
2118,59527430,7937,59535367,4,0,1,2048,10,8326429515
2119,59536339,106300,59642639,3,0,0,9216,28,3049066734
2120,59537600,200404,59738004,3,0,0,41984,28,2235398208
2121,59651959,246749,59898708,3,0,0,246784,28,6242452180
2122,59661099,298113,59959212,3,0,0,130560,28,7702104897
2123,59736159,336899,60073058,3,0,0,23040,28,7766358554
2124,59741980,235331,59977311,9,0,0,29696,9,4205180168
2125,59741989,311330,60053319,3,0,0,144896,28,10543648145
2126,59775299,285055,60060354,3,0,0,23040,28,10650498170
2127,59791089,107962,59899051,3,0,0,1024,28,6819351705
2128,59801850,13341,59815191,4,0,1,22528,10,2657502243
2129,59835290,300421,60135711,9,0,0,106496,9,1498879545
2130,59882219,318898,60201117,3,0,0,93184,28,2322230073
2131,59943680,33646,59977326,1,0,1,17920,18,6836734770
2132,59945920,31421,59977341,8,0,1,10752,3,4215663002
2133,59951670,150062,60101732,9,0,0,5120,9,5709613334
2134,59994760,5326,60000086,5,0,1,5632,12,6396505353
2135,60076410,4850,60081260,1,0,1,5120,18,1051733318
2136,60111170,34791,60145961,8,0,1,16384,3,10360886977
2137,60134310,12637,60146947,1,0,1,1536,18,10552013156
2138,60160390,1042,60161432,4,0,1,1024,10,5964214414
2139,60182730,23705,60206435,1,0,1,5632,18,9181197047
2140,60251759,154245,60406004,3,0,0,54784,28,2829050720
2141,60301789,13600,60315389,3,0,1,23040,28,8204737774
2142,60367260,142621,60509881,9,0,0,51200,9,2762965913
2143,60399550,7012,60406562,4,0,1,512,10,578852345
2144,60411810,13341,60425151,8,0,1,22528,3,383906595
2145,60443470,2946,60446416,4,0,1,3072,10,3053361908
2146,60498900,15135,60514035,4,0,1,11264,10,4116612115
2147,60583900,7706,60591606,4,0,1,8192,10,4373975304
2148,60589929,165124,60755053,3,0,0,92672,28,7476482635
2149,60598130,13770,60611900,1,0,1,26624,18,5333640789
2150,60636300,16096,60652396,4,0,1,31232,10,3548073127
2151,60647940,183127,60831067,9,0,0,114176,9,5840874789
2152,60681489,228309,60909798,3,0,0,126464,28,5373597310
2153,60702760,7230,60709990,4,0,1,7680,10,1085867691
2154,60728750,33066,60761816,8,0,1,7168,3,9637642422
2155,60754050,12592,60766642,4,0,1,7680,10,3292885315
2156,60757350,10163,60767513,1,0,1,12288,18,1901942167
2157,60801760,292405,61094165,3,0,0,196608,28,4531288912
2158,60833600,4850,60838450,1,0,1,5120,18,7748444378
2159,60841870,258862,61100732,3,0,0,21504,28,281237871
2160,60844020,7706,60851726,1,0,1,8192,18,6626427180
2161,60919240,2946,60922186,8,0,1,3072,3,7346980884
2162,60945810,12566,60958376,8,0,1,20992,3,427213818
2163,60952720,326030,61278750,3,0,0,211968,28,6298082934
2164,60991300,16096,61007396,4,0,1,31232,10,10406840989
2165,60995080,135801,61130881,3,0,0,8704,28,4862461009
2166,61068990,36688,61105678,8,0,1,12800,3,10012559708
2167,61091910,28310,61120220,8,0,1,30208,3,9502481442
2168,61125170,157355,61282525,3,0,0,12288,28,6332819450
2169,61149080,3645,61152725,6,0,1,10240,0,1009719003
2170,61222510,72023,61294533,8,0,1,19968,3,1113358676
2171,61243470,51934,61295404,8,0,1,12288,3,7031216626
2172,61319360,4937,61324297,8,0,1,12800,3,10322353574
2173,61319570,26706,61346276,6,0,1,37888,0,1570087831
2174,61322980,24372,61347352,1,0,1,13312,18,6858775682
2175,61324780,23545,61348325,8,0,1,12800,3,4886034545
2176,61341040,337627,61678667,9,0,0,59392,9,669654831
2177,61367160,287027,61654187,3,0,0,145408,28,1819110653
2178,61371210,25704,61396914,8,0,1,46592,3,695771208
2179,61418280,6278,61424558,8,0,1,6656,3,9346029118
2180,61440500,5802,61446302,8,0,1,6144,3,4308604994
2181,61448250,1518,61449768,4,0,1,1536,10,10541372557
2182,61471110,1042,61472152,8,0,1,1024,3,7650255844
2183,61476250,423529,61899779,3,0,0,225280,28,6457700942
2184,61482920,3128,61486048,8,0,1,9216,3,9183281929
2185,61493799,6754,61500553,3,0,1,7168,28,2153854312
2186,61501160,302122,61803282,9,0,0,63488,9,7414101112
2187,61534470,7230,61541700,4,0,1,7680,10,6130500766
2188,61535270,12605,61547875,4,0,1,17920,10,335763122
2189,61568460,6754,61575214,6,0,1,7168,0,9515193861
2190,61657470,173654,61831124,9,0,0,43008,9,8521857575
2191,61706280,2946,61709226,6,0,1,3072,0,4663458737
2192,61715360,332372,62047732,3,0,0,196608,28,8348780669
2193,61740230,5971,61746201,4,0,1,14848,10,9993151362
2194,61741550,17111,61758661,6,0,1,23552,0,5154331645
2195,61808839,6754,61815593,3,0,1,7168,28,10052694714
2196,61843010,215033,62058043,3,0,0,33792,28,938978309
2197,61850380,54283,61904663,4,0,1,5120,10,2976166647
2198,61878190,197714,62075904,3,0,0,20480,28,6881872000
2199,61904260,5326,61909586,6,0,1,5632,0,2970430420
2200,61977829,6754,61984583,3,0,1,7168,28,717594252
2201,62016270,42331,62058601,4,0,1,512,10,2875186129
2202,62069520,116828,62186348,3,0,0,58368,28,3101234133
2203,62077200,82820,62160020,9,0,0,12288,9,7247205192
2204,62157269,29094,62186363,3,0,1,29184,28,6512074218
2205,62198880,252062,62450942,9,0,0,163328,9,6926670754
2206,62199020,201984,62401004,3,0,0,101376,28,4526711820
2207,62207559,14117,62221676,3,0,1,24064,28,4738507706
2208,62265009,212795,62477804,3,0,0,88064,28,7067797225
2209,62338630,170358,62508988,9,0,0,90112,9,5953807378
2210,62367009,34018,62401027,3,0,1,13824,28,5688992494
2211,62371330,79627,62450957,4,0,1,4096,10,8148109307
2212,62445699,63312,62509011,3,0,1,7168,28,5385907101
2213,62454490,119046,62573536,3,0,0,17408,28,4808684129
2214,62468940,40086,62509026,4,0,1,7680,10,7508247020
2215,62482619,236057,62718676,3,0,0,32768,28,8529915337
2216,62492650,162048,62654698,9,0,0,55808,9,4207554887
2217,62641970,14238,62656208,4,0,1,1536,10,3107042789
2218,62672010,5326,62677336,4,0,1,5632,10,4163666816
2219,62676540,2870,62679410,4,0,1,8704,10,9352243068
2220,62680280,2946,62683226,7,0,1,3072,2,2771681716
2221,62698880,4937,62703817,4,0,1,12800,10,5354948482
2222,62768920,152826,62921746,9,0,0,28672,9,351540105
2223,62782770,6754,62789524,4,0,1,7168,10,7774077077
2224,62927690,101816,63029506,9,0,0,34304,9,1534768068
2225,62951000,3128,62954128,6,0,1,9216,0,9333146449
2226,62953959,150157,63104116,3,0,0,51200,28,6062633643
2227,62989449,296060,63285509,3,0,0,88576,28,8598624087
2228,62998330,3422,63001752,7,0,1,3584,2,4136534160
2229,63009790,181705,63191495,3,0,0,28160,28,2665295043
2230,63012330,3128,63015458,7,0,1,9216,2,5828396514
2231,63024680,9238,63033918,4,0,1,11776,10,10297539046
2232,63033840,105118,63138958,9,0,0,38400,9,1677874821
2233,63086780,17351,63104131,6,0,1,6144,0,7377518029
2234,63102500,202350,63304850,9,0,0,61952,9,6554062662
2235,63261310,43555,63304865,4,0,1,2560,10,4709080695
2236,63267870,172159,63440029,9,0,0,142848,9,10180453072
2237,63305141,135527,63440668,1,0,0,2048,18,3625659229
2238,63390200,112892,63503092,9,0,0,70656,9,4364804332
2239,63491890,84027,63575917,3,0,0,9216,28,9918580646
2240,63506270,4850,63511120,6,0,1,5120,0,2976015285
2241,63520490,6278,63526768,6,0,1,6656,0,7446820472
2242,63574231,57426,63631657,1,0,0,4096,18,3791951944
2243,63575390,14661,63590051,6,0,1,24064,0,2216410362
2244,63589780,24242,63614022,6,0,1,40448,0,1312471659
2245,63600550,19885,63620435,4,0,1,22528,10,2558309895
2246,63610301,46874,63657175,1,0,0,1024,18,5614215748
2247,63706890,3387,63710277,4,0,1,9728,10,4088079948
2248,63707200,27632,63734832,6,0,1,45056,0,3655602845
2249,63742221,96925,63839146,1,0,0,1536,18,5242709237
2250,63758100,2470,63760570,4,0,1,2560,10,380061011
2251,63803350,188520,63991870,9,0,0,28160,9,2799241889
2252,63890920,5196,63896116,6,0,1,13312,0,674763104
2253,63902150,141031,64043181,9,0,0,54272,9,5203795228
2254,64015371,47288,64062659,1,0,0,1536,18,3705072883
2255,64026100,17096,64043196,4,0,1,12288,10,10164298260
2256,64072310,1518,64073828,4,0,1,1536,10,9527324401
2257,64135760,128705,64264465,9,0,0,105472,9,745440348
2258,64139249,141755,64281004,3,0,0,25600,28,5906058368
2259,64205329,6229,64211558,0,0,1,15360,20,8918650350
2260,64225790,38690,64264480,6,0,1,18432,0,9369379256
2261,64231219,33276,64264495,0,0,1,1536,20,5221033730
2262,64270520,10499,64281019,6,0,1,4608,0,1260109603
2263,64394309,15062,64409371,3,0,1,29184,28,2270649575
2264,64426129,151666,64577795,3,0,0,110080,28,10276688246
2265,64431890,3422,64435312,6,0,1,3584,0,9853045826
2266,64458390,173672,64632062,9,0,0,13824,9,8805906166
2267,64474480,5326,64479806,6,0,1,5632,0,1024331661
2268,64481489,24154,64505643,0,0,1,43520,20,6969840865
2269,64503849,299239,64803088,3,0,0,74240,28,2938220241
2270,64539599,199851,64739450,3,0,0,38912,28,10032322645
2271,64581059,3898,64584957,0,0,1,4096,20,6659410380
2272,64657939,12566,64670505,0,0,1,20992,20,2231235430
2273,64752260,12737,64764997,6,0,1,24576,0,2433142723
2274,64762971,189132,64952103,1,0,0,2560,18,9569146997
2275,64764171,45752,64809923,1,0,0,1536,18,1101754271
2276,64800500,5708,64806208,6,0,1,9216,0,9894820935
2277,64839610,21658,64861268,2,0,1,35328,29,5028769634
2278,64893489,4850,64898339,0,0,1,5120,20,6971836329
2279,64989589,13253,65002842,0,0,1,25600,20,3197291619
2280,64990280,13228,65003508,1,0,1,1024,18,8972589503
2281,64992199,12282,65004481,0,0,1,12800,20,9044917629
2282,65016599,173348,65189947,3,0,0,19968,28,9031211659
2283,65051849,1994,65053843,0,0,1,2048,20,989096601
2284,65055211,52997,65108208,1,0,0,1024,18,2466074567
2285,65059470,201803,65261273,3,0,0,111104,28,5849530276
2286,65318059,54056,65372115,3,0,0,3584,28,10358476941
2287,65357959,5712,65363671,0,0,1,14336,20,10675879212
2288,65430730,114296,65545026,9,0,0,75264,9,5918188392
2289,65559649,5326,65564975,0,0,1,5632,20,7909307683
2290,65599979,3422,65603401,0,0,1,3584,20,446380369
2291,65614180,108212,65722392,9,0,0,55296,9,7147592099
2292,65694109,3645,65697754,0,0,1,10240,20,7373906058
2293,65740619,16613,65757232,0,0,1,32256,20,5762754696
2294,65838039,196505,66034544,3,0,0,141824,28,32359957
2295,65892529,6488,65899017,0,0,1,15872,20,4350837284
2296,65913990,271566,66185556,9,0,0,192000,9,10464513764
2297,66106879,190904,66297783,3,0,0,165376,28,10386706689
2298,66191760,151335,66343095,9,0,0,19456,9,4081465015
2299,66205721,92241,66297962,1,0,0,512,18,4622703902
2300,66257800,194302,66452102,9,0,0,90112,9,781548490
2301,66271839,117707,66389546,3,0,0,15872,28,7517794400
2302,66319440,2870,66322310,5,0,1,8704,12,3107626755
2303,66394730,14287,66409017,5,0,1,27648,12,9773435877
2304,66412079,111488,66523567,3,0,0,66048,28,3715598394
2305,66460530,13253,66473783,5,0,1,25600,12,7449850261
2306,66465471,15474,66480945,9,0,1,20992,9,433297049
2307,66468619,14272,66482891,0,0,1,3072,20,1103226709
2308,66522380,6633,66529013,5,0,1,13824,12,10674076553
2309,66565860,12825,66578685,5,0,1,21504,12,3974807992
2310,66621289,98681,66719970,3,0,0,25088,28,2975285933
2311,66658920,12995,66671915,5,0,1,25088,12,4381058164
2312,66672310,11016,66683326,5,0,1,17920,12,7262251063
2313,66692080,566,66692646,5,0,1,512,12,740917945
2314,66708221,43904,66752125,1,0,0,512,18,5127510862
2315,66717209,153621,66870830,3,0,0,81408,28,873352175
2316,66729150,4679,66733829,6,0,1,12288,0,5588914482
2317,66737490,3645,66741135,5,0,1,10240,12,7174711837
2318,66740221,68837,66809058,1,0,0,3072,18,4159776171
2319,66786240,10241,66796481,5,0,1,16384,12,10165283179
2320,66856830,18842,66875672,5,0,1,5120,12,9525507460
2321,66997830,3904,67001734,5,0,1,10752,12,9478699481
2322,67007590,5326,67012916,5,0,1,5632,12,2409144683
2323,67012931,145256,67158187,1,0,0,512,18,696875474
2324,67072739,76544,67149283,3,0,0,16896,28,2921631020
2325,67116320,7230,67123550,5,0,1,7680,12,6847322103
2326,67117310,107583,67224893,9,0,0,48640,9,6910940727
2327,67120140,5356,67125496,5,0,1,3072,12,6160668273
2328,67144699,148786,67293485,3,0,0,84480,28,6490104985
2329,67160790,3904,67164694,5,0,1,10752,12,1843236651
2330,67255931,45596,67301527,1,0,0,1024,18,10455883348
2331,67265130,214646,67479776,9,0,0,176640,9,7670132052
2332,67339000,6754,67345754,5,0,1,7168,12,3263838396
2333,67400259,80936,67481195,3,0,0,4608,28,5711224921
2334,67484799,82026,67566825,3,0,0,4096,28,8110878810
2335,67497891,43904,67541795,1,0,0,512,18,5614165299
2336,67498789,124324,67623113,3,0,0,39424,28,1000477441
2337,67607290,74360,67681650,3,0,0,9728,28,8630513344
2338,67625010,136615,67761625,3,0,0,105472,28,8333413362
2339,67630370,3645,67634015,2,0,1,10240,29,9106017592
2340,67682720,176970,67859690,9,0,0,19456,9,3863304022
2341,67705229,126609,67831838,3,0,0,74240,28,1437852731
2342,67798390,117572,67915962,3,0,0,86016,28,2228439446
2343,67798740,215964,68014704,9,0,0,106496,9,6574806292
2344,67804899,115914,67920813,3,0,0,15872,28,7749996941
2345,67837381,177962,68015343,1,0,0,2048,18,4894321507
2346,67959130,6488,67965618,5,0,1,15872,12,6342551163
2347,67964890,101660,68066550,9,0,0,33792,9,128502050
2348,67990380,28853,68019233,5,0,1,4096,12,2567036080
2349,68027890,98540,68126430,3,0,0,23552,28,4843642329
2350,68033330,158422,68191752,3,0,0,25088,28,7766889673
2351,68216029,3128,68219157,3,0,1,9216,28,1152732204
2352,68247871,43904,68291775,1,0,0,512,18,10731868878
2353,68252769,5326,68258095,3,0,1,5632,28,651669398
2354,68253990,135865,68389855,3,0,0,92672,28,5228761698
2355,68278449,2470,68280919,3,0,1,2560,28,6221608233
2356,68312820,111120,68423940,9,0,0,28160,9,4098305711
2357,68336050,124646,68460696,9,0,0,37888,9,5944393610
2358,68476739,1042,68477781,3,0,1,1024,28,2286611062
2359,68504469,6754,68511223,3,0,1,7168,28,1907726675
2360,68553559,7706,68561265,3,0,1,8192,28,1732034677
2361,68564710,2946,68567656,8,0,1,3072,3,6576321989
2362,68654080,109460,68763540,3,0,0,59392,28,3663396637
2363,68672671,1518,68674189,9,0,1,1536,9,5067061263
2364,68746290,28516,68774806,8,0,1,18432,3,3187189010
2365,68813310,99008,68912318,3,0,0,25088,28,8675258993
2366,68819491,47288,68866779,1,0,0,1536,18,1229586763
2367,68865511,5196,68870707,9,0,1,13312,9,3387347420
2368,68869999,11791,68881790,3,0,1,19456,28,4576573125
2369,68877581,48980,68926561,1,0,0,2048,18,692548700
2370,68896661,3645,68900306,9,0,1,10240,9,2716510571
2371,68916700,11533,68928233,8,0,1,18944,3,4239466640
2372,68918710,215420,69134130,3,0,0,25600,28,4270996164
2373,68926361,2218,68928579,9,0,1,512,9,7212135659
2374,68940171,58518,68998689,1,0,0,1536,18,1914993499
2375,68955791,11791,68967582,9,0,1,19456,9,729111342
2376,68975001,3898,68978899,9,0,1,4096,9,7827980778
2377,69013710,50672,69064382,9,0,0,2560,9,7152088895
2378,69024709,5326,69030035,3,0,1,5632,28,1731559245
2379,69052099,3128,69055227,3,0,1,9216,28,6960480501
2380,69064469,1042,69065511,3,0,1,1024,28,9285362231
2381,69094790,133758,69228548,3,0,0,62464,28,7362109485
2382,69126410,11099,69137509,8,0,1,9728,3,9921961148
2383,69157050,14545,69171595,8,0,1,28160,3,9778661502
2384,69208920,139811,69348731,9,0,0,35328,9,6560294537
2385,69352020,129272,69481292,9,0,0,124416,9,5139137217
2386,69397451,93165,69490616,1,0,0,1536,18,10194748744
2387,69475060,102604,69577664,3,0,0,21504,28,6324315710
2388,69552449,4937,69557386,3,0,1,12800,28,1048873384
2389,69558460,158866,69717326,9,0,0,25088,9,1757899226
2390,69584710,5454,69590164,8,0,1,13824,3,3013728868
2391,69709430,110084,69819514,3,0,0,61440,28,1768071007
2392,69714879,3481,69718360,3,0,1,1024,28,5010714654
2393,69718899,1042,69719941,3,0,1,1024,28,6085967541
2394,69790220,6278,69796498,8,0,1,6656,3,4072095668
2395,69802200,247773,70049973,7,0,0,250368,2,4007723200
2396,69805009,38693,69843702,3,0,1,43520,28,1854769078
2397,69815020,29758,69844778,8,0,1,13312,3,5457752000
2398,69869091,181685,70050776,1,0,0,2560,18,9421468141
2399,69912940,11533,69924473,8,0,1,18944,3,4882088518
2400,69940800,11533,69952333,8,0,1,18944,3,8899611267
2401,69975589,78568,70054157,3,0,1,3584,28,4168112784
2402,70054659,16613,70071272,3,0,1,32256,28,9547404360
2403,70181840,123500,70305340,9,0,0,105472,9,10078850654
2404,70279109,29627,70308736,3,0,1,9728,28,8137360347
2405,70287871,75238,70363109,1,0,0,5632,18,7419448116
2406,70355879,237667,70593546,3,0,0,249344,28,6801346707
2407,70356009,566,70356575,3,0,1,512,28,1069897179
2408,70358151,235722,70593873,1,0,0,1024,18,6986137124
2409,70362499,6404,70368903,3,0,1,6144,28,3864635293
2410,70371739,6278,70378017,3,0,1,6656,28,6225017240
2411,70379790,4850,70384640,2,0,1,5120,29,262021321
2412,70483019,4374,70487393,3,0,1,4608,28,6073137117
2413,70533690,208757,70742447,9,0,0,61952,9,4371462283
2414,70563750,291533,70855283,3,0,0,132608,28,5706834979
2415,70599769,1518,70601287,3,0,1,1536,28,1804971553
2416,70609419,146459,70755878,5,0,0,44032,12,5350060526
2417,70619060,5802,70624862,2,0,1,6144,29,5297232828
2418,70632570,566,70633136,2,0,1,512,29,3307421288
2419,70633600,4374,70637974,2,0,1,4608,29,487433910
2420,70683239,10241,70693480,0,0,1,16384,20,5690165741
2421,70750690,5763,70756453,2,0,1,512,29,336402443
2422,70754500,7255,70761755,4,0,1,14336,10,9841513743
2423,70818429,41783,70860212,0,0,1,12800,20,1745657671
2424,70873751,43904,70917655,1,0,0,512,18,7348414349
2425,70925840,3645,70929485,5,0,1,10240,12,1670863781
2426,71021310,59444,71080754,3,0,0,6144,28,165002686
2427,71069060,1518,71070578,2,0,1,1536,29,5041153411
2428,71132809,97760,71230569,3,0,0,20992,28,1450405501
2429,71159379,4162,71163541,0,0,1,11264,20,7859205539
2430,71180500,5196,71185696,2,0,1,13312,29,5003331836
2431,71204560,3904,71208464,5,0,1,10752,12,6392978691
2432,71232430,4850,71237280,5,0,1,5120,12,4147848372
2433,71266110,1042,71267152,5,0,1,1024,12,597010473
2434,71297650,192460,71490110,9,0,0,69120,9,3050471383
2435,71315930,14804,71330734,2,0,1,28672,29,6057936928
2436,71316900,15460,71332360,5,0,1,2560,12,589996869
2437,71330981,57385,71388366,1,0,0,1536,18,9471662174
2438,71340290,2470,71342760,2,0,1,2560,29,4036488221
2439,71375749,141337,71517086,5,0,0,22528,12,6654680438
2440,71381411,109182,71490593,1,0,0,1536,18,6191486743
2441,71454850,11016,71465866,7,0,1,17920,2,9813850293
2442,71460359,6275,71466634,0,0,1,11776,20,9941218127
2443,71484211,76627,71560838,1,0,0,2560,18,10287012540
2444,71521350,141772,71663122,9,0,0,101888,9,10426793695
2445,71521560,2470,71524030,5,0,1,2560,12,3425057383
2446,71550040,79639,71629679,9,0,0,1024,9,9163629002
2447,71624419,292590,71917009,3,0,0,61440,28,3555999346
2448,71629089,114577,71743666,3,0,0,66560,28,4527967028
2449,71645340,25480,71670820,7,0,1,8192,2,1169031116
2450,71688150,132708,71820858,9,0,0,54272,9,5956286606
2451,71701130,71180,71772310,9,0,0,2048,9,2863962453
2452,71702070,4679,71706749,2,0,1,12288,29,2491597169
2453,71705789,241810,71947599,5,0,0,93696,12,9995290971
2454,71840271,108435,71948706,1,0,0,3584,18,5442769712
2455,71844200,7706,71851906,5,0,1,8192,12,6679804865
2456,71848181,170748,72018929,1,0,0,1536,18,7102244826
2457,71893360,4420,71897780,5,0,1,11776,12,10391857200
2458,71897960,92708,71990668,9,0,0,24576,9,2674619875
2459,72075519,76208,72151727,3,0,0,10752,28,6698083849
2460,72095069,62208,72157277,3,0,0,7680,28,1575720758
2461,72123271,50672,72173943,1,0,0,2560,18,6385092964
2462,72162120,1042,72163162,5,0,1,1024,12,2277837170
2463,72174180,4420,72178600,6,0,1,11776,0,6517088115
2464,72180151,47288,72227439,1,0,0,1536,18,8355734849
2465,72180511,64726,72245237,1,0,0,1024,18,2465612984
2466,72203579,123204,72326783,3,0,0,72704,28,7551838287
2467,72204030,129974,72334004,9,0,0,4608,9,5482455902
2468,72209630,4420,72214050,2,0,1,11776,29,7738606266
2469,72209790,242168,72451958,3,0,0,93184,28,8323038132
2470,72216300,163223,72379523,3,0,0,84480,28,6497236360
2471,72222110,7230,72229340,5,0,1,7680,12,1007882449
2472,72223429,314162,72537591,3,0,0,100864,28,10375743292
2473,72265410,2946,72268356,6,0,1,3072,0,7049138292
2474,72310710,20761,72331471,6,0,1,12288,0,8686648431
2475,72322610,9527,72332137,5,0,1,1024,12,633826229
2476,72423211,45596,72468807,1,0,0,1024,18,6353522278
2477,72431400,314229,72745629,9,0,0,124928,9,8785052476
2478,72463010,12995,72476005,5,0,1,25088,12,7155293104
2479,72470319,454154,72924473,5,0,0,327168,12,4685328580
2480,72484840,2946,72487786,6,0,1,3072,0,2068302835
2481,72493830,6278,72500108,5,0,1,6656,12,4589058436
2482,72499580,2470,72502050,2,0,1,2560,29,4354282196
2483,72583249,6278,72589527,3,0,1,6656,28,1121724435
2484,72678551,103133,72781684,1,0,0,1024,18,6309751284
2485,72689740,2946,72692686,8,0,1,3072,3,2206736134
2486,72705899,351396,73057295,5,0,0,230400,12,1899401394
2487,72724691,68218,72792909,1,0,0,1536,18,1242836321
2488,72725749,23067,72748816,3,0,1,9216,28,898959554
2489,72732730,17760,72750490,1,0,1,2048,18,1107622096
2490,72738080,31922,72770002,2,0,1,33792,29,4748259837
2491,72771620,1994,72773614,5,0,1,2048,12,8698248228
2492,72785660,6754,72792414,2,0,1,7168,29,8041448460
2493,72787760,5164,72792924,2,0,1,8704,29,2892567227
2494,72817830,106658,72924488,2,0,1,8192,29,7741462801
2495,72818570,263240,73081810,9,0,0,80384,9,3566081723
2496,72840299,89649,72929948,3,0,1,5632,28,2345251651
2497,72858560,72694,72931254,2,0,1,2048,29,7517100737
2498,72863520,67888,72931408,5,0,1,8704,12,10372022418
2499,72873600,82493,72956093,5,0,1,48128,12,3007830161
2500,72886259,70500,72956759,3,0,1,11264,28,1845905594
2501,72914640,56795,72971435,6,0,1,39424,0,1139758667
2502,72921009,301920,73222929,5,0,0,149504,12,7989145625
2503,72932340,45508,72977848,7,0,1,30720,2,3423948878
2504,72967440,11714,72979154,1,0,1,2048,18,1970573926
2505,72975370,5730,72981100,2,0,1,3072,29,5113892811
2506,73018919,76904,73095823,3,0,1,27136,28,4442357557
2507,73042970,61687,73104657,2,0,1,28160,29,4786619889
2508,73058270,56259,73114529,2,0,1,30720,29,8610127029
2509,73066359,333931,73400290,5,0,0,30720,12,7861378228
2510,73124630,43904,73168534,8,0,0,512,3,3528069036
2511,73226319,281369,73507688,5,0,0,28672,12,5996070201
2512,73229820,1042,73230862,6,0,1,1024,0,25845493
2513,73236880,4162,73241042,5,0,1,11264,12,4677211397
2514,73244840,10499,73255339,1,0,1,16896,18,289943740
2515,73248740,11784,73260524,8,0,1,16384,3,7717254702
2516,73262939,11274,73274213,3,0,1,18432,28,5086578800
2517,73335790,4374,73340164,8,0,1,4608,3,2580906534
2518,73365100,4374,73369474,8,0,1,4608,3,3455135863
2519,73381090,1518,73382608,5,0,1,1536,12,3852863178
2520,73383650,45596,73429246,9,0,0,1024,9,199036951
2521,73410330,6488,73416818,1,0,1,15872,18,1631036651
2522,73417149,201934,73619083,5,0,0,135168,12,4421136270
2523,73431100,109747,73540847,9,0,0,512,9,2667376629
2524,73484470,134784,73619254,9,0,0,512,9,1530154048
2525,73489211,130230,73619441,1,0,0,512,18,5172167004
2526,73491949,2946,73494895,0,0,1,3072,20,7340344929
2527,73586509,37078,73623587,0,0,1,11264,20,1293351287
2528,73588260,36633,73624893,2,0,1,2048,29,9451313621
2529,73614040,223057,73837097,9,0,0,8704,9,4036148947
2530,73638039,115856,73753895,5,0,0,80384,12,9604774137
2531,73645819,13858,73659677,3,0,1,23552,28,3383744210
2532,73664689,5454,73670143,3,0,1,13824,28,593707141
2533,73671799,3387,73675186,3,0,1,9728,28,2579304604
2534,73699571,76752,73776323,1,0,0,512,18,9151165196
2535,73715010,4162,73719172,2,0,1,11264,29,3179217850
2536,73726970,26940,73753910,5,0,1,12288,12,3006031571
2537,73736729,27672,73764401,3,0,1,16896,28,6677048930
2538,73867350,109858,73977208,9,0,0,1536,9,9774523889
2539,73868689,1994,73870683,0,0,1,2048,20,7622600103
2540,73923950,43904,73967854,9,0,0,512,9,6765927682
2541,73924660,1518,73926178,5,0,1,1536,12,5526734338
2542,73939709,2946,73942655,0,0,1,3072,20,10329684975
2543,73977379,3898,73981277,0,0,1,4096,20,7051591952
2544,74017260,11274,74028534,5,0,1,18432,12,1350014877
2545,74021220,7660,74028880,8,0,1,512,3,5445541985
2546,74041720,3387,74045107,8,0,1,9728,3,4270659320
2547,74067700,11791,74079491,5,0,1,19456,12,8269211710
2548,74077270,10241,74087511,1,0,1,16384,18,6960041395
2549,74091750,4374,74096124,1,0,1,4608,18,9300988724
2550,74097030,23637,74120667,8,0,1,42496,3,7456653772
2551,74101900,23952,74125852,1,0,1,16384,18,9645240042
2552,74103780,23557,74127337,1,0,1,15360,18,1570496338
2553,74109580,18423,74128003,2,0,1,1024,29,2041071995
2554,74117990,140813,74258803,9,0,0,2560,9,9702220813
2555,74129780,10757,74140537,8,0,1,17408,3,9725540642
2556,74182670,1042,74183712,2,0,1,1024,29,9906911322
2557,74290980,3387,74294367,5,0,1,9728,12,1542948024
2558,74324340,4850,74329190,7,0,1,5120,2,8692715050
2559,74350080,10499,74360579,5,0,1,16896,12,8213805733
2560,74352470,98203,74450673,9,0,0,2048,9,8110709684
2561,74363019,3387,74366406,3,0,1,9728,28,7371542397
2562,74397880,5454,74403334,1,0,1,13824,18,2246501031
2563,74442181,43904,74486085,1,0,0,512,18,3134017633
2564,74446160,2946,74449106,5,0,1,3072,12,6241390933
2565,74446470,23366,74469836,1,0,1,37376,18,5018837198
2566,74453119,22823,74475942,0,0,1,20992,20,835147961
2567,74467569,22433,74490002,0,0,1,36864,20,1767247814
2568,74478680,11886,74490566,1,0,1,10752,18,7238415077
2569,74492340,6229,74498569,1,0,1,15360,18,7328812593
2570,74508030,566,74508596,5,0,1,512,12,10017276469
2571,74522110,74632,74596742,9,0,0,4096,9,2397780300
2572,74571179,150459,74721638,5,0,0,107008,12,9391905127
2573,74595329,183634,74778963,5,0,0,36864,12,4070629421
2574,74607920,1042,74608962,2,0,1,1024,29,727096760
2575,74611690,3898,74615588,1,0,1,4096,18,5919908621
2576,74616499,1994,74618493,0,0,1,2048,20,9573549251
2577,74654160,5326,74659486,2,0,1,5632,29,7903689335
2578,74661280,4937,74666217,8,0,1,12800,3,5897925436
2579,74721650,45596,74767246,9,0,0,1024,9,2859575139
2580,74736310,15579,74751889,1,0,1,30208,18,1637254601
2581,74749720,3387,74753107,8,0,1,9728,3,4833240097
2582,74787991,43904,74831895,1,0,0,512,18,1335153666
2583,74799049,1518,74800567,0,0,1,1536,20,6486912245
2584,74821701,43904,74865605,1,0,0,512,18,1029614889
2585,74836000,3422,74839422,1,0,1,3584,18,6743186323
2586,74952220,6278,74958498,1,0,1,6656,18,8515660306
2587,74963070,4937,74968007,5,0,1,12800,12,690921291
2588,74976750,6754,74983504,2,0,1,7168,29,2915714144
2589,74992980,15579,75008559,1,0,1,30208,18,1416859970
2590,75015120,6754,75021874,2,0,1,7168,29,6922007792
2591,75026621,148975,75175596,1,0,0,2048,18,3495143541
2592,75076091,52292,75128383,1,0,0,1024,18,1227768596
2593,75081800,7706,75089506,1,0,1,8192,18,2252419579
2594,75082240,10492,75092732,5,0,1,5120,12,2854634995
2595,75106509,2470,75108979,0,0,1,2560,20,2412227078
2596,75111670,4850,75116520,2,0,1,5120,29,2837820539
2597,75123779,4619,75128398,0,0,1,11776,20,821827196
2598,75168149,106340,75274489,5,0,0,49152,12,1726405747
2599,75199311,76285,75275596,1,0,0,3584,18,4394952651
2600,75211490,7230,75218720,1,0,1,7680,18,8090063255
2601,75233930,5802,75239732,5,0,1,6144,12,5566387234
2602,75236120,13083,75249203,1,0,1,22016,18,9499586727
2603,75248220,2289,75250509,5,0,1,2048,12,6025867108
2604,75249080,181066,75430146,9,0,0,1536,9,3659158987
2605,75258130,566,75258696,5,0,1,512,12,1074592484
2606,75275759,61120,75336879,5,0,0,5632,12,5568865504
2607,75306789,5326,75312115,0,0,1,5632,20,5739456468
2608,75325179,4420,75329599,0,0,1,11776,20,5367093875
2609,75356960,4374,75361334,5,0,1,4608,12,3566953767
2610,75367870,13858,75381728,5,0,1,23552,12,4660904434
2611,75399000,5326,75404326,5,0,1,5632,12,9800610695
2612,75431940,135822,75567762,9,0,0,512,9,7849103095
2613,75463679,1042,75464721,0,0,1,1024,20,6836946258
2614,75481200,5712,75486912,2,0,1,14336,29,2387735772
2615,75552739,11791,75564530,0,0,1,19456,20,6572821819
2616,75639100,3898,75642998,5,0,1,4096,12,6793173290
2617,75776979,166101,75943080,5,0,0,139264,12,8148473753
2618,75787920,1518,75789438,2,0,1,1536,29,8363961854
2619,75795460,222341,76017801,5,0,0,108544,12,1895942485
2620,75846080,3898,75849978,2,0,1,4096,29,9601704284
2621,76006301,60472,76066773,1,0,0,2048,18,6400456245
2622,76187240,11016,76198256,2,0,1,17920,29,1519594408
2623,76191049,433451,76624500,5,0,0,249856,12,9320464766
2624,76251351,210703,76462054,1,0,0,4608,18,10654122490
2625,76276490,271851,76548341,9,0,0,4608,9,8798065434
2626,76277110,1994,76279104,2,0,1,2048,29,4859906726
2627,76277489,183146,76460635,5,0,0,128512,12,6205775995
2628,76303060,1994,76305054,2,0,1,2048,29,7578350703
2629,76311609,235313,76546922,5,0,0,101888,12,8900685036
2630,76315660,1518,76317178,8,0,1,1536,3,117991553
2631,76324750,25962,76350712,5,0,1,47104,12,8935882574
2632,76388760,237011,76625771,9,0,0,4096,9,2047187290
2633,76391050,3898,76394948,5,0,1,4096,12,7192465824
2634,76415740,3387,76419127,2,0,1,9728,29,2109994913
2635,76417969,222949,76640918,5,0,0,49664,12,10471551665
2636,76516870,175550,76692420,9,0,0,512,9,8176053980
2637,76544870,96063,76640933,5,0,1,7168,12,3444050413
2638,76653161,234788,76887949,1,0,0,1024,18,10193932979
2639,76658820,45596,76704416,9,0,0,1024,9,4200593782
2640,76676840,7230,76684070,5,0,1,7680,12,4898754092
2641,76691370,4374,76695744,2,0,1,4608,29,534401162
2642,76707950,59042,76766992,9,0,0,3072,9,10685918189
2643,76713469,102975,76816444,5,0,0,34304,12,5968680992
2644,76714859,43904,76758763,5,0,0,512,12,8327345923
2645,76732209,84874,76817083,5,0,0,2048,12,9915714339
2646,76733550,47288,76780838,9,0,0,1536,9,7984161482
2647,76738240,2470,76740710,2,0,1,2560,29,1760948115
2648,76739980,1716,76741696,5,0,1,1536,12,8648245691
2649,76835149,48980,76884129,5,0,0,2048,12,9630023608
2650,76835630,140501,76976131,9,0,0,62464,9,7005204575
2651,76930080,104905,77034985,9,0,0,27648,9,8979555988
2652,76958410,28746,76987156,5,0,1,17920,12,8672909357
2653,76968220,147497,77115717,9,0,0,63488,9,5740216089
2654,76987239,227525,77214764,5,0,0,8192,12,4054625884
2655,76999969,4850,77004819,3,0,1,5120,28,2374315924
2656,77019769,101484,77121253,5,0,0,1024,12,778074038
2657,77022080,283575,77305655,9,0,0,188416,9,4453461595
2658,77026219,8781,77035000,3,0,1,3584,28,6456568861
2659,77037410,1042,77038452,5,0,1,1024,12,6428045224
2660,77119160,24412,77143572,2,0,1,44032,29,4121097492
2661,77130600,18873,77149473,2,0,1,28160,29,2652574539
2662,77151350,12995,77164345,5,0,1,25088,12,2083261900
2663,77249020,63182,77312202,5,0,1,15872,12,9630044894
2664,77268790,52259,77321049,2,0,1,16896,29,5954658867
2665,77280821,236894,77517715,1,0,0,2560,18,10673377237
2666,77293310,32565,77325875,5,0,1,7680,12,8477388481
2667,77319190,84574,77403764,9,0,0,8192,9,6787907631
2668,77330269,1042,77331311,3,0,1,1024,28,4419915201
2669,77343730,11274,77355004,5,0,1,18432,12,9193313371
2670,77352950,2870,77355820,5,0,1,8704,12,322883885
2671,77358879,64391,77423270,5,0,0,512,12,1941208382
2672,77359720,5454,77365174,5,0,1,13824,12,2676819504
2673,77408639,6229,77414868,0,0,1,15360,20,572293498
2674,77416120,1042,77417162,2,0,1,1024,29,669051102
2675,77432330,13013,77445343,2,0,1,25088,29,8863259489
2676,77432339,77384,77509723,5,0,0,1536,12,372702686
2677,77474360,5802,77480162,2,0,1,6144,29,7432767158
2678,77480010,7706,77487716,8,0,1,8192,3,9057338428
2679,77507989,69578,77577567,5,0,0,3072,12,1819168388
2680,77512559,155533,77668092,5,0,0,4096,12,6690513134
2681,77521410,4679,77526089,5,0,1,12288,12,1768716061
2682,77524679,142076,77666755,6,0,0,9728,0,894721097
2683,77564290,3128,77567418,5,0,1,9216,12,3503537157
2684,77588779,82751,77671530,5,0,0,1024,12,32782275
2685,77593649,50672,77644321,5,0,0,2560,12,8669382901
2686,77599050,2946,77601996,8,0,1,3072,3,8843845808
2687,77599349,6398,77605747,3,0,1,14336,28,735571647
2688,77622299,5326,77627625,3,0,1,5632,28,1537935251
2689,77642209,31783,77673992,0,0,1,51712,20,9100673346
2690,77711310,10757,77722067,5,0,1,17408,12,8797306732
2691,77725901,49041,77774942,1,0,0,512,18,6971167265
2692,77803700,11274,77814974,5,0,1,18432,12,9315585857
2693,77817310,2870,77820180,7,0,1,8704,2,9651640138
2694,77825201,81704,77906905,1,0,0,4096,18,5110655052
2695,77843821,47288,77891109,1,0,0,1536,18,8068618732
2696,77906509,6666,77913175,0,0,1,6656,20,5489177519
2697,77913560,1042,77914602,2,0,1,1024,29,7009086909
2698,77930900,84992,78015892,7,0,1,138752,2,3800932041
2699,78011440,363171,78374611,9,0,0,31744,9,5090128952
2700,78112500,15579,78128079,7,0,1,30208,2,6259288556
2701,78143530,152719,78296249,9,0,0,70144,9,5224072206
2702,78143850,21141,78164991,2,0,1,34304,29,7917908504
2703,78147690,22588,78170278,7,0,1,16896,2,8762633128
2704,78199230,13600,78212830,7,0,1,23040,2,1492756036
2705,78206040,7866,78213906,2,0,1,13312,29,5468232003
2706,78258279,65522,78323801,5,0,0,2048,12,475183155
2707,78261431,57294,78318725,1,0,0,512,18,3717956844
2708,78525100,3128,78528228,1,0,1,9216,18,5392630713
2709,78588160,2470,78590630,2,0,1,2560,29,3443112641
2710,78630581,55748,78686329,1,0,0,4096,18,664854305
2711,78682340,105929,78788269,7,0,1,176128,2,6257345728
2712,78689209,171438,78860647,5,0,0,1024,12,1406040403
2713,78729630,159115,78888745,9,0,0,38912,9,2680215129
2714,78800560,15579,78816139,2,0,1,30208,29,5835665358
2715,78801060,87700,78888760,7,0,1,128000,2,2249990360
2716,78816530,91371,78907901,7,0,1,80896,2,6760130161
2717,78850050,58107,78908157,7,0,1,9216,2,6480670529
2718,78873670,51166,78924836,7,0,1,55296,2,6154543413
2719,79023160,319685,79342845,9,0,0,147968,9,4275357961
2720,79129490,6754,79136244,8,0,1,7168,3,5375157719
2721,79158969,53251,79212220,5,0,0,1024,12,191832873
2722,79169620,54617,79224237,7,0,1,89600,2,3575030928
2723,79193580,31323,79224903,6,0,1,1024,0,5127571048
2724,79199770,31342,79231112,2,0,1,29696,29,6462966297
2725,79216460,18198,79234658,8,0,1,5632,3,1328686206
2726,79238670,2870,79241540,6,0,1,8704,0,447541903
2727,79252360,6278,79258638,8,0,1,6656,3,5584027296
2728,79286701,2470,79289171,9,0,1,2560,9,10372056640
2729,79298090,79093,79377183,2,0,1,59904,29,9092327684
2730,79313781,249042,79562823,1,0,0,512,18,8517191938
2731,79329111,97993,79427104,1,0,0,1536,18,3937567600
2732,79332129,51058,79383187,0,0,1,20480,20,626839829
2733,79450011,106568,79556579,1,0,0,46080,18,1618394119
2734,79508290,50741,79559031,6,0,1,81920,0,1816332084
2735,79540230,148545,79688775,9,0,0,43008,9,7904398725
2736,79635369,55092,79690461,5,0,0,2048,12,4995939967
2737,79682799,79414,79762213,5,0,0,5120,12,574231447
2738,79868430,108680,79977110,9,0,0,56832,9,6874530996
2739,79906981,303691,80210672,1,0,0,297984,18,10291604112
2740,79961011,257350,80218361,1,0,0,23552,18,815240159
2741,80045539,165304,80210843,5,0,0,512,12,6173941320
2742,80063121,170543,80233664,1,0,0,50176,18,4926942840
2743,80109349,101821,80211170,5,0,0,1024,12,9727930808
2744,80278390,7706,80286096,6,0,1,8192,0,7299974468
2745,80343460,118352,80461812,9,0,0,88576,9,6590588525
2746,80480599,10757,80491356,3,0,1,17408,28,4349245480
2747,80556529,3904,80560433,0,0,1,10752,20,6387677300
2748,80569831,70535,80640366,1,0,0,8704,18,10130241521
2749,80710481,72692,80783173,1,0,0,14336,18,2950934350
2750,80720249,43904,80764153,5,0,0,512,12,9659547934
2751,80753009,1994,80755003,3,0,1,2048,28,1189825593
2752,80866879,4374,80871253,3,0,1,4608,28,449590138
2753,80906670,4850,80911520,6,0,1,5120,0,7282921207
2754,80961741,102128,81063869,1,0,0,35328,18,6720143562
2755,80981010,7706,80988716,5,0,1,8192,12,4779923114
2756,80983240,6142,80989382,6,0,1,11264,0,3927513614
2757,80995309,116848,81112157,5,0,0,4096,12,956261821
2758,81000710,89649,81090359,9,0,0,14336,9,5569136792
2759,81078220,214038,81292258,2,0,0,135680,29,3391889719
2760,81173139,6278,81179417,3,0,1,6656,28,815271397
2761,81238190,117572,81355762,2,0,0,86016,29,3602622636
2762,81268040,445638,81713678,9,0,0,360960,9,7030724549
2763,81324089,31688,81355777,3,0,1,7680,28,2590013030
2764,81356789,3387,81360176,3,0,1,9728,28,7041320298
2765,81401089,143463,81544552,5,0,0,1536,12,8571909932
2766,81458850,22174,81481024,6,0,1,36352,0,7637596624
2767,81471350,10750,81482100,6,0,1,13312,0,5679672171
2768,81476561,127122,81603683,1,0,0,47104,18,4992366972
2769,81626779,135871,81762650,5,0,0,2048,12,5560202464
2770,81718909,3645,81722554,3,0,1,10240,28,6641681974
2771,81798410,110396,81908806,9,0,0,62464,9,9276962089
2772,81877290,2946,81880236,6,0,1,3072,0,3136121212
2773,81879590,220076,82099666,9,0,0,261120,9,6642693377
2774,81970321,309033,82279354,1,0,0,273920,18,149254920
2775,82044659,235662,82280321,5,0,0,3072,12,9205178071
2776,82076020,211360,82287380,9,0,0,23040,9,7737527502
2777,82093880,367645,82461525,9,0,0,271872,9,10655884976
2778,82160380,1042,82161422,5,0,1,1024,12,9236600412
2779,82197240,101915,82299155,6,0,1,19456,0,10169742375
2780,82202041,273890,82475931,1,0,0,46080,18,9651190971
2781,82227940,74441,82302381,6,0,1,5120,0,7257149527
2782,82234630,68417,82303047,6,0,1,1024,0,2798726093
2783,82247430,319395,82566825,9,0,0,45568,9,456642358
2784,82269349,36604,82305953,3,0,1,4608,28,4669924250
2785,82309639,152221,82461860,5,0,0,1024,12,3499504725
2786,82386111,161346,82547457,1,0,0,22528,18,108863464
2787,82415459,122374,82537833,5,0,0,1024,12,4314345244
2788,82450211,156226,82606437,1,0,0,54784,18,10716804775
2789,82534731,295704,82830435,1,0,0,171008,18,3114566154
2790,82554871,122810,82677681,1,0,0,64000,18,1601512971
2791,82643080,1994,82645074,5,0,1,2048,12,650591286
2792,82647710,29986,82677696,5,0,1,20992,12,5666785402
2793,82666480,212045,82878525,9,0,0,100864,9,3601204880
2794,82753300,2946,82756246,4,0,1,3072,10,8218734123
2795,82801539,35659,82837198,3,0,1,7168,28,6445892598
2796,82824079,13580,82837659,3,0,1,10240,28,6243402209
2797,82836180,1825,82838005,4,0,1,512,10,7968499026
2798,82880139,2470,82882609,0,0,1,2560,20,6760020033
2799,82882919,3898,82886817,0,0,1,4096,20,607276467
2800,82933149,5802,82938951,0,0,1,6144,20,5890616479
2801,82996150,69284,83065434,9,0,0,8192,9,2553499046
2802,83010190,1518,83011708,4,0,1,1536,10,10697507230
2803,83028109,59132,83087241,5,0,0,5120,12,4348650955
2804,83059089,12566,83071655,3,0,1,20992,28,3384619681
2805,83073330,2946,83076276,4,0,1,3072,10,7759830524
2806,83160219,2946,83163165,3,0,1,3072,28,9900726027
2807,83223310,566,83223876,4,0,1,512,10,5048022686
2808,83311869,13858,83325727,3,0,1,23552,28,8656787094
2809,83320919,211212,83532131,5,0,0,1536,12,1970800309
2810,83337980,11791,83349771,5,0,1,19456,12,5898558753
2811,83363779,2946,83366725,0,0,1,3072,20,10213332969
2812,83401720,3128,83404848,5,0,1,9216,12,1822305370
2813,83447250,4162,83451412,5,0,1,11264,12,514342312
2814,83479240,178503,83657743,9,0,0,99840,9,2993443736
2815,83497519,4937,83502456,3,0,1,12800,28,7768172528
2816,83607950,99377,83707327,9,0,0,13312,9,8624776639
2817,83614920,149515,83764435,9,0,0,39424,9,9952815019
2818,83634529,29194,83663723,3,0,1,14848,28,1586288752
2819,83635729,63410,83699139,3,0,1,65024,28,611472653
2820,83716379,12308,83728687,3,0,1,20480,28,9679671693
2821,83726819,5971,83732790,0,0,1,14848,20,1655278991
2822,83965331,72668,84037999,1,0,0,9216,18,5224339972
2823,83977560,176564,84154124,9,0,0,153600,9,8424421187
2824,84029890,8124,84038014,2,0,1,7680,29,4755010638
2825,84044439,2470,84046909,3,0,1,2560,28,6107225938
2826,84066721,89914,84156635,1,0,0,8192,18,937300512
2827,84145409,17020,84162429,0,0,1,6144,20,9668727849
2828,84221579,3904,84225483,3,0,1,10752,28,5016605480
2829,84236009,11274,84247283,3,0,1,18432,28,7881711278
2830,84265480,4850,84270330,2,0,1,5120,29,1989408890
2831,84266890,21598,84288488,2,0,1,34816,29,7021913445
2832,84305309,6488,84311797,3,0,1,15872,28,6294581947
2833,84321189,59947,84381136,5,0,0,512,12,1808488510
2834,84374490,80060,84454550,9,0,0,13312,9,10728217207
2835,84374940,22174,84397114,2,0,1,36352,29,2526133499
2836,84402979,12049,84415028,0,0,1,19968,20,5037921069
2837,84412290,135441,84547731,9,0,0,8192,9,1521596590
2838,84446159,13600,84459759,3,0,1,23040,28,9584004102
2839,84449699,15245,84464944,0,0,1,16384,20,6400229930
2840,84455010,10280,84465290,2,0,1,512,29,5183917328
2841,84464389,3645,84468034,3,0,1,10240,28,4244758842
2842,84478170,3898,84482068,5,0,1,4096,12,1250229458
2843,84505349,3898,84509247,0,0,1,4096,20,7818577056
2844,84526460,186757,84713217,9,0,0,80896,9,5192269879
2845,84529621,267945,84797566,1,0,0,236032,18,8904278896
2846,84564621,616426,85181047,1,0,0,34304,18,4543948538
2847,84643191,325641,84968832,1,0,0,142848,18,3543259546
2848,84660940,509640,85170580,9,0,0,262144,9,325638122
2849,84677890,3904,84681794,2,0,1,10752,29,2437925283
2850,84682549,3904,84686453,3,0,1,10752,28,7114666215
2851,84716081,209212,84925293,1,0,0,36352,18,5226269867
2852,84717779,7706,84725485,3,0,1,8192,28,358819709
2853,84722950,509280,85232230,9,0,0,167936,9,3484111645
2854,84734849,74309,84809158,0,0,1,18944,20,2231187631
2855,84756900,53244,84810144,2,0,1,1536,29,10446400126
2856,84772759,140990,84913749,5,0,0,3584,12,1961895285
2857,84783579,32057,84815636,0,0,1,17920,20,5874387009
2858,84811469,10241,84821710,3,0,1,16384,28,5549147538
2859,84835891,426462,85262353,1,0,0,98816,18,9201491818
2860,84870309,3128,84873437,3,0,1,9216,28,4015714055
2861,84884199,6278,84890477,3,0,1,6656,28,8569185875
2862,84942041,320811,85262852,1,0,0,1536,18,8026135308
2863,84961770,308741,85270511,9,0,0,25088,9,6231519502
2864,84969260,4850,84974110,2,0,1,5120,29,4471721698
2865,85009510,4850,85014360,5,0,1,5120,12,10093908442
2866,85013019,2007,85015026,3,0,1,1024,28,7056435498
2867,85130839,175410,85306249,5,0,0,512,12,3585667522
2868,85152579,157079,85309658,5,0,0,1536,12,3205138527
2869,85265430,25439,85290869,1,0,1,32768,18,9261399698
2870,85340869,4162,85345031,3,0,1,11264,28,2226185550
2871,85362870,15579,85378449,2,0,1,30208,29,5873649100
2872,85400249,5326,85405575,3,0,1,5632,28,9055415254
2873,85435189,6488,85441677,3,0,1,15872,28,4014373422
2874,85439000,4719,85443719,2,0,1,10240,29,4516759071
2875,85460209,62516,85522725,5,0,0,6144,12,3763420672
2876,85514859,4374,85519233,3,0,1,4608,28,1366379032
2877,85521949,155311,85677260,5,0,0,7680,12,6976362189
2878,85573600,3422,85577022,2,0,1,3584,29,9788999024
2879,85590810,3422,85594232,1,0,1,3584,18,4618771519
2880,85593779,1518,85595297,3,0,1,1536,28,3977342230
2881,85608180,3904,85612084,2,0,1,10752,29,10299280508
2882,85643489,108074,85751563,5,0,0,512,12,3975520952
2883,85645989,48980,85694969,5,0,0,2048,12,9143693954
2884,85682420,3422,85685842,1,0,1,3584,18,9550912840
2885,85742759,45596,85788355,5,0,0,1024,12,5602485148
2886,85749639,1042,85750681,3,0,1,1024,28,8573110760
2887,85844150,12566,85856716,1,0,1,20992,18,5707864357
2888,85859880,7230,85867110,2,0,1,7680,29,9175774672
2889,85863850,5454,85869304,2,0,1,13824,29,4231140084
2890,85877799,24929,85902728,3,0,1,45056,28,9723641880
2891,85879499,55294,85934793,3,0,1,70656,28,4906578007
2892,85881239,75769,85957008,3,0,1,75264,28,8045324103
2893,85913020,45614,85958634,2,0,1,2560,29,7104863064
2894,85988750,4937,85993687,1,0,1,12800,18,9556853349
2895,85990761,307674,86298435,1,0,0,184832,18,4906094575
2896,86023911,320091,86344002,1,0,0,149504,18,9670766334
2897,86089310,11274,86100584,2,0,1,18432,29,2278684396
2898,86140870,5802,86146672,2,0,1,6144,29,3819012797
2899,86211410,4374,86215784,2,0,1,4608,29,4003886457
2900,86219631,131718,86351349,1,0,0,24064,18,6073344021
2901,86321361,98508,86419869,1,0,0,10752,18,7336497431
2902,86324991,120981,86445972,1,0,0,7168,18,6361878010
2903,86397941,120911,86518852,1,0,0,28672,18,9218047839
2904,86409829,326612,86736441,3,0,1,532480,28,35012774
2905,86601689,161697,86763386,3,0,1,88064,28,5109650080
2906,86693379,267525,86960904,5,0,0,2048,12,3902285831
2907,86754731,383672,87138403,1,0,0,133632,18,1695583922
2908,86775529,42166,86817695,3,0,1,68608,28,100292996
2909,86783280,278826,87062106,9,0,0,150016,9,2228103889
2910,86938099,202362,87140461,5,0,0,3072,12,6484286899
2911,86953479,300257,87253736,5,0,0,4608,12,9931076563
2912,86957479,13253,86970732,3,0,1,25600,28,7659290322
2913,86975729,164747,87140476,3,0,1,235008,28,1723258248
2914,86981710,157800,87139510,9,0,0,3584,9,9119182973
2915,86991650,259272,87250922,9,0,0,1536,9,10720823702
2916,87037361,388390,87425751,1,0,0,178688,18,10256308097
2917,87259760,3387,87263147,4,0,1,9728,10,9232677723
2918,87321459,35829,87357288,3,0,1,62976,28,10122524876
2919,87325699,100231,87425930,5,0,0,512,12,8357850732
2920,87390649,46514,87437163,3,0,1,18432,28,9584362680
2921,87452080,13341,87465421,4,0,1,22528,10,2952515776
2922,87469341,87989,87557330,1,0,0,512,18,3788308509
2923,87543350,4679,87548029,4,0,1,12288,10,6128388022
2924,87552289,13600,87565889,3,0,1,23040,28,2602188739
2925,87602461,1042,87603503,9,0,1,1024,9,8351558868
2926,87616350,14029,87630379,4,0,1,27136,10,8379867721
2927,87622540,147588,87770128,9,0,0,1024,9,10605936764
2928,87677861,3128,87680989,9,0,1,9216,9,7500328707
2929,87786330,4420,87790750,1,0,1,11776,18,4798847756
2930,87803730,2870,87806600,4,0,1,8704,10,10167851994
2931,87828790,57440,87886230,9,0,0,4608,9,3437161842
2932,87850491,215106,88065597,1,0,0,69120,18,8338329673
2933,87927410,5326,87932736,1,0,1,5632,18,9067321388
2934,87928580,44499,87973079,9,0,0,512,9,4907468265
2935,87987550,85445,88072995,9,0,0,1536,9,2366035090
2936,87996650,3898,88000548,1,0,1,4096,18,7398993546
2937,88009250,3422,88012672,8,0,1,3584,3,8440247373
2938,88034830,1518,88036348,1,0,1,1536,18,6357992926
2939,88074031,566,88074597,9,0,1,512,9,9476962229
2940,88093610,2470,88096080,4,0,1,2560,10,10716659038
2941,88166081,101660,88267741,1,0,0,33792,18,5752288714
2942,88166830,3422,88170252,8,0,1,3584,3,7102146587
2943,88198300,12825,88211125,1,0,1,21504,18,25918587
2944,88205640,8391,88214031,4,0,1,4608,10,5599379732
2945,88322829,47288,88370117,5,0,0,1536,12,5433921527
2946,88363131,4420,88367551,9,0,1,11776,9,6248300913
2947,88369520,48546,88418066,9,0,0,1536,9,5260505850
2948,88382800,4679,88387479,1,0,1,12288,18,522620192
2949,88405750,45596,88451346,9,0,0,1024,9,4457602675
2950,88420530,7230,88427760,1,0,1,7680,18,8568708210
2951,88438550,6278,88444828,1,0,1,6656,18,3764356904
2952,88451941,3128,88455069,9,0,1,9216,9,7787838477
2953,88542480,1518,88543998,1,0,1,1536,18,9616380335
2954,88545831,4420,88550251,9,0,1,11776,9,8226970362
2955,88587620,79371,88666991,9,0,0,512,9,2347522423
2956,88677980,12825,88690805,1,0,1,21504,18,2130512260
2957,88786360,4420,88790780,4,0,1,11776,10,8114862256
2958,88856289,55748,88912037,5,0,0,4096,12,2830819692
2959,88908161,3891,88912052,9,0,1,8704,9,1500195856
2960,88919140,4679,88923819,4,0,1,12288,10,9705729070
2961,88988291,5802,88994093,9,0,1,6144,9,4583539689
2962,89010050,4937,89014987,1,0,1,12800,18,9539168514
2963,89028650,4850,89033500,1,0,1,5120,18,7252273716
2964,89080280,1042,89081322,4,0,1,1024,10,9050041259
2965,89091031,160690,89251721,1,0,0,20992,18,7018693368
2966,89128899,63708,89192607,3,0,1,103936,28,8586220489
2967,89204561,250565,89455126,1,0,0,34304,18,1725897354
2968,89259851,115076,89374927,1,0,0,77824,18,3163554839
2969,89276550,3904,89280454,2,0,1,10752,29,3051135326
2970,89319880,3904,89323784,2,0,1,10752,29,1833696867
2971,89358990,17447,89376437,4,0,1,1536,10,2086627774
2972,89395909,63450,89459359,3,0,1,103424,28,8776974029
2973,89403640,117469,89521109,9,0,0,1536,9,10072416528
2974,89446670,171856,89618526,7,0,1,264704,2,2654639349
2975,89571670,179371,89751041,9,0,0,512,9,1470515208
2976,89639710,3904,89643614,4,0,1,10752,10,9427349533
2977,89652290,51648,89703938,9,0,0,1536,9,2288354341
2978,89675130,3898,89679028,2,0,1,4096,29,1761736944
2979,89678391,112035,89790426,1,0,0,2560,18,10498008092
2980,89687169,52364,89739533,5,0,0,3072,12,8017331836
2981,89777079,43904,89820983,5,0,0,512,12,9344108829
2982,89812110,43904,89856014,9,0,0,512,9,4642007932
2983,89817941,105872,89923813,1,0,0,47616,18,10605851981
2984,89846341,6278,89852619,9,0,1,6656,9,4810991513
2985,89852770,100383,89953153,9,0,0,512,9,1932662123
2986,89883840,79465,89963305,9,0,0,3584,9,7275663858
2987,89917110,10117,89927227,4,0,1,3584,10,4225478301
2988,89956231,56598,90012829,1,0,0,2560,18,9261580967
2989,89984141,135902,90120043,1,0,0,126464,18,6923824634
2990,90023660,36604,90060264,1,0,1,64512,18,6500480366
2991,90043180,18390,90061570,4,0,1,2048,10,6171962402
2992,90079790,64500,90144290,9,0,0,512,9,5865991520
2993,90135710,1518,90137228,1,0,1,1536,18,8533690172
2994,90213180,4937,90218117,4,0,1,12800,10,6137063996
2995,90286040,72541,90358581,7,0,1,117760,2,470875713
2996,90290961,257000,90547961,1,0,0,77312,18,5778424065
2997,90305890,56557,90362447,1,0,1,6144,18,5695358073
2998,90327871,103398,90431269,1,0,0,22528,18,3083005209
2999,90349430,13683,90363113,7,0,1,11264,2,6740891457
3000,90352920,53583,90406503,7,0,1,87552,2,1915964544
3001,90359420,47429,90406849,1,0,1,512,18,7703179210
3002,90416280,4374,90420654,4,0,1,4608,10,3501417040
3003,90419510,266983,90686493,7,0,1,433152,2,7696522347
3004,90439881,284459,90724340,1,0,0,5120,18,5863711263
3005,90448441,310802,90759243,1,0,0,512,18,8670195291
3006,90459521,483547,90943068,1,0,0,2048,18,619112932
3007,90512240,178759,90690999,1,0,1,7168,18,3584926017
3008,90524720,166638,90691358,4,0,1,9728,10,9626329337
3009,90544610,153161,90697771,7,0,1,30720,2,985776571
3010,90622870,80598,90703468,4,0,1,18944,10,6783706807
3011,90668310,37104,90705414,7,0,1,3072,2,9268257198
3012,90735649,192199,90927848,5,0,0,3584,12,10057820890
3013,90750950,2946,90753896,4,0,1,3072,10,3285983576
3014,90778420,14545,90792965,4,0,1,28160,10,10684060748
3015,90818000,47288,90865288,9,0,0,1536,9,2317045505
3016,90853530,3387,90856917,4,0,1,9728,10,4826903086
3017,90878550,3422,90881972,1,0,1,3584,18,5437749995
3018,90939100,111473,91050573,9,0,0,1536,9,5995741635
3019,90943090,1994,90945084,1,0,1,2048,18,9824190576
3020,90943950,87882,91031832,9,0,0,1536,9,4345002363
3021,91013420,76880,91090300,9,0,0,3584,9,9666824015
3022,91052059,45596,91097655,5,0,0,1024,12,9181206519
3023,91161630,60824,91222454,9,0,0,5632,9,6374851168
3024,91222550,13341,91235891,1,0,1,22528,18,787704459
3025,91286980,125404,91412384,7,0,1,207360,2,10557466847
3026,91350670,200196,91550866,2,0,0,69120,29,4966001733
3027,91371090,187723,91558813,2,0,0,5120,29,2024094159
3028,91372980,41990,91414970,1,0,1,4096,18,8021742345
3029,91432529,127851,91560380,5,0,0,1536,12,7056483573
3030,91480869,139619,91620488,5,0,0,3584,12,7647947033
3031,91493050,14545,91507595,1,0,1,28160,18,2215364844
3032,91545390,227947,91773337,2,0,0,73216,29,6601228309
3033,91576360,15321,91591681,1,0,1,29696,18,6580124853
3034,91661499,57440,91718939,5,0,0,4608,12,2884632084
3035,91667709,136354,91804063,5,0,0,1536,12,3453520951
3036,91715821,58475,91774296,1,0,0,3072,18,379096076
3037,91752180,29305,91781485,1,0,1,7680,18,10635434671
3038,91795690,2946,91798636,1,0,1,3072,18,4653880218
3039,91851560,11274,91862834,1,0,1,18432,18,9584215452
3040,91852629,48500,91901129,5,0,0,512,12,6181830479
3041,91902070,146483,92048553,9,0,0,131072,9,9522514089
3042,91932360,13253,91945613,1,0,1,25600,18,2851997632
3043,91959731,92734,92052465,1,0,0,512,18,7096718969
3044,91975770,103617,92079387,2,0,0,2048,29,6809369860
3045,91992301,70160,92062461,1,0,0,3072,18,4032724847
3046,92013910,311195,92325105,2,0,0,285184,29,1712493433
3047,92028850,308305,92337155,9,0,0,37888,9,5882335857
3048,92073390,325899,92399289,2,0,0,72704,29,3310039361
3049,92164920,3645,92168565,1,0,1,10240,18,713493270
3050,92207439,118157,92325596,5,0,0,1536,12,8338201851
3051,92256220,105048,92361268,1,0,1,43520,18,6381012378
3052,92368311,57212,92425523,1,0,0,1024,18,1336362270
3053,92381621,68332,92449953,1,0,0,2560,18,9389787175
3054,92383231,59979,92443210,1,0,0,512,18,5206113765
3055,92404521,47288,92451809,1,0,0,1536,18,9816924788
3056,92501710,4374,92506084,2,0,1,4608,29,10017337544
3057,92575090,15062,92590152,2,0,1,29184,29,3373282224
3058,92593309,53534,92646843,5,0,0,1024,12,2888405476
3059,92630190,281660,92911850,2,0,0,140288,29,1320577112
3060,92692920,106496,92799416,2,0,0,49664,29,7399751510
3061,92809049,102972,92912021,5,0,0,512,12,6744513930
3062,92857590,134180,92991770,2,0,0,102912,29,2239064417
3063,92914900,112990,93027890,2,0,0,27648,29,1067520561
3064,92931100,149560,93080660,9,0,0,38400,9,7277818373
3065,92958070,33715,92991785,1,0,1,2560,18,8232400077
3066,92986080,10893,92996973,1,0,1,13312,18,4968510357
3067,93006690,11016,93017706,1,0,1,17920,18,7220641678
3068,93007311,98879,93106190,1,0,0,5120,18,9330025243
3069,93024560,16939,93041499,8,0,1,23040,3,3542645187
3070,93024720,17240,93041960,1,0,1,10240,18,5115558410
3071,93029330,192124,93221454,0,0,0,126464,20,2586661933
3072,93059230,21445,93080675,8,0,1,26112,3,3449751196
3073,93065720,14970,93080690,2,0,1,2560,29,3093092643
3074,93081660,2870,93084530,1,0,1,8704,18,9565534253
3075,93135430,15579,93151009,8,0,1,30208,3,5511413768
3076,93150610,4374,93154984,1,0,1,4608,18,5264592338
3077,93200159,33853,93234012,0,0,1,20992,20,4920599966
3078,93270110,12049,93282159,1,0,1,19968,18,2975341394
3079,93298969,80903,93379872,5,0,0,1024,12,9376250852
3080,93347090,165242,93512332,2,0,0,124928,29,3813711361
3081,93355850,7230,93363080,1,0,1,7680,18,890009504
3082,93372750,5326,93378076,1,0,1,5632,18,8557685900
3083,93434900,2470,93437370,8,0,1,2560,3,3572969643
3084,93459070,3645,93462715,1,0,1,10240,18,5752538651
3085,93462031,6179,93468210,9,0,1,14848,9,1403362979
3086,93539941,155108,93695049,1,0,0,2560,18,8375891060
3087,93561189,566,93561755,0,0,1,512,20,8626164981
3088,93566770,4850,93571620,2,0,1,5120,29,10051910882
3089,93572971,109769,93682740,1,0,0,1536,18,5886077565
3090,93573670,181479,93755149,9,0,0,25088,9,3630222473
3091,93575569,84257,93659826,5,0,0,3072,12,2227406478
3092,93593961,50672,93644633,1,0,0,2560,18,8402031977
3093,93659280,15342,93674622,1,0,1,28672,18,4834588163
3094,93672961,61129,93734090,1,0,0,2048,18,8497437687
3095,93699071,3904,93702975,9,0,1,10752,9,3517010624
3096,93705420,275383,93980803,9,0,0,249344,9,3999017289
3097,93716621,4162,93720783,9,0,1,11264,9,1844886440
3098,93738980,3422,93742402,1,0,1,3584,18,7480074734
3099,93762640,271692,94034332,9,0,0,7168,9,902718174
3100,93769270,235807,94005077,9,0,0,16896,9,9209389874
3101,93781581,92843,93874424,1,0,0,512,18,1190318411
3102,93801540,198350,93999890,9,0,0,62464,9,9387791555
3103,93834831,180208,94015039,1,0,0,1536,18,7656127533
3104,93860130,2470,93862600,1,0,1,2560,18,5340625039
3105,93883301,1518,93884819,9,0,1,1536,9,2021859520
3106,93886260,159604,94045864,2,0,0,9728,29,4419480223
3107,93907051,98049,94005100,9,0,1,4608,9,348987755
3108,93930870,74245,94005115,2,0,1,10240,29,1853176619
3109,93941040,107397,94048437,9,0,0,7680,9,6650765375
3110,93942811,65460,94008271,9,0,1,4096,9,2373969539
3111,93971039,83111,94054150,5,0,0,512,12,9905021920
3112,93990541,22556,94013097,9,0,1,7680,9,8944424454
3113,94006870,7507,94014377,2,0,1,14336,29,6331707509
3114,94072899,43904,94116803,5,0,0,512,12,4887950169
3115,94111341,2470,94113811,9,0,1,2560,9,9913638183
3116,94135139,48034,94183173,5,0,0,512,12,2004424806
3117,94146911,1518,94148429,9,0,1,1536,9,2233597938
3118,94170571,566,94171137,9,0,1,512,9,1521233658
3119,94304721,119600,94424321,1,0,0,92672,18,6815762045
3120,94348931,12566,94361497,9,0,1,20992,9,9331080893
3121,94378121,4850,94382971,9,0,1,5120,9,589147359
3122,94466300,204574,94670874,9,0,0,87040,9,286723004
3123,94542730,1518,94544248,1,0,1,1536,18,4527449826
3124,94547551,7230,94554781,9,0,1,7680,9,5180478444
3125,94561790,11016,94572806,1,0,1,17920,18,7797394506
3126,94569110,169822,94738932,2,0,0,82432,29,4741435554
3127,94570711,3645,94574356,9,0,1,10240,9,10032005540
3128,94710881,667652,95378533,1,0,0,644096,18,4820597174
3129,94729490,11904,94741394,4,0,1,2560,10,4744008971
3130,94739530,3610,94743140,1,0,1,9728,18,636908702
3131,94802391,2946,94805337,9,0,1,3072,9,3876213427
3132,94808101,374169,95182270,1,0,0,26112,18,9845632379
3133,94856830,1518,94858348,5,0,1,1536,12,9816562754
3134,94870660,233364,95104024,2,0,0,33280,29,618635562
3135,94925670,501426,95427096,9,0,0,159232,9,7045193989
3136,94934310,239989,95174299,2,0,0,17920,29,8275949664
3137,94947000,183841,95130841,9,0,0,27648,9,4116479242
3138,95015621,22691,95038312,9,0,1,37376,9,4450109312
3139,95064051,5712,95069763,9,0,1,14336,9,2948255073
3140,95095050,347513,95442563,2,0,0,50688,29,1522056142
3141,95122671,12536,95135207,9,0,1,4608,9,4892004715
3142,95181470,264305,95445775,1,0,1,9216,18,8783750677
3143,95182911,392964,95575875,1,0,0,186368,18,2050241163
3144,95188840,405941,95594781,2,0,0,15872,29,8088611539
3145,95225310,226899,95452209,1,0,1,7168,18,4882810784
3146,95252800,432569,95685369,2,0,0,87552,29,8581822224
3147,95305331,148184,95453515,9,0,1,2048,9,8911723393
3148,95307051,154799,95461850,9,0,1,26112,9,6561896570
3149,95313480,149676,95463156,1,0,1,2048,18,2687299809
3150,95339471,124658,95464129,9,0,1,12800,9,7407106059
3151,95346740,394886,95741626,9,0,0,18944,9,1698064796
3152,95428041,76155,95504196,9,0,1,74240,9,10596586527
3153,95437631,70751,95508382,9,0,1,6656,9,8789704655
3154,95441111,148819,95589930,1,0,0,46080,18,1480605516
3155,95465481,49212,95514693,9,0,1,22016,9,10199636541
3156,95677360,210965,95888325,2,0,0,99328,29,10049181102
3157,95777560,7706,95785266,1,0,1,8192,18,7288431909
3158,95845570,1994,95847564,6,0,1,2048,0,8420242020
3159,95978650,5802,95984452,6,0,1,6144,0,4044322523
3160,96026020,1042,96027062,1,0,1,1024,18,3360315639
3161,96028650,12049,96040699,4,0,1,19968,10,2791281905
3162,96062820,71756,96134576,2,0,0,11264,29,6229906092
3163,96105131,4937,96110068,9,0,1,12800,9,1428830077
3164,96193200,566,96193766,6,0,1,512,0,9929588983
3165,96284221,23725,96307946,9,0,1,39424,9,1268488799
3166,96338929,566,96339495,0,0,1,512,20,5251907969
3167,96367249,12825,96380074,0,0,1,21504,20,7845253182
3168,96403520,36087,96439607,7,0,1,63488,2,6715654765
3169,96404771,34990,96439761,9,0,1,8704,9,4346131098
3170,96418559,22380,96440939,0,0,1,13824,20,8867524488
3171,96442111,294772,96736883,1,0,0,210944,18,8744004472
3172,96473790,4937,96478727,1,0,1,12800,18,6410599751
3173,96523730,4937,96528667,6,0,1,12800,0,7318557897
3174,96541710,470777,97012487,2,0,0,122368,29,8262233369
3175,96544410,261497,96805907,9,0,0,41472,9,5138179863
3176,96551501,314328,96865829,1,0,0,183808,18,8702761329
3177,96551750,359600,96911350,9,0,0,129024,9,8508217510
3178,96643411,224476,96867887,1,0,0,6656,18,8386144042
3179,96702520,163324,96865844,7,0,1,132096,2,4848764695
3180,96707200,369977,97077177,9,0,0,2560,9,3055744157
3181,96710851,320034,97030885,1,0,0,12288,18,7321781446
3182,96712370,155548,96867918,7,0,1,89088,2,1801087628
3183,96762401,185279,96947680,1,0,0,4608,18,2538546631
3184,96781220,86713,96867933,4,0,1,15872,10,4835188398
3185,96802860,65548,96868408,7,0,1,76288,2,1101052342
3186,96806420,482822,97289242,9,0,0,66560,9,5170642924
3187,96843000,68365,96911365,5,0,1,4608,12,7913400097
3188,96847650,63730,96911380,6,0,1,12800,0,7941722327
3189,96922380,43370,96965750,7,0,1,74240,2,7015157334
3190,97008270,6203,97014473,5,0,1,2048,12,92850837
3191,97023210,7690,97030900,5,0,1,14336,12,3728024340
3192,97030980,335248,97366228,9,0,0,5632,9,2968656625
3193,97035840,328627,97364467,9,0,0,71680,9,8178215195
3194,97058910,200342,97259252,2,0,0,101888,29,2678571414
3195,97064009,13183,97077192,0,0,1,22016,20,7731531342
3196,97068100,200839,97268939,9,0,0,31744,9,4682130998
3197,97071771,32041,97103812,9,0,1,52224,9,8473055457
3198,97142820,10757,97153577,6,0,1,17408,0,2955480214
3199,97143731,197860,97341591,1,0,0,78336,18,10276175224
3200,97144499,151863,97296362,3,0,0,15872,28,8459965465
3201,97156171,7706,97163877,9,0,1,8192,9,5186476251
3202,97237080,52762,97289842,5,0,1,512,12,7370093089
3203,97257020,84602,97341622,7,0,1,68096,2,8058017847
3204,97257361,336662,97594023,1,0,0,100352,18,3951524764
3205,97266401,75236,97341637,9,0,1,17408,9,3694678171
3206,97300420,41232,97341652,5,0,1,14848,12,4459388334
3207,97303119,38548,97341667,0,0,1,13824,20,9807818856
3208,97323039,41443,97364482,0,0,1,13312,20,1904756905
3209,97331059,33438,97364497,0,0,1,1024,20,6210665435
3210,97359260,33181,97392441,7,0,1,47616,2,1197117444
3211,97388281,6106,97394387,9,0,1,3072,9,5276462755
3212,97447330,3645,97450975,5,0,1,10240,12,10209866650
3213,97449660,373776,97823436,2,0,0,205312,29,10342112088
3214,97530850,550760,98081610,2,0,0,478720,29,3066296487
3215,97565630,33906,97599536,5,0,1,13824,12,5129643372
3216,97574230,31294,97605524,5,0,1,7680,12,6578491720
3217,97576180,30010,97606190,6,0,1,1024,0,1792678343
3218,97592280,14883,97607163,5,0,1,12800,12,4313271174
3219,97640730,12737,97653467,6,0,1,24576,0,8028702086
3220,97674841,5196,97680037,9,0,1,13312,9,2360811746
3221,97682380,4937,97687317,6,0,1,12800,0,874917755
3222,97756670,566,97757236,6,0,1,512,0,7025292109
3223,97775600,310704,98086304,2,0,0,12800,29,7048032422
3224,97785310,38751,97824061,5,0,1,512,12,6947539905
3225,97797629,29444,97827073,0,0,1,3584,20,7748138085
3226,97803950,27309,97831259,8,0,1,6656,3,8868661073
3227,97824161,14458,97838619,9,0,1,19456,9,3969639575
3228,97836490,2795,97839285,8,0,1,1024,3,2534627897
3229,97865490,216851,98082341,2,0,0,2048,29,5955814262
3230,97888901,12825,97901726,9,0,1,21504,9,4757529756
3231,97908059,23725,97931784,0,0,1,39424,20,7431471380
3232,97908329,27321,97935650,0,0,1,6144,20,3221771692
3233,97918060,163565,98081625,5,0,1,3584,12,2251262978
3234,97920019,161621,98081640,0,0,1,2560,20,854421264
3235,97926310,155353,98081663,6,0,1,3584,0,4070597153
3236,97926770,154908,98081678,1,0,1,2048,18,5438660041
3237,97940320,150367,98090687,6,0,1,4608,0,429028675
3238,97967250,303091,98270341,7,0,1,295424,2,3406953482
3239,97969199,304368,98273567,0,0,1,5120,20,8792455462
3240,97972940,301805,98274745,6,0,1,13824,0,10494238220
3241,97996360,280971,98277331,8,0,1,4096,3,6082816352
3242,97996949,287103,98284052,0,0,1,24064,20,7756201417
3243,97997230,288448,98285678,6,0,1,2560,0,1623710947
3244,98016359,269780,98286139,0,0,1,10240,20,1461303210
3245,98018780,171210,98189990,2,0,0,28160,29,4328086637
3246,98027670,263295,98290965,8,0,1,7680,3,5482101792
3247,98072630,179822,98252452,2,0,0,20480,29,3827040253
3248,98076420,220037,98296457,5,0,1,17920,12,958976631
3249,98127740,171943,98299683,8,0,1,5120,3,4220638882
3250,98165310,137919,98303229,6,0,1,5632,0,3756042701
3251,98231390,78150,98309540,6,0,1,22016,0,5710602669
3252,98232160,83998,98316158,8,0,1,31744,3,472298865
3253,98236630,80808,98317438,6,0,1,14336,0,2505992716
3254,98268800,48984,98317784,8,0,1,512,3,842818118
3255,98287090,31360,98318450,6,0,1,1024,0,4742998747
3256,98290949,28487,98319436,0,0,1,1536,20,8483071642
3257,98357949,566,98358515,0,0,1,512,20,3760589006
3258,98371280,124628,98495908,7,0,1,205824,2,2316631363
3259,98426390,85685,98512075,7,0,1,60928,2,8689910235
3260,98433321,170118,98603439,1,0,0,22016,18,6014764158
3261,98434329,78092,98512421,0,0,1,512,20,4955150713
3262,98434391,83317,98517708,9,0,1,25088,9,4148150596
3263,98437750,81584,98519334,5,0,1,2560,12,7641496003
3264,98465849,54791,98520640,0,0,1,2048,20,5241481515
3265,98537440,234953,98772393,2,0,0,43520,29,5698529257
3266,98539709,10499,98550208,0,0,1,16896,20,9695772518
3267,98539930,10534,98550464,6,0,1,9216,0,4097939030
3268,98563120,5196,98568316,5,0,1,13312,12,4307009416
3269,98563930,19391,98583321,8,0,1,31232,3,7048841855
3270,98609800,4162,98613962,8,0,1,11264,3,4995520363
3271,98643241,96356,98739597,1,0,0,16384,18,5693065854
3272,98656860,1042,98657902,8,0,1,1024,3,7144057505
3273,98663900,200164,98864064,2,0,0,29696,29,9810732062
3274,98758300,566,98758866,5,0,1,512,12,4582394059
3275,98761740,17399,98779139,5,0,1,7168,12,9180405526
3276,98834610,4162,98838772,8,0,1,11264,3,5299561298
3277,98848481,536484,99384965,1,0,0,405504,18,9370519811
3278,98872160,110196,98982356,2,0,0,39936,29,2414528821
3279,98911111,252357,99163468,1,0,0,22528,18,5078886256
3280,98928640,94341,99022981,7,0,1,153600,2,4361279492
3281,98961330,63136,99024466,6,0,1,15360,0,5680611227
3282,98968200,424424,99392624,2,0,0,25088,29,9758052810
3283,99013300,16760,99030060,6,0,1,18432,0,8167374020
3284,99026130,10499,99036629,8,0,1,16896,3,9874661655
3285,99098301,352721,99451022,1,0,0,176640,18,431931259
3286,99159790,7849,99167639,5,0,1,11264,12,5095711962
3287,99162101,235078,99397179,1,0,0,14848,18,10656857407
3288,99237050,6754,99243804,6,0,1,7168,0,3424518064
3289,99287540,304756,99592296,2,0,0,86528,29,9952589331
3290,99329421,122404,99451825,1,0,0,2560,18,7329659072
3291,99372120,178821,99550941,2,0,0,58368,29,5728588126
3292,99432970,26044,99459014,6,0,1,7680,0,663858122
3293,99482650,161012,99643662,2,0,0,27136,29,5345518745
3294,99521800,29156,99550956,8,0,1,30720,3,4515047240
3295,99549931,186101,99736032,1,0,0,31744,18,511403698
3296,99575281,292145,99867426,1,0,0,235008,18,2216434187
3297,99579590,23997,99603587,8,0,1,18432,3,8557089760
3298,99642260,3388,99645648,6,0,1,2048,0,10007881078
3299,99655110,21916,99677026,6,0,1,35840,0,5235750602
3300,99655289,22301,99677590,3,0,1,10752,28,8999061263
3301,99671260,104637,99775897,7,0,1,173568,2,7505899519
3302,99673150,103733,99776883,8,0,1,1536,3,7727683890
3303,99696660,170789,99867449,7,0,1,141824,2,6358126281
3304,99723020,144444,99867464,5,0,1,14336,12,5490335765
3305,99725000,142479,99867479,6,0,1,1024,0,6807450876
3306,99743670,123824,99867494,6,0,1,5120,0,5988976217
3307,99815300,63527,99878827,8,0,1,18432,3,4059896548
3308,99824120,143044,99967164,7,0,1,156160,2,8513650366
3309,99834871,271483,100106354,1,0,0,56320,18,9062399325
3310,99861190,106640,99967830,8,0,1,1024,3,635565746
3311,99862360,163426,100025786,7,0,1,170496,2,7377695276
3312,99895860,132512,100028372,6,0,1,4096,0,2583698151
3313,99901080,128598,100029678,5,0,1,2048,12,201303323
3314,99923831,407932,100331763,1,0,0,29696,18,4221759982
3315,100058680,5326,100064006,6,0,1,5632,0,2797405430
3316,100067390,5326,100072716,6,0,1,5632,0,8151261532
3317,100071310,312603,100383913,2,0,0,47104,29,7392971997
3318,100080810,4162,100084972,8,0,1,11264,3,7116965099
3319,100206570,12308,100218878,5,0,1,20480,12,9752058555
3320,100212831,11232,100224063,9,0,1,16384,9,1218524548
3321,100218050,8599,100226649,2,0,1,4096,29,6720288117
3322,100225220,4420,100229640,8,0,1,11776,3,3404141334
3323,100226940,5070,100232010,5,0,1,9216,12,9570419316
3324,100227150,251815,100478965,2,0,0,59392,29,4383582912
3325,100271671,24412,100296083,9,0,1,44032,9,658225779
3326,100289490,10779,100300269,8,0,1,6656,3,8914635576
3327,100317950,13828,100331778,5,0,1,6656,12,6798482485
3328,100334730,5712,100340442,8,0,1,14336,3,3234336186
3329,100344600,3645,100348245,5,0,1,10240,12,1256187333
3330,100363671,1042,100364713,9,0,1,1024,9,8893421121
3331,100425580,5802,100431382,8,0,1,6144,3,4337019750
3332,100438610,4850,100443460,6,0,1,5120,0,3284076168
3333,100444690,56596,100501286,7,0,1,96768,2,5728395447
3334,100450470,51802,100502272,6,0,1,1536,0,10186065155
3335,100561890,3422,100565312,5,0,1,3584,12,1701014218
3336,100564821,1518,100566339,9,0,1,1536,9,10480168954
3337,100598490,12049,100610539,8,0,1,19968,3,9263495938
3338,100684190,5802,100689992,6,0,1,6144,0,2514871699
3339,100706350,61382,100767732,7,0,1,99328,2,5275109119
3340,100726100,46778,100772878,8,0,1,8192,3,1963281683
3341,100736570,38894,100775464,6,0,1,4096,0,9906551013
3342,100746741,62384,100809125,1,0,0,10752,18,3027763636
3343,100805390,3750,100809140,8,0,1,2560,3,1478240497
3344,100818030,3904,100821934,8,0,1,10752,3,9109241696
3345,100848641,566,100849207,9,0,1,512,9,3065288181
3346,100954340,83156,101037496,2,0,0,18432,29,2637954866
3347,100956120,566,100956686,6,0,1,512,0,793317633
3348,100983980,4937,100988917,5,0,1,12800,12,4844148568
3349,101034210,75058,101109268,2,0,0,16384,29,4882707054
3350,101044690,4679,101049369,6,0,1,12288,0,1210950738
3351,101079140,1518,101080658,5,0,1,1536,12,3962608524
3352,101089590,62674,101152264,7,0,1,101888,2,7440801606
3353,101095351,67435,101162786,9,0,1,33792,9,6327343814
3354,101139670,113078,101252748,2,0,0,17920,29,2173676469
3355,101192750,153254,101346004,2,0,0,20992,29,3242186999
3356,101295000,3128,101298128,8,0,1,9216,3,2363649352
3357,101328381,190514,101518895,1,0,0,152576,18,1505509962
3358,101330550,4374,101334924,5,0,1,4608,12,8793968159
3359,101358341,228491,101586832,1,0,0,116736,18,6141642876
3360,101364020,3898,101367918,6,0,1,4096,0,3197821256
3361,101376310,3422,101379732,8,0,1,3584,3,5552245098
3362,101403070,5454,101408524,8,0,1,13824,3,1018937799
3363,101448900,1042,101449942,6,0,1,1024,0,2612998255
3364,101514961,7348,101522309,9,0,1,3584,9,7182166555
3365,101567810,24210,101592020,8,0,1,13312,3,3846691956
3366,101614321,237167,101851488,1,0,0,36352,18,7398291646
3367,101628630,211759,101840389,2,0,0,65024,29,7640848761
3368,101635190,270956,101906146,2,0,0,95744,29,8904514400
3369,101654090,166472,101820562,2,0,0,66560,29,5709667116
3370,101667880,21916,101689796,6,0,1,35840,0,7462958905
3371,101708521,211056,101919577,1,0,0,44032,18,8818264262
3372,101712981,2870,101715851,9,0,1,8704,9,3913478870
3373,101734890,12566,101747456,6,0,1,20992,0,6572172085
3374,101828510,24455,101852965,5,0,1,1536,12,5334002997
3375,101871210,188630,102059840,2,0,0,44032,29,4372440026
3376,101892970,255064,102148034,2,0,0,66560,29,3833115004
3377,101903659,21261,101924920,0,0,1,5632,20,81668125
3378,101932380,195359,102127739,2,0,0,30208,29,2397826029
3379,101964501,81908,102046409,1,0,0,14336,18,7834193496
3380,101977830,566,101978396,2,0,1,512,29,3837909653
3381,102006610,4374,102010984,6,0,1,4608,0,6463326239
3382,102033260,3387,102036647,6,0,1,9728,0,9173786483
3383,102147359,3613,102150972,0,0,1,3072,20,8365850105
3384,102173000,10499,102183499,8,0,1,16896,3,5769674229
3385,102227650,7706,102235356,8,0,1,8192,3,4237795510
3386,102229301,112694,102341995,1,0,0,67072,18,2602988529
3387,102255261,231166,102486427,1,0,0,171520,18,5427528604
3388,102342490,1518,102344008,6,0,1,1536,0,217797088
3389,102386020,2470,102388490,8,0,1,2560,3,5749056919
3390,102437161,128718,102565879,1,0,0,16384,18,2994441428
3391,102520901,111248,102632149,1,0,0,56320,18,7992454522
3392,102562420,9680,102572100,8,0,1,15360,3,2807011575
3393,102693860,2470,102696330,6,0,1,2560,0,9361786770
3394,102742320,5802,102748122,8,0,1,6144,3,7816133051
3395,102795320,2470,102797790,8,0,1,2560,3,3781640480
3396,102798490,1042,102799532,6,0,1,1024,0,1859172777
3397,102838001,129196,102967197,1,0,0,52224,18,1355151013
3398,102842350,4420,102846770,1,0,1,11776,18,9935863333
3399,102850880,566,102851446,1,0,1,512,18,8563572820
3400,102864941,204324,103069265,1,0,0,81920,18,8827435020
3401,102874290,4162,102878452,6,0,1,11264,0,2335316151
3402,102917940,5326,102923266,8,0,1,5632,3,9737710437
3403,102950800,16412,102967212,1,0,1,2560,18,6695319642
3404,103018370,5802,103024172,1,0,1,6144,18,8920146027
3405,103059090,24301,103083391,1,0,1,24064,18,784992777
3406,103065950,105460,103171410,2,0,0,35328,29,7550099720
3407,103088860,2946,103091806,1,0,1,3072,18,10376411779
3408,103196020,2470,103198490,1,0,1,2560,18,4903372855
3409,103392090,1994,103394084,1,0,1,2048,18,4465817071
3410,103409580,114296,103523876,2,0,0,75264,29,9622116912
3411,103551860,115700,103667560,2,0,0,79872,29,8656703091
3412,103589390,1518,103590908,8,0,1,1536,3,5314049439
3413,103647490,25516,103673006,1,0,1,13824,18,10497248883
3414,103727680,3898,103731578,8,0,1,4096,3,1735551007
3415,103727760,5764,103733524,1,0,1,3072,18,9062473461
3416,103761280,5326,103766606,8,0,1,5632,3,9029554166
3417,103917720,5802,103923522,2,0,1,6144,29,2247768728
3418,103918630,148003,104066633,2,0,0,104960,29,7315926604
3419,103930770,3904,103934674,1,0,1,10752,18,8100734042
3420,103958420,566,103958986,1,0,1,512,18,6895688957
3421,103961090,5802,103966892,1,0,1,6144,18,8532433208
3422,104052000,20854,104072854,2,0,1,15360,29,9582501661
3423,104100330,3422,104103752,1,0,1,3584,18,7525436184
3424,104169250,1042,104170292,8,0,1,1024,3,4174594629
3425,104205420,24154,104229574,2,0,1,43520,29,843296222
3426,104228460,5802,104234262,1,0,1,6144,18,706907448
3427,104234390,13083,104247473,1,0,1,22016,18,2071731021
3428,104247641,566,104248207,9,0,1,512,9,4621179258
3429,104281421,2870,104284291,9,0,1,8704,9,9040625166
3430,104389500,4162,104393662,2,0,1,11264,29,6469340727
3431,104404740,231656,104636396,2,0,0,118784,29,4312780730
3432,104437450,1042,104438492,8,0,1,1024,3,2335378456
3433,104465120,4374,104469494,2,0,1,4608,29,9729306180
3434,104486229,1518,104487747,0,0,1,1536,20,6319306724
3435,104519120,566,104519686,1,0,1,512,18,6126039661
3436,104523121,12737,104535858,9,0,1,24576,9,7544548796
3437,104547610,12308,104559918,8,0,1,20480,3,6905003155
3438,104559080,4162,104563242,8,0,1,11264,3,7713442787
3439,104666590,4374,104670964,1,0,1,4608,18,2679390220
3440,104735220,4850,104740070,8,0,1,5120,3,4873398886
3441,104788651,566,104789217,9,0,1,512,9,5558404317
3442,104813341,5326,104818667,9,0,1,5632,9,7982385052
3443,104842730,11791,104854521,1,0,1,19456,18,3840686318
3444,104929961,1518,104931479,9,0,1,1536,9,2906287221
3445,104938310,1518,104939828,8,0,1,1536,3,4801421467
3446,104953320,74360,105027680,2,0,0,9728,29,1923215562
3447,104984680,7706,104992386,8,0,1,8192,3,100715960
3448,104989530,3387,104992917,8,0,1,9728,3,3457426899
3449,105005870,10499,105016369,1,0,1,16896,18,5236715528
3450,105057850,3898,105061748,8,0,1,4096,3,10602528094
3451,105063330,2946,105066276,1,0,1,3072,18,4969784719
3452,105110830,7230,105118060,8,0,1,7680,3,8124205675
3453,105130071,4162,105134233,9,0,1,11264,9,2035397601
3454,105140261,1518,105141779,9,0,1,1536,9,8922231517
3455,105167320,106563,105273883,2,0,0,35328,29,2610744665
3456,105222530,12566,105235096,1,0,1,20992,18,9018353040
3457,105250810,5971,105256781,8,0,1,14848,3,3850041741
3458,105257180,116324,105373504,2,0,0,81920,29,2839737541
3459,105265410,22494,105287904,1,0,1,27136,18,2382198650
3460,105276920,11650,105288570,1,0,1,1024,18,5273148880
3461,105342570,76894,105419464,2,0,0,8704,29,8293908707
3462,105420750,1042,105421792,4,0,1,1024,10,656736188
3463,105423181,4374,105427555,9,0,1,4608,9,5492133086
3464,105434271,3387,105437658,9,0,1,9728,9,6336001647
3465,105483610,3645,105487255,6,0,1,10240,0,4254467157
3466,105508220,1042,105509262,8,0,1,1024,3,5700689254
3467,105532621,11274,105543895,9,0,1,18432,9,7196068831
3468,105543390,4937,105548327,8,0,1,12800,3,2963626457
3469,105706430,4162,105710592,8,0,1,11264,3,9910174552
3470,105791550,2470,105794020,4,0,1,2560,10,2457341736
3471,105793120,53118,105846238,2,0,0,3072,29,10021284682
3472,105867280,5802,105873082,8,0,1,6144,3,5357798714
3473,105920951,1994,105922945,4,0,1,2048,10,690529165
3474,105922880,2870,105925750,8,0,1,8704,3,9820416515
3475,105999540,203741,106203281,2,0,0,196608,29,2908722803
3476,106009199,12566,106021765,0,0,1,20992,20,1385351817
3477,106097870,3904,106101774,8,0,1,10752,3,5013518632
3478,106124850,420909,106545759,2,0,0,434688,29,8814270726
3479,106177681,36608,106214289,4,0,1,17920,10,10509459660
3480,106227920,333462,106561382,2,0,0,51200,29,9987939132
3481,106265150,314187,106579337,2,0,0,58880,29,2450656470
3482,106368691,3645,106372336,4,0,1,10240,10,9908054469
3483,106429650,160005,106589655,8,0,0,512,3,1728103773
3484,106480520,146097,106626617,8,0,0,1536,3,4298640
3485,106678051,15579,106693630,4,0,1,30208,10,10345732213
3486,106679810,31389,106711199,8,0,1,43008,3,9379402845
3487,106717831,3904,106721735,9,0,1,10752,9,5751825318
3488,106755300,2470,106757770,8,0,1,2560,3,3602645603
3489,106861881,4937,106866818,4,0,1,12800,10,8294873176
3490,106883341,5712,106889053,4,0,1,14336,10,2713004133
3491,107019441,1994,107021435,4,0,1,2048,10,1929390087
3492,107064621,5326,107069947,4,0,1,5632,10,4909629195
3493,107066170,22649,107088819,8,0,1,36864,3,6398223464
3494,107068371,23034,107091405,4,0,1,4096,10,5566243727
3495,107075631,22495,107098126,4,0,1,24064,10,736322342
3496,107113401,3422,107116823,4,0,1,3584,10,1080282329
3497,107220860,12566,107233426,6,0,1,20992,0,3730124521
3498,107221970,125718,107347688,2,0,0,54272,29,3526062409
3499,107339030,9216,107348246,6,0,1,512,0,3250367393
3500,107368640,1042,107369682,8,0,1,1024,3,4512308527
3501,107411300,171303,107582603,2,0,0,15360,29,1169804349
3502,107441460,2470,107443930,8,0,1,2560,3,6417429410
3503,107508970,6754,107515724,8,0,1,7168,3,8682028064
3504,107521720,223081,107744801,2,0,0,203776,29,8578480325
3505,107589291,11274,107600565,4,0,1,18432,10,10708623675
3506,107679480,76440,107755920,8,0,0,1024,3,915892814
3507,107687370,106403,107793773,8,0,0,2048,3,3051091466
3508,107706461,41502,107747963,4,0,1,9216,10,5503673042
3509,107720990,38186,107759176,8,0,1,18944,3,4603410622
3510,107779060,10241,107789301,6,0,1,16384,0,8270007246
3511,107782451,7311,107789762,4,0,1,10240,10,643156258
3512,107827720,269020,108096740,2,0,0,150016,29,6184928924
3513,107841391,3422,107844813,4,0,1,3584,10,8992750379
3514,107850411,7706,107858117,4,0,1,8192,10,8932242235
3515,107891580,87931,107979511,8,0,0,1024,3,10587620294
3516,108083640,210860,108294500,2,0,0,187904,29,4847402061
3517,108125400,169762,108295162,8,0,0,1536,3,1687906835
3518,108131531,20882,108152413,4,0,1,33792,10,10698742767
3519,108147870,146801,108294671,8,0,0,512,3,7896915775
3520,108280850,102069,108382919,2,0,0,25088,29,8700577411
3521,108284450,127137,108411587,2,0,0,13312,29,8095283622
3522,108437321,5196,108442517,4,0,1,13312,10,4949354747
3523,108477360,55748,108533108,2,0,0,4096,29,969291621
3524,108480070,45596,108525666,8,0,0,1024,3,92190930
3525,108590450,81854,108672304,8,0,0,3072,3,771509777
3526,108597581,4937,108602518,4,0,1,12800,10,2585009412
3527,108610960,566,108611526,8,0,1,512,3,2215230477
3528,108626400,1518,108627918,6,0,1,1536,0,6771688576
3529,108684990,115856,108800846,2,0,0,80384,29,7284020566
3530,108730840,31783,108762623,8,0,1,51712,3,8764164179
3531,108761950,7706,108769656,8,0,1,8192,3,10733919072
3532,108804840,71643,108876483,8,0,0,2560,3,8311342132
3533,108879660,566,108880226,8,0,1,512,3,8604704332
3534,108907770,167505,109075275,2,0,0,66560,29,800581210
3535,108910520,36087,108946607,6,0,1,63488,0,1402734953
3536,108920461,28092,108948553,4,0,1,3072,10,9852137522
3537,108923240,25774,108949014,6,0,1,10240,0,4245937790
3538,108967650,1518,108969168,8,0,1,1536,3,7129433331
3539,109072380,5833,109078213,6,0,1,3072,0,3012995303
3540,109151210,206324,109357534,2,0,0,210944,29,875206475
3541,109172370,185335,109357705,8,0,0,512,3,7313237092
3542,109318260,84877,109403137,8,0,0,512,3,1479710553
3543,109356960,100189,109457149,2,0,0,21504,29,588916856
3544,109454500,65157,109519657,2,0,0,6144,29,1499909711
3545,109463700,115584,109579284,2,0,0,23040,29,5221566841
3546,109473220,50672,109523892,8,0,0,2560,3,596078980
3547,109619979,74779,109694758,3,0,1,125440,28,5619222446
3548,109624010,245782,109869792,2,0,0,9728,29,1405026904
3549,109631810,63294,109695104,6,0,1,512,0,10079097937
3550,109635239,86606,109721845,3,0,1,87040,28,300352696
3551,109655990,72576,109728566,8,0,1,24064,3,591181477
3552,109784669,6488,109791157,3,0,1,15872,28,5085626756
3553,110075810,102752,110178562,2,0,0,37376,29,6083209407
3554,110201300,1518,110202818,2,0,1,1536,29,5992229428
3555,110381171,4679,110385850,9,0,1,12288,9,3715054365
3556,110391640,3422,110395062,5,0,1,3584,12,6259825460
3557,110424130,54056,110478186,8,0,0,3584,3,2815927926
3558,110522230,23725,110545955,7,0,1,39424,2,278814805
3559,110693060,238329,110931389,7,0,1,390656,2,8786254603
3560,110697540,255969,110953509,7,0,1,73216,2,8543540122
3561,110854620,99862,110954482,5,0,1,12800,12,411619894
3562,110863450,94898,110958348,5,0,1,6144,12,3198386795
3563,110881020,78954,110959974,5,0,1,2560,12,9140486018
3564,110911830,193032,111104862,8,0,0,512,3,7969129295
3565,110959580,124060,111083640,8,0,0,2560,3,6046944062
3566,110983630,82820,111066450,2,0,0,12288,29,5717585155
3567,111044690,311206,111355896,2,0,0,198656,29,99439556
3568,111140640,2946,111143586,5,0,1,3072,12,1195929568
3569,111168230,66383,111234613,8,0,0,5632,3,1394325864
3570,111275840,83823,111359663,2,0,0,12288,29,5583696422
3571,111340630,32075,111372705,5,0,1,22016,12,4055381228
3572,111388510,1042,111389552,5,0,1,1024,12,10095676381
3573,111438760,5802,111444562,5,0,1,6144,12,292027014
3574,111489490,4374,111493864,5,0,1,4608,12,1388884229
3575,111514560,128816,111643376,8,0,0,1024,3,315714299
3576,111576750,45596,111622346,8,0,0,1024,3,6901480558
3577,111613820,99476,111713296,2,0,0,26624,29,8848553012
3578,111628370,166370,111794740,2,0,0,132608,29,659879279
3579,111774210,44764,111818974,7,0,1,40448,2,7610434205
3580,111829360,74505,111903865,8,0,0,1536,3,3875389372
3581,111873570,72024,111945594,7,0,1,116736,2,5920759383
3582,111884450,83910,111968360,2,0,0,5120,29,2566102407
3583,111898400,204163,112102563,8,0,0,512,3,9284983046
3584,111900420,50871,111951291,1,0,1,18944,18,4175128159
3585,111935000,108391,112043391,8,0,0,2048,3,2919315090
3586,112050970,115537,112166507,7,0,1,191488,2,872930605
3587,112056300,168616,112224916,8,0,0,1536,3,2595845545
3588,112107230,114014,112221244,8,0,0,4608,3,8073695134
3589,112212809,127992,112340801,6,0,0,103424,0,8191559560
3590,112227470,2470,112229940,1,0,1,2560,18,262299857
3591,112295830,175083,112470913,7,0,1,284160,2,3212939277
3592,112343430,257246,112600676,2,0,0,28672,29,8657660381
3593,112369330,444056,112813386,2,0,0,134656,29,2404112103
3594,112422340,49239,112471579,1,0,1,11264,18,804313170
3595,112441909,224416,112666325,3,0,1,363520,28,359629119
3596,112452900,224459,112677359,7,0,1,36352,2,8292263471
3597,112471350,206355,112677705,1,0,1,512,18,7999858950
3598,112506970,172041,112679011,6,0,1,2048,0,5634578994
3599,112583990,112008,112695998,7,0,1,56832,2,2314666330
3600,112599300,100244,112699544,7,0,1,5632,2,5659607740
3601,112639290,65848,112705138,1,0,1,26624,18,6634636047
3602,112708040,10241,112718281,1,0,1,16384,18,3907715091
3603,112708209,206678,112914887,6,0,0,17408,0,94563473
3604,112736920,5712,112742632,1,0,1,14336,18,1158379779
3605,112767720,45689,112813409,7,0,1,41472,2,4623191871
3606,112783240,112029,112895269,7,0,1,132608,2,335207528
3607,112848810,46805,112895615,1,0,1,512,18,2433178873
3608,112872490,43811,112916301,7,0,1,74240,2,2404680175
3609,112916730,52054,112968784,8,0,0,1024,3,202754769
3610,112964110,1042,112965152,1,0,1,1024,18,3980014530
3611,113017630,4162,113021792,1,0,1,11264,18,5482933092
3612,113048941,3387,113052328,9,0,1,9728,9,1745610528
3613,113071960,119295,113191255,8,0,0,512,3,5260438182
3614,113212160,61124,113273284,7,0,1,98816,2,1857522621
3615,113253020,44145,113297165,7,0,1,75776,2,1050526579
3616,113354430,97292,113451722,2,0,0,19456,29,6699872891
3617,113388480,2470,113390950,8,0,1,2560,3,5327254123
3618,113393520,5326,113398846,7,0,1,5632,2,5495132340
3619,113415860,2946,113418806,8,0,1,3072,3,1046732197
3620,113429951,1518,113431469,9,0,1,1536,9,8474280897
3621,113440400,11337,113451737,1,0,1,17408,18,4649114873
3622,113498250,7706,113505956,1,0,1,8192,18,1461591400
3623,113558820,3645,113562465,7,0,1,10240,2,7560958062
3624,113615080,5326,113620406,8,0,1,5632,3,3008100465
3625,113640350,4162,113644512,1,0,1,11264,18,8570714346
3626,113654890,164487,113819377,2,0,0,20480,29,9323927372
3627,113658080,61419,113719499,8,0,0,2048,3,4621505979
3628,113674920,5326,113680246,8,0,1,5632,3,8107703707
3629,113674940,68740,113743680,8,0,0,512,3,6799499583
3630,113676660,21708,113698368,7,0,1,35328,2,4537808251
3631,113679519,165197,113844716,6,0,0,9728,0,2251759835
3632,113700490,110796,113811286,8,0,0,3584,3,4662613689
3633,113764910,124553,113889463,2,0,0,22528,29,8022650968
3634,113804910,3422,113808332,8,0,1,3584,3,1900310566
3635,113831210,13521,113844731,7,0,1,19456,2,6616846897
3636,113873499,110704,113984203,6,0,0,33792,0,9670810074
3637,113874819,224230,114099049,6,0,0,147456,0,9941292995
3638,113920329,186118,114106447,6,0,0,14336,0,9438701561
3639,113933320,1994,113935314,8,0,1,2048,3,1374436075
3640,113945530,54529,114000059,7,0,1,92672,2,263120905
3641,114029150,70390,114099540,8,0,0,1536,3,7877942458
3642,114036540,77744,114114284,2,0,0,10752,29,7750597536
3643,114053040,46531,114099571,7,0,1,72704,2,1348968834
3644,114060190,46272,114106462,8,0,1,11776,3,7020606859
3645,114084460,22589,114107049,8,0,1,10752,3,1158481052
3646,114088040,21251,114109291,8,0,1,8704,3,8983577076
3647,114118130,22862,114140992,7,0,1,40960,2,10156817217
3648,114163679,146368,114310047,6,0,0,3072,0,4479138256
3649,114177059,243602,114420661,6,0,0,56320,0,2077697347
3650,114178640,188707,114367347,2,0,0,70144,29,8405970078
3651,114197959,143115,114341074,6,0,0,15360,0,1846608387
3652,114209339,231341,114440680,6,0,0,23552,0,6563524833
3653,114216389,187097,114403486,6,0,0,58880,0,691487486
3654,114219840,355103,114574943,4,0,0,73728,10,1253223616
3655,114358480,62204,114420684,7,0,1,70656,2,454978282
3656,114410350,15629,114425979,1,0,1,5632,18,7395780119
3657,114464410,45596,114510006,8,0,0,1024,3,905199235
3658,114509719,98304,114608023,6,0,0,15872,0,225744306
3659,114510699,127016,114637715,6,0,0,36352,0,10529360828
3660,114516800,5454,114522254,8,0,1,13824,3,7583301019
3661,114520910,2010,114522920,1,0,1,1024,18,7049722950
3662,114533700,52364,114586064,8,0,0,3072,3,8904229447
3663,114563080,62527,114625607,8,0,0,2560,3,7467998872
3664,114582820,167107,114749927,2,0,0,104960,29,2359320184
3665,114688470,85169,114773639,8,0,0,4096,3,1719493362
3666,114789430,6754,114796184,1,0,1,7168,18,4928364015
3667,114868630,43904,114912534,4,0,0,512,10,9247589535
3668,114896140,47288,114943428,4,0,0,1536,10,3696614089
3669,114927561,5971,114933532,4,0,1,14848,10,6423529547
3670,114983960,47043,115031003,8,0,0,512,3,580437403
3671,114998220,5454,115003674,1,0,1,13824,18,6204419482
3672,114999810,7045,115006855,8,0,1,4608,3,683631937
3673,115009249,115388,115124637,6,0,0,78848,0,5032030694
3674,115174440,47288,115221728,8,0,0,1536,3,9602230292
3675,115281680,12566,115294246,1,0,1,20992,18,4575449419
3676,115292780,178905,115471685,8,0,0,3584,3,8301526858
3677,115300149,104156,115404305,6,0,0,41984,0,2200024272
3678,115301080,2870,115303950,1,0,1,8704,18,10427263584
3679,115335439,113320,115448759,6,0,0,15360,0,4296825044
3680,115352811,1518,115354329,9,0,1,1536,9,7086008190
3681,115421130,2470,115423600,1,0,1,2560,18,10294888843
3682,115446610,51146,115497756,8,0,0,2048,3,5141369368
3683,115448190,53970,115502160,4,0,0,512,10,7487833995
3684,115466460,62516,115528976,2,0,0,6144,29,7968425420
3685,115471830,50672,115522502,4,0,0,2560,10,10096678033
3686,115475260,3904,115479164,8,0,1,10752,3,10604590885
3687,115493429,139959,115633388,6,0,0,49152,0,223746779
3688,115497750,3128,115500878,2,0,1,9216,29,2667461186
3689,115544930,94083,115639013,7,0,1,153088,2,6099431294
3690,115587340,107507,115694847,8,0,0,1536,3,4087194560
3691,115594080,46521,115640601,8,0,1,15872,3,6799257657
3692,115597710,46851,115644561,8,0,0,1024,3,6524364587
3693,115620591,36014,115656605,9,0,1,38400,9,7648987895
3694,115621250,92839,115714089,8,0,0,3072,3,4976951581
3695,115657860,293097,115950957,4,0,0,1536,10,4796206130
3696,115667980,65639,115733619,8,0,0,512,3,4735685793
3697,115668109,136814,115804923,6,0,0,73216,0,6790205163
3698,115716810,2470,115719280,8,0,1,2560,3,7721216837
3699,115741171,6278,115747449,9,0,1,6656,9,9558146010
3700,115748650,3422,115752072,8,0,1,3584,3,8427150570
3701,115757400,192886,115950286,2,0,0,117248,29,9869526340
3702,115777781,27157,115804938,9,0,1,6144,9,100305012
3703,115806230,3387,115809617,8,0,1,9728,3,10367042017
3704,115831030,6278,115837308,6,0,1,6656,0,8449074452
3705,115831880,5992,115837872,6,0,1,10752,0,6206775374
3706,115839720,61401,115901121,8,0,0,2048,3,2147020964
3707,115951120,1042,115952162,6,0,1,1024,0,309755316
3708,115962230,1994,115964224,2,0,1,2048,29,1511732478
3709,116079430,180110,116259540,2,0,0,148992,29,1239155025
3710,116094620,4937,116099557,2,0,1,12800,29,1507314958
3711,116112240,4374,116116614,2,0,1,4608,29,3237831433
3712,116140270,119753,116260023,8,0,0,1536,3,4276203724
3713,116161300,2946,116164246,6,0,1,3072,0,1994304652
3714,116197920,1042,116198962,2,0,1,1024,29,2700934091
3715,116202290,11016,116213306,8,0,1,17920,3,7334806957
3716,116225870,46711,116272581,2,0,1,20992,29,10052424165
3717,116264240,47816,116312056,8,0,0,1024,3,4592243013
3718,116291830,3898,116295728,2,0,1,4096,29,7366212587
3719,116327550,52364,116379914,4,0,0,3072,10,8829510492
3720,116336271,2946,116339217,9,0,1,3072,9,10537874082
3721,116392070,5802,116397872,5,0,1,6144,12,1711327725
3722,116416300,1042,116417342,6,0,1,1024,0,4199767730
3723,116478851,12566,116491417,9,0,1,20992,9,10563804330
3724,116528550,5802,116534352,2,0,1,6144,29,2305823905
3725,116554251,2946,116557197,9,0,1,3072,9,10193552261
3726,116574671,6278,116580949,9,0,1,6656,9,3338412713
3727,116605499,203989,116809488,6,0,0,175104,0,4404441065
3728,116627220,3645,116630865,2,0,1,10240,29,10142432484
3729,116655430,566,116655996,2,0,1,512,29,286359013
3730,116658599,168087,116826686,6,0,0,20480,0,7815099363
3731,116727740,81763,116809503,8,0,1,49664,3,5616203150
3732,116759149,151382,116910531,6,0,0,31744,0,347088540
3733,116805850,155713,116961563,4,0,0,2560,10,1064262294
3734,116830420,11274,116841694,7,0,1,18432,2,7657276991
3735,116841429,161748,117003177,6,0,0,96256,0,5036902156
3736,116855540,277537,117133077,7,0,1,453632,2,6734111199
3737,116907969,465933,117373902,6,0,0,90112,0,1130773931
3738,116920960,223049,117144009,8,0,1,44032,3,2129068576
3739,116938130,259248,117197378,8,0,0,3072,3,10121502671
3740,117051620,93977,117145597,6,0,1,15872,0,6765466680
3741,117059230,330353,117389583,2,0,0,30208,29,3980489343
3742,117061220,397276,117458496,2,0,0,139776,29,6273878570
3743,117068850,108723,117177573,7,0,1,103936,2,9079040604
3744,117073110,316652,117389762,8,0,0,512,3,2954569430
3745,117089679,427703,117517382,6,0,0,60416,0,5861047816
3746,117154859,395349,117550208,6,0,0,13824,0,9934934290
3747,117219240,4162,117223402,6,0,1,11264,0,8576863639
3748,117225420,4374,117229794,8,0,1,4608,3,522323044
3749,117291680,566,117292246,8,0,1,512,3,3261346908
3750,117297301,2470,117299771,9,0,1,2560,9,430601404
3751,117305200,16096,117321296,7,0,1,31232,2,4700478952
3752,117310270,13612,117323882,6,0,1,4096,0,9594274385
3753,117322739,295832,117618571,6,0,0,95744,0,3427717099
3754,117367691,10365,117378056,9,0,1,11264,9,2135078754
3755,117385699,203685,117589384,6,0,0,14848,0,5913399478
3756,117397940,123249,117521189,8,0,0,1024,3,5283067886
3757,117398350,3898,117402248,2,0,1,4096,29,10525264697
3758,117410350,76283,117486633,8,0,0,2560,3,5588563333
3759,117442111,19799,117461910,9,0,1,3584,9,9383939915
3760,117465470,153272,117618742,8,0,0,512,3,1556046012
3761,117489930,128827,117618757,7,0,1,187904,2,6641680120
3762,117521070,97702,117618772,7,0,1,7680,2,1973261677
3763,117532230,86557,117618787,2,0,1,20480,29,4824590003
3764,117558060,97723,117655783,8,0,0,1536,3,5117515896
3765,117673320,121388,117794708,4,0,0,3072,10,10145949614
3766,117685321,1994,117687315,9,0,1,2048,9,10544638347
3767,117691330,5712,117697042,2,0,1,14336,29,7990385186
3768,117731060,141256,117872316,4,0,0,512,10,6593847464
3769,117757109,142129,117899238,5,0,0,2048,12,5865451683
3770,117772270,89588,117861858,2,0,0,14336,29,8695166494
3771,117778410,78828,117857238,4,0,0,2560,10,6919220111
3772,117803540,5802,117809342,6,0,1,6144,0,2085751635
3773,117960370,11791,117972161,6,0,1,19456,0,8433551570
3774,117968260,15062,117983322,7,0,1,29184,2,1683778901
3775,117970039,32608,118002647,3,0,1,46080,28,10079474300
3776,117979700,23715,118003415,8,0,1,11776,3,4945884580
3777,118024589,592320,118616909,6,0,0,101888,0,2604144182
3778,118040830,65682,118106512,4,0,0,512,10,1427967067
3779,118045570,67424,118112994,8,0,0,3072,3,133628889
3780,118056919,252323,118309242,6,0,0,56320,0,5056502682
3781,118060630,56034,118116664,4,0,0,3584,10,849249190
3782,118075640,3904,118079544,8,0,1,10752,3,2415239139
3783,118092930,33245,118126175,7,0,1,57856,2,10348849019
3784,118105659,287085,118392744,6,0,0,102400,0,6865000526
3785,118137330,130582,118267912,4,0,0,1024,10,5771444967
3786,118141660,5326,118146986,8,0,1,5632,3,2389243161
3787,118151390,55045,118206435,7,0,1,93696,2,9444493747
3788,118185711,26421,118212132,9,0,1,18944,9,4802883167
3789,118214859,231862,118446721,6,0,0,55296,0,1351368337
3790,118251180,3422,118254602,6,0,1,3584,0,1889008264
3791,118278529,307321,118585850,6,0,0,145408,0,6634461040
3792,118313740,4374,118318114,6,0,1,4608,0,4285413
3793,118332799,299116,118631915,6,0,0,48640,0,7334562356
3794,118352570,40197,118392767,2,0,1,43008,29,3921269480
3795,118372070,23612,118395682,2,0,1,3072,29,1236787659
3796,118430590,17182,118447772,6,0,1,1024,0,7345761214
3797,118435260,34902,118470162,6,0,1,41472,0,4926116418
3798,118489420,127660,118617080,4,0,0,512,10,4548145359
3799,118489600,22174,118511774,7,0,1,36352,2,6883544316
3800,118537400,1994,118539394,2,0,1,2048,29,182771406
3801,118595250,41094,118636344,6,0,1,11776,0,1594658035
3802,118619190,29834,118649024,2,0,1,26112,29,5690235481
3803,118642400,124033,118766433,7,0,1,199168,2,4048499763
3804,118689550,148381,118837931,4,0,0,512,10,6647280809
3805,118692860,74034,118766894,2,0,1,10240,29,10734961694
3806,118739500,38428,118777928,7,0,1,44544,2,2294676625
3807,118898410,99191,118997601,4,0,0,8704,10,7576677126
3808,118903431,6754,118910185,4,0,1,7168,10,2492006868
3809,118925531,22691,118948222,4,0,1,37376,10,8108459300
3810,118938981,9907,118948888,4,0,1,1024,10,4385572323
3811,118958990,2946,118961936,8,0,1,3072,3,1318741190
3812,118975910,181322,119157232,2,0,0,68096,29,5997178504
3813,119032670,11016,119043686,8,0,1,17920,3,5264528160
3814,119041400,6229,119047629,6,0,1,15360,0,9856002056
3815,119044010,92459,119136469,2,0,0,10240,29,10166223257
3816,119077720,181084,119258804,2,0,0,71680,29,1015838944
3817,119119260,4162,119123422,8,0,1,11264,3,9666929480
3818,119166600,105454,119272054,8,0,0,512,3,2660292572
3819,119173171,13341,119186512,4,0,1,22528,10,8139388312
3820,119187560,5454,119193014,2,0,1,13824,29,9682209559
3821,119235620,23199,119258819,7,0,1,35840,2,6189396372
3822,119262680,13341,119276021,8,0,1,22528,3,7187502439
3823,119342940,24929,119367869,7,0,1,45056,2,9581942467
3824,119375500,23120,119398620,7,0,1,41472,2,7110454360
3825,119376650,24556,119401206,8,0,1,4096,3,199681180
3826,119390079,240308,119630387,6,0,0,32768,0,4396132339
3827,119399770,65170,119464940,7,0,1,110080,2,3904838570
3828,119413029,236862,119649891,6,0,0,5632,0,2754658721
3829,119441629,127204,119568833,6,0,0,1024,0,7459764123
3830,119453390,22950,119476340,7,0,1,37888,2,7608980624
3831,119482500,148534,119631034,4,0,0,2048,10,4999542807
3832,119493620,221605,119715225,8,0,0,2048,3,9047219061
3833,119515620,1042,119516662,8,0,1,1024,3,78427845
3834,119516510,11274,119527784,8,0,1,18432,3,6209081144
3835,119552920,7706,119560626,6,0,1,8192,0,8353343616
3836,119620850,16446,119637296,6,0,1,6656,0,6130424080
3837,119626129,90264,119716393,6,0,0,512,0,516447568
3838,119715830,3898,119719728,5,0,1,4096,12,10731610657
3839,119722490,5326,119727816,6,0,1,5632,0,2367387051
3840,119744840,3422,119748262,8,0,1,3584,3,4785140220
3841,119786470,43904,119830374,8,0,0,512,3,2442709392
3842,119804700,43904,119848604,4,0,0,512,10,2913767716
3843,119819460,13858,119833318,6,0,1,23552,0,8860518053
3844,119851950,1042,119852992,6,0,1,1024,0,10277420185
3845,119949500,6229,119955729,6,0,1,15360,0,9993788227
3846,119955910,3422,119959332,6,0,1,3584,0,6076311710
3847,119968349,175120,120143469,6,0,0,2048,0,9628951138
3848,119993960,7706,120001666,6,0,1,8192,0,10607543423
3849,119995600,13730,120009330,2,0,1,21504,29,4742412673
3850,120004130,62867,120066997,8,0,0,1024,3,10629472920
3851,120041460,3422,120044882,6,0,1,3584,0,4012639651
3852,120060730,12049,120072779,2,0,1,19968,29,7292748382
3853,120062430,10810,120073240,6,0,1,10240,0,2910128273
3854,120088870,4850,120093720,8,0,1,5120,3,1002416680
3855,120097359,50672,120148031,6,0,0,2560,0,5831294861
3856,120122990,219929,120342919,2,0,0,148992,29,4673086420
3857,120182750,5196,120187946,8,0,1,13312,3,3732304926
3858,120196620,166123,120362743,2,0,0,52736,29,8924863761
3859,120200570,11016,120211586,8,0,1,17920,3,8868293736
3860,120218610,125424,120344034,8,0,0,3584,3,1099525971
3861,120271180,201300,120472480,2,0,0,51712,29,9512240655
3862,120300110,146240,120446350,2,0,0,15872,29,4324682567
3863,120317210,28376,120345586,2,0,1,1536,29,3176333816
3864,120330670,32088,120362758,8,0,1,9216,3,7511149978
3865,120333509,77447,120410956,6,0,0,1024,0,9935960542
3866,120369869,165006,120534875,6,0,0,512,0,4694191955
3867,120372610,32987,120405597,5,0,1,57344,12,8131893435
3868,120376620,157829,120534449,2,0,0,22016,29,5703113120
3869,120378580,27363,120405943,5,0,1,512,12,533262738
3870,120385931,25299,120411230,4,0,1,16896,10,6297681723
3871,120387830,27586,120415416,5,0,1,6656,12,2414467207
3872,120395860,19902,120415762,5,0,1,512,12,7269339537
3873,120431820,5326,120437146,8,0,1,5632,3,726779513
3874,120454651,17844,120472495,4,0,1,11264,10,410332530
3875,120484430,6278,120490708,5,0,1,6656,12,4778383249
3876,120497919,204525,120702444,6,0,0,1024,0,3549545966
3877,120523740,1994,120525734,2,0,1,2048,29,758979605
3878,120534480,152271,120686751,2,0,0,31232,29,1352648958
3879,120544220,4850,120549070,2,0,1,5120,29,5399857976
3880,120555380,4374,120559754,8,0,1,4608,3,5154288409
3881,120591939,77229,120669168,6,0,0,512,0,10706370593
3882,120648481,12737,120661218,9,0,1,24576,9,3431403706
3883,120661300,329504,120990804,2,0,0,260096,29,10521878554
3884,120672140,14626,120686766,2,0,1,18944,29,4425819472
3885,120700100,6488,120706588,8,0,1,15872,3,5429618978
3886,120725280,183301,120908581,4,0,0,6656,10,8175061457
3887,120831351,4374,120835725,4,0,1,4608,10,630504676
3888,120832080,158895,120990975,8,0,0,512,3,10444815093
3889,120848680,57858,120906538,8,0,0,1536,3,3185013129
3890,120947390,58898,121006288,2,0,1,29696,29,5022300966
3891,121006550,49136,121055686,4,0,0,2560,10,2411094942
3892,121024350,5196,121029546,2,0,1,13312,29,9362083009
3893,121031841,12995,121044836,1,0,1,25088,18,1211584917
3894,121060040,2470,121062510,2,0,1,2560,29,557214787
3895,121067620,2946,121070566,2,0,1,3072,29,4930958746
3896,121114931,1518,121116449,9,0,1,1536,9,9939828462
3897,121224600,4420,121229020,1,0,1,11776,18,10499718562
3898,121236651,6229,121242880,4,0,1,15360,10,4219265136
3899,121315781,4374,121320155,9,0,1,4608,9,9870067662
3900,121333970,69308,121403278,2,0,0,13312,29,7901397458
3901,121355411,23208,121378619,1,0,1,38400,18,5449025084
3902,121357610,72674,121430284,8,0,0,2048,3,5652237193
3903,121384880,58291,121443171,8,0,0,4608,3,2607780296
3904,121396239,234585,121630824,6,0,0,1024,0,8682974805
3905,121404351,5802,121410153,9,0,1,6144,9,5691161165
3906,121409710,47288,121456998,4,0,0,1536,10,833458722
3907,121413260,10241,121423501,8,0,1,16384,3,1633639230
3908,121414340,14718,121429058,1,0,1,17408,18,4950010188
3909,121423070,130752,121553822,4,0,0,2560,10,8685195404
3910,121441510,45596,121487106,8,0,0,1024,3,3863163923
3911,121462199,4162,121466361,0,0,1,11264,20,8621564997
3912,121464799,175776,121640575,6,0,0,3584,0,6539072159
3913,121517410,4420,121521830,8,0,1,11776,3,1883726310
3914,121530710,15837,121546547,8,0,1,30720,3,3839340096
3915,121534470,135984,121670454,4,0,0,1536,10,5823517488
3916,121555240,104468,121659708,2,0,0,43008,29,650718955
3917,121622710,13858,121636568,8,0,1,23552,3,9913794024
3918,121670350,5898,121676248,8,0,1,6144,3,3194111698
3919,121747370,47288,121794658,4,0,0,1536,10,8293873318
3920,121775460,4374,121779834,8,0,1,4608,3,4309517410
3921,121810950,43904,121854854,4,0,0,512,10,5251343788
3922,121829150,134684,121963834,2,0,0,132096,29,5477453957
3923,121934641,32607,121967248,9,0,1,3584,9,6500073512
3924,122010480,43904,122054384,8,0,0,512,3,1304904280
3925,122042911,1042,122043953,1,0,1,1024,18,8583070387
3926,122055010,10241,122065251,7,0,1,16384,2,8328305581
3927,122072600,3645,122076245,1,0,1,10240,18,1226903130
3928,122102740,48315,122151055,4,0,0,512,10,1541556528
3929,122103980,1518,122105498,7,0,1,1536,2,154690712
3930,122115640,146745,122262385,8,0,0,3584,3,3890807576
3931,122116390,117895,122234285,4,0,0,2048,10,2875422547
3932,122149110,1994,122151104,1,0,1,2048,18,4938463179
3933,122152200,33333,122185533,1,0,1,54784,18,5574082983
3934,122157330,28562,122185892,8,0,1,9728,3,6945619807
3935,122371360,3898,122375258,8,0,1,4096,3,7159620225
3936,122424110,144607,122568717,2,0,0,15360,29,9457439621
3937,122438900,91241,122530141,7,0,1,147456,2,9770327727
3938,122449970,85317,122535287,5,0,1,8192,12,7553091541
3939,122456350,79296,122535646,5,0,1,9728,12,6825973088
3940,122458361,81791,122540152,9,0,1,7168,9,4731221281
3941,122468900,86907,122555807,7,0,1,50176,2,5924339137
3942,122469729,89361,122559090,6,0,0,1024,0,9874488824
3943,122511190,98061,122609251,4,0,0,3584,10,6798013526
3944,122533320,177882,122711202,2,0,0,86528,29,7137850404
3945,122542970,14463,122557433,8,0,1,2560,3,1014681379
3946,122553420,4474,122557894,5,0,1,10240,12,5451712652
3947,122591550,271871,122863421,8,0,0,2560,3,8680499839
3948,122606270,7706,122613976,5,0,1,8192,12,318772228
3949,122628651,15321,122643972,9,0,1,29696,9,2464509766
3950,122799200,4850,122804050,8,0,1,5120,3,5173480581
3951,122843140,7230,122850370,5,0,1,7680,12,1204438446
3952,122864939,328996,123193935,6,0,0,5120,0,8652685626
3953,122866910,296228,123163138,2,0,0,198656,29,5380306837
3954,122868499,3645,122872144,0,0,1,10240,20,7876743496
3955,122892391,5802,122898193,9,0,1,6144,9,8007218245
3956,122894380,11016,122905396,8,0,1,17920,3,45523754
3957,122897080,36596,122933676,7,0,1,58880,2,7020501048
3958,122898990,133822,123032812,4,0,0,1536,10,2331155680
3959,122902020,33282,122935302,8,0,1,2560,3,9733997225
3960,122919040,21447,122940487,8,0,1,16384,3,7786155466
3961,122935100,5643,122940743,8,0,1,9216,3,587938595
3962,122936869,125076,123061945,6,0,0,512,0,8885838007
3963,122942221,1042,122943263,9,0,1,1024,9,628777654
3964,122946530,11791,122958321,8,0,1,19456,3,6609554541
3965,122989790,292975,123282765,2,0,0,121856,29,2398535898
3966,123041231,5712,123046943,9,0,1,14336,9,9822773102
3967,123060839,103094,123163933,6,0,0,2560,0,8258221172
3968,123170220,113043,123283263,4,0,0,1536,10,6549417788
3969,123172530,2870,123175400,8,0,1,8704,3,9441751952
3970,123174380,186464,123360844,4,0,0,512,10,3308990095
3971,123183900,11274,123195174,1,0,1,18432,18,2513071230
3972,123229260,6754,123236014,8,0,1,7168,3,3236519940
3973,123232860,235666,123468526,2,0,0,125952,29,9558838577
3974,123243690,39090,123282780,1,0,1,24064,18,2198240175
3975,123299310,5802,123305112,1,0,1,6144,18,4682158156
3976,123349300,5802,123355102,8,0,1,6144,3,7676821949
3977,123401880,5454,123407334,1,0,1,13824,18,7588501527
3978,123492660,1518,123494178,8,0,1,1536,3,7243205449
3979,123509520,145989,123655509,8,0,0,83456,3,5102764699
3980,123516570,1994,123518564,8,0,1,2048,3,5909843986
3981,123550100,162049,123712149,8,0,0,108032,3,5552093341
3982,123579790,14804,123594594,1,0,1,28672,18,7226537536
3983,123603461,6278,123609739,9,0,1,6656,9,6101229415
3984,123633440,34110,123667550,8,0,1,19968,3,7840988289
3985,123715080,5326,123720406,1,0,1,5632,18,10704899390
3986,123725791,4374,123730165,9,0,1,4608,9,9349558312
3987,123752990,141846,123894836,2,0,0,19968,29,181917545
3988,123787630,1042,123788672,8,0,1,1024,3,4290998478
3989,123792780,150216,123942996,8,0,0,62464,3,1257409652
3990,123801880,76052,123877932,8,0,0,10240,3,7017484959
3991,123808620,3645,123812265,8,0,1,10240,3,8966259614
3992,123837200,4374,123841574,8,0,1,4608,3,3889440766
3993,123837940,14483,123852423,1,0,1,26624,18,8956100896
3994,123843860,55121,123898981,8,0,0,2560,3,7070598897
3995,123852820,90815,123943635,4,0,0,2048,10,9659556541
3996,123854390,268846,124123236,2,0,0,80384,29,4717398807
3997,123866560,280958,124147518,8,0,0,43008,3,7170718706
3998,123870240,2470,123872710,8,0,1,2560,3,5264952526
3999,123921049,61191,123982240,6,0,0,512,0,3157329038
4000,123968160,12049,123980209,8,0,1,19968,3,2489647811
4001,123980940,46684,124027624,4,0,0,1024,10,6993183249
4002,124000300,57752,124058052,4,0,0,2560,10,1896530437
4003,124042431,5326,124047757,9,0,1,5632,9,8638818627
4004,124054310,5712,124060022,8,0,1,14336,3,7968182978
4005,124102741,31244,124133985,9,0,1,17408,9,9407726453
4006,124135680,18318,124153998,1,0,1,15872,18,10078513997
4007,124169480,6278,124175758,8,0,1,6656,3,1414571009
4008,124232700,124322,124357022,4,0,0,3584,10,520012552
4009,124235040,115856,124350896,2,0,0,80384,29,7105488702
4010,124246019,125925,124371944,6,0,0,1024,0,1580991715
4011,124252010,54056,124306066,8,0,0,3584,3,7462285804
4012,124261830,566,124262396,8,0,1,512,3,10013143808
4013,124267270,142300,124409570,8,0,0,39936,3,261827932
4014,124320420,171547,124491967,8,0,0,43008,3,4478455829
4015,124340370,14892,124355262,8,0,1,4608,3,7034323593
4016,124352850,144164,124497014,4,0,0,2048,10,10696980779
4017,124387499,46090,124433589,6,0,0,512,0,9975845249
4018,124427280,121412,124548692,8,0,0,9216,3,7200126759
4019,124452460,118386,124570846,8,0,0,5632,3,5031991825
4020,124460870,99164,124560034,4,0,0,25600,10,2756022767
4021,124469340,219317,124688657,8,0,0,52224,3,5168273855
4022,124491570,16743,124508313,8,0,1,31744,3,2089814743
4023,124512649,94291,124606940,6,0,0,1536,0,8982274599
4024,124531310,3387,124534697,8,0,1,9728,3,10514892434
4025,124543090,56638,124599728,2,0,0,3072,29,7527712073
4026,124615119,45596,124660715,6,0,0,1024,0,50168455
4027,124636460,1994,124638454,8,0,1,2048,3,848098170
4028,124661100,5326,124666426,8,0,1,5632,3,3203334346
4029,124664710,138091,124802801,4,0,0,102912,10,9727890490
4030,124772069,79704,124851773,6,0,0,2048,0,2123900255
4031,124773350,34164,124807514,8,0,1,12288,3,9692394651
4032,124785600,146057,124931657,4,0,0,102912,10,5934571557
4033,124815949,138971,124954920,6,0,0,512,0,5159165859
4034,124826230,6278,124832508,8,0,1,6656,3,2006747196
4035,124833999,105929,124939928,3,0,1,176128,28,4050883421
4036,124845359,121617,124966976,3,0,1,96768,28,232575634
4037,124853120,384091,125237211,8,0,0,145920,3,8085641628
4038,124877499,94662,124972161,3,0,1,16384,28,2711109531
4039,124895190,296095,125191285,2,0,0,11264,29,440635038
4040,124901029,336673,125237702,6,0,0,1536,0,2895450094
4041,124924810,200074,125124884,8,0,0,22016,3,7095642869
4042,124937049,45942,124982991,3,0,1,35328,28,7782250526
4043,124993040,420978,125414018,8,0,0,118784,3,9401235679
4044,125059841,3898,125063739,9,0,1,4096,9,4427277279
4045,125076850,2470,125079320,8,0,1,2560,3,7454772819
4046,125088290,7230,125095520,8,0,1,7680,3,10093663922
4047,125187860,227741,125415601,4,0,0,5120,10,3459864041
4048,125215760,395455,125611215,8,0,0,283648,3,4998221464
4049,125252900,376122,125629022,4,0,0,58368,10,9100811197
4050,125266720,461172,125727892,2,0,0,226816,29,7343065026
4051,125280830,5802,125286632,8,0,1,6144,3,2505455598
4052,125285480,20366,125305846,8,0,1,32768,3,7002948231
4053,125301579,5253,125306832,3,0,1,1536,28,10273000248
4054,125318769,189051,125507820,6,0,0,1536,0,10429894552
4055,125322270,11791,125334061,8,0,1,19456,3,8924468294
4056,125382890,271687,125654577,4,0,0,10752,10,9721884410
4057,125456110,277740,125733850,8,0,0,19456,3,4124544247
4058,125472310,11533,125483843,8,0,1,18944,3,1966930300
4059,125503450,239931,125743381,8,0,0,31232,3,7277246797
4060,125544999,200816,125745815,6,0,0,1024,0,5719982251
4061,125593800,287409,125881209,4,0,0,133632,10,8910520469
4062,125615679,112228,125727907,3,0,1,59392,28,9422776737
4063,125719069,188012,125907081,3,0,1,265216,28,7532346474
4064,125725500,186868,125912368,2,0,1,16896,29,8428992351
4065,125731350,181364,125912714,8,0,1,512,3,8030283812
4066,125760639,152536,125913175,0,0,1,10240,20,6342838975
4067,125791819,158772,125950591,3,0,1,121856,28,7901757922
4068,125866890,272826,126139716,8,0,0,70144,3,6375895250
4069,125902560,49311,125951871,8,0,1,14336,3,9033219235
4070,126001320,12566,126013886,5,0,1,20992,12,7287112565
4071,126003960,286803,126290763,4,0,0,66048,10,5846135042
4072,126009909,5971,126015880,0,0,1,14848,20,140146617
4073,126147610,195775,126343385,8,0,0,56320,3,8282779284
4074,126160670,207579,126368249,4,0,0,45056,10,8416559116
4075,126172579,304113,126476692,6,0,0,1536,0,8404158806
4076,126175210,288244,126463454,4,0,0,72192,10,1714204495
4077,126175600,178876,126354476,8,0,0,36352,3,6744803993
4078,126232989,121502,126354491,3,0,1,159744,28,8988636665
4079,126275890,368961,126644851,4,0,0,61440,10,7965232644
4080,126292529,61977,126354506,3,0,1,35840,28,10578405727
4081,126314170,398727,126712897,2,0,0,152576,29,3212787730
4082,126368199,146994,126515193,6,0,0,512,0,1055896849
4083,126399269,26221,126425490,3,0,1,47616,28,123220629
4084,126403050,315798,126718848,8,0,0,19456,3,7058448744
4085,126435330,385573,126820903,8,0,0,117760,3,9505882779
4086,126447650,297545,126745195,8,0,0,2048,3,2937075045
4087,126459009,5980,126464989,0,0,1,1536,20,4768529172
4088,126483979,11533,126495512,0,0,1,18944,20,9614705800
4089,126488830,173664,126662494,2,0,0,57856,29,5584841340
4090,126589840,424768,127014608,4,0,0,291328,10,9128102298
4091,126704059,47047,126751106,0,0,1,52736,20,234377664
4092,126861300,188314,127049614,8,0,0,114176,3,2533921115
4093,126862269,235739,127098008,5,0,0,512,12,7136578793
4094,126865179,149600,127014779,6,0,0,512,0,6147961800
4095,126877770,220067,127097837,4,0,0,61952,10,2744781785
4096,126958709,95714,127054423,3,0,1,5120,28,3374161832
4097,126979179,81213,127060392,5,0,0,1024,12,8529619884
4098,126996189,59364,127055553,0,0,1,11776,20,5529626716
4099,127005190,167076,127172266,8,0,0,46080,3,453489566
4100,127047719,13264,127060983,0,0,1,15360,20,9793193408
4101,127061920,301538,127363458,4,0,0,143872,10,10338681531
4102,127067580,195941,127263521,4,0,0,134656,10,8860101745
4103,127075799,22224,127098023,3,0,1,33280,28,7845687639
4104,127106690,333191,127439881,8,0,0,44544,3,6191239795
4105,127115190,199277,127314467,2,0,0,18432,29,8222435052
4106,127117270,247451,127364721,4,0,0,4096,10,5566148089
4107,127124049,24412,127148461,3,0,1,44032,28,8902918552
4108,127164489,9287,127173776,0,0,1,1536,20,3629207664
4109,127182359,6488,127188847,0,0,1,15872,20,8262814372
4110,127209749,65987,127275736,6,0,0,512,0,6207550539
4111,127227930,337595,127565525,8,0,0,76800,3,731268492
4112,127287899,213516,127501415,3,0,1,345600,28,2154952955
4113,127293630,458782,127752412,2,0,0,62976,29,8549365331
4114,127309950,276674,127586624,4,0,0,512,10,2031450405
4115,127311459,190315,127501774,0,0,1,9728,20,5400411840
4116,127314969,188290,127503259,0,0,1,15360,20,6021367869
4117,127352820,223274,127576094,7,0,1,233984,2,7983926572
4118,127493070,175065,127668135,4,0,0,3584,10,8639610150
4119,127587949,4420,127592369,0,0,1,11776,20,5080808796
4120,127599190,24412,127623602,7,0,1,44032,2,5011212798
4121,127629520,122907,127752427,7,0,1,175616,2,5305538361
4122,127650019,106574,127756593,3,0,1,69632,28,1379835481
4123,127688830,160995,127849825,7,0,1,236544,2,7468752957
4124,127755540,105422,127860962,7,0,1,36864,2,9772133323
4125,127773779,117810,127891589,6,0,0,1024,0,1894103620
4126,127778690,163558,127942248,0,0,0,56320,20,3007350726
4127,127798340,89055,127887395,7,0,1,85504,2,5815108088
4128,127819590,285054,128104644,0,0,0,56320,20,7328454859
4129,127872749,232097,128104846,6,0,0,512,0,2825115400
4130,127894439,5802,127900241,0,0,1,6144,20,5869730534
4131,127958619,146056,128104675,3,0,1,230400,28,1170519514
4132,127968919,159027,128127946,3,0,1,88064,28,7370005790
4133,127970200,330205,128300405,2,0,0,124928,29,10572609701
4134,128010630,523752,128534382,0,0,0,75776,20,10513066847
4135,128030950,380041,128410991,4,0,0,1024,10,4320472439
4136,128045959,93124,128139083,3,0,1,45056,28,3793137488
4137,128058340,597815,128656155,0,0,0,313344,20,9737133912
4138,128070460,69391,128139851,7,0,1,11776,2,6470827794
4139,128084139,178187,128262326,5,0,0,4608,12,9689861359
4140,128090529,209907,128300436,3,0,1,300544,28,9283720870
4141,128093550,270734,128364284,4,0,0,512,10,6152427857
4142,128115219,206463,128321682,3,0,1,102400,28,6504826788
4143,128197320,125988,128323308,7,0,1,2560,2,427919292
4144,128219979,671263,128891242,5,0,0,43520,12,2630385300
4145,128244220,444133,128688353,2,0,0,67584,29,5038343345
4146,128244950,422772,128667722,8,0,0,37888,3,825280535
4147,128269510,265691,128535201,4,0,0,2560,10,165026722
4148,128276380,416548,128692928,2,0,0,3072,29,9692786421
4149,128296080,27689,128323769,7,0,1,10240,2,3581973306
4150,128309229,19046,128328275,0,0,1,7168,20,7368172127
4151,128314620,14001,128328621,7,0,1,512,2,4860596763
4152,128328720,472600,128801320,4,0,0,3584,10,8037897949
4153,128331500,12825,128344325,7,0,1,21504,2,9262221538
4154,128486650,2946,128489596,8,0,1,3072,3,10160878522
4155,128525420,19981,128545401,8,0,1,16384,3,5818517180
4156,128525629,274584,128800213,5,0,0,50688,12,2837856579
4157,128527399,18361,128545760,0,0,1,9728,20,8692424411
4158,128539199,8187,128547386,0,0,1,2560,20,2732086970
4159,128544830,3128,128547958,8,0,1,9216,3,10141680586
4160,128571299,391602,128962901,5,0,0,29696,12,7315706458
4161,128590289,337472,128927761,5,0,0,119808,12,9944264560
4162,128598450,92808,128691258,8,0,1,3072,3,6986328335
4163,128661350,32577,128693927,7,0,1,12288,2,4903051310
4164,128692350,10940,128703290,7,0,1,16384,2,5253886478
4165,128760179,322152,129082331,5,0,0,138240,12,4375183224
4166,128800530,403640,129204170,8,0,0,239104,3,1712597615
4167,128836269,397587,129233856,5,0,0,95232,12,6875577559
4168,128860420,402721,129263141,0,0,0,88064,20,715393615
4169,128885199,43162,128928361,0,0,1,512,20,680087736
4170,128910759,294050,129204809,5,0,0,2048,12,1837380749
4171,128916020,318015,129234035,4,0,0,512,10,7036507949
4172,128932800,366801,129299601,0,0,0,43008,20,4945902170
4173,129013539,220667,129234206,5,0,0,512,12,4428805926
4174,129098219,1994,129100213,0,0,1,2048,20,2253088794
4175,129113419,121442,129234861,5,0,0,2048,12,9895790096
4176,129146510,201503,129348013,4,0,0,2048,10,7339167697
4177,129160461,74925,129235386,4,0,1,512,10,2069289505
4178,129167660,166375,129334035,4,0,0,8704,10,8295748443
4179,129171180,91984,129263164,7,0,1,5120,2,1366835589
4180,129172400,196695,129369095,2,0,0,6656,29,2423864040
4181,129212650,50529,129263179,7,0,1,7168,2,21122608
4182,129237850,179472,129417322,4,0,0,512,10,3668172057
4183,129255130,167268,129422398,4,0,0,2048,10,1359705761
4184,129280540,291117,129571657,8,0,0,192512,3,7305953125
4185,129346420,225572,129571992,4,0,0,1024,10,10069650419
4186,129372660,259099,129631759,2,0,0,161792,29,9005315314
4187,129413100,369499,129782599,8,0,0,162304,3,7189150903
4188,129435120,234533,129669653,4,0,0,2048,10,4159000999
4189,129436419,293942,129730361,5,0,0,2048,12,1859382508
4190,129460909,4679,129465588,0,0,1,12288,20,5201913581
4191,129489630,221321,129710951,2,0,0,30208,29,8073044954
4192,129497029,285765,129782794,5,0,0,512,12,9848652595
4193,129502000,70015,129572015,7,0,1,45568,2,1944243935
4194,129511410,62092,129573502,6,0,1,1536,0,9516419649
4195,129526260,50090,129576350,7,0,1,4096,2,4351347291
4196,129649270,169129,129818399,2,0,0,57856,29,9579925802
4197,129698279,1042,129699321,0,0,1,1024,20,448023490
4198,129705630,180639,129886269,2,0,0,51712,29,1844213236
4199,129709010,437749,130146759,8,0,0,171520,3,7419789984
4200,129719990,6278,129726268,7,0,1,6656,2,4617563334
4201,129731240,100315,129831555,8,0,0,2048,3,7450249458
4202,129740030,50454,129790484,7,0,1,8192,2,9654984595
4203,129752770,187823,129940593,2,0,0,73728,29,243797313
4204,129762820,331664,130094484,8,0,0,128000,3,801085667
4205,129769970,258616,130028586,4,0,0,4096,10,7424992990
4206,129870830,69778,129940608,7,0,1,57344,2,6024015172
4207,129905970,34653,129940623,7,0,1,17408,2,4620786000
4208,130032060,160742,130192802,0,0,0,100352,20,1936666949
4209,130038090,5802,130043892,7,0,1,6144,2,1471376363
4210,130072550,75310,130147860,7,0,1,1024,2,6055761748
4211,130074820,76472,130151292,5,0,1,11264,12,3118649893
4212,130107320,138177,130245497,8,0,0,24064,3,9669413302
4213,130128430,158803,130287233,0,0,0,14848,20,2916865986
4214,130146840,7416,130154256,7,0,1,10240,2,104199104
4215,130178410,15902,130194312,7,0,1,1536,2,7400474110
4216,130250070,334760,130584830,8,0,0,332800,3,9604470938
4217,130251929,162351,130414280,5,0,0,1024,12,8120025710
4218,130268380,316621,130585001,4,0,0,512,10,637499189
4219,130299190,561124,130860314,0,0,0,239616,20,130160704
4220,130312330,273186,130585516,4,0,0,1536,10,8845365973
4221,130326510,33850,130360360,1,0,1,55808,18,4005826323
4222,130360889,295951,130656840,3,0,0,89088,28,10065001945
4223,130363429,293738,130657167,3,0,0,1024,28,3216220444
4224,130397230,206453,130603683,4,0,0,3072,10,5609723261
4225,130411880,375403,130787283,2,0,0,177152,29,7908674027
4226,130446310,155890,130602200,4,0,0,512,10,8099884880
4227,130467550,450741,130918291,2,0,0,86528,29,2003190707
4228,130471240,3645,130474885,6,0,1,10240,0,4787601635
4229,130476710,182664,130659374,4,0,0,512,10,2526147590
4230,130486489,378216,130864705,3,0,0,14336,28,2216902297
4231,130504970,84478,130589448,6,0,1,4096,0,8628128042
4232,130509460,81758,130591218,7,0,1,11776,2,6518079484
4233,130518110,85588,130603698,6,0,1,25088,0,718384961
4234,130564260,40747,130605007,6,0,1,2560,0,7914146405
4235,130566060,45487,130611547,6,0,1,24576,0,8919694812
4236,130576010,290590,130866600,4,0,0,6144,10,5369609260
4237,130695729,11533,130707262,0,0,1,18944,20,5742694325
4238,130695850,226158,130922008,4,0,0,512,10,314111234
4239,130731859,187235,130919094,5,0,0,2560,12,5145723919
4240,130741419,125368,130866787,5,0,0,512,12,2745215903
4241,130801240,70356,130871596,6,0,1,5120,0,3816225274
4242,130820480,192321,131012801,8,0,0,90624,3,992304653
4243,130837360,34582,130871942,6,0,1,512,0,1847839291
4244,130853420,18881,130872301,6,0,1,9728,0,10264983704
4245,130861200,21809,130883009,6,0,1,18944,0,1713840768
4246,130862800,182897,131045697,0,0,0,33792,20,2599371417
4247,130905590,180781,131086371,2,0,0,19968,29,5411980719
4248,130921710,23120,130944830,6,0,1,41472,0,9199789839
4249,130972930,332763,131305693,2,0,0,59392,29,2267012033
4250,130975990,205487,131181477,8,0,0,83968,3,5661762879
4251,131006070,13018,131019088,7,0,1,6656,2,9114432465
4252,131008770,15464,131024234,6,0,1,8192,0,9377732857
4253,131033620,12092,131045712,5,0,1,5632,12,6855164690
4254,131053370,7230,131060600,7,0,1,7680,2,784456933
4255,131080310,9475,131089785,7,0,1,3584,2,6071333105
4256,131092979,188204,131281183,3,0,0,60928,28,5224429313
4257,131132310,275089,131407399,8,0,0,155136,3,7315131655
4258,131172870,9165,131182035,7,0,1,512,2,8987310921
4259,131214919,476251,131691170,5,0,0,512,12,2128442886
4260,131216970,326046,131543016,4,0,0,1024,10,716622099
4261,131221110,190984,131412094,8,0,0,15360,3,4731262729
4262,131223760,11274,131235034,7,0,1,18432,2,6307347598
4263,131244139,93737,131337876,3,0,1,155648,28,8213644216
4264,131262191,77631,131339822,9,0,1,3072,9,7859072961
4265,131276269,75407,131351676,3,0,1,48640,28,8456359137
4266,131339840,202849,131542689,0,0,0,110592,20,1859110231
4267,131418500,510156,131928656,0,0,0,390656,20,1418940658
4268,131423670,588701,132012371,8,0,0,114176,3,1189837767
4269,131427701,22950,131450651,9,0,1,37888,9,2349130645
4270,131457200,520197,131977397,3,0,0,157184,28,5841202306
4271,131527979,401503,131929482,5,0,0,1536,12,8256307767
4272,131558061,4679,131562740,9,0,1,12288,9,10267229251
4273,131648680,2870,131651550,7,0,1,8704,2,245299873
4274,131653420,1042,131654462,7,0,1,1024,2,8321075275
4275,131715190,262378,131977568,4,0,0,512,10,7840231100
4276,131744800,184199,131928999,4,0,0,1024,10,5012748111
4277,131812840,200514,132013354,4,0,0,3072,10,5687562557
4278,131826129,195491,132021620,5,0,0,6144,12,3700766988
4279,131852690,164587,132017277,8,0,0,12800,3,1961957496
4280,131904420,207731,132112151,0,0,0,27648,20,7931940498
4281,131913370,696890,132610260,8,0,0,228352,3,3096711647
4282,131916099,243523,132159622,6,0,0,512,0,8676144090
4283,131937140,292769,132229909,8,0,0,2560,3,2473840610
4284,131980970,178473,132159443,2,0,0,56832,29,10713001285
4285,132003431,26833,132030264,4,0,1,25088,10,8722914816
4286,132046820,362580,132409400,8,0,0,29184,3,3421798730
4287,132067330,161776,132229106,2,0,0,43520,29,8381293576
4288,132067450,632180,132699630,2,0,0,206336,29,10045299488
4289,132069340,3898,132073238,1,0,1,4096,18,5063755348
4290,132118860,209207,132328067,4,0,0,3072,10,9387240609
4291,132125480,4850,132130330,6,0,1,5120,0,6221278170
4292,132145310,317974,132463284,2,0,0,35328,29,7846517243
4293,132163940,464119,132628059,0,0,0,58368,20,10253517007
4294,132166560,576508,132743068,0,0,0,113664,20,8120626004
4295,132178141,3422,132181563,1,0,1,3584,18,896282749
4296,132204660,166976,132371636,4,0,0,1024,10,5003369305
4297,132226419,144374,132370793,5,0,0,1024,12,2036492236
4298,132248480,292181,132540661,8,0,0,99328,3,7362051043
4299,132262401,2470,132264871,1,0,1,2560,18,3540690063
4300,132263480,371318,132634798,8,0,0,22016,3,46748772
4301,132283980,352751,132636731,4,0,0,2048,10,576516467
4302,132360839,275237,132636076,5,0,0,512,12,4946473759
4303,132423601,3898,132427499,9,0,1,4096,9,5656918938
4304,132425430,350013,132775443,2,0,0,103424,29,1533229584
4305,132426830,209075,132635905,4,0,0,3584,10,6704690373
4306,132449430,342282,132791712,8,0,0,52224,3,2242781293
4307,132459920,248501,132708421,3,0,0,28672,28,2953840104
4308,132518399,225472,132743871,5,0,0,2560,12,9352939599
4309,132534080,284340,132818420,3,0,0,13824,28,3550298788
4310,132536070,207816,132743886,1,0,1,2048,18,9462625934
4311,132583420,160481,132743901,1,0,1,9728,18,2445045445
4312,132583830,191940,132775770,4,0,0,1024,10,3130407234
4313,132613311,130605,132743916,9,0,1,6656,9,5549189617
4314,132615381,160404,132775785,9,0,1,3072,9,1214857545
4315,132635819,156384,132792203,5,0,0,1536,12,3561110107
4316,132685030,352853,133037883,0,0,0,283136,20,10254728770
4317,132738711,59253,132797964,9,0,1,6144,9,2821223631
4318,132820369,234782,133055151,3,0,0,7168,28,8670172509
4319,132833199,204879,133038078,5,0,0,512,12,4161190866
4320,132848970,203982,133052952,2,0,0,41472,29,3389249604
4321,132859080,5454,132864534,1,0,1,13824,18,9210546336
4322,132870239,170038,133040277,3,0,0,7168,28,9269591587
4323,132878490,212811,133091301,0,0,0,38912,20,5695849527
4324,132884551,14117,132898668,9,0,1,24064,9,8845640050
4325,132924071,4937,132929008,9,0,1,12800,9,2835539771
4326,132965210,195871,133161081,8,0,0,45568,3,5579098762
4327,132965709,256860,133222569,3,0,0,78336,28,9972170938
4328,132970470,87510,133057980,1,0,1,8704,18,1472958116
4329,133002489,122292,133124781,3,0,0,12800,28,6760737795
4330,133006651,54533,133061184,9,0,1,3584,9,4772476218
4331,133009080,55330,133064410,5,0,1,5120,12,7875835298
4332,133065460,6488,133071948,1,0,1,15872,18,1696788974
4333,133086540,339732,133426272,0,0,0,105984,20,4832774279
4334,133105030,119449,133224479,8,0,0,4096,3,2633672254
4335,133138970,84246,133223216,4,0,0,2048,10,9790688881
4336,133165730,4374,133170104,1,0,1,4608,18,6960780359
4337,133177510,6278,133183788,1,0,1,6656,18,5397061145
4338,133206979,107198,133314177,5,0,0,3584,12,4857201243
4339,133354519,72244,133426763,5,0,0,1536,12,441527930
4340,133375620,120765,133496385,8,0,0,83968,3,8006099278
4341,133387360,167650,133555010,2,0,0,60928,29,5379784635
4342,133399979,116997,133516976,5,0,0,512,12,4023524771
4343,133410440,152073,133562513,4,0,0,24576,10,6519265856
4344,133431829,69590,133501419,5,0,0,3584,12,4598975096
4345,133461000,170384,133631384,8,0,0,93696,3,3705071827
4346,133534789,105949,133640738,3,0,0,17408,28,273576567
4347,133616791,23962,133640753,1,0,1,5632,18,8929948611
4348,133664400,5802,133670202,1,0,1,6144,18,7328964399
4349,133683750,161748,133845498,0,0,0,101888,20,6496233645
4350,133692370,102784,133795154,0,0,0,15360,20,9814219506
4351,133695260,235324,133930584,2,0,0,92672,29,1901456916
4352,133705780,564773,134270553,2,0,0,66560,29,1515433529
4353,133714720,449512,134164232,4,0,0,250368,10,4754162682
4354,133735449,451020,134186469,5,0,0,5120,12,1085939229
4355,133755289,306283,134061572,3,0,0,74752,28,4378024508
4356,133770269,24908,133795177,3,0,1,34816,28,1376958055
4357,133770979,292012,134062991,5,0,0,4608,12,872250429
4358,133783979,380432,134164411,5,0,0,512,12,6911551139
4359,133791060,437856,134228916,4,0,0,139264,10,5706850484
4360,133792970,5631,133798601,1,0,1,3584,18,2550460572
4361,133811990,1042,133813032,1,0,1,1024,18,1307295242
4362,133854260,494970,134349230,8,0,0,123904,3,8063984453
4363,133872070,367813,134239883,2,0,0,35840,29,8574626752
4364,133876440,5196,133881636,1,0,1,13312,18,7431359816
4365,133891400,293462,134184862,4,0,0,67072,10,1787004869
4366,134005259,31783,134037042,3,0,1,51712,28,6791573263
4367,134027681,9617,134037298,4,0,1,9216,10,4035957852
4368,134034440,3904,134038344,1,0,1,10752,18,3182065497
4369,134072420,291801,134364221,0,0,0,49152,20,10680741039
4370,134110739,254472,134365211,5,0,0,1024,12,3387262024
4371,134131389,274807,134406196,3,0,1,291840,28,5526556960
4372,134132929,231955,134364884,5,0,0,2048,12,3112841357
4373,134138109,110667,134248776,5,0,0,1024,12,7105088528
4374,134156120,485334,134641454,2,0,0,150528,29,9968171762
4375,134208290,354462,134562752,0,0,0,16384,20,6037510268
4376,134220590,374937,134595527,8,0,0,107520,3,4684882847
4377,134221529,299941,134521470,3,0,0,40448,28,7780644845
4378,134288650,121092,134409742,1,0,1,5632,18,1168279407
4379,134299119,396496,134695615,3,0,1,536576,28,3745062734
4380,134310090,444647,134754737,8,0,0,31232,3,7194905302
4381,134351219,290414,134641633,5,0,0,512,12,4786426147
4382,134361589,370111,134731700,3,0,1,115200,28,360696596
4383,134369860,658234,135028094,8,0,0,96256,3,4912081090
4384,134416390,327894,134744284,4,0,0,2048,10,8603381423
4385,134421219,751559,135172778,5,0,0,512,12,4706808770
4386,134459989,284778,134744767,5,0,0,1536,12,1044138711
4387,134477000,695607,135172607,2,0,0,314368,29,10425367372
4388,134556580,185356,134741936,4,0,0,14848,10,8230058830
4389,134590040,333837,134923877,8,0,0,48640,3,4220553637
4390,134668120,809254,135477374,4,0,0,100352,10,4171444238
4391,134687020,49506,134736526,6,0,1,7680,0,8878092645
4392,134691410,679327,135370737,8,0,0,87040,3,2631354244
4393,134724800,243861,134968661,0,0,0,34304,20,8975070585
4394,134808130,384400,135192530,8,0,0,33792,3,8838110041
4395,134845689,409293,135254982,5,0,0,67584,12,5473095346
4396,134876870,12308,134889178,6,0,1,20480,0,641506251
4397,134894290,533326,135427616,4,0,0,54272,10,8684290380
4398,134896609,27283,134923892,3,0,1,34816,28,7906732849
4399,134921880,312495,135234375,2,0,0,21504,29,8186810374
4400,134945900,1518,134947418,6,0,1,1536,0,10637648955
4401,134959689,21806,134981495,3,0,1,21504,28,6622052328
4402,134962710,19451,134982161,6,0,1,1024,0,3335605487
4403,134985700,387860,135373560,8,0,0,9216,3,10185414167
4404,134998179,679616,135677795,5,0,0,115712,12,8546327239
4405,135005769,636755,135642524,5,0,0,300032,12,6564579082
4406,135021169,33680,135054849,3,0,1,48640,28,10517136804
4407,135039159,665217,135704376,5,0,0,87040,12,762307956
4408,135039560,15955,135055515,1,0,1,11264,18,6287047102
4409,135049310,9111,135058421,1,0,1,4608,18,5169459720
4410,135060900,3898,135064798,1,0,1,4096,18,4151045073
4411,135121190,599652,135720842,4,0,0,33280,10,10010315571
4412,135124021,68524,135192545,9,0,1,22016,9,7835359133
4413,135194499,1042,135195541,0,0,1,1024,20,287320442
4414,135211379,167196,135378575,3,0,1,275456,28,6700945919
4415,135232490,151231,135383721,7,0,1,8192,2,2919601182
4416,135263849,177206,135441055,3,0,1,192512,28,9291795823
4417,135264019,446660,135710679,5,0,0,20480,12,6757382279
4418,135333050,109183,135442233,1,0,1,13824,18,2596116249
4419,135353579,123810,135477389,3,0,1,39424,28,9438085320
4420,135364180,113224,135477404,1,0,1,4608,18,10114069314
4421,135414460,62975,135477435,8,0,1,16896,3,10257581526
4422,135421769,62221,135483990,3,0,1,80384,28,8513171450
4423,135445310,517294,135962604,8,0,0,57344,3,886561635
4424,135445829,231981,135677810,3,0,1,159232,28,3257274712
4425,135491539,441275,135932814,3,0,0,136192,28,6874767957
4426,135512989,553928,136066917,3,0,0,70656,28,7186430867
4427,135530909,146932,135677841,3,0,1,6144,28,2271656871
4428,135545650,461218,136006868,8,0,0,13312,3,2617250169
4429,135574559,146322,135720881,0,0,1,2560,20,10581970662
4430,135575190,145706,135720896,5,0,1,3584,12,8969202439
4431,135623400,357041,135980441,2,0,0,58368,29,6458687521
4432,135666219,379147,136045366,3,0,0,61440,28,5398418452
4433,135675150,46242,135721392,7,0,1,512,2,8305540581
4434,135678820,45584,135724404,1,0,1,3584,18,7010093909
4435,135683250,469621,136152871,2,0,0,160256,29,973479590
4436,135700869,34304,135735173,0,0,1,22016,20,5961399004
4437,135720940,730524,136451464,8,0,0,171008,3,10647375547
4438,135727480,10919,135738399,8,0,1,5120,3,9828142052
4439,135783420,3422,135786842,1,0,1,3584,18,6898113056
4440,135918829,43790,135962619,3,0,1,20480,28,3926985622
4441,135920170,42472,135962642,1,0,1,19968,18,1399951845
4442,135929469,231857,136161326,5,0,0,27648,12,9998002397
4443,135938100,45453,135983553,5,0,1,9216,12,5664447729
4444,135954430,31774,135986204,1,0,1,3072,18,3050685485
4445,135980130,303142,136283272,0,0,0,84480,20,3779170997
4446,135993730,707186,136700916,8,0,0,16384,3,6446100178
4447,136009590,1042,136010632,1,0,1,1024,18,2171412841
4448,136039270,528549,136567819,2,0,0,83968,29,2404582974
4449,136078900,4374,136083274,1,0,1,4608,18,5862899322
4450,136097490,793024,136890514,2,0,0,281600,29,9038626543
4451,136116160,50837,136166997,5,0,1,14336,12,4157312710
4452,136118710,817958,136936668,0,0,0,87552,20,245406538
4453,136184950,5326,136190276,1,0,1,5632,18,7262235197
4454,136208319,542982,136751301,3,0,0,55808,28,5641342128
4455,136260969,22861,136283830,0,0,1,512,20,10128320582
4456,136286280,4374,136290654,5,0,1,4608,12,7293563339
4457,136297580,2946,136300526,5,0,1,3072,12,1113474281
4458,136317400,10757,136328157,5,0,1,17408,12,319197084
4459,136326270,478421,136804691,4,0,0,142336,10,5024240171
4460,136343549,636822,136980371,5,0,0,143360,12,8049694965
4461,136363839,546130,136909969,3,0,0,63488,28,2168573985
4462,136411999,733655,137145654,5,0,0,50176,12,8161125606
4463,136425220,30702,136455922,1,0,1,4608,18,8972551351
4464,136432250,24089,136456339,1,0,1,9728,18,9222022706
4465,136437559,33419,136470978,3,0,1,29184,28,10193558443
4466,136451020,35962,136486982,2,0,1,36352,29,3229163483
4467,136456770,603458,137060228,0,0,0,152576,20,7725657888
4468,136469019,18424,136487443,3,0,1,10240,28,6618806866
4469,136470850,290450,136761300,4,0,0,32768,10,5223173233
4470,136480799,11470,136492269,0,0,1,7680,20,7141451667
4471,136516619,11016,136527635,0,0,1,17920,20,4049925413
4472,136555910,548603,137104513,4,0,0,25600,10,362599379
4473,136557790,455935,137013725,8,0,0,109056,3,6005200087
4474,136571450,522801,137094251,4,0,0,111616,10,318924530
4475,136600129,1042,136601171,0,0,1,1024,20,4267058445
4476,136671899,6278,136678177,3,0,1,6656,28,834833800
4477,136698030,10108,136708138,1,0,1,7680,18,2543785880
4478,136721670,401787,137123457,2,0,0,61952,29,5269427973
4479,136755470,372838,137128308,0,0,0,15872,20,1831176173
4480,136760899,219535,136980434,0,0,1,2560,20,2336918226
4481,136773369,320905,137094274,3,0,1,10752,28,7361939949
4482,136773440,436609,137210049,4,0,0,2048,10,8963107754
4483,136778130,318529,137096659,0,0,0,7680,20,9150800008
4484,136796080,298209,137094289,5,0,1,11264,12,458210221
4485,136798920,295384,137094304,5,0,1,8192,12,3886318886
4486,136815389,314962,137130351,3,0,0,6656,28,4145785912
4487,136822320,274354,137096674,1,0,1,28672,18,5284904585
4488,136827230,351776,137179006,2,0,0,50688,29,935313293
4489,136827609,276919,137104528,0,0,1,36864,20,2985869524
4490,136828790,275753,137104543,1,0,1,1536,18,7890507602
4491,136833209,376193,137209402,3,0,0,96256,28,8306858644
4492,136848420,256138,137104558,1,0,1,11264,18,5250447297
4493,136853479,420462,137273941,5,0,0,62464,12,5962170235
4494,136894510,251167,137145677,1,0,1,11776,18,2985801337
4495,136899889,245803,137145692,3,0,1,3584,28,5855835478
4496,136912039,233668,137145707,0,0,1,16896,20,4932907499
4497,136912970,453599,137366569,2,0,0,97280,29,10547285740
4498,136921890,525877,137447767,8,0,0,77312,3,7855413104
4499,136973419,751672,137725091,3,0,0,120832,28,7080077100
4500,137036750,604032,137640782,0,0,0,209408,20,9083636834
4501,137094730,586471,137681201,2,0,0,132608,29,7077748058
4502,137121170,29016,137150186,1,0,1,11776,18,727627010
4503,137124119,28880,137152999,0,0,1,10240,20,4904882805
4504,137124570,563682,137688252,2,0,0,23040,29,5670646033
4505,137137190,406283,137543473,2,0,0,40448,29,8805386233
4506,137166870,337682,137504552,8,0,0,14336,3,3863395230
4507,137184250,577896,137762146,4,0,0,5632,10,4884334207
4508,137202149,12312,137214461,3,0,1,11776,28,6114337910
4509,137213609,1518,137215127,0,0,1,1024,20,7375582453
4510,137216030,528780,137744810,0,0,0,64512,20,1790923565
4511,137272619,603665,137876284,5,0,0,66560,12,3103543053
4512,137281070,23725,137304795,5,0,1,39424,12,6615481339
4513,137284810,25682,137310492,5,0,1,18944,12,540518457
4514,137343749,25775,137369524,0,0,1,3072,20,280565527
4515,137364380,532119,137896499,4,0,0,59392,10,7319251503
4516,137376100,477043,137853143,2,0,0,131072,29,7028090287
4517,137404910,42872,137447782,1,0,1,58368,18,4995462551
4518,137445140,319361,137764501,2,0,0,7680,29,1925554860
4519,137484189,4850,137489039,3,0,1,5120,28,9962280840
4520,137495400,3645,137499045,1,0,1,10240,18,9545588273
4521,137496479,8088,137504567,3,0,1,10752,28,7945645456
4522,137498260,7500,137505760,5,0,1,4096,12,4866693754
4523,137500480,7546,137508026,5,0,1,3584,12,2374534165
4524,137519780,6278,137526058,1,0,1,6656,18,6891870153
4525,137542710,519877,138062587,4,0,0,178176,10,5052816996
4526,137560450,1042,137561492,5,0,1,1024,12,6061433916
4527,137571500,1518,137573018,5,0,1,1536,12,6796019252
4528,137601599,144617,137746216,0,0,1,34304,20,1749745583
4529,137602439,144750,137747189,0,0,1,12800,20,10292122157
4530,137627899,724900,138352799,3,0,0,109568,28,5398703964
4531,137673550,73985,137747535,5,0,1,512,12,6173959601
4532,137687230,234147,137921377,0,0,0,2560,20,4141443865
4533,137689859,58662,137748521,0,0,1,1536,20,2471716041
4534,137691220,850968,138542188,0,0,0,306176,20,2611929802
4535,137707980,45687,137753667,5,0,1,8192,12,7049084942
4536,137717990,36138,137754128,1,0,1,10240,18,1507850678
4537,137726060,38456,137764516,1,0,1,16384,18,9682217572
4538,137734019,425066,138159085,3,0,0,14848,28,429807733
4539,137757399,7132,137764531,0,0,1,4096,20,2874296219
4540,137773829,6229,137780058,3,0,1,15360,28,4857892591
4541,137795129,58029,137853158,0,0,1,32768,20,673970635
4542,137800669,648216,138448885,3,0,0,138240,28,120936952
4543,137868860,7982,137876842,5,0,1,512,12,839780251
4544,137893220,4313,137897533,1,0,1,1024,18,8643042136
4545,137946270,566,137946836,1,0,1,512,18,2534992133
4546,137950760,634124,138584884,8,0,0,10752,3,3758389234
4547,137955090,401008,138356098,4,0,0,10752,10,2598357198
4548,137964249,318526,138282775,5,0,0,16384,12,9046272410
4549,137964619,616974,138581593,5,0,0,5632,12,9833992698
4550,137969309,347088,138316397,3,0,0,12288,28,4715715886
4551,137992089,10499,138002588,0,0,1,16896,20,7674314955
4552,138011710,53406,138065116,5,0,1,2560,12,1421338842
4553,138017280,50050,138067330,5,0,1,10752,12,452883325
4554,138017900,555355,138573255,8,0,0,101888,3,6505107215
4555,138038330,691140,138729470,2,0,0,299520,29,8068384898
4556,138078169,515474,138593643,5,0,0,28672,12,10709056637
4557,138170700,409162,138579862,0,0,0,21504,20,9380316440
4558,138179099,427011,138606110,5,0,0,19968,12,2294713399
4559,138197359,578661,138776020,5,0,0,71680,12,3857775524
4560,138209039,4850,138213889,0,0,1,5120,20,3124046764
4561,138248070,551560,138799630,4,0,0,33792,10,7223280463
4562,138260160,716809,138976969,0,0,0,126464,20,674692994
4563,138284999,469166,138754165,3,0,0,80896,28,1562576711
4564,138331860,483877,138815737,4,0,0,52736,10,1867829615
4565,138338930,450389,138789319,0,0,0,43520,20,6769846765
4566,138357529,11533,138369062,0,0,1,18944,20,1982803872
4567,138386710,538734,138925444,0,0,0,18944,20,1055905272
4568,138433760,397156,138830916,0,0,0,49664,20,4202218561
4569,138439099,159829,138598928,0,0,1,5632,20,773539163
4570,138444510,633529,139078039,0,0,0,53760,20,4869254423
4571,138456679,418285,138874964,3,0,0,73728,28,1657097159
4572,138461170,148265,138609435,1,0,1,24064,18,9161427933
4573,138481000,128781,138609781,7,0,1,512,2,442255864
4574,138535339,79268,138614607,0,0,1,7680,20,3635248782
4575,138584840,36488,138621328,7,0,1,24064,2,5586635556
4576,138594360,417724,139012084,0,0,0,115200,20,6039386837
4577,138600909,22365,138623274,0,0,1,3072,20,2165775258
4578,138602070,22190,138624260,1,0,1,1536,18,10128435799
4579,138607539,312118,138919657,3,0,0,89600,28,9826911720
4580,138638260,732210,139370470,0,0,0,288256,20,10607393932
4581,138641700,189239,138830939,1,0,1,4096,18,3263087930
4582,138668360,162594,138830954,1,0,1,5632,18,2097207540
4583,138671470,865962,139537432,8,0,0,239104,3,9042823644
4584,138697509,321462,139018971,5,0,0,22528,12,9234559180
4585,138699309,131676,138830985,0,0,1,2048,20,2420674359
4586,138716350,559008,139275358,2,0,0,51712,29,2975404842
4587,138727640,117093,138844733,1,0,1,23552,18,112506622
4588,138736490,138497,138874987,5,0,1,46080,12,4055040670
4589,138770110,796074,139566184,2,0,0,9728,29,778603390
4590,138779250,397546,139176796,2,0,0,36864,29,6590459451
4591,138814549,592160,139406709,5,0,0,118784,12,6602904400
4592,138845219,29783,138875002,0,0,1,15872,20,1345564489
4593,138862639,14820,138877459,0,0,1,2560,20,9662881296
4594,138871940,9631,138881571,5,0,1,6144,12,4452596142
4595,138883700,41775,138925475,5,0,1,61440,12,3832323011
4596,138909680,554847,139464527,8,0,0,47104,3,72365769
4597,138917719,636296,139554015,5,0,0,54272,12,6379671765
4598,138926920,505427,139432347,8,0,0,83456,3,626362387
4599,138930040,671078,139601118,8,0,0,36864,3,1589538291
4600,138967909,55466,139023375,3,0,1,11776,28,1447485563
4601,139009590,646533,139656123,8,0,0,126976,3,5142855052
4602,139109739,3422,139113161,0,0,1,3584,20,9951952941
4603,139129151,4374,139133525,9,0,1,4608,9,2082535980
4604,139206049,1042,139207091,0,0,1,1024,20,3433173971
4605,139211410,642868,139854278,8,0,0,7168,3,2664027904
4606,139218029,232131,139450160,5,0,0,20992,12,6007941477
4607,139226139,11791,139237930,0,0,1,19456,20,161104841
4608,139237710,169194,139406904,8,0,0,512,3,4500006794
4609,139248620,597492,139846112,8,0,0,63488,3,1066887929
4610,139259590,410176,139669766,8,0,0,4608,3,832367739
4611,139313070,119332,139432402,6,0,1,38400,0,4581359749
4612,139314629,117788,139432417,0,0,1,3072,20,4396291797
4613,139347880,87808,139435688,8,0,1,6144,3,8997268337
4614,139355540,420490,139776030,8,0,0,144896,3,6722668716
4615,139409539,207881,139617420,3,0,0,33792,28,8389899578
4616,139414629,49913,139464542,0,0,1,41984,20,10499503092
4617,139416520,48037,139464557,6,0,1,4608,0,2624109506
4618,139427450,524803,139952253,0,0,0,67584,20,10465554454
4619,139428760,397985,139826745,4,0,0,166400,10,10565062501
4620,139459129,94925,139554054,0,0,1,2048,20,2762118348
4621,139480170,79800,139559970,6,0,1,14848,0,1573755780
4622,139491429,537316,140028745,5,0,0,22016,12,4291370240
4623,139504280,58663,139562943,5,0,1,11776,12,57651771
4624,139518890,47309,139566199,5,0,1,3072,12,7118579490
4625,139562719,582540,140145259,5,0,0,65536,12,1198537450
4626,139617960,45978,139663938,2,0,1,8192,29,3152584209
4627,139638220,26896,139665116,6,0,1,13824,0,2357743216
4628,139638940,30841,139669781,2,0,1,5632,29,3279386716
4629,139643840,287783,139931623,8,0,0,52224,3,1180933605
4630,139647339,246329,139893668,5,0,0,13824,12,1396698282
4631,139649410,202645,139852055,0,0,0,19456,20,6869510827
4632,139667429,200038,139867467,3,0,0,8192,28,5819984711
4633,139686210,1042,139687252,2,0,1,1024,29,3398685069
4634,139692390,196165,139888555,0,0,0,6656,20,7935048894
4635,139752090,115392,139867482,2,0,1,22016,29,7483888408
4636,139812380,55648,139868028,6,0,1,4608,0,2728456246
4637,139837020,35834,139872854,2,0,1,7680,29,4064637414
4638,139851990,298900,140150890,4,0,0,18432,10,9187173689
4639,139858669,357135,140215804,3,0,0,92160,28,588015436
4640,139869320,233813,140103133,4,0,0,77312,10,7105401609
4641,139902030,337349,140239379,4,0,0,38400,10,245004754
4642,139912850,18788,139931638,2,0,1,10240,29,2425722564
4643,139918100,36982,139955082,6,0,1,8704,0,5385956756
4644,139943860,335052,140278912,0,0,0,73728,20,2314308874
4645,139969300,4937,139974237,2,0,1,12800,29,5485036383
4646,139976860,6754,139983614,6,0,1,7168,0,2144285858
4647,140008490,52364,140060854,2,0,0,3072,29,5016002258
4648,140018570,13341,140031911,5,0,1,22528,12,5882387144
4649,140037280,3645,140040925,6,0,1,10240,0,3800394382
4650,140064700,1518,140066218,2,0,1,1536,29,7023666040
4651,140095970,20238,140116208,5,0,1,22016,12,8163713942
4652,140115980,163587,140279567,2,0,0,2048,29,4389626343
4653,140130050,26634,140156684,2,0,1,6144,29,9440234829
4654,140243290,179269,140422559,2,0,0,34304,29,9531946070
4655,140266020,280174,140546194,0,0,0,44032,20,6582655945
4656,140268529,132129,140400658,3,0,0,50688,28,694055947
4657,140273920,10506,140284426,7,0,1,5120,2,10570575828
4658,140278420,582649,140861069,8,0,0,70656,3,3423166538
4659,140287640,645692,140933332,2,0,0,131072,29,431531175
4660,140295940,4162,140300102,7,0,1,11264,2,740980208
4661,140327340,566,140327906,7,0,1,512,2,7217689089
4662,140342750,4679,140347429,5,0,1,12288,12,6154991008
4663,140364580,2946,140367526,6,0,1,3072,0,7016116751
4664,140378800,261475,140640275,2,0,0,512,29,6933920095
4665,140384750,454776,140839526,4,0,0,311808,10,7674397902
4666,140392180,352327,140744507,4,0,0,85504,10,884943981
4667,140398540,612409,141010949,4,0,0,162816,10,10672726070
4668,140417359,476007,140893366,3,0,0,18944,28,394215197
4669,140470880,3898,140474778,6,0,1,4096,0,4312560852
4670,140518070,2470,140520540,2,0,1,2560,29,5278600836
4671,140537140,610613,141147753,8,0,0,263168,3,6820834477
4672,140542350,612298,141154648,2,0,0,22528,29,1798142739
4673,140548160,519386,141067546,4,0,0,108544,10,3838511807
4674,140608100,6278,140614378,5,0,1,6656,12,3432535570
4675,140615890,591405,141207295,4,0,0,33792,10,1638269651
4676,140671280,525704,141196984,8,0,0,132096,3,1749498318
4677,140680770,11533,140692303,6,0,1,18944,0,7852784518
4678,140685100,11709,140696809,2,0,1,7168,29,532706272
4679,140775030,86664,140861694,6,0,1,512,0,10322881758
4680,140818310,50680,140868990,6,0,1,8192,0,653674515
4681,140824170,45166,140869336,5,0,1,512,12,3580347932
4682,140855810,365348,141221158,2,0,0,30720,29,171188157
4683,140889380,492008,141381388,4,0,0,136192,10,3333956803
4684,140923530,15523,140939053,5,0,1,14336,12,1339272839
4685,140928150,11569,140939719,5,0,1,1024,12,10565420778
4686,140937750,21202,140958952,5,0,1,33792,12,1524935746
4687,140947610,280196,141227806,4,0,0,15360,10,5653008576
4688,140974330,41307,141015637,5,0,1,12288,12,7020401670
4689,141004830,20113,141024943,5,0,1,16384,12,9440689731
4690,141034551,120128,141154679,9,0,1,9216,9,1365803243
4691,141086699,308120,141394819,3,0,0,44032,28,789486173
4692,141116770,366204,141482974,2,0,0,19456,29,9663390913
4693,141135429,285811,141421240,3,0,0,37888,28,7936388585
4694,141167741,42534,141210275,9,0,1,3072,9,10618126670
4695,141176310,510182,141686492,4,0,0,331776,10,3449035909
4696,141198180,87825,141286005,2,0,0,9728,29,723106053
4697,141222951,34367,141257318,9,0,1,56832,9,272238196
4698,141307109,403780,141710889,3,0,0,17408,28,10216892301
4699,141338350,247039,141585389,4,0,0,80384,10,3479306021
4700,141390429,7821,141398250,3,0,1,3584,28,1596042651
4701,141391420,380950,141772370,0,0,0,50688,20,19225939
4702,141429621,7706,141437327,9,0,1,8192,9,6725498800
4703,141439110,266452,141705562,4,0,0,51712,10,10164803189
4704,141443541,13858,141457399,9,0,1,23552,9,10263800514
4705,141530040,159743,141689783,2,0,0,10752,29,5455527191
4706,141548849,175044,141723893,3,0,0,17408,28,3748931319
4707,141642141,69749,141711890,9,0,1,1024,9,98720177
4708,141662871,54285,141717156,9,0,1,14848,9,384866999
4709,141702051,21865,141723916,9,0,1,6656,9,5387189442
4710,141717910,144364,141862274,4,0,0,46080,10,9827631021
4711,141719189,257661,141976850,3,0,0,126976,28,8625961545
4712,141725161,10757,141735918,9,0,1,17408,9,4318358268
4713,141805551,5326,141810877,9,0,1,5632,9,1094230939
4714,141859230,123563,141982793,4,0,0,19456,10,383869042
4715,141900331,1994,141902325,9,0,1,2048,9,7071554119
4716,141974871,10784,141985655,9,0,1,8704,9,4679653352
4717,141988550,6754,141995304,2,0,1,7168,29,3173983842
4718,142012320,139760,142152080,8,0,0,133632,3,9646629959
4719,142020230,178188,142198418,2,0,0,82944,29,9298841721
4720,142071430,204964,142276394,8,0,0,24064,3,9587878137
4721,142128530,305220,142433750,4,0,0,202752,10,2216444312
4722,142147200,164672,142311872,4,0,0,30720,10,1718283288
4723,142164580,197479,142362059,0,0,0,34304,20,7850064444
4724,142181691,19707,142201398,9,0,1,3072,9,1576707166
4725,142184500,37579,142222079,2,0,1,37376,29,8785317916
4726,142184980,40645,142225625,2,0,1,5632,29,10257429267
4727,142229690,4679,142234369,5,0,1,12288,12,9993195496
4728,142271499,300841,142572340,3,0,0,30208,28,1594722067
4729,142328180,173760,142501940,0,0,0,128000,20,5073694326
4730,142362970,165349,142528319,2,0,0,33280,29,728120622
4731,142422330,25458,142447788,1,0,1,27136,18,9886899603
4732,142423230,29384,142452614,1,0,1,7680,18,8841792685
4733,142461109,173955,142635064,3,0,0,74752,28,10139241958
4734,142485210,224620,142709830,8,0,0,92160,3,8631548714
4735,142499131,16167,142515298,9,0,1,22528,9,8582675620
4736,142510740,17594,142528334,7,0,1,6656,2,9949892736
4737,142554090,237130,142791220,8,0,0,104960,3,4806132461
4738,142558890,266410,142825300,0,0,0,4608,20,7517925517
4739,142621960,254575,142876535,2,0,0,100352,29,9883635537
4740,142673190,3422,142676612,1,0,1,3584,18,2303171143
4741,142679920,29925,142709845,1,0,1,6144,18,7217384603
4742,142695031,21084,142716115,9,0,1,6656,9,9968845229
4743,142735460,95858,142831318,8,0,0,3072,3,1126217576
4744,142762530,31169,142793699,1,0,1,2560,18,7313978014
4745,142767180,28785,142795965,1,0,1,3584,18,2398731486
4746,142814420,123598,142938018,4,0,0,43008,10,2707448106
4747,142826810,14029,142840839,1,0,1,27136,18,9148568190
4748,142850360,422759,143273119,8,0,0,65024,3,6815569762
4749,142880199,612324,143492523,3,0,0,113664,28,4628994617
4750,142916300,500735,143417035,4,0,0,342016,10,7941613186
4751,142960669,292623,143253292,3,0,0,22528,28,97633428
4752,142987470,12825,143000295,1,0,1,21504,18,1933991898
4753,142996310,189317,143185627,2,0,0,10240,29,5502183210
4754,143002710,14117,143016827,1,0,1,24064,18,4440496986
4755,143020190,292622,143312812,2,0,0,71680,29,2383934315
4756,143108540,11274,143119814,1,0,1,18432,18,1742276150
4757,143111130,309508,143420638,0,0,0,11776,20,5448924363
4758,143115750,330831,143446581,0,0,0,84992,20,6202408941
4759,143148190,309654,143457844,4,0,0,36864,10,4152742057
4760,143177960,450097,143628057,8,0,0,68608,3,7459658458
4761,143188800,526643,143715443,2,0,0,38400,29,1452491805
4762,143201330,687749,143889079,2,0,0,163328,29,2224981310
4763,143220630,11274,143231904,1,0,1,18432,18,10200668823
4764,143222380,516213,143738593,4,0,0,48640,10,6924453922
4765,143227039,380091,143607130,3,0,0,86528,28,5026868988
4766,143240390,5326,143245716,1,0,1,5632,18,6321370353
4767,143249790,719870,143969660,0,0,0,181248,20,6136960116
4768,143278289,395178,143673467,3,0,0,61952,28,704513818
4769,143305349,489816,143795165,3,0,0,31744,28,6248797742
4770,143321169,171401,143492570,3,0,1,4608,28,6630966098
4771,143321570,171015,143492585,1,0,1,8704,18,715577046
4772,143342411,150189,143492600,9,0,1,6656,9,7868653383
4773,143406730,98368,143505098,1,0,1,20992,18,103945266
4774,143410270,342536,143752806,0,0,0,2560,20,6535062066
4775,143424160,648412,144072572,8,0,0,117248,3,6796660516
4776,143427620,78554,143506174,5,0,1,13312,12,5513063432
4777,143443540,306180,143749720,8,0,0,15872,3,10569388184
4778,143447630,59530,143507160,1,0,1,1536,18,6780770726
4779,143525710,454175,143979885,2,0,0,33280,29,10525201402
4780,143595559,318838,143914397,3,0,0,51200,28,9507345002
4781,143613841,24707,143638548,9,0,1,16896,9,954514413
4782,143639320,259446,143898766,2,0,0,31744,29,5408873223
4783,143648481,25001,143673482,9,0,1,16896,9,6928919628
4784,143744880,7941,143752821,1,0,1,8704,18,3833972090
4785,143779910,256923,144036833,2,0,0,28160,29,3467147271
4786,143786500,15887,143802387,8,0,1,7680,3,9580067482
4787,143803799,361752,144165551,3,0,0,217600,28,4156328916
4788,143871821,97870,143969691,9,0,1,16384,9,3436110066
4789,143877850,91856,143969706,1,0,1,8704,18,2859162856
4790,143898341,81567,143979908,9,0,1,13312,9,10728892872
4791,143906590,270060,144176650,4,0,0,36352,10,2934197388
4792,143928550,508357,144436907,0,0,0,289280,20,6203983901
4793,143940670,512336,144453006,2,0,0,52736,29,9637659256
4794,143950891,36183,143987074,9,0,1,7680,9,501965310
4795,143991160,14287,144005447,1,0,1,27648,18,8500135709
4796,144054571,28251,144082822,9,0,1,16384,9,1639549059
4797,144071930,19930,144091860,1,0,1,27648,18,5465367334
4798,144086400,5921,144092321,8,0,1,10240,3,4534394248
4799,144120440,63474,144183914,8,0,1,7680,3,8685087954
4800,144134280,422882,144557162,4,0,0,46080,10,10653572923
4801,144139020,46520,144185540,8,0,1,2560,3,1350422468
4802,144157180,354739,144511919,2,0,0,153600,29,5089516281
4803,144204330,566,144204896,8,0,1,512,3,7019411576
4804,144211090,332017,144543107,2,0,0,89600,29,4292405993
4805,144220851,5971,144226822,9,0,1,14848,9,7570263564
4806,144231790,11274,144243064,8,0,1,18432,3,3907358344
4807,144288281,3422,144291703,9,0,1,3584,9,735818336
4808,144296090,10241,144306331,8,0,1,16384,3,8955542414
4809,144334870,374384,144709254,0,0,0,93184,20,4427593243
4810,144355760,391093,144746853,0,0,0,12800,20,8489121096
4811,144360600,378539,144739139,2,0,0,41984,29,2370192607
4812,144378791,133143,144511934,9,0,1,22016,9,8744936643
4813,144395859,377537,144773396,3,0,0,87040,28,2097017792
4814,144543281,25423,144568704,9,0,1,18944,9,9479098952
4815,144549610,19440,144569050,1,0,1,512,18,1119687333
4816,144572541,3387,144575928,9,0,1,9728,9,4661357096
4817,144597721,12566,144610287,9,0,1,20992,9,6440998018
4818,144628790,1042,144629832,1,0,1,1024,18,19652397
4819,144744049,119844,144863893,3,0,0,53248,28,5935086378
4820,144900109,104312,145004421,3,0,0,42496,28,5887241079
4821,145001421,13749,145015170,9,0,1,17408,9,9305677599
4822,145013720,115930,145129650,0,0,0,52224,20,3231257283
4823,145052019,131575,145183594,3,0,0,29696,28,2564039647
4824,145055981,7230,145063211,9,0,1,7680,9,8750728519
4825,145060050,374296,145434346,8,0,0,195072,3,6812910097
4826,145071710,161492,145233202,2,0,0,61440,29,4580610533
4827,145091519,150442,145241961,3,0,0,28672,28,286598711
4828,145111900,375000,145486900,8,0,0,109056,3,1929008723
4829,145132140,3422,145135562,1,0,1,3584,18,8256950598
4830,145134041,1867,145135908,9,0,1,512,9,5137993782
4831,145164040,127188,145291228,0,0,0,31744,20,6616786364
4832,145165811,4937,145170748,9,0,1,12800,9,2014253469
4833,145209771,2470,145212241,9,0,1,2560,9,1226874590
4834,145218440,306227,145524667,0,0,0,123904,20,10011618550
4835,145250990,188519,145439509,4,0,0,16896,10,4189915241
4836,145267441,4679,145272120,9,0,1,12288,9,3560771015
4837,145315310,4162,145319472,1,0,1,11264,18,5612656810
4838,145327080,224294,145551374,2,0,0,87552,29,244703154
4839,145403870,267957,145671827,4,0,0,12288,10,5899760126
4840,145420530,247538,145668068,2,0,0,60928,29,3596094592
4841,145437600,189052,145626652,4,0,0,121856,10,10281711743
4842,145467781,90306,145558087,9,0,1,7168,9,9975250176
4843,145504020,206549,145710569,0,0,0,26112,20,2737636626
4844,145631851,2870,145634721,9,0,1,8704,9,747120092
4845,145670051,4714,145674765,9,0,1,3072,9,8683637216
4846,145678691,13083,145691774,9,0,1,22016,9,8742523275
4847,145743420,315046,146058466,0,0,0,259584,20,5894717121
4848,145808391,1042,145809433,9,0,1,1024,9,7566507501
4849,145818449,250640,146069089,3,0,0,34816,28,2533789054
4850,145835701,11274,145846975,9,0,1,18432,9,7112234197
4851,145867970,232224,146100194,4,0,0,38400,10,3117963629
4852,145907270,178214,146085484,2,0,0,53760,29,3111732977
4853,145959900,128579,146088479,2,0,0,9728,29,8598902283
4854,145974880,131577,146106457,0,0,0,20480,20,249116944
4855,146010090,154090,146164180,2,0,0,18944,29,10645760135
4856,146043599,196223,146239822,3,0,0,59392,28,6477444510
4857,146057610,146888,146204498,2,0,0,42496,29,6770080821
4858,146119639,141833,146261472,3,0,0,41472,28,1936796423
4859,146186570,2470,146189040,2,0,1,2560,29,9684968631
4860,146207410,128036,146335446,8,0,0,86528,3,3667276293
4861,146247221,14266,146261487,9,0,1,10240,9,9945214389
4862,146259970,123938,146383908,4,0,0,62976,10,9032861592
4863,146297890,262783,146560673,0,0,0,97792,20,6418682088
4864,146325520,140318,146465838,0,0,0,68608,20,9155903443
4865,146341209,311079,146652288,3,0,0,189440,28,10596676628
4866,146406060,161336,146567396,4,0,0,22016,10,3772278931
4867,146408280,475348,146883628,8,0,0,67584,3,7390496232
4868,146411649,566,146412215,0,0,1,512,20,4668180549
4869,146506839,173440,146680279,3,0,0,47104,28,1300106335
4870,146515289,347732,146863021,3,0,0,96256,28,791404804
4871,146524389,416193,146940582,3,0,0,98816,28,10522424376
4872,146574990,422111,146997101,2,0,0,53248,29,1619667108
4873,146586370,865885,147452255,4,0,0,333824,10,1373183345
4874,146586650,472061,147058711,2,0,0,187904,29,6161956598
4875,146605669,563871,147169540,3,0,0,57344,28,7492862104
4876,146610851,69443,146680294,9,0,1,28160,9,4539066727
4877,146649320,622137,147271457,4,0,0,69632,10,4528920156
4878,146656010,496019,147152029,8,0,0,99840,3,3309745618
4879,146752631,1994,146754625,9,0,1,2048,9,8724192945
4880,146802230,307691,147109921,4,0,0,128000,10,7205848355
4881,146819650,417727,147237377,2,0,0,48128,29,3963551621
4882,146852220,324690,147176910,0,0,0,5120,20,10284609582
4883,146893440,728438,147621878,4,0,0,102400,10,8126344539
4884,146910000,289571,147199571,4,0,0,29184,10,6054071538
4885,146926061,28647,146954708,9,0,1,24064,9,8158646934
4886,146935271,25338,146960609,9,0,1,19968,9,4007455084
4887,146957430,331980,147289410,4,0,0,35328,10,5021111040
4888,146986241,72485,147058726,9,0,1,12288,9,1624801879
4889,146995730,322173,147317903,8,0,0,9216,3,1677583539
4890,147025170,36987,147062157,6,0,1,3584,0,9442761914
4891,147041400,417430,147458830,0,0,0,21504,20,4777114765
4892,147064169,422912,147487081,3,0,0,92672,28,22185447
4893,147075110,458037,147533147,8,0,0,43008,3,3825058222
4894,147136559,454058,147590617,3,0,0,146432,28,10187969758
4895,147141940,404046,147545986,4,0,0,41984,10,10681443404
4896,147145311,35979,147181290,9,0,1,19456,9,2912662707
4897,147194170,325858,147520028,8,0,0,108032,3,3372498120
4898,147318820,314796,147633616,0,0,0,38400,20,944514750
4899,147326190,1518,147327708,6,0,1,1536,0,3571166673
4900,147333751,2946,147336697,9,0,1,3072,9,1136095772
4901,147350640,290807,147641447,4,0,0,25600,10,7989697124
4902,147410241,180391,147590632,9,0,1,6144,9,3502078381
4903,147413700,176955,147590655,6,0,1,15872,0,9278099544
4904,147490110,226450,147716560,4,0,0,7680,10,6457548911
4905,147492310,129591,147621901,6,0,1,9216,0,8830572692
4906,147544691,96771,147641462,9,0,1,6144,9,5161072450
4907,147610960,138722,147749682,2,0,0,68608,29,9094914529
4908,147612510,176656,147789166,4,0,0,23040,10,7631879759
4909,147760999,171561,147932560,3,0,0,130560,28,9016908049
4910,147791810,257813,148049623,4,0,0,100864,10,3698661991
4911,147808530,210346,148018876,8,0,0,96256,3,4666890570
4912,147864580,196149,148060729,2,0,0,30208,29,4183075305
4913,147891771,40804,147932575,9,0,1,25600,9,7134802428
4914,147929750,133787,148063537,2,0,0,7680,29,5908277290
4915,147934020,155947,148089967,0,0,0,2560,20,4292580388
4916,147951539,99971,148051510,3,0,0,6144,28,3810919359
4917,147971700,223609,148195309,2,0,0,120320,29,5425434489
4918,147972350,5326,147977676,6,0,1,5632,0,2530877199
4919,148058130,223871,148282001,4,0,0,66560,10,7018316234
4920,148073741,13858,148087599,9,0,1,23552,9,5784395355
4921,148096910,101082,148197992,0,0,0,8704,20,8606014067
4922,148097400,222883,148320283,8,0,0,33792,3,6293598542
4923,148134920,175036,148309956,2,0,0,91648,29,5263531331
4924,148177690,233673,148411363,2,0,0,84992,29,6564741057
4925,148184830,194701,148379531,0,0,0,512,20,4279793773
4926,148202460,173969,148376429,2,0,0,1536,29,4869169370
4927,148220490,255617,148476107,8,0,0,156160,3,2884929655
4928,148271999,496104,148768103,3,0,0,231936,28,9536077170
4929,148273221,53048,148326269,9,0,1,31744,9,3909892388
4930,148286030,264783,148550813,2,0,0,62464,29,9455354429
4931,148333369,250168,148583537,3,0,0,64000,28,6129779466
4932,148355781,10757,148366538,9,0,1,17408,9,7155019306
4933,148388140,38553,148426693,6,0,1,29696,0,6750257619
4934,148403000,366054,148769054,4,0,0,3072,10,156995356
4935,148419300,377501,148796801,2,0,0,22528,29,3152566052
4936,148471410,548200,149019610,8,0,0,200704,3,1588992211
4937,148501650,566,148502216,6,0,1,512,0,195410049
4938,148509480,3128,148512608,6,0,1,9216,0,8466211898
4939,148512869,409531,148922400,3,0,0,124928,28,6037594284
4940,148524990,25838,148550828,6,0,1,28672,0,4498760073
4941,148579820,250120,148829940,8,0,0,46080,3,1496770626
4942,148611150,3898,148615048,6,0,1,4096,0,4547256315
4943,148615150,3422,148618572,6,0,1,3584,0,7475167397
4944,148655490,294575,148950065,4,0,0,10752,10,9203343835
4945,148669820,276954,148946774,0,0,0,52224,20,5007709645
4946,148692790,238057,148930847,4,0,0,27648,10,7008317880
4947,148721500,608076,149329576,4,0,0,51200,10,1585499330
4948,148741159,702061,149443220,3,0,0,91136,28,3945259403
4949,148792659,494455,149287114,3,0,0,269824,28,10481187363
4950,148812970,500991,149313961,8,0,0,88064,3,4206610569
4951,148890290,514672,149404962,8,0,0,100864,3,9741693190
4952,148984380,389827,149374207,8,0,0,146432,3,5763924226
4953,149013300,402129,149415429,2,0,0,34304,29,8574261988
4954,149046461,1994,149048455,4,0,1,2048,10,7266545241
4955,149127480,333227,149460707,2,0,0,57344,29,9395094226
4956,149138860,4850,149143710,2,0,1,5120,29,1480493914
4957,149199350,294006,149493356,2,0,0,57344,29,799444120
4958,149318950,194590,149513540,8,0,0,37888,3,7115637506
4959,149364790,343336,149708126,0,0,0,287232,20,804178846
4960,149545769,182943,149728712,3,0,0,51200,28,1983264429
4961,149574619,228827,149803446,3,0,0,87040,28,9872317808
4962,149583680,193231,149776911,2,0,0,78848,29,6506256977
4963,149616970,296885,149913855,2,0,0,100352,29,2747280654
4964,149622120,426657,150048777,8,0,0,120832,3,4082384975
4965,149636980,584642,150221622,4,0,0,90624,10,6861793037
4966,149664050,265888,149929938,4,0,0,52736,10,1175727743
4967,149682310,803597,150485907,0,0,0,95232,20,5365835394
4968,149834469,359526,150193995,3,0,0,79872,28,3421439547
4969,149901180,268371,150169551,8,0,0,9728,3,8169367847
4970,149901610,791810,150693420,2,0,0,317440,29,1679565400
4971,149981020,457313,150438333,2,0,0,326144,29,9446835511
4972,150117910,478775,150596685,0,0,0,112640,20,4758068630
4973,150164900,323674,150488574,4,0,0,8704,10,2594267694
4974,150220689,226723,150447412,3,0,0,29696,28,7113444352
4975,150220940,297847,150518787,2,0,0,19968,29,1467370946
4976,150230569,591775,150822344,3,0,0,123904,28,8368017805
4977,150237659,507256,150744915,3,0,0,168960,28,3363340772
4978,150285710,239767,150525477,2,0,0,12800,29,1231200582
4979,150341630,109163,150450793,5,0,1,3584,12,5338004727
4980,150404730,343796,150748526,0,0,0,11776,20,7355523954
4981,150448950,335627,150784577,4,0,0,118272,10,2287804501
4982,150489590,398827,150888417,4,0,0,187904,10,5265060788
4983,150528890,455977,150984867,0,0,0,276480,20,1177251188
4984,150612110,554773,151166883,0,0,0,261632,20,3944894652
4985,150819569,200429,151019998,3,0,0,115200,28,4618302993
4986,150864650,334462,151199112,8,0,0,47104,3,628912440
4987,150888869,286172,151175041,3,0,0,25600,28,8759893276
4988,150937400,86480,151023880,2,0,1,4096,29,7999857324
4989,150941100,226126,151167226,4,0,0,1024,10,5432851645
4990,150980221,54546,151034767,4,0,1,26112,10,2601784417
4991,151002770,217633,151220403,2,0,0,2048,29,10294858070
4992,151022551,13522,151036073,4,0,1,2048,10,3682591865
4993,151081140,160885,151242025,8,0,0,10752,3,3363638349
4994,151100890,196296,151297186,0,0,0,5632,20,4976986673
4995,151103559,320767,151424326,3,0,0,160768,28,5592797315
4996,151164770,166178,151330948,8,0,0,72192,3,7806518386
4997,151201140,244113,151445253,8,0,0,68608,3,5030714297
4998,151248831,10499,151259330,4,0,1,16896,10,9170909683
4999,151297741,10499,151308240,9,0,1,16896,9,3715645256
5000,151313450,20877,151334327,2,0,1,9728,29,4819259590
5001,151353250,135900,151489150,8,0,0,48640,3,1973244936
5002,151399470,150130,151549600,0,0,0,59392,20,4744908210
5003,151448800,360901,151809701,0,0,0,77824,20,9159732112
5004,151480941,11605,151492546,4,0,1,9728,10,10197623370
5005,151481500,491563,151973063,2,0,0,219648,29,7702428278
5006,151508929,199455,151708384,3,0,0,76800,28,1026705066
5007,151518620,317936,151836556,2,0,0,88064,29,8113417925
5008,151541851,11903,151553754,4,0,1,11264,10,6386341441
5009,151551681,6242,151557923,9,0,1,5120,9,9586759942
5010,151567431,3645,151571076,9,0,1,10240,9,6097035055
5011,151606861,3387,151610248,4,0,1,9728,10,2654531924
5012,151629939,450506,152080445,3,0,0,182784,28,4177646795
5013,151689640,292198,151981838,4,0,0,28672,10,3702918309
5014,151694530,159144,151853674,8,0,0,3584,3,8535039883
5015,151701620,421934,152123554,8,0,0,87552,3,8414950138
5016,151729081,5802,151734883,4,0,1,6144,10,1704739174
5017,151736980,359860,152096840,2,0,0,53760,29,4640316816
5018,151751080,409135,152160215,2,0,0,55296,29,5543443676
5019,151751731,1042,151752773,9,0,1,1024,9,4291048232
5020,151781621,4162,151785783,4,0,1,11264,10,6691310659
5021,151795110,44351,151839461,6,0,1,3072,0,1746514826
5022,151815840,441729,152257569,8,0,0,56832,3,3731460317
5023,151837600,481297,152318897,0,0,0,181760,20,6540550340
5024,151839589,158224,151997813,3,0,0,52224,28,5320024152
5025,151872620,550420,152423040,8,0,0,32256,3,3547700193
5026,151920660,415420,152336080,0,0,0,56320,20,5552254246
5027,151922981,74871,151997852,4,0,1,2560,10,3710248043
5028,151926291,71576,151997867,9,0,1,1536,9,2494542817
5029,151930910,423749,152354659,2,0,0,60928,29,3873217718
5030,151933801,76279,152010080,4,0,1,20480,10,603745741
5031,151936501,74245,152010746,9,0,1,1024,9,8674590718
5032,151970121,48320,152018441,9,0,1,24064,9,3962841901
5033,152022881,73974,152096855,9,0,1,4608,9,4569176753
5034,152028701,98999,152127700,9,0,1,11264,9,4395957112
5035,152084161,76069,152160230,4,0,1,36864,10,2215098373
5036,152097621,62624,152160245,9,0,1,14336,9,6894824693
5037,152155309,398178,152553487,3,0,0,9216,28,10097973069
5038,152177990,372674,152550664,0,0,0,2560,20,10561336346
5039,152183711,4162,152187873,4,0,1,11264,10,1676760888
5040,152184080,17141,152201221,7,0,1,27136,2,7839869213
5041,152234129,128969,152363098,3,0,0,27648,28,7112770946
5042,152243911,17812,152261723,4,0,1,11264,10,2506899184
5043,152267600,282261,152549861,2,0,0,164864,29,7859983155
5044,152323491,44925,152368416,4,0,1,5632,10,5638984381
5045,152401401,1994,152403395,9,0,1,2048,9,3647103562
5046,152418160,177482,152595642,0,0,0,66048,20,1690356058
5047,152511931,45438,152557369,9,0,1,4096,9,4408484057
5048,152530080,196725,152726805,2,0,0,43520,29,5299209163
5049,152582050,232625,152814675,8,0,0,103936,3,2665047670
5050,152609390,1042,152610432,8,0,1,1024,3,9761604643
5051,152639151,7230,152646381,4,0,1,7680,10,4447075239
5052,152667821,1518,152669339,9,0,1,1536,9,5095552020
5053,152673290,4850,152678140,6,0,1,5120,0,5465891043
5054,152682780,300394,152983174,2,0,0,216064,29,4362409395
5055,152688530,378626,153067156,4,0,0,102400,10,5175096641
5056,152697350,65119,152762469,4,0,0,2048,10,2086882682
5057,152749321,6278,152755599,9,0,1,6656,9,8804463409
5058,152808310,336973,153145283,0,0,0,39936,20,4254707125
5059,152812390,270077,153082467,0,0,0,50176,20,8393473724
5060,152840100,10499,152850599,6,0,1,16896,0,9049532596
5061,152853410,3898,152857308,8,0,1,4096,3,6089906304
5062,152887010,4937,152891947,8,0,1,12800,3,2946823286
5063,152901360,566,152901926,7,0,1,512,2,6956024225
5064,152920941,65887,152986828,4,0,1,10240,10,7030384430
5065,152921390,65784,152987174,7,0,1,512,2,96894118
5066,153001170,131930,153133100,2,0,0,10752,29,6943626457
5067,153001891,12995,153014886,4,0,1,25088,10,5125262187
5068,153046871,39742,153086613,9,0,1,11264,9,8743059811
5069,153063739,117854,153181593,3,0,0,22528,28,6853521813
5070,153084850,272016,153356866,2,0,0,182784,29,4203069324
5071,153091000,91076,153182076,4,0,0,1536,10,5901850262
5072,153121420,264368,153385788,2,0,0,94208,29,9232940211
5073,153193821,566,153194387,9,0,1,512,9,8302697377
5074,153194010,4953,153198963,7,0,1,12800,2,8471915657
5075,153249250,107795,153357045,4,0,0,512,10,1922857540
5076,153277350,566,153277916,7,0,1,512,2,10344139274
5077,153294140,622068,153916208,0,0,0,233984,20,7132148670
5078,153316460,111374,153427834,4,0,0,8704,10,1701494857
5079,153317699,285167,153602866,3,0,0,255488,28,3554579083
5080,153321860,523041,153844901,0,0,0,196608,20,10516642816
5081,153324619,298910,153623529,3,0,0,23040,28,9466494366
5082,153343180,47567,153390747,7,0,1,5120,2,4923082889
5083,153353361,38052,153391413,4,0,1,1024,10,783450958
5084,153358970,244083,153603053,4,0,0,512,10,348824268
5085,153364210,29530,153393740,7,0,1,14848,2,10031437645
5086,153372120,548323,153920443,2,0,0,13824,29,8064954683
5087,153381049,590180,153971229,3,0,0,164352,28,4593784025
5088,153409410,278253,153687663,4,0,0,512,10,5325592253
5089,153428180,25187,153453367,6,0,1,45568,0,1710905129
5090,153439350,337528,153776878,2,0,0,7680,29,5463200309
5091,153493130,2870,153496000,7,0,1,8704,2,3814330470
5092,153509480,468848,153978328,8,0,0,23040,3,5986819183
5093,153512001,12737,153524738,9,0,1,24576,9,642811101
5094,153536990,67565,153604555,5,0,1,1536,12,1774626249
5095,153549690,79002,153628692,7,0,1,45568,2,2502035279
5096,153592731,38867,153631598,9,0,1,4608,9,9572906325
5097,153634989,363517,153998506,3,0,0,66048,28,4236963118
5098,153639010,4850,153643860,6,0,1,5120,0,6588608536
5099,153641681,5085,153646766,9,0,1,4608,9,3916671026
5100,153643650,277440,153921090,4,0,0,2048,10,9050655263
5101,153661061,4420,153665481,9,0,1,11776,9,232611323
5102,153690369,6229,153696598,3,0,1,15360,28,6154134069
5103,153724660,359978,154084638,2,0,0,49152,29,2112301065
5104,153733541,31524,153765065,9,0,1,51200,9,8450262787
5105,153759310,13341,153772651,5,0,1,22528,12,8063716492
5106,153802440,211513,154013953,4,0,0,1024,10,6929931295
5107,153831760,146607,153978367,6,0,1,9728,0,8400625196
5108,153858869,170019,154028888,3,0,0,4608,28,4792861297
5109,153882331,116190,153998521,4,0,1,5632,10,10166770710
5110,153882880,115656,153998536,6,0,1,26624,0,1788578421
5111,153884951,113600,153998551,4,0,1,2048,10,5327167301
5112,153889600,108966,153998566,5,0,1,1024,12,1782551111
5113,153892909,117219,154010128,3,0,1,45568,28,3364376633
5114,153919839,91275,154011114,3,0,1,1536,28,5051716822
5115,153934290,77490,154011780,6,0,1,11264,0,1999818875
5116,153955880,60726,154016606,7,0,1,7680,2,8064337544
5117,153958500,222380,154180880,0,0,0,91136,20,2861451763
5118,153987920,32872,154020792,5,0,1,6656,12,5196896919
5119,154003470,81830,154085300,4,0,0,2048,10,10278134486
5120,154008530,12621,154021151,2,0,1,9728,29,5365416991
5121,154022461,566,154023027,9,0,1,512,9,940094950
5122,154048761,4679,154053440,4,0,1,12288,10,7962640760
5123,154066831,17830,154084661,4,0,1,7680,10,4815316517
5124,154070941,17446,154088387,4,0,1,9216,10,7766691720
5125,154086090,121177,154207267,8,0,0,35840,3,3907119606
5126,154146670,297920,154444590,8,0,0,60928,3,5490666848
5127,154152801,28094,154180895,9,0,1,20992,9,8722401612
5128,154202981,9145,154212126,4,0,1,5120,10,8749412986
5129,154204080,257537,154461617,2,0,0,55808,29,1039972827
5130,154214481,6754,154221235,4,0,1,7168,10,6832175811
5131,154217540,76727,154294267,4,0,0,1536,10,3790559744
5132,154246030,269050,154515080,8,0,0,35328,3,10251186883
5133,154269420,100568,154369988,0,0,0,30208,20,3740288723
5134,154305600,185156,154490756,4,0,0,512,10,3809776414
5135,154336769,316584,154653353,3,0,0,20480,28,608857494
5136,154338049,2870,154340919,0,0,1,8704,20,1371941290
5137,154349450,324822,154674272,0,0,0,68608,20,3752551270
5138,154359430,202662,154562092,0,0,0,51712,20,3836705647
5139,154374310,3387,154377697,7,0,1,9728,2,7864214866
5140,154376010,7542,154383552,6,0,1,15360,0,5775344401
5141,154381100,6431,154387531,6,0,1,13824,0,4309287586
5142,154381641,7836,154389477,4,0,1,3072,10,4528526228
5143,154416680,1518,154418198,7,0,1,1536,2,9773788260
5144,154429240,398899,154828139,2,0,0,109056,29,7325927675
5145,154448159,19770,154467929,0,0,1,6656,20,9446585077
5146,154453960,14955,154468915,6,0,1,1536,0,9694485506
5147,154456241,13750,154469991,9,0,1,13312,9,2489009585
5148,154466931,12337,154479268,4,0,1,17920,10,8060048147
5149,154493180,5454,154498634,6,0,1,13824,0,219420736
5150,154535320,216211,154751531,0,0,0,18944,20,4555318189
5151,154542820,463977,155006797,8,0,0,48128,3,8137425981
5152,154545390,479534,155024924,2,0,0,59392,29,9195736660
5153,154556609,848233,155404842,3,0,0,368128,28,1073022640
5154,154585659,3904,154589563,0,0,1,10752,20,8536742382
5155,154589030,402761,154991791,0,0,0,183296,20,9023247466
5156,154602330,2946,154605276,7,0,1,3072,2,974790205
5157,154604790,387328,154992118,4,0,0,1024,10,1042095914
5158,154626700,532891,155159591,8,0,0,90624,3,5358301061
5159,154630920,467453,155098373,8,0,0,74752,3,6523521519
5160,154654639,539308,155193947,3,0,0,9216,28,9992238094
5161,154709151,566,154709717,9,0,1,512,9,6482511951
5162,154713650,1042,154714692,7,0,1,1024,2,9827459552
5163,154723180,4850,154728030,6,0,1,5120,0,10558149207
5164,154723880,302955,155026835,4,0,0,6144,10,311540765
5165,154727689,552604,155280293,3,0,0,11776,28,4857980861
5166,154733370,723139,155456509,8,0,0,169472,3,4778718623
5167,154825400,749120,155574520,0,0,0,220672,20,371973957
5168,154876169,601259,155477428,3,0,0,68608,28,4444564411
5169,154960201,67678,155027879,4,0,1,3072,10,2881856940
5170,154982309,594254,155576563,3,0,0,6656,28,50605247
5171,154994079,46598,155040677,0,0,1,23552,20,4019260197
5172,154996609,510660,155507269,3,0,0,37376,28,4677347448
5173,155015940,26043,155041983,7,0,1,2048,2,10551463491
5174,155025760,21629,155047389,6,0,1,24576,0,1180213407
5175,155036210,442481,155478691,8,0,0,4096,3,3309507561
5176,155042630,5745,155048375,7,0,1,1536,2,5637823201
5177,155051051,3128,155054179,4,0,1,9216,10,839399497
5178,155071370,2470,155073840,6,0,1,2560,0,6301781233
5179,155110810,552313,155663123,2,0,0,100352,29,7124032162
5180,155120030,715764,155835794,0,0,0,156160,20,31097901
5181,155128560,459110,155587670,2,0,0,36352,29,7206527886
5182,155144929,752959,155897888,3,0,0,145920,28,9275780280
5183,155156579,339287,155495866,3,0,0,56320,28,4139681823
5184,155160920,691011,155851931,0,0,0,51712,20,2202514567
5185,155180671,3128,155183799,4,0,1,9216,10,7296218605
5186,155242050,6488,155248538,7,0,1,15872,2,6611296542
5187,155301960,486239,155788199,8,0,0,208384,3,8571678112
5188,155330750,616518,155947268,2,0,0,146944,29,3729520119
5189,155514480,479398,155993878,8,0,0,99328,3,8929891566
5190,155525629,437946,155963575,3,0,0,38912,28,3828298677
5191,155564680,337771,155902451,8,0,0,14848,3,10320746326
5192,155570710,281712,155852422,4,0,0,1536,10,4803414244
5193,155593010,242979,155835989,4,0,0,512,10,2191937505
5194,155594590,566,155595156,6,0,1,512,0,7456531464
5195,155639560,196600,155836160,4,0,0,512,10,4322832795
5196,155700119,153254,155853373,3,0,0,3072,28,6074579219
5197,155754449,148017,155902466,3,0,1,16384,28,6969320997
5198,155788211,114270,155902481,9,0,1,9728,9,1675806248
5199,155792470,159204,155951674,0,0,0,14336,20,6876255048
5200,155820099,127192,155947291,3,0,1,17920,28,2753083744
5201,155831730,119959,155951689,7,0,1,23552,2,156441048
5202,155834490,117214,155951704,6,0,1,9216,0,5192825608
5203,155836529,172380,156008909,3,0,0,49152,28,7768975592
5204,155892340,398554,156290894,8,0,0,59392,3,1698214243
5205,155927531,81409,156008940,4,0,1,5632,10,4848130213
5206,155935029,201455,156136484,3,0,0,57856,28,130899308
5207,155936590,380223,156316813,2,0,0,84992,29,132511754
5208,155941989,545521,156487510,3,0,0,327680,28,640413817
5209,155970680,230151,156200831,4,0,0,512,10,3380233511
5210,155973160,91558,156064718,4,0,0,1024,10,1931517919
5211,155978841,36806,156015647,4,0,1,7168,10,7002234531
5212,155991059,25574,156016633,3,0,1,1536,28,3267647072
5213,156014720,5459,156020179,4,0,1,5632,10,4081808025
5214,156017460,12049,156029509,7,0,1,19968,2,9079743223
5215,156052670,274572,156327242,0,0,0,33280,20,5945551926
5216,156060841,2470,156063311,9,0,1,2560,9,7287351085
5217,156074150,566,156074716,2,0,1,512,29,8200211379
5218,156098570,163121,156261691,4,0,0,512,10,9034179610
5219,156132989,376103,156509092,3,0,0,70656,28,8678261404
5220,156164800,5802,156170602,8,0,1,6144,3,7281645835
5221,156165959,8509,156174468,3,0,1,6144,28,749920717
5222,156169519,344432,156513951,3,0,0,15872,28,75194619
5223,156209520,304642,156514162,4,0,0,512,10,3045951415
5224,156232339,15579,156247918,3,0,1,30208,28,892139898
5225,156244150,14287,156258437,4,0,1,27648,10,5114328216
5226,156248749,10354,156259103,3,0,1,1024,28,4705207315
5227,156254601,6448,156261049,9,0,1,3072,9,9481954073
5228,156270930,362716,156633646,0,0,0,28160,20,1326238431
5229,156282471,45575,156328046,4,0,1,18432,10,7805525499
5230,156322051,11478,156333529,9,0,1,6656,9,7262415165
5231,156323150,213511,156536661,4,0,0,4096,10,1428082142
5232,156330069,278010,156608079,3,0,0,123392,28,1649389376
5233,156352760,262213,156614973,0,0,0,22528,20,881094445
5234,156372650,419617,156792267,8,0,0,8192,3,5495147411
5235,156379900,276306,156656206,2,0,0,27136,29,10630626418
5236,156382310,105223,156487533,8,0,1,48640,3,5669476490
5237,156387999,129408,156517407,3,0,1,3584,28,8720922200
5238,156417839,109546,156527385,3,0,1,20480,28,172964983
5239,156418290,197634,156615924,4,0,0,3072,10,3612453830
5240,156425850,101881,156527731,7,0,1,512,2,7818722784
5241,156456730,424613,156881343,0,0,0,2048,20,6843799964
5242,156477891,50404,156528295,4,0,1,10752,10,7210388273
5243,156486199,292605,156778804,3,0,0,25088,28,8175623225
5244,156509690,23111,156532801,4,0,1,7168,10,3849376089
5245,156519971,13598,156533569,9,0,1,11776,9,7513978837
5246,156562109,394415,156956524,3,0,0,125440,28,4808905603
5247,156567991,40103,156608094,4,0,1,5120,10,10680385296
5248,156617981,4850,156622831,9,0,1,5120,9,6070777515
5249,156621420,271809,156893229,8,0,0,19456,3,8939994676
5250,156629991,17505,156647496,4,0,1,23552,10,9094704975
5251,156633821,22400,156656221,4,0,1,1024,10,3388424421
5252,156651520,5735,156657255,2,0,1,1024,29,2543116500
5253,156662200,218496,156880696,8,0,0,37888,3,4499225246
5254,156680530,304375,156984905,8,0,0,10240,3,7594122761
5255,156717820,434251,157152071,2,0,0,240640,29,756334687
5256,156749850,424100,157173950,2,0,0,71680,29,5429659873
5257,156787230,269603,157056833,8,0,0,84992,3,2652518643
5258,156818979,5454,156824433,3,0,1,13824,28,10219006109
5259,156856370,3422,156859792,2,0,1,3584,29,7357721126
5260,156870650,359727,157230377,2,0,0,32256,29,498212580
5261,157030460,187856,157218316,8,0,0,139264,3,2891206007
5262,157037380,21932,157059312,2,0,1,2560,29,5938320948
5263,157042429,133440,157175869,3,0,0,6144,28,794910161
5264,157057159,235865,157293024,3,0,0,39424,28,1303053951
5265,157058480,1818,157060298,5,0,1,1536,12,10068583851
5266,157061541,6754,157068295,4,0,1,7168,10,653242295
5267,157066339,7706,157074045,3,0,1,8192,28,8797131908
5268,157073870,305715,157379585,0,0,0,96256,20,8419189880
5269,157081859,317576,157399435,3,0,0,64512,28,7478448232
5270,157089270,177724,157266994,0,0,0,14336,20,7335644396
5271,157096489,121858,157218347,3,0,1,15872,28,2515564586
5272,157105590,363346,157468936,8,0,0,114176,3,662658881
5273,157112780,117612,157230392,7,0,1,6144,2,7395055323
5274,157141120,411992,157553112,9,0,0,68608,9,3060274418
5275,157170030,60377,157230407,2,0,1,12288,29,3413500633
5276,157183960,195796,157379756,4,0,0,512,10,9435229717
5277,157195350,35072,157230422,2,0,1,11264,29,10229173801
5278,157206330,24107,157230437,5,0,1,3072,12,6542654830
5279,157208769,33223,157241992,3,0,1,23040,28,7706288109
5280,157222609,89735,157312344,3,0,0,9216,28,7783648783
5281,157226261,16397,157242658,9,0,1,11264,9,7141695022
5282,157227439,205384,157432823,3,0,0,15872,28,8684677954
5283,157234970,8252,157243222,5,0,1,10752,12,6424162435
5284,157240539,514446,157754985,3,0,0,56320,28,6530902598
5285,157245149,345567,157590716,3,0,0,100352,28,7848412690
5286,157329980,457172,157787152,0,0,0,105472,20,2596760100
5287,157364500,56318,157420818,7,0,1,34816,2,8033930169
5288,157370780,297018,157667798,9,0,0,107520,9,8203950269
5289,157402710,20694,157423404,7,0,1,4096,2,2212230193
5290,157405580,67402,157472982,2,0,1,99840,29,9323183054
5291,157486499,3387,157489886,3,0,1,9728,28,5082357268
5292,157527301,25834,157553135,4,0,1,13824,10,6705582796
5293,157532191,27692,157559883,4,0,1,7168,10,3139671220
5294,157548380,42351,157590731,2,0,1,11264,29,8669074071
5295,157554320,36426,157590746,2,0,1,25600,29,2234433719
5296,157573299,19951,157593250,3,0,1,2560,28,4149401538
5297,157585970,278774,157864744,9,0,0,20992,9,4756774426
5298,157586770,15289,157602059,7,0,1,16896,2,7083201181
5299,157597761,23466,157621227,4,0,1,38912,10,10053412287
5300,157599021,22360,157621381,4,0,1,8704,10,3426580576
5301,157611170,335125,157946295,8,0,0,156160,3,10215645011
5302,157640460,41117,157681577,4,0,1,26624,10,8807263062
5303,157647140,340221,157987361,0,0,0,133120,20,3336571188
5304,157689630,100353,157789983,4,0,0,512,10,928867225
5305,157703980,242806,157946786,4,0,0,1536,10,3524587698
5306,157714879,5326,157720205,3,0,1,5632,28,1436050711
5307,157727879,4850,157732729,3,0,1,5120,28,2473679946
5308,157746220,46242,157792462,2,0,1,5632,29,8366493010
5309,157746871,64672,157811543,9,0,1,37376,9,8504174745
5310,157754570,59879,157814449,2,0,1,4608,29,290263921
5311,157756219,69060,157825279,3,0,1,35328,28,3938375844
5312,157777049,315153,158092202,3,0,0,141824,28,10696702940
5313,157797230,335867,158133097,2,0,0,34304,29,229809841
5314,157873280,359410,158232690,0,0,0,49152,20,5864447444
5315,157876600,341091,158217691,9,0,0,96256,9,8100303266
5316,157879759,14804,157894563,3,0,1,28672,28,9918770572
5317,157880630,15559,157896189,2,0,1,2560,29,9355211414
5318,157888150,9345,157897495,7,0,1,2048,2,2882683086
5319,157898619,289721,158188340,3,0,0,98304,28,2030442539
5320,157919660,71847,157991507,5,0,1,11264,12,6893788515
5321,157940140,56141,157996281,7,0,1,13824,2,4952737581
5322,157947250,379058,158326308,9,0,0,17408,9,623433607
5323,157960690,40061,158000751,2,0,1,14336,29,9501207857
5324,157993220,12046,158005266,7,0,1,6144,2,3386002004
5325,158011950,374540,158386490,9,0,0,22528,9,10618490599
5326,158021550,218192,158239742,9,0,0,13824,9,6540689030
5327,158029640,1994,158031634,4,0,1,2048,10,3181327830
5328,158030491,5454,158035945,9,0,1,13824,9,9827344798
5329,158043390,442610,158486000,8,0,0,2048,3,8018568657
5330,158064249,32432,158096681,3,0,1,11776,28,4367837437
5331,158064970,32057,158097027,5,0,1,512,12,3612859607
5332,158075891,22984,158098875,9,0,1,8704,9,6133436601
5333,158086150,399211,158485361,8,0,0,37888,3,5660775316
5334,158101849,371938,158473787,3,0,0,244736,28,4971856669
5335,158125350,11637,158136987,8,0,1,4096,3,9283405065
5336,158151381,5454,158156835,9,0,1,13824,9,539504269
5337,158158410,378294,158536704,4,0,0,1024,10,5382282448
5338,158187341,58328,158245669,9,0,1,25088,9,2117104033
5339,158213279,35936,158249215,3,0,1,5632,28,728030543
5340,158227491,22185,158249676,9,0,1,10240,9,5657062065
5341,158242270,7752,158250022,4,0,1,512,10,9012605062
5342,158255481,566,158256047,9,0,1,512,9,9784320130
5343,158274419,223008,158497427,3,0,0,37376,28,6327141228
5344,158300570,12825,158313395,5,0,1,21504,12,10212603342
5345,158315300,265186,158580486,8,0,0,32256,3,8747548950
5346,158322640,237154,158559794,4,0,0,512,10,8740102021
5347,158330110,310550,158640660,8,0,0,147968,3,2700248353
5348,158374469,282126,158656595,3,0,0,52224,28,9523103679
5349,158384779,4573,158389352,0,0,1,8704,20,5327957210
5350,158386590,311617,158698207,9,0,0,52224,9,8278217478
5351,158393820,79982,158473802,7,0,1,29696,2,10112046902
5352,158453520,49320,158502840,4,0,1,13824,10,410793745
5353,158455760,59696,158515456,7,0,1,23552,2,9436576540
5354,158457150,59292,158516442,5,0,1,1536,12,4179077440
5355,158487670,29643,158517313,4,0,1,12288,10,140256129
5356,158516070,34279,158550349,5,0,1,59904,12,9672940168
5357,158534730,260053,158794783,9,0,0,86016,9,3598086761
5358,158556280,12308,158568588,2,0,1,20480,29,7485808730
5359,158563959,16542,158580501,3,0,1,24064,28,7646158511
5360,158578931,6888,158585819,9,0,1,5632,9,5381172528
5361,158584600,412619,158997219,8,0,0,96256,3,5170403627
5362,158587141,1518,158588659,9,0,1,1536,9,3779203909
5363,158589800,408058,158997858,4,0,0,2048,10,2103334052
5364,158598630,340661,158939291,9,0,0,26624,9,1856956533
5365,158618470,291870,158910340,9,0,0,114176,9,10042402520
5366,158632990,26534,158659524,4,0,1,8704,10,5776398228
5367,158643790,277984,158921774,2,0,0,36864,29,5364478704
5368,158650130,21225,158671355,2,0,1,19968,29,4729010917
5369,158699780,465567,159165347,9,0,0,27136,9,1365060484
5370,158721420,189107,158910527,4,0,0,512,10,8185936241
5371,158733860,11533,158745393,2,0,1,18944,29,5782886016
5372,158751110,342781,159093891,2,0,0,93696,29,977100323
5373,158773320,22990,158796310,5,0,1,1536,12,8221908546
5374,158784220,17318,158801538,2,0,1,6656,29,6374008158
5375,158796520,126517,158923037,0,0,0,4096,20,9172163020
5376,158831850,757044,159588894,9,0,0,238080,9,6674466095
5377,158834199,2946,158837145,3,0,1,3072,28,4564929611
5378,158851270,12995,158864265,5,0,1,25088,12,8210243070
5379,158859430,5181,158864611,7,0,1,512,2,6593775361
5380,158859620,5977,158865597,7,0,1,1536,2,10070187955
5381,158878160,429361,159307521,0,0,0,47616,20,5759838897
5382,158881500,321832,159203332,4,0,0,1536,10,10735155153
5383,158902240,26827,158929067,7,0,1,14848,2,10051200028
5384,158912180,135964,159048144,4,0,0,2048,10,8542046942
5385,158917399,21915,158939314,3,0,1,7168,28,8858949484
5386,158922639,555488,159478127,3,0,0,173056,28,8587968825
5387,158932741,17816,158950557,9,0,1,18432,9,1541371465
5388,158941920,15853,158957773,5,0,1,21504,12,3140309324
5389,158947300,16986,158964286,2,0,1,24576,29,5621856694
5390,158954810,461203,159416013,9,0,0,35328,9,8236829289
5391,159019080,16354,159035434,5,0,1,31744,12,1897797016
5392,159029590,213576,159243166,8,0,0,5120,3,791245518
5393,159056570,544211,159600781,9,0,0,38912,9,3761573395
5394,159089070,293513,159382583,4,0,0,512,10,5396182999
5395,159096880,590145,159687025,0,0,0,149504,20,10236150887
5396,159102160,13341,159115501,2,0,1,22528,29,1009431708
5397,159106699,48070,159154769,3,0,1,78848,28,10662952255
5398,159111160,44377,159155537,2,0,1,11776,29,8188082692
5399,159116771,48591,159165362,9,0,1,5632,9,2269831650
5400,159127600,37777,159165377,2,0,1,1024,29,7623521128
5401,159146810,494203,159641013,8,0,0,72704,3,5772565349
5402,159175950,1042,159176992,4,0,1,1024,10,3280368815
5403,159181760,2470,159184230,7,0,1,2560,2,3627569162
5404,159232210,509172,159741382,9,0,0,164352,9,4784519888
5405,159267070,7230,159274300,2,0,1,7680,29,5574883643
5406,159272549,4162,159276711,3,0,1,11264,28,6137672513
5407,159298830,190931,159489761,4,0,0,3584,10,9537052502
5408,159335199,477330,159812529,3,0,0,144384,28,6477663258
5409,159339190,262394,159601584,9,0,0,2560,9,2406570725
5410,159426460,65188,159491648,5,0,1,26112,12,1044876253
5411,159455340,477339,159932679,2,0,0,144384,29,9790347
5412,159482540,10388,159492928,4,0,1,14336,10,2807021870
5413,159491550,457071,159948621,0,0,0,51200,20,7899782613
5414,159493241,6754,159499995,9,0,1,7168,9,4557209858
5415,159528419,75694,159604113,3,0,1,2560,28,8152995285
5416,159542979,221896,159764875,3,0,0,2048,28,1916709407
5417,159556870,427472,159984342,2,0,0,53248,29,10459999608
5418,159564721,42923,159607644,9,0,1,13312,9,5163525572
5419,159564930,44702,159609632,4,0,1,9216,10,9890250339
5420,159567400,73644,159641044,5,0,1,40960,12,2167182452
5421,159585030,383065,159968095,8,0,0,25088,3,1945172064
5422,159592500,501963,160094463,4,0,0,7168,10,1864214678
5423,159607769,79271,159687040,3,0,1,6144,28,605574407
5424,159623330,309676,159933006,4,0,0,1024,10,4704947121
5425,159639930,312606,159952536,9,0,0,12800,9,8218173479
5426,159672840,418917,160091757,8,0,0,257024,3,5925293768
5427,159677340,12680,159690020,2,0,1,3072,29,5308359808
5428,159681000,60397,159741397,5,0,1,4608,12,753692925
5429,159716469,36986,159753455,3,0,1,19968,28,6415438869
5430,159738300,353948,160092248,4,0,0,1536,10,1438132857
5431,159747830,5881,159753711,4,0,1,9216,10,6666512030
5432,159759860,5196,159765056,2,0,1,13312,29,10005767886
5433,159786670,218762,160005432,4,0,0,1536,10,3173436696
5434,159792530,405892,160198422,9,0,0,96256,9,7730458573
5435,159803619,15706,159819325,3,0,1,7168,28,5095136578
5436,159836300,22691,159858991,4,0,1,37376,10,5863346930
5437,159866880,294900,160161780,9,0,0,118272,9,10463240728
5438,159879600,339061,160218661,0,0,0,50688,20,8617353370
5439,159962820,279346,160242166,9,0,0,41472,9,164225433
5440,159972459,19581,159992040,0,0,1,8192,20,236202739
5441,160018470,314855,160333325,8,0,0,71168,3,4832359254
5442,160065450,304217,160369667,8,0,0,17920,3,716695979
5443,160070090,29207,160099297,5,0,1,5120,12,1949201176
5444,160091640,133364,160225004,8,0,0,17408,3,2900524876
5445,160140909,133784,160274693,3,0,0,1536,28,581564282
5446,160173820,44856,160218676,5,0,1,7168,12,18776854
5447,160199170,19521,160218691,4,0,1,1024,10,2249303021
5448,160264780,310770,160575550,4,0,0,2048,10,10059007655
5449,160294420,198856,160493276,0,0,0,27136,20,1079963290
5450,160343690,566,160344256,4,0,1,512,10,7031815475
5451,160395040,4162,160399202,2,0,1,11264,29,3211391329
5452,160395749,54939,160450688,3,0,0,2560,28,4422619711
5453,160427930,198395,160626325,8,0,0,49664,3,1954714642
5454,160429710,11274,160440984,5,0,1,18432,12,6003651053
5455,160465261,566,160465827,9,0,1,512,9,275892201
5456,160484210,62054,160546264,9,0,0,3072,9,3042533878
5457,160490750,4512,160495262,5,0,1,2048,12,7678102667
5458,160495600,115578,160611178,0,0,0,33280,20,6075809196
5459,160514009,45596,160559605,3,0,0,1024,28,9624687481
5460,160521920,335102,160857022,8,0,0,243200,3,5339930797
5461,160526810,12825,160539635,8,0,1,21504,3,4705166861
5462,160578930,3898,160582828,4,0,1,4096,10,10062214215
5463,160580120,282073,160862193,9,0,0,16896,9,5550648659
5464,160595639,140108,160735747,3,0,0,512,28,8517139448
5465,160669771,2946,160672717,9,0,1,3072,9,4512939154
5466,160676690,70372,160747062,4,0,0,7168,10,7773318692
5467,160684420,184192,160868612,8,0,0,20992,3,1695866355
5468,160684780,10241,160695021,4,0,1,16384,10,54061675
5469,160695090,249329,160944419,9,0,0,134656,9,1521204979
5470,160710260,241506,160951766,9,0,0,24064,9,4252834932
5471,160737120,5196,160742316,5,0,1,13312,12,1594647847
5472,160808440,264544,161072984,2,0,0,54272,29,5468548035
5473,160824670,186425,161011095,9,0,0,113152,9,6389393192
5474,160889670,566,160890236,4,0,1,512,10,9408062095
5475,160921660,226402,161148062,9,0,0,72704,9,3177005409
5476,161003340,242628,161245968,8,0,0,71168,3,6262284609
5477,161027510,196759,161224269,9,0,0,46080,9,311710178
5478,161117160,142143,161259303,8,0,0,8704,3,8411143554
5479,161138840,156895,161295735,2,0,0,47616,29,10477114660
5480,161154800,6754,161161554,4,0,1,7168,10,1848488777
5481,161160950,1994,161162944,2,0,1,2048,29,2876202185
5482,161180750,340627,161521377,2,0,0,237568,29,4228228606
5483,161209929,36054,161245983,3,0,1,16896,28,2896291998
5484,161224790,312381,161537171,0,0,0,51712,20,8783965531
5485,161237100,380928,161618028,0,0,0,102400,20,9017866823
5486,161289230,516259,161805489,0,0,0,168448,20,1004041367
5487,161294310,459832,161754142,0,0,0,257024,20,1885213546
5488,161310451,1518,161311969,9,0,1,1536,9,4784530636
5489,161334610,566,161335176,5,0,1,512,12,9569429459
5490,161343510,3128,161346638,2,0,1,9216,29,8858157699
5491,161412340,14117,161426457,2,0,1,24064,29,5646128036
5492,161443590,77802,161521392,1,0,1,7680,18,759420754
5493,161468760,70389,161539149,5,0,1,2048,12,3749776587
5494,161504910,35225,161540135,2,0,1,1536,29,3850351470
5495,161581750,2870,161584620,5,0,1,8704,12,10600889225
5496,161699690,118608,161818298,2,0,1,21504,29,1434709925
5497,161746040,160633,161906673,8,0,0,32256,3,8068670920
5498,161756450,66994,161823444,2,0,1,8192,29,4442121191
5499,161794990,29760,161824750,4,0,1,2048,10,4601141154
5500,161797750,493426,162291176,9,0,0,74240,9,2310533390
5501,161802510,28141,161830651,5,0,1,19968,12,4094347845
5502,161834560,5326,161839886,4,0,1,5632,10,3758104179
5503,161835110,8642,161843752,5,0,1,6144,12,7607211193
5504,161837940,430593,162268533,9,0,0,37888,9,2767681706
5505,161843440,3387,161846827,4,0,1,9728,10,3696392418
5506,161858420,398522,162256942,9,0,0,442368,9,225534863
5507,161890860,15828,161906688,4,0,1,16384,10,2947385673
5508,161917290,1042,161918332,4,0,1,1024,10,3335639528
5509,161969260,395351,162364611,2,0,0,17920,29,4805219198
5510,161979620,317367,162296987,2,0,0,18944,29,9727636221
5511,162000700,358390,162359090,8,0,0,203776,3,5481544974
5512,162032370,3422,162035792,4,0,1,3584,10,6570856370
5513,162082830,3898,162086728,2,0,1,4096,29,5022733879
5514,162124320,234785,162359105,2,0,1,7168,29,10530069660
5515,162125739,233389,162359128,0,0,1,20480,20,6098383379
5516,162137130,245193,162382323,9,0,0,27136,9,1077958163
5517,162173420,310670,162484090,2,0,0,72192,29,10420508207
5518,162188590,416732,162605322,8,0,0,30208,3,3980964839
5519,162263660,479296,162742956,0,0,0,253952,20,682222208
5520,162298040,74236,162372276,2,0,1,8192,29,6299991638
5521,162319010,53612,162372622,4,0,1,512,10,4807648918
5522,162365960,121273,162487233,9,0,0,10240,9,9581876185
5523,162386140,164715,162550855,9,0,0,53248,9,3727762914
5524,162454790,4420,162459210,4,0,1,11776,10,4300465344
5525,162463810,27544,162491354,5,0,1,11264,12,9528358482
5526,162640030,117301,162757331,8,0,0,47104,3,5131146522
5527,162663290,137422,162800712,2,0,0,34816,29,1319359155
5528,162720920,175126,162896046,9,0,0,114688,9,8208382607
5529,162755980,336572,163092552,2,0,0,58880,29,2565445506
5530,162773080,571037,163344117,0,0,0,266240,20,7167896957
5531,162794300,333436,163127736,2,0,0,93696,29,9172482880
5532,162801700,262136,163063836,9,0,0,125952,9,381806925
5533,162816340,247667,163064007,2,0,0,512,29,3577699380
5534,162834180,4937,162839117,4,0,1,12800,10,5017201681
5535,162856380,519903,163376283,9,0,0,30720,9,9788565019
5536,162876960,489948,163366908,0,0,0,74752,20,9351996138
5537,162883690,37577,162921267,2,0,1,45568,29,1342302292
5538,162890070,241284,163131354,2,0,0,5120,29,8548911302
5539,162927910,553076,163480986,0,0,0,255488,20,5819850874
5540,162933350,196429,163129779,2,0,0,6656,29,1235410458
5541,162954200,611376,163565576,8,0,0,154624,3,4725626768
5542,162973990,566,162974556,4,0,1,512,10,7345158118
5543,162977790,2946,162980736,4,0,1,3072,10,4508208024
5544,163003990,11016,163015006,2,0,1,17920,29,8720556856
5545,163060550,516905,163577455,8,0,0,38912,3,6983345712
5546,163068280,24295,163092575,4,0,1,8192,10,4842875681
5547,163068480,24110,163092590,2,0,1,5632,29,2245093027
5548,163075640,442801,163518441,8,0,0,122880,3,10280500652
5549,163173290,5712,163179002,4,0,1,14336,10,8479203046
5550,163177440,14125,163191565,2,0,1,23552,29,1810086413
5551,163235240,344726,163579966,0,0,0,8192,20,7650492324
5552,163235430,3898,163239328,4,0,1,4096,10,7299064527
5553,163238480,361789,163600269,9,0,0,66560,9,7116660128
5554,163310530,68307,163378837,4,0,1,2560,10,6957487147
5555,163322860,452219,163775079,0,0,0,105472,20,2654503280
5556,163325510,310216,163635726,9,0,0,23040,9,4232329050
5557,163328260,53163,163381423,4,0,1,4096,10,3605752839
5558,163340380,372875,163713255,9,0,0,202240,9,8308063175
5559,163414160,186140,163600300,2,0,1,3072,29,900853619
5560,163452960,434931,163887891,8,0,0,39936,3,1344708077
5561,163548500,59492,163607992,2,0,1,8192,29,6070559625
5562,163555160,54458,163609618,2,0,1,2560,29,4426212993
5563,163600340,10904,163611244,4,0,1,2560,10,8261878991
5564,163608200,4670,163612870,4,0,1,2560,10,3249164101
5565,163611530,221911,163833441,0,0,0,64000,20,2118840340
5566,163614049,1042,163615091,3,0,1,1024,28,341057827
5567,163624060,3645,163627705,4,0,1,10240,10,9577878820
5568,163655410,60324,163715734,2,0,1,2560,29,7978868604
5569,163680210,37738,163717948,4,0,1,10752,10,7365786036
5570,163741890,33204,163775094,4,0,1,6144,10,9961421242
5571,163776240,57684,163833924,0,0,0,1536,20,863940830
5572,163795190,161727,163956917,0,0,0,32768,20,8507624313
5573,163826040,184322,164010362,9,0,0,30720,9,9110982881
5574,163882740,10945,163893685,4,0,1,6144,10,5471964286
5575,163925659,6278,163931937,0,0,1,6656,20,5039233843
5576,163963379,61317,164024696,3,0,0,1024,28,10478437923
5577,163964230,94692,164058922,9,0,0,23040,9,4154957453
5578,164031219,10757,164041976,0,0,1,17408,20,4169031347
5579,164070090,3645,164073735,2,0,1,10240,29,5004096982
5580,164083110,103505,164186615,9,0,0,35840,9,8227358101
5581,164126430,6754,164133184,2,0,1,7168,29,3204970174
5582,164138589,4374,164142963,0,0,1,4608,20,6728511933
5583,164143929,1042,164144971,0,0,1,1024,20,6438730067
5584,164169230,71274,164240504,8,0,0,8704,3,507143811
5585,164216519,24000,164240519,0,0,1,35328,20,1438613534
5586,164226189,14345,164240534,0,0,1,8704,20,8047396104
5587,164263920,260631,164524551,8,0,0,33280,3,10193038582
5588,164265620,248776,164514396,9,0,0,34816,9,10451802979
5589,164295610,1994,164297604,2,0,1,2048,29,3406395229
5590,164323729,1518,164325247,3,0,1,1536,28,8473574321
5591,164347140,4679,164351819,2,0,1,12288,29,5099310266
5592,164352549,7706,164360255,3,0,1,8192,28,10427158615
5593,164366070,6278,164372348,2,0,1,6656,29,5320897644
5594,164378290,503273,164881563,8,0,0,287744,3,8157045307
5595,164400240,207720,164607960,0,0,0,46080,20,8000023632
5596,164418309,22950,164441259,3,0,1,37888,28,9694988361
5597,164434031,9814,164443845,9,0,1,4096,9,3107452232
5598,164449470,3898,164453368,2,0,1,4096,29,3036810567
5599,164461730,5196,164466926,2,0,1,13312,29,9894632016
5600,164465019,11832,164476851,3,0,1,17920,28,9203404439
5601,164520139,5446,164525585,3,0,1,1024,28,1525725108
5602,164529480,174656,164704136,0,0,0,13824,20,7116643394
5603,164555230,1994,164557224,2,0,1,2048,29,2686812937
5604,164579960,2870,164582830,2,0,1,8704,29,9873060616
5605,164587240,4420,164591660,4,0,1,11776,10,1216370408
5606,164629340,280474,164909814,0,0,0,92672,20,4663268409
5607,164633680,82750,164716430,8,0,0,7680,3,8052121832
5608,164750260,170053,164920313,0,0,0,34304,20,6916236463
5609,164821190,105410,164926600,2,0,1,6656,29,6442293576
5610,164839670,88876,164928546,2,0,1,3072,29,1697417609
5611,164841990,89782,164931772,4,0,1,5120,10,4789126228
5612,164843080,89460,164932540,4,0,1,11776,10,580045633
5613,164861580,77378,164938958,2,0,1,16896,29,7335325325
5614,164867350,218300,165085650,9,0,0,146944,9,7321729457
5615,164911540,31284,164942824,2,0,1,6144,29,5882106618
5616,164941500,2630,164944130,1,0,1,2048,18,6956629224
5617,164943050,6278,164949328,1,0,1,6656,18,7240064506
5618,164963740,5712,164969452,4,0,1,14336,10,3264978463
5619,165057360,34577,165091937,1,0,1,6656,18,7825019610
5620,165057560,135145,165192705,9,0,0,36864,9,6046017456
5621,165093401,2470,165095871,9,0,1,2560,9,8302902120
5622,165120380,16613,165136993,4,0,1,32256,10,1851517038
5623,165174919,566,165175485,3,0,1,512,28,5705300159
5624,165181910,13750,165195660,2,0,1,3072,29,10095155436
5625,165186220,12346,165198566,2,0,1,4608,29,3263757881
5626,165204809,3904,165208713,3,0,1,10752,28,3440171048
5627,165311570,47288,165358858,8,0,0,1536,3,4914639743
5628,165362950,179033,165541983,9,0,0,142336,9,5353297554
5629,165378750,253036,165631786,0,0,0,46592,20,10379225622
5630,165404580,4679,165409259,2,0,1,12288,29,931317051
5631,165420270,144326,165564596,9,0,0,57344,9,2185313179
5632,165426519,10757,165437276,3,0,1,17408,28,7332933147
5633,165464780,4937,165469717,4,0,1,12800,10,7535798887
5634,165476070,302428,165778498,8,0,0,36864,3,347981652
5635,165477581,64417,165541998,9,0,1,58368,9,10466708848
5636,165496089,45924,165542013,3,0,1,11776,28,10415076846
5637,165532691,99110,165631801,9,0,1,137216,9,6429814967
5638,165561900,362368,165924268,9,0,0,98816,9,4036971557
5639,165562230,69688,165631918,4,0,1,18944,10,4577752770
5640,165580090,276120,165856210,8,0,0,103424,3,7745722643
5641,165580329,51935,165632264,3,0,1,512,28,10436892616
5642,165600780,182257,165783037,8,0,0,14848,3,9796144148
5643,165613860,266984,165880844,0,0,0,20480,20,3500520624
5644,165628990,373940,166002930,8,0,0,55808,3,8041356160
5645,165660000,5454,165665454,4,0,1,13824,10,6700620703
5646,165663811,260472,165924283,9,0,1,408064,9,1923495746
5647,165780769,143529,165924298,3,0,1,8704,28,1707491863
5648,165796940,291750,166088690,8,0,0,36352,3,3291362770
5649,165925690,462207,166387897,9,0,0,45568,9,7915342809
5650,165961119,14117,165975236,3,0,1,24064,28,4566613120
5651,166035420,263275,166298695,8,0,0,15872,3,6648044463
5652,166052220,202456,166254676,9,0,0,4608,9,9570466593
5653,166087920,238774,166326694,0,0,0,12288,20,1451697903
5654,166093340,356456,166449796,0,0,0,56320,20,9223923932
5655,166150820,412851,166563671,8,0,0,91648,3,5794014883
5656,166154390,219608,166373998,8,0,0,57344,3,10424340161
5657,166184990,2470,166187460,4,0,1,2560,10,9995515243
5658,166206860,473914,166680774,0,0,0,85504,20,4246674
5659,166274640,6488,166281128,4,0,1,15872,10,3819395243
5660,166276641,251855,166528496,9,0,1,408064,9,10303085590
5661,166285531,244450,166529981,9,0,1,15360,9,4885001791
5662,166320301,243385,166563686,9,0,1,69632,9,460644284
5663,166327210,382784,166709994,8,0,0,60416,3,699961730
5664,166335111,258003,166593114,9,0,1,134144,9,5080654648
5665,166362170,491398,166853568,9,0,0,142336,9,8212144305
5666,166441770,438333,166880103,9,0,0,87040,9,2281018497
5667,166443940,149533,166593473,1,0,1,9728,18,9678461558
5668,166457980,333971,166791951,9,0,0,64000,9,3219927846
5669,166465411,144025,166609436,9,0,1,51712,9,7967361895
5670,166501380,111602,166612982,1,0,1,5632,18,5434742335
5671,166502080,387718,166889798,8,0,0,31744,3,2297291269
5672,166511570,460458,166972028,8,0,0,129024,3,8690260329
5673,166551750,514844,167066594,0,0,0,35328,20,1703290320
5674,166593730,19918,166613648,4,0,1,11264,10,922417535
5675,166659650,24104,166683754,7,0,1,3072,2,2279628946
5676,166663591,128375,166791966,9,0,1,159232,9,9695694954
5677,166669000,671434,167340434,8,0,0,137216,3,5162671948
5678,166700840,91141,166791981,7,0,1,9216,2,4838369357
5679,166786600,6891,166793491,1,0,1,1536,18,5545311900
5680,166793970,411744,167205714,0,0,0,58368,20,10352469356
5681,166848250,450337,167298587,9,0,0,27136,9,8904950913
5682,166862440,421297,167283737,0,0,0,256000,20,3952471882
5683,166873030,28576,166901606,1,0,1,19456,18,9359234156
5684,166906950,383354,167290304,0,0,0,21504,20,2750459949
5685,167053870,404062,167457932,9,0,0,185856,9,7826122594
5686,167115610,229489,167345099,9,0,0,2560,9,9568814416
5687,167191250,292915,167484165,0,0,0,49152,20,687147288
5688,167267120,75743,167342863,1,0,1,2560,18,5520317515
5689,167280630,268473,167549103,8,0,0,34304,3,6886633470
5690,167282190,181701,167463891,0,0,0,19456,20,7643686579
5691,167346780,12737,167359517,7,0,1,24576,2,8703433401
5692,167423510,138858,167562368,9,0,0,10752,9,6236868991
5693,167436810,280983,167717793,9,0,0,198656,9,6830172870
5694,167672430,47366,167719796,1,0,1,2048,18,8482640263
5695,167677490,143149,167820639,0,0,0,22528,20,7545626769
5696,167729470,566,167730036,7,0,1,512,2,8942194693
5697,167786630,109820,167896450,8,0,0,22016,3,911458165
5698,167823440,566,167824006,1,0,1,512,18,9469408214
5699,167828520,116168,167944688,9,0,0,81408,9,4115897559
5700,167895371,49332,167944703,9,0,1,60416,9,7545141185
5701,167910981,189643,168100624,9,0,1,301568,9,2943076048
5702,167956610,147560,168104170,1,0,1,5632,18,10530324335
5703,167962140,151448,168113588,8,0,0,4096,3,1537271170
5704,167996430,469112,168465542,8,0,0,170496,3,2123143792
5705,168014230,574594,168588824,0,0,0,347136,20,8720793017
5706,168041070,345096,168386166,0,0,0,62464,20,8179154087
5707,168106290,570272,168676562,0,0,0,84480,20,4246465420
5708,168106760,4420,168111180,7,0,1,11776,2,3132058757
5709,168123790,263959,168387749,8,0,0,5120,3,6776980036
5710,168145710,2946,168148656,1,0,1,3072,18,4489661
5711,168146900,465766,168612666,9,0,0,2048,9,10144198884
5712,168250110,2470,168252580,6,0,1,2560,0,1845178303
5713,168253530,593336,168846866,9,0,0,19968,9,8916724693
5714,168268770,6229,168274999,6,0,1,15360,0,282282323
5715,168288600,353335,168641935,8,0,0,59392,3,3352030249
5716,168353310,766988,169120298,8,0,0,354816,3,4488984021
5717,168380490,490897,168871387,8,0,0,38912,3,1956482114
5718,168398960,11016,168409976,6,0,1,17920,0,6079518587
5719,168445010,741080,169186090,0,0,0,160256,20,10438079692
5720,168482620,358131,168840751,8,0,0,89600,3,7016266158
5721,168510210,501965,169012175,9,0,0,152064,9,487912525
5722,168551310,40970,168592280,7,0,1,3584,2,3832739318
5723,168571210,22127,168593337,6,0,1,9728,0,6972194823
5724,168591540,346217,168937757,8,0,0,24064,3,6372467470
5725,168616590,4679,168621269,4,0,1,12288,10,1689924338
5726,168627950,18368,168646318,4,0,1,4608,10,8938255254
5727,168641670,7554,168649224,1,0,1,4608,18,9558683167
5728,168645360,489345,169134705,8,0,0,47104,3,9309579505
5729,168692750,444481,169137231,8,0,0,8192,3,3924797740
5730,168697170,4162,168701332,7,0,1,11264,2,9643419315
5731,168719801,15321,168735122,9,0,1,29696,9,2140424733
5732,168755890,11274,168767164,6,0,1,18432,0,7486254007
5733,168776160,2470,168778630,6,0,1,2560,0,5762967022
5734,168819480,37894,168857374,2,0,1,16896,29,7946238612
5735,168822940,48462,168871402,4,0,1,18432,10,6172715608
5736,168837630,33787,168871417,6,0,1,15360,0,3327172098
5737,168839610,37771,168877381,6,0,1,29184,0,10503376848
5738,168871790,6155,168877945,7,0,1,10752,2,1848660842
5739,168933961,200759,169134720,9,0,1,168960,9,2568955330
5740,168939701,250722,169190423,9,0,1,4608,9,615444163
5741,168942410,252839,169195249,7,0,1,7680,2,7735456305
5742,168945990,264169,169210159,7,0,1,32768,2,3864741702
5743,168987390,360795,169348185,9,0,0,167936,9,3991753596
5744,168994860,362544,169357404,0,0,0,30208,20,2871373187
5745,169074551,282868,169357419,9,0,1,238592,9,4432292748
5746,169080500,347336,169427836,9,0,0,130048,9,1494717049
5747,169210250,147184,169357434,6,0,1,6144,0,4581411248
5748,169214720,431852,169646572,9,0,0,143872,9,1654640727
5749,169220430,340486,169560916,0,0,0,24064,20,9633086325
5750,169250370,428217,169678587,0,0,0,68096,20,6650333458
5751,169272751,87009,169359760,9,0,1,37376,9,2168475412
5752,169352190,7916,169360106,4,0,1,512,10,9708635350
5753,169353320,16845,169370165,6,0,1,20992,0,4174894141
5754,169400540,31203,169431743,4,0,1,4096,10,811529119
5755,169401600,33049,169434649,7,0,1,4608,2,9927705295
5756,169485750,270436,169756186,8,0,0,88576,3,3838267171
5757,169513640,193082,169706722,7,0,0,4096,2,803260619
5758,169534160,11016,169545176,1,0,1,17920,18,10533526597
5759,169542950,226214,169769164,8,0,0,39936,3,2645911280
5760,169554810,6664,169561474,7,0,1,512,2,5707042872
5761,169571550,5712,169577262,4,0,1,14336,10,6929227868
5762,169588021,4162,169592183,9,0,1,11264,9,2583561363
5763,169599340,47247,169646587,1,0,1,23040,18,4464491165
5764,169649660,107321,169756981,9,0,0,2560,9,4304684581
5765,169662761,31655,169694416,9,0,1,30720,9,7552058582
5766,169682420,15542,169697962,7,0,1,5632,2,6570040991
5767,169754320,223401,169977721,9,0,0,52736,9,157279825
5768,169783810,5326,169789136,6,0,1,5632,0,10077361468
5769,169785580,12995,169798575,6,0,1,25088,0,4423900865
5770,169794120,4711,169798831,7,0,1,9216,2,1294829870
5771,169798179,4374,169802553,3,0,1,4608,28,5893907039
5772,169832140,2470,169834610,6,0,1,2560,0,6195954836
5773,169849160,5454,169854614,4,0,1,13824,10,3984894796
5774,169865160,5712,169870872,8,0,1,14336,3,8539360026
5775,169870930,88097,169959027,7,0,0,2560,2,6218236848
5776,169896730,453364,170350094,8,0,0,139776,3,4298920679
5777,169935261,66462,170001723,9,0,1,112640,9,205329027
5778,169950240,57282,170007522,1,0,1,19456,18,5998867481
5779,170027400,5712,170033112,6,0,1,14336,0,6996008177
5780,170077310,15837,170093147,1,0,1,30720,18,3233692819
5781,170099220,205105,170304325,0,0,0,162816,20,5242293592
5782,170101620,4374,170105994,1,0,1,4608,18,3177327560
5783,170103050,204441,170307491,0,0,0,10240,20,3971767499
5784,170140091,32041,170172132,9,0,1,52224,9,6925506292
5785,170144150,293359,170437509,9,0,0,133120,9,1156642505
5786,170148950,26408,170175358,4,0,1,5120,10,8381786310
5787,170172600,3744,170176344,4,0,1,1536,10,2559338924
5788,170172659,4878,170177537,3,0,1,11776,28,3058164493
5789,170173890,6294,170180184,4,0,1,3584,10,8601896111
5790,170178100,282923,170461023,0,0,0,12800,20,7005768423
5791,170218611,85737,170304348,9,0,1,81408,9,8646970626
5792,170236720,207684,170444404,7,0,0,22528,2,7603157457
5793,170262520,90955,170353475,4,0,1,3584,10,3525916466
5794,170270970,276295,170547265,7,0,0,18944,2,1664959348
5795,170312840,42261,170355101,6,0,1,2560,0,2317021614
5796,170363930,5712,170369642,8,0,1,14336,3,7694464977
5797,170380490,6488,170386978,4,0,1,15872,10,6345225121
5798,170405470,46599,170452069,7,0,1,8192,2,5157469199
5799,170416680,36695,170453375,7,0,1,2048,2,9306017569
5800,170438970,263096,170702066,7,0,0,131584,2,8538056006
5801,170448959,254222,170703181,6,0,0,3584,0,5600062756
5802,170534320,317597,170851917,0,0,0,66560,20,7859090287
5803,170548669,92581,170641250,6,0,0,2560,0,1486472031
5804,170567141,15321,170582462,9,0,1,29696,9,650664425
5805,170600801,102395,170703196,9,0,1,143360,9,5540748713
5806,170614020,184377,170798397,0,0,0,52224,20,7917549991
5807,170672000,33149,170705149,5,0,1,2048,12,10318913582
5808,170723330,302907,171026237,0,0,0,17920,20,1266754686
5809,170729260,3387,170732647,1,0,1,9728,18,6454717884
5810,170750189,1042,170751231,0,0,1,1024,20,1250450209
5811,170760911,92274,170853185,9,0,1,149504,9,4945214616
5812,170761630,254103,171015733,9,0,0,114688,9,6398715608
5813,170829710,24141,170853851,1,0,1,11264,18,2401866260
5814,170846010,12670,170858680,4,0,1,7168,10,5302798247
5815,170851040,9906,170860946,4,0,1,3584,10,8819651894
5816,170929280,4374,170933654,5,0,1,4608,12,6032821643
5817,170931730,140146,171071876,9,0,0,32256,9,2535205879
5818,170972930,566,170973496,8,0,1,512,3,925786963
5819,171026440,4937,171031377,7,0,1,12800,2,7381919158
5820,171033370,13858,171047228,1,0,1,23552,18,10203320466
5821,171053110,6754,171059864,7,0,1,7168,2,9446870455
5822,171076010,4937,171080947,5,0,1,12800,12,1456966583
5823,171099710,1518,171101228,4,0,1,1536,10,2983350760
5824,171119150,198914,171318064,7,0,0,56832,2,833495789
5825,171120859,109602,171230461,6,0,0,2560,0,6367486849
5826,171163610,3645,171167255,7,0,1,10240,2,10414643548
5827,171171610,5326,171176936,4,0,1,5632,10,10166286914
5828,171197779,141410,171339189,6,0,0,512,0,3378497002
5829,171208850,7230,171216080,4,0,1,7680,10,4604725322
5830,171220069,98166,171318235,6,0,0,512,0,1323801142
5831,171220800,4850,171225650,4,0,1,5120,10,8443790908
5832,171221580,135410,171356990,0,0,0,38912,20,47695501
5833,171230730,190191,171420921,0,0,0,68608,20,8991379788
5834,171232560,3898,171236458,7,0,1,4096,2,9974609804
5835,171233550,7734,171241284,4,0,1,7680,10,1701299812
5836,171239700,4170,171243870,1,0,1,4096,18,3907675710
5837,171262709,566,171263275,3,0,1,512,28,3622185600
5838,171265490,167161,171432651,7,0,0,36864,2,7002826263
5839,171270800,3422,171274222,5,0,1,3584,12,2688069294
5840,171288899,132505,171421404,6,0,0,1536,0,3115074722
5841,171315609,56646,171372255,6,0,0,2048,0,213937150
5842,171324340,3422,171327762,7,0,1,3584,2,8247018030
5843,171330079,3898,171333977,3,0,1,4096,28,762066904
5844,171338630,165602,171504232,7,0,0,62464,2,1093088151
5845,171354641,188495,171543136,9,0,1,305664,9,7096424717
5846,171387080,156620,171543700,1,0,1,10752,18,2716945345
5847,171399200,262504,171661704,9,0,0,64512,9,10501731747
5848,171420710,123976,171544686,5,0,1,1536,12,1233702584
5849,171432990,111850,171544840,8,0,1,8704,3,213248788
5850,171441111,186830,171627941,9,0,1,274944,9,3194646589
5851,171447590,190669,171638259,1,0,1,32768,18,4683617544
5852,171451270,187335,171638605,5,0,1,512,12,7306743123
5853,171460820,178451,171639271,1,0,1,1024,18,9335755713
5854,171463690,198029,171661719,7,0,1,27648,2,6633078052
5855,171465870,195864,171661734,1,0,1,25088,18,7549688860
5856,171491830,169919,171661749,1,0,1,8192,18,5911498713
5857,171498270,163494,171661764,4,0,1,12800,10,5048665584
5858,171528210,133569,171661779,5,0,1,14336,12,7845855504
5859,171551911,137104,171689015,9,0,1,100352,9,2361005475
5860,171558820,513402,172072222,0,0,0,44544,20,6581945303
5861,171562580,368083,171930663,7,0,0,106496,2,4567691097
5862,171619660,69816,171689476,4,0,1,10240,10,1828743103
5863,171638840,578445,172217285,9,0,0,331776,9,7601250018
5864,171669890,20866,171690756,1,0,1,14336,18,4180441842
5865,171685020,347817,172032837,9,0,0,33792,9,3531974560
5866,171713650,7706,171721356,8,0,1,8192,3,10534655202
5867,171720421,15321,171735742,9,0,1,29696,9,1721004502
5868,171740670,2470,171743140,1,0,1,2560,18,2354882828
5869,171785980,2870,171788850,4,0,1,8704,10,7213693899
5870,171836140,422866,172259006,7,0,0,107520,2,7807787483
5871,171883180,6278,171889458,7,0,1,6656,2,5640117738
5872,171891980,60079,171952059,7,0,0,3072,2,8618925201
5873,171954451,11016,171965467,9,0,1,17920,9,5733179217
5874,171976981,95256,172072237,9,0,1,136192,9,1740185251
5875,172012800,378907,172391707,7,0,0,110592,2,7252357455
5876,172026409,249835,172276244,6,0,0,3072,0,7675655141
5877,172046950,361169,172408119,9,0,0,35328,9,10251054524
5878,172058311,13941,172072252,9,0,1,11264,9,6437269684
5879,172092229,169459,172261688,6,0,0,7680,0,1333228899
5880,172103171,6229,172109400,9,0,1,15360,9,7212332150
5881,172113359,145974,172259333,6,0,0,1024,0,3728125476
5882,172118680,468766,172587446,0,0,0,105472,20,3876161305
5883,172136209,342108,172478317,6,0,0,512,0,4177963846
5884,172205279,233681,172438960,6,0,0,2048,0,5083585289
5885,172261380,396936,172658316,9,0,0,40448,9,7279212399
5886,172262090,11791,172273881,4,0,1,19456,10,6712433735
5887,172304430,341539,172645969,9,0,0,192000,9,10431393976
5888,172418550,267225,172685775,9,0,0,43008,9,525318336
5889,172547041,4162,172551203,9,0,1,11264,9,663790149
5890,172557670,100677,172658347,7,0,1,5632,2,743381264
5891,172619380,43803,172663183,5,0,1,5120,12,2923138283
5892,172634570,377061,173011631,7,0,0,209920,2,3547806833
5893,172667511,103862,172771373,9,0,1,172032,9,3819513072
5894,172683749,163382,172847131,6,0,0,1024,0,1681434087
5895,172688650,194481,172883131,7,0,0,48640,2,7854495056
5896,172717120,56839,172773959,5,0,1,4096,12,7353548723
5897,172751230,285696,173036926,7,0,0,82944,2,1331088908
5898,172776350,15062,172791412,4,0,1,29184,10,9515701233
5899,172777050,15233,172792283,5,0,1,12288,12,3302263516
5900,172821990,4374,172826364,1,0,1,4608,18,4657896142
5901,172858610,238746,173097356,0,0,0,12288,20,9282694529
5902,172911460,164280,173075740,9,0,0,80896,9,3063918155
5903,172935000,3645,172938645,4,0,1,10240,10,552441088
5904,172977700,166050,173143750,0,0,0,22016,20,8117971716
5905,172987420,181114,173168534,7,0,0,17920,2,4857588575
5906,172988410,62667,173051077,4,0,1,24064,10,1803965804
5907,172993200,82555,173075755,5,0,1,2560,12,10212102704
5908,173130920,2946,173133866,5,0,1,3072,12,3659655254
5909,173158680,3422,173162102,8,0,1,3584,3,393626791
5910,173184610,105941,173290551,7,0,0,33280,2,4271209722
5911,173221560,239562,173461122,7,0,0,161792,2,1159327367
5912,173235139,265368,173500507,6,0,0,1024,0,2148709269
5913,173246701,4162,173250863,1,0,1,11264,18,6694004675
5914,173283820,254967,173538787,7,0,0,25088,2,7870465219
5915,173301870,198294,173500164,7,0,0,61952,2,10289054326
5916,173307459,278635,173586094,6,0,0,2048,0,9553085649
5917,173383010,1994,173385004,5,0,1,2048,12,5342003400
5918,173414810,248999,173663809,7,0,0,33792,2,4148496554
5919,173481070,104385,173585455,7,0,0,4608,2,8970558426
5920,173485440,17896,173503336,8,0,1,8704,3,5033388936
5921,173493830,13186,173507016,2,0,1,4096,29,2130066328
5922,173507120,14117,173521237,8,0,1,24064,3,7649544286
5923,173523700,5802,173529502,5,0,1,6144,12,5575266633
5924,173576270,4374,173580644,5,0,1,4608,12,8779845316
5925,173614240,177164,173791404,9,0,0,40448,9,1177857492
5926,173632150,43904,173676054,0,0,0,512,20,3113840507
5927,173647239,50661,173697900,6,0,0,512,0,152179309
5928,173687930,20882,173708812,2,0,1,33792,29,1354694548
5929,173720680,5326,173726006,8,0,1,5632,3,1738830508
5930,173784269,54727,173838996,6,0,0,2560,0,5282655996
5931,173814130,1518,173815648,5,0,1,1536,12,10376429260
5932,173924440,47288,173971728,9,0,0,1536,9,6837688784
5933,173971199,43904,174015103,6,0,0,512,0,8826471465
5934,173977520,5454,173982974,8,0,1,13824,3,8212293477
5935,174055770,3387,174059157,2,0,1,9728,29,6649284760
5936,174063060,1518,174064578,5,0,1,1536,12,5359669806
5937,174098660,150069,174248729,7,0,0,131072,2,1831265951
5938,174123160,2870,174126030,5,0,1,8704,12,6383259927
5939,174130940,5196,174136136,2,0,1,13312,29,196051116
5940,174141789,107282,174249071,6,0,0,1024,0,3261793519
5941,174150910,1042,174151952,8,0,1,1024,3,2345401177
5942,174206660,127226,174333886,7,0,0,95744,2,1614180242
5943,174207610,41134,174248744,5,0,1,10752,12,1972178874
5944,174244550,210433,174454983,0,0,0,8192,20,450403234
5945,174363580,1518,174365098,8,0,1,1536,3,4969463629
5946,174391110,221925,174613035,0,0,0,204288,20,10262683234
5947,174401429,211933,174613362,3,0,0,1024,28,1567208607
5948,174405600,131282,174536882,0,0,0,7168,20,4351418076
5949,174430140,189337,174619477,0,0,0,19968,20,8923679941
5950,174525840,137114,174662954,0,0,0,50688,20,4039916256
5951,174556710,212165,174768875,0,0,0,63488,20,8018646782
5952,174559600,189916,174749516,9,0,0,61440,9,6536999819
5953,174606350,17040,174623390,8,0,1,10752,3,5803648283
5954,174609280,73768,174683048,0,0,0,4608,20,2370092259
5955,174620640,5816,174626456,5,0,1,10240,12,2163438623
5956,174624090,5543,174629633,5,0,1,10240,12,10599798190
5957,174694550,566,174695116,8,0,1,512,3,5180287101
5958,174709930,59748,174769678,7,0,0,2560,2,5675984702
5959,174727190,209636,174936826,9,0,0,28160,9,10206046514
5960,174729020,84824,174813844,0,0,0,13824,20,7246764868
5961,174746280,160926,174907206,9,0,0,81920,9,3654643137
5962,174782229,88383,174870612,6,0,0,1024,0,7690540443
5963,174798139,110338,174908477,6,0,0,4096,0,8070539413
5964,174883180,30106,174913286,2,0,1,5120,29,2485085983
5965,174948100,114140,175062240,9,0,0,74752,9,5766163586
5966,174957650,7230,174964880,8,0,1,7680,3,4641078056
5967,174998849,63562,175062411,6,0,0,512,0,8652551796
5968,175053820,213683,175267503,7,0,0,211968,2,60741442
5969,175076200,199758,175275958,9,0,0,27648,9,6715745691
5970,175111719,280852,175392571,6,0,0,1024,0,5139810962
5971,175137450,14029,175151479,8,0,1,27136,3,1663174585
5972,175210730,210614,175421344,0,0,0,6144,20,7927095459
5973,175245700,146544,175392244,9,0,0,58368,9,5639872152
5974,175266869,54677,175321546,6,0,0,1024,0,9117960900
5975,175279950,20624,175300574,5,0,1,33280,12,7514942820
5976,175320949,161966,175482915,6,0,0,3584,0,1268485731
5977,175326129,102563,175428692,6,0,0,1024,0,10377861860
5978,175336000,1994,175337994,8,0,1,2048,3,772827517
5979,175448939,4374,175453313,3,0,1,4608,28,3076660292
5980,175485799,12825,175498624,3,0,1,21504,28,3882624883
5981,175490350,131552,175621902,7,0,0,52224,2,3264642595
5982,175504900,126221,175631121,9,0,0,30208,9,6010334712
5983,175534740,4937,175539677,5,0,1,12800,12,4451344024
5984,175640660,10757,175651417,5,0,1,17408,12,7563263403
5985,175675859,48980,175724839,6,0,0,2048,0,580415010
5986,175676180,6488,175682668,5,0,1,15872,12,755287519
5987,175685450,99815,175785265,9,0,0,15872,9,8557619957
5988,175779749,6278,175786027,3,0,1,6656,28,8475031178
5989,175784490,4206,175788696,5,0,1,3584,12,3982181783
5990,175784859,5143,175790002,3,0,1,2048,28,1639463491
5991,175813390,80552,175893942,9,0,0,19968,9,10136624326
5992,175830180,10757,175840937,8,0,1,17408,3,2634579773
5993,175866330,301692,176168022,7,0,0,312320,2,9484940283
5994,175880239,6754,175886993,3,0,1,7168,28,3938878182
5995,175896820,281209,176178029,0,0,0,32768,20,662098902
5996,175899119,1518,175900637,3,0,1,1536,28,103936518
5997,175904670,5802,175910472,8,0,1,6144,3,2679037186
5998,175928769,3422,175932191,3,0,1,3584,28,7166930371
5999,175940220,1994,175942214,5,0,1,2048,12,5091769354
6000,175982000,14029,175996029,4,0,1,27136,10,8340542389
6001,175996619,4850,176001469,3,0,1,5120,28,5572050497
6002,176000449,6754,176007203,3,0,1,7168,28,9735099276
6003,176038450,6488,176044938,8,0,1,15872,3,1805509487
6004,176113340,68060,176181400,5,0,1,9728,12,6260187248
6005,176133420,53860,176187280,8,0,1,6656,3,528139228
6006,176175640,206506,176382146,7,0,0,91136,2,7672210584
6007,176213960,11016,176224976,8,0,1,17920,3,1843996987
6008,176236940,210263,176447203,0,0,0,93696,20,3166889275
6009,176238020,161925,176399945,7,0,0,58368,2,4467972381
6010,176263750,10757,176274507,8,0,1,17408,3,6226045346
6011,176306830,10757,176317587,8,0,1,17408,3,3335243153
6012,176387990,342910,176730900,7,0,0,312832,2,2694423307
6013,176459599,136985,176596584,6,0,0,3072,0,9061685117
6014,176594690,145133,176739823,9,0,0,29184,9,10134921469
6015,176654730,90764,176745494,1,0,1,14336,18,6860565447
6016,176679870,70558,176750428,8,0,1,6656,3,9764301722
6017,176769350,24929,176794279,8,0,1,45056,3,346154000
6018,176818090,6754,176824844,8,0,1,7168,3,5532650853
6019,176899380,52364,176951744,9,0,0,3072,9,4615928908
6020,176911800,4937,176916737,2,0,1,12800,29,9381687709
6021,176958630,371420,177330050,9,0,0,435200,9,1893959
6022,177106870,294862,177401732,9,0,0,155136,9,39366257
6023,177110390,4850,177115240,8,0,1,5120,3,10257266673
6024,177113810,12825,177126635,8,0,1,21504,3,8486232835
6025,177146040,607727,177753767,9,0,0,220672,9,4918664942
6026,177154760,531756,177686516,9,0,0,324096,9,8089430343
6027,177210220,674352,177884572,7,0,0,300032,2,7045640388
6028,177221280,722797,177944077,7,0,0,146944,2,9250053756
6029,177235170,96958,177332128,8,0,1,2048,3,10514465782
6030,177254540,80592,177335132,8,0,1,4608,3,1239227083
6031,177311050,455696,177766746,0,0,0,42496,20,1466208237
6032,177342380,450753,177793133,9,0,0,86528,9,4232727309
6033,177459440,2470,177461910,8,0,1,2560,3,369819224
6034,177534940,364350,177899290,7,0,0,48128,2,5232225775
6035,177577879,366369,177944248,6,0,0,512,0,996230899
6036,177650520,298587,177949107,7,0,0,15872,2,1607499323
6037,177665530,219073,177884603,5,0,1,15360,12,4948374173
6038,177684370,312176,177996546,9,0,0,155648,9,2787945887
6039,177764220,295095,178059315,0,0,0,16384,20,10120356038
6040,177783080,238129,178021209,9,0,0,80896,9,8301264806
6041,177804760,235319,178040079,0,0,0,8704,20,10397431768
6042,177896870,178392,178075262,9,0,0,21504,9,6784572706
6043,178035199,70634,178105833,6,0,0,3584,0,10425538043
6044,178177990,118196,178296186,0,0,0,88064,20,6327937
6045,178196790,4162,178200952,8,0,1,11264,3,6356448322
6046,178259910,307809,178567719,9,0,0,339456,9,3472147260
6047,178299520,3422,178302942,8,0,1,3584,3,5413688106
6048,178323059,4679,178327738,0,0,1,12288,20,8647119310
6049,178371620,212510,178584130,0,0,0,53760,20,4501222746
6050,178448690,12825,178461515,7,0,1,21504,2,7918151769
6051,178472050,115486,178587536,8,0,1,3584,3,6785545250
6052,178513400,82822,178596222,8,0,1,17920,3,4816737794
6053,178551320,148952,178700272,9,0,0,49664,9,9559084941
6054,178578810,144221,178723031,0,0,0,17408,20,349104645
6055,178619620,170761,178790381,0,0,0,25600,20,1637770731
6056,178658839,64675,178723514,6,0,0,1536,0,8247636318
6057,178795190,12566,178807756,8,0,1,20992,3,2913579467
6058,178865060,115388,178980448,7,0,0,78848,2,2803205910
6059,179008580,99944,179108524,9,0,0,28160,9,113997995
6060,179031690,11274,179042964,7,0,1,18432,2,10515093565
6061,179046170,230893,179277063,7,0,0,21504,2,5510451521
6062,179087460,104936,179192396,9,0,0,44544,9,5054525177
6063,179088150,5196,179093346,6,0,1,13312,0,8811143091
6064,179099980,10547,179110527,5,0,1,2048,12,1033870080
6065,179102240,9913,179112153,6,0,1,2560,0,6262565504
6066,179153200,3422,179156622,7,0,1,3584,2,6773552220
6067,179179630,276322,179455952,7,0,0,157184,2,3505125436
6068,179260540,1994,179262534,6,0,1,2048,0,7559886780
6069,179277909,79343,179357252,6,0,0,2048,0,809762575
6070,179311390,2470,179313860,6,0,1,2560,0,2097899410
6071,179316509,45783,179362292,6,0,0,1024,0,8629627366
6072,179321380,65612,179386992,9,0,0,11264,9,2071829782
6073,179346770,566,179347336,7,0,1,512,2,5631619482
6074,179371811,158363,179530174,9,0,1,261632,9,9849977335
6075,179394410,425345,179819755,9,0,0,207872,9,10097747007
6076,179455020,252662,179707682,0,0,0,20992,20,10012114383
6077,179478070,53487,179531557,6,0,1,14848,0,1157167540
6078,179488970,45813,179534783,7,0,1,5120,2,9153009069
6079,179492769,328569,179821338,6,0,0,5120,0,9388887733
6080,179536340,5326,179541666,8,0,1,5632,3,8595731285
6081,179567030,1042,179568072,8,0,1,1024,3,9890911341
6082,179608780,1042,179609822,6,0,1,1024,0,496729472
6083,179679340,7706,179687046,7,0,1,8192,2,6840316580
6084,179707860,2870,179710730,7,0,1,8704,2,546043503
6085,179710339,111482,179821821,6,0,0,1536,0,3341136417
6086,179768710,218472,179987182,7,0,0,113664,2,8387058183
6087,179790799,125388,179916187,6,0,0,1536,0,2417411143
6088,179855629,79176,179934805,6,0,0,1024,0,5251040938
6089,179864410,387320,180251730,9,0,0,158208,9,8623738936
6090,179886430,316566,180202996,9,0,0,271360,9,222422236
6091,179934490,7061,179941551,6,0,1,7168,0,10141649676
6092,179974930,23001,179997931,7,0,1,17408,2,157817052
6093,180015470,2946,180018416,7,0,1,3072,2,2617346399
6094,180022039,181448,180203487,6,0,0,1536,0,4849255578
6095,180139270,117381,180256651,7,0,1,12800,2,4942618760
6096,180154800,105188,180259988,7,0,1,4608,2,7790651402
6097,180156450,108364,180264814,7,0,1,7680,2,4680953706
6098,180175820,89980,180265800,7,0,1,1536,2,9984042524
6099,180194040,73706,180267746,6,0,1,3072,0,7737851803
6100,180214209,91065,180305274,6,0,0,512,0,2059105509
6101,180294969,155105,180450074,6,0,0,512,0,9732945258
6102,180316260,1518,180317778,7,0,1,1536,2,4149274711
6103,180356800,3422,180360222,7,0,1,3584,2,5660533156
6104,180367770,156687,180524457,0,0,0,37376,20,9235954220
6105,180382520,2946,180385466,6,0,1,3072,0,3556694333
6106,180431230,52364,180483594,4,0,0,3072,10,1700839104
6107,180503220,2470,180505690,6,0,1,2560,0,4904565270
6108,180531520,1042,180532562,1,0,1,1024,18,7122123670
6109,180543159,4850,180548009,0,0,1,5120,20,9041507465
6110,180556170,4850,180561020,6,0,1,5120,0,5783216082
6111,180577960,153645,180731605,7,0,0,46592,2,8933992802
6112,180686630,10499,180697129,6,0,1,16896,0,3619003371
6113,180697890,250846,180948736,0,0,0,10752,20,10076106482
6114,180733640,211805,180945445,0,0,0,197632,20,7378743945
6115,180812990,175349,180988339,7,0,0,100352,2,9117564977
6116,180905390,176748,181082138,9,0,0,37888,9,8967570333
6117,180906350,82004,180988354,6,0,1,16896,0,2735822234
6118,180940220,112643,181052863,9,0,0,22528,9,4833043539
6119,180990510,170335,181160845,7,0,0,512,2,8331353703
6120,180992510,95883,181088393,9,0,0,20480,9,6761815090
6121,181010580,181772,181192352,0,0,0,15360,20,7111894687
6122,181026759,186299,181213058,6,0,0,1536,0,2480850344
6123,181041410,245424,181286834,0,0,0,142848,20,2590881451
6124,181104320,249347,181353667,7,0,0,30208,2,7193223281
6125,181106650,93741,181200391,4,0,0,8192,10,5242340117
6126,181116150,68389,181184539,4,0,0,1536,10,5326487823
6127,181176620,3898,181180518,6,0,1,4096,0,3497978993
6128,181195760,148680,181344440,9,0,0,103936,9,100857634
6129,181202470,31783,181234253,7,0,1,51712,2,4607317184
6130,181206540,155011,181361551,9,0,0,10240,9,5769553594
6131,181231180,4379,181235559,6,0,1,2048,0,2251196103
6132,181304580,5802,181310382,6,0,1,6144,0,5484453637
6133,181323299,76135,181399434,6,0,0,1024,0,4242893723
6134,181357150,1042,181358192,2,0,1,1024,29,3725020432
6135,181492679,45596,181538275,6,0,0,1024,0,5214683676
6136,181493890,5454,181499344,7,0,1,13824,2,2975224036
6137,181500210,144513,181644723,7,0,0,44032,2,1288354234
6138,181548969,238831,181787800,6,0,0,1024,0,982354917
6139,181558560,160773,181719333,7,0,0,60928,2,6892761486
6140,181571910,121124,181693034,4,0,0,3072,10,7535420202
6141,181582660,3898,181586558,6,0,1,4096,0,5461419245
6142,181595990,3422,181599412,7,0,1,3584,2,3767621863
6143,181646600,3898,181650498,6,0,1,4096,0,691956215
6144,181654130,145306,181799436,7,0,0,5632,2,2972217772
6145,181689460,261827,181951287,9,0,0,204288,9,8876124872
6146,181713450,10312,181723762,6,0,1,11776,0,6773955821
6147,181717250,283547,182000797,0,0,0,42496,20,2384747166
6148,181789859,95078,181884937,6,0,0,512,0,666393975
6149,181826920,258154,182085074,0,0,0,64000,20,6817705794
6150,181841000,12308,181853308,7,0,1,20480,2,7500050319
6151,181880700,183752,182064452,0,0,0,37376,20,4002634231
6152,181898270,167289,182065559,0,0,0,3584,20,4783708746
6153,181907730,45117,181952847,1,0,1,1536,18,3421217829
6154,181907850,46817,181954667,7,0,1,8704,2,8294878063
6155,181951350,212593,182163943,9,0,0,35328,9,2412892512
6156,182004760,125781,182130541,7,0,0,17408,2,5951701728
6157,182025900,1994,182027894,6,0,1,2048,0,2027472959
6158,182069260,19710,182088970,6,0,1,10752,0,5245009796
6159,182107619,90170,182197789,6,0,0,1536,0,654584614
6160,182129250,130302,182259552,9,0,0,99328,9,4399592241
6161,182129900,194375,182324275,0,0,0,108032,20,3262226610
6162,182169100,214155,182383255,7,0,0,140288,2,884281731
6163,182175939,105136,182281075,6,0,0,1536,0,1515289368
6164,182260569,173878,182434447,6,0,0,3584,0,10601826877
6165,182272860,249379,182522239,0,0,0,185856,20,8874237653
6166,182326250,204452,182530702,0,0,0,27648,20,629824982
6167,182349010,272382,182621392,7,0,0,88576,2,4499561464
6168,182353150,241239,182594389,0,0,0,56320,20,4792368679
6169,182422860,118981,182541841,4,0,0,2048,10,503574768
6170,182497600,34579,182532179,6,0,1,1536,0,4373202761
6171,182505630,61328,182566958,6,0,1,62976,0,3372979044
6172,182510140,157611,182667751,7,0,0,69120,2,1386673460
6173,182525960,110467,182636427,4,0,0,3072,10,2017494951
6174,182636839,4937,182641776,0,0,1,12800,20,2657231132
6175,182656830,13383,182670213,6,0,1,2560,0,1485491193
6176,182729310,48980,182778290,0,0,0,2048,20,764162802
6177,182767890,25187,182793077,6,0,1,45568,0,5187229973
6178,182863190,57440,182920630,0,0,0,4608,20,10264931079
6179,182876009,4420,182880429,3,0,1,11776,28,9872539593
6180,182885669,3128,182888797,3,0,1,9216,28,8485361211
6181,182935460,7230,182942690,7,0,1,7680,2,7588844344
6182,182945270,12825,182958095,2,0,1,21504,29,6991504245
6183,182975690,23208,182998898,7,0,1,38400,2,10476383595
6184,182991460,76388,183067848,9,0,0,16384,9,6287671242
6185,183017639,60824,183078463,6,0,0,5632,0,9367063041
6186,183035830,2946,183038776,7,0,1,3072,2,2268702419
6187,183041460,5712,183047172,6,0,1,14336,0,6144290717
6188,183054670,158720,183213390,4,0,0,2048,10,8828908991
6189,183098120,66418,183164538,4,0,0,1024,10,7511781134
6190,183111430,6278,183117708,7,0,1,6656,2,2749393764
6191,183132630,2470,183135100,7,0,1,2560,2,10696601170
6192,183160659,5196,183165855,3,0,1,13312,28,8473516586
6193,183163020,6423,183169443,6,0,1,12288,0,5031211087
6194,183184720,71443,183256163,7,0,0,13312,2,4761760271
6195,183217970,3422,183221392,6,0,1,3584,0,3328232120
6196,183218340,3718,183222058,7,0,1,1024,2,3996324876
6197,183235229,2870,183238099,3,0,1,8704,28,7646159835
6198,183269740,78316,183348056,4,0,0,3584,10,10315276106
6199,183278409,3904,183282313,3,0,1,10752,28,2861119040
6200,183279220,144959,183424179,7,0,0,69632,2,8343649108
6201,183297310,43904,183341214,4,0,0,512,10,8439746338
6202,183306390,119520,183425910,7,0,0,5632,2,4099794875
6203,183350310,431563,183781873,0,0,0,303616,20,10278776841
6204,183357130,4162,183361292,6,0,1,11264,0,1870262765
6205,183361650,3645,183365295,6,0,1,10240,0,3837570988
6206,183372680,271558,183644238,7,0,0,222208,2,3767527342
6207,183378329,138733,183517062,5,0,0,26624,12,6669960545
6208,183407420,280546,183687966,4,0,0,512,10,7135345579
6209,183438190,369298,183807488,9,0,0,83968,9,5096793193
6210,183444759,5802,183450561,3,0,1,6144,28,5887786021
6211,183453460,13083,183466543,6,0,1,22016,0,6117517038
6212,183508420,394435,183902855,0,0,0,119296,20,7055249445
6213,183527319,303918,183831237,5,0,0,2560,12,10216993662
6214,183530270,1994,183532264,6,0,1,2048,0,10376020443
6215,183533389,16096,183549485,3,0,1,31232,28,2603629240
6216,183567339,76914,183644253,3,0,1,22016,28,2832707717
6217,183586099,73208,183659307,3,0,1,29184,28,8168243915
6218,183724000,232978,183956978,9,0,0,10240,9,8097054480
6219,183760959,49434,183810393,3,0,1,3072,28,8462910737
6220,183847979,121267,183969246,6,0,0,512,0,6530392241
6221,183855880,357067,184212947,0,0,0,79872,20,5270618769
6222,183865209,256581,184121790,5,0,0,55296,12,8238767467
6223,183914969,272676,184187645,5,0,0,216064,12,10428585690
6224,184035130,178456,184213586,4,0,0,2048,10,10356963026
6225,184038000,3422,184041422,6,0,1,3584,0,9744851547
6226,184066590,169250,184235840,0,0,0,70144,20,5591363115
6227,184086759,101837,184188596,6,0,0,3072,0,10120279209
6228,184116470,135921,184252391,9,0,0,54272,9,2752460730
6229,184214319,111644,184325963,5,0,0,66560,12,9332246993
6230,184229880,96410,184326290,4,0,0,1024,10,9164833854
6231,184237180,257635,184494815,9,0,0,225280,9,8610126089
6232,184290260,206130,184496390,0,0,0,5120,20,6997092265
6233,184483780,35052,184518832,6,0,1,36864,0,10345598625
6234,184491029,68362,184559391,5,0,0,7680,12,6065739258
6235,184508770,45596,184554366,4,0,0,1024,10,7868250271
6236,184509700,49870,184559570,4,0,0,512,10,7095951624
6237,184557610,156982,184714592,7,0,0,4608,2,8689379795
6238,184610999,10241,184621240,3,0,1,16384,28,4709404810
6239,184735630,55354,184790984,4,0,0,512,10,7384100252
6240,184757069,54056,184811125,6,0,0,3584,0,10307700009
6241,184785930,107744,184893674,7,0,0,53760,2,9436950317
6242,184815919,2870,184818789,3,0,1,8704,28,2511021293
6243,184875390,45596,184920986,4,0,0,1024,10,7815318178
6244,184951050,64364,185015414,7,0,0,7168,2,2547568338
6245,184969369,84404,185053773,5,0,0,22528,12,2188114952
6246,185010589,4850,185015439,3,0,1,5120,28,4805237689
6247,185014149,212233,185226382,5,0,0,48640,12,4153603002
6248,185043579,2870,185046449,3,0,1,8704,28,8334807701
6249,185109229,43904,185153133,5,0,0,512,12,3760948565
6250,185112670,48980,185161650,4,0,0,2048,10,5405232762
6251,185133750,4679,185138429,6,0,1,12288,0,8221124965
6252,185143929,16096,185160025,0,0,1,31232,20,1120135666
6253,185160760,66105,185226865,4,0,0,1536,10,3568783961
6254,185166820,345163,185511983,0,0,0,130048,20,9771973413
6255,185237710,60824,185298534,4,0,0,5632,10,3750568385
6256,185241710,142278,185383988,7,0,0,56320,2,5427047471
6257,185292259,7706,185299965,3,0,1,8192,28,2761550266
6258,185322189,12825,185335014,3,0,1,21504,28,5047930101
6259,185364509,93939,185458448,6,0,0,1024,0,4890399031
6260,185391849,4374,185396223,3,0,1,4608,28,4007329290
6261,185392310,4379,185396689,6,0,1,9728,0,8209246954
6262,185413639,303866,185717505,5,0,0,74752,12,2302782677
6263,185448900,63418,185512318,4,0,0,1024,10,5498325202
6264,185479540,195532,185675072,7,0,0,77824,2,6582009730
6265,185517340,73691,185591031,4,0,0,3584,10,3985024810
6266,185553989,212008,185765997,5,0,0,50176,12,190653208
6267,185590180,5693,185595873,6,0,1,5120,0,6601196762
6268,185616890,149746,185766636,4,0,0,2048,10,3047363376
6269,185662349,23989,185686338,3,0,1,18432,28,1818786616
6270,185717309,4562,185721871,3,0,1,4608,28,7977933334
6271,185732419,2946,185735365,3,0,1,3072,28,8386051634
6272,185766490,130977,185897467,7,0,0,71680,2,5274567106
6273,185820460,189213,186009673,7,0,0,146432,2,5278969138
6274,185875110,173293,186048403,7,0,0,111104,2,10288422228
6275,185908740,140146,186048886,0,0,0,1536,20,692116766
6276,185923130,126083,186049213,4,0,0,1024,10,10450094092
6277,185958829,98502,186057331,6,0,0,2048,0,10084807051
6278,185976830,97043,186073873,7,0,0,6656,2,4972832350
6279,185988980,94895,186083875,4,0,0,3072,10,8629450417
6280,185991600,114487,186106087,7,0,0,15872,2,2856883718
6281,186144840,48980,186193820,4,0,0,2048,10,9725636414
6282,186210189,169928,186380117,5,0,0,146944,12,8642276710
6283,186252739,173284,186426023,5,0,0,69632,12,5554049806
6284,186512500,50672,186563172,4,0,0,2560,10,7398518463
6285,186541239,100724,186641963,5,0,0,30720,12,6683694855
6286,186550719,161798,186712517,5,0,0,34304,12,4132082184
6287,186634020,108815,186742835,7,0,0,31232,2,2579974458
6288,186679281,33251,186712532,9,0,1,38400,9,6086783323
6289,186693810,158162,186851972,7,0,0,33280,2,6682166748
6290,186762980,222883,186985863,7,0,0,73728,2,8084292765
6291,186765099,51119,186816218,6,0,0,512,0,7013020777
6292,186798100,54683,186852783,0,0,0,2560,20,409249707
6293,186798140,87540,186885680,0,0,0,512,20,698334260
6294,186833119,79483,186912602,6,0,0,2048,0,10314301471
6295,186846079,12941,186859020,3,0,1,6656,28,4341882459
6296,186846199,15727,186861926,0,0,1,4608,20,2291996523
6297,186856900,54010,186910910,0,0,0,1536,20,5053365656
6298,186880360,271239,187151599,7,0,0,269312,2,2792881018
6299,186888629,11274,186899903,0,0,1,18432,20,412902694
6300,187051860,100574,187152434,4,0,0,2560,10,7275604685
6301,187083829,75393,187159222,0,0,1,7168,20,10609209996
6302,187103369,57479,187160848,3,0,1,2560,28,2123603805
6303,187115140,82097,187197237,4,0,0,1024,10,4897112276
6304,187119720,87694,187207414,0,0,0,4096,20,1361295266
6305,187135389,26227,187161616,3,0,1,11776,28,2976048960
6306,187140330,62637,187202967,0,0,0,2048,20,7786087998
6307,187144059,52296,187196355,6,0,0,512,0,2850729817
6308,187144641,95495,187240136,9,0,1,131072,9,7891455396
6309,187175689,96794,187272483,6,0,0,512,0,5280455635
6310,187181510,94176,187275686,4,0,0,1024,10,1362500122
6311,187182599,57883,187240482,0,0,1,512,20,5556337977
6312,187197190,178378,187375568,7,0,0,100864,2,5737073111
6313,187199899,194586,187394485,6,0,0,1024,0,4973513941
6314,187207791,65077,187272868,9,0,1,105984,9,4027543301
6315,187288241,195850,187484091,9,0,1,317952,9,9417036702
6316,187346839,139838,187486677,0,0,1,4096,20,8311668195
6317,187381739,115563,187497302,3,0,1,42496,28,10529940177
6318,187384150,322345,187706495,7,0,0,109568,2,4302704829
6319,187398119,102089,187500208,3,0,1,4608,28,9553573044
6320,187421609,83988,187505597,3,0,1,17408,28,9347358823
6321,187424990,318492,187743482,7,0,0,121344,2,9939668451
6322,187425109,80744,187505853,3,0,1,9216,28,6734114628
6323,187426029,80810,187506839,0,0,1,1536,20,9957611587
6324,187485159,23306,187508465,3,0,1,2560,28,237369915
6325,187487700,293103,187780803,4,0,0,2048,10,3922541251
6326,187502330,241331,187743661,0,0,0,512,20,8928586310
6327,187594811,7706,187602517,9,0,1,8192,9,8232493005
6328,187627319,3898,187631217,0,0,1,4096,20,2789219212
6329,187647550,120968,187768518,4,0,0,3072,10,7257664026
6330,187650370,242292,187892662,7,0,0,89600,2,351864989
6331,187683380,234132,187917512,4,0,0,5632,10,8081912567
6332,187708950,206815,187915765,7,0,0,75776,2,1106438392
6333,187752389,3422,187755811,0,0,1,3584,20,1315075252
6334,187765431,152128,187917559,9,0,1,235520,9,146865676
6335,187769779,323308,188093087,6,0,0,2048,0,3383513700
6336,187793079,188378,187981457,6,0,0,5120,0,10540103902
6337,187803120,114454,187917574,4,0,1,512,10,3992189674
6338,187834399,83190,187917589,0,0,1,10752,20,258297547
6339,187841090,138792,187979882,7,0,0,99840,2,7167805794
6340,187875210,55122,187930332,6,0,1,24576,0,8373666935
6341,187877889,58210,187936099,0,0,1,17920,20,4253489821
6342,187883591,160510,188044101,9,0,1,184320,9,4150529802
6343,187888290,158397,188046687,6,0,1,4096,0,3446834704
6344,187888319,182695,188071014,6,0,0,1536,0,908882163
6345,187890980,156693,188047673,6,0,1,1536,0,7712034408
6346,187943320,106939,188050259,6,0,1,4096,0,6804986979
6347,187988410,165649,188154059,0,0,0,512,20,6508424768
6348,187994130,56475,188050605,6,0,1,512,0,806230003
6349,188027210,25021,188052231,6,0,1,2560,0,2873892280
6350,188053321,64137,188117458,9,0,1,108032,9,9928835332
6351,188061800,56631,188118431,6,0,1,12800,0,542473096
6352,188076050,78180,188154230,4,0,0,512,10,1248326711
6353,188135710,7230,188142940,2,0,1,7680,29,4962886440
6354,188152930,253584,188406514,4,0,0,512,10,247236982
6355,188180869,3128,188183997,3,0,1,9216,28,640618122
6356,188202381,1042,188203423,9,0,1,1024,9,3296848185
6357,188218399,166581,188384980,6,0,0,1536,0,6866414704
6358,188220649,103519,188324168,6,0,0,2048,0,4166219881
6359,188247660,166005,188413665,7,0,0,12288,2,4350506934
6360,188263429,6278,188269707,0,0,1,6656,20,1141898702
6361,188271930,144239,188416169,4,0,0,512,10,529077635
6362,188382840,5326,188388166,6,0,1,5632,0,5086473494
6363,188399870,43904,188443774,4,0,0,512,10,7273349828
6364,188406220,47288,188453508,4,0,0,1536,10,3268010274
6365,188410449,168730,188579179,6,0,0,54784,0,3179945650
6366,188411650,6406,188418056,8,0,1,4608,3,9189273886
6367,188420269,253830,188674099,6,0,0,6656,0,9328274710
6368,188466320,92864,188559184,7,0,0,25088,2,1688873572
6369,188482249,189480,188671729,6,0,0,130560,0,7299072093
6370,188514550,157506,188672056,0,0,0,1024,20,4907919904
6371,188533550,4850,188538400,2,0,1,5120,29,5469770503
6372,188535469,7117,188542586,0,0,1,6656,20,3324883264
6373,188622940,3422,188626362,8,0,1,3584,3,7713751655
6374,188628900,47288,188676188,0,0,0,1536,20,9955459855
6375,188692390,4850,188697240,2,0,1,5120,29,9239490710
6376,188720300,3898,188724198,5,0,1,4096,12,10051005864
6377,188730470,13341,188743811,2,0,1,22528,29,5842011157
6378,188760620,3904,188764524,4,0,1,10752,10,10667655308
6379,188762320,4095,188766415,5,0,1,2560,12,4275803363
6380,188803020,83195,188886215,0,0,0,512,20,3943884634
6381,188805510,3645,188809155,2,0,1,10240,29,3498875804
6382,188827740,4420,188832160,6,0,1,11776,0,216234659
6383,188866000,13512,188879512,6,0,1,26112,0,6143545770
6384,188888870,5802,188894672,6,0,1,6144,0,9117372757
6385,188889940,5500,188895440,2,0,1,11776,29,1997608458
6386,188904120,92355,188996475,4,0,0,22528,10,8551704166
6387,188915430,99567,189014997,0,0,0,1536,20,275158413
6388,188944340,7230,188951570,8,0,1,7680,3,4289983788
6389,188979780,50672,189030452,0,0,0,2560,20,8146060192
6390,188982100,66119,189048219,0,0,0,3584,20,8761712863
6391,189028219,186091,189214310,6,0,0,58880,0,5869574725
6392,189031760,2946,189034706,1,0,1,3072,18,710915786
6393,189039190,157157,189196347,7,0,0,90624,2,7650612290
6394,189047970,166667,189214637,0,0,0,1024,20,7011883399
6395,189081370,7230,189088600,6,0,1,7680,0,9293831040
6396,189127110,2470,189129580,5,0,1,2560,12,7043704134
6397,189131000,4420,189135420,1,0,1,11776,18,10597031346
6398,189167400,276740,189444140,7,0,0,37888,2,9826062420
6399,189173750,413972,189587722,7,0,0,6656,2,1925553000
6400,189196450,33241,189229691,8,0,1,29184,3,8824153815
6401,189223369,147481,189370850,6,0,0,40448,0,282733206
6402,189223370,6885,189230255,6,0,1,10752,0,10367651198
6403,189225280,5561,189230841,8,0,1,10752,3,7754942497
6404,189225800,10642,189236442,2,0,1,15360,29,10237657170
6405,189283870,566,189284436,1,0,1,512,18,8161192845
6406,189286329,299334,189585663,6,0,0,180224,0,645186282
6407,189310200,2470,189312670,2,0,1,2560,29,2827045588
6408,189311809,294542,189606351,6,0,0,53760,0,5522867676
6409,189317210,4850,189322060,1,0,1,5120,18,803337977
6410,189351390,2870,189354260,8,0,1,8704,3,3316529406
6411,189387230,3645,189390875,6,0,1,10240,0,1520543869
6412,189395690,3904,189399594,1,0,1,10752,18,2274613295
6413,189418540,4850,189423390,6,0,1,5120,0,10092646692
6414,189460140,6278,189466418,1,0,1,6656,18,8852440905
6415,189490240,12049,189502289,5,0,1,19968,12,263424035
6416,189519950,221138,189741088,7,0,0,61440,2,4550609078
6417,189527540,227291,189754831,4,0,0,45056,10,3540110732
6418,189540940,92003,189632943,0,0,0,1536,20,1236025493
6419,189557651,308342,189865993,9,0,1,455168,9,8263784059
6420,189594390,272576,189866966,8,0,1,12800,3,4481030324
6421,189618460,249492,189867952,6,0,1,1536,0,3812990072
6422,189628640,245930,189874570,1,0,1,31744,18,5241012113
6423,189629150,248006,189877156,6,0,1,4096,0,1765449106
6424,189646800,485278,190132078,4,0,0,20480,10,3999053243
6425,189669319,403927,190073246,6,0,0,35328,0,2051156579
6426,189679269,413024,190092293,6,0,0,62464,0,371964750
6427,189682410,200852,189883262,5,0,1,20992,12,843584907
6428,189699279,303461,190002740,6,0,0,41984,0,8826745341
6429,189713100,175551,189888651,8,0,1,17408,3,3244022982
6430,189713400,185569,189898969,1,0,1,32768,18,5354748105
6431,189716590,325165,190041755,0,0,0,1536,20,9553339828
6432,189721780,182015,189903795,5,0,1,7680,12,8934301318
6433,189741130,279124,190020254,0,0,0,2560,20,686079072
6434,189750410,153731,189904141,5,0,1,512,12,6274209251
6435,189757760,151668,189909428,1,0,1,16896,18,2792085392
6436,189779440,130974,189910414,5,0,1,1536,12,916428137
6437,189822610,90390,189913000,5,0,1,4096,12,2023420805
6438,189824289,289087,190113376,6,0,0,69120,0,3367498175
6439,189852430,186546,190038976,0,0,0,2560,20,7894225740
6440,189898059,294017,190192076,6,0,0,54784,0,6592932845
6441,189955280,2470,189957750,8,0,1,2560,3,4212518595
6442,189968780,15321,189984101,7,0,1,29696,2,6408764471
6443,190010770,1518,190012288,8,0,1,1536,3,3579784982
6444,190017470,3422,190020892,8,0,1,3584,3,3501260770
6445,190023320,3387,190026707,8,0,1,9728,3,2332169480
6446,190082481,52770,190135251,9,0,1,35840,9,8475149560
6447,190111910,24519,190136429,8,0,1,13824,3,6276698130
6448,190125390,11705,190137095,2,0,1,1024,29,1239587313
6449,190134010,394264,190528274,4,0,0,82944,10,2403404219
6450,190137730,4374,190142104,8,0,1,4608,3,4198113761
6451,190196729,7706,190204435,3,0,1,8192,28,10356043350
6452,190201430,14804,190216234,5,0,1,28672,12,1326929811
6453,190213270,119000,190332270,7,0,0,43520,2,9083506534
6454,190216761,186154,190402915,9,0,1,305664,9,9372838257
6455,190231690,175731,190407421,5,0,1,7168,12,4859797480
6456,190245499,163202,190408701,3,0,1,14336,28,6271920750
6457,190248870,418293,190667163,7,0,0,96768,2,1989403048
6458,190256350,152505,190408855,5,0,1,8704,12,2159450659
6459,190273820,136341,190410161,8,0,1,2048,3,6598732323
6460,190294930,157540,190452470,0,0,0,512,20,7654300183
6461,190308939,268794,190577733,6,0,0,31232,0,3617803009
6462,190388209,22298,190410507,0,0,1,512,20,3278876407
6463,190392289,214758,190607047,6,0,0,15360,0,2743836818
6464,190405489,15837,190421326,0,0,1,30720,20,2693548146
6465,190431781,117604,190549385,9,0,1,195584,9,9005493062
6466,190459050,148168,190607218,0,0,0,512,20,7520166726
6467,190461130,309048,190770178,7,0,0,52224,2,9141727383
6468,190529729,247336,190777065,6,0,0,22528,0,489872775
6469,190557389,5196,190562585,0,0,1,13312,20,4203474207
6470,190578899,3422,190582321,0,0,1,3584,20,8402537578
6471,190587920,4162,190592082,5,0,1,11264,12,6367453107
6472,190627411,74091,190701502,9,0,1,120832,9,10148373895
6473,190689430,14018,190703448,8,0,1,3072,3,2496851526
6474,190700730,160439,190861169,0,0,0,2560,20,4795108573
6475,190720529,5802,190726331,0,0,1,6144,20,4230274177
6476,190766490,12553,190779043,5,0,1,2048,12,839019261
6477,190768759,12559,190781318,0,0,1,10240,20,4418278426
6478,190792670,4850,190797520,8,0,1,5120,3,7693851617
6479,190803459,2470,190805929,0,0,1,2560,20,7631149199
6480,190803940,260810,191064750,4,0,0,32256,10,9912501353
6481,190812559,6229,190818788,0,0,1,15360,20,8458222980
6482,190838680,3904,190842584,7,0,1,10752,2,2802634885
6483,190914279,12995,190927274,0,0,1,25088,20,8797145032
6484,190914300,16200,190930500,5,0,1,5120,12,6101069108
6485,190930960,2470,190933430,5,0,1,2560,12,6641680585
6486,191000179,147336,191147515,6,0,0,80896,0,3265970116
6487,191030800,6278,191037078,2,0,1,6656,29,6571839193
6488,191092469,65900,191158369,6,0,0,7168,0,5369255471
6489,191098690,49316,191148006,0,0,0,1536,20,5166856261
6490,191127901,77177,191205078,9,0,1,97792,9,3871957868
6491,191152770,57134,191209904,5,0,1,7680,12,9727922985
6492,191171430,42660,191214090,2,0,1,6656,29,8645482498
6493,191177880,41804,191219684,2,0,1,18432,29,6187094279
6494,191195320,25235,191220555,2,0,1,12288,29,1885583934
6495,191198301,68050,191266351,9,0,1,114176,9,5501214567
6496,191201150,70027,191271177,2,0,1,7680,29,1596595136
6497,191245899,336880,191582779,6,0,0,27136,0,9292838899
6498,191273701,36346,191310047,9,0,1,64000,9,4146305985
6499,191284620,25773,191310393,2,0,1,512,29,307275390
6500,191287281,108316,191395597,9,0,1,165376,9,5539869623
6501,191288900,100821,191389721,0,0,0,3072,20,77828515
6502,191305800,96210,191402010,2,0,1,22528,29,4466708215
6503,191401890,195256,191597146,7,0,0,47104,2,2397204565
6504,191409879,2946,191412825,3,0,1,3072,28,2576050664
6505,191433700,170409,191604109,7,0,0,7168,2,2807116270
6506,191434620,566,191435186,5,0,1,512,12,3981103188
6507,191460189,331282,191791471,6,0,0,130560,0,1271219262
6508,191475320,26479,191501799,5,0,1,48128,12,7910938347
6509,191533651,13600,191547251,9,0,1,23040,9,4375085810
6510,191539421,9008,191548429,9,0,1,13824,9,3187056140
6511,191547360,4420,191551780,2,0,1,11776,29,4885458374
6512,191554721,45696,191600417,9,0,1,78848,9,1771188382
6513,191557669,352449,191910118,6,0,0,38912,0,6046368542
6514,191577209,26915,191604124,3,0,1,3072,28,4258898564
6515,191600770,4850,191605620,5,0,1,5120,12,8895625165
6516,191606869,20366,191627235,3,0,1,32768,28,7104469815
6517,191633430,4374,191637804,6,0,1,4608,0,7604076882
6518,191647229,523143,192170372,6,0,0,384512,0,7865592161
6519,191668801,122701,191791502,9,0,1,193024,9,4112417670
6520,191677180,114337,191791517,5,0,1,4608,12,2591992536
6521,191705830,85702,191791532,5,0,1,1024,12,3134892319
6522,191720310,73969,191794279,2,0,1,26624,29,1456815861
6523,191726210,70015,191796225,5,0,1,3072,12,4954053570
6524,191727749,74685,191802434,3,0,1,21504,28,5348029647
6525,191733830,73430,191807260,5,0,1,7680,12,2986244959
6526,191753880,278868,192032748,0,0,0,512,20,809235796
6527,191760019,47395,191807414,3,0,1,8704,28,3415179757
6528,191842980,340043,192183023,7,0,0,41472,2,9949935470
6529,191887210,7706,191894916,5,0,1,8192,12,10475016833
6530,191934180,249014,192183194,0,0,0,512,20,10025908348
6531,191945640,6229,191951869,4,0,1,15360,10,3589243437
6532,192017679,1042,192018721,3,0,1,1024,28,4065676566
6533,192043480,150801,192194281,7,0,0,11776,2,5808843428
6534,192050830,149213,192200043,0,0,0,2048,20,1941364502
6535,192099139,89390,192188529,3,0,1,5632,28,3005329153
6536,192170630,25305,192195935,2,0,1,17920,29,535100460
6537,192188050,15978,192204028,1,0,1,23040,18,6849579893
6538,192196620,164050,192360670,0,0,0,1536,20,9583398529
6539,192219249,49033,192268282,6,0,0,2048,0,8320329044
6540,192237730,348232,192585962,4,0,0,90112,10,8806847992
6541,192264230,239831,192504061,4,0,0,202752,10,7992550101
6542,192352780,25446,192378226,1,0,1,46080,18,2999201752
6543,192380100,275936,192656036,7,0,0,15360,2,3187369934
6544,192388390,4374,192392764,2,0,1,4608,29,2533531375
6545,192388900,5105,192394005,1,0,1,11264,18,4057223794
6546,192390750,6994,192397744,2,0,1,11776,29,2824802092
6547,192414700,6754,192421454,7,0,1,7168,2,835980518
6548,192415079,6721,192421800,3,0,1,512,28,2690940409
6549,192441940,351789,192793729,4,0,0,184320,10,3349844205
6550,192461770,45428,192507198,1,0,1,9216,18,3896554984
6551,192479340,49196,192528536,7,0,1,35328,2,6752283966
6552,192537450,3645,192541095,2,0,1,10240,29,3504296484
6553,192568290,20134,192588424,2,0,1,2560,29,7497742067
6554,192614410,60640,192675050,0,0,0,1024,20,2849968831
6555,192619071,3904,192622975,9,0,1,10752,9,3273820030
6556,192637839,12995,192650834,3,0,1,25088,28,7456877473
6557,192686029,49907,192735936,6,0,0,2048,0,1177950623
6558,192714970,82542,192797512,7,0,0,12288,2,5552387099
6559,192717640,87944,192805584,0,0,0,1536,20,8125183446
6560,192718310,198908,192917218,4,0,0,66048,10,10713454458
6561,192749369,274190,193023559,6,0,0,56320,0,8293621647
6562,192757320,215527,192972847,7,0,0,51200,2,2660965351
6563,192764010,36407,192800417,2,0,1,3072,29,8524469438
6564,192830050,7230,192837280,2,0,1,7680,29,9755721200
6565,192869090,14287,192883377,1,0,1,27648,18,9098789614
6566,192893261,1994,192895255,9,0,1,2048,9,5171402898
6567,192906620,24724,192931344,7,0,1,24064,2,9097525090
6568,192911309,26850,192938159,3,0,1,23040,28,4807108361
6569,192923509,471640,193395149,6,0,0,214528,0,5175458078
6570,192935010,238808,193173818,7,0,0,78336,2,5125527653
6571,192954780,69129,193023909,0,0,0,1024,20,10116140801
6572,192968750,492753,193461503,4,0,0,203264,10,3910197720
6573,192976690,1518,192978208,2,0,1,1536,29,8018571178
6574,192977490,137192,193114682,4,0,0,45568,10,9426954657
6575,193001720,21862,193023582,8,0,1,20480,3,10165507589
6576,193004940,179143,193184083,0,0,0,3072,20,4255790052
6577,193055130,11016,193066146,1,0,1,17920,18,8480177046
6578,193063560,4420,193067980,7,0,1,11776,2,3425264254
6579,193079641,2946,193082587,9,0,1,3072,9,5289377327
6580,193132309,267247,193399556,6,0,0,14336,0,2154095857
6581,193142659,336058,193478717,6,0,0,27136,0,2338832192
6582,193145060,325374,193470434,4,0,0,29184,10,2190934717
6583,193153140,387036,193540176,7,0,0,1024,2,3645628141
6584,193175830,364011,193539841,4,0,0,83456,10,8202987447
6585,193215700,433035,193648735,7,0,0,41472,2,6642325690
6586,193280890,14545,193295435,1,0,1,28160,18,9289647921
6587,193300359,413294,193713653,6,0,0,185344,0,4339330291
6588,193311650,7706,193319356,2,0,1,8192,29,9750466386
6589,193317350,2992,193320342,1,0,1,1536,18,9822701887
6590,193342150,136606,193478756,7,0,1,11776,2,10467871218
6591,193368100,132885,193500985,7,0,0,15360,2,3789538430
6592,193375329,103450,193478779,3,0,1,12288,28,9994453181
6593,193409410,81398,193490808,7,0,1,19968,2,10736638037
6594,193451800,44397,193496197,7,0,1,17408,2,6711086530
6595,193455380,454402,193909782,4,0,0,299520,10,4603041154
6596,193456600,310918,193767518,7,0,0,512,2,5463212003
6597,193485300,445461,193930761,7,0,0,512,2,2309113322
6598,193514870,199149,193714019,0,0,0,1024,20,3209047922
6599,193530470,203781,193734251,0,0,0,2560,20,2343096170
6600,193538550,7445,193545995,2,0,1,6144,29,6075214648
6601,193586279,344311,193930590,6,0,0,66560,0,8889757363
6602,193591809,198536,193790345,6,0,0,16384,0,368342910
6603,193599420,3422,193602842,7,0,1,3584,2,7051292597
6604,193612390,5454,193617844,7,0,1,13824,2,6115635551
6605,193623201,25557,193648758,9,0,1,32768,9,3726867256
6606,193638571,14368,193652939,9,0,1,11264,9,9452002965
6607,193644950,68718,193713668,2,0,1,20480,29,5080481770
6608,193645860,264435,193910295,0,0,0,512,20,334226604
6609,193665200,244924,193910124,0,0,0,1024,20,9098729394
6610,193686020,245700,193931720,0,0,0,3072,20,2464203237
6611,193696890,29396,193726286,4,0,1,20480,10,4147145924
6612,193727230,3422,193730652,7,0,1,3584,2,2542980463
6613,193727670,3968,193731638,2,0,1,1536,29,1942548923
6614,193750490,1518,193752008,2,0,1,1536,29,2610313510
6615,193813350,96447,193909797,1,0,1,5632,18,9476991568
6616,193873170,206970,194080140,4,0,0,58368,10,10530614167
6617,193902310,80183,193982493,0,0,0,1024,20,3034307982
6618,193951530,2470,193954000,7,0,1,2560,2,8353104757
6619,193965270,126132,194091402,4,0,0,36864,10,358521676
6620,193980960,3128,193984088,2,0,1,9216,29,9610205531
6621,194006060,150244,194156304,7,0,0,2048,2,1378435081
6622,194009020,303326,194312346,4,0,0,286208,10,8366154485
6623,194059100,21055,194080155,1,0,1,6656,18,5291921721
6624,194071370,146129,194217499,0,0,0,1024,20,7383602242
6625,194157020,5802,194162822,4,0,1,6144,10,183483978
6626,194158410,154739,194313149,7,0,0,2560,2,4777622659
6627,194164859,153157,194318016,6,0,0,15872,0,2849595623
6628,194182420,6278,194188698,4,0,1,6656,10,2254750124
6629,194217300,155125,194372425,7,0,0,2048,2,5755615061
6630,194239540,79978,194319518,4,0,1,1536,10,8556105
6631,194259511,82077,194341588,9,0,1,41472,9,3300321748
6632,194267450,74702,194342152,7,0,1,10752,2,1293394424
6633,194280190,95157,194375347,0,0,0,1536,20,7073406170
6634,194325720,19018,194344738,1,0,1,4096,18,6194193205
6635,194346861,64912,194411773,9,0,1,109568,9,6133668681
6636,194364500,47632,194412132,1,0,1,9728,18,7698342241
6637,194365770,296886,194662656,4,0,0,201728,10,932081114
6638,194370950,44088,194415038,1,0,1,4608,18,3133285564
6639,194374981,42323,194417304,9,0,1,3584,9,559807194
6640,194376300,47213,194423513,1,0,1,21504,18,2354543872
6641,194383451,40728,194424179,9,0,1,1024,9,6002903704
6642,194445900,12995,194458895,1,0,1,25088,18,8882450496
6643,194476781,1518,194478299,9,0,1,1536,9,9915034610
6644,194503260,3128,194506388,4,0,1,9216,10,6896166143
6645,194517720,3422,194521142,4,0,1,3584,10,9407075749
6646,194530670,6229,194536899,7,0,1,15360,2,6902688384
6647,194535220,2345,194537565,7,0,1,1024,2,997020863
6648,194551100,5802,194556902,5,0,1,6144,12,8568667961
6649,194557200,5802,194563002,7,0,1,6144,2,9016873915
6650,194597650,1518,194599168,1,0,1,1536,18,10445714362
6651,194641210,22004,194663214,1,0,1,512,18,4080196168
6652,194663221,1995,194665216,9,0,1,2048,9,6869565152
6653,194666520,2946,194669466,1,0,1,3072,18,2830513140
6654,194719530,10757,194730287,7,0,1,17408,2,7576202680
6655,194719739,113536,194833275,6,0,0,14848,0,2014396933
6656,194723200,151955,194875155,4,0,0,53248,10,3626667864
6657,194726841,5712,194732553,9,0,1,3584,9,2219624288
6658,194757090,16613,194773703,1,0,1,32256,18,434749709
6659,194766200,13200,194779400,4,0,1,18944,10,2257834811
6660,194776300,229361,195005661,4,0,0,64000,10,8242931855
6661,194783979,161298,194945277,6,0,0,27136,0,10660213951
6662,194788840,316889,195105729,4,0,0,65024,10,4191584298
6663,194822189,263698,195085887,6,0,0,99328,0,2481342825
6664,194842831,566,194843397,9,0,1,512,9,8530003000
6665,194858091,17079,194875170,9,0,1,15360,9,6178471997
6666,194963381,3422,194966803,9,0,1,3584,9,8234732098
6667,194977220,130114,195107334,7,0,0,1536,2,4604736144
6668,194994260,112591,195106851,7,0,0,2560,2,5073210583
6669,195012230,1042,195013272,4,0,1,1024,10,690459755
6670,195034040,72016,195106056,7,0,0,1024,2,6484364857
6671,195050831,35071,195085902,9,0,1,6144,9,3783009654
6672,195105190,5082,195110272,7,0,1,3072,2,6390072158
6673,195119379,103376,195222755,6,0,0,39424,0,1956543655
6674,195123130,7706,195130836,7,0,1,8192,2,4860691654
6675,195142470,13512,195155982,7,0,1,26112,2,3341694288
6676,195142520,81342,195223862,0,0,0,3584,20,9192112989
6677,195203839,184419,195388258,6,0,0,100864,0,5516119034
6678,195213251,63411,195276662,9,0,1,86016,9,7471538821
6679,195256380,87629,195344009,7,0,0,1024,2,5424349995
6680,195326720,1042,195327762,7,0,1,1024,2,1730991118
6681,195338030,99601,195437631,0,0,0,2048,20,872374369
6682,195373830,60016,195433846,0,0,0,1024,20,1527857874
6683,195408240,83756,195491996,4,0,0,15360,10,6366159845
6684,195423480,42424,195465904,7,0,1,69120,2,9257492410
6685,195442741,24149,195466890,9,0,1,1536,9,6979955195
6686,195452390,15166,195467556,7,0,1,1024,2,3408262544
6687,195519490,52364,195571854,4,0,0,3072,10,4591330294
6688,195521739,221022,195742761,6,0,0,91648,0,5716385680
6689,195568400,235460,195803860,0,0,0,4608,20,5363798937
6690,195624730,12566,195637296,7,0,1,20992,2,2097282302
6691,195674319,259825,195934144,6,0,0,175104,0,3378525703
6692,195680181,23466,195703647,9,0,1,38912,9,8952116375
6693,195718410,155931,195874341,7,0,0,4096,2,9419130698
6694,195723630,22094,195745724,4,0,1,3072,10,7855840494
6695,195780780,15579,195796359,7,0,1,30208,2,2720791000
6696,195785280,12385,195797665,1,0,1,2048,18,176277378
6697,195802709,3137,195805846,3,0,1,2048,28,5053790064
6698,195826690,309346,196136036,4,0,0,157184,10,7580109307
6699,195858899,171639,196030538,6,0,0,38912,0,9603850137
6700,195874950,4420,195879370,4,0,1,11776,10,10406132856
6701,195877020,57139,195934159,4,0,1,9216,10,4631402010
6702,195902580,36267,195938847,1,0,1,12288,18,1863878670
6703,195922150,95776,196017926,0,0,0,2560,20,7056778706
6704,195938740,6278,195945018,4,0,1,6656,10,5375873013
6705,195962990,5326,195968316,7,0,1,5632,2,7363804918
6706,195983530,13512,195997042,4,0,1,26112,10,18035607
6707,196038190,98485,196136675,0,0,0,2048,20,7751690043
6708,196062010,74844,196136854,7,0,0,512,2,10367621021
6709,196062900,82507,196145407,0,0,0,3072,20,6544101753
6710,196121890,16917,196138807,1,0,1,2048,18,8173823196
6711,196148200,80243,196228443,4,0,0,12800,10,535413302
6712,196153950,49531,196203481,0,0,0,1536,20,6303947208
6713,196157670,59132,196216802,4,0,0,5120,10,6277249892
6714,196181179,184405,196365584,6,0,0,27648,0,6182194128
6715,196212529,267566,196480095,6,0,0,87040,0,1946629512
6716,196243230,5326,196248556,4,0,1,5632,10,880201204
6717,196263350,47288,196310638,0,0,0,1536,20,5319906321
6718,196302950,82980,196385930,7,0,0,2560,2,4711123121
6719,196366340,5971,196372311,4,0,1,14848,10,8517052561
6720,196370259,11670,196381929,3,0,1,17920,28,6186016931
6721,196374169,25469,196399638,3,0,1,38400,28,1588192998
6722,196397400,49292,196446692,7,0,0,3072,2,8124046744
6723,196406140,74438,196480578,7,0,0,1536,2,131976080
6724,196435790,2946,196438736,4,0,1,3072,10,1544850956
6725,196443810,165237,196609047,4,0,0,1024,10,10371250368
6726,196494960,2870,196497830,4,0,1,8704,10,8705130471
6727,196528060,45596,196573656,7,0,0,1024,2,9632617330
6728,196531690,4679,196536369,7,0,1,12288,2,4374131916
6729,196554519,5802,196560321,3,0,1,6144,28,10085674540
6730,196558189,6754,196564943,3,0,1,7168,28,7511637755
6731,196579390,52148,196631538,7,0,0,1024,2,2371359532
6732,196586960,3645,196590605,4,0,1,10240,10,10721117938
6733,196660820,34367,196695187,1,0,1,56832,18,3228982175
6734,196768430,10499,196778929,1,0,1,16896,18,2225365902
6735,196838919,16096,196855015,3,0,1,31232,28,442870120
6736,196849030,9851,196858881,5,0,1,6144,12,868834950
6737,196850840,70732,196921572,7,0,0,1024,2,3413618775
6738,196900920,5326,196906246,4,0,1,5632,10,6718346647
6739,196922659,3422,196926081,3,0,1,3584,28,2997101882
6740,196927919,62228,196990147,6,0,0,10240,0,9268069491
6741,196938850,86262,197025112,4,0,0,2560,10,2889882708
6742,196941439,14117,196955556,3,0,1,24064,28,5003675200
6743,197012370,47288,197059658,7,0,0,1536,2,7502090225
6744,197017100,14117,197031217,4,0,1,24064,10,6765365877
6745,197065780,21658,197087438,5,0,1,35328,12,4903730158
6746,197078110,9994,197088104,2,0,1,1024,29,9409647211
6747,197087720,43904,197131624,7,0,0,512,2,957432648
6748,197090720,151604,197242324,4,0,0,137216,10,5744899725
6749,197118970,10241,197129211,5,0,1,16384,12,248883552
6750,197128270,6229,197134499,5,0,1,15360,12,9921046561
6751,197135310,5971,197141281,4,0,1,14848,10,9960366518
6752,197137790,285820,197423610,9,0,0,44032,9,1216682344
6753,197162340,1518,197163858,2,0,1,1536,29,6818117747
6754,197173210,6278,197179488,2,0,1,6656,29,10427950651
6755,197200069,42270,197242339,3,0,1,1024,28,3679632582
6756,197205020,53449,197258469,1,0,1,31232,18,2920597170
6757,197205109,56266,197261375,0,0,1,4608,20,10229351940
6758,197240819,169360,197410179,6,0,0,62976,0,796066005
6759,197243229,18402,197261631,3,0,1,9216,28,3821765574
6760,197262900,4850,197267750,5,0,1,5120,12,4094127324
6761,197307940,305812,197613752,9,0,0,159744,9,9002190194
6762,197329431,1042,197330473,9,0,1,1024,9,547037290
6763,197333770,47288,197381058,7,0,0,1536,2,6582011775
6764,197339380,139084,197478464,7,0,0,512,2,3828533361
6765,197395130,29581,197424711,7,0,1,1024,2,3623681614
6766,197396940,126118,197523058,9,0,0,7680,9,3455149571
6767,197408161,20499,197428660,9,0,1,12288,9,3877616007
6768,197416770,95991,197512761,7,0,0,3072,2,5995315916
6769,197440770,86913,197527683,7,0,0,512,2,8076373860
6770,197494800,6488,197501288,2,0,1,15872,29,5146575973
6771,197502390,1042,197503432,1,0,1,1024,18,3614900729
6772,197506790,1518,197508308,4,0,1,1536,10,1706243942
6773,197517280,102307,197619587,4,0,0,18944,10,8946785009
6774,197518319,21658,197539977,3,0,1,35328,28,6418670896
6775,197524920,18923,197543843,1,0,1,6144,18,3624052464
6776,197547260,209485,197756745,7,0,0,512,2,2276536909
6777,197570179,289516,197859695,6,0,0,140800,0,9436506023
6778,197572300,51144,197623444,2,0,1,4096,29,273742997
6779,197574880,333042,197907922,9,0,0,158208,9,4784850161
6780,197590610,34863,197625473,1,0,1,12288,18,9079274591
6781,197594250,36090,197630340,7,0,1,6144,2,7788816928
6782,197607900,301160,197909060,7,0,0,1024,2,8727336815
6783,197645199,566,197645765,3,0,1,512,28,4606163324
6784,197664640,32558,197697198,5,0,1,53248,12,3456854287
6785,197676080,24984,197701064,7,0,1,6144,2,9226875658
6786,197680059,22951,197703010,3,0,1,3072,28,8069003096
6787,197705540,203185,197908725,7,0,0,2560,2,5904968443
6788,197738280,3387,197741667,2,0,1,9728,29,6613060719
6789,197761280,359705,198120985,9,0,0,204288,9,5345160760
6790,197763789,2470,197766259,3,0,1,2560,28,8480807117
6791,197835730,156176,197991906,7,0,0,512,2,2398890027
6792,197861260,49753,197911013,2,0,1,2048,29,6781075137
6793,197873010,277162,198150172,9,0,0,95744,9,8332765380
6794,197921090,11274,197932364,5,0,1,18432,12,1481024211
6795,197931380,1650,197933030,4,0,1,1024,10,9281198312
6796,197943490,345201,198288691,9,0,0,224256,9,1740491258
6797,197990990,306780,198297770,9,0,0,29696,9,7018730954
6798,198011490,6754,198018244,2,0,1,7168,29,7908585939
6799,198029170,3387,198032557,1,0,1,9728,18,6926870781
6800,198035850,2470,198038320,1,0,1,2560,18,4527482400
6801,198050550,247547,198298097,7,0,0,1024,2,9423390317
6802,198202520,3898,198206418,1,0,1,4096,18,3562420255
6803,198210900,88328,198299228,7,0,0,3584,2,10369554793
6804,198211589,121342,198332931,6,0,0,81408,0,3753833880
6805,198224270,78339,198302609,4,0,1,3584,10,8121052068
6806,198228620,74655,198303275,1,0,1,1024,18,3266028575
6807,198253480,49981,198303461,2,0,1,8704,29,301154868
6808,198276340,123434,198399774,9,0,0,33792,9,5912329046
6809,198285770,18039,198303809,1,0,1,512,18,8280606722
6810,198308540,34666,198343206,2,0,1,16384,29,5766560605
6811,198331870,12514,198344384,5,0,1,13824,12,892023443
6812,198331959,288153,198620112,6,0,0,27648,0,9120432500
6813,198353969,215133,198569102,6,0,0,152064,0,10225256273
6814,198435730,135571,198571301,9,0,0,7168,9,449685936
6815,198470770,181961,198652731,9,0,0,107008,9,6501814010
6816,198483349,2870,198486219,3,0,1,8704,28,5171872630
6817,198495000,7706,198502706,5,0,1,8192,12,9743982841
6818,198502240,150678,198652918,7,0,0,512,2,6786411336
6819,198546480,29229,198575709,4,0,1,4608,10,3187529235
6820,198564930,140475,198705405,8,0,0,3072,3,724414341
6821,198571210,5949,198577159,1,0,1,11776,18,2741308391
6822,198573720,7360,198581080,2,0,1,12288,29,852688540
6823,198574460,8555,198583015,7,0,1,8704,2,1611471744
6824,198582170,4590,198586760,7,0,1,4096,2,3468553996
6825,198620100,33343,198653443,2,0,1,512,29,10467891138
6826,198622940,32087,198655027,7,0,1,2048,2,5448087946
6827,198655190,3128,198658318,5,0,1,9216,12,9501613810
6828,198695431,10499,198705930,9,0,1,16896,9,10220614155
6829,198731299,1994,198733293,3,0,1,2048,28,7409457546
6830,198769240,2470,198771710,2,0,1,2560,29,3158265620
6831,198780880,4374,198785254,4,0,1,4608,10,4694703757
6832,198801690,152056,198953746,4,0,0,23552,10,8063847016
6833,198806210,47288,198853498,7,0,0,1536,2,8119109280
6834,198821200,276996,199098196,9,0,0,259584,9,442076064
6835,198847220,4679,198851899,5,0,1,12288,12,9169841523
6836,198862889,20882,198883771,3,0,1,33792,28,4591064620
6837,198863829,23488,198887317,3,0,1,5632,28,2300467241
6838,198880060,219087,199099147,7,0,0,3072,2,5126213649
6839,198880940,12074,198893014,2,0,1,18944,29,2719058198
6840,198887779,9101,198896880,3,0,1,6144,28,2163599947
6841,198904860,222322,199127182,9,0,0,79872,9,83643198
6842,198938710,225892,199164602,4,0,0,14336,10,3575955590
6843,198956160,4162,198960322,7,0,1,11264,2,3643241476
6844,198965270,4937,198970207,5,0,1,12800,12,438455508
6845,198987820,13770,199001590,4,0,1,26624,10,2894725969
6846,198994310,7434,199001744,2,0,1,8704,29,8072359011
6847,199085000,93634,199178634,7,0,0,1024,2,2143816243
6848,199135680,4374,199140054,5,0,1,4608,12,5641345408
6849,199155130,14804,199169934,4,0,1,28672,10,8488347133
6850,199159740,11820,199171560,4,0,1,2560,10,9654853431
6851,199168950,170956,199339906,7,0,0,512,2,1721249908
6852,199173850,2946,199176796,7,0,1,3072,2,2613036696
6853,199185850,5326,199191176,5,0,1,5632,12,49757651
6854,199244780,43904,199288684,7,0,0,512,2,3603056293
6855,199246850,184830,199431680,4,0,0,97280,10,7086352853
6856,199319500,5802,199325302,7,0,1,6144,2,1957142182
6857,199319990,268932,199588922,9,0,0,244224,9,1888514084
6858,199418250,19151,199437401,4,0,1,14336,10,1624838770
6859,199423940,22874,199446814,4,0,1,17408,10,6764155300
6860,199432090,157479,199589569,7,0,0,2048,2,7927230158
6861,199466090,3422,199469512,7,0,1,3584,2,1959134650
6862,199512380,78140,199590520,7,0,0,3072,2,8901217075
6863,199544250,51966,199596216,5,0,1,14336,12,10038327492
6864,199575430,42650,199618080,2,0,1,38400,29,139760381
6865,199602710,16241,199618951,4,0,1,12288,10,4803876248
6866,199681020,205368,199886388,4,0,0,114176,10,1033746764
6867,199688219,417576,200105795,6,0,0,3072,0,6806736018
6868,199714860,3422,199718282,4,0,1,3584,10,7715051533
6869,199737739,367105,200104844,6,0,0,112128,0,39339844
6870,199768680,301985,200070665,4,0,0,118784,10,10337687044
6871,199776281,4374,199780655,9,0,1,4608,9,4192894013
6872,199792281,6754,199799035,9,0,1,7168,9,80517404
6873,199804910,15837,199820747,4,0,1,30720,10,5120107644
6874,199839579,2470,199842049,3,0,1,2560,28,3716746123
6875,199860060,30999,199891059,4,0,1,12288,10,5577519316
6876,199887901,5400,199893301,9,0,1,9216,9,6993512480
6877,199915530,3128,199918658,2,0,1,9216,29,8944705787
6878,199966479,1518,199967997,3,0,1,1536,28,10364669561
6879,199999429,1518,200000947,3,0,1,1536,28,611414630
6880,200086619,96156,200182775,6,0,0,13312,0,10631324007
6881,200108820,3645,200112465,4,0,1,10240,10,1247362080
6882,200124330,173111,200297441,4,0,0,33792,10,5526889663
6883,200157870,5802,200163672,7,0,1,6144,2,7788121299
6884,200161891,4047,200165938,9,0,1,3584,9,2179887234
6885,200184099,244034,200428133,6,0,0,47104,0,10459138548
6886,200190840,6278,200197118,7,0,1,6656,2,4706466645
6887,200215430,5802,200221232,4,0,1,6144,10,8010362011
6888,200215770,13889,200229659,5,0,1,20480,12,1303481477
6889,200217520,12907,200230427,2,0,1,11776,29,5694514815
6890,200267670,2470,200270140,4,0,1,2560,10,9886413652
6891,200271439,200077,200471516,6,0,0,142336,0,1750176614
6892,200319529,236308,200555837,6,0,0,45568,0,5216465535
6893,200321060,3387,200324447,2,0,1,9728,29,8292872676
6894,200336761,6229,200342990,9,0,1,15360,9,151968236
6895,200337559,243047,200580606,6,0,0,19456,0,4635250543
6896,200339250,9019,200348269,2,0,1,7168,29,2560777545
6897,200342960,8215,200351175,4,0,1,4608,10,7657610346
6898,200355380,172365,200527745,9,0,0,49152,9,2327022493
6899,200393200,346596,200739796,9,0,0,25600,9,9203303327
6900,200394080,242052,200636132,9,0,0,29696,9,2559518322
6901,200420400,305942,200726342,9,0,0,97792,9,6252505100
6902,200487759,4850,200492609,3,0,1,5120,28,8445902986
6903,200493159,238822,200731981,6,0,0,18432,0,10426012563
6904,200494260,189107,200683367,4,0,0,32256,10,6201231133
6905,200496241,1518,200497759,9,0,1,1536,9,5025290568
6906,200589780,6754,200596534,5,0,1,7168,12,9336005030
6907,200619860,306316,200926176,9,0,0,64512,9,10049580129
6908,200621580,14567,200636147,5,0,1,7680,12,9418280767
6909,200639099,184092,200823191,6,0,0,108032,0,2041733466
6910,200671480,12049,200683529,4,0,1,19968,10,6230413032
6911,200703209,37588,200740797,3,0,1,1024,28,7068426355
6912,200731261,11309,200742570,9,0,1,2560,9,2722617852
6913,200750800,4937,200755737,2,0,1,12800,29,990047432
6914,200800951,26669,200827620,9,0,1,11776,9,5389452802
6915,200818241,12445,200830686,9,0,1,4096,9,2486711750
6916,200844940,4850,200849790,5,0,1,5120,12,9187603642
6917,200877890,5712,200883602,4,0,1,14336,10,8398948097
6918,200888640,157488,201046128,4,0,0,22528,10,1111689315
6919,200896419,216492,201112911,6,0,0,72704,0,4427899895
6920,200920170,7992,200928162,4,0,1,2048,10,7785621065
6921,200945590,3422,200949012,2,0,1,3584,29,2844651261
6922,200986870,4374,200991244,8,0,1,4608,3,8562911481
6923,201008229,227031,201235260,6,0,0,34304,0,2843483209
6924,201030190,248863,201279053,4,0,0,128000,10,10220134781
6925,201050470,290301,201340771,4,0,0,137216,10,5897178113
6926,201079230,33696,201112926,4,0,1,20480,10,4377867234
6927,201118640,13858,201132498,2,0,1,23552,29,2845654271
6928,201145969,231049,201377018,6,0,0,99840,0,1577483841
6929,201177940,566,201178506,5,0,1,512,12,2549818582
6930,201210730,2470,201213200,4,0,1,2560,10,1086166884
6931,201225330,53738,201279068,1,0,1,7168,18,2479383821
6932,201245260,37264,201282524,1,0,1,3584,18,10143103213
6933,201246529,258816,201505345,6,0,0,68096,0,7018786160
6934,201246809,43884,201290693,3,0,1,16896,28,9196586938
6935,201279740,12259,201291999,5,0,1,2048,12,7782154310
6936,201282420,10450,201292870,1,0,1,12288,18,4017820244
6937,201338560,38497,201377057,2,0,1,27648,29,3870007441
6938,201342749,44810,201387559,3,0,1,16896,28,9199462323
6939,201354230,36875,201391105,4,0,1,5632,10,8128017768
6940,201354589,37182,201391771,0,0,1,1024,20,5132853944
6941,201460020,1518,201461538,1,0,1,1536,18,5139036996
6942,201463129,299469,201762598,6,0,0,166400,0,5690278633
6943,201467620,244263,201711883,4,0,0,84992,10,5027844630
6944,201482780,427325,201910105,9,0,0,46592,9,4019869311
6945,201504530,328931,201833461,9,0,0,94720,9,6772387641
6946,201533690,3645,201537335,4,0,1,10240,10,5672406900
6947,201579730,436029,202015759,4,0,0,165376,10,6412085125
6948,201582660,3422,201586082,5,0,1,3584,12,10618348961
6949,201644660,3422,201648082,4,0,1,3584,10,8097858382
6950,201663580,119067,201782647,9,0,0,9728,9,9907760354
6951,201750280,112839,201863119,9,0,0,18432,9,8766061789
6952,201783869,5326,201789195,0,0,1,5632,20,5687106328
6953,201786170,3691,201789861,1,0,1,1024,18,9019131703
6954,201823590,286745,202110335,9,0,0,116224,9,8610172487
6955,201839449,5454,201844903,3,0,1,13824,28,4971891671
6956,201943550,224928,202168478,9,0,0,98304,9,8445440416
6957,201948749,67025,202015774,3,0,1,40448,28,6803879882
6958,201989650,39457,202029107,4,0,1,22528,10,10149450371
6959,202017190,29472,202046662,4,0,1,39936,10,719063787
6960,202026099,30983,202057082,3,0,1,33280,28,4130501031
6961,202080239,764921,202845160,6,0,0,251904,0,3439900963
6962,202087439,26317,202113756,3,0,1,9728,28,1117706463
6963,202102600,631224,202733824,9,0,0,88064,9,2856210571
6964,202120830,586131,202706961,9,0,0,378880,9,1504533288
6965,202121070,127467,202248537,9,0,0,81408,9,6054655237
6966,202142270,619961,202762231,9,0,0,93184,9,8043700816
6967,202152500,16561,202169061,2,0,1,512,29,6085854843
6968,202182680,1042,202183722,1,0,1,1024,18,1890729284
6969,202198090,11533,202209623,2,0,1,18944,29,1896638897
6970,202250130,686171,202936301,9,0,0,116736,9,740550886
6971,202275319,490991,202766310,6,0,0,13312,0,6246758185
6972,202288450,4679,202293129,1,0,1,12288,18,7428668159
6973,202288620,6569,202295189,1,0,1,3072,18,8845236472
6974,202313960,566,202314526,2,0,1,512,29,8824164788
6975,202354710,530745,202885455,4,0,0,132096,10,6347154009
6976,202379880,35829,202415709,5,0,1,62976,12,5794860351
6977,202392720,23348,202416068,2,0,1,9728,29,9534287604
6978,202397380,370997,202768377,4,0,0,6656,10,784467042
6979,202444840,443009,202887849,4,0,0,7680,10,6746450551
6980,202455349,6278,202461627,0,0,1,6656,20,5099235130
6981,202533360,50999,202584359,5,0,1,82432,12,1304422898
6982,202583119,2546,202585665,3,0,1,2048,28,3395523314
6983,202585940,314716,202900656,9,0,0,41984,9,5610491003
6984,202586860,3422,202590282,2,0,1,3584,29,3256739242
6985,202595260,290218,202885478,4,0,1,4608,10,5141040072
6986,202596170,391298,202987468,9,0,0,161280,9,9574768539
6987,202643150,387880,203031030,4,0,0,20480,10,4501047155
6988,202657989,280308,202938297,6,0,0,4608,0,10286504913
6989,202660170,240525,202900695,5,0,1,9216,12,7911914353
6990,202677019,223699,202900718,3,0,1,4608,28,4318223134
6991,202695229,241127,202936356,3,0,1,3584,28,7515051259
6992,202737329,199518,202936847,6,0,0,1536,0,4377768715
6993,202750050,186828,202936878,4,0,1,40448,10,8461152799
6994,202780609,206874,202987483,3,0,1,512,28,10171870194
6995,202796529,190985,202987514,3,0,1,5120,28,4076911372
6996,202820729,166800,202987529,3,0,1,4096,28,1740925210
6997,202837850,425849,203263699,9,0,0,80384,9,3702359898
6998,202850519,137025,202987544,3,0,1,512,28,749285327
6999,202869809,117750,202987559,3,0,1,1024,28,6966908920
7000,202873790,113784,202987574,2,0,1,2048,29,2245343955
7001,202886730,391212,203277942,4,0,0,46592,10,4192509796
7002,202922070,77163,202999233,7,0,1,19456,2,6676151337
7003,202936999,217122,203154121,6,0,0,74752,0,1568766613
7004,202963069,40030,203003099,3,0,1,6144,28,9510539440
7005,202975219,31426,203006645,3,0,1,5632,28,6730656718
7006,203006030,25015,203031045,5,0,1,41984,12,8809889467
7007,203060420,301740,203362160,9,0,0,150528,9,2783592597
7008,203119519,336307,203455826,6,0,0,103936,0,2658764807
7009,203119710,1518,203121228,6,0,1,1536,0,6408078233
7010,203157309,383111,203540420,6,0,0,153600,0,9304111240
7011,203242730,46445,203289175,1,0,1,18432,18,8886358129
7012,203245980,48021,203294001,6,0,1,7680,0,1518971086
7013,203253970,45625,203299595,6,0,1,18432,0,5965420560
7014,203260760,40320,203301080,4,0,1,15360,10,891859167
7015,203273900,136644,203410544,9,0,0,4608,9,2454674247
7016,203286040,24053,203310093,4,0,1,23552,10,6061677014
7017,203326070,60236,203386306,5,0,1,43520,12,3462626015
7018,203406661,1994,203408655,9,0,1,2048,9,4180383834
7019,203407700,69471,203477171,4,0,0,1536,10,3790330438
7020,203413239,2470,203415709,0,0,1,2560,20,10225139535
7021,203494170,181828,203675998,4,0,0,99328,10,3653291914
7022,203499550,125362,203624912,5,0,1,137728,12,5095751044
7023,203585059,44359,203629418,0,0,1,7168,20,9449933493
7024,203598029,129892,203727921,6,0,0,4608,0,6049844470
7025,203654930,147937,203802867,4,0,0,27648,10,3270871668
7026,203683300,242038,203925338,9,0,0,131584,9,5075588056
7027,203757700,244063,204001763,9,0,0,20480,9,8458580241
7028,203771550,342740,204114290,9,0,0,154624,9,5467668739
7029,203786110,239517,204025627,9,0,0,59392,9,6781106047
7030,203811290,640516,204451806,9,0,0,136192,9,5179395860
7031,203821430,11274,203832704,6,0,1,18432,0,1765758347
7032,203840790,366337,204207127,4,0,0,73728,10,6006039693
7033,203864069,1994,203866063,3,0,1,2048,28,5768590029
7034,203866440,174825,204041265,5,0,1,283648,12,1174546896
7035,203884390,363088,204247478,9,0,0,12288,9,1308331031
7036,203908230,149919,204058149,5,0,1,56320,12,7564755319
7037,203929070,130462,204059532,5,0,1,14848,12,5179815386
7038,203930979,130499,204061478,3,0,1,3072,28,10577508619
7039,203940379,122379,204062758,3,0,1,14336,28,6918519458
7040,203957830,393508,204351338,4,0,0,69120,10,10005563856
7041,203976180,86924,204063104,5,0,1,512,12,8527061520
7042,204009340,104973,204114313,5,0,1,67072,12,1131370472
7043,204021640,92688,204114328,4,0,1,1024,10,2970721878
7044,204066360,47983,204114343,5,0,1,37888,12,5614110684
7045,204079090,56636,204135726,5,0,1,34816,12,488369850
7046,204100740,45406,204146146,5,0,1,33280,12,8444292090
7047,204188119,31066,204219185,3,0,1,19968,28,7779127131
7048,204199899,349245,204549144,6,0,0,158208,0,8867494819
7049,204210639,407554,204618193,6,0,0,53248,0,3627204255
7050,204212030,9741,204221771,6,0,1,4096,0,3238761466
7051,204274589,327365,204601954,6,0,0,91648,0,1344415199
7052,204281890,3422,204285312,8,0,1,3584,3,5881634574
7053,204294149,465022,204759171,6,0,0,91648,0,1613119385
7054,204298670,432554,204731224,4,0,0,104960,10,10288240007
7055,204377540,121874,204499414,5,0,1,197120,12,4971660230
7056,204404879,95713,204500592,3,0,1,13824,28,4242179439
7057,204426910,122257,204549167,5,0,1,45056,12,10149320706
7058,204503719,50768,204554487,3,0,1,5632,28,9097474739
7059,204545090,215352,204760442,9,0,0,4096,9,3134007476
7060,204588600,30168,204618768,4,0,1,512,10,355762285
7061,204604300,27399,204631699,6,0,1,22528,0,7840961717
7062,204638570,2946,204641516,6,0,1,3072,0,8591465772
7063,204644949,284957,204929906,6,0,0,47104,0,4129073272
7064,204655969,4679,204660648,3,0,1,12288,28,2698150160
7065,204663270,11274,204674544,8,0,1,18432,3,9230273868
7066,204690359,5326,204695685,3,0,1,5632,28,379710910
7067,204691490,5821,204697311,4,0,1,2560,10,4510519630
7068,204699311,66892,204766203,4,0,1,6144,10,8400071337
7069,204707640,59549,204767189,8,0,1,1536,3,7177011362
7070,204739551,30864,204770415,4,0,1,5120,10,1729855648
7071,204761570,476491,205238061,4,0,0,153600,10,10190160155
7072,204761999,9799,204771798,3,0,1,14848,28,5626503381
7073,204762691,11373,204774064,4,0,1,3584,10,8511184408
7074,204815490,2870,204818360,8,0,1,8704,3,6857092412
7075,204842089,184964,205027053,6,0,0,76288,0,5541243469
7076,204934651,2470,204937121,4,0,1,2560,10,5449157262
7077,204965530,24242,204989772,6,0,1,40448,0,9456756769
7078,204967439,308052,205275491,6,0,0,31744,0,8439572964
7079,204995450,5802,205001252,6,0,1,6144,0,5657920386
7080,204998179,387980,205386159,6,0,0,250368,0,2430520596
7081,205003890,280204,205284094,9,0,0,28160,9,79333213
7082,205030070,3898,205033968,8,0,1,4096,3,1055648065
7083,205032729,367664,205400393,6,0,0,46592,0,5195220294
7084,205053220,566,205053786,8,0,1,512,3,4970626929
7085,205067020,5326,205072346,8,0,1,5632,3,4729495616
7086,205067940,4867,205072807,8,0,1,10240,3,2091984623
7087,205074040,6754,205080794,7,0,1,7168,2,6728079781
7088,205079559,7706,205087265,3,0,1,8192,28,10310853367
7089,205081630,6301,205087931,2,0,1,11264,29,632503767
7090,205082530,8775,205091305,2,0,1,14336,29,2755938636
7091,205126810,313573,205440383,9,0,0,9216,9,3992298771
7092,205135300,2870,205138170,1,0,1,8704,18,4973177442
7093,205135340,9133,205144473,2,0,1,15872,29,5665721411
7094,205161310,4162,205165472,8,0,1,11264,3,1983755941
7095,205199501,40112,205239613,4,0,1,1536,10,10370757502
7096,205208360,32239,205240599,2,0,1,1536,29,10510572666
7097,205229611,14874,205244485,4,0,1,13824,10,1811198111
7098,205247779,6278,205254057,3,0,1,6656,28,1010153242
7099,205252100,2303,205254403,8,0,1,512,3,1927538005
7100,205270949,271234,205542183,6,0,0,88064,0,830600096
7101,205306731,2470,205309201,4,0,1,2560,10,10603524819
7102,205308950,77224,205386174,8,0,1,9216,3,999267716
7103,205317569,302219,205619788,6,0,0,109568,0,7161498259
7104,205365270,39811,205405081,6,0,1,12288,0,5381848181
7105,205373650,33918,205407568,2,0,1,3584,29,5089638882
7106,205438600,220447,205659047,9,0,0,13824,9,5402194427
7107,205453531,3387,205456918,4,0,1,9728,10,2407150500
7108,205490130,251840,205741970,9,0,0,115712,9,703090266
7109,205542790,10241,205553031,1,0,1,16384,18,743479651
7110,205553010,252744,205805754,4,0,0,512,10,5295575398
7111,205578690,226893,205805583,9,0,0,111104,9,8105601695
7112,205582840,3387,205586227,6,0,1,9728,0,3315899188
7113,205593940,31183,205625123,1,0,1,5632,18,7636082580
7114,205616960,16344,205633304,6,0,1,19456,0,5662638735
7115,205634849,307654,205942503,6,0,0,27136,0,2291753546
7116,205658841,3068,205661909,4,0,1,8704,10,2894584213
7117,205664549,212080,205876629,6,0,0,38912,0,9474049333
7118,205671800,2870,205674670,1,0,1,8704,18,7362598570
7119,205693210,1042,205694252,7,0,1,1024,2,10483212992
7120,205749451,5326,205754777,4,0,1,5632,10,7930864161
7121,205765930,1042,205766972,2,0,1,1024,29,2458985233
7122,205769690,1042,205770732,6,0,1,1024,0,5637462950
7123,205861960,204561,206066521,4,0,0,77312,10,8980683058
7124,205871920,48159,205920079,2,0,1,71168,29,8758163375
7125,205891450,29295,205920745,6,0,1,1024,0,1547869545
7126,205898799,412297,206311096,6,0,0,129536,0,4090530680
7127,205922190,6278,205928468,6,0,1,6656,0,9449703162
7128,205929589,201026,206130615,6,0,0,67584,0,10045412865
7129,205934751,10231,205944982,4,0,1,2560,10,780553343
7130,205936150,282935,206219085,4,0,0,124928,10,620008105
7131,205967440,36863,206004303,2,0,1,65024,29,6216776089
7132,205972510,374979,206347489,9,0,0,22528,9,8834869420
7133,205980441,24528,206004969,4,0,1,1024,10,7979305448
7134,205983980,22295,206006275,8,0,1,2048,3,4060731115
7135,206005990,11533,206017523,2,0,1,18944,29,10080801787
7136,206011070,14090,206025160,8,0,1,22528,3,8023219923
7137,206026200,73487,206099687,2,0,1,122880,29,1678532639
7138,206062669,192145,206254814,6,0,0,21504,0,10247573800
7139,206063190,40363,206103553,6,0,1,6144,0,4295805508
7140,206063530,40279,206103809,6,0,1,9216,0,7575711131
7141,206088460,302260,206390720,4,0,0,24576,10,8442346153
7142,206100329,147887,206248216,6,0,0,84480,0,2793506953
7143,206124989,256268,206381257,6,0,0,17408,0,6725975238
7144,206137100,12995,206150095,2,0,1,25088,29,9583071799
7145,206140880,9561,206150441,1,0,1,512,18,10524911478
7146,206152590,248631,206401221,7,0,0,1536,2,6511500387
7147,206155780,2946,206158726,1,0,1,3072,18,2459592378
7148,206217331,30908,206248239,4,0,1,17920,10,1126113959
7149,206227850,83285,206311135,2,0,1,83968,29,6628914457
7150,206241609,331910,206573519,6,0,0,97280,0,5123612673
7151,206263821,83691,206347512,4,0,1,51712,10,3565677553
7152,206266780,576733,206843513,7,0,0,3072,2,6515130410
7153,206300540,46987,206347527,7,0,1,3072,2,6283737225
7154,206314220,33322,206347542,8,0,1,2560,3,9347107282
7155,206326200,21357,206347557,6,0,1,9728,0,6742511152
7156,206342380,911833,207254213,4,0,0,202240,10,7415259238
7157,206349880,251148,206601028,4,0,0,9728,10,10435191853
7158,206355100,487423,206842523,4,0,0,229888,10,10037577644
7159,206359800,172535,206532335,7,0,0,512,2,354505467
7160,206408450,4850,206413300,1,0,1,5120,18,5186641265
7161,206418969,231344,206650313,6,0,0,121344,0,8484142160
7162,206430330,3422,206433752,1,0,1,3584,18,4976521981
7163,206445270,34795,206480065,2,0,1,60928,29,4373607239
7164,206446390,39167,206485557,1,0,1,17920,18,5047722713
7165,206454930,36938,206491868,8,0,1,22016,3,154598077
7166,206457619,734951,207192570,6,0,0,52224,0,1631437164
7167,206484650,536891,207021541,9,0,0,86016,9,9738053923
7168,206490770,51516,206542286,2,0,1,83456,29,621309209
7169,206504850,671793,207176643,4,0,0,172544,10,560322405
7170,206516239,222049,206738288,6,0,0,57856,0,6088622314
7171,206553610,25355,206578965,1,0,1,13824,18,7987450498
7172,206591279,59049,206650328,0,0,1,45568,20,1154880293
7173,206642220,18924,206661144,7,0,1,17408,2,5080943277
7174,206643440,94871,206738311,2,0,1,119808,29,654606182
7175,206645799,92527,206738326,0,0,1,13312,20,10297268608
7176,206649060,89281,206738341,7,0,1,2560,2,9676934268
7177,206664970,73386,206738356,1,0,1,3072,18,9248575323
7178,206706809,261790,206968599,6,0,0,2560,0,8702030100
7179,206711001,28507,206739508,9,0,1,26624,9,8304438151
7180,206717680,23454,206741134,7,0,1,2560,2,8690420660
7181,206724819,19221,206744040,0,0,1,4608,20,3488506976
7182,206734441,9958,206744399,9,0,1,9728,9,3514489091
7183,206758090,635854,207393944,4,0,0,147456,10,9791287120
7184,206767771,74767,206842538,9,0,1,6656,9,4736958786
7185,206785081,68632,206853713,9,0,1,16384,9,332953277
7186,206789510,65279,206854789,1,0,1,13312,18,10249034564
7187,206801219,234517,207035736,6,0,0,4608,0,2808128414
7188,206850570,8405,206858975,8,0,1,6656,3,4571292880
7189,206859349,26221,206885570,0,0,1,47616,20,6279744588
7190,206867700,18331,206886031,8,0,1,10240,3,4370182082
7191,206875900,653092,207528992,4,0,0,223232,10,5864839720
7192,206879339,467435,207346774,6,0,0,52736,0,8298063227
7193,206889850,3387,206893237,7,0,1,9728,2,4843072391
7194,206892369,416601,207308970,6,0,0,20480,0,10427816785
7195,206934060,3898,206937958,7,0,1,4096,2,2742772055
7196,206949970,6229,206956199,8,0,1,15360,3,392635014
7197,206968250,2811,206971061,8,0,1,2560,3,6801036677
7198,207048840,205388,207254228,2,0,1,202752,29,3165654860
7199,207079361,174882,207254243,9,0,1,2048,9,4495520035
7200,207090621,163637,207254258,9,0,1,15360,9,9664215321
7201,207112291,141982,207254273,9,0,1,512,9,1284943973
7202,207115360,138936,207254296,1,0,1,6656,18,7101242789
7203,207142850,119146,207261996,1,0,1,8192,18,4842402051
7204,207176719,86263,207262982,0,0,1,1536,20,322012164
7205,207181300,86188,207267488,8,0,1,7168,3,10243066472
7206,207221950,46844,207268794,1,0,1,2048,18,1275594450
7207,207277570,6754,207284324,1,0,1,7168,18,9664146177
7208,207295200,566,207295766,1,0,1,512,18,5004859554
7209,207308660,220782,207529442,0,0,0,1024,20,10505633154
7210,207317430,136304,207453734,2,0,1,225280,29,5108041677
7211,207342910,545321,207888231,9,0,0,118272,9,5236690547
7212,207356010,103523,207459533,7,0,1,19456,2,1828559100
7213,207383149,77690,207460839,0,0,1,2048,20,5930418406
7214,207397320,131687,207529007,1,0,1,4608,18,452647564
7215,207421889,107157,207529046,0,0,1,14848,20,1126545307
7216,207424949,104112,207529061,0,0,1,3072,20,3629875212
7217,207439630,89446,207529076,6,0,1,8192,0,6979104809
7218,207458900,70199,207529099,1,0,1,18432,18,1359897917
7219,207459431,77676,207537107,9,0,1,8192,9,10516965234
7220,207461469,489506,207950975,6,0,0,131584,0,3465471592
7221,207462190,79103,207541293,2,0,1,6656,29,8339131973
7222,207474740,91484,207566224,6,0,1,52736,0,4069418699
7223,207482010,87440,207569450,7,0,1,5120,2,7549213566
7224,207510520,61516,207572036,2,0,1,4096,29,4885896765
7225,207529660,44642,207574302,6,0,1,3584,0,1235461928
7226,207536520,42608,207579128,6,0,1,7680,0,5956718408
7227,207543200,36594,207579794,8,0,1,1024,3,2692998229
7228,207549590,31280,207580870,6,0,1,13312,0,5523536369
7229,207566270,18466,207584736,1,0,1,6144,18,3716805677
7230,207608020,566,207608586,1,0,1,512,18,5118062880
7231,207609559,2470,207612029,0,0,1,2560,20,6509581919
7232,207654961,12737,207667698,9,0,1,24576,9,8362817531
7233,207689090,13770,207702860,7,0,1,26624,2,9309087505
7234,207709140,189705,207898845,9,0,0,15872,9,512032020
7235,207718150,12737,207730887,8,0,1,24576,3,6288360072
7236,207728061,15062,207743123,9,0,1,29184,9,973440793
7237,207731610,11974,207743584,7,0,1,10240,2,5985580736
7238,207735600,13130,207748730,7,0,1,8192,2,5554501741
7239,207748921,566,207749487,9,0,1,512,9,6239926462
7240,207751480,12995,207764475,2,0,1,25088,29,7720614316
7241,207774420,3422,207777842,6,0,1,3584,0,6591225628
7242,207774640,6108,207780748,7,0,1,4608,2,9204477960
7243,207834979,10757,207845736,0,0,1,17408,20,7381955876
7244,207850370,1518,207851888,6,0,1,1536,0,4756398513
7245,207871920,79070,207950990,6,0,1,48640,0,3311290503
7246,207891680,145674,208037354,2,0,1,221184,29,1123673420
7247,207901021,142542,208043563,9,0,1,21504,9,7731199842
7248,207906561,143211,208049772,9,0,1,21504,9,8449109004
7249,207914641,141135,208055776,9,0,1,28672,9,2393016004
7250,207957170,104303,208061473,2,0,1,27136,29,9912638650
7251,207976430,117019,208093449,2,0,1,103936,29,6000676546
7252,208009910,88045,208097955,7,0,1,7168,2,9534560439
7253,208018390,79911,208098301,7,0,1,512,2,399984627
7254,208030000,475494,208505494,4,0,0,224768,10,8381438577
7255,208030470,161812,208192282,9,0,0,40448,9,4327282212
7256,208084669,15258,208099927,0,0,1,2560,20,1268043344
7257,208092940,8613,208101553,7,0,1,2560,2,8179290410
7258,208116039,404602,208520641,6,0,0,49664,0,1423487591
7259,208120230,225883,208346113,7,0,0,1536,2,2483966000
7260,208164740,72283,208237023,2,0,1,117248,29,8232558413
7261,208249970,294080,208544050,9,0,0,2048,9,10191022809
7262,208260860,264024,208524884,4,0,0,13824,10,7999569217
7263,208297680,2470,208300150,6,0,1,2560,0,9026993407
7264,208301859,310414,208612273,6,0,0,87552,0,501685311
7265,208319530,13512,208333042,6,0,1,26112,0,4884492298
7266,208371970,10241,208382211,6,0,1,16384,0,5701130847
7267,208447220,81577,208528797,6,0,1,10752,0,5029198525
7268,208457880,76567,208534447,7,0,1,6656,2,3951426361
7269,208495370,318450,208813820,7,0,0,512,2,1998798169
7270,208511610,32704,208544314,6,0,1,24064,0,2065747189
7271,208530340,230385,208760725,4,0,0,3584,10,6285919911
7272,208537279,471866,209009145,6,0,0,197120,0,1818970357
7273,208564419,384651,208949070,5,0,0,169984,12,3367250614
7274,208566370,2870,208569240,7,0,1,8704,2,8787033791
7275,208579571,32717,208612288,9,0,1,20480,9,6662595835
7276,208651791,23983,208675774,9,0,1,39936,9,9260664661
7277,208679160,94600,208773760,5,0,1,154112,12,9082983406
7278,208682979,380852,209063831,6,0,0,75264,0,1591445305
7279,208700040,152766,208852806,4,0,0,15360,10,8252644759
7280,208735029,277727,209012756,6,0,0,11776,0,2360960224
7281,208762641,16918,208779559,9,0,1,19456,9,2885425935
7282,208779020,23378,208802398,2,0,1,41984,29,2873325713
7283,208787460,322801,209110261,4,0,0,76288,10,1431531012
7284,208791599,11465,208803064,0,0,1,1024,20,8444497534
7285,208797440,6610,208804050,6,0,1,1536,0,5778233424
7286,208966309,57030,209023339,0,0,1,16896,20,8114998944
7287,208970919,54046,209024965,0,0,1,2560,20,9964945539
7288,208972349,278700,209251049,6,0,0,34816,0,9181675120
7289,208973060,57602,209030662,6,0,1,18944,0,8883317072
7290,208981300,57552,209038852,7,0,1,27648,2,3311272093
7291,208996990,114846,209111836,7,0,0,5120,2,5187689082
7292,209012331,27392,209039723,9,0,1,12288,9,4716360990
7293,209035220,672069,209707289,2,0,1,1058304,29,10334887578
7294,209082820,624484,209707304,6,0,1,8192,0,10165494565
7295,209083740,925648,210009388,4,0,0,12800,10,9778472913
7296,209129320,577954,209707274,4,0,0,56832,10,1171479760
7297,209166590,552568,209719158,2,0,1,90624,29,4330489410
7298,209168840,646224,209815064,4,0,0,90624,10,1521418518
7299,209182610,454888,209637498,7,0,0,1024,2,8358040425
7300,209190430,532594,209723024,6,0,1,6144,0,2888363194
7301,209220779,744719,209965498,6,0,0,61440,0,9492035470
7302,209225109,213063,209438172,6,0,0,2048,0,1794194220
7303,209229159,494531,209723690,0,0,1,1024,20,1620213647
7304,209238600,609760,209848360,9,0,0,3072,9,8954171640
7305,209253851,470710,209724561,4,0,1,12288,10,1459789184
7306,209273199,354810,209628009,6,0,0,32256,0,2069196774
7307,209290501,436326,209726827,4,0,1,3584,10,3990092502
7308,209313361,414132,209727493,9,0,1,1024,9,3395114363
7309,209321490,407488,209728978,6,0,1,15360,0,6169516230
7310,209348700,381046,209729746,6,0,1,11776,0,1530604496
7311,209350590,380232,209730822,7,0,1,13312,2,2364730702
7312,209351880,355603,209707483,7,0,0,512,2,9410236813
7313,209354759,432678,209787437,6,0,0,51200,0,796151665
7314,209359620,1018156,210377776,4,0,0,65024,10,7545048669
7315,209409561,321607,209731168,4,0,1,512,10,8591875345
7316,209409699,523693,209933392,5,0,0,120832,12,10167154281
7317,209409880,235766,209645646,7,0,0,2560,2,9682775145
7318,209414729,320945,209735674,0,0,1,7168,20,8505096457
7319,209426851,314315,209741166,4,0,1,17920,10,3849075001
7320,209428319,261624,209689943,5,0,0,18944,12,10456366117
7321,209442840,277530,209720370,7,0,0,2560,2,7375906633
7322,209453900,565035,210018935,9,0,0,1024,9,1644808727
7323,209464901,276521,209741422,4,0,1,9216,10,7521214316
7324,209477080,456491,209933571,7,0,0,512,2,4932042667
7325,209494909,496188,209991097,5,0,0,83968,12,5779835373
7326,209503470,990639,210494109,4,0,0,102912,10,7178892818
7327,209511151,231577,209742728,9,0,1,2048,9,6870846903
7328,209520381,223653,209744034,9,0,1,2048,9,5209567685
7329,209531431,217109,209748540,9,0,1,7168,9,9095935437
7330,209572181,177025,209749206,9,0,1,1024,9,10244805439
7331,209572639,177873,209750512,0,0,1,2048,20,4042107898
7332,209573800,177698,209751498,7,0,1,1536,2,7215680529
7333,209589481,162376,209751857,4,0,1,9728,10,1392293495
7334,209594889,162972,209757861,0,0,1,28672,20,7320385022
7335,209603110,160960,209764070,1,0,1,29696,18,10248639538
7336,209608459,749474,210357933,5,0,0,237056,12,10621960442
7337,209616831,152833,209769664,9,0,1,18432,9,9166873407
7338,209657479,112339,209769818,0,0,1,8704,20,898656969
7339,209702699,909635,210612334,6,0,0,143360,0,3702854745
7340,209730199,84880,209815079,0,0,1,27648,20,2509054158
7341,209755801,59293,209815094,4,0,1,1024,10,3852739282
7342,209784441,41444,209825885,9,0,1,17408,9,8161743698
7343,209789059,53031,209842090,0,0,1,35328,20,3687502141
7344,209807879,34877,209842756,0,0,1,1024,20,2747491432
7345,209848451,26221,209874672,9,0,1,47616,9,7323938871
7346,209868121,11377,209879498,9,0,1,7680,9,1205587035
7347,209870091,14694,209884785,9,0,1,16896,9,9778377235
7348,209920599,23197,209943796,0,0,1,16384,20,9325643260
7349,209930541,14881,209945422,4,0,1,2560,10,5703483859
7350,209951501,42500,209994001,9,0,1,8704,9,5380297436
7351,209971890,26743,209998633,8,0,1,5120,3,6829938598
7352,209984939,546214,210531153,6,0,0,47616,0,9500249772
7353,209992720,470018,210462738,7,0,0,1024,2,1569000703
7354,210005121,4282,210009403,4,0,1,4096,10,5759811192
7355,210036099,418801,210454900,6,0,0,177664,0,2085518143
7356,210045409,417002,210462411,6,0,0,24576,0,470268295
7357,210069369,22691,210092060,0,0,1,37376,20,1073633364
7358,210074000,18521,210092521,8,0,1,10240,3,6648914121
7359,210076680,19707,210096387,8,0,1,6144,3,10161237820
7360,210079010,549563,210628573,4,0,0,53248,10,8750351185
7361,210080511,17822,210098333,4,0,1,3072,10,10207239123
7362,210099561,3904,210103465,9,0,1,10752,9,9420060941
7363,210133369,13600,210146969,0,0,1,23040,20,7524984739
7364,210140419,240064,210380483,6,0,0,8704,0,4471769345
7365,210146229,515619,210661848,5,0,0,109056,12,9609389692
7366,210160931,1518,210162449,9,0,1,1536,9,221344279
7367,210230240,1518,210231758,8,0,1,1536,3,2421530682
7368,210238150,5454,210243604,6,0,1,13824,0,3585345758
7369,210250700,2470,210253170,6,0,1,2560,0,7216831654
7370,210317540,62982,210380522,6,0,1,2560,0,4689692811
7371,210324941,56595,210381536,4,0,1,2048,10,648422063
7372,210341141,42021,210383162,4,0,1,2560,10,7355903572
7373,210365670,21830,210387500,6,0,1,6656,0,6612566698
7374,210371301,17505,210388806,4,0,1,2048,10,3760461163
7375,210409240,93013,210502253,9,0,0,1024,9,8305278706
7376,210458449,343205,210801654,6,0,0,20480,0,5778254751
7377,210477570,18592,210496162,8,0,1,2048,3,2649308175
7378,210479100,304026,210783126,4,0,0,73216,10,8451255477
7379,210487279,320477,210807756,5,0,0,11776,12,2219236881
7380,210534860,267277,210802137,9,0,0,1536,9,5587224269
7381,210576499,431875,211008374,6,0,0,170496,0,8919908918
7382,210586301,81477,210667778,4,0,1,14848,10,2695447065
7383,210586700,92197,210678897,8,0,1,20992,3,8435020846
7384,210594639,84719,210679358,0,0,1,10240,20,6048171013
7385,210686970,249581,210936551,4,0,0,69120,10,3091319502
7386,210753480,187615,210941095,9,0,0,1024,9,6275600521
7387,210765830,116836,210882666,9,0,0,2048,9,10167695608
7388,210768840,169286,210938126,7,0,0,5120,2,2683608083
7389,210880820,7230,210888050,6,0,1,7680,0,6616614857
7390,210891871,1042,210892913,4,0,1,1024,10,1687316084
7391,210895419,366237,211261656,6,0,0,253440,0,1213556199
7392,210947459,409263,211356722,5,0,0,166912,12,10012703629
7393,211030950,61273,211092223,9,0,0,3584,9,4379693241
7394,211042510,263317,211305827,4,0,0,144896,10,4145219186
7395,211059271,5196,211064467,4,0,1,13312,10,5720925547
7396,211189439,220075,211409514,6,0,0,27648,0,2021183968
7397,211261399,231004,211492403,6,0,0,12800,0,10308473950
7398,211261520,97631,211359151,8,0,1,2560,3,10581081166
7399,211264370,92687,211357057,9,0,0,1024,9,9648126743
7400,211369489,91009,211460498,5,0,0,18432,12,3795081846
7401,211458000,6864,211464864,8,0,1,4608,3,1749251085
7402,211479319,126624,211605943,5,0,0,67584,12,6816593550
7403,211479930,66333,211546263,7,0,0,512,2,112547991
7404,211565210,4850,211570060,8,0,1,5120,3,9591853790
7405,211584630,21328,211605958,8,0,1,9728,3,9886900474
7406,211611329,65300,211676629,5,0,0,10240,12,8783587925
7407,211612930,91671,211704601,7,0,0,3584,2,7400403837
7408,211627130,1042,211628172,7,0,1,1024,2,1823411686
7409,211661090,5326,211666416,8,0,1,5632,3,5923253624
7410,211762550,2946,211765496,7,0,1,3072,2,7677278205
7411,211765380,80708,211846088,4,0,0,20480,10,6978401736
7412,211770290,84248,211854538,4,0,0,22016,10,4036602407
7413,211779399,135991,211915390,6,0,0,60416,0,4629693453
7414,211783100,469143,212252243,4,0,0,463360,10,4419527232
7415,211822719,433751,212256470,6,0,0,13824,0,10267149222
7416,211827280,236378,212063658,9,0,0,512,9,9535012264
7417,211950211,338464,212288675,1,0,0,82432,18,3326573760
7418,211972380,78954,212051334,7,0,0,512,2,737665550
7419,211983000,280193,212263193,4,0,0,22016,10,4031725230
7420,212037981,391298,212429279,1,0,0,138240,18,1467806637
7421,212045291,1994,212047285,4,0,1,2048,10,2862193284
7422,212068650,23378,212092028,8,0,1,41984,3,3339013112
7423,212070700,22314,212093014,8,0,1,1536,3,2253205280
7424,212084731,544702,212629433,1,0,0,199168,18,5981510940
7425,212091640,171904,212263544,9,0,0,1024,9,8215019018
7426,212094020,5802,212099822,7,0,1,6144,2,9990384948
7427,212094350,5818,212100168,7,0,1,512,2,2478596304
7428,212097790,3128,212100918,7,0,1,9216,2,1011770797
7429,212101681,596601,212698282,1,0,0,174080,18,7953890087
7430,212107699,534853,212642552,6,0,0,43008,0,1258828063
7431,212165331,156636,212321967,4,0,1,54784,10,521473954
7432,212180649,329150,212509799,6,0,0,79872,0,9762292168
7433,212194111,336118,212530229,1,0,0,39936,18,5558377814
7434,212266321,55902,212322223,4,0,1,9216,10,8903826888
7435,212276821,56539,212333360,4,0,1,36864,10,10390533569
7436,212302090,42202,212344292,8,0,1,44032,3,2524667648
7437,212324610,25071,212349681,8,0,1,25600,3,8035561455
7438,212370470,328919,212699389,9,0,0,3584,9,10309518640
7439,212387450,46258,212433708,8,0,1,11776,3,8447754647
7440,212415170,27947,212443117,7,0,1,16384,2,384560273
7441,212433721,211498,212645219,1,0,0,8704,18,584860864
7442,212456020,1042,212457062,7,0,1,1024,2,10600965971
7443,212503411,206152,212709563,1,0,0,512,18,10065490513
7444,212512709,295800,212808509,6,0,0,31744,0,9961746938
7445,212529070,170810,212699880,9,0,0,1536,9,1247674127
7446,212595681,115200,212710881,4,0,1,18944,10,4859763293
7447,212686290,158375,212844665,9,0,0,5120,9,5713599714
7448,212710269,373802,213084071,6,0,0,385536,0,8571066614
7449,212715730,206209,212921939,9,0,0,512,9,4392021183
7450,212740140,213485,212953625,7,0,0,2560,2,5899375028
7451,212744019,350207,213094226,6,0,0,33280,0,8646990513
7452,212856041,280210,213136251,1,0,0,32256,18,557030114
7453,212857410,268990,213126400,9,0,0,1024,9,301142081
7454,212861060,96861,212957921,7,0,0,1536,2,7748202659
7455,212870550,4850,212875400,7,0,1,5120,2,7321942917
7456,212904209,221856,213126065,5,0,0,104448,12,4732399277
7457,212949721,10241,212959962,4,0,1,16384,10,240283307
7458,213048650,177351,213226001,4,0,0,28160,10,10257038478
7459,213069161,79123,213148284,4,0,1,19968,10,6585638818
7460,213109879,199169,213309048,6,0,0,31232,0,6023879276
7461,213127841,21314,213149155,4,0,1,12288,10,6595012283
7462,213131299,80060,213211359,5,0,0,7168,12,2056228436
7463,213160331,5971,213166302,4,0,1,14848,10,6889846336
7464,213162969,237849,213400818,6,0,0,104448,0,9494700887
7465,213185450,5454,213190904,8,0,1,13824,3,979853028
7466,213194281,3422,213197703,4,0,1,3584,10,7068202327
7467,213341990,110166,213452156,7,0,0,2048,2,4663166279
7468,213383680,83030,213466710,4,0,0,7168,10,7727723205
7469,213389961,24903,213414864,4,0,1,27136,10,8752689750
7470,213409290,50672,213459962,7,0,0,2560,2,6076869929
7471,213425400,126816,213552216,4,0,0,54784,10,9365861481
7472,213446880,163815,213610695,7,0,0,2048,2,703347860
7473,213461180,48980,213510160,9,0,0,2048,9,7047903295
7474,213502770,12825,213515595,7,0,1,21504,2,1497807485
7475,213508981,7600,213516581,4,0,1,1536,10,3390348825
7476,213534000,18231,213552231,6,0,1,30208,0,3917274093
7477,213571491,132726,213704217,1,0,0,57856,18,2317760230
7478,213584230,70259,213654489,7,0,0,512,2,1000519661
7479,213604399,190964,213795363,5,0,0,129024,12,1451673934
7480,213611360,3422,213614782,6,0,1,3584,0,7990790531
7481,213642399,97206,213739605,5,0,0,6656,12,7406989995
7482,213650650,10499,213661149,5,0,1,16896,12,5374728390
7483,213679461,161274,213840735,1,0,0,110592,18,633082385
7484,213681900,115323,213797223,9,0,0,3072,9,1672342378
7485,213781889,111270,213893159,5,0,0,15360,12,2432415330
7486,213809830,36699,213846529,7,0,1,6144,2,1563678465
7487,213853700,105761,213959461,4,0,0,16896,10,3500236166
7488,213874280,13770,213888050,8,0,1,26624,3,5299565382
7489,213893721,393562,214287283,1,0,0,232960,18,860246211
7490,213910210,127411,214037621,9,0,0,1024,9,279936821
7491,213926370,175111,214101481,4,0,0,22016,10,1888967273
7492,213952241,196022,214148263,1,0,0,81408,18,914094820
7493,213977610,10241,213987851,7,0,1,16384,2,8427697586
7494,214044710,104348,214149058,7,0,0,2560,2,8777006579
7495,214077029,279596,214356625,5,0,0,76288,12,9408722178
7496,214096821,200157,214296978,1,0,0,31744,18,5048278694
7497,214115091,190638,214305729,1,0,0,28672,18,1735942727
7498,214118960,54959,214173919,4,0,0,2048,10,3311271395
7499,214131760,30390,214162150,8,0,1,22016,3,1264694321
7500,214135660,34919,214170579,7,0,1,28672,2,5474434450
7501,214159671,257188,214416859,1,0,0,40960,18,1599785287
7502,214170560,4385,214174945,6,0,1,4608,0,4231053098
7503,214229230,77074,214306304,6,0,1,512,0,6683644994
7504,214270310,58559,214328869,8,0,1,37888,3,111197694
7505,214286040,43175,214329215,6,0,1,512,0,6354511171
7506,214289969,134713,214424682,6,0,0,25600,0,4392558489
7507,214335940,128868,214464808,7,0,0,512,2,5317577707
7508,214354939,392126,214747065,5,0,0,89600,12,7984907744
7509,214366510,3422,214369932,6,0,1,3584,0,2961971269
7510,214370091,115719,214485810,1,0,0,18432,18,1994980444
7511,214371209,4374,214375583,0,0,1,4608,20,8477594145
7512,214374569,212941,214587510,6,0,0,11264,0,3306639100
7513,214407740,20799,214428539,6,0,1,4096,0,7263997794
7514,214420639,163424,214584063,5,0,0,72192,12,10657222101
7515,214423021,6571,214429592,4,0,1,10240,10,4050524041
7516,214439840,73108,214512948,7,0,0,512,2,2293831533
7517,214466720,566,214467286,8,0,1,512,3,5202244530
7518,214489621,220366,214709987,1,0,0,99840,18,4235102273
7519,214503749,276508,214780257,5,0,0,27136,12,9544763791
7520,214530090,289401,214819491,4,0,0,99328,10,3394964570
7521,214550680,231932,214782612,7,0,0,7680,2,8451021587
7522,214551730,268571,214820301,7,0,0,512,2,8445479545
7523,214552890,7706,214560596,7,0,1,8192,2,5030412942
7524,214598810,4374,214603184,7,0,1,4608,2,1132304011
7525,214604779,228797,214833576,6,0,0,43520,0,805331269
7526,214662370,12308,214674678,6,0,1,20480,0,9422604486
7527,214703190,131033,214834223,9,0,0,2048,9,6661571179
7528,214713170,106960,214820130,9,0,0,2048,9,8487710513
7529,214775520,326394,215101914,4,0,0,196608,10,3878746752
7530,214813600,125684,214939284,4,0,0,47104,10,676066402
7531,214894860,1518,214896378,7,0,1,1536,2,2916433771
7532,214894959,4339,214899298,0,0,1,10752,20,1111195100
7533,214895060,134560,215029620,9,0,0,3584,9,5634332779
7534,214919670,4850,214924520,6,0,1,5120,0,6161533183
7535,214973270,11016,214984286,7,0,1,17920,2,7353981956
7536,214977979,265377,215243356,6,0,0,46592,0,6929164483
7537,214983700,1252,214984952,6,0,1,1024,0,10132327350
7538,215023901,142904,215166805,1,0,0,56832,18,6095819368
7539,215050850,52616,215103466,6,0,1,1536,0,15668853
7540,215080080,34385,215114465,6,0,1,19968,0,8803988931
7541,215089439,80197,215169636,6,0,0,9216,0,3563669585
7542,215157661,158204,215315865,1,0,0,44544,18,8469271733
7543,215167700,47524,215215224,9,0,0,1024,9,7731222583
7544,215171060,21399,215192459,6,0,1,34816,0,10492878194
7545,215177169,243280,215420449,6,0,0,84992,0,9019592631
7546,215215570,1518,215217088,8,0,1,1536,3,7182642864
7547,215239780,16909,215256689,8,0,1,22528,3,7889959319
7548,215274610,196153,215470763,4,0,0,86528,10,272918536
7549,215287369,376785,215664154,5,0,0,133632,12,6695349628
7550,215308030,169640,215477670,7,0,0,1024,2,806263826
7551,215392080,28384,215420464,8,0,1,9728,3,8973753102
7552,215491630,566,215492196,8,0,1,512,3,4882356742
7553,215499161,14117,215513278,9,0,1,24064,9,6366545432
7554,215504531,9515,215514046,9,0,1,11776,9,4046612040
7555,215526069,87033,215613102,6,0,0,9728,0,7961383861
7556,215533309,11274,215544583,0,0,1,18432,20,1216369869
7557,215535461,10710,215546171,4,0,1,15872,10,4195657249
7558,215554950,4850,215559800,6,0,1,5120,0,7146611135
7559,215555900,4156,215560056,8,0,1,9216,3,1034449455
7560,215571409,6278,215577687,0,0,1,6656,20,10008385643
7561,215573080,5375,215578455,6,0,1,11776,0,4668614573
7562,215575679,368904,215944583,6,0,0,68096,0,1356879945
7563,215591411,135551,215726962,1,0,0,50176,18,2270139065
7564,215606450,57719,215664169,8,0,1,39424,3,1053008641
7565,215714371,16481,215730852,9,0,1,4096,9,6076437967
7566,215727190,167311,215894501,4,0,0,40960,10,3951146895
7567,215758610,121507,215880117,7,0,0,512,2,2304060727
7568,215758790,1518,215760308,6,0,1,1536,0,10162497095
7569,215795860,566,215796426,8,0,1,512,3,6308194646
7570,215817340,3645,215820985,8,0,1,10240,3,6939090289
7571,215895310,82085,215977395,7,0,0,1536,2,6315042340
7572,215930809,26332,215957141,0,0,1,20992,20,5681685291
7573,215950119,87995,216038114,5,0,0,13312,12,7704142096
7574,215960560,66754,216027314,7,0,0,3072,2,10208539459
7575,215976080,102780,216078860,4,0,0,14848,10,8466348874
7576,215988241,566,215988807,9,0,1,512,9,3518957988
7577,215988631,2470,215991101,9,0,1,2560,9,2612294893
7578,216021840,48980,216070820,7,0,0,2048,2,1038136013
7579,216123349,6229,216129578,0,0,1,15360,20,4249319316
7580,216172859,7230,216180089,0,0,1,7680,20,4037740573
7581,216176889,104540,216281429,5,0,0,43008,12,5919741536
7582,216181011,236591,216417602,1,0,0,69632,18,1669933132
7583,216194321,2870,216197191,9,0,1,8704,9,8006174785
7584,216251709,12825,216264534,0,0,1,21504,20,389993102
7585,216283610,7706,216291316,8,0,1,8192,3,2548092274
7586,216308989,305983,216614972,6,0,0,192000,0,1260111877
7587,216337639,292636,216630275,6,0,0,50176,0,2767236932
7588,216342001,395551,216737552,1,0,0,53248,18,5397390405
7589,216394420,23197,216417617,6,0,1,5632,0,3393606950
7590,216406431,347984,216754415,1,0,0,55296,18,2082239407
7591,216439860,12737,216452597,8,0,1,24576,3,10049458687
7592,216456430,264883,216721313,4,0,0,107008,10,5425944725
7593,216491260,2470,216493730,6,0,1,2560,0,7164557747
7594,216494580,11533,216506113,1,0,1,18944,18,2577786172
7595,216546079,111614,216657693,6,0,0,14848,0,7467692877
7596,216548381,3387,216551768,9,0,1,9728,9,8193462431
7597,216551061,4753,216555814,9,0,1,11776,9,3763032698
7598,216594380,38850,216633230,6,0,1,3072,0,5920458442
7599,216626810,7538,216634348,6,0,1,9216,0,5196826755
7600,216631229,325392,216956621,5,0,0,287232,12,6889105672
7601,216659191,1518,216660709,9,0,1,1536,9,5320323270
7602,216678951,3128,216682079,9,0,1,9216,9,8866071689
7603,216686760,270548,216957308,7,0,0,2048,2,8363837489
7604,216779819,296274,217076093,6,0,0,233472,0,9476196130
7605,216794690,16613,216811303,8,0,1,32256,3,3799404536
7606,216822511,4937,216827448,9,0,1,12800,9,7452125535
7607,216881141,77669,216958810,9,0,1,1536,9,7019300318
7608,216900620,60268,216960888,1,0,1,9216,18,6111120576
7609,216921450,355398,217276848,4,0,0,93184,10,9885570403
7610,216921599,460903,217382502,6,0,0,211968,0,4644739647
7611,216928240,33370,216961610,1,0,1,1024,18,4398909386
7612,216934621,31455,216966076,9,0,1,13312,9,881963796
7613,216956310,227407,217183717,7,0,0,5632,2,9599017152
7614,216958380,117728,217076108,2,0,1,76800,29,3258536046
7615,216958960,200157,217159117,7,0,0,512,2,3872814442
7616,216969180,413649,217382829,7,0,0,1024,2,3029487050
7617,216975489,316076,217291565,5,0,0,23552,12,3147690941
7618,216987430,88693,217076123,8,0,1,2048,3,9732188766
7619,216994811,182786,217177597,1,0,0,10752,18,9637617804
7620,217030600,47075,217077675,8,0,1,1536,3,3833393580
7621,217043530,43594,217087124,1,0,1,16896,18,7314297192
7622,217056310,32299,217088609,1,0,1,15360,18,3893180917
7623,217099151,1042,217100193,9,0,1,1024,9,5008056294
7624,217102260,295006,217397266,7,0,0,1536,2,2598459020
7625,217116081,267707,217383788,1,0,0,3072,18,1876483778
7626,217151830,566,217152396,1,0,1,512,18,7603163072
7627,217174061,3551,217177612,9,0,1,2560,9,10276856670
7628,217219410,3422,217222832,1,0,1,3584,18,6443570444
7629,217228259,186962,217415221,6,0,0,58880,0,9797020914
7630,217231630,165129,217396759,4,0,0,42496,10,2669639900
7631,217250089,231154,217481243,6,0,0,128512,0,4343939508
7632,217267801,15359,217283160,9,0,1,6656,9,9984436904
7633,217273920,155670,217429590,7,0,0,2048,2,3240585706
7634,217313451,203071,217516522,1,0,0,62464,18,3792777482
7635,217327229,277816,217605045,5,0,0,54272,12,5468173431
7636,217354369,173686,217528055,5,0,0,7680,12,6552887285
7637,217363689,133786,217497475,5,0,0,30720,12,9387254164
7638,217369211,262922,217632133,1,0,0,78336,18,5515918141
7639,217370501,285842,217656343,1,0,0,48128,18,9266541094
7640,217507599,162279,217669878,5,0,0,15360,12,10632090723
7641,217524770,116894,217641664,4,0,0,31232,10,5483025683
7642,217793189,117260,217910449,6,0,0,84992,0,1393003646
7643,217833861,2470,217836331,9,0,1,2560,9,6537365369
7644,217843771,226686,218070457,1,0,0,159232,18,7394515108
7645,217850141,220667,218070808,1,0,0,1024,18,8678490611
7646,217891831,335287,218227118,1,0,0,50176,18,9858388175
7647,217925849,152618,218078467,6,0,0,25088,0,10022436297
7648,217928330,91379,218019709,7,0,0,512,2,7929917216
7649,217955300,3387,217958687,1,0,1,9728,18,7787868304
7650,218001459,210356,218211815,6,0,0,97792,0,6733141721
7651,218014999,167005,218182004,5,0,0,67072,12,6492475932
7652,218041500,231983,218273483,7,0,0,3072,2,9454720543
7653,218042540,229992,218272532,4,0,0,64512,10,9274422518
7654,218060799,173042,218233841,6,0,0,22016,0,3706271142
7655,218093231,245187,218338418,1,0,0,22528,18,7001455892
7656,218151600,83192,218234792,7,0,0,3072,2,3038468814
7657,218287049,98852,218385901,5,0,0,24576,12,7508007123
7658,218310320,3898,218314218,1,0,1,4096,18,8037868491
7659,218310660,3827,218314487,1,0,1,8704,18,3514883810
7660,218326280,368349,218694629,4,0,0,373248,10,9069604604
7661,218333590,8207,218341797,1,0,1,9728,18,8438680637
7662,218377301,320463,218697764,1,0,0,10240,18,857208999
7663,218525071,241714,218766785,1,0,0,154112,18,5334553072
7664,218572710,125561,218698271,7,0,0,1536,2,3521958740
7665,218602559,274596,218877155,5,0,0,125952,12,934184014
7666,218626681,140462,218767143,1,0,0,1024,18,171819033
7667,218634261,302751,218937012,1,0,0,2048,18,6620938116
7668,218667979,243207,218911186,6,0,0,111616,0,1802442639
7669,218672459,26395,218698854,3,0,1,512,28,10426892433
7670,218703411,232946,218936357,1,0,0,82432,18,8604397873
7671,218719109,47691,218766800,3,0,1,8704,28,8528715142
7672,218729229,50698,218779927,3,0,1,21504,28,3166933255
7673,218739410,87827,218827237,2,0,1,87552,29,660030112
7674,218784211,248798,219033009,1,0,0,66048,18,6838052776
7675,218802520,375534,219178054,4,0,0,49664,10,9351612081
7676,218823659,115249,218938908,6,0,0,2560,0,8579423215
7677,218839291,97752,218937043,4,0,1,512,10,9672822503
7678,218876190,78892,218955082,7,0,0,512,2,3852412538
7679,218882951,57943,218940894,4,0,1,4096,10,5144460517
7680,218885649,322373,219208022,5,0,0,66560,12,6797924920
7681,218893120,83808,218976928,7,0,0,512,2,9515404666
7682,218895009,56868,218951877,3,0,1,23040,28,4448222011
7683,218896281,70157,218966438,4,0,1,34304,10,7302640297
7684,218911140,371462,219282602,4,0,0,150016,10,9785663114
7685,218927689,465002,219392691,5,0,0,114688,12,4637664431
7686,218940649,28695,218969344,0,0,1,4608,20,9004086241
7687,218956239,121991,219078230,5,0,0,15872,12,3183330468
7688,219035971,252293,219288264,1,0,0,14336,18,9659046835
7689,219099730,184151,219283881,7,0,0,4096,2,6683142884
7690,219154479,425411,219579890,5,0,0,88064,12,5503601144
7691,219184751,151697,219336448,1,0,0,49152,18,4093903372
7692,219208039,257093,219465132,6,0,0,34816,0,10445442063
7693,219214640,239869,219454509,4,0,0,89600,10,3325300512
7694,219238669,170473,219409142,5,0,0,1536,12,1069640583
7695,219263351,330750,219594101,1,0,0,46592,18,9809706918
7696,219292759,771310,220064069,6,0,0,612352,0,7960548316
7697,219345840,362159,219707999,4,0,0,137728,10,4360773769
7698,219359781,36547,219396328,4,0,1,10240,10,2048344654
7699,219396791,119735,219516526,1,0,0,6656,18,637256647
7700,219408431,6278,219414709,9,0,1,6656,9,188442820
7701,219417769,688162,220105931,6,0,0,132608,0,8969124953
7702,219435239,35123,219470362,3,0,1,13312,28,6763994186
7703,219450259,702213,220152472,5,0,0,131072,12,2668627469
7704,219463661,8327,219471988,9,0,1,2560,9,9109291140
7705,219468219,6252,219474471,3,0,1,11776,28,4127544813
7706,219486689,274555,219761244,5,0,0,1536,12,7054506502
7707,219531269,5326,219536595,3,0,1,5632,28,358439275
7708,219540801,571712,220112513,1,0,0,20480,18,8761916083
7709,219613370,3898,219617268,6,0,1,4096,0,3257458145
7710,219618730,446766,220065496,7,0,0,4608,2,8851706976
7711,219658389,3645,219662034,3,0,1,10240,28,5496583718
7712,219684180,422078,220106258,7,0,0,1024,2,2634027836
7713,219708131,7230,219715361,4,0,1,7680,10,9903256603
7714,219844600,312567,220157167,4,0,0,15360,10,1723837168
7715,219890741,277269,220168010,1,0,0,35328,18,3989432979
7716,219911771,256302,220168073,4,0,1,5632,10,5809047886
7717,219919399,283318,220202717,6,0,0,29184,0,4926053502
7718,219964810,282457,220247267,4,0,0,23040,10,4144316077
7719,220058291,110244,220168535,4,0,1,512,10,10534490418
7720,220082781,96618,220179399,4,0,1,18432,10,924743160
7721,220090231,91114,220181345,4,0,1,3072,10,6851833110
7722,220103240,80371,220183611,1,0,1,3584,18,3074304004
7723,220108709,194016,220302725,5,0,0,82944,12,10156266164
7724,220148980,38497,220187477,6,0,1,6144,0,9879943782
7725,220150960,60223,220211183,7,0,0,2560,2,9248067886
7726,220161789,311097,220472886,5,0,0,193536,12,669504759
7727,220193740,194840,220388580,7,0,0,6656,2,143375071
7728,220201681,2070,220203751,4,0,1,1024,10,1896388172
7729,220259810,6278,220266088,6,0,1,6656,0,7717784045
7730,220260831,5603,220266434,4,0,1,512,10,7831411362
7731,220263341,3452,220266793,4,0,1,9728,10,5317240705
7732,220285789,228479,220514268,6,0,0,101376,0,144921158
7733,220305510,167562,220473072,7,0,0,512,2,5227426179
7734,220316819,1042,220317861,3,0,1,1024,28,2298648584
7735,220404500,68401,220472901,1,0,1,16896,18,2024321803
7736,220409430,105477,220514907,7,0,0,2048,2,10080354975
7737,220438940,237664,220676604,4,0,0,206848,10,5910758703
7738,220438959,270579,220709538,5,0,0,81920,12,7130264171
7739,220461180,325729,220786909,4,0,0,20992,10,8186950537
7740,220476370,3898,220480268,6,0,1,4096,0,7844769996
7741,220490500,37652,220528152,1,0,1,25600,18,2178338155
7742,220582140,5196,220587336,6,0,1,13312,0,2933481010
7743,220715990,158232,220874222,4,0,0,112128,10,1463771756
7744,220720290,116177,220836467,7,0,0,512,2,3358412662
7745,220726551,3128,220729679,4,0,1,9216,10,7756378704
7746,220731411,4162,220735573,4,0,1,11264,10,1246679556
7747,220737349,155947,220893296,6,0,0,12288,0,8845843465
7748,220746369,7230,220753599,3,0,1,7680,28,6261414070
7749,220758210,223088,220981298,4,0,0,68096,10,9854135213
7750,220841879,309978,221151857,6,0,0,18944,0,9062625700
7751,220853559,22691,220876250,3,0,1,2048,28,3213329977
7752,220869209,8027,220877236,3,0,1,1536,28,9774940617
7753,220875861,358873,221234734,1,0,0,173568,18,9964300740
7754,220878871,3128,220881999,4,0,1,9216,10,4019300905
7755,220932270,4679,220936949,6,0,1,12288,0,9413497729
7756,220944129,237698,221181827,6,0,0,80896,0,6107013072
7757,220953809,384626,221338435,6,0,0,202752,0,1059188295
7758,220961460,33688,220995148,6,0,1,23552,0,29022122
7759,220986939,9835,220996774,3,0,1,2560,28,3172334801
7760,220993120,357202,221350322,4,0,0,38912,10,8223976645
7761,221015419,11016,221026435,3,0,1,17920,28,1164283262
7762,221040980,3422,221044402,1,0,1,3584,18,2331790014
7763,221059339,181682,221241021,5,0,0,20480,12,4677741923
7764,221062699,182424,221245123,6,0,0,13312,0,9328882109
7765,221065950,4850,221070800,1,0,1,5120,18,4935627352
7766,221089609,377214,221466823,6,0,0,243712,0,5490757617
7767,221098250,566,221098816,1,0,1,512,18,2606935405
7768,221104409,172088,221276497,5,0,0,18432,12,10032252785
7769,221105399,5712,221111111,0,0,1,14336,20,5652650931
7770,221121620,10757,221132377,6,0,1,17408,0,9397183861
7771,221167349,73703,221241052,0,0,1,3584,20,3649071041
7772,221219350,274770,221494120,7,0,0,1024,2,7230682305
7773,221220611,25244,221245855,4,0,1,5120,10,10095697989
7774,221233619,238415,221472034,5,0,0,16896,12,8863682048
7775,221234461,406236,221640697,1,0,0,138752,18,7999176466
7776,221299840,226003,221525843,4,0,0,24064,10,244407627
7777,221308541,55252,221363793,4,0,1,26112,10,591063609
7778,221362660,3898,221366558,1,0,1,4096,18,8459977959
7779,221397600,79243,221476843,6,0,1,5120,0,10365487490
7780,221408440,73549,221481989,1,0,1,8192,18,5652746909
7781,221409239,77576,221486815,3,0,1,7680,28,7623056159
7782,221428521,59370,221487891,4,0,1,13312,10,10398397701
7783,221435940,56137,221492077,1,0,1,6656,18,9581050830
7784,221449449,211984,221661433,5,0,0,40448,12,8683144252
7785,221515520,11274,221526794,2,0,1,18432,29,10554084404
7786,221554659,185572,221740231,6,0,0,66048,0,7893321739
7787,221612270,34697,221646967,1,0,1,6656,18,4180584525
7788,221650521,177998,221828519,1,0,0,39936,18,10674431012
7789,221662160,14545,221676705,1,0,1,28160,18,878006209
7790,221676549,3387,221679936,0,0,1,9728,20,7398899515
7791,221708050,133679,221841729,4,0,0,13312,10,7169824651
7792,221734059,284680,222018739,6,0,0,80384,0,6988289345
7793,221766970,1042,221768012,1,0,1,1024,18,8440932481
7794,221797410,13083,221810493,6,0,1,22016,0,10128754212
7795,221816110,12432,221828542,1,0,1,15872,18,8306775785
7796,221821510,252434,222073944,4,0,0,97792,10,10194536198
7797,221867239,10499,221877738,3,0,1,16896,28,7169637172
7798,221884140,220463,222104603,4,0,0,81408,10,9094396535
7799,221929620,5326,221934946,6,0,1,5632,0,9313001931
7800,221936641,3387,221940028,4,0,1,9728,10,1021027390
7801,221942831,2470,221945301,4,0,1,2560,10,8882627986
7802,221955149,257096,222212245,6,0,0,51712,0,467963542
7803,222000799,245789,222246588,5,0,0,112640,12,3848370910
7804,222063511,211360,222274871,1,0,0,92672,18,3381952977
7805,222092629,13484,222106113,0,0,1,1536,20,556509922
7806,222121359,442864,222564223,6,0,0,46592,0,4381316696
7807,222135299,3387,222138686,0,0,1,9728,20,6902615300
7808,222145179,190750,222335929,5,0,0,11776,12,4845866823
7809,222154711,395293,222550004,1,0,0,344064,18,7774460292
7810,222158060,6754,222164814,4,0,1,7168,10,6386974860
7811,222158889,693533,222852422,5,0,0,22528,12,4081082654
7812,222160290,442706,222602996,7,0,0,1024,2,5417176104
7813,222167790,407540,222575330,4,0,0,36352,10,9984998959
7814,222168400,7706,222176106,6,0,1,8192,0,9090452571
7815,222173531,429114,222602645,1,0,0,89600,18,7337386570
7816,222178959,3422,222182381,3,0,1,3584,28,6272122061
7817,222184351,3128,222187479,4,0,1,9216,10,6766448967
7818,222200669,491219,222691888,6,0,0,53248,0,9233383104
7819,222236021,439605,222675626,1,0,0,87552,18,2954764951
7820,222240830,35042,222275872,1,0,1,1024,18,3610501120
7821,222242640,751841,222994481,4,0,0,174080,10,10664335130
7822,222244010,762966,223006976,4,0,0,40960,10,2241939231
7823,222277119,371635,222648754,5,0,0,94208,12,9756220640
7824,222286410,409705,222696115,4,0,0,13824,10,3255259795
7825,222326920,381066,222707986,4,0,0,38912,10,5999379994
7826,222340560,2870,222343430,4,0,1,8704,10,4668956578
7827,222358829,3387,222362216,0,0,1,9728,20,2496471280
7828,222404031,4850,222408881,4,0,1,5120,10,5963024553
7829,222412910,566,222413476,1,0,1,512,18,2491661301
7830,222420729,1518,222422247,0,0,1,1536,20,5153381349
7831,222473059,540172,223013231,6,0,0,20480,0,4853770464
7832,222482769,127892,222610661,0,0,1,8192,20,895360481
7833,222502601,611718,223114319,1,0,0,173056,18,7628289544
7834,222546839,289491,222836330,5,0,0,22016,12,4640201374
7835,222553999,58045,222612044,3,0,1,14848,28,6348647010
7836,222554489,61101,222615590,0,0,1,5632,20,7244110080
7837,222593889,22060,222615949,0,0,1,9728,20,9347858644
7838,222603030,13265,222616295,4,0,1,512,10,129809813
7839,222641019,34630,222675649,3,0,1,1536,28,6838852177
7840,222650179,68265,222718444,0,0,1,16896,20,10406077191
7841,222679559,39231,222718790,0,0,1,512,20,2595067407
7842,222696940,41288,222738228,1,0,1,45056,18,1198101655
7843,222717989,26755,222744744,0,0,1,23040,20,7459648355
7844,222738409,301039,223039448,6,0,0,53248,0,5799689272
7845,222751731,23725,222775456,4,0,1,39424,10,9338389567
7846,222830239,318442,223148681,5,0,0,57856,12,4830576127
7847,222831340,27869,222859209,1,0,1,40960,18,3652473933
7848,222845029,17086,222862115,0,0,1,4608,20,4970133919
7849,222854690,63980,222918670,7,0,0,3584,2,5310095518
7850,222862140,369719,223231859,7,0,0,2048,2,4967522134
7851,222864450,566,222865016,1,0,1,512,18,5999198057
7852,222871699,11791,222883490,3,0,1,19456,28,5348573483
7853,222874769,14008,222888777,3,0,1,16896,28,1216684348
7854,222912379,301405,223213784,6,0,0,31232,0,8937269940
7855,222915549,4850,222920399,3,0,1,5120,28,10706787333
7856,222917411,311916,223229327,1,0,0,18944,18,1659746346
7857,222917759,286470,223204229,6,0,0,78848,0,9174038333
7858,222922410,3898,222926308,4,0,1,4096,10,9277058911
7859,222924250,290345,223214595,7,0,0,2560,2,161739818
7860,222983719,31498,223015217,3,0,1,2048,28,2532804278
7861,223062540,56688,223119228,1,0,1,5120,18,910603252
7862,223080691,47813,223128504,4,0,1,20992,10,4799232037
7863,223106610,60386,223166996,2,0,1,76800,29,5142467915
7864,223110689,57293,223167982,0,0,1,1536,20,4172210776
7865,223180480,140486,223320966,4,0,0,19968,10,3732072132
7866,223183219,32994,223216213,3,0,1,2560,28,3136647751
7867,223200831,16368,223217199,4,0,1,1536,10,10384737773
7868,223236710,7706,223244416,1,0,1,8192,18,9893161315
7869,223248279,4162,223252441,3,0,1,11264,28,3473030920
7870,223248720,15348,223264068,1,0,1,20480,18,663787862
7871,223264709,566,223265275,0,0,1,512,20,4108915942
7872,223267980,5454,223273434,1,0,1,13824,18,1604136574
7873,223286569,7230,223293799,0,0,1,7680,20,830001593
7874,223296589,161470,223458059,5,0,0,24576,12,398077241
7875,223313400,159173,223472573,7,0,0,512,2,9423021387
7876,223363029,1518,223364547,0,0,1,1536,20,3297581386
7877,223369719,305864,223675583,5,0,0,277504,12,7006092772
7878,223454430,8300,223462730,1,0,1,12288,18,7545759223
7879,223473159,289378,223762537,6,0,0,154624,0,4612042151
7880,223499410,278430,223777840,4,0,0,50176,10,6167287503
7881,223504909,21399,223526308,3,0,1,34816,28,8211336069
7882,223511069,297846,223808915,6,0,0,101888,0,9013083689
7883,223511180,16716,223527896,1,0,1,15872,18,9812702371
7884,223516630,159460,223676090,7,0,0,1536,2,8877072633
7885,223537480,318837,223856317,4,0,0,40448,10,1440162406
7886,223602089,76004,223678093,0,0,1,2048,20,1272957806
7887,223605289,74430,223679719,3,0,1,2560,28,7453162478
7888,223641460,40463,223681923,1,0,1,11776,18,6622880711
7889,223649169,257292,223906461,5,0,0,109056,12,8576373733
7890,223650630,295449,223946079,7,0,0,1024,2,1924895421
7891,223736969,586193,224323162,5,0,0,97280,12,7040989630
7892,223770821,520768,224291589,1,0,0,391680,18,6693530545
7893,223783190,30746,223813936,5,0,1,12800,12,5931487845
7894,223783390,647160,224430550,4,0,0,308224,10,9364690465
7895,223803919,260705,224064624,6,0,0,4608,0,1117952280
7896,223804229,14124,223818353,3,0,1,13824,28,7953688444
7897,223805920,100556,223906476,5,0,1,117760,12,5643939688
7898,223919449,2470,223921919,0,0,1,2560,20,8698570833
7899,223944531,4679,223949210,4,0,1,12288,10,4939802679
7900,223978180,126179,224104359,5,0,1,208896,12,2823948288
7901,224015320,92905,224108225,1,0,1,6144,18,1539317726
7902,224025949,86142,224112091,0,0,1,6144,20,9737172519
7903,224028719,84550,224113269,3,0,1,13824,28,4163128685
7904,224039900,435149,224475049,4,0,0,145920,10,9614831584
7905,224046979,246512,224293491,6,0,0,6144,0,7204469838
7906,224067650,412733,224480383,4,0,0,15872,10,7602302439
7907,224074339,401193,224475532,5,0,0,1536,12,3965275821
7908,224109809,13770,224123579,3,0,1,26624,28,1610542345
7909,224163061,331401,224494462,1,0,0,46080,18,5685868340
7910,224171529,120075,224291604,0,0,1,16896,20,9790367486
7911,224200940,128509,224329449,7,0,1,6656,2,407445946
7912,224221279,488277,224709556,5,0,0,169472,12,5367214540
7913,224282819,542271,224825090,5,0,0,68608,12,6584118453
7914,224292550,40125,224332675,1,0,1,5120,18,9639274105
7915,224298499,215442,224513941,6,0,0,28672,0,3397620747
7916,224346339,148162,224494501,0,0,1,512,20,10657027801
7917,224363279,396024,224759303,5,0,0,48128,12,2311042290
7918,224374020,120496,224494516,7,0,1,2048,2,9423839295
7919,224405519,218839,224624358,6,0,0,10240,0,5192850337
7920,224447500,330553,224778053,4,0,0,14848,10,2355929610
7921,224447630,49377,224497007,1,0,1,2560,18,10431604336
7922,224450940,76160,224527100,7,0,1,51712,2,2911341743
7923,224483090,45636,224528726,1,0,1,2560,18,632004912
7924,224532270,241244,224773514,4,0,0,46592,10,7840878400
7925,224535289,6278,224541567,3,0,1,6656,28,2693047359
7926,224558919,1994,224560913,3,0,1,2048,28,1756764086
7927,224573830,10757,224584587,7,0,1,17408,2,9022784833
7928,224587000,5802,224592802,1,0,1,6144,18,1509581537
7929,224606540,3645,224610185,7,0,1,10240,2,6854698411
7930,224630030,311665,224941695,4,0,0,89600,10,8007155006
7931,224640160,274204,224914364,4,0,0,133632,10,7837765358
7932,224662780,47334,224710114,7,0,1,512,2,3866371776
7933,224736571,288321,225024892,1,0,0,118784,18,7981229040
7934,224807990,134360,224942350,7,0,0,2048,2,2338361666
7935,224894109,49063,224943172,3,0,1,1536,28,10100107303
7936,224903429,304443,225207872,5,0,0,111616,12,7465783109
7937,224921670,23128,224944798,7,0,1,2560,2,8747260133
7938,225045531,170202,225215733,1,0,0,24576,18,1328688706
7939,225063130,144913,225208043,7,0,0,512,2,6681021009
7940,225098970,4374,225103344,7,0,1,4608,2,6975671861
7941,225142199,123897,225266096,5,0,0,15360,12,2244281161
7942,225157750,50480,225208230,7,0,0,512,2,6828047288
7943,225186801,171990,225358791,1,0,0,54784,18,10168493139
7944,225199930,67216,225267146,7,0,0,2560,2,7023562362
7945,225226279,11533,225237812,0,0,1,18944,20,5650124818
7946,225237549,194136,225431685,6,0,0,66048,0,535220032
7947,225268459,4850,225273309,0,0,1,5120,20,10600861493
7948,225282039,12308,225294347,0,0,1,20480,20,2976422337
7949,225290329,179449,225469778,6,0,0,60416,0,5980224914
7950,225310199,2470,225312669,0,0,1,2560,20,106256996
7951,225385160,145320,225530480,4,0,0,26624,10,731216160
7952,225486179,148917,225635096,6,0,0,43520,0,9015429421
7953,225529589,86043,225615632,6,0,0,19968,0,5876181135
7954,225608511,47288,225655799,1,0,0,1536,18,5796715413
7955,225610571,64497,225675068,1,0,0,6144,18,92364406
7956,225611390,23729,225635119,6,0,1,20480,0,1214175487
7957,225623159,281771,225904930,6,0,0,116224,0,8795178212
7958,225662491,207012,225869503,1,0,0,72192,18,6259215420
7959,225664069,183423,225847492,5,0,0,9216,12,8700533976
7960,225702569,10499,225713068,0,0,1,16896,20,2407717064
7961,225706540,7194,225713734,6,0,1,11264,0,1923259663
7962,225714010,1518,225715528,6,0,1,1536,0,445871086
7963,225787639,2470,225790109,3,0,1,2560,28,4374198981
7964,225836419,316741,226153160,6,0,0,264704,0,3515861174
7965,225869289,38145,225907434,0,0,1,2560,20,9634839609
7966,225882280,35255,225917535,6,0,1,19456,0,8780645301
7967,225884279,316485,226200764,6,0,0,33792,0,1301531225
7968,225915369,11791,225927160,0,0,1,19456,20,9831635982
7969,225927919,251175,226179094,6,0,0,10752,0,7411459067
7970,225929391,246404,226175795,1,0,0,74240,18,1009126718
7971,225940429,4679,225945108,0,0,1,12288,20,4565161337
7972,225988079,4850,225992929,0,0,1,5120,20,5801944154
7973,225999849,1994,226001843,3,0,1,2048,28,473163711
7974,226019010,163571,226182581,4,0,0,11264,10,1886602319
7975,226024110,4850,226028960,6,0,1,5120,0,2494691406
7976,226030570,5196,226035766,6,0,1,13312,0,3571011157
7977,226081940,106854,226188794,1,0,1,15360,18,10416631810
7978,226101041,437072,226538113,1,0,0,250880,18,5146093368
7979,226127779,62001,226189780,0,0,1,1536,20,8866722837
7980,226140081,526732,226666813,1,0,0,66560,18,6685302439
7981,226144421,437707,226582128,1,0,0,144384,18,978896602
7982,226145369,55410,226200779,0,0,1,18432,20,8003099456
7983,226164121,174093,226338214,1,0,0,5632,18,7747566512
7984,226236939,4679,226241618,3,0,1,12288,28,633342702
7985,226244000,454620,226698620,4,0,0,102912,10,2574321603
7986,226252970,7230,226260200,6,0,1,7680,0,10037423741
7987,226255100,391410,226646510,4,0,0,6144,10,8725697592
7988,226262770,10499,226273269,6,0,1,16896,0,6636384658
7989,226268649,9126,226277775,0,0,1,7168,20,9998124267
7990,226277309,367282,226644591,5,0,0,204800,12,7033494468
7991,226282090,4374,226286464,7,0,1,4608,2,4661580346
7992,226293840,373316,226667156,7,0,0,1024,2,10720380349
7993,226337050,4578,226341628,6,0,1,3584,0,477472846
7994,226367170,33591,226400761,7,0,1,55296,2,7914413893
7995,226403359,479207,226882566,6,0,0,28160,0,6550037941
7996,226414349,430487,226844836,5,0,0,187904,12,2420953937
7997,226438001,277874,226715875,1,0,0,9216,18,8086239305
7998,226465399,322170,226787569,5,0,0,26624,12,8971623187
7999,226526181,362531,226888712,1,0,0,13824,18,5365593814
8000,226529860,137335,226667195,6,0,1,7168,0,788384023
8001,226533139,245334,226778473,5,0,0,52224,12,1829316845
8002,226534270,132940,226667210,6,0,1,12800,0,7447282160
8003,226537770,129455,226667225,6,0,1,512,0,8019535762
8004,226561229,137406,226698635,0,0,1,16896,20,7369121677
8005,226594939,103735,226698674,3,0,1,9216,28,8926278925
8006,226604359,97622,226701981,3,0,1,9728,28,8885195998
8007,226616019,99871,226715890,0,0,1,21504,20,3448843216
8008,226636040,232379,226868419,4,0,0,64000,10,2243852808
8009,226639960,435326,227075286,7,0,0,3072,2,7734020843
8010,226642860,202474,226845334,7,0,0,512,2,3875922815
8011,226655069,260048,226915117,6,0,0,71680,0,2202621011
8012,226656049,65144,226721193,3,0,1,22016,28,3954812107
8013,226672640,50179,226722819,8,0,1,2560,3,7116695610
8014,226673020,172143,226845163,7,0,0,1024,2,14956557
8015,226696210,32101,226728311,8,0,1,17920,3,8715726835
8016,226726310,11791,226738101,6,0,1,19456,0,1974237449
8017,226728479,653327,227381806,6,0,0,405504,0,8870520461
8018,226748120,174939,226923059,7,0,0,2560,2,8155567224
8019,226776479,376421,227152900,5,0,0,43520,12,5230573776
8020,226849779,21144,226870923,0,0,1,2560,20,7892254824
8021,226853369,29212,226882581,0,0,1,14336,20,9626992862
8022,226866950,15646,226882596,6,0,1,5120,0,4967797216
8023,226954251,517066,227471317,1,0,0,101376,18,393361072
8024,226958340,275233,227233573,7,0,0,2560,2,6058077259
8025,226961859,444618,227406477,6,0,0,80896,0,9359098193
8026,226969379,6278,226975657,3,0,1,6656,28,5407224695
8027,226974610,503430,227478040,4,0,0,22016,10,2327770339
8028,226995859,2470,226998329,0,0,1,2560,20,4648069875
8029,227008109,408070,227416179,6,0,0,29184,0,386329011
8030,227015169,4420,227019589,3,0,1,11776,28,5994741995
8031,227028131,451499,227479630,1,0,0,4608,18,5583728318
8032,227081929,6278,227088207,0,0,1,6656,20,7569943228
8033,227100939,339459,227440398,5,0,0,79360,12,6727142256
8034,227173470,58460,227231930,7,0,0,1024,2,449159203
8035,227201740,205532,227407272,7,0,0,2560,2,6168378915
8036,227235690,242521,227478211,7,0,0,512,2,3907970537
8037,227259810,220022,227479832,2,0,1,46080,29,4456228875
8038,227310039,425306,227735345,5,0,0,43520,12,2245558204
8039,227332549,541283,227873832,6,0,0,234496,0,2033733013
8040,227342880,136937,227479817,0,0,0,512,20,8515232321
8041,227391639,177867,227569506,6,0,0,77824,0,4241469221
8042,227436209,482678,227918887,5,0,0,13824,12,5619039471
8043,227443160,39577,227482737,6,0,1,3072,0,8962532848
8044,227484761,397822,227882583,1,0,0,28672,18,1979039640
8045,227507869,505285,228013154,6,0,0,103424,0,8045821855
8046,227531940,136391,227668331,7,0,0,2048,2,1978256089
8047,227536639,435441,227972080,5,0,0,166400,12,400352336
8048,227558970,85307,227644277,5,0,1,125440,12,6832334914
8049,227579359,335286,227914645,6,0,0,11264,0,6570072132
8050,227660540,352957,228013497,7,0,0,1024,2,3600838599
8051,227661009,320602,227981611,5,0,0,31232,12,663547555
8052,227685710,235655,227921365,7,0,0,3072,2,6548545870
8053,227887730,26930,227914660,2,0,1,44032,29,4535141768
8054,227890510,28392,227918902,6,0,1,5120,0,10066816745
8055,227923551,181644,228105195,1,0,0,40448,18,2482842598
8056,227926140,102776,228028916,7,0,0,1536,2,10190082680
8057,227957030,99134,228056164,2,0,1,69632,29,5564343674
8058,227966051,92716,228058767,1,0,0,1024,18,1008394832
8059,228012020,49329,228061349,6,0,1,24576,0,2187235782
8060,228089140,136304,228225444,2,0,1,225280,29,5334900895
8061,228107009,165973,228272982,5,0,0,47616,12,1859255389
8062,228107069,227545,228334614,6,0,0,88576,0,7344400463
8063,228113450,112340,228225790,6,0,1,512,0,6839475460
8064,228121770,105198,228226968,6,0,1,13824,0,9515902315
8065,228121929,164960,228286889,5,0,0,37888,12,3426400282
8066,228137710,115077,228252787,2,0,1,90624,29,5210424144
8067,228193060,443797,228636857,8,0,0,258560,3,8999505912
8068,228246571,449351,228695922,1,0,0,20480,18,2801101970
8069,228255501,421181,228676682,1,0,0,87552,18,4198084684
8070,228305999,343041,228649040,5,0,0,39936,12,462738183
8071,228335300,3898,228339198,6,0,1,4096,0,5637146251
8072,228405639,244352,228649991,5,0,0,3072,12,7139969266
8073,228414710,262775,228677485,7,0,0,2560,2,7566302398
8074,228647541,136678,228784219,1,0,0,22528,18,3924261999
8075,228690740,31136,228721876,2,0,1,47104,29,408231666
8076,228718760,164710,228883470,8,0,0,56832,3,2110200621
8077,228744090,110437,228854527,8,0,0,31232,3,10289863069
8078,228820290,6278,228826568,1,0,1,6656,18,10664792247
8079,228889469,111799,229001268,6,0,0,62464,0,6741557311
8080,228926770,81164,229007934,7,0,0,2560,2,8748972665
8081,228944450,57465,229001915,7,0,0,2048,2,1228490490
8082,228990340,59900,229050240,7,0,0,2048,2,2718966011
8083,229038560,12308,229050868,1,0,1,20480,18,5223191337
8084,229060170,4374,229064544,1,0,1,4608,18,671313411
8085,229123750,4420,229128170,1,0,1,11776,18,3660368789
8086,229171221,61641,229232862,4,0,1,99840,10,675954740
8087,229278360,30749,229309109,2,0,1,49664,29,9176036700
8088,229287890,25405,229313295,7,0,1,6656,2,4498652786
8089,229324280,96062,229420342,2,0,1,160256,29,4704724628
8090,229326091,216382,229542473,1,0,0,2560,18,5164711535
8091,229394640,32320,229426960,2,0,1,31744,29,639257459
8092,229401490,185162,229586652,7,0,0,4096,2,4226360016
8093,229404130,26056,229430186,1,0,1,5120,18,5907420113
8094,229421509,182668,229604177,6,0,0,40960,0,433378936
8095,229432790,11791,229444581,7,0,1,19456,2,4974604797
8096,229443070,24412,229467482,7,0,1,44032,2,127249938
8097,229447220,219844,229667064,7,0,0,3072,2,10357647385
8098,229480320,12308,229492628,2,0,1,20480,29,7617013689
8099,229489220,550642,230039862,8,0,0,105984,3,4394659107
8100,229514460,124469,229638929,7,0,0,1536,2,2660172454
8101,229555260,5712,229560972,8,0,1,14336,3,6844631211
8102,229558600,377097,229935697,8,0,0,100864,3,8476265407
8103,229611799,770472,230382271,5,0,0,34816,12,5584382052
8104,229629650,275300,229904950,8,0,0,132608,3,1330246249
8105,229631659,474846,230106505,5,0,0,218624,12,5959552997
8106,229681099,496767,230177866,6,0,0,78336,0,7961803005
8107,229681599,690026,230371625,6,0,0,222720,0,5467625767
8108,229703439,838088,230541527,5,0,0,56832,12,7516502264
8109,229762431,723185,230485616,1,0,0,80384,18,6292769240
8110,229789249,319019,230108268,6,0,0,5632,0,1664059845
8111,229791310,318554,230109864,2,0,1,520192,29,4473932505
8112,229814490,311746,230126236,2,0,1,53760,29,4146333245
8113,229816359,459877,230276236,6,0,0,52224,0,833077314
8114,229837230,289262,230126492,7,0,1,9216,2,3645724643
8115,229854620,275418,230130038,7,0,1,5632,2,9548889161
8116,229864009,597100,230461109,5,0,0,38400,12,6342219873
8117,229867870,690679,230558549,7,0,0,1536,2,5229196463
8118,229917319,481560,230398879,5,0,0,43520,12,3069575934
8119,229932691,625360,230558051,1,0,0,32768,18,5625658288
8120,229950100,283841,230233941,7,0,0,2048,2,6510106297
8121,229993999,859740,230853739,5,0,0,121344,12,535297627
8122,229997640,503451,230501091,8,0,0,50688,3,4602425921
8123,230011740,118862,230130602,7,0,1,10752,2,1873651356
8124,230015069,754555,230769624,6,0,0,119808,0,6790403463
8125,230038169,606525,230644694,6,0,0,70656,0,8724144168
8126,230045900,338414,230384314,7,0,0,6656,2,9199512467
8127,230075310,61501,230136811,2,0,1,29696,29,2908360402
8128,230098569,694782,230793351,5,0,0,77824,12,2507724676
8129,230110280,27402,230137682,1,0,1,12288,18,6101381063
8130,230118230,25661,230143891,1,0,1,21504,18,1273031865
8131,230137370,45179,230182549,2,0,1,77824,29,484922932
8132,230139909,560702,230700611,5,0,0,84480,12,160349394
8133,230159160,131506,230290666,2,0,1,182784,29,7699150598
8134,230249691,425150,230674841,1,0,0,55808,18,5698421152
8135,230251390,39532,230290922,1,0,1,9216,18,7669207361
8136,230279670,91970,230371640,2,0,1,54784,29,8881068697
8137,230319930,227751,230547681,2,0,1,264704,29,3468981039
8138,230455570,338264,230793834,7,0,0,1536,2,1062945792
8139,230473080,426649,230899729,8,0,0,29184,3,3860874334
8140,230493200,64866,230558066,7,0,1,5632,2,2525088503
8141,230560740,566,230561306,8,0,1,512,3,355011154
8142,230562590,231447,230794037,7,0,0,512,2,4529485070
8143,230568010,14029,230582039,8,0,1,27136,3,9706139791
8144,230607980,66876,230674856,2,0,1,93184,29,3062648128
8145,230622340,78286,230700626,7,0,1,28160,2,141267486
8146,230654330,46311,230700641,7,0,1,2560,2,7857344131
8147,230678759,769831,231448590,6,0,0,256000,0,8208985186
8148,230694490,12156,230706646,7,0,1,14848,2,8006850000
8149,230700200,96498,230796698,5,0,1,147968,12,4042886655
8150,230705190,460469,231165659,7,0,0,2560,2,2793280569
8151,230712489,816992,231529481,5,0,0,191488,12,3616353512
8152,230723780,136576,230860356,8,0,0,1024,3,9907100447
8153,230783839,586736,231370575,6,0,0,86528,0,5729858742
8154,230818071,726713,231544784,1,0,0,50176,18,4033283145
8155,230945590,4162,230949752,8,0,1,11264,3,5106668744
8156,230953800,96837,231050637,2,0,1,161792,29,2687170472
8157,230961450,89751,231051201,7,0,1,10752,2,7199472991
8158,230980100,599955,231580055,8,0,0,115712,3,3242172804
8159,230990340,72407,231062747,5,0,1,47104,12,3521170922
8160,230999400,450293,231449693,7,0,0,1024,2,1536317793
8161,231045860,54270,231100130,5,0,1,92160,12,2778774625
8162,231046130,196946,231243076,7,0,0,1024,2,10610212561
8163,231052089,576620,231628709,5,0,0,13824,12,7507772260
8164,231053710,48046,231101756,8,0,1,2560,3,5754466904
8165,231124309,480915,231605224,5,0,0,56320,12,3386258347
8166,231141850,163145,231304995,7,0,0,1536,2,8787315025
8167,231150301,437748,231588049,1,0,0,26112,18,2272187151
8168,231153081,471370,231624451,1,0,0,62976,18,5028618050
8169,231157010,164441,231321451,5,0,1,266752,12,720676953
8170,231158960,290383,231449343,7,0,0,2048,2,3963345452
8171,231161450,287163,231448613,2,0,1,218112,29,5314695469
8172,231175680,272956,231448636,2,0,1,35840,29,6061598564
8173,231237620,211031,231448651,8,0,1,3584,3,6279720902
8174,231275870,172796,231448666,7,0,1,8192,2,392960065
8175,231280820,167869,231448689,1,0,1,3072,18,622207109
8176,231288429,472556,231760985,5,0,0,51200,12,5118274099
8177,231293360,155344,231448704,1,0,1,12800,18,9359647882
8178,231314530,134836,231449366,2,0,1,118272,29,4007075437
8179,231370800,496868,231867668,7,0,0,1536,2,7125998624
8180,231398170,57453,231455623,1,0,1,14848,18,9079488545
8181,231407810,52595,231460405,8,0,1,15360,3,3741031074
8182,231434550,28210,231462760,1,0,1,10752,18,4215364612
8183,231454560,125510,231580070,5,0,1,101376,12,9184044208
8184,231524660,99822,231624482,8,0,1,2560,3,8886501933
8185,231582070,63481,231645551,5,0,1,34304,12,7839962300
8186,231583979,410477,231994456,6,0,0,43008,0,10117644489
8187,231607470,350567,231958037,8,0,0,5632,3,3852979946
8188,231668850,3898,231672748,1,0,1,4096,18,9927130185
8189,231670440,3294,231673734,1,0,1,1536,18,10251202206
8190,231675139,339801,232014940,5,0,0,54784,12,8187295537
8191,231677830,1042,231678872,7,0,1,1024,2,6929503057
8192,231682430,104637,231787067,5,0,1,173568,12,4121986051
8193,231688659,146239,231834898,6,0,0,2048,0,8842156190
8194,231697691,419437,232117128,1,0,0,29696,18,4373631173
8195,231701289,456020,232157309,5,0,0,18944,12,487017555
8196,231704550,691492,232396042,8,0,0,36864,3,409416599
8197,231705470,108850,231814320,5,0,1,97792,12,1908148048
8198,231733330,85496,231818826,7,0,1,7168,2,6669968340
8199,231751761,794041,232545802,1,0,0,92672,18,8369662353
8200,231754569,436139,232190708,5,0,0,109568,12,8429363118
8201,231758500,63232,231821732,7,0,1,4608,2,10541179808
8202,231851661,491143,232342804,1,0,0,90112,18,7390271115
8203,231863911,510969,232374880,1,0,0,84480,18,8381486819
8204,231893630,309463,232203093,7,0,0,512,2,5732727498
8205,231897051,305863,232202914,1,0,0,3072,18,10566495049
8206,231939661,262294,232201955,1,0,0,36864,18,9934575886
8207,231959890,4850,231964740,7,0,1,5120,2,987777188
8208,231980300,85679,232065979,2,0,1,143360,29,540795591
8209,232043580,22963,232066543,7,0,1,10752,2,6368027571
8210,232049120,17769,232066889,8,0,1,512,3,8488391742
8211,232068640,134468,232203108,2,0,1,207360,29,5128750787
8212,232082979,120144,232203123,3,0,1,14336,28,6217729198
8213,232089770,540565,232630335,7,0,0,2560,2,2834462500
8214,232091579,111559,232203138,0,0,1,18432,20,8113685663
8215,232101300,101853,232203153,8,0,1,11264,3,7789587273
8216,232112410,92080,232204490,1,0,1,4608,18,7673238364
8217,232113870,95126,232208996,8,0,1,7168,3,1276717924
8218,232118890,161100,232279990,0,0,0,1024,20,7249456481
8219,232166180,351371,232517551,8,0,0,50176,3,9106136174
8220,232169209,640864,232810073,6,0,0,152064,0,5664801326
8221,232210250,11016,232221266,8,0,1,17920,3,185675115
8222,232236820,12825,232249645,7,0,1,21504,2,3746228160
8223,232256879,500724,232757603,5,0,0,168448,12,1306165871
8224,232300940,287300,232588240,0,0,0,3072,20,3231787091
8225,232317321,544525,232861846,1,0,0,21504,18,7635698573
8226,232323339,620756,232944095,5,0,0,118272,12,1950310762
8227,232347480,27415,232374895,8,0,1,13824,3,3826020943
8228,232366139,29926,232396065,3,0,1,25600,28,156044657
8229,232387309,376401,232763710,6,0,0,19968,0,2926571534
8230,232400569,643983,233044552,6,0,0,22016,0,869927088
8231,232415980,260535,232676515,0,0,0,512,20,3954904328
8232,232451800,12308,232464108,7,0,1,20480,2,850608876
8233,232458800,738429,233197229,8,0,0,20992,3,3687784860
8234,232482631,329017,232811648,1,0,0,5120,18,7160329598
8235,232528830,18023,232546853,1,0,1,1024,18,5476238847
8236,232537239,29766,232567005,3,0,1,33792,28,6757608105
8237,232547620,33098,232580718,2,0,1,40448,29,6790865276
8238,232579670,845750,233425420,8,0,0,322048,3,4066641407
8239,232610740,955139,233565879,0,0,0,512,20,6439349145
8240,232620150,245296,232865446,0,0,0,3072,20,575578538
8241,232632360,11533,232643893,8,0,1,18944,3,5978410936
8242,232637360,447068,233084428,0,0,0,2560,20,4568233039
8243,232673210,13770,232686980,2,0,1,26624,29,4006243288
8244,232690079,4937,232695016,0,0,1,12800,20,8124820102
8245,232721059,124398,232845457,0,0,1,55808,20,6832486136
8246,232729310,347841,233077151,7,0,0,1024,2,4581089055
8247,232732791,458027,233190818,1,0,0,124928,18,1809115908
8248,232759720,86813,232846533,7,0,1,13312,2,9608936467
8249,232780289,81572,232861861,0,0,1,37376,20,2352574077
8250,232788139,450457,233238596,6,0,0,53760,0,6603404314
8251,232808139,501369,233309508,6,0,0,20480,0,6497199778
8252,232872521,816555,233689076,1,0,0,49664,18,3312482687
8253,232898721,666963,233565684,1,0,0,69120,18,1131396517
8254,232902629,400624,233303253,6,0,0,103936,0,4709954744
8255,232907931,944765,233852696,1,0,0,274432,18,8421741741
8256,232915799,628810,233544609,5,0,0,132608,12,8363963075
8257,233008811,574243,233583054,1,0,0,56320,18,3987524426
8258,233026689,7230,233033919,0,0,1,7680,20,1323609238
8259,233040949,630529,233671478,6,0,0,61952,0,2383982732
8260,233045630,863017,233908647,0,0,0,2048,20,513156281
8261,233047021,4162,233051183,4,0,1,11264,10,7893848447
8262,233097859,6488,233104347,0,0,1,15872,20,2650259490
8263,233102560,2133,233104693,1,0,1,512,18,947333997
8264,233108949,4420,233113369,3,0,1,11776,28,3567088360
8265,233112300,313650,233425950,7,0,0,1536,2,4851144512
8266,233126231,625791,233752022,1,0,0,3072,18,7886378876
8267,233181869,16887,233198756,3,0,1,1536,28,2530744214
8268,233185791,17241,233203032,4,0,1,5632,10,9559683212
8269,233209251,10499,233219750,4,0,1,16896,10,5824070118
8270,233223749,25355,233249104,0,0,1,16896,20,3450915597
8271,233229561,24689,233254250,9,0,1,8192,9,3257486672
8272,233254640,4374,233259014,8,0,1,4608,3,4578756756
8273,233254729,4951,233259680,3,0,1,1024,28,2056331757
8274,233320829,548614,233869443,5,0,0,54784,12,9050774854
8275,233323930,101505,233425435,7,0,1,24064,2,2825449254
8276,233359299,73198,233432497,3,0,1,15872,28,191158194
8277,233364291,678204,234042495,1,0,0,63488,18,8383462782
8278,233392200,52157,233444357,2,0,1,26112,29,10403296762
8279,233402540,325980,233728520,7,0,0,1024,2,7615006664
8280,233405520,40220,233445740,1,0,1,14848,18,8138776813
8281,233408541,40745,233449286,4,0,1,5632,10,9056901926
8282,233409930,41622,233451552,1,0,1,3584,18,9438448935
8283,233411260,206191,233617451,0,0,0,1024,20,824298274
8284,233427081,28977,233456058,4,0,1,7168,10,4595430099
8285,233449529,573591,234023120,5,0,0,355840,12,7514886360
8286,233477380,1994,233479374,7,0,1,2048,2,3372926648
8287,233523089,63822,233586911,3,0,1,4096,28,3417724609
8288,233535280,53577,233588857,1,0,1,3072,18,8969702792
8289,233541809,331768,233873577,5,0,0,12288,12,2974331110
8290,233569510,497905,234067415,7,0,0,6144,2,4936186790
8291,233572170,493318,234065488,8,0,0,38912,3,4300719047
8292,233572560,303935,233876495,7,0,0,2048,2,10634847244
8293,233573260,16482,233589742,7,0,1,11776,2,3920360145
8294,233573670,19138,233592808,7,0,1,4096,2,6342056877
8295,233604000,23466,233627466,1,0,1,38912,18,1640232301
8296,233627660,242150,233869810,7,0,0,1024,2,7108623750
8297,233633470,38047,233671517,2,0,1,59904,29,368218580
8298,233641121,30411,233671532,4,0,1,10240,10,7427638685
8299,233658029,485300,234143329,5,0,0,36864,12,4166857129
8300,233658391,30700,233689091,4,0,1,8704,10,3311474000
8301,233658929,30193,233689122,3,0,1,512,28,5554684726
8302,233673429,583161,234256590,5,0,0,77824,12,5504237355
8303,233674430,21958,233696388,1,0,1,7680,18,660702304
8304,233681900,15154,233697054,1,0,1,1024,18,7183303672
8305,233684690,14950,233699640,2,0,1,4096,29,7330438587
8306,233693009,360429,234053438,6,0,0,35840,0,6996531528
8307,233739419,6278,233745697,3,0,1,6656,28,5635818612
8308,233759000,352249,234111249,8,0,0,125440,3,4282915479
8309,233775010,278607,234053617,7,0,0,512,2,135059718
8310,233776870,104865,233881735,1,0,1,20480,18,5118455919
8311,233787080,96921,233884001,8,0,1,3584,3,9027893640
8312,233797330,87017,233884347,1,0,1,512,18,5074883364
8313,233799560,86733,233886293,2,0,1,3072,29,1709134279
8314,233804510,94548,233899058,2,0,1,34304,29,2743554868
8315,233855769,322402,234178171,6,0,0,41984,0,9649828122
8316,233860270,39454,233899724,2,0,1,1024,29,156677474
8317,233885370,14508,233899878,2,0,1,8704,29,7184513030
8318,233896491,6293,233902784,4,0,1,4608,10,677867401
8319,233920299,190981,234111280,3,0,1,23552,28,6786407055
8320,233945010,166285,234111295,1,0,1,3072,18,7473080147
8321,233957279,154031,234111310,3,0,1,1024,28,3960402077
8322,233994140,117193,234111333,2,0,1,15872,29,9586288635
8323,234045250,72187,234117437,7,0,1,15360,2,2110766754
8324,234049111,135154,234184265,1,0,0,2048,18,9005481811
8325,234074640,44423,234119063,1,0,1,2560,18,1974879160
8326,234083090,193997,234277087,0,0,0,512,20,596708646
8327,234087570,55774,234143344,6,0,1,30208,0,5818131997
8328,234090791,266099,234356890,1,0,0,34304,18,5246032345
8329,234104030,211823,234315853,7,0,0,5632,2,6142755870
8330,234116711,421745,234538456,1,0,0,112128,18,4932734975
8331,234173220,48847,234222067,7,0,0,512,2,3084983041
8332,234193529,1994,234195523,0,0,1,2048,20,3058939768
8333,234245430,18399,234263829,6,0,1,7680,0,5697150323
8334,234251650,17788,234269438,2,0,1,16896,29,2467106950
8335,234258450,12064,234270514,8,0,1,13312,3,2693733646
8336,234275140,2946,234278086,2,0,1,3072,29,3633078019
8337,234279990,108887,234388877,7,0,0,2048,2,6283485945
8338,234285709,3904,234289613,3,0,1,10752,28,5451527917
8339,234296820,105391,234402211,8,0,0,5632,3,2248453154
8340,234309550,6318,234315868,8,0,1,12800,3,9305630153
8341,234338189,288512,234626701,5,0,0,89088,12,4679237337
8342,234366700,14117,234380817,8,0,1,24064,3,1444373831
8343,234392959,247641,234640600,6,0,0,45568,0,8408673762
8344,234411870,229845,234641715,0,0,0,3584,20,474368283
8345,234450260,10241,234460501,8,0,1,16384,3,328553103
8346,234460860,184528,234645388,7,0,0,512,2,3367572078
8347,234520899,124302,234645201,5,0,0,11264,12,3035145303
8348,234521010,132389,234653399,7,0,0,512,2,8589756730
8349,234562421,244697,234807118,1,0,0,36864,18,5953854103
8350,234581630,4850,234586480,2,0,1,5120,29,2729579409
8351,234591469,50269,234641738,3,0,1,42496,28,3303256480
8352,234597970,50516,234648486,2,0,1,7168,29,5609850186
8353,234612789,274255,234887044,5,0,0,155648,12,1145038415
8354,234637470,12394,234649864,8,0,1,12288,3,6559621035
8355,234641360,9810,234651170,2,0,1,2048,29,2644354678
8356,234655370,233717,234889087,7,0,0,6656,2,9137271986
8357,234743180,211614,234954794,0,0,0,512,20,2432708227
8358,234758570,207614,234966184,0,0,0,1024,20,8586195139
8359,234792271,247783,235040054,1,0,0,162816,18,10454393265
8360,234826270,4679,234830949,2,0,1,12288,29,10348130334
8361,234829979,408690,235238669,5,0,0,171008,12,7878531315
8362,234861710,76349,234938059,0,0,0,2048,20,7827558247
8363,234877739,415412,235293151,5,0,0,177664,12,6619493123
8364,234910420,246982,235157402,7,0,0,4096,2,6088005622
8365,234943029,388231,235331260,5,0,0,35328,12,10307130795
8366,234968650,566,234969216,8,0,1,512,3,4905188597
8367,234980320,59773,235040093,2,0,1,89600,29,4122673348
8368,234982370,256634,235239004,7,0,0,1024,2,8615351664
8369,234995080,58874,235053954,2,0,1,23552,29,7898361936
8370,235019741,300740,235320481,1,0,0,86528,18,5517348388
8371,235136149,1042,235137191,3,0,1,1024,28,7974527797
8372,235148431,187236,235335667,1,0,0,14336,18,8631741586
8373,235159670,134432,235294102,7,0,0,3072,2,10028597078
8374,235162999,407420,235570419,6,0,0,23040,0,4476756829
8375,235182330,154772,235337102,0,0,0,4608,20,7161999151
8376,235189280,203326,235392606,8,0,0,44544,3,2397117619
8377,235292779,270605,235563384,6,0,0,186880,0,125535727
8378,235298249,42703,235340952,3,0,1,5632,28,5777186594
8379,235307589,37229,235344818,3,0,1,6144,28,4927717948
8380,235384589,20575,235405164,3,0,1,20992,28,9807155826
8381,235392760,349919,235742679,7,0,0,1024,2,1663138699
8382,235395910,218704,235614614,0,0,0,2560,20,969661793
8383,235420870,14029,235434899,8,0,1,27136,3,5300103055
8384,235439680,130762,235570442,2,0,1,175104,29,4887470529
8385,235459150,336740,235795890,8,0,0,168960,3,6438912939
8386,235538030,34425,235572455,8,0,1,2048,3,4060061676
8387,235558429,19886,235578315,3,0,1,7680,28,83648299
8388,235564730,24016,235588746,2,0,1,29696,29,10718153306
8389,235624639,6488,235631127,3,0,1,15872,28,4577181744
8390,235652249,148778,235801027,5,0,0,4096,12,1267906524
8391,235665860,566,235666426,8,0,1,512,3,6475096773
8392,235667390,2946,235670336,8,0,1,3072,3,6731043248
8393,235671510,181577,235853087,8,0,0,20480,3,2628720756
8394,235702900,5802,235708702,8,0,1,6144,3,7976325855
8395,235704070,111999,235816069,7,0,0,512,2,6215941135
8396,235708260,87645,235795905,8,0,1,74240,3,506478120
8397,235708580,87340,235795920,8,0,1,12288,3,690486581
8398,235753451,49257,235802708,4,0,1,7168,10,33667205
8399,235760281,499318,236259599,1,0,0,136704,18,4330272371
8400,235794449,58653,235853102,0,0,1,88064,20,4314859416
8401,235806969,378690,236185659,6,0,0,140288,0,6035807386
8402,235815960,37157,235853117,2,0,1,11776,29,1583038794
8403,235859941,6229,235866170,4,0,1,15360,10,5436979702
8404,235882721,335179,236217900,1,0,0,57344,18,391436616
8405,235884860,5326,235890186,8,0,1,5632,3,3273931875
8406,235934529,123876,236058405,5,0,0,19968,12,3718310766
8407,235945969,330852,236276821,6,0,0,56320,0,5990808508
8408,235954490,46212,236000702,2,0,1,79872,29,1461601343
8409,235966670,328023,236294693,7,0,0,3584,2,7197333605
8410,235986051,15317,236001368,4,0,1,1024,10,8677989460
8411,235995571,8063,236003634,4,0,1,3584,10,2121632426
8412,236015939,334270,236350209,6,0,0,88064,0,1990450283
8413,236058831,2946,236061777,4,0,1,3072,10,3956997959
8414,236079230,198542,236277772,7,0,0,3072,2,9547697879
8415,236098679,2870,236101549,3,0,1,8704,28,6722271126
8416,236146299,44073,236190372,3,0,1,12288,28,2434034716
8417,236158890,119426,236278316,7,0,0,1536,2,9739389309
8418,236160320,99294,236259614,2,0,1,47616,29,3454704624
8419,236189539,88256,236277795,3,0,1,6144,28,4230936910
8420,236196180,113024,236309204,0,0,0,512,20,4076600319
8421,236197500,80310,236277810,8,0,1,13312,3,10619464296
8422,236208121,69704,236277825,4,0,1,1536,10,5529763464
8423,236226189,275706,236501895,5,0,0,44544,12,9017192104
8424,236254400,37500,236291900,7,0,1,23040,2,2208903153
8425,236268900,30537,236299437,8,0,1,24064,3,9706800880
8426,236275880,297052,236572932,7,0,0,2560,2,2122457778
8427,236287550,12348,236299898,8,0,1,10240,3,3768201960
8428,236294670,5689,236300359,7,0,1,10240,2,10138269068
8429,236298520,69660,236368180,0,0,0,3584,20,1090144649
8430,236299900,311927,236611827,8,0,0,85504,3,4489722078
8431,236309210,207883,236517093,8,0,0,2560,3,596353783
8432,236324129,28083,236352212,3,0,1,2048,28,2961573896
8433,236343580,14492,236358072,7,0,1,7680,2,8571032073
8434,236361890,204274,236566164,0,0,0,512,20,6403421975
8435,236377520,1994,236379514,7,0,1,2048,2,8067796074
8436,236413680,56079,236469759,2,0,1,95744,29,2468909959
8437,236425621,143624,236569245,1,0,0,9216,18,7368343627
8438,236478210,158180,236636390,7,0,0,1024,2,4113408115
8439,236524100,87898,236611998,7,0,0,512,2,1633566034
8440,236548860,63621,236612481,7,0,0,1536,2,8428837168
8441,236623119,47600,236670719,5,0,0,2560,12,10400115896
8442,236649601,7230,236656831,4,0,1,7680,10,2753815747
8443,236670480,4135,236674615,8,0,1,10752,3,3261772505
8444,236682660,84054,236766714,8,0,0,14848,3,10248227125
8445,236693190,103220,236796410,7,0,0,38912,2,96209021
8446,236693959,265027,236958986,5,0,0,60416,12,1261850002
8447,236697710,20366,236718076,8,0,1,32768,3,3168349906
8448,236702540,555131,237257671,7,0,0,9728,2,8779143639
8449,236713550,5832,236719382,8,0,1,2048,3,5977983244
8450,236734771,6278,236741049,4,0,1,6656,10,5861765345
8451,236737610,8265,236745875,8,0,1,7680,3,588465965
8452,236747880,101348,236849228,8,0,0,32768,3,2238323004
8453,236751889,406213,237158102,5,0,0,209408,12,3605502107
8454,236771160,53066,236824226,2,0,1,86528,29,10622838308
8455,236771860,53672,236825532,7,0,1,2048,2,5692681319
8456,236813869,154516,236968385,6,0,0,30720,0,3070987720
8457,236818860,275408,237094268,8,0,0,55296,3,464978718
8458,236847689,578871,237426560,6,0,0,84992,0,191400394
8459,236862970,65429,236928399,2,0,1,110592,29,905059605
8460,236863040,67305,236930345,7,0,1,3072,2,7612950357
8461,236868800,566511,237435311,7,0,0,28672,2,47177500
8462,236903949,408796,237312745,5,0,0,110080,12,2092175293
8463,236905000,30171,236935171,7,0,1,7680,2,8228714814
8464,236946180,107584,237053764,2,0,1,142848,29,8212521615
8465,236952020,570468,237522488,8,0,0,72704,3,1937631005
8466,236953919,518699,237472618,5,0,0,122368,12,2199936459
8467,236967949,643231,237611180,5,0,0,24064,12,4399473629
8468,236976861,77159,237054020,4,0,1,9216,10,8882490387
8469,236992399,611255,237603654,6,0,0,55808,0,3517652570
8470,236996440,652811,237649251,8,0,0,45056,3,2763220025
8471,236997539,1007522,238005061,5,0,0,82432,12,8085772766
8472,236999650,59964,237059614,2,0,1,26624,29,6076549289
8473,237052581,786227,237838808,1,0,0,82944,18,5101119420
8474,237071220,4420,237075640,8,0,1,11776,3,5564944194
8475,237075779,18504,237094283,3,0,1,6144,28,8094607825
8476,237104230,70027,237174257,5,0,1,31232,12,8054696479
8477,237104579,482056,237586635,5,0,0,187392,12,3382808735
8478,237105669,96803,237202472,3,0,1,60928,28,8922211912
8479,237120129,88859,237208988,3,0,1,23040,28,6278944206
8480,237183311,31374,237214685,4,0,1,27136,10,6898513122
8481,237228330,2870,237231200,8,0,1,8704,3,6066915801
8482,237251370,2946,237254316,2,0,1,3072,29,2916171545
8483,237258521,13858,237272379,4,0,1,23552,10,9842502946
8484,237259840,13512,237273352,8,0,1,12800,3,4863492121
8485,237266490,9176,237275666,7,0,1,14848,2,3497453921
8486,237276770,888736,238165506,7,0,0,153600,2,7742750936
8487,237277240,35528,237312768,8,0,1,16384,3,1612813854
8488,237279511,37671,237317182,4,0,1,11776,10,1509570209
8489,237303180,18882,237322062,8,0,1,14336,3,10263992322
8490,237319351,4552,237323903,4,0,1,9216,10,7349069255
8491,237326420,289471,237615891,8,0,0,15360,3,1327386632
8492,237388780,1518,237390298,2,0,1,1536,29,2475923945
8493,237397920,231299,237629219,0,0,0,1536,20,6946746210
8494,237410000,282829,237692829,7,0,0,43008,2,3287962790
8495,237414891,63757,237478648,4,0,1,14848,10,4303349664
8496,237418130,291597,237709727,0,0,0,512,20,1461884814
8497,237438730,165095,237603825,0,0,0,512,20,9380386060
8498,237466690,33631,237500321,2,0,1,41472,29,6797801890
8499,237478310,219682,237697992,7,0,0,16896,2,9726016650
8500,237558350,90916,237649266,2,0,1,39424,29,2839287728
8501,237583071,66210,237649281,4,0,1,1536,10,3787077459
8502,237588020,216953,237804973,0,0,0,4096,20,586325887
8503,237612251,349538,237961789,1,0,0,91648,18,197562484
8504,237615630,292410,237908040,7,0,0,14848,2,6356015639
8505,237627860,34160,237662020,2,0,1,55296,29,1256352518
8506,237646750,25588,237672338,2,0,1,40960,29,2309245159
8507,237657360,181775,237839135,8,0,0,1024,3,4634278072
8508,237718320,572809,238291129,8,0,0,82944,3,6731605203
8509,237740180,98978,237839158,2,0,1,157184,29,6521432338
8510,237748910,90263,237839173,8,0,1,5120,3,6625875060
8511,237778779,64836,237843615,0,0,1,18944,20,4398062422
8512,237814840,429036,238243876,7,0,0,168960,2,8227201070
8513,237846080,1042,237847122,1,0,1,1024,18,2910760058
8514,237868870,23466,237892336,2,0,1,38912,29,10047901382
8515,237869800,556944,238426744,7,0,0,203264,2,9649823815
8516,237886829,477568,238364397,5,0,0,59904,12,2045330635
8517,237886950,6154,237893104,1,0,1,11776,18,1161660840
8518,237912809,392375,238305184,6,0,0,46080,0,2484826955
8519,237961550,1749,237963299,1,0,1,1536,18,9372380794
8520,237965780,39312,238005092,2,0,1,62464,29,9570735216
8521,237969850,45727,238015577,1,0,1,16896,18,5018213278
8522,237988010,29513,238017523,2,0,1,3072,29,9996988168
8523,238099980,65549,238165529,2,0,1,71168,29,5311240196
8524,238125419,350554,238475973,5,0,0,10240,12,3222709747
8525,238191979,51928,238243907,0,0,1,36352,20,8798164009
8526,238193440,233647,238427087,0,0,0,1024,20,4493212249
8527,238200289,58149,238258438,0,0,1,28160,20,9432173449
8528,238263689,367614,238631303,5,0,0,84480,12,18512884
8529,238274719,36445,238311164,0,0,1,14848,20,3751117340
8530,238277860,149250,238427110,2,0,1,118272,29,9131870114
8531,238359740,137068,238496808,7,0,0,15360,2,3439814521
8532,238367069,66031,238433100,3,0,1,14848,28,369200415
8533,238367559,175585,238543144,0,0,1,180224,20,8602229634
8534,238374440,173530,238547970,1,0,1,7680,18,615385944
8535,238406300,145536,238551836,1,0,1,6144,18,2451336357
8536,238419460,134642,238554102,2,0,1,3584,29,4408324039
8537,238427300,173436,238600736,7,0,0,9216,2,6456888784
8538,238432869,416591,238849460,6,0,0,46080,0,7256320521
8539,238456549,104069,238560618,3,0,1,23040,28,9284208694
8540,238469360,91822,238561182,8,0,1,10752,3,1321626516
8541,238483260,491102,238974362,8,0,0,115712,3,10220690593
8542,238536600,64742,238601342,2,0,1,105984,29,4124195280
8543,238537389,469607,239006996,5,0,0,25088,12,4630947834
8544,238546389,58179,238604568,0,0,1,5120,20,1790929120
8545,238560539,70779,238631318,3,0,1,35328,28,10485333523
8546,238564890,326060,238890950,0,0,0,2048,20,9779729312
8547,238567880,322431,238890311,8,0,0,36352,3,8731706984
8548,238601589,328787,238930376,5,0,0,48640,12,7394503957
8549,238643750,253530,238897280,0,0,0,512,20,7894323924
8550,238662769,186714,238849483,0,0,1,305152,20,9288798844
8551,238709289,521562,239230851,6,0,0,201216,0,6795153782
8552,238725730,548675,239274405,7,0,0,137728,2,4564991795
8553,238730071,502355,239232426,1,0,0,5120,18,2768456693
8554,238731640,650884,239382524,7,0,0,99840,2,5942594767
8555,238739850,130114,238869964,2,0,1,77312,29,267282591
8556,238779900,92010,238871910,8,0,1,3072,3,9873524960
8557,238805650,498566,239304216,8,0,0,97792,3,6918920044
8558,238840510,34306,238874816,8,0,1,4608,3,1955647463
8559,238875790,98587,238974377,5,0,1,115200,12,8420721179
8560,238952060,511841,239463901,8,0,0,56320,3,6336347873
8561,238978499,740576,239719075,5,0,0,109056,12,7173379373
8562,238983349,11533,238994882,0,0,1,18944,20,186311365
8563,238994059,12952,239007011,3,0,1,8192,28,5844996085
8564,239033710,3387,239037097,8,0,1,9728,3,1862693708
8565,239034460,429776,239464236,2,0,0,1024,29,1468714706
8566,239045520,558961,239604481,7,0,0,212992,2,6775951476
8567,239049510,5196,239054706,2,0,1,13312,29,2907223443
8568,239069690,31783,239101473,8,0,1,51712,3,5587522257
8569,239083550,380717,239464267,5,0,1,611840,12,10440764116
8570,239116519,347763,239464282,3,0,1,1024,28,496538909
8571,239118879,351176,239470055,3,0,1,22016,28,4646937670
8572,239142119,724514,239866633,5,0,0,188928,12,8234942955
8573,239184179,782948,239967127,6,0,0,124416,0,9612329316
8574,239185010,291663,239476673,1,0,1,23552,18,3121321303
8575,239207661,433645,239641306,1,0,0,76800,18,253402143
8576,239209300,791865,240001165,7,0,0,111616,2,7645460038
8577,239212231,885059,240097290,1,0,0,20480,18,10366320241
8578,239214269,264670,239478939,3,0,1,3584,28,9066454825
8579,239218030,267425,239485455,2,0,1,31232,29,3043863108
8580,239240180,250972,239491152,8,0,1,27136,3,4297560949
8581,239241120,661762,239902882,0,0,0,5632,20,8052092777
8582,239255260,236878,239492138,1,0,1,1536,18,4434153347
8583,239264890,340386,239605276,7,0,0,2560,2,10422611556
8584,239305950,190374,239496324,6,0,1,6656,0,2590949235
8585,239346890,554261,239901151,7,0,0,74240,2,2828742049
8586,239351620,1089713,240441333,8,0,0,189440,3,5813470790
8587,239371220,1137993,240509213,8,0,0,28672,3,2079671848
8588,239379731,888574,240268305,1,0,0,34816,18,8015276432
8589,239381929,129846,239511775,0,0,1,57344,20,1140028533
8590,239390600,1274900,240665500,8,0,0,456704,3,5367943607
8591,239399009,730211,240129220,5,0,0,24576,12,8534533877
8592,239401590,755229,240156819,7,0,0,38912,2,2317722502
8593,239414840,643276,240058116,8,0,0,86016,3,6641605162
8594,239426830,85931,239512761,2,0,1,1536,29,2916323870
8595,239435911,1061042,240496953,1,0,0,75776,18,4057129899
8596,239458900,56447,239515347,1,0,1,4096,18,1833886879
8597,239462499,58954,239521453,3,0,1,20992,28,9920585901
8598,239462639,876348,240338987,5,0,0,60416,12,7806949048
8599,239486659,164700,239651359,0,0,1,267264,20,461440850
8600,239501749,1180332,240682081,5,0,0,37888,12,10454455995
8601,239546379,108526,239654905,3,0,1,5632,28,10583958912
8602,239552431,921419,240473850,1,0,0,41472,18,2152294645
8603,239576059,885140,240461199,6,0,0,64000,0,8387111570
8604,239581870,77861,239659731,6,0,1,7680,0,3096610599
8605,239592630,67255,239659885,6,0,1,8704,0,6573539184
8606,239604279,55952,239660231,3,0,1,512,28,9500938923
8607,239611149,70792,239681941,0,0,1,79360,20,4659934914
8608,239628830,812846,240441676,2,0,0,1024,29,5598952246
8609,239633230,50337,239683567,1,0,1,2560,18,10008833689
8610,239635290,748308,240383598,8,0,0,23040,3,8147803912
8611,239635520,83578,239719098,2,0,1,41984,29,9818179676
8612,239647750,1078523,240726273,8,0,0,27136,3,8339533184
8613,239688550,36319,239724869,6,0,1,6144,0,7947303103
8614,239735719,982271,240717990,6,0,0,29696,0,8282977758
8615,239758281,912226,240670507,1,0,0,16384,18,2782264324
8616,239769489,428661,240198150,3,0,0,1024,28,3375584427
8617,239770750,397575,240168325,0,0,0,2560,20,9119957135
8618,239795170,566,239795736,1,0,1,512,18,1360946128
8619,239862690,45067,239907757,2,0,1,66560,29,4207838443
8620,239879290,811058,240690348,0,0,0,2048,20,2716118018
8621,239928049,39093,239967142,0,0,1,5632,20,6700834979
8622,239983189,517094,240500283,6,0,0,1536,0,10051885197
8623,239991690,691966,240683656,0,0,0,5120,20,9447361589
8624,240017639,325107,240342746,5,0,0,12288,12,648838999
8625,240027590,317535,240345125,7,0,0,7680,2,1551657900
8626,240035759,24343,240060102,3,0,1,2048,28,6720735188
8627,240100400,7230,240107630,2,0,1,7680,29,3770780988
8628,240103770,241370,240345140,8,0,1,389632,3,5288774282
8629,240146840,198315,240345155,1,0,1,12800,18,536677453
8630,240162469,183632,240346101,3,0,1,5632,28,4054504456
8631,240169469,857114,241026583,6,0,0,191488,0,3770344216
8632,240171769,180438,240352207,3,0,1,29184,28,7601841630
8633,240175649,324151,240499800,6,0,0,9216,0,4710461584
8634,240175861,513840,240689701,1,0,0,15360,18,6698650914
8635,240198060,510867,240708927,8,0,0,60928,3,2636753180
8636,240211619,644320,240855939,6,0,0,11776,0,3171122928
8637,240235380,449539,240684919,0,0,0,4096,20,7536055236
8638,240248810,251644,240500454,2,0,0,512,29,9300358865
8639,240297620,615725,240913345,8,0,0,158720,3,5417481399
8640,240328110,39866,240367976,1,0,1,40960,18,8913014828
8641,240329310,434778,240764088,8,0,0,11264,3,6768242443
8642,240335649,37473,240373122,3,0,1,8192,28,4795542923
8643,240383969,125267,240509236,3,0,1,1536,28,5970770211
8644,240390231,119020,240509251,4,0,1,8192,10,10417091126
8645,240413019,257503,240670522,0,0,1,62976,20,1851340499
8646,240472259,212715,240684974,0,0,1,95232,20,702558345
8647,240489990,569064,241059054,8,0,0,106496,3,658171670
8648,240502121,574012,241076133,1,0,0,55808,18,399181841
8649,240507670,240570,240748240,8,0,1,106496,3,4520403924
8650,240531299,963875,241495174,6,0,0,160256,0,2349849774
8651,240538229,403025,240941254,3,0,0,512,28,5106690204
8652,240547060,1123856,241670916,8,0,0,76288,3,5054271061
8653,240551990,206568,240758558,8,0,1,32768,3,8475301732
8654,240579710,373591,240953301,0,0,0,512,20,10262218407
8655,240625549,134392,240759941,3,0,1,14848,28,2425723919
8656,240642910,533033,241175943,2,0,0,512,29,10197953119
8657,240651280,713699,241364979,8,0,0,51200,3,6104982959
8658,240674190,89913,240764103,6,0,1,6144,0,9757215482
8659,240722510,354426,241076936,2,0,0,2560,29,8547020998
8660,240752570,17958,240770528,6,0,1,32256,0,4024139397
8661,240770910,5802,240776712,6,0,1,6144,0,1630558321
8662,240778039,384643,241162682,6,0,0,105472,0,213764988
8663,240788830,447652,241236482,0,0,0,1024,20,1153858700
8664,240806091,415883,241221974,1,0,0,138752,18,257536079
8665,240835651,566,240836217,9,0,1,512,9,8450754689
8666,240859819,199250,241059069,0,0,1,206848,20,7251866041
8667,240862080,676033,241538113,7,0,0,140800,2,522107244
8668,240866659,192425,241059084,0,0,1,29696,20,3978407114
8669,240873171,185928,241059099,4,0,1,19456,10,462121629
8670,240877769,999502,241877271,5,0,0,49664,12,3130412262
8671,240901581,823816,241725397,1,0,0,73216,18,6775811845
8672,240904691,154423,241059114,4,0,1,18944,10,9029635081
8673,240929399,890659,241820058,5,0,0,166400,12,5449176707
8674,240961059,993302,241954361,6,0,0,25600,0,9671610573
8675,240974470,563970,241538440,2,0,0,1024,29,8925515501
8676,241010269,610515,241620784,6,0,0,23552,0,3868209123
8677,241045820,1092088,242137908,8,0,0,71168,3,4927344274
8678,241057341,25414,241082755,9,0,1,6144,9,10374368608
8679,241096300,23725,241120025,6,0,1,39424,0,6272841940
8680,241126530,36167,241162697,2,0,1,15360,29,2809507959
8681,241149180,72825,241222005,2,0,1,40960,29,3617397060
8682,241162589,59431,241222020,3,0,1,26624,28,6074059581
8683,241170799,173613,241344412,5,0,0,1024,12,96638629
8684,241180099,1013866,242193965,6,0,0,97792,0,775166969
8685,241192589,695788,241888377,6,0,0,22016,0,2542770548
8686,241205919,22909,241228828,3,0,1,7168,28,4890328478
8687,241216310,390798,241607108,0,0,0,512,20,5738655804
8688,241244010,1042,241245052,2,0,1,1024,29,3514057196
8689,241281529,5196,241286725,0,0,1,13312,20,5744959829
8690,241307110,554803,241861913,8,0,0,137216,3,8213174048
8691,241345250,206302,241551552,8,0,0,7168,3,3338393549
8692,241352660,558438,241911098,7,0,0,64512,2,5455426957
8693,241364920,3022,241367942,2,0,1,3072,29,6763075874
8694,241371221,5971,241377192,4,0,1,14848,10,6319080140
8695,241408359,136562,241544921,0,0,1,225792,20,9569432768
8696,241427520,507796,241935316,8,0,0,79360,3,2654898093
8697,241434690,579548,242014238,8,0,0,54784,3,7305083931
8698,241479880,69227,241549107,6,0,1,6656,0,569260107
8699,241505750,838071,242343821,7,0,0,129024,2,9721363364
8700,241518599,363055,241881654,6,0,0,14336,0,1606718943
8701,241582550,581596,242164146,7,0,0,86016,2,7627753534
8702,241584610,4420,241589030,6,0,1,11776,0,4452138940
8703,241623830,266628,241890458,7,0,0,6656,2,1846935873
8704,241629050,233074,241862124,0,0,0,512,20,2755529845
8705,241641891,1518,241643409,4,0,1,1536,10,6508229115
8706,241653999,449449,242103448,3,0,0,512,28,7227503665
8707,241680640,558456,242239096,7,0,0,147968,2,2455592758
8708,241682390,820904,242503294,7,0,0,173056,2,214244354
8709,241708469,1134413,242842882,6,0,0,83456,0,5248781853
8710,241775620,112772,241888392,2,0,1,1024,29,899689913
8711,241784691,103716,241888407,4,0,1,1536,10,8208020571
8712,241793750,96723,241890473,6,0,1,8192,0,8164224961
8713,241793809,591462,242385271,3,0,0,512,28,8180997294
8714,241801950,876472,242678422,7,0,0,196096,2,3466998073
8715,241822261,88860,241911121,4,0,1,10240,10,5378157585
8716,241888089,541602,242429691,6,0,0,6144,0,660450693
8717,241889299,558404,242447703,6,0,0,36864,0,5319068055
8718,241928629,11053,241939682,3,0,1,4608,28,4212195111
8719,241941479,443606,242385085,6,0,0,70656,0,10439888685
8720,241967490,3422,241970912,2,0,1,3584,29,990007447
8721,241996800,17453,242014253,6,0,1,5632,0,1573187211
8722,242032251,7230,242039481,4,0,1,7680,10,9957733226
8723,242060440,1042,242061482,2,0,1,1024,29,4112577030
8724,242074909,519750,242594659,5,0,0,59904,12,10631848019
8725,242095509,42414,242137923,3,0,1,36352,28,102643348
8726,242126039,377434,242503473,3,0,0,512,28,10074172890
8727,242145869,671570,242817439,6,0,0,76800,0,7373008437
8728,242156519,347125,242503644,3,0,0,512,28,3527820310
8729,242164829,87567,242252396,3,0,1,22528,28,359799034
8730,242178860,74202,242253062,2,0,1,1024,29,2260061527
8731,242205170,48353,242253523,2,0,1,10240,29,662802873
8732,242226689,498776,242725465,5,0,0,39424,12,7548950225
8733,242234110,23599,242257709,2,0,1,6656,29,7197932787
8734,242240770,44058,242284828,5,0,1,54784,12,3366102453
8735,242278680,632292,242910972,7,0,0,18944,2,7598013112
8736,242298661,733200,243031861,1,0,0,265216,18,6321419419
8737,242319879,252582,242572461,5,0,0,14848,12,2104175250
8738,242341450,15213,242356663,6,0,1,21504,0,6116120936
8739,242352290,32810,242385100,5,0,1,19968,12,7914452098
8740,242359091,1004976,243364067,1,0,0,208384,18,232703983
8741,242372400,798806,243171206,8,0,0,16384,3,9536705262
8742,242378270,21839,242400109,2,0,1,28672,29,10385203687
8743,242382879,803006,243185885,5,0,0,48128,12,8784623555
8744,242389060,29289,242418349,5,0,1,40448,12,8214377102
8745,242394020,30026,242424046,6,0,1,27136,0,1255265148
8746,242409919,643017,243052936,5,0,0,69120,12,4821972713
8747,242440340,411005,242851345,7,0,0,27648,2,9982323165
8748,242446760,56899,242503659,6,0,1,86528,0,3638724983
8749,242450639,293180,242743819,3,0,0,1536,28,5409004610
8750,242501061,665098,243166159,1,0,0,178176,18,2241954223
8751,242501199,16335,242517534,3,0,1,23552,28,8046966031
8752,242530769,398574,242929343,3,0,0,1536,28,3507174285
8753,242546821,1994,242548815,4,0,1,2048,10,3313320620
8754,242551421,818775,243370196,1,0,0,19968,18,4069839306
8755,242552129,633927,243186056,3,0,0,512,28,400610574
8756,242593010,85427,242678437,6,0,1,77312,0,87326614
8757,242598590,126890,242725480,5,0,1,161280,12,2279881050
8758,242608879,116616,242725495,3,0,1,9216,28,10011925585
8759,242614640,672498,243287138,8,0,0,114176,3,2074742152
8760,242623181,572161,243195342,1,0,0,23552,18,3180097187
8761,242625250,933165,243558415,7,0,0,112128,2,8399855190
8762,242629069,424514,243053583,3,0,0,2048,28,10283851634
8763,242660060,741054,243401114,7,0,0,100352,2,6563497285
8764,242662491,63019,242725510,4,0,1,21504,10,7551809045
8765,242669009,441601,243110610,5,0,0,11264,12,7104220555
8766,242694761,31774,242726535,4,0,1,24576,10,9690569774
8767,242701180,352442,243053622,5,0,1,248832,12,5115767493
8768,242740900,467241,243208141,0,0,0,1024,20,9685844785
8769,242741589,558939,243300528,6,0,0,38400,0,9560396837
8770,242806090,380045,243186135,5,0,1,130560,12,2214297237
8771,242810641,478102,243288743,1,0,0,5120,18,7511612787
8772,242821540,465613,243287153,1,0,1,20480,18,8155255099
8773,242837780,449388,243287168,7,0,1,1536,2,3106201053
8774,242843151,445607,243288758,4,0,1,4096,10,8003485198
8775,242855081,433692,243288773,4,0,1,13312,10,409440216
8776,242925520,438562,243364082,1,0,1,40960,18,10317337968
8777,242935990,428107,243364097,2,0,1,2048,29,9604626021
8778,242972970,456501,243429471,6,0,1,117248,0,6537022220
8779,243000280,429550,243429830,2,0,1,9728,29,8143680933
8780,243001090,451712,243452802,1,0,1,3072,18,326179339
8781,243011860,413263,243425123,8,0,0,28160,3,10469856832
8782,243014141,440249,243454390,4,0,1,15872,10,9094352520
8783,243028500,436795,243465295,2,0,1,6656,29,5906401390
8784,243041369,466357,243507726,3,0,1,66560,28,363967958
8785,243048000,465016,243513016,1,0,1,10752,18,9932850786
8786,243104679,579511,243684190,5,0,0,28672,12,495462699
8787,243107799,484086,243591885,3,0,0,1536,28,6860494658
8788,243109750,482150,243591900,7,0,1,8192,2,5007060187
8789,243123400,467986,243591386,8,0,0,108032,3,3290333383
8790,243126450,465465,243591915,7,0,1,2048,2,182455249
8791,243146010,445920,243591930,1,0,1,1536,18,7541231196
8792,243150559,373677,243524236,6,0,0,22016,0,9286636008
8793,243160259,210264,243370523,3,0,0,1024,28,7326048399
8794,243163959,441776,243605735,0,0,1,52736,20,8217728929
8795,243165590,440160,243605750,7,0,1,1536,2,1821538172
8796,243166269,439496,243605765,3,0,1,1024,28,7403496719
8797,243181470,410631,243592101,0,0,0,512,20,1321061430
8798,243190380,608345,243798725,5,0,1,215552,12,3722858568
8799,243192369,606371,243798740,3,0,1,5120,28,6986849692
8800,243198820,202873,243401693,0,0,0,1536,20,7292839064
8801,243224851,573843,243798694,1,0,0,142336,18,4178952514
8802,243227330,626213,243853543,5,0,1,75776,12,8892579367
8803,243240790,364930,243605720,8,0,0,44544,3,415106653
8804,243249530,642517,243892047,6,0,1,39424,0,7336475576
8805,243269350,624963,243894313,2,0,1,3584,29,4975719057
8806,243280551,374391,243654942,1,0,0,26112,18,786809289
8807,243302430,654564,243956994,8,0,0,75264,3,1456924659
8808,243309020,661202,243970222,6,0,1,137728,0,10587518380
8809,243324510,665416,243989926,6,0,1,11776,0,5127638155
8810,243325290,423586,243748876,8,0,0,39424,3,4486811914
8811,243328701,810611,244139312,1,0,0,105984,18,9895411737
8812,243340049,650223,243990272,3,0,1,512,28,6532216079
8813,243345770,705258,244051028,5,0,1,88576,12,287726102
8814,243351041,701293,244052334,4,0,1,2048,10,107374645
8815,243358950,724275,244083225,6,0,1,50688,0,7635743830
8816,243360820,726640,244087460,1,0,1,1536,18,5064421230
8817,243365960,722166,244088126,1,0,1,1024,18,6009784514
8818,243384780,722225,244107005,5,0,1,6656,12,6592702509
8819,243392140,765174,244157314,6,0,1,99840,0,8488571861
8820,243474560,683420,244157980,1,0,1,25088,18,7692007692
8821,243482040,707141,244189181,2,0,1,10240,29,10115903174
8822,243489489,324350,243813839,3,0,0,2560,28,255802327
8823,243511860,678307,244190167,2,0,1,1536,29,9873693414
8824,243525140,319849,243844989,8,0,0,4608,3,8501403928
8825,243528350,663443,244191793,7,0,1,2560,2,3635052901
8826,243532619,190258,243722877,3,0,0,512,28,9951828664
8827,243558110,634042,244192152,2,0,1,9728,29,1656850074
8828,243585450,764381,244349831,5,0,1,172032,12,7492281588
8829,243604280,210471,243814751,0,0,0,512,20,7186812863
8830,243645699,288348,243934047,5,0,0,44032,12,4872790922
8831,243686450,470833,244157283,8,0,0,58880,3,3513864587
8832,243738529,625555,244364084,3,0,1,35840,28,9651414853
8833,243763330,612868,244376198,2,0,1,33792,29,8970283986
8834,243765300,341690,244106990,8,0,0,54784,3,266225046
8835,243799630,162341,243961971,0,0,0,2048,20,1634939424
8836,243815610,562534,244378144,2,0,1,3072,29,7215710770
8837,243816211,585678,244401889,4,0,1,15872,10,3660118090
8838,243826191,577644,244403835,4,0,1,3072,10,9827381869
8839,243838220,506887,244345107,8,0,0,92160,3,2110714857
8840,243860091,356602,244216693,1,0,0,54272,18,5264275983
8841,243890289,303693,244193982,3,0,0,2048,28,7919241601
8842,243904090,501881,244405971,2,0,1,14336,29,10199421856
8843,243945899,254227,244200126,3,0,0,2048,28,8129001341
8844,243946830,460447,244407277,2,0,1,2048,29,8130453828
8845,243949199,464031,244413230,3,0,1,28160,28,9129538520
8846,243967289,311126,244278415,6,0,0,53760,0,6362222799
8847,243982060,418208,244400268,0,0,0,512,20,9079065335
8848,243993970,425311,244419281,2,0,1,1536,29,3620792932
8849,244010650,412177,244422827,2,0,1,5632,29,8316984041
8850,244039540,214146,244253686,0,0,0,3072,20,6483591898
8851,244053460,371979,244425439,2,0,1,4096,29,5215186490
8852,244075311,352074,244427385,4,0,1,25600,10,5046525538
8853,244076040,415427,244491467,5,0,1,121856,12,4333658957
8854,244088719,468196,244556915,5,0,0,34304,12,327304497
8855,244126011,374831,244500842,4,0,1,3584,10,10683253907
8856,244144850,504647,244649497,6,0,1,123392,0,2050515194
8857,244164110,759307,244923417,5,0,1,165888,12,8567873645
8858,244180260,847783,245028043,6,0,1,7168,0,652841870
8859,244180351,863790,245044141,4,0,1,4096,10,1522831495
8860,244207649,559626,244767275,5,0,0,36864,12,1615587
8861,244216869,415972,244632841,6,0,0,17920,0,4264687128
8862,244229701,798327,245028028,1,0,0,292352,18,7956614265
8863,244248961,601933,244850894,1,0,0,103936,18,1358657946
8864,244264530,822841,245087371,5,0,1,182784,12,6887189066
8865,244281890,846880,245128770,6,0,1,40960,0,6232285232
8866,244283599,535612,244819211,6,0,0,90112,0,6119825543
8867,244356270,772515,245128785,7,0,1,1024,2,6092224979
8868,244377200,751600,245128800,2,0,1,15360,29,2450859826
8869,244397559,673399,245070958,5,0,0,50688,12,6010810841
8870,244408060,728824,245136884,5,0,1,28672,12,7629938551
8871,244421941,478888,244900829,1,0,0,163840,18,2828741862
8872,244461479,582647,245044126,6,0,0,52736,0,2771796471
8873,244508340,633690,245142030,2,0,1,8192,29,8952901666
8874,244527870,633633,245161503,5,0,1,4608,12,7899483729
8875,244545020,683667,245228687,6,0,1,155648,0,2019821000
8876,244554781,573974,245128755,1,0,0,39936,18,9366572834
8877,244619831,639153,245258984,4,0,1,15360,10,6956836800
8878,244648231,620123,245268354,4,0,1,19456,10,2973751530
8879,244691290,586066,245277356,7,0,1,1024,2,94366987
8880,244697310,582632,245279942,7,0,1,4096,2,3181308680
8881,244711120,569488,245280608,7,0,1,1024,2,2712673334
8882,244736670,318789,245055459,2,0,0,1536,29,9803818773
8883,244760660,294308,245054968,5,0,0,35328,12,4431994002
8884,244816570,547551,245364121,5,0,1,50176,12,8429650236
8885,244816720,560976,245377696,6,0,1,103424,0,10492209858
8886,244834770,547432,245382202,7,0,1,7168,2,824158538
8887,244851710,536291,245388001,7,0,1,19456,2,9908505735
8888,244861360,527627,245388987,2,0,1,1536,29,8121552935
8889,244888990,501623,245390613,7,0,1,2560,2,1264764954
8890,244900869,463237,245364106,5,0,0,184832,12,9393939796
8891,244910200,485559,245395759,2,0,1,8192,29,5101651074
8892,244914441,487117,245401558,4,0,1,19456,10,3660131667
8893,244920300,703161,245623461,0,0,0,2560,20,727492610
8894,244931670,496342,245428012,2,0,1,39424,29,5689452671
8895,244985561,445256,245430817,4,0,1,4608,10,87868035
8896,244988820,444583,245433403,2,0,1,4096,29,9890472370
8897,245014700,523522,245538222,5,0,1,222720,12,3437394690
8898,245060810,542023,245602833,5,0,1,88576,12,6125622931
8899,245069131,563934,245633065,4,0,1,10240,10,154160459
8900,245104179,589812,245693991,3,0,0,1024,28,10310844666
8901,245109701,524350,245634051,4,0,1,1536,10,6069328069
8902,245181840,320120,245501960,0,0,0,1536,20,10683937615
8903,245203199,256993,245460192,3,0,0,11264,28,8253941409
8904,245212510,423487,245635997,2,0,1,3072,29,2189214130
8905,245215610,437341,245652951,6,0,1,3072,0,4463106682
8906,245228779,959284,246188063,6,0,0,377344,0,8709628611
8907,245241100,657889,245898989,5,0,1,115200,12,2536949580
8908,245243711,655944,245899655,4,0,1,1024,10,9415535209
8909,245244099,725909,245970008,3,0,0,2560,28,8604764483
8910,245258259,529950,245788209,5,0,0,72192,12,5377085929
8911,245269160,630956,245900116,6,0,1,10240,0,10716382910
8912,245275370,152627,245427997,2,0,0,3072,29,3488810818
8913,245289450,716973,246006423,5,0,1,99840,12,3450919458
8914,245315621,692428,246008049,9,0,1,2560,9,8760325206
8915,245318231,691489,246009720,4,0,1,512,10,10284553915
8916,245321459,1101585,246423044,6,0,0,25088,0,7919364025
8917,245327150,882361,246209511,5,0,1,37376,12,7957815547
8918,245338039,981177,246319216,6,0,0,116736,0,5603043064
8919,245355350,617262,245972612,0,0,0,1024,20,1518382668
8920,245380580,850177,246230757,2,0,1,8704,29,1944438339
8921,245399240,831532,246230772,5,0,1,4608,12,2544521867
8922,245408590,822851,246231441,9,0,0,2048,9,9937374319
8923,245423520,807222,246230742,8,0,0,69632,3,2240263573
8924,245438430,792357,246230787,2,0,1,4096,29,9478776513
8925,245482070,1112370,246594440,5,0,0,185344,12,7801363180
8926,245482360,245918,245728278,2,0,0,2048,29,8120069987
8927,245501899,707589,246209488,6,0,0,65536,0,550525393
8928,245508869,680628,246189497,3,0,0,3584,28,2684931037
8929,245532400,377848,245910248,9,0,0,1536,9,6416284950
8930,245546069,363696,245909765,6,0,0,29696,0,10246985635
8931,245557351,673451,246230802,4,0,1,6656,10,2973865109
8932,245566740,694487,246261227,9,0,0,512,9,1470659905
8933,245592320,639136,246231456,6,0,1,6656,0,3612938995
8934,245609000,623142,246232142,0,0,0,1536,20,4511520351
8935,245615290,859659,246474949,6,0,1,90624,0,7086316355
8936,245633570,966866,246600436,8,0,0,18432,3,7612643337
8937,245643929,893994,246537923,6,0,0,124416,0,4488604475
8938,245679989,363465,246043454,3,0,0,512,28,10680460603
8939,245706560,768735,246475295,2,0,1,512,29,10153938260
8940,245719699,468691,246188390,3,0,0,1024,28,6201809114
8941,245722130,815808,246537938,6,0,1,5120,0,6839687328
8942,245730760,551359,246282119,8,0,0,13312,3,3951798700
8943,245735310,960057,246695367,8,0,0,95744,3,5574014778
8944,245743769,516936,246260705,6,0,0,93696,0,7892106858
8945,245779340,758613,246537953,5,0,1,11264,12,1643791783
8946,245787360,211274,245998634,2,0,0,512,29,6666681635
8947,245797580,796883,246594463,6,0,1,3072,0,496663615
8948,245801950,792855,246594805,6,0,1,10240,0,10258890700
8949,245817031,783420,246600451,4,0,1,37376,10,7255370487
8950,245819909,449942,246269851,3,0,0,512,28,10325074810
8951,245835360,913149,246748509,6,0,1,199168,0,8898878770
8952,245837050,424006,246261056,2,0,0,1024,29,1656114684
8953,245853710,561675,246415385,4,0,0,116224,10,6708532606
8954,245863389,516442,246379831,6,0,0,154112,0,10138127275
8955,245905100,550996,246456096,2,0,0,512,29,9962096406
8956,245916641,832971,246749612,4,0,1,1024,10,6047050373
8957,245920041,829827,246749868,9,0,1,9216,9,1971667296
8958,245928401,839759,246768160,4,0,1,3584,10,2207955910
8959,245967611,801010,246768621,9,0,1,10240,9,6198302337
8960,246011859,736603,246748462,5,0,0,53248,12,2247195461
8961,246032090,914573,246946663,8,0,0,167936,3,1785406211
8962,246045179,621001,246666180,5,0,0,68608,12,652656630
8963,246045610,379173,246424783,2,0,0,5632,29,6837578677
8964,246046990,184645,246231635,2,0,0,512,29,8209389439
8965,246057710,748021,246805731,5,0,1,38912,12,1346528238
8966,246068690,811110,246879800,6,0,1,117760,0,4320177786
8967,246096850,856604,246953454,4,0,0,20992,10,6445249322
8968,246116461,764107,246880568,9,0,1,11776,9,5612804309
8969,246192150,307850,246500000,8,0,0,14336,3,10418660287
8970,246215660,516563,246732223,8,0,0,102912,3,5459359343
8971,246218530,376260,246594790,0,0,0,1024,20,697458285
8972,246229850,717163,246947013,5,0,1,5120,12,2481048671
8973,246234529,201326,246435855,5,0,0,9728,12,707632682
8974,246249040,697988,246947028,5,0,1,20992,12,9876490389
8975,246372331,574712,246947043,4,0,1,23040,10,3435252603
8976,246392179,382068,246774247,3,0,0,2560,28,497908012
8977,246441450,394173,246835623,4,0,0,46080,10,6628261356
8978,246445310,585595,247030905,5,0,0,46592,12,6228133691
8979,246471409,224597,246696006,6,0,0,2048,0,3677803643
8980,246518750,330713,246849463,8,0,0,10240,3,5988914208
8981,246560150,386848,246946998,9,0,0,1024,9,959168220
8982,246564191,389613,246953804,4,0,1,23552,10,5842725722
8983,246564450,323589,246888039,4,0,0,12800,10,7488968514
8984,246634290,381133,247015423,4,0,0,79360,10,1006970978
8985,246707271,246564,246953835,4,0,1,3584,10,3016173931
8986,246716311,792524,247508835,1,0,0,222208,18,10301469971
8987,246717301,551570,247268871,1,0,0,82944,18,8823272002
8988,246719260,297434,247016694,7,0,0,4096,2,10673119007
8989,246746099,570232,247316331,6,0,0,96768,0,9731182910
8990,246779200,607866,247387066,0,0,0,512,20,10656834165
8991,246787789,349766,247137555,5,0,0,2048,12,7304163546
8992,246791979,528579,247320558,5,0,0,13824,12,8379469177
8993,246805109,148672,246953781,3,0,0,1024,28,10136286972
8994,246817799,310694,247128493,3,0,0,1024,28,2432185225
8995,246851689,427181,247278870,6,0,0,32768,0,2860885372
8996,246895100,787628,247682728,0,0,0,3072,20,382555555
8997,246897710,308502,247206212,9,0,0,1536,9,3629492181
8998,246930891,604339,247535230,1,0,0,86528,18,1751430252
8999,246941131,398073,247339204,1,0,0,6144,18,6000281556
9000,246943861,15941,246959802,9,0,1,14848,9,10631466038
9001,246964050,1167447,248131497,4,0,0,122368,10,418069751
9002,247006040,315313,247321353,0,0,0,2560,20,7746617313
9003,247010160,1005267,248015427,4,0,0,140800,10,10262046207
9004,247011830,586231,247598061,8,0,0,89600,3,6595012062
9005,247143720,247815,247391535,0,0,0,3584,20,1379903160
9006,247165929,226206,247392135,3,0,0,512,28,2572670380
9007,247211410,345227,247556637,8,0,0,34304,3,7704317326
9008,247224709,1046456,248271165,6,0,0,102400,0,8171222283
9009,247237950,566,247238516,5,0,1,512,12,8881744769
9010,247268100,108478,247376578,0,0,0,1536,20,2807577814
9011,247268460,1337196,248605656,8,0,0,76800,3,1866419544
9012,247271180,784198,248055378,8,0,0,131072,3,1189270334
9013,247274450,260951,247535401,9,0,0,512,9,7832628762
9014,247329590,98882,247428472,9,0,0,512,9,9745854249
9015,247353269,1091992,248445261,6,0,0,131584,0,2498884161
9016,247380311,12308,247392619,9,0,1,20480,9,9449139509
9017,247388201,5404,247393605,9,0,1,1536,9,5272987134
9018,247403470,337469,247740939,4,0,0,23040,10,2814170204
9019,247407690,1368352,248776042,7,0,0,452608,2,5695769801
9020,247413350,985500,248398850,8,0,0,10240,3,2034325074
9021,247417860,822090,248239950,5,0,0,62976,12,3050188685
9022,247425159,654618,248079777,5,0,0,79872,12,982751937
9023,247454930,1127311,248582241,8,0,0,144896,3,1643583103
9024,247484000,989274,248473274,7,0,0,37888,2,2792615090
9025,247522021,1441132,248963153,1,0,0,114176,18,3826198146
9026,247533269,795845,248329114,3,0,0,1024,28,7085294164
9027,247535821,1000613,248536434,1,0,0,204800,18,10443750331
9028,247545141,1265690,248810831,1,0,0,52224,18,10430345807
9029,247552231,6392,247558623,9,0,1,2048,9,9190699375
9030,247590510,573425,248163935,2,0,0,2048,29,3948583438
9031,247593649,1285734,248879383,6,0,0,224256,0,4452187092
9032,247609360,474020,248083380,7,0,0,11776,2,113871040
9033,247674000,864070,248538070,9,0,0,1536,9,3682070536
9034,247684170,1196640,248880810,8,0,0,4608,3,6936694035
9035,247712630,824131,248536761,9,0,0,1024,9,6654043365
9036,247715820,1212530,248928350,7,0,0,138240,2,4752355404
9037,247716291,566,247716857,9,0,1,512,9,6545337352
9038,247724681,7706,247732387,9,0,1,8192,9,6441157731
9039,247742180,1586840,249329020,8,0,0,111616,3,596409587
9040,247746310,791261,248537571,9,0,0,2048,9,7193217946
9041,247772529,1209288,248981817,6,0,0,14848,0,9501618847
9042,247779350,1227269,249006619,9,0,0,1536,9,3314082760
9043,247801351,15062,247816413,9,0,1,29184,9,9698039965
9044,247826010,257628,248083638,9,0,0,512,9,4639565877
9045,247827530,1219669,249047199,0,0,0,6656,20,2940363918
9046,247828071,966793,248794864,1,0,0,61440,18,3117961328
9047,247835610,1309893,249145503,8,0,0,159744,3,1199745258
9048,247843960,7706,247851666,1,0,1,8192,18,10435840358
9049,247849940,686992,248536932,2,0,0,512,29,2788511271
9050,247859429,778694,248638123,5,0,0,88064,12,637937847
9051,247863389,1140018,249003407,6,0,0,70656,0,1337855833
9052,247864740,1141396,249006136,8,0,0,8192,3,8590387656
9053,247872230,1013985,248886215,0,0,0,512,20,8353632634
9054,247883539,1322028,249205567,6,0,0,56320,0,7954992700
9055,247890770,485428,248376198,2,0,0,1536,29,8367531566
9056,247906921,1354641,249261562,1,0,0,47616,18,2514087551
9057,247918429,892573,248811002,3,0,0,512,28,4754678183
9058,247930290,5802,247936092,1,0,1,6144,18,9675124068
9059,247933460,149959,248083419,8,0,1,187904,3,848061956
9060,247948830,1239493,249188323,7,0,0,138240,2,301511598
9061,247963079,1060411,249023490,6,0,0,55296,0,10003897611
9062,247963280,1078123,249041403,2,0,0,512,29,1085448121
9063,247977899,1025726,249003625,3,0,0,512,28,1692772072
9064,247978920,152592,248131512,1,0,1,30720,18,7350692653
9065,247982940,903104,248886044,0,0,0,512,20,8830671985
9066,248030221,101306,248131527,9,0,1,5632,9,3355993732
9067,248032431,99111,248131542,9,0,1,17920,9,2231038686
9068,248042250,1766909,249809159,4,0,0,183296,10,2002458707
9069,248052290,79267,248131557,1,0,1,2560,18,3177551504
9070,248052990,1561078,249614068,5,0,0,99840,12,386050879
9071,248054380,986579,249040959,9,0,0,4096,9,1382465206
9072,248061509,1084633,249146142,3,0,0,2048,28,1659207361
9073,248078430,53142,248131572,1,0,1,6656,18,3318018962
9074,248117001,20365,248137366,9,0,1,6144,9,9101600656
9075,248143040,1292714,249435754,5,0,0,45056,12,7786855083
9076,248182230,1080157,249262387,2,0,0,1024,29,4604306897
9077,248214250,1138060,249352310,4,0,0,5120,10,69274732
9078,248246459,141544,248388003,0,0,1,194048,20,2017462111
9079,248249200,1454437,249703637,4,0,0,47616,10,8549549032
9080,248310220,1174057,249484277,7,0,0,33792,2,5758811635
9081,248319230,1337771,249657001,8,0,0,78336,3,1315848905
9082,248321500,68449,248389949,1,0,1,3072,18,8328899183
9083,248346049,710350,249056399,3,0,0,512,28,5666222091
9084,248356780,620474,248977254,5,0,0,28160,12,5182431959
9085,248374689,401424,248776113,0,0,1,149504,20,3254775433
9086,248380020,588608,248968628,8,0,0,17920,3,9965372990
9087,248399270,1514195,249913465,7,0,0,27136,2,7030905542
9088,248408460,853585,249262045,9,0,0,1536,9,5941960900
9089,248410300,400725,248811025,1,0,1,10752,18,114984103
9090,248412160,1203171,249615331,9,0,0,4096,9,10440700135
9091,248412780,473093,248885873,7,0,0,16384,2,144988460
9092,248467060,343980,248811040,2,0,1,4608,29,2023466753
9093,248493011,475632,248968643,9,0,1,7680,9,8351684994
9094,248494909,486955,248981864,0,0,1,24064,20,1644366682
9095,248520671,1465157,249985828,1,0,0,56832,18,10529212517
9096,248533639,745947,249279586,3,0,0,3584,28,9783784830
9097,248557740,994708,249552448,8,0,0,116736,3,6008430733
9098,248561980,441466,249003446,1,0,1,24576,18,8945611273
9099,248565640,1067478,249633118,5,0,0,17408,12,2411117277
9100,248565889,580276,249146165,0,0,1,35840,20,607155713
9101,248578289,567891,249146180,0,0,1,6656,20,9721473941
9102,248578620,609734,249188354,1,0,1,4096,18,10695125779
9103,248580039,1946806,250526845,6,0,0,96768,0,10176790551
9104,248597629,427452,249025081,6,0,0,5120,0,9042643101
9105,248602060,586309,249188369,1,0,1,3584,18,8797881187
9106,248615190,573194,249188384,1,0,1,2560,18,5983749434
9107,248625330,786004,249411334,0,0,0,2560,20,6994575822
9108,248642610,563292,249205902,9,0,0,1024,9,934398205
9109,248670189,535736,249205925,0,0,1,36352,20,1281136603
9110,248679980,525960,249205940,1,0,1,2560,18,6422773396
9111,248690449,1142871,249833320,3,0,0,512,28,1303549872
9112,248694789,331267,249026056,3,0,0,3072,28,5019622133
9113,248703579,502376,249205955,3,0,1,5632,28,5225038957
9114,248735919,470051,249205970,3,0,1,6656,28,6453561049
9115,248741380,874122,249615502,9,0,0,512,9,793277693
9116,248751959,454026,249205985,0,0,1,3584,20,6737857363
9117,248780851,481209,249262060,9,0,1,4608,9,10291564583
9118,248795670,1013816,249809486,9,0,0,1024,9,7003078255
9119,248855709,406693,249262402,3,0,1,7680,28,7334206969
9120,248865830,689438,249555268,8,0,0,7680,3,5118759063
9121,248870341,419751,249290092,9,0,1,16896,9,4527722945
9122,248881801,409059,249290860,4,0,1,11776,10,7461677407
9123,248886881,404543,249291424,9,0,1,10752,9,495760693
9124,248891461,443837,249335298,9,0,1,512,9,940043567
9125,248894350,441788,249336138,0,0,0,2560,20,1966854703
9126,248914300,756486,249670786,9,0,0,2560,9,7394646437
9127,248923581,981562,249905143,1,0,0,158720,18,1347501351
9128,248925010,512574,249437584,4,0,0,3584,10,2384032548
9129,248934710,400603,249335313,2,0,1,2560,29,3791654797
9130,248951730,383598,249335328,8,0,1,24064,3,4761084256
9131,248999970,335313,249335283,7,0,0,20480,2,3504619821
9132,249000719,334624,249335343,3,0,1,14336,28,474367753
9133,249001630,334531,249336161,8,0,1,2560,3,10138887249
9134,249030921,993245,250024166,1,0,0,56320,18,6495848617
9135,249034700,933797,249968497,9,0,0,512,9,2100196539
9136,249059430,772666,249832096,0,0,0,1536,20,6651323812
9137,249076069,272439,249348508,3,0,1,24064,28,143179275
9138,249087930,281728,249369658,1,0,1,16896,18,7439176726
9139,249092350,343419,249435769,2,0,1,1536,29,5452152206
9140,249106580,1095889,250202469,8,0,0,148480,3,549029047
9141,249135009,770149,249905158,0,0,1,233984,20,7042732046
9142,249149130,508822,249657952,2,0,0,3072,29,1279738024
9143,249155980,313040,249469020,8,0,0,4608,3,6018386460
9144,249168520,744960,249913480,1,0,1,5632,18,8368927661
9145,249171989,741538,249913527,3,0,1,9216,28,5558468277
9146,249212100,726648,249938748,2,0,0,2560,29,6040320820
9147,249218580,915735,250134315,7,0,0,133632,2,7142003448
9148,249224540,1436770,250661310,5,0,0,131584,12,2357319754
9149,249234550,678992,249913542,2,0,1,4608,29,4786246746
9150,249242350,823883,250066233,9,0,0,2048,9,1320472826
9151,249249600,1163098,250412698,0,0,0,6144,20,1374034879
9152,249265721,1014742,250280463,1,0,0,100864,18,2980296360
9153,249270020,643537,249913557,2,0,1,3584,29,2647992840
9154,249296510,617062,249913572,1,0,1,9728,18,1634891466
9155,249322120,898975,250221095,8,0,0,49152,3,9816230051
9156,249330570,410270,249740840,5,0,0,23552,12,8021933663
9157,249347170,621156,249968326,5,0,0,89600,12,8325238276
9158,249358970,2876101,252235071,8,0,1,701440,3,8562690311
9159,249362519,2965384,252327903,3,0,1,4096,28,3963342561
9160,249412500,2915418,252327918,2,0,1,6144,29,1826804917
9161,249412970,973703,250386673,0,0,0,91648,20,1466338524
9162,249416981,2950591,252367572,9,0,1,7168,9,5832449888
9163,249425630,712616,250138246,0,0,0,12800,20,7335633842
9164,249430330,1002690,250433020,2,0,0,1536,29,4425158096
9165,249431440,1160854,250592294,8,0,0,93184,3,1347611568
9166,249451049,397531,249848580,5,0,0,16896,12,8253060818
9167,249457499,2951917,252409416,0,0,1,20480,20,10427058189
9168,249463290,1414766,250878056,8,0,0,195072,3,7197051459
9169,249473400,3274272,252747672,8,0,1,60928,3,3333289059
9170,249483659,1323027,250806686,6,0,0,326144,0,1452873692
9171,249490361,744495,250234856,1,0,0,2048,18,10244416628
9172,249494360,3318463,252812823,2,0,1,28160,29,8814398980
9173,249503050,3393168,252896218,2,0,1,15360,29,6759348121
9174,249515299,4221366,253736665,0,0,1,228352,20,8151651535
9175,249527240,968999,250496239,0,0,0,61952,20,7516023853
9176,249532840,4216677,253749517,1,0,1,1024,18,8186003290
9177,249534590,215676,249750266,9,0,0,512,9,3778465821
9178,249552661,4197932,253750593,9,0,1,13312,9,5557916349
9179,249616141,4145600,253761741,9,0,1,8192,9,4783964671
9180,249617329,4148598,253765927,3,0,1,6656,28,9989180384
9181,249634360,1357754,250992114,5,0,0,171520,12,2405261375
9182,249649490,4176430,253825920,2,0,1,2560,29,6591289405
9183,249649671,432613,250082284,1,0,0,5632,18,2785580932
9184,249659129,4334083,253993212,0,0,1,107520,20,6000468477
9185,249689909,4591391,254281300,0,0,1,211456,20,2299650665
9186,249711040,4666812,254377852,8,0,1,29184,3,6386480107
9187,249725890,732574,250458464,0,0,0,39936,20,5591986017
9188,249728359,4699944,254428303,0,0,1,71680,20,3481777337
9189,249760850,445230,250206080,4,0,0,11776,10,4183321647
9190,249794819,4724352,254519171,0,0,1,58880,20,8779609546
9191,249826249,4692937,254519186,3,0,1,4608,28,3028477758
9192,249869231,4680070,254549301,4,0,1,14336,10,7274001484
9193,249877210,1039790,250917000,8,0,0,6144,3,5685334579
9194,249901390,595956,250497346,2,0,0,3584,29,3584670548
9195,249902980,780201,250683181,7,0,0,71680,2,6798643521
9196,249958050,4591266,254549316,2,0,1,2560,29,10536386382
9197,250035671,4513660,254549331,9,0,1,4096,9,1875211274
9198,250036649,1026327,251062976,6,0,0,145920,0,6661317280
9199,250076150,313510,250389660,0,0,0,9728,20,7994708255
9200,250093099,4468742,254561841,0,0,1,19968,20,8513799410
9201,250111510,185237,250296747,9,0,0,4096,9,8607950302
9202,250114710,766013,250880723,8,0,0,8704,3,9014011190
9203,250141290,762084,250903374,0,0,0,74240,20,528235970
9204,250143030,4418997,254562027,8,0,1,15872,3,190365011
9205,250144580,265178,250409758,9,0,0,1536,9,4368077982
9206,250154999,4407043,254562042,3,0,1,6144,28,1003654954
9207,250157689,454233,250611922,3,0,0,512,28,4397017076
9208,250161190,4568966,254730156,8,0,1,173568,3,198626897
9209,250171840,257910,250429750,8,0,0,21504,3,4299631870
9210,250189019,4547563,254736582,0,0,1,29184,20,1069802216
9211,250196789,4709350,254906139,0,0,1,163840,20,8941322540
9212,250208160,610397,250818557,5,0,0,38912,12,1201899623
9213,250210580,1018014,251228594,0,0,0,246272,20,6603910704
9214,250234589,4671565,254906154,3,0,1,20992,28,5368024930
9215,250259241,1380260,251639501,1,0,0,168960,18,3674883994
9216,250266479,4639690,254906169,0,0,1,1536,20,7814483095
9217,250315090,600023,250915113,5,0,0,38400,12,8523692400
9218,250316349,4595507,254911856,0,0,1,36864,20,10735163578
9219,250354900,663601,251018501,8,0,0,86528,3,7276530593
9220,250370301,4542323,254912624,9,0,1,11776,9,9968896542
9221,250379849,4558026,254937875,3,0,1,11776,28,2860276055
9222,250416789,4526366,254943155,3,0,1,7680,28,2050046979
9223,250419250,820147,251239397,4,0,0,35328,10,2659805614
9224,250439951,917111,251357062,1,0,0,59904,18,1962351249
9225,250444849,1272721,251717570,3,0,0,1536,28,5715363999
9226,250536190,4453632,254989822,2,0,1,35840,29,1514194571
9227,250548450,1221729,251770179,8,0,0,2048,3,4528094450
9228,250558429,1124113,251682542,3,0,0,123904,28,4216336783
9229,250564029,502894,251066923,3,0,0,12800,28,8146713396
9230,250566470,971031,251537501,7,0,0,2560,2,392602616
9231,250572160,4426695,254998855,5,0,1,512,12,146782411
9232,250572830,1357163,251929993,2,0,0,1536,29,4417106358
9233,250590060,4451752,255041812,8,0,1,55296,3,3625618282
9234,250594320,942386,251536706,4,0,0,113152,10,4715812851
9235,250598700,1432074,252030774,8,0,0,106496,3,3841426319
9236,250633719,4554284,255188003,0,0,1,89600,20,4079529533
9237,250638780,4622329,255261109,8,0,1,124416,3,9923519986
9238,250662469,4600498,255262967,3,0,1,6144,28,10473623615
9239,250663869,1190483,251854352,6,0,0,36352,0,1804128141
9240,250665789,1662099,252327888,6,0,0,159744,0,5096827979
9241,250694430,772622,251467052,5,0,0,264704,12,9791047751
9242,250697860,847808,251545668,0,0,0,26624,20,1725225975
9243,250735280,528240,251263520,7,0,0,7168,2,6558824299
9244,250758949,792818,251551767,3,0,0,19968,28,540175524
9245,250762350,599432,251361782,7,0,0,5632,2,9617073317
9246,250787990,4480892,255268882,5,0,1,1536,12,4163667640
9247,250810651,691516,251502167,1,0,0,115200,18,204697826
9248,250826940,4572947,255399887,8,0,1,107008,3,4104563622
9249,250830660,752592,251583252,2,0,0,2048,29,7634124132
9250,250891290,1553342,252444632,2,0,0,1024,29,8862837479
9251,250898800,4526107,255424907,8,0,1,90112,3,9788356225
9252,250907460,4521258,255428718,5,0,1,12288,12,1828656767
9253,250927010,1705672,252632682,4,0,0,108544,10,2413959981
9254,250981740,1385817,252367557,5,0,0,130048,12,4853791665
9255,251016731,561157,251577888,1,0,0,4608,18,578312554
9256,251049720,719820,251769540,0,0,0,46592,20,9031663984
9257,251057751,1314080,252371831,1,0,0,13824,18,5222733205
9258,251069750,1078914,252148664,5,0,0,57344,12,6282281670
9259,251089720,4358806,255448526,5,0,1,2048,12,58381086
9260,251114690,4336742,255451432,5,0,1,4608,12,714306822
9261,251136941,1087577,252224518,1,0,0,182784,18,10497449133
9262,251138929,790565,251929494,3,0,0,51200,28,9217145211
9263,251162850,4297295,255460145,5,0,1,512,12,4290601420
9264,251187260,1253101,252440361,4,0,0,73216,10,2940796706
9265,251194780,4273840,255468620,5,0,1,25088,12,696133430
9266,251235260,1566106,252801366,0,0,0,156160,20,2024088357
9267,251258121,537144,251795265,1,0,0,30720,18,7307512853
9268,251265650,1175194,252440844,0,0,0,1536,20,6774489769
9269,251268180,900623,252168803,8,0,0,66048,3,712183088
9270,251271949,620174,251892123,3,0,0,9728,28,1128120589
9271,251277019,4216651,255493670,0,0,1,39936,20,5322365566
9272,251291350,278798,251570148,8,0,0,24576,3,8696192076
9273,251327300,1272295,252599595,5,0,0,186368,12,10628397128
9274,251328580,4170941,255499521,8,0,1,27648,3,597000288
9275,251341369,4528224,255869593,0,0,1,217600,20,4307991177
9276,251359599,4524708,255884307,3,0,1,15872,28,2361465332
9277,251372130,1524073,252896203,8,0,0,69632,3,5624023085
9278,251374930,4589580,255964510,8,0,1,4096,3,10639278595
9279,251388480,4733577,256122057,8,0,1,119808,3,8706370700
9280,251414469,985697,252400166,6,0,0,55808,0,3500924206
9281,251441850,1468702,252910552,2,0,0,1536,29,9401321050
9282,251509570,743015,252252585,7,0,0,36864,2,7170823708
9283,251515149,1637737,253152886,6,0,0,246272,0,5420542037
9284,251583990,1480143,253064133,4,0,0,44032,10,3420146816
9285,251613610,1236512,252850122,7,0,0,122368,2,1988283713
9286,251615810,793591,252409401,0,0,0,24064,20,9750762855
9287,251631139,648062,252279201,3,0,0,85504,28,2633251288
9288,251639510,1050535,252690045,0,0,0,43520,20,9329409891
9289,251646900,1613374,253260274,4,0,0,2048,10,4769861792
9290,251647051,1100606,252747657,1,0,0,113664,18,8523013398
9291,251668960,4521065,256190025,8,0,1,22528,3,210031051
9292,251709410,1701530,253410940,5,0,0,77312,12,2259049367
9293,251716600,508113,252224713,2,0,0,512,29,4647342576
9294,251746140,1150273,252896413,2,0,0,512,29,2102410892
9295,251761970,4428070,256190040,8,0,1,11264,3,10599799683
9296,251784440,1453083,253237523,8,0,0,46080,3,194032507
9297,251794619,851057,252645676,6,0,0,41984,0,119495135
9298,251806450,856557,252663007,4,0,0,56832,10,10637844833
9299,251812151,1575218,253387369,1,0,0,78848,18,766935567
9300,251823769,4412671,256236440,3,0,1,1536,28,7829585427
9301,251826060,927711,252753771,8,0,0,19968,3,3099412801
9302,251829891,405165,252235056,1,0,0,33792,18,3247242650
9303,251832741,1903738,253736479,1,0,0,100864,18,7127629199
9304,251833830,1095445,252929275,7,0,0,3072,2,385530676
9305,251852580,780273,252632853,2,0,0,512,29,831734767
9306,251888650,1724196,253612846,7,0,0,82432,2,5983227888
9307,251888940,4347515,256236455,1,0,1,2048,18,630156645
9308,251914540,4333060,256247600,8,0,1,26112,3,6254017840
9309,251920280,4327335,256247615,1,0,1,2560,18,7233898802
9310,251951781,4297424,256249205,4,0,1,4608,10,2345843105
9311,251957359,4465953,256423312,0,0,1,51200,20,9889073849
9312,251969549,843259,252812808,6,0,0,36864,0,7133174783
9313,251985459,4522722,256508181,0,0,1,102912,20,7057132927
9314,252028670,846115,252874785,4,0,0,80896,10,7291032529
9315,252078070,4431077,256509147,1,0,1,17920,18,7283339995
9316,252084780,361232,252446012,2,0,0,512,29,3181961470
9317,252122270,4386892,256509162,8,0,1,13824,3,5846458448
9318,252124860,676677,252801537,2,0,0,512,29,4551837175
9319,252127570,1891100,254018670,7,0,0,12800,2,7562902982
9320,252130989,840461,252971450,3,0,0,101376,28,5576740289
9321,252142390,390803,252533193,5,0,0,17920,12,5871722460
9322,252151070,1086648,253237718,2,0,0,512,29,2177604649
9323,252162450,851135,253013585,8,0,0,138240,3,8903407783
9324,252162470,4380724,256543194,8,0,1,110592,3,5580367857
9325,252177081,515163,252692244,1,0,0,7168,18,2953459775
9326,252188310,4380915,256569225,8,0,1,60928,3,3195886277
9327,252191100,4405414,256596514,1,0,1,38400,18,10159381284
9328,252192991,4407709,256600700,4,0,1,6656,10,4278504423
9329,252213920,449274,252663194,2,0,0,512,29,2884631223
9330,252249010,1873279,254122289,7,0,0,79360,2,7662506491
9331,252253711,4349447,256603158,4,0,1,512,10,3553500498
9332,252300079,4509721,256809800,0,0,1,355840,20,5111521772
9333,252313060,4498687,256811747,1,0,1,25600,18,639835942
9334,252352970,4463978,256816948,1,0,1,5120,18,7359698950
9335,252358959,1164632,253523591,6,0,0,116736,0,10654290004
9336,252362730,4468895,256831625,1,0,1,2048,18,8938880929
9337,252367089,4495933,256863022,0,0,1,48640,20,9544168546
9338,252369270,4496658,256865928,1,0,1,4608,18,3274628839
9339,252382450,492514,252874964,2,0,0,512,29,8460078567
9340,252386800,1226217,253613017,2,0,0,512,29,6543270448
9341,252387639,4478648,256866287,0,0,1,9728,20,8709070535
9342,252417389,4483588,256900977,0,0,1,55808,20,2160986537
9343,252447129,1453582,253900711,3,0,0,31232,28,6776204965
9344,252460679,762789,253223468,3,0,0,216576,28,1093892146
9345,252461969,4601737,257063706,0,0,1,140288,20,5203452997
9346,252529519,4748529,257278048,0,0,1,265728,20,6776398079
9347,252540060,806066,253346126,4,0,0,86016,10,6016337858
9348,252594419,936675,253531094,3,0,0,24576,28,63097022
9349,252596300,1658278,254254578,0,0,0,141312,20,6205162963
9350,252654720,1171185,253825905,7,0,0,166400,2,6819126395
9351,252669410,4608661,257278071,1,0,1,2560,18,405782537
9352,252713720,873995,253587715,0,0,0,180736,20,8541875424
9353,252737700,950091,253687791,4,0,0,39424,10,2255190472
9354,252820099,4480531,257300630,0,0,1,77824,20,4265831302
9355,252856950,394436,253251386,2,0,0,4608,29,2456004689
9356,252857539,4483042,257340581,0,0,1,26624,20,2537820354
9357,252937499,4728531,257666030,0,0,1,291328,20,1917055051
9358,252939870,1229421,254169291,0,0,0,119296,20,10104677561
9359,253006139,1512993,254519132,6,0,0,151552,0,2838559710
9360,253006700,340221,253346921,2,0,0,2560,29,7578207567
9361,253029939,4675524,257705463,0,0,1,69632,20,5970044529
9362,253051889,1325948,254377837,6,0,0,123392,0,7031771577
9363,253069189,4720089,257789278,0,0,1,91648,20,2126219567
9364,253092770,682196,253774966,4,0,0,5632,10,7037805501
9365,253100439,4726674,257827113,0,0,1,124416,20,1541987690
9366,253127560,609090,253736650,4,0,0,512,10,2819397863
9367,253144819,500817,253645636,3,0,0,57856,28,1264504888
9368,253196089,797108,253993197,6,0,0,222208,0,1634215058
9369,253215949,798806,254014755,3,0,0,70656,28,10178560838
9370,253222310,526555,253748865,0,0,0,29696,20,5863893533
9371,253284330,736095,254020425,0,0,0,5632,20,8237894327
9372,253358660,4478835,257837495,6,0,1,5120,0,3900412811
9373,253361799,1427786,254789585,6,0,0,138240,0,381383484
9374,253438110,4612671,258050781,6,0,1,299520,0,1269824936
9375,253456000,4629666,258085666,6,0,1,67072,0,408546376
9376,253463760,4646811,258110571,2,0,1,50688,29,8491128171
9377,253483619,435266,253918885,3,0,0,12800,28,2256410339
9378,253520359,577735,254098094,3,0,0,75776,28,1446876324
9379,253606740,1016531,254623271,7,0,0,95744,2,9449074595
9380,253618810,4510036,258128846,6,0,1,29184,0,9428535330
9381,253625710,4536445,258162155,6,0,1,87552,0,7837116035
9382,253626740,654545,254281285,5,0,0,87552,12,2458368425
9383,253667300,4501033,258168333,2,0,1,15872,29,4061210395
9384,253694301,1166135,254860436,1,0,0,16896,18,3905171599
9385,253768030,4407723,258175753,6,0,1,8192,0,6986205905
9386,253779029,770257,254549286,6,0,0,68096,0,4633447499
9387,253795049,893287,254688336,6,0,0,25088,0,641310527
9388,253796250,594409,254390659,7,0,0,41984,2,4776942691
9389,253816280,316640,254132920,7,0,0,34816,2,503844933
9390,253837420,1350560,255187980,4,0,0,406016,10,4806722478
9391,253865730,4310177,258175907,6,0,1,8704,0,2797052200
9392,253911500,4496634,258408134,6,0,1,205824,0,3723076820
9393,253940710,633028,254573738,0,0,0,37888,20,3101228532
9394,253942089,691836,254633925,5,0,0,3584,12,611213338
9395,253990310,4424955,258415265,2,0,1,15872,29,8318705474
9396,254010180,4407351,258417531,2,0,1,3584,29,9981174705
9397,254041699,520127,254561826,5,0,0,40960,12,8320691393
9398,254057409,235639,254293048,6,0,0,1024,0,3007922769
9399,254099020,4321914,258420934,2,0,1,3584,29,7187074559
9400,254160020,4263820,258423840,2,0,1,4608,29,4162519220
9401,254170829,272692,254443521,3,0,0,5120,28,3377709252
9402,254177150,1049854,255227004,4,0,0,80896,10,7070418618
9403,254220421,412389,254632810,1,0,0,31232,18,1240395117
9404,254229120,812661,255041781,0,0,0,101888,20,1556808406
9405,254255340,1075674,255331014,5,0,0,78336,12,8685334326
9406,254272049,289963,254562012,6,0,0,512,0,9790985068
9407,254384290,521834,254906124,7,0,0,44544,2,9919901819
9408,254436881,3987945,258424826,4,0,1,1536,10,5595392820
9409,254485370,369903,254855273,0,0,0,72192,20,3318593216
9410,254498160,1036097,255534257,0,0,0,40448,20,4240051615
9411,254503490,4412669,258916159,1,0,1,201216,18,620426889
9412,254525469,485253,255010722,5,0,0,30208,12,3997942632
9413,254570819,493438,255064257,5,0,0,60416,12,4632500501
9414,254597570,4340303,258937873,1,0,1,5632,18,7812670752
9415,254753459,474496,255227955,6,0,0,3072,0,2733472721
9416,254777450,4160438,258937888,2,0,1,13824,29,2351856956
9417,254778490,659017,255437507,2,0,0,1024,29,8094111938
9418,254794970,466100,255261070,4,0,0,77824,10,3112282052
9419,254797370,592003,255389373,4,0,0,191488,10,1250834459
9420,254812859,867756,255680615,5,0,0,126464,12,9806408523
9421,254944510,3993393,258937903,2,0,1,1024,29,831440174
9422,254966969,617118,255584087,5,0,0,61440,12,3360969128
9423,254992260,482609,255474869,2,0,0,1536,29,1768040647
9424,255011380,388492,255399872,0,0,0,34304,20,980169848
9425,255029319,158903,255188222,6,0,0,512,0,10023088343
9426,255042460,568741,255611201,4,0,0,38400,10,1613109463
9427,255075110,3862808,258937918,2,0,1,10752,29,8720063220
9428,255110580,3827353,258937933,7,0,1,512,2,4630709192
9429,255112039,806813,255918852,3,0,0,20992,28,124741279
9430,255136599,712155,255848754,3,0,0,180224,28,4607870161
9431,255137520,264753,255402273,2,0,0,1536,29,10225079884
9432,255140909,1282388,256423297,3,0,0,523776,28,5671143470
9433,255143800,3803874,258947674,1,0,1,66048,18,4139510323
9434,255190950,3778453,258969403,7,0,1,4608,2,7533292951
9435,255221989,566470,255788459,5,0,0,64512,12,433440873
9436,255238610,163172,255401782,0,0,0,6144,20,2824070285
9437,255240529,996269,256236798,6,0,0,1024,0,2288000845
9438,255251620,3717806,258969426,1,0,1,46080,18,5804777670
9439,255271420,369751,255641171,4,0,0,1536,10,2733280102
9440,255288079,563186,255851265,6,0,0,8192,0,2504480512
9441,255319080,392438,255711518,2,0,0,512,29,5087893322
9442,255325909,258817,255584726,6,0,0,2048,0,8230504557
9443,255336520,724964,256061484,0,0,0,7680,20,3849023942
9444,255337520,3631953,258969473,1,0,1,43520,18,2771805019
9445,255354050,856449,256210499,4,0,0,67072,10,2331672156
9446,255394880,3595613,258990493,7,0,1,7168,2,4563800765
9447,255396999,839426,256236425,6,0,0,2560,0,4682472556
9448,255411530,3613219,259024749,2,0,1,28672,29,2478465288
9449,255442150,3583905,259026055,2,0,1,2048,29,4157320080
9450,255549319,686311,256235630,5,0,0,82432,12,6019927512
9451,255556360,614119,256170479,4,0,0,154624,10,2676867607
9452,255570159,853356,256423515,6,0,0,512,0,1684872899
9453,255615291,574703,256189994,1,0,0,64000,18,3573332033
9454,255615620,644841,256260461,2,0,0,2048,29,5602070383
9455,255625111,3401405,259026516,4,0,1,10240,10,7970062331
9456,255628100,487130,256115230,2,0,0,3072,29,8929640487
9457,255635600,788741,256424341,2,0,0,1536,29,5799180470
9458,255639370,391780,256031150,2,0,0,2048,29,5893649884
9459,255648989,600201,256249190,6,0,0,5120,0,5642081203
9460,255763389,660461,256423850,6,0,0,1024,0,6309473604
9461,255789530,3244389,259033919,7,0,1,6656,2,7584425009
9462,255802100,704000,256506100,0,0,0,268288,20,2507524060
9463,255817379,430198,256247577,3,0,0,35328,28,4548008921
9464,255881690,3153855,259035545,7,0,1,2560,2,295597467
9465,255887591,628762,256516353,1,0,0,23552,18,2071704886
9466,255895380,647799,256543179,0,0,0,27136,20,1121264563
9467,255897249,750666,256647915,5,0,0,115712,12,1230540771
9468,255956201,3095166,259051367,4,0,1,22528,10,7591356404
9469,255978859,529307,256508166,3,0,0,6144,28,6119478133
9470,256000751,3051589,259052340,4,0,1,12800,10,3746524616
9471,256003870,505262,256509132,2,0,0,3072,29,1239094014
9472,256077950,2977936,259055886,2,0,1,5632,29,5328692861
9473,256083150,2977562,259060712,7,0,1,7680,2,4188950896
9474,256090470,456488,256546958,2,0,0,512,29,2578516155
9475,256094710,421970,256516680,2,0,0,1024,29,10082260278
9476,256130511,2935335,259065846,4,0,1,21504,10,6174083506
9477,256131991,2934201,259066192,4,0,1,512,10,3219850233
9478,256138510,367769,256506279,2,0,0,512,29,3339577856
9479,256204850,346468,256551318,2,0,0,1536,29,9491513877
9480,256309290,300520,256609810,2,0,0,1536,29,9509490155
9481,256310040,281567,256591607,2,0,0,1024,29,936491392
9482,256311759,589032,256900791,3,0,0,108032,28,5023102633
9483,256322609,405032,256727641,5,0,0,15872,12,3212276459
9484,256336799,427844,256764643,5,0,0,27648,12,6537302935
9485,256383360,329147,256712507,2,0,0,2048,29,646343501
9486,256409820,247654,256657474,2,0,0,4096,29,792806726
9487,256510380,284158,256794538,2,0,0,512,29,2116185628
9488,256577671,414578,256992249,1,0,0,114688,18,1369492916
9489,256581050,165971,256747021,2,0,0,4096,29,4812810004
9490,256598440,302522,256900962,2,0,0,512,29,10599183644
9491,256598500,417972,257016472,2,0,0,512,29,5810392172
9492,256671001,332928,257003929,1,0,0,12800,18,8216728880
9493,256720110,2346748,259066858,5,0,1,11264,12,9139135919
9494,256760901,509449,257270350,1,0,0,263680,18,926658375
9495,256809151,468858,257278009,1,0,0,25088,18,2345334595
9496,256835509,459760,257295269,6,0,0,9728,0,7016897368
9497,256965140,464886,257430026,0,0,0,130560,20,10312369236
9498,256967939,697256,257665195,5,0,0,98304,12,8012858025
9499,257014981,296455,257311436,1,0,0,4608,18,5995297103
9500,257075279,465550,257540829,3,0,0,103936,28,5183780808
9501,257117449,271717,257389166,5,0,0,31744,12,9013443123
9502,257153759,185897,257339656,6,0,0,1536,0,6803355386
9503,257175880,333258,257509138,0,0,0,64000,20,4123142592
9504,257201401,849333,258050734,1,0,0,97280,18,5072824912
9505,257225180,1864864,259090044,5,0,1,37376,12,194554833
9506,257230301,506177,257736478,1,0,0,98304,18,7028535229
9507,257249399,607944,257857343,6,0,0,512,0,3791748943
9508,257320869,468394,257789263,3,0,0,77824,28,3187544814
9509,257344069,579807,257923876,3,0,0,9728,28,9964900626
9510,257412030,214413,257626443,2,0,0,1024,29,10068477082
9511,257505490,365339,257870829,2,0,0,3584,29,4665928417
9512,257511890,426026,257937916,2,0,0,1536,29,5213973947
9513,257515540,396997,257912537,2,0,0,4096,29,687306316
9514,257549679,241565,257791244,6,0,0,2560,0,5626420908
9515,257565769,412757,257978526,3,0,0,56320,28,1447230095
9516,257610020,187056,257797076,0,0,0,1536,20,3863091896
9517,257666390,332392,257998782,0,0,0,22016,20,1987957482
9518,257699019,231679,257930698,5,0,0,10752,12,3187371045
9519,257743250,1478886,259222136,6,0,1,138240,0,1048367734
9520,257815689,554543,258370232,6,0,0,512,0,1585226339
9521,257871550,221059,258092609,2,0,0,512,29,302590721
9522,257872851,252494,258125345,1,0,0,9728,18,8320719864
9523,257877390,1559091,259436481,6,0,1,156672,0,5457624392
9524,257907341,304587,258211928,1,0,0,58880,18,3462774679
9525,257908149,587834,258495983,3,0,0,512,28,9636913770
9526,257914889,767621,258682510,3,0,0,168960,28,6278974841
9527,257915520,1533427,259448947,6,0,1,8192,0,6398619285
9528,257939589,142241,258081830,6,0,0,512,0,7685449301
9529,257968601,395156,258363757,1,0,0,43520,18,2636772539
9530,257987300,1466473,259453773,6,0,1,7680,0,6729733330
9531,258007419,895583,258903002,3,0,0,270336,28,1428291402
9532,258021680,1433719,259455399,6,0,1,2560,0,1097808441
9533,258022160,1434865,259457025,6,0,1,2560,0,3908992603
9534,258022390,1437221,259459611,6,0,1,4096,0,2919845986
9535,258041311,755893,258797204,1,0,0,110080,18,9162821732
9536,258060980,454421,258515401,2,0,0,4608,29,10374066104
9537,258074579,538042,258612621,5,0,0,17920,12,7497160130
9538,258091661,515485,258607146,1,0,0,123392,18,949363705
9539,258111319,856806,258968125,5,0,0,67072,12,9372940651
9540,258129599,355496,258485095,6,0,0,2048,0,5911882704
9541,258145730,770406,258916136,2,0,0,1024,29,8489246630
9542,258175730,644889,258820619,0,0,0,76800,20,8745183854
9543,258179879,766337,258946216,5,0,0,27136,12,5195090479
9544,258267469,911883,259179352,5,0,0,85504,12,952195178
9545,258272090,643719,258915809,0,0,0,41984,20,5011676402
9546,258274781,663077,258937858,1,0,0,71168,18,2412520988
9547,258403049,801278,259204327,5,0,0,81920,12,3279442573
9548,258439759,529629,258969388,6,0,0,4096,0,8892401370
9549,258526059,444053,258970112,5,0,0,2048,12,1166282244
9550,258536991,781147,259318138,1,0,0,161792,18,330316898
9551,258611559,361271,258972830,6,0,0,1536,0,10166801410
9552,258683270,736755,259420025,0,0,0,139264,20,3923461515
9553,258743600,204059,258947659,2,0,0,4608,29,2630061294
9554,258806919,976749,259783668,3,0,0,88064,28,9421649723
9555,258854979,771063,259626042,5,0,0,121344,12,2918075451
9556,258859549,605208,259464757,3,0,1,8192,28,3822526536
9557,258877820,676180,259554000,0,0,0,128000,20,1069133872
9558,258919219,555677,259474896,3,0,0,29696,28,405144459
9559,258938079,498371,259436450,5,0,0,51712,12,9828566311
9560,258942969,522761,259465730,3,0,1,12800,28,1283958342
9561,258959929,889915,259849844,3,0,0,131072,28,5134439923
9562,258980220,440459,259420679,2,0,0,1536,29,6035512815
9563,259041149,163513,259204662,6,0,0,1024,0,9293631779
9564,259043800,584129,259627929,2,0,0,6144,29,3550520785
9565,259056629,295766,259352395,6,0,0,2048,0,10726488369
9566,259076659,586868,259663527,6,0,0,512,0,1310370766
9567,259119710,300486,259420196,2,0,0,512,29,2476463964
9568,259128070,425945,259554015,1,0,1,65536,18,10511875848
9569,259133359,911723,260045082,3,0,0,135168,28,4677229742
9570,259183951,775789,259959740,1,0,0,29184,18,6188266455
9571,259210129,343901,259554030,3,0,1,14848,28,1374796081
9572,259232939,321122,259554061,3,0,1,2560,28,3499868417
9573,259248790,645251,259894041,1,0,1,167936,18,7755746422
9574,259298759,511134,259809893,5,0,0,19456,12,8696503859
9575,259331099,811374,260142473,3,0,0,73216,28,3965418493
9576,259332159,617715,259949874,5,0,0,162816,12,9827185060
9577,259336300,783850,260120150,0,0,0,124928,20,2924878271
9578,259367170,210889,259578059,2,0,0,1536,29,2954002850
9579,259405560,554195,259959755,1,0,1,98816,18,4869585989
9580,259424059,658012,260082071,5,0,0,93184,12,2188586758
9581,259439240,606013,260045253,2,0,0,512,29,4635764059
9582,259483900,668001,260151901,1,0,1,214016,18,8967217229
9583,259499599,451226,259950825,3,0,0,3072,28,3233945681
9584,259535529,616022,260151551,6,0,0,512,0,6421482823
9585,259622469,636429,260258898,5,0,0,23040,12,3347430512
9586,259635790,515590,260151380,0,0,0,29184,20,1999700555
9587,259636859,530106,260166965,3,0,1,15872,28,7568508537
9588,259650880,1065561,260716441,1,0,1,514048,18,1176190065
9589,259657019,674748,260331767,5,0,0,194560,12,670158958
9590,259659489,720989,260380478,5,0,0,59904,12,1658354790
9591,259696451,646656,260343107,1,0,0,20480,18,1470133762
9592,259727869,703677,260431546,3,0,0,117760,28,2740201136
9593,259738219,529207,260267426,6,0,0,1024,0,7522103633
9594,259786270,365608,260151878,2,0,0,1024,29,9127371576
9595,259801229,351319,260152548,6,0,0,2048,0,10521668833
9596,259852859,863597,260716456,3,0,1,9728,28,5485290837
9597,259934969,337195,260272164,6,0,0,2048,0,443621876
9598,259992210,226925,260219135,2,0,0,1024,29,3706745646
9599,260112899,453775,260566674,3,0,0,51200,28,3954415361
9600,260135399,87303,260222702,3,0,0,512,28,9256468508
9601,260165839,525738,260691577,5,0,0,70656,12,2760322205
9602,260166570,800701,260967271,1,0,1,309248,18,8610843393
9603,260173421,581590,260755011,1,0,0,126464,18,6038499142
9604,260209230,775872,260985102,1,0,1,12800,18,6252086805
9605,260219469,262288,260481757,5,0,0,10752,12,2973654127
9606,260253710,458801,260712511,2,0,0,2560,29,1333444807
9607,260259879,571030,260830909,5,0,0,205312,12,3041793530
9608,260278490,764808,261043298,1,0,1,49664,18,4617686054
9609,260285490,426226,260711716,0,0,0,66048,20,10047882414
9610,260299311,547549,260846860,1,0,0,52224,18,9185032302
9611,260313400,606479,260919879,0,0,0,44032,20,3792088844
9612,260380580,516651,260897231,2,0,0,2560,29,849974872
9613,260409360,565013,260974373,2,0,0,2560,29,8098979402
9614,260419491,296935,260716426,1,0,0,12800,18,3263268772
9615,260434779,150920,260585699,3,0,0,512,28,9362552993
9616,260459230,442953,260902183,2,0,0,1024,29,3341706629
9617,260490860,370794,260861654,0,0,0,42496,20,2795618887
9618,260549949,493503,261043452,3,0,1,8704,28,3680481591
9619,260560640,328287,260888927,2,0,0,512,29,8700391745
9620,260565890,356843,260922733,2,0,0,3072,29,4167160741
9621,260587970,455828,261043798,1,0,1,512,18,8454364631
9622,260639870,548328,261188198,0,0,0,198144,20,9964172399
9623,260665769,181582,260847351,3,0,0,1536,28,3940980003
9624,260712291,286097,260998388,1,0,0,2048,18,9067125669
9625,260714900,388721,261103621,2,0,0,1536,29,1135673277
9626,260769220,661766,261430986,0,0,0,100864,20,250486880
9627,260789689,257015,261046704,3,0,1,4608,28,9662935734
9628,260821600,449628,261271228,0,0,0,70144,20,6298187572
9629,260845319,211118,261056437,0,0,1,25088,20,9641698719
9630,260847789,253208,261100997,0,0,1,53760,20,4154354761
9631,260851619,424781,261276400,0,0,1,268288,20,9217301887
9632,260890031,717905,261607936,1,0,0,173056,18,8574811107
9633,260915630,433662,261349292,0,0,0,39424,20,8194547723
9634,260931221,739224,261670445,1,0,0,15360,18,10341479681
9635,260951950,514822,261466772,0,0,0,102912,20,7685996691
9636,261019860,707076,261726936,0,0,0,35840,20,6125420370
9637,261031529,456267,261487796,3,0,0,2048,28,4864602678
9638,261106779,165252,261272031,5,0,0,2560,12,7008085245
9639,261173071,312823,261485894,1,0,0,34816,18,1304728372
9640,261178000,99112,261277112,5,0,1,512,12,5513359639
9641,261214231,255840,261470071,1,0,0,10752,18,4875871132
9642,261215259,215898,261431157,3,0,0,512,28,4003950627
9643,261250101,237056,261487157,1,0,0,4096,18,3177631940
9644,261264009,236443,261500452,3,0,0,2048,28,3656222311
9645,261268559,12419,261280978,3,0,1,6144,28,4327339367
9646,261289009,251957,261540966,3,0,0,512,28,5140196653
9647,261299679,131493,261431172,0,0,1,146944,20,8989288456
9648,261301950,431397,261733347,5,0,0,20992,12,5936514237
9649,261343850,479872,261823722,0,0,0,65024,20,6175806354
9650,261458349,367268,261825617,3,0,0,6144,28,10590350088
9651,261470490,659468,262129958,5,0,0,121344,12,2731976314
9652,261511011,525334,262036345,1,0,0,13824,18,1882383067
9653,261515859,92100,261607959,0,0,1,120832,20,8979485162
9654,261536791,495319,262032110,1,0,0,236544,18,5894723496
9655,261571169,48575,261619744,3,0,1,19456,28,8326157128
9656,261587909,42068,261629977,0,0,1,31232,20,5114719051
9657,261634290,435017,262069307,0,0,0,99328,20,5142875519
9658,261715480,491997,262207477,2,0,0,1024,29,7438382073
9659,261729741,477379,262207120,1,0,0,125440,18,7343362509
9660,261762000,400889,262162889,0,0,0,108032,20,5524299446
9661,261778089,498015,262276104,3,0,0,512,28,5841381650
9662,261810789,22493,261833282,3,0,1,8192,28,240930221
9663,261890570,148458,262039028,0,0,0,8704,20,332139721
9664,261957150,366399,262323549,0,0,0,23552,20,6428166179
9665,261957470,420961,262378431,0,0,0,26112,20,284442403
9666,261963299,107009,262070308,0,0,1,1024,20,4122851806
9667,261976009,95285,262071294,3,0,1,1536,28,8182926939
9668,261990331,510730,262501061,1,0,0,4608,18,8044562262
9669,262034171,605335,262639506,1,0,0,139264,18,620041863
9670,262050950,430885,262481835,0,0,0,87040,20,8297750117
9671,262085740,4850,262090590,2,0,1,5120,29,10643562650
9672,262111009,398662,262509671,5,0,0,3072,12,483851344
9673,262129369,35598,262164967,0,0,1,2048,20,1712430899
9674,262134491,447675,262582166,1,0,0,2560,18,9342300236
9675,262139689,67446,262207135,0,0,1,32768,20,1103418052
9676,262151609,55541,262207150,3,0,1,14336,28,3100116603
9677,262192991,306651,262499642,1,0,0,58368,18,1354194269
9678,262204429,304291,262508720,5,0,0,25088,12,10625598720
9679,262216729,423134,262639863,3,0,0,1024,28,1486266247
9680,262229860,4679,262234539,5,0,1,12288,12,699315673
9681,262242769,566,262243335,3,0,1,512,28,2486214726
9682,262256210,391624,262647834,0,0,0,26112,20,6102366447
9683,262263850,3898,262267748,2,0,1,4096,29,1704240669
9684,262269049,148088,262417137,3,0,0,2560,28,2940968498
9685,262287981,440576,262728557,1,0,0,60416,18,1260745722
9686,262295660,266820,262562480,2,0,0,2048,29,5082126354
9687,262310780,20624,262331404,2,0,1,33280,29,9343915342
9688,262323101,258270,262581371,1,0,0,26624,18,2575386834
9689,262364749,36863,262401612,0,0,1,65024,20,2459236046
9690,262403319,16096,262419415,3,0,1,31232,28,7903901554
9691,262450150,421370,262871520,0,0,0,98304,20,6658477742
9692,262453701,456381,262910082,1,0,0,126464,18,10597083725
9693,262466871,446502,262913373,1,0,0,10752,18,8926449916
9694,262505240,15197,262520437,2,0,1,17408,29,8284529453
9695,262509499,17534,262527033,0,0,1,19968,20,3154117639
9696,262520311,571119,263091430,1,0,0,29184,18,7676959199
9697,262564779,242978,262807757,3,0,0,512,28,7845228106
9698,262583910,5326,262589236,5,0,1,5632,12,8610255549
9699,262583980,55541,262639521,2,0,1,18944,29,8725454624
9700,262589389,50147,262639536,3,0,1,512,28,10719442621
9701,262631659,331259,262962918,5,0,0,59392,12,6294450379
9702,262667549,61039,262728588,0,0,1,95744,20,1075513755
9703,262674000,55120,262729120,2,0,1,26112,29,9984864257
9704,262681879,47587,262729466,3,0,1,512,28,6913270944
9705,262691679,48105,262739784,0,0,1,32768,20,4683638786
9706,262710460,212443,262922903,2,0,0,1536,29,2013013355
9707,262710809,254152,262964961,5,0,0,6656,12,6749636337
9708,262726369,19624,262745993,0,0,1,21504,20,5277285931
9709,262751439,291115,263042554,3,0,0,2048,28,3243174604
9710,262778150,6754,262784904,5,0,1,7168,12,8281971490
9711,262799409,72126,262871535,0,0,1,77824,20,359768906
9712,262801969,248393,263050362,3,0,0,1024,28,6218557556
9713,262888390,385014,263273404,0,0,0,72192,20,2795100478
9714,262892960,24334,262917294,2,0,1,10752,29,3612420247
9715,262962270,26666,262988936,5,0,1,39936,12,8210641798
9716,262967160,22749,262989909,5,0,1,12800,12,378713188
9717,263049369,61641,263111010,0,0,1,99840,20,6509926451
9718,263116920,289741,263406661,2,0,0,2048,29,3583671505
9719,263123139,152766,263275905,0,0,1,247296,20,5008906355
9720,263128619,346912,263475531,5,0,0,69120,12,10298114098
9721,263154059,490033,263644092,5,0,0,54784,12,336481946
9722,263205879,275619,263481498,5,0,0,19456,12,1371583880
9723,263258470,269239,263527709,2,0,0,1536,29,9942140541
9724,263292520,202803,263495323,2,0,0,1536,29,7996672159
9725,263296760,380183,263676943,0,0,0,46080,20,10117082932
9726,263403859,254014,263657873,5,0,0,33280,12,3875606380
9727,263411791,348642,263760433,1,0,0,12288,18,360629874
9728,263459750,203130,263662880,0,0,0,16384,20,1133356509
9729,263460960,157416,263618376,0,0,0,41472,20,5752246036
9730,263462840,23943,263486783,5,0,1,5632,12,1530343051
9731,263541091,287343,263828434,1,0,0,101888,18,1413803146
9732,263559260,7230,263566490,5,0,1,7680,12,6896267231
9733,263562639,374953,263937592,5,0,0,116224,12,5344491148
9734,263596510,245230,263841740,0,0,0,4608,20,93184109
9735,263605270,345441,263950711,0,0,0,43008,20,3363067826
9736,263658221,198251,263856472,1,0,0,46592,18,7673350322
9737,263666770,190185,263856955,0,0,0,1536,20,9358634701
9738,263703580,183688,263887268,0,0,0,17920,20,5637090148
9739,263718830,232988,263951818,2,0,0,3584,29,1341330424
9740,263762339,335222,264097561,5,0,0,83456,12,996004617
9741,263789290,4420,263793710,5,0,1,11776,12,2368973928
9742,263838470,362252,264200722,0,0,0,129536,20,670609583
9743,263853960,4505,263858465,5,0,1,1536,12,4113089723
9744,263957360,4850,263962210,5,0,1,5120,12,6206099371
9745,263966820,167011,264133831,0,0,0,14848,20,10083869302
9746,264016509,416414,264432923,5,0,0,333312,12,7262143815
9747,264037280,123959,264161239,0,0,0,29184,20,1246293650
9748,264232199,208235,264440434,5,0,0,24576,12,8365784936
9749,264247670,1042,264248712,5,0,1,1024,12,1539968124
9750,264249160,76587,264325747,5,0,1,129024,12,5992111339
9751,264283609,264173,264547782,5,0,0,51200,12,10284694258
9752,264283990,248177,264532167,0,0,0,78336,20,3563701315
9753,264396139,178538,264574677,5,0,0,30208,12,8968321957
9754,264483100,79199,264562299,2,0,0,3584,29,1177412080
9755,264568080,107938,264676018,0,0,0,32768,20,5368440633
9756,264570720,119100,264689820,5,0,1,187392,12,2187660022
9757,264574670,55748,264630418,2,0,0,4096,29,9215794199
9758,264622390,78772,264701162,5,0,1,37888,12,1715498334
9759,264627050,90177,264717227,5,0,1,52224,12,1106701803
9760,264666060,260932,264926992,2,0,0,1536,29,4384041081
9761,264740630,75812,264816442,5,0,1,127488,12,7183897051
9762,264791620,232045,265023665,0,0,0,58368,20,6551869394
9763,264857461,252670,265110131,1,0,0,114176,18,6084702141
9764,264880320,163598,265043918,2,0,0,512,29,7514722935
9765,264924100,251372,265175472,2,0,0,2560,29,6160977852
9766,264949490,116312,265065802,5,0,1,193024,12,10244252591
9767,264995190,114956,265110146,5,0,1,55808,12,3761850459
9768,265016921,143748,265160669,1,0,0,41984,18,8734974015
9769,265067390,42771,265110161,5,0,1,30720,12,3345829769
9770,265100099,422645,265522744,5,0,0,211968,12,1767563894
9771,265165400,177820,265343220,2,0,0,1024,29,5288202846
9772,265172850,275210,265448060,5,0,0,44544,12,570697913
9773,265209540,138444,265347984,2,0,0,1536,29,5163839588
9774,265220430,56337,265276767,5,0,1,96256,12,1529587394
9775,265264980,257951,265522931,2,0,0,512,29,6120377812
9776,265293509,396798,265690307,5,0,0,137216,12,3810034636
9777,265421100,186315,265607415,2,0,0,3072,29,8596763379
9778,265447290,75656,265522946,5,0,1,107008,12,3814080794
9779,265465710,60582,265526292,5,0,1,9728,12,9644642958
9780,265487271,152610,265639881,1,0,0,7680,18,8134001397
9781,265591560,162904,265754464,5,0,0,45568,12,1888475100
9782,265618860,111681,265730541,2,0,0,512,29,4645983056
9783,265696330,82064,265778394,0,0,0,14848,20,6380381894
9784,265742090,86199,265828289,5,0,1,120320,12,3832787838
9785,265844860,15837,265860697,5,0,1,30720,12,1780937021
9786,265885470,152615,266038085,0,0,0,19968,20,721604251
9787,265906240,137270,266043510,2,0,0,1536,29,1429319372
9788,266011450,127088,266138538,5,0,0,117248,12,393828138
9789,266038530,290768,266329298,5,0,0,78336,12,6666647043
9790,266053600,12308,266065908,5,0,1,20480,12,10412736468
9791,266138670,165474,266304144,5,0,0,133120,12,9906024386
9792,266203910,101505,266305415,2,0,0,4096,29,10280787614
9793,266272320,131916,266404236,5,0,0,28672,12,6904933902
9794,266301950,105109,266407059,0,0,0,9216,20,8200876224
9795,266335840,5802,266341642,5,0,1,6144,12,4971317313
9796,266417790,52364,266470154,2,0,0,3072,29,6558762286
9797,266418910,4850,266423760,5,0,1,5120,12,2173180355
9798,266444330,4374,266448704,5,0,1,4608,12,3179221806
9799,266445900,45282,266491182,5,0,0,512,12,1465656763
9800,266526740,45596,266572336,2,0,0,1024,29,3591907257
9801,266617680,10499,266628179,5,0,1,16896,12,988366654
9802,266888050,153541,267041591,5,0,1,248832,12,331218751
9803,266897600,250904,267148504,0,0,0,16384,20,5611748261
9804,267098749,246381,267345130,5,0,0,129024,12,6826052813
9805,267140400,125152,267265552,0,0,0,100864,20,8937468408
9806,267175010,34020,267209030,5,0,1,59392,12,3222640881
9807,267209740,86196,267295936,5,0,1,144384,12,9241117032
9808,267267680,173098,267440778,2,0,0,512,29,8114583768
9809,267301840,3128,267304968,5,0,1,9216,12,6588596074
9810,267302570,296108,267598678,5,0,0,195584,12,7783280785
9811,267390500,208513,267599013,2,0,0,1024,29,973428143
9812,267420180,107450,267527630,2,0,0,1536,29,1147676822
9813,267448269,174842,267623111,5,0,0,40448,12,9247769373
9814,267458220,246388,267704608,5,0,0,38912,12,9827035577
9815,267554220,49714,267603934,5,0,1,12800,12,7997856496
9816,267586590,137746,267724336,0,0,0,53248,20,8588850428
9817,267647220,198248,267845468,0,0,0,24576,20,8464134862
9818,267678600,218252,267896852,0,0,0,41984,20,3749864140
9819,267793780,3904,267797684,5,0,1,10752,12,7884072359
9820,267843330,53693,267897023,2,0,0,512,29,2416121881
9821,267855140,140089,267995229,5,0,0,129536,12,3724884407
9822,267984150,82671,268066821,0,0,0,10752,20,2893350043
9823,268077679,125996,268203675,5,0,0,113664,12,6960148881
9824,268114590,122841,268237431,0,0,0,25600,20,1804900176
9825,268149170,93995,268243165,5,0,1,156160,12,86613395
9826,268151090,96901,268247991,2,0,1,7680,29,2087544955
9827,268217529,290991,268508520,5,0,0,70144,12,10038895441
9828,268245050,14287,268259337,5,0,1,27648,12,5441357388
9829,268262180,107130,268369310,5,0,0,20992,12,9091615678
9830,268326430,566,268326996,2,0,1,512,29,5839080116
9831,268390760,3645,268394405,2,0,1,10240,29,6652913360
9832,268444180,64355,268508535,5,0,1,71168,12,4212853252
9833,268479930,71835,268551765,2,0,0,1024,29,1139714305
9834,268484740,185460,268670200,2,0,0,1536,29,8314355787
9835,268519750,241293,268761043,0,0,0,106496,20,10413733813
9836,268553450,115076,268668526,0,0,0,77824,20,7780785454
9837,268553630,118418,268672048,2,0,0,2560,29,815325340
9838,268569590,215066,268784656,5,0,1,348672,12,1323702105
9839,268613140,187376,268800516,5,0,1,59392,12,2946544567
9840,268614200,228456,268842656,5,0,1,144384,12,7837468280
9841,268648220,315008,268963228,5,0,1,365056,12,6307231731
9842,268688690,477069,269165759,2,0,0,24576,29,7815383925
9843,268694970,271484,268966454,2,0,1,5120,29,2729162946
9844,268785210,181910,268967120,5,0,1,1024,12,3651811847
9845,268877880,412109,269289989,5,0,0,174080,12,2871654841
9846,268964040,336736,269300776,2,0,0,35328,29,325100403
9847,269097780,4937,269102717,5,0,1,12800,12,4600007547
9848,269164180,235782,269399962,5,0,0,29184,12,4653648710
9849,269176670,3904,269180574,5,0,1,10752,12,8541031301
9850,269204490,4374,269208864,2,0,1,4608,29,4366104360
9851,269251400,54556,269305956,5,0,1,13312,12,713164829
9852,269286130,181226,269467356,0,0,0,66048,20,6023631226
9853,269362660,193187,269555847,5,0,0,32256,12,3379201877
9854,269385010,178652,269563662,5,0,0,25600,12,10647721384
9855,269513240,11274,269524514,5,0,1,18432,12,729393257
9856,269514290,10890,269525180,5,0,1,1024,12,2623486919
9857,269610900,2870,269613770,5,0,1,8704,12,4719393567
9858,269621230,566,269621796,2,0,1,512,29,2840261793
9859,269625770,99944,269725714,0,0,0,28160,20,7729182618
9860,269641310,566,269641876,2,0,1,512,29,9380225135
9861,269652500,6754,269659254,2,0,1,7168,29,3338736039
9862,269663100,64657,269727757,2,0,0,6656,29,8849315187
9863,269777190,79928,269857118,0,0,0,17920,20,8744120430
9864,269868020,4850,269872870,5,0,1,5120,12,57264275
9865,269921550,13083,269934633,2,0,1,22016,29,4073784212
9866,269978110,199796,270177906,5,0,0,194560,12,3079529587
9867,270041280,6278,270047558,2,0,1,6656,29,2500150916
9868,270045520,278882,270324402,2,0,0,138752,29,9447963292
9869,270060560,531460,270592020,0,0,0,305152,20,2961682217
9870,270060790,181635,270242425,5,0,0,111616,12,6228577583
9871,270115450,62479,270177929,5,0,1,42496,12,6680632723
9872,270133260,46657,270179917,5,0,1,2048,12,8152882060
9873,270167930,424605,270592535,5,0,0,1536,12,1162575514
9874,270181220,577859,270759079,5,0,0,372224,12,277809170
9875,270194120,4850,270198970,5,0,1,5120,12,2256028438
9876,270217820,29940,270247760,5,0,1,5632,12,352998864
9877,270229710,24939,270254649,2,0,1,16896,29,2713135664
9878,270305690,19312,270325002,1,0,1,512,18,5815002279
9879,270313320,18978,270332298,2,0,1,8192,29,8442403128
9880,270322460,442250,270764710,2,0,0,18432,29,10268198858
9881,270355520,6278,270361798,5,0,1,6656,12,3205876179
9882,270360880,3128,270364008,2,0,1,9216,29,10676598379
9883,270433820,158738,270592558,1,0,1,176128,18,6400835733
9884,270441210,151363,270592573,5,0,1,14336,12,8061363942
9885,270481170,111418,270592588,2,0,1,19968,29,9447866542
9886,270492560,576209,271068769,0,0,0,51200,20,6454556559
9887,270507160,105753,270612913,2,0,1,32768,29,3667752219
9888,270507590,106091,270613681,2,0,1,11776,29,8812300707
9889,270509130,337145,270846275,2,0,0,50688,29,3771090399
9890,270523680,241045,270764725,1,0,1,79872,18,1009336833
9891,270535900,228840,270764740,2,0,1,9216,29,5180900425
9892,270605410,159345,270764755,5,0,1,13312,12,267579313
9893,270631290,365616,270996906,2,0,0,205824,29,1082867824
9894,270726470,417221,271143691,0,0,0,69120,20,7862968182
9895,270732740,36236,270768976,2,0,1,11264,29,1791773786
9896,270739550,35450,270775000,5,0,1,7168,12,184346887
9897,270746600,99698,270846298,1,0,1,120832,18,10682591754
9898,270834000,13785,270847785,2,0,1,1536,29,5975179634
9899,270957650,236861,271194511,2,0,0,27648,29,3253173025
9900,270997980,167171,271165151,5,0,0,2560,12,9946472324
9901,271090590,1518,271092108,2,0,1,1536,29,4577902907
9902,271128340,17813,271146153,2,0,1,2560,29,5073133631
9903,271146480,155867,271302347,1,0,1,253440,18,1933915906
9904,271175780,136987,271312767,1,0,1,41472,18,2999089469
9905,271216260,97480,271313740,5,0,1,12800,12,503485399
9906,271265940,48466,271314406,5,0,1,1024,12,1898801162
9907,271358390,54270,271412660,1,0,1,92160,18,2905883364
9908,271450280,144843,271595123,5,0,0,5120,12,6224441611
9909,271483110,4374,271487484,2,0,1,4608,29,9982948426
9910,271533990,112799,271646789,0,0,0,42496,20,7634514103
9911,271677290,12737,271690027,2,0,1,24576,29,6483446424
9912,271686460,169501,271855961,2,0,0,69632,29,1182947640
9913,271725350,82820,271808170,2,0,0,12288,29,2559849759
9914,271752230,147204,271899434,1,0,1,243200,18,3948814115
9915,271799730,128082,271927812,0,0,0,10752,20,1681367412
9916,271799990,287900,272087890,5,0,0,40448,12,9974301302
9917,271858610,51346,271909956,1,0,1,41984,18,42507919
9918,271870890,224326,272095216,0,0,0,23040,20,427351590
9919,271904150,9032,271913182,1,0,1,5120,18,9311476493
9920,271913040,7230,271920270,1,0,1,7680,18,5381040369
9921,271930220,108431,272038651,0,0,0,44544,20,5106390555
9922,271961960,219737,272181697,0,0,0,23552,20,2850064539
9923,272106700,11533,272118233,5,0,1,18944,12,10289658186
9924,272130110,271662,272401772,0,0,0,25088,20,6854835810
9925,272199510,286688,272486198,5,0,0,152576,12,1058643000
9926,272210010,229685,272439695,0,0,0,124416,20,2690365000
9927,272268620,264564,272533184,5,0,0,126464,12,4918584852
9928,272350620,182624,272533244,1,0,1,295424,18,7518186107
9929,272470520,234563,272705083,0,0,0,12288,20,693590374
9930,272491580,124887,272616467,1,0,1,206336,18,2089154244
9931,272507340,109486,272616826,1,0,1,9728,18,5157921261
9932,272668570,41649,272710219,1,0,1,67584,18,9340555906
9933,272940410,25962,272966372,1,0,1,47104,18,9695826485
9934,273103020,119600,273222620,0,0,0,92672,20,4745358964
9935,273167180,320244,273487424,0,0,0,339456,20,1380891554
9936,273207760,71189,273278949,1,0,1,96256,18,6670390779
9937,273332010,170109,273502119,0,0,0,48128,20,1114829295
9938,273403460,193768,273597228,1,0,1,131072,18,9727606563
9939,273431640,165573,273597213,0,0,0,60416,20,7711112462
9940,273569830,153520,273723350,0,0,0,70144,20,7980749785
9941,273616290,229355,273845645,0,0,0,47616,20,2361785001
9942,273712510,44594,273757104,1,0,1,58880,18,8662213183
9943,274052820,99320,274152140,0,0,0,26112,20,9690165084
9944,274592370,114452,274706822,0,0,0,75776,20,3155913441
9945,274659040,101816,274760856,0,0,0,34304,20,2065131952
9946,275070310,252536,275322846,0,0,0,271872,20,1976140327
9947,276511250,83700,276594950,1,0,1,136192,18,10656350557
9948,278042470,6278,278048748,1,0,1,6656,18,8860900078
9949,280715750,24670,280740420,1,0,1,44544,18,148404297
9950,280961760,31266,280993026,1,0,1,50688,18,4309970250
9951,281077730,74867,281152597,1,0,1,122368,18,8026442472
9952,281339830,153799,281493629,1,0,1,249344,18,6328574038
9953,281377420,136793,281514213,1,0,1,73728,18,8372620635
9954,281517270,30749,281548019,1,0,1,49664,18,7487538845
9955,281536180,73575,281609755,1,0,1,119808,18,6765775365
9956,281740500,43458,281783958,1,0,1,71168,18,8967821724
9957,281996940,35312,282032252,1,0,1,61952,18,6764013864
9958,282015510,95125,282110635,1,0,1,157696,18,5357756518
9959,282052030,75489,282127519,1,0,1,64512,18,9170832094
9960,282073420,75604,282149024,1,0,1,78336,18,8191698383
9961,282220660,143158,282363818,1,0,1,231936,18,5848672946
9962,282239830,160892,282400722,1,0,1,119296,18,2020429626
9963,282281690,125036,282406726,1,0,1,20480,18,6032351722
9964,282542620,53066,282595686,1,0,1,86528,18,5572639846
9965,282654600,4162,282658762,1,0,1,11264,18,4381232734
9966,282723990,24154,282748144,1,0,1,43520,18,6374657137
9967,282825080,12825,282837905,1,0,1,21504,18,10324190757
9968,282933750,188221,283121971,1,0,1,309760,18,6606772093
9969,282989250,148172,283137422,1,0,1,49152,18,1083517989
9970,283230900,72541,283303441,1,0,1,117760,18,9536250990
9971,283472280,153541,283625821,1,0,1,248832,18,4786080273
9972,283563390,144191,283707581,1,0,1,233984,18,5353885368
9973,283679950,93825,283773775,1,0,1,152576,18,7186633496
9974,284123200,60866,284184066,1,0,1,98304,18,5880324876
9975,284694530,43200,284737730,1,0,1,70656,18,4674205526
9976,284704780,127381,284832161,1,0,1,192512,18,5515684330
9977,284864040,25187,284889227,1,0,1,45568,18,3888715560
9978,285013350,3904,285017254,1,0,1,10752,18,8186509323
9979,285747160,3645,285750805,1,0,1,10240,18,6901386032
9980,285804590,82408,285886998,1,0,1,133632,18,3654069178
9981,285881650,33245,285914895,1,0,1,57856,18,6076525018
9982,286718250,72024,286790274,1,0,1,116736,18,6092019822
9983,287163700,71249,287234949,1,0,1,115200,18,3750968543
9984,287350690,125492,287476182,1,0,1,204288,18,3100358360
9985,287397890,83784,287481674,1,0,1,26112,18,4005368054
9986,289585650,10499,289596149,1,0,1,16896,18,3747043369
9987,290417970,3422,290421392,1,0,1,3584,18,396821209
9988,290570090,12566,290582656,1,0,1,20992,18,6157634951
9989,290664900,566,290665466,1,0,1,512,18,1266758366
9990,291248020,4937,291252957,1,0,1,12800,18,1595110634
9991,291285300,5802,291291102,1,0,1,6144,18,6718361112
9992,291331070,5326,291336396,1,0,1,5632,18,1637391381
9993,291593500,3645,291597145,1,0,1,10240,18,1627018925
9994,291820780,566,291821346,1,0,1,512,18,5551808465
9995,291822010,1994,291824004,1,0,1,2048,18,534023056
9996,292395180,6278,292401458,1,0,1,6656,18,9078459125
9997,292406190,16096,292422286,1,0,1,31232,18,3693835345
9998,292450680,6229,292456909,1,0,1,15360,18,6808558319
9999,292500680,5971,292506651,1,0,1,14848,18,7582699900
