RequestID,ArrivalTime,DelayTime,FinishTime,InitiatorID,TargetID,IOType,Size,VolumeID,Offset
0,0,45596,45596,0,0,0,1024,38,7338217449
1,1,47288,47289,0,2,0,1536,8,3841472392
2,2,1518,1520,0,8,1,1536,27,2684894949
3,3,13083,13086,0,1,1,22016,36,306355098
4,4,1042,1046,0,5,1,1024,46,10215920473
5,5,67772,67777,0,7,0,13312,41,8025029070
6,6,566,572,0,4,1,512,21,5778473221
7,7,1994,2001,0,9,1,2048,20,5427347572
8,8,6229,6237,0,6,1,15360,42,715045030
9,9,49136,49145,0,3,0,2560,4,7576685337
10,4311,2870,7181,0,5,1,8704,46,2481946198
11,5508,149732,155240,0,1,0,25088,36,10095435658
12,6941,149798,156739,0,7,0,77312,41,7098514578
13,8759,1042,9801,0,4,1,1024,21,295625043
14,12678,75320,87998,0,6,0,17920,42,4005473132
15,22202,4850,27052,0,6,1,5120,42,1394706714
16,30952,1042,31994,0,4,1,1024,21,6833502133
17,44946,1042,45988,0,3,1,1024,4,3807667639
18,47717,2470,50187,0,8,1,2560,27,6107204926
19,51130,45752,96882,0,3,0,1536,4,2573271518
20,65508,566,66074,0,3,1,512,4,6732092843
21,67738,99944,167682,0,1,0,28160,36,10120249938
22,70263,97940,168203,0,6,0,26624,42,7295762078
23,88434,210410,298844,0,7,0,48128,41,10730745190
24,91836,132554,224390,0,1,0,24064,36,5952706718
25,99673,1042,100715,0,5,1,1024,46,1370047244
26,123354,104780,228134,0,7,0,44032,41,4578166388
27,127458,43904,171362,0,9,0,512,20,120658770
28,127884,91241,219125,0,2,1,147456,8,2728479078
29,129049,72536,201585,0,6,0,13824,42,2418894062
30,133782,80511,214293,0,6,0,5120,42,7530564578
31,142673,45596,188269,0,3,0,1024,4,7264354478
32,144338,7230,151568,0,8,1,7680,27,7388350214
33,145226,1042,146268,0,4,1,1024,21,6381991564
34,153368,59304,212672,0,1,0,4608,36,2351650089
35,180618,566,181184,0,9,1,512,20,2826840393
36,191148,5802,196950,0,8,1,6144,27,4021850119
37,191862,117884,309746,0,1,0,87040,36,5206013196
38,194505,163673,358178,0,1,0,42496,36,4010276460
39,208805,2470,211275,0,4,1,2560,21,3885679970
40,210337,5802,216139,0,1,1,6144,36,8905463965
41,223148,108354,331502,0,7,0,39424,41,6590328353
42,223263,10757,234020,0,2,1,17408,8,4369645062
43,223551,2349,225900,0,1,1,1536,36,10605935874
44,224535,19660,244195,0,2,1,30208,8,10233997641
45,237921,2870,240791,0,9,1,8704,20,2057408079
46,258008,43904,301912,0,9,0,512,20,10100361380
47,260446,566,261012,0,3,1,512,4,1585610064
48,271689,1518,273207,0,4,1,1536,21,1650669996
49,273113,5326,278439,0,8,1,5632,27,7185714717
50,285030,140295,425325,0,7,0,115200,41,9817408336
51,289144,162220,451364,0,7,0,39424,41,9594493152
52,290671,45596,336267,0,6,0,1024,42,3993017551
53,311014,6278,317292,0,9,1,6656,20,3061277087
54,314016,4902,318918,0,9,1,2560,20,8978705063
55,316964,4162,321126,0,6,1,11264,42,9276724612
56,324562,3898,328460,0,5,1,4096,46,4077361565
57,337440,3904,341344,0,6,1,10752,42,6828844995
58,339348,88544,427892,0,1,0,20992,36,3861396784
59,358696,3422,362118,0,6,1,3584,42,3953374904
60,362267,6488,368755,0,2,1,15872,8,3392658665
61,374597,3128,377725,0,4,1,9216,21,3114207696
62,377550,5196,382746,0,2,1,13312,8,1911665063
63,378691,74092,452783,0,7,0,4608,41,7477193887
64,383124,45596,428720,0,0,0,1024,38,5349493796
65,387902,6754,394656,0,8,1,7168,27,1956059528
66,388487,3645,392132,0,3,1,10240,4,4936281592
67,392485,1518,394003,0,5,1,1536,46,6377728314
68,400350,102284,502634,0,4,0,35840,21,1152072327
69,411559,154700,566259,0,2,0,1536,8,8842468171
70,418299,104022,522321,0,7,0,17920,41,7008066709
71,441707,1518,443225,0,8,1,1536,27,8740686652
72,442637,5802,448439,0,0,1,6144,38,7112120305
73,447893,13770,461663,0,4,1,26624,21,1121699958
74,454685,123144,577829,0,7,0,15360,41,1917222787
75,457217,1518,458735,0,5,1,1536,46,5206937153
76,459568,1518,461086,0,0,1,1536,38,3731659764
77,466371,5802,472173,0,4,1,6144,21,8989194773
78,478496,130459,608955,0,7,0,95232,41,224828085
79,487925,181013,668938,0,7,0,92160,41,6699739570
80,498948,1042,499990,0,0,1,1024,38,5334796473
81,508928,4679,513607,0,4,1,12288,21,7352471408
82,512050,218850,730900,0,7,0,32256,41,8657523459
83,523445,63878,587323,0,2,1,107520,8,9903055031
84,526986,1994,528980,0,1,1,2048,36,6562988136
85,531529,1518,533047,0,4,1,1536,21,4340034710
86,550923,43904,594827,0,9,0,512,20,5693397496
87,555870,187004,742874,0,6,0,152576,42,751851318
88,560343,1518,561861,0,6,1,1536,42,5689905025
89,564970,43904,608874,0,0,0,512,38,6387006408
90,565070,3898,568968,0,8,1,4096,27,6430485757
91,566330,108863,675193,0,7,0,20480,41,6730377358
92,572886,45596,618482,0,3,0,1024,4,6528459231
93,575378,4850,580228,0,8,1,5120,27,6683531194
94,579119,124505,703624,0,7,0,13312,41,6222247222
95,586102,566,586668,0,6,1,512,42,6323795143
96,611564,47288,658852,0,9,0,1536,20,9129339838
97,615712,214304,830016,0,5,0,242176,46,395391104
98,618940,3422,622362,0,3,1,3584,4,7199227828
99,621992,4850,626842,0,4,1,5120,21,9783500467
100,626478,3422,629900,0,6,1,3584,42,7588814490
101,640582,566,641148,0,5,1,512,46,9013345809
102,653489,10499,663988,0,5,1,16896,46,666955862
103,654654,9680,664334,0,5,1,512,46,10681955448
104,669013,4374,673387,0,0,1,4608,38,5557294113
105,679812,3898,683710,0,6,1,4096,42,6752837203
106,680448,122596,803044,0,7,0,39936,41,2005216643
107,700318,123856,824174,0,6,0,17408,42,8934356422
108,706006,2870,708876,0,3,1,8704,4,4779425458
109,732178,43904,776082,0,3,0,512,4,10724245656
110,738513,3128,741641,0,4,1,9216,21,3754086843
111,739530,99320,838850,0,7,0,26112,41,7631951916
112,745082,45954,791036,0,2,1,79360,8,7879295345
113,745281,566,745847,0,0,1,512,38,5082762446
114,754004,74510,828514,0,0,0,512,38,5364463672
115,757221,1518,758739,0,8,1,1536,27,994287468
116,768548,6754,775302,0,3,1,7168,4,4672578709
117,799014,45596,844610,0,9,0,1024,20,7473319244
118,806273,116566,922839,0,6,0,36864,42,2734220632
119,809878,2470,812348,0,6,1,2560,42,6356939224
120,812758,22576,835334,0,5,1,5632,46,10728341772
121,818975,114027,933002,0,6,0,33280,42,9382767382
122,819215,4850,824065,0,1,1,5120,36,9356716786
123,826222,1994,828216,0,1,1,2048,36,448020765
124,830613,3387,834000,0,3,1,9728,4,643863802
125,838869,49048,887917,0,2,0,1536,8,8036684205
126,848720,3128,851848,0,1,1,9216,36,10649481928
127,854750,48980,903730,0,5,0,2048,46,5041989646
128,857274,136851,994125,0,6,0,32768,42,4157601317
129,861055,85022,946077,0,6,0,6144,42,7478108920
130,876421,43904,920325,0,3,0,512,4,4528672550
131,883841,49488,933329,0,6,0,1024,42,3557310920
132,887148,4679,891827,0,4,1,12288,21,7373441133
133,897505,566,898071,0,0,1,512,38,8658756086
134,897758,1994,899752,0,5,1,2048,46,10540244947
135,908899,45596,954495,0,2,0,1024,8,2817995512
136,912383,111148,1023531,0,6,0,7168,42,3399792085
137,935090,48980,984070,0,3,0,2048,4,1365117990
138,938762,1518,940280,0,1,1,1536,36,9441617119
139,940194,3387,943581,0,0,1,9728,38,4740614512
140,941911,55748,997659,0,1,0,4096,36,9152284788
141,945201,53237,998438,0,2,1,90112,8,7786777168
142,945662,6754,952416,0,4,1,7168,21,1986238447
143,945962,1994,947956,0,5,1,2048,46,1267210809
144,952663,566,953229,0,0,1,512,38,8907588409
145,978985,25457,1004442,0,2,1,20480,8,6440792966
146,981316,81596,1062912,0,6,0,13312,42,726147465
147,995343,43904,1039247,0,5,0,512,46,10268775831
148,1008948,75452,1084400,0,6,0,13312,42,9552247989
149,1014253,67460,1081713,0,7,0,12288,41,4243811472
150,1020507,108524,1129031,0,1,0,13824,36,6491148260
151,1020509,3921,1024430,0,1,1,4096,36,4873913910
152,1028309,1518,1029827,0,4,1,1536,21,2838265666
153,1032721,59653,1092374,0,6,0,3072,42,5963073970
154,1047125,114608,1161733,0,1,0,76288,36,1485526846
155,1058479,5196,1063675,0,2,1,13312,8,4080878959
156,1070202,51296,1121498,0,7,0,4608,41,9981424536
157,1080142,2470,1082612,0,1,1,2560,36,8656864497
158,1083225,1994,1085219,0,5,1,2048,46,2021397844
159,1091214,33591,1124805,0,2,1,55296,8,5280776085
160,1104003,566,1104569,0,0,1,512,38,2337912322
161,1105697,2946,1108643,0,0,1,3072,38,7424737
162,1155610,82220,1237830,0,7,0,15360,41,7762813958
163,1171903,11533,1183436,0,0,1,18944,38,3625026422
164,1181784,45596,1227380,0,5,0,1024,46,5653417888
165,1184237,566,1184803,0,5,1,512,46,4963015770
166,1190341,1994,1192335,0,4,1,2048,21,6232610605
167,1226948,43904,1270852,0,5,0,512,46,316152135
168,1232191,65900,1298091,0,6,0,7168,42,10462246797
169,1239063,3898,1242961,0,5,1,4096,46,3860019150
170,1239796,3831,1243627,0,5,1,1024,46,534634386
171,1248356,116700,1365056,0,6,0,26624,42,3858547592
172,1255269,101660,1356929,0,6,0,33792,42,3025361197
173,1259531,52364,1311895,0,6,0,3072,42,2918873113
174,1286200,43904,1330104,0,3,0,512,4,8813978353
175,1286325,86672,1372997,0,1,0,14848,36,3176591196
176,1288602,32558,1321160,0,2,1,53248,8,176264216
177,1304622,47288,1351910,0,9,0,1536,20,450370696
178,1328847,77185,1406032,0,6,0,8704,42,1082480013
179,1336935,566,1337501,0,0,1,512,38,3715522227
180,1351144,566,1351710,0,1,1,512,36,4776033600
181,1357490,45596,1403086,0,3,0,1024,4,7474051833
182,1361554,4420,1365974,0,2,1,11776,8,3184012852
183,1372063,45596,1417659,0,3,0,1024,4,3495360480
184,1380089,107139,1487228,0,5,0,45568,46,2301037608
185,1397277,76052,1473329,0,5,0,10240,46,566492326
186,1412746,81776,1494522,0,1,0,18944,36,886284682
187,1450964,111176,1562140,0,7,0,65024,41,4577365734
188,1457504,96092,1553596,0,1,0,25600,36,8813428520
189,1462731,566,1463297,0,1,1,512,36,8951122118
190,1483334,48980,1532314,0,3,0,2048,4,2368409623
191,1489173,48980,1538153,0,7,0,2048,41,3045513841
192,1500865,3422,1504287,0,8,1,3584,27,2775699386
193,1506851,108449,1615300,0,7,0,20480,41,9325041132
194,1517031,43904,1560935,0,0,0,512,38,882979359
195,1545275,106808,1652083,0,5,0,50688,46,8594769905
196,1546549,118215,1664764,0,1,0,65024,36,6063482542
197,1561503,2946,1564449,0,1,1,3072,36,785476377
198,1567397,92216,1659613,0,7,0,17920,41,6893023639
199,1568720,7706,1576426,0,6,1,8192,42,10256083777
200,1576518,62672,1639190,0,7,0,6656,41,3565482547
201,1587858,171637,1759495,0,7,0,117760,41,9816406778
202,1604869,1994,1606863,0,1,1,2048,36,1872248478
203,1618428,43904,1662332,0,9,0,512,20,6212732050
204,1620842,3898,1624740,0,5,1,4096,46,6122249836
205,1622466,6278,1628744,0,0,1,6656,38,3959907072
206,1628597,43904,1672501,0,3,0,512,4,4749247023
207,1636321,5326,1641647,0,0,1,5632,38,787614285
208,1647461,10499,1657960,0,0,1,16896,38,2096331294
209,1672738,177553,1850291,0,5,0,79360,46,9371552507
210,1675334,46321,1721655,0,3,0,1024,4,4678723648
211,1683791,101036,1784827,0,6,0,31744,42,64489508
212,1689397,43904,1733301,0,0,0,512,38,8275272135
213,1696369,43904,1740273,0,3,0,512,4,701342
214,1708374,566,1708940,0,1,1,512,36,9082467965
215,1710376,3898,1714274,0,5,1,4096,46,2698850522
216,1737801,52364,1790165,0,9,0,3072,20,5000317920
217,1739272,43904,1783176,0,9,0,512,20,4653557870
218,1744322,133313,1877635,0,6,0,56832,42,10379103316
219,1757100,1042,1758142,0,1,1,1024,36,206444112
220,1765117,4162,1769279,0,1,1,11264,36,4089347041
221,1785144,45596,1830740,0,3,0,1024,4,8646495877
222,1792949,14287,1807236,0,2,1,27648,8,10467162634
223,1800683,55748,1856431,0,5,0,4096,46,299496713
224,1821536,48980,1870516,0,3,0,2048,4,3828228592
225,1833987,1518,1835505,0,7,1,1536,41,7835606491
226,1858231,3422,1861653,0,0,1,3584,38,4542135782
227,1874957,3904,1878861,0,0,1,10752,38,5463892777
228,1881285,72668,1953953,0,5,0,9216,46,2107236351
229,1908254,1994,1910248,0,5,1,2048,46,6371606192
230,1915048,5326,1920374,0,1,1,5632,36,1707812824
231,1931488,66368,1997856,0,5,0,8704,46,6052020303
232,1955960,5326,1961286,0,0,1,5632,38,6073163472
233,1959025,2607,1961632,0,0,1,512,38,1477043253
234,1961277,4374,1965651,0,2,1,4608,8,5492211005
235,1969550,103064,2072614,0,6,0,38400,42,5908799541
236,1970008,78865,2048873,0,5,0,12288,46,5654867899
237,1981745,43904,2025649,0,0,0,512,38,8242128250
238,1982598,62516,2045114,0,5,0,6144,46,9949713260
239,1991033,3645,1994678,0,1,1,10240,36,5396115429
240,1993796,43904,2037700,0,3,0,512,4,3184105553
241,1998699,63620,2062319,0,2,1,107008,8,3379699482
242,2007860,62828,2070688,0,5,0,7168,46,9829444176
243,2010393,48980,2059373,0,6,0,2048,42,4463424250
244,2028726,110708,2139434,0,1,0,63488,36,6545417157
245,2035699,43904,2079603,0,3,0,512,4,1811379296
246,2040490,3128,2043618,0,7,1,9216,41,6656898644
247,2054315,110608,2164923,0,7,0,52736,41,8416792600
248,2069315,164578,2233893,0,7,0,46080,41,4143971903
249,2074627,43904,2118531,0,9,0,512,20,4127281169
250,2089947,47288,2137235,0,9,0,1536,20,8337384112
251,2093891,204292,2298183,0,7,0,24064,41,2893425910
252,2120970,19022,2139992,0,1,1,512,36,10006532052
253,2155479,2470,2157949,0,0,1,2560,38,4114628510
254,2165858,5326,2171184,0,0,1,5632,38,10616347349
255,2166599,43112,2209711,0,2,1,73728,8,8518589000
256,2169069,43548,2212617,0,2,1,4608,8,1032477371
257,2215616,43904,2259520,0,9,0,512,20,1912111011
258,2233193,82408,2315601,0,2,1,133632,8,3786553999
259,2238786,102752,2341538,0,6,0,37376,42,9202644208
260,2249269,566,2249835,0,0,1,512,38,2759670438
261,2253817,7230,2261047,0,7,1,7680,41,71652164
262,2254395,3128,2257523,0,0,1,9216,38,8948530691
263,2301028,43904,2344932,0,3,0,512,4,6379067965
264,2311028,100773,2411801,0,0,0,1024,38,4580858808
265,2329804,4850,2334654,0,0,1,5120,38,9484959130
266,2336901,1994,2338895,0,7,1,2048,41,4387028934
267,2337567,5802,2343369,0,1,1,6144,36,7456441799
268,2337761,82820,2420581,0,7,0,12288,41,9454341379
269,2338024,43904,2381928,0,9,0,512,20,1766917926
270,2338727,45596,2384323,0,3,0,1024,4,319926757
271,2340100,43904,2384004,0,0,0,512,38,257100984
272,2349838,3387,2353225,0,1,1,9728,36,8893004996
273,2360244,161564,2521808,0,1,0,51712,36,5027646684
274,2362117,124904,2487021,0,6,0,110080,42,4457764043
275,2366187,47288,2413475,0,0,0,1536,38,10505613200
276,2373464,40616,2414080,0,2,1,65536,8,171538446
277,2378917,54712,2433629,0,0,0,1024,38,4136621655
278,2380465,6229,2386694,0,7,1,15360,41,5239524307
279,2394397,2870,2397267,0,7,1,8704,41,6156424456
280,2404133,43904,2448037,0,3,0,512,4,1478786643
281,2405118,4850,2409968,0,7,1,5120,41,7526176313
282,2420413,197845,2618258,0,1,0,140288,36,6251060439
283,2433490,52495,2485985,0,0,0,3072,38,7612761763
284,2452993,104900,2557893,0,6,0,43008,42,9454628285
285,2458859,113516,2572375,0,5,0,72704,46,2398721713
286,2459734,45596,2505330,0,3,0,1024,4,9775879770
287,2466778,138365,2605143,0,6,0,55808,42,2223771653
288,2476026,1518,2477544,0,1,1,1536,36,4207171683
289,2504892,116865,2621757,0,6,0,46592,42,9552861275
290,2505253,2470,2507723,0,5,1,2560,46,4833743420
291,2515130,5802,2520932,0,0,1,6144,38,2878598365
292,2517943,6215,2524158,0,0,1,5120,38,9003688377
293,2522963,566,2523529,0,7,1,512,41,10690859948
294,2525994,94159,2620153,0,1,0,6144,36,2591345801
295,2533045,1994,2535039,0,6,1,2048,42,5015820150
296,2547201,45596,2592797,0,9,0,1024,20,2777281830
297,2563392,133754,2697146,0,1,0,79360,36,8358089506
298,2572692,72692,2645384,0,7,0,14336,41,5277643277
299,2587777,45596,2633373,0,9,0,1024,20,147787030
300,2594523,28084,2622607,0,1,1,2560,36,8959421468
301,2595623,3128,2598751,0,0,1,9216,38,2494670150
302,2609413,1518,2610931,0,4,1,1536,21,7626792333
303,2615150,9412,2624562,0,1,1,10240,36,5898072382
304,2624017,95624,2719641,0,5,0,24064,46,8828350347
305,2626955,4162,2631117,0,7,1,11264,41,9323072262
306,2629455,43904,2673359,0,0,0,512,38,4466526361
307,2634891,45596,2680487,0,0,0,1024,38,6059851297
308,2636748,47288,2684036,0,3,0,1536,4,3962220305
309,2649455,79436,2728891,0,6,0,11264,42,3382409923
310,2650779,78056,2728835,0,1,0,11776,36,7925582267
311,2662105,5196,2667301,0,1,1,13312,36,1071931469
312,2706174,1518,2707692,0,7,1,1536,41,3628520614
313,2713158,35829,2748987,0,2,1,62976,8,9539109184
314,2729939,43904,2773843,0,0,0,512,38,10254545930
315,2732342,1042,2733384,0,1,1,1024,36,3364497312
316,2760987,43904,2804891,0,9,0,512,20,7237307018
317,2766320,43904,2810224,0,9,0,512,20,1753258617
318,2784708,4162,2788870,0,7,1,11264,41,3843809164
319,2785589,68996,2854585,0,5,0,12288,46,6647470004
320,2792502,219608,3012110,0,1,0,259584,36,4193065249
321,2796036,53495,2849531,0,2,1,90624,8,3558634243
322,2816852,54184,2871036,0,2,1,70144,8,9151066989
323,2824481,92528,2917009,0,6,0,18944,42,421288963
324,2830879,566,2831445,0,3,1,512,4,1280216025
325,2842385,43904,2886289,0,9,0,512,20,8800149160
326,2847299,45596,2892895,0,9,0,1024,20,4129767568
327,2861227,3387,2864614,0,3,1,9728,4,9771581770
328,2870272,1518,2871790,0,1,1,1536,36,4431600730
329,2879727,91516,2971243,0,6,0,14336,42,10601393398
330,2912089,86573,2998662,0,5,0,17920,46,330753959
331,2912096,1536,2913632,0,5,1,1536,46,3204968042
332,2917100,3645,2920745,0,1,1,10240,36,7545076144
333,2925558,52364,2977922,0,7,0,3072,41,9559983392
334,2961635,70211,3031846,0,3,0,512,4,9537090694
335,2962903,113407,3076310,0,1,0,6656,36,929970727
336,3004117,43904,3048021,0,9,0,512,20,6239763562
337,3010837,108524,3119361,0,7,0,56320,41,6479842051
338,3023107,2946,3026053,0,9,1,3072,20,2453961258
339,3038681,2470,3041151,0,7,1,2560,41,4496497952
340,3097152,116168,3213320,0,7,0,81408,41,3820955322
341,3143272,10241,3153513,0,1,1,16384,36,6467587440
342,3143628,3422,3147050,0,3,1,3584,4,5113357252
343,3144968,2870,3147838,0,3,1,8704,4,6380041609
344,3150896,6163,3157059,0,1,1,5632,36,6827228953
345,3151418,566,3151984,0,3,1,512,4,2477812444
346,3157534,5196,3162730,0,1,1,13312,36,7016027947
347,3177558,72848,3250406,0,6,0,14848,42,6773074001
348,3179738,2946,3182684,0,1,1,3072,36,9545775024
349,3217297,55748,3273045,0,3,0,4096,4,5263336804
350,3252031,10499,3262530,0,1,1,16896,36,9224238561
351,3276544,1994,3278538,0,1,1,2048,36,3273010777
352,3277113,43904,3321017,0,9,0,512,20,4413171871
353,3283206,1042,3284248,0,1,1,1024,36,9439785095
354,3310140,3904,3314044,0,1,1,10752,36,8153786268
355,3322093,43904,3365997,0,9,0,512,20,7157334161
356,3324246,4374,3328620,0,1,1,4608,36,5586607646
357,3324703,16354,3341057,0,7,1,31744,41,8959962135
358,3324855,47288,3372143,0,9,0,1536,20,1731324443
359,3333327,43904,3377231,0,3,0,512,4,58900090
360,3336082,566,3336648,0,8,1,512,27,7410333156
361,3342230,47288,3389518,0,0,0,1536,38,1972892056
362,3357596,75920,3433516,0,7,0,14848,41,8829808233
363,3409535,67904,3477439,0,1,0,8704,36,2388558749
364,3430847,45596,3476443,0,0,0,1024,38,3506682534
365,3437007,72668,3509675,0,1,0,9216,36,3211154499
366,3440821,3898,3444719,0,8,1,4096,27,1449963470
367,3441019,1994,3443013,0,1,1,2048,36,7530708910
368,3447577,45596,3493173,0,6,0,1024,42,818376077
369,3447645,1518,3449163,0,1,1,1536,36,729566767
370,3472626,6754,3479380,0,1,1,7168,36,8355332849
371,3509458,106028,3615486,0,7,0,48128,41,1473677369
372,3513720,1042,3514762,0,8,1,1024,27,4927907473
373,3517263,566,3517829,0,1,1,512,36,7613742641
374,3518266,3128,3521394,0,8,1,9216,27,8338832046
375,3521742,118040,3639782,0,6,0,87552,42,4768692491
376,3539846,148846,3688692,0,7,0,60416,41,830950137
377,3549720,45596,3595316,0,9,0,1024,20,10123157598
378,3556794,113252,3670046,0,6,0,8192,42,2250751311
379,3591256,5326,3596582,0,1,1,5632,36,7500628439
380,3600813,48980,3649793,0,3,0,2048,4,1066157276
381,3630934,60824,3691758,0,1,0,5632,36,6598331721
382,3656281,4374,3660655,0,2,1,4608,8,525311705
383,3672761,63296,3736057,0,6,0,8704,42,1623816468
384,3683507,50672,3734179,0,3,0,2560,4,5467737319
385,3684225,45596,3729821,0,9,0,1024,20,562955961
386,3686472,566,3687038,0,3,1,512,4,2489034707
387,3693652,102128,3795780,0,1,0,35328,36,3535482626
388,3706401,5326,3711727,0,1,1,5632,36,4502821734
389,3709328,46073,3755401,0,3,0,512,4,9831767797
390,3709339,4374,3713713,0,8,1,4608,27,10659934852
391,3714981,43904,3758885,0,3,0,512,4,4587735080
392,3727453,6741,3734194,0,3,1,15360,4,2745757046
393,3731935,65900,3797835,0,6,0,7168,42,9384252613
394,3738403,52364,3790767,0,7,0,3072,41,4382708990
395,3739510,2470,3741980,0,8,1,2560,27,1501340051
396,3740795,13770,3754565,0,1,1,26624,36,10160783079
397,3741935,15216,3757151,0,1,1,4096,36,382104337
398,3742714,101192,3843906,0,7,0,32256,41,1591925020
399,3759586,53762,3813348,0,3,0,512,4,4844672410
400,3768615,102284,3870899,0,7,0,35840,41,6958642560
401,3778754,1518,3780272,0,1,1,1536,36,8880843801
402,3786827,1042,3787869,0,8,1,1024,27,7026084814
403,3795176,1994,3797170,0,8,1,2048,27,157704618
404,3796603,111254,3907857,0,1,0,15360,36,8994524421
405,3802191,7230,3809421,0,8,1,7680,27,8941790308
406,3823269,52364,3875633,0,9,0,3072,20,5535168288
407,3831149,43904,3875053,0,3,0,512,4,8474042683
408,3857228,4374,3861602,0,3,1,4608,4,9929281211
409,3882530,5802,3888332,0,8,1,6144,27,1597506567
410,3882979,7299,3890278,0,8,1,3072,27,7510315098
411,3900285,114908,4015193,0,3,0,512,4,3614182345
412,3900565,2470,3903035,0,8,1,2560,27,10106539736
413,3903628,45596,3949224,0,0,0,1024,38,6942481695
414,3918399,91016,4009415,0,7,0,24064,41,6077585346
415,3922284,14029,3936313,0,2,1,27136,8,8726843830
416,3984723,3645,3988368,0,2,1,10240,8,5398897307
417,3988439,2946,3991385,0,3,1,3072,4,8394681991
418,4004176,97604,4101780,0,1,0,20480,36,5147611550
419,4010191,52364,4062555,0,1,0,3072,36,4112817941
420,4018542,1042,4019584,0,9,1,1024,20,3586958278
421,4028029,2870,4030899,0,3,1,8704,4,6792833957
422,4028964,50746,4079710,0,3,0,2048,4,1133482516
423,4033675,47288,4080963,0,0,0,1536,38,3844846194
424,4057202,5326,4062528,0,8,1,5632,27,7884260271
425,4080824,1042,4081866,0,3,1,1024,4,6223537639
426,4081263,1589,4082852,0,3,1,1536,4,5107538199
427,4081302,106652,4187954,0,4,0,50176,21,2232751023
428,4099907,2946,4102853,0,3,1,3072,4,8299534996
429,4108541,51296,4159837,0,0,0,4608,38,4872989209
430,4113275,107744,4221019,0,7,0,53760,41,9585407886
431,4127334,49136,4176470,0,7,0,2560,41,6987058233
432,4148045,4937,4152982,0,3,1,12800,4,2497882177
433,4170704,109460,4280164,0,6,0,59392,42,2234011751
434,4246518,2470,4248988,0,8,1,2560,27,10702313696
435,4248874,7230,4256104,0,8,1,7680,27,4517108259
436,4257290,1518,4258808,0,1,1,1536,36,1114292006
437,4257544,5717,4263261,0,1,1,13824,36,7343998284
438,4281119,1994,4283113,0,1,1,2048,36,4700495502
439,4289243,45596,4334839,0,3,0,1024,4,9714283840
440,4289487,3898,4293385,0,8,1,4096,27,5831427332
441,4289501,51794,4341295,0,3,0,2048,4,652187200
442,4291310,2470,4293780,0,5,1,2560,46,10237844630
443,4292628,4850,4297478,0,7,1,5120,41,7323739965
444,4295349,1518,4296867,0,8,1,1536,27,10668202116
445,4297124,11533,4308657,0,2,1,18944,8,3474966098
446,4301287,113763,4415050,0,7,0,25088,41,6828804753
447,4303731,47444,4351175,0,3,0,2048,4,1299303389
448,4329327,5802,4335129,0,3,1,6144,4,6719166767
449,4338604,5802,4344406,0,1,1,6144,36,6764688856
450,4354986,1042,4356028,0,1,1,1024,36,9859340517
451,4368193,13512,4381705,0,2,1,26112,8,4429185134
452,4389185,43904,4433089,0,3,0,512,4,891793003
453,4392594,45596,4438190,0,9,0,1024,20,1145052403
454,4397888,1518,4399406,0,8,1,1536,27,9629156240
455,4437622,14029,4451651,0,2,1,27136,8,9186164147
456,4444538,51140,4495678,0,7,0,4096,41,3904937274
457,4448503,43904,4492407,0,7,0,512,41,283608598
458,4450872,99632,4550504,0,6,0,27136,42,5311379390
459,4470514,5196,4475710,0,1,1,13312,36,2590851981
460,4481734,162692,4644426,0,7,0,143360,41,9641815018
461,4482444,3128,4485572,0,3,1,9216,4,2294556912
462,4509958,114140,4624098,0,6,0,74752,42,10514383639
463,4540339,43904,4584243,0,3,0,512,4,7264095099
464,4561799,43904,4605703,0,0,0,512,38,2019716563
465,4608610,2946,4611556,0,3,1,3072,4,770528684
466,4616388,1994,4618382,0,3,1,2048,4,7626306100
467,4629065,14029,4643094,0,1,1,27136,36,4883651873
468,4647828,11274,4659102,0,3,1,18432,4,7802179641
469,4662937,76587,4739524,0,2,1,129024,8,6298001190
470,4671345,7230,4678575,0,3,1,7680,4,6429854242
471,4672170,106964,4779134,0,1,0,51200,36,1786312571
472,4679621,101660,4781281,0,7,0,33792,41,7028697283
473,4700391,101972,4802363,0,3,0,34816,4,1900103581
474,4701134,1518,4702652,0,3,1,1536,4,1950532446
475,4706636,6278,4712914,0,8,1,6656,27,10383428723
476,4712082,1518,4713600,0,1,1,1536,36,3758488883
477,4717074,1994,4719068,0,1,1,2048,36,1985924632
478,4718587,45596,4764183,0,9,0,1024,20,7598984397
479,4719683,121458,4841141,0,3,0,59392,4,467917026
480,4727835,3898,4731733,0,3,1,4096,4,5801336864
481,4728227,11274,4739501,0,8,1,18432,27,4577323941
482,4729001,70976,4799977,0,6,0,8704,42,7405257213
483,4729597,174766,4904363,0,3,0,38912,4,10531010791
484,4731205,1518,4732723,0,3,1,1536,4,3954328365
485,4741323,48980,4790303,0,0,0,2048,38,6568665488
486,4783810,3387,4787197,0,1,1,9728,36,2981381657
487,4789008,51516,4840524,0,2,1,83456,8,9164385345
488,4792656,114296,4906952,0,7,0,75264,41,7775775282
489,4793233,43904,4837137,0,0,0,512,38,9902447508
490,4795401,120635,4916036,0,7,0,14336,41,1990228310
491,4805764,1994,4807758,0,0,1,2048,38,2679966690
492,4809186,1042,4810228,0,8,1,1024,27,8839003265
493,4811721,45596,4857317,0,7,0,1024,41,3877810684
494,4815021,12825,4827846,0,1,1,21504,36,2356935650
495,4820171,15051,4835222,0,1,1,23040,36,5240007206
496,4822618,23091,4845709,0,2,1,16384,8,2489179558
497,4840586,104466,4945052,0,2,1,169984,8,10623888356
498,4853752,5196,4858948,0,1,1,13312,36,5424922260
499,4878415,2470,4880885,0,8,1,2560,27,10072760817
500,4908496,6754,4915250,0,8,1,7168,27,10210148588
501,4918832,566,4919398,0,8,1,512,27,2909065203
502,4928247,152098,5080345,0,1,0,50688,36,737292359
503,4933920,47444,4981364,0,1,0,2048,36,4215166365
504,4974379,43904,5018283,0,9,0,512,20,290738360
505,4979515,1042,4980557,0,8,1,1024,27,10506452043
506,4981525,74360,5055885,0,6,0,9728,42,398477132
507,4981961,4850,4986811,0,1,1,5120,36,5722348710
508,4991243,566,4991809,0,8,1,512,27,8780130501
509,5002285,156236,5158521,0,3,0,142336,4,1706177810
510,5010793,127190,5137983,0,6,0,51200,42,2066483225
511,5014291,566,5014857,0,1,1,512,36,8165936031
512,5027564,3898,5031462,0,0,1,4096,38,5456696866
513,5039009,60824,5099833,0,6,0,5632,42,3594991083
514,5039693,22691,5062384,0,2,1,37376,8,10389312098
515,5067199,43904,5111103,0,0,0,512,38,792329736
516,5068567,12812,5081379,0,1,1,1024,36,8827967671
517,5086303,566,5086869,0,6,1,512,42,2993676349
518,5095220,43904,5139124,0,9,0,512,20,5292128421
519,5106780,122649,5229429,0,2,1,198656,8,108150343
520,5125089,110446,5235535,0,2,1,29184,8,3437243246
521,5126035,3387,5129422,0,8,1,9728,27,5712697897
522,5127906,2660,5130566,0,8,1,1536,27,1255973460
523,5143184,102752,5245936,0,6,0,37376,42,8763667153
524,5156275,45752,5202027,0,9,0,1536,20,8315124090
525,5158002,2470,5160472,0,1,1,2560,36,5421436247
526,5170692,43904,5214596,0,0,0,512,38,2692525282
527,5188809,1518,5190327,0,6,1,1536,42,10429769304
528,5216219,71475,5287694,0,1,0,8192,36,683530950
529,5219805,4374,5224179,0,1,1,4608,36,4608381838
530,5224947,2870,5227817,0,1,1,8704,36,10298428116
531,5234565,116926,5351491,0,6,0,42496,42,6503371696
532,5245506,4679,5250185,0,1,1,12288,36,9914403164
533,5246547,1994,5248541,0,6,1,2048,42,6356881212
534,5255202,92840,5348042,0,1,0,19968,36,5054291425
535,5262544,4374,5266918,0,1,1,4608,36,7267343021
536,5271047,45596,5316643,0,9,0,1024,20,6455687466
537,5276438,4850,5281288,0,8,1,5120,27,562003759
538,5280882,12049,5292931,0,1,1,19968,36,9295150966
539,5288217,32299,5320516,0,2,1,52736,8,1224310494
540,5313035,2870,5315905,0,6,1,8704,42,1830096950
541,5319329,108212,5427541,0,7,0,55296,41,851189908
542,5334580,59132,5393712,0,1,0,5120,36,3584811137
543,5336708,124628,5461336,0,2,1,205824,8,8820447263
544,5340835,155232,5496067,0,7,0,52224,41,41427086
545,5344578,8423,5353001,0,6,1,1536,42,751051815
546,5360562,107432,5467994,0,7,0,52736,41,10231219203
547,5369620,86390,5456010,0,1,0,16896,36,1474574806
548,5374937,1042,5375979,0,6,1,1024,42,2806473482
549,5395579,43904,5439483,0,0,0,512,38,9504908302
550,5401615,2470,5404085,0,1,1,2560,36,4222965090
551,5416892,44437,5461329,0,0,0,512,38,7167653632
552,5420426,89583,5510009,0,1,0,16896,36,9574133236
553,5449931,2470,5452401,0,8,1,2560,27,174571869
554,5450889,102128,5553017,0,6,0,35328,42,6924922188
555,5466251,3904,5470155,0,1,1,10752,36,4938561838
556,5466677,47288,5513965,0,9,0,1536,20,4868984027
557,5470243,566,5470809,0,1,1,512,36,3451611625
558,5481376,80607,5561983,0,7,0,12288,41,6482557554
559,5482449,4679,5487128,0,2,1,12288,8,2408725322
560,5485855,2470,5488325,0,6,1,2560,42,10504154724
561,5505317,102624,5607941,0,1,0,26624,36,6755566462
562,5530782,58688,5589470,0,3,0,8704,4,3536287958
563,5544772,13563,5558335,0,6,1,5632,42,6306735777
564,5556970,81908,5638878,0,7,0,14336,41,10523777366
565,5576650,43904,5620554,0,0,0,512,38,10136473930
566,5582016,12995,5595011,0,1,1,25088,36,10671094287
567,5592567,106808,5699375,0,3,0,50688,4,3408969727
568,5614233,91436,5705669,0,7,0,15360,41,5479295361
569,5616452,3422,5619874,0,6,1,3584,42,5463351906
570,5633724,127313,5761037,0,3,0,25088,4,10528164337
571,5662533,77612,5740145,0,3,0,15360,4,6480449971
572,5685310,118843,5804153,0,6,0,53760,42,6876126975
573,5697736,43904,5741640,0,9,0,512,20,4442261440
574,5723612,5802,5729414,0,6,1,6144,42,665503006
575,5731784,2870,5734654,0,6,1,8704,42,562060034
576,5785341,3904,5789245,0,0,1,10752,38,1018632056
577,5801554,97652,5899206,0,1,0,30720,36,4426864128
578,5804211,76988,5881199,0,7,0,13312,41,6439232041
579,5806827,5326,5812153,0,3,1,5632,4,8235556030
580,5822385,118484,5940869,0,6,0,11776,42,1817679106
581,5832734,105783,5938517,0,7,0,44032,41,7616149304
582,5862899,4162,5867061,0,8,1,11264,27,9106372330
583,5868685,43904,5912589,0,9,0,512,20,1976735721
584,5888424,566,5888990,0,3,1,512,4,2733575701
585,5900716,43904,5944620,0,0,0,512,38,520273313
586,5902585,3422,5906007,0,6,1,3584,42,6415578995
587,5929854,566,5930420,0,5,1,512,46,6960119181
588,5932267,4374,5936641,0,0,1,4608,38,4211901875
589,5960144,47288,6007432,0,9,0,1536,20,9082122256
590,5970858,128648,6099506,0,3,0,122368,4,851121782
591,5973386,86454,6059840,0,2,1,144896,8,9512554404
592,5991604,5712,5997316,0,5,1,14336,46,7382078680
593,6010338,5802,6016140,0,5,1,6144,46,2326554671
594,6012875,1042,6013917,0,1,1,1024,36,2597010685
595,6016989,110084,6127073,0,6,0,61440,42,9681917937
596,6021754,99201,6120955,0,2,0,3072,8,7989450998
597,6026903,4374,6031277,0,3,1,4608,4,5693083492
598,6030084,125546,6155630,0,3,0,22016,4,7722317344
599,6037009,180611,6217620,0,2,0,1024,8,7772573651
600,6039905,81393,6121298,0,3,0,5120,4,1854421352
601,6046885,187612,6234497,0,2,0,1024,8,10040645716
602,6056665,1994,6058659,0,5,1,2048,46,1501079683
603,6057264,1518,6058782,0,6,1,1536,42,3579731226
604,6093539,3898,6097437,0,6,1,4096,42,7157400409
605,6095765,25704,6121469,0,2,1,46592,8,8408551084
606,6096974,1518,6098492,0,8,1,1536,27,812637504
607,6110287,165834,6276121,0,3,0,16384,4,6609761352
608,6115953,108407,6224360,0,3,0,29696,4,10677142271
609,6120427,2946,6123373,0,0,1,3072,38,2973864526
610,6156420,56960,6213380,0,2,0,512,8,1702634434
611,6186277,6229,6192506,0,8,1,15360,27,6501570113
612,6191383,98696,6290079,0,1,0,24064,36,8673438648
613,6197576,43904,6241480,0,2,0,512,8,7841388874
614,6203595,104468,6308063,0,7,0,43008,41,6260603499
615,6217877,1042,6218919,0,8,1,1024,27,6314966968
616,6222638,114294,6336932,0,3,0,69632,4,5432442805
617,6228025,45596,6273621,0,1,0,1024,36,7365142930
618,6229410,82820,6312230,0,7,0,12288,41,3108304167
619,6233659,59132,6292791,0,9,0,5120,20,10566958367
620,6240996,45596,6286592,0,9,0,1024,20,4161123527
621,6246440,4850,6251290,0,3,1,5120,4,3963088136
622,6267284,72541,6339825,0,2,1,117760,8,1551513524
623,6274312,43904,6318216,0,0,0,512,38,5280853301
624,6275879,76208,6352087,0,1,0,10752,36,1417198444
625,6279554,3128,6282682,0,5,1,9216,46,1595099040
626,6298471,2870,6301341,0,0,1,8704,38,5936421342
627,6305166,7230,6312396,0,5,1,7680,46,367739273
628,6309227,126339,6435566,0,7,0,104960,41,5967526412
629,6309640,6278,6315918,0,0,1,6656,38,133540485
630,6311146,34990,6346136,0,2,1,22016,8,9810545044
631,6320973,566,6321539,0,8,1,512,27,7585080653
632,6324164,1518,6325682,0,0,1,1536,38,9925718488
633,6331790,43904,6375694,0,0,0,512,38,8312577491
634,6332110,8712,6340822,0,3,1,4096,4,1789555571
635,6334485,566,6335051,0,6,1,512,42,9228360400
636,6335527,43904,6379431,0,9,0,512,20,4344582656
637,6353999,84560,6438559,0,3,0,23040,4,618335274
638,6357314,12566,6369880,0,6,1,20992,42,8112150034
639,6378670,3904,6382574,0,0,1,10752,38,2755431681
640,6396334,2870,6399204,0,4,1,8704,21,8231432392
641,6404108,3904,6408012,0,5,1,10752,46,904634694
642,6404395,566,6404961,0,3,1,512,4,7153839258
643,6414318,4162,6418480,0,8,1,11264,27,8311279910
644,6418742,3898,6422640,0,5,1,4096,46,3248759550
645,6446787,5971,6452758,0,3,1,14848,4,8753433195
646,6451959,55045,6507004,0,2,1,93696,8,6603726681
647,6455010,105404,6560414,0,1,0,46080,36,6458173708
648,6458509,199412,6657921,0,2,0,512,8,1886197176
649,6468227,47600,6515827,0,9,0,2560,20,5532999355
650,6470879,81468,6552347,0,2,1,116224,8,6424349907
651,6488194,43904,6532098,0,0,0,512,38,5225698913
652,6500090,199072,6699162,0,2,0,1536,8,10106876255
653,6518932,1042,6519974,0,3,1,1024,4,1948100934
654,6540043,100412,6640455,0,6,0,29696,42,7960023722
655,6541980,566,6542546,0,3,1,512,4,286570775
656,6550859,122172,6673031,0,3,0,47616,4,2857094050
657,6555228,105806,6661034,0,6,0,39936,42,345307420
658,6560251,88600,6648851,0,6,0,11264,42,1310901415
659,6567159,72148,6639307,0,3,0,512,4,3867186349
660,6574427,47288,6621715,0,0,0,1536,38,6135318433
661,6614163,6278,6620441,0,2,1,6656,8,9324373790
662,6631681,31783,6663464,0,2,1,51712,8,9820790710
663,6635246,29204,6664450,0,2,1,1536,8,7960904976
664,6668696,3387,6672083,0,6,1,9728,42,4394641602
665,6669862,45596,6715458,0,0,0,1024,38,10715004353
666,6678450,43904,6722354,0,9,0,512,20,2928352001
667,6684955,65768,6750723,0,6,0,11776,42,9987269585
668,6687963,60824,6748787,0,7,0,5632,41,6731116530
669,6689554,43904,6733458,0,0,0,512,38,5673981664
670,6689790,131627,6821417,0,3,0,67584,4,8297725664
671,6707737,5326,6713063,0,3,1,5632,4,7123485899
672,6713143,106184,6819327,0,6,0,48640,42,3622242899
673,6713609,2946,6716555,0,6,1,3072,42,3807906926
674,6728850,106256,6835106,0,2,0,5632,8,6108419039
675,6739650,566,6740216,0,6,1,512,42,1754261469
676,6748814,6488,6755302,0,9,1,15872,20,1393420419
677,6762446,12308,6774754,0,6,1,20480,42,10019126963
678,6774973,10241,6785214,0,2,1,16384,8,10326529555
679,6804704,107192,6911896,0,6,0,11264,42,8871926446
680,6824162,6278,6830440,0,2,1,6656,8,5485720102
681,6824927,45804,6870731,0,2,1,73216,8,3144042246
682,6825043,11274,6836317,0,3,1,18432,4,9134938812
683,6842199,106028,6948227,0,7,0,48128,41,8275459731
684,6847505,88100,6935605,0,6,0,24576,42,9242795813
685,6848249,2470,6850719,0,4,1,2560,21,9234130898
686,6851751,5196,6856947,0,6,1,13312,42,8437575278
687,6853182,3422,6856604,0,3,1,3584,4,1264517121
688,6896180,47288,6943468,0,9,0,1536,20,8703726091
689,6903833,2946,6906779,0,3,1,3072,4,10608356497
690,6907083,4374,6911457,0,9,1,4608,20,10274401431
691,6911066,54056,6965122,0,0,0,3584,38,8395701646
692,6913185,2946,6916131,0,3,1,3072,4,5852575844
693,6916793,11274,6928067,0,4,1,18432,21,10374968086
694,6923783,43904,6967687,0,9,0,512,20,7166708514
695,6939140,1518,6940658,0,9,1,1536,20,7220632054
696,6949514,10499,6960013,0,6,1,16896,42,9655689100
697,6952472,1042,6953514,0,4,1,1024,21,3936679126
698,6993922,11016,7004938,0,2,1,17920,8,7232581462
699,7003066,188408,7191474,0,7,0,157184,41,2273599423
700,7007375,188794,7196169,0,7,0,15360,41,6289350355
701,7007847,2946,7010793,0,6,1,3072,42,5160373182
702,7043639,48980,7092619,0,0,0,2048,38,1241804947
703,7046458,98852,7145310,0,3,0,24576,4,8311761304
704,7048851,7230,7056081,0,3,1,7680,4,2858281360
705,7058293,45596,7103889,0,2,0,1024,8,7271845237
706,7073653,3128,7076781,0,9,1,9216,20,9610377130
707,7079314,177332,7256646,0,7,0,20992,41,10657855861
708,7087214,236158,7323372,0,3,0,188416,4,6081810094
709,7092828,4374,7097202,0,4,1,4608,21,7868053225
710,7098122,45596,7143718,0,2,0,1024,8,10496109035
711,7102294,102314,7204608,0,7,0,27648,41,7113624631
712,7110596,45596,7156192,0,9,0,1024,20,4594821110
713,7112901,121316,7234217,0,1,0,98304,36,7788723664
714,7114105,164441,7278546,0,2,1,266752,8,5428328069
715,7116770,1042,7117812,0,6,1,1024,42,215513268
716,7129913,175476,7305389,0,2,1,95744,8,229709090
717,7136983,70976,7207959,0,6,0,8704,42,10505043140
718,7140606,150912,7291518,0,7,0,21504,41,3997073146
719,7158491,2946,7161437,0,3,1,3072,4,1394050083
720,7182344,111669,7294013,0,1,0,60416,36,391416808
721,7225022,69076,7294098,0,7,0,512,41,9443823025
722,7236100,95313,7331413,0,2,1,83456,8,1413892080
723,7247014,67592,7314606,0,6,0,7680,42,9757250026
724,7247077,45596,7292673,0,0,0,1024,38,9631152171
725,7251634,160710,7412344,0,2,0,1024,8,4385036979
726,7264630,5326,7269956,0,9,1,5632,20,8998743938
727,7269193,5326,7274519,0,9,1,5632,20,4254554395
728,7318589,86360,7404949,0,7,0,13824,41,842860735
729,7319882,8808,7328690,0,3,1,5632,4,4313301914
730,7330848,5326,7336174,0,4,1,5632,21,1503324129
731,7331327,2946,7334273,0,6,1,3072,42,3490111953
732,7341098,6278,7347376,0,6,1,6656,42,308095606
733,7341904,3128,7345032,0,2,1,9216,8,6392645309
734,7348883,4850,7353733,0,4,1,5120,21,9089011896
735,7349698,43904,7393602,0,9,0,512,20,133637866
736,7351418,6754,7358172,0,9,1,7168,20,7415500608
737,7389111,110864,7499975,0,3,0,64000,4,10505126912
738,7392055,3422,7395477,0,4,1,3584,21,3091349915
739,7393440,12566,7406006,0,2,1,20992,8,736579394
740,7397959,45908,7443867,0,7,0,2048,41,1008789822
741,7404807,52364,7457171,0,0,0,3072,38,1976454440
742,7413426,112424,7525850,0,6,0,69120,42,2597198904
743,7423662,566,7424228,0,3,1,512,4,9489398536
744,7434465,4162,7438627,0,4,1,11264,21,1692167033
745,7466961,69983,7536944,0,6,0,3584,42,9884455602
746,7472983,45596,7518579,0,9,0,1024,20,10421045443
747,7473444,1518,7474962,0,6,1,1536,42,9852607717
748,7483663,191490,7675153,0,3,0,18944,4,3653407238
749,7511433,138865,7650298,0,2,0,512,8,5051939219
750,7543734,84512,7628246,0,1,0,12800,36,4632803202
751,7544434,4850,7549284,0,6,1,5120,42,4240098148
752,7544798,109460,7654258,0,7,0,59392,41,4953472799
753,7545118,60057,7605175,0,6,0,5120,42,3879950089
754,7545189,105092,7650281,0,3,0,45056,4,1476776535
755,7549667,7706,7557373,0,3,1,8192,4,8556032771
756,7596344,43904,7640248,0,0,0,512,38,9434642202
757,7597588,1994,7599582,0,9,1,2048,20,9271254888
758,7611272,112112,7723384,0,1,0,68096,36,6128272808
759,7619910,106808,7726718,0,7,0,50688,41,506301728
760,7642556,112106,7754662,0,7,0,29696,41,7836220024
761,7664392,1994,7666386,0,4,1,2048,21,7908564902
762,7670630,4374,7675004,0,4,1,4608,21,5277641323
763,7687839,44060,7731899,0,0,0,1024,38,8552971355
764,7689221,122099,7811320,0,7,0,17920,41,2021021749
765,7709632,50672,7760304,0,2,0,2560,8,4483965158
766,7717566,1994,7719560,0,4,1,2048,21,1424919660
767,7723229,110359,7833588,0,6,0,22528,42,4978621564
768,7725099,125125,7850224,0,7,0,59904,41,8638082002
769,7734572,2470,7737042,0,6,1,2560,42,307546055
770,7738325,4850,7743175,0,4,1,5120,21,8103381395
771,7741957,89367,7831324,0,7,0,10752,41,8486746037
772,7748197,1994,7750191,0,4,1,2048,21,1899872997
773,7755725,56337,7812062,0,2,1,96256,8,3504944853
774,7755827,4374,7760201,0,9,1,4608,20,1907448114
775,7756447,44737,7801184,0,9,0,512,20,660738046
776,7756967,7230,7764197,0,4,1,7680,21,1908195789
777,7759055,47288,7806343,0,0,0,1536,38,7938367967
778,7767332,43904,7811236,0,9,0,512,20,5575998338
779,7777092,1518,7778610,0,4,1,1536,21,8094141723
780,7780177,105716,7885893,0,3,0,47104,4,17147572
781,7789657,93741,7883398,0,2,0,1536,8,4659738171
782,7791656,57440,7849096,0,1,0,4608,36,9299814304
783,7818231,114296,7932527,0,6,0,75264,42,4453930236
784,7835920,43904,7879824,0,9,0,512,20,4761982671
785,7869183,57596,7926779,0,7,0,5120,41,10366208434
786,7878258,128319,8006577,0,3,0,96256,4,7258504662
787,7882443,566,7883009,0,6,1,512,42,3392726347
788,7884174,48980,7933154,0,0,0,2048,38,2173527130
789,7899076,1994,7901070,0,9,1,2048,20,1530328494
790,7903180,2946,7906126,0,4,1,3072,21,2694239957
791,7928833,77172,8006005,0,1,0,14848,36,314865869
792,7933850,67616,8001466,0,1,0,12800,36,3105565489
793,7943497,2470,7945967,0,4,1,2560,21,831498483
794,7951200,43904,7995104,0,9,0,512,20,9442047821
795,7961470,43904,8005374,0,9,0,512,20,7642664672
796,7969777,3422,7973199,0,3,1,3584,4,6451876898
797,7979320,5454,7984774,0,6,1,13824,42,2559953705
798,7986349,12566,7998915,0,9,1,20992,20,3335018652
799,7992873,55748,8048621,0,7,0,4096,41,1980886128
800,8005988,15579,8021567,0,2,1,30208,8,9735126659
801,8022221,5196,8027417,0,6,1,13312,42,9266655480
802,8036211,3422,8039633,0,9,1,3584,20,1184206130
803,8057648,240946,8298594,0,6,0,150016,42,727337090
804,8061837,102908,8164745,0,1,0,37888,36,7790755624
805,8075878,1042,8076920,0,4,1,1024,21,8758720282
806,8080334,16096,8096430,0,6,1,31232,42,2097972073
807,8099580,1994,8101574,0,9,1,2048,20,5669453065
808,8101974,1042,8103016,0,9,1,1024,20,115652039
809,8127309,45752,8173061,0,2,0,1536,8,10377033209
810,8129982,101816,8231798,0,1,0,34304,36,1189028028
811,8161849,11274,8173123,0,4,1,18432,21,2594423335
812,8181668,566,8182234,0,6,1,512,42,8829599119
813,8189727,93737,8283464,0,2,1,155648,8,1547924049
814,8201992,1994,8203986,0,6,1,2048,42,9988022649
815,8223672,3645,8227317,0,9,1,10240,20,10117926812
816,8228129,123105,8351234,0,1,0,92160,36,9074526689
817,8238803,45752,8284555,0,0,0,1536,38,10673226905
818,8249786,2870,8252656,0,4,1,8704,21,8148257674
819,8252367,43904,8296271,0,0,0,512,38,4668905969
820,8260571,67904,8328475,0,7,0,8704,41,6891468251
821,8261234,50672,8311906,0,3,0,2560,4,9676646893
822,8274332,24820,8299152,0,6,1,512,42,696434545
823,8278251,144791,8423042,0,1,0,28160,36,4932300730
824,8280626,31524,8312150,0,2,1,51200,8,3602342546
825,8287208,1042,8288250,0,4,1,1024,21,601731675
826,8317480,12049,8329529,0,2,1,19968,8,10343542858
827,8328206,43904,8372110,0,9,0,512,20,10027701776
828,8341190,47288,8388478,0,0,0,1536,38,7594912866
829,8342145,77900,8420045,0,6,0,11264,42,10027636698
830,8353569,1042,8354611,0,4,1,1024,21,4482366316
831,8358518,2946,8361464,0,8,1,3072,27,4227042634
832,8364052,117664,8481716,0,1,0,53248,36,1189563409
833,8369260,10241,8379501,0,1,1,16384,36,9996639945
834,8374491,33503,8407994,0,2,1,58368,8,7546743861
835,8375960,80847,8456807,0,2,1,105472,8,708825848
836,8379958,104548,8484506,0,3,0,33792,4,8661811709
837,8385428,101927,8487355,0,1,0,18432,36,8149809388
838,8392107,82088,8474195,0,3,0,19968,4,5867891560
839,8394945,3898,8398843,0,6,1,4096,42,6602751069
840,8401951,1042,8402993,0,9,1,1024,20,6127262141
841,8405984,62574,8468558,0,2,1,39936,8,9258234869
842,8415652,135648,8551300,0,9,0,1024,20,7332339138
843,8425613,1042,8426655,0,9,1,1024,20,10253700291
844,8451292,3422,8454714,0,1,1,3584,36,8175326300
845,8456449,43887,8500336,0,2,1,75264,8,4328664378
846,8457314,7706,8465020,0,6,1,8192,42,3534845217
847,8468718,24825,8493543,0,1,1,15360,36,10632534186
848,8482923,7230,8490153,0,4,1,7680,21,6425021844
849,8484765,232170,8716935,0,6,0,15360,42,1765899493
850,8496958,123812,8620770,0,3,0,106496,4,8350433990
851,8499156,237515,8736671,0,1,0,88064,36,5403031913
852,8504788,10241,8515029,0,2,1,16384,8,4829817727
853,8534370,566,8534936,0,2,1,512,8,9313577693
854,8536839,3422,8540261,0,6,1,3584,42,1257779943
855,8553222,3422,8556644,0,6,1,3584,42,6261596166
856,8564656,47288,8611944,0,9,0,1536,20,9791835261
857,8564834,1518,8566352,0,1,1,1536,36,3760436589
858,8570505,5326,8575831,0,9,1,5632,20,10705008961
859,8587208,5196,8592404,0,6,1,13312,42,10200685158
860,8587647,1518,8589165,0,4,1,1536,21,324443577
861,8589028,10757,8599785,0,1,1,17408,36,4541409731
862,8592420,11016,8603436,0,4,1,17920,21,459394610
863,8602755,3128,8605883,0,9,1,9216,20,6814423641
864,8611906,1042,8612948,0,2,1,1024,8,8397031485
865,8633987,4374,8638361,0,1,1,4608,36,9305043454
866,8638581,7230,8645811,0,1,1,7680,36,667047203
867,8645737,265676,8911413,0,6,0,97792,42,468426362
868,8650631,3898,8654529,0,2,1,4096,8,2599881872
869,8652857,1518,8654375,0,8,1,1536,27,1860536152
870,8663198,48980,8712178,0,9,0,2048,20,765841724
871,8666540,7230,8673770,0,2,1,7680,8,655265828
872,8692225,45596,8737821,0,9,0,1024,20,9444132327
873,8701873,5326,8707199,0,1,1,5632,36,991625005
874,8703625,4560,8708185,0,1,1,1536,36,2127102934
875,8722681,110084,8832765,0,3,0,61440,4,8947930412
876,8727445,99632,8827077,0,6,0,27136,42,8116107532
877,8745709,176795,8922504,0,6,0,36352,42,9948350591
878,8752122,4850,8756972,0,1,1,5120,36,10108316884
879,8752320,3898,8756218,0,2,1,4096,8,8008026277
880,8754590,1042,8755632,0,9,1,1024,20,6393512065
881,8764697,163126,8927823,0,6,0,17408,42,9614298835
882,8769076,1042,8770118,0,2,1,1024,8,7032956461
883,8771178,48980,8820158,0,9,0,2048,20,2594784319
884,8773709,1518,8775227,0,0,1,1536,38,625498543
885,8777375,5196,8782571,0,6,1,13312,42,9046165187
886,8779686,43904,8823590,0,9,0,512,20,9668982747
887,8785640,1042,8786682,0,2,1,1024,8,3484968884
888,8795160,94088,8889248,0,1,0,24064,36,3237083426
889,8826830,566,8827396,0,9,1,512,20,574962779
890,8831255,112424,8943679,0,5,0,69120,46,4230165135
891,8834448,6754,8841202,0,0,1,7168,38,9689458292
892,8848592,3898,8852490,0,0,1,4096,38,6079805030
893,8861909,2946,8864855,0,1,1,3072,36,6323343788
894,8873625,6278,8879903,0,7,1,6656,41,8627770769
895,8875215,1994,8877209,0,9,1,2048,20,7876195600
896,8879955,566,8880521,0,2,1,512,8,632239700
897,8895724,2470,8898194,0,2,1,2560,8,10157378782
898,8897109,1994,8899103,0,1,1,2048,36,3312195423
899,8909784,109515,9019299,0,6,0,25600,42,6478340930
900,8910086,107588,9017674,0,1,0,53248,36,2988199405
901,8912310,566,8912876,0,0,1,512,38,3303397612
902,8915285,1994,8917279,0,4,1,2048,21,4747315928
903,8921836,3422,8925258,0,2,1,3584,8,2797983231
904,8933461,45596,8979057,0,0,0,1024,38,7720460877
905,8935684,2946,8938630,0,7,1,3072,41,7729426998
906,8939830,4374,8944204,0,2,1,4608,8,3770107494
907,8943015,115969,9058984,0,1,0,11264,36,4703535112
908,8943101,2470,8945571,0,1,1,2560,36,8911315270
909,8944686,103779,9048465,0,7,0,30720,41,7399825104
910,8949830,4850,8954680,0,0,1,5120,38,3636928139
911,8951124,87764,9038888,0,3,0,18432,4,9952395202
912,8951618,5196,8956814,0,0,1,13312,38,1193244143
913,8960610,2470,8963080,0,9,1,2560,20,9484666556
914,8968425,4420,8972845,0,1,1,11776,36,8862876627
915,8977024,60824,9037848,0,7,0,5632,41,1801305448
916,8985771,566,8986337,0,2,1,512,8,8721943904
917,8995086,3898,8998984,0,2,1,4096,8,9858959386
918,8998860,4850,9003710,0,2,1,5120,8,6363486769
919,9001835,1994,9003829,0,7,1,2048,41,4619713750
920,9007939,124487,9132426,0,7,0,88064,41,5891231501
921,9015455,9441,9024896,0,1,1,7680,36,5253890670
922,9017572,3904,9021476,0,2,1,10752,8,9829432311
923,9020403,45596,9065999,0,9,0,1024,20,6822625376
924,9021396,10757,9032153,0,0,1,17408,38,6663772071
925,9040526,5802,9046328,0,0,1,6144,38,1674902487
926,9042690,78368,9121058,0,5,0,12800,46,2563478715
927,9049885,7706,9057591,0,0,1,8192,38,13018756
928,9077924,70476,9148400,0,5,0,5632,46,9802748855
929,9093718,107900,9201618,0,6,0,54272,42,1358160185
930,9105911,1042,9106953,0,4,1,1024,21,4150779938
931,9109424,53144,9162568,0,6,0,5632,42,3363290073
932,9128543,4374,9132917,0,3,1,4608,4,400541829
933,9155045,45596,9200641,0,5,0,1024,46,1776113940
934,9155542,5196,9160738,0,0,1,13312,38,8578852850
935,9170235,566,9170801,0,2,1,512,8,5333352521
936,9176210,115889,9292099,0,5,0,73216,46,10012532972
937,9185736,45765,9231501,0,0,0,512,38,1612287224
938,9207281,72824,9280105,0,7,0,9728,41,6170273500
939,9218798,119600,9338398,0,1,0,92672,36,3446284286
940,9218996,5326,9224322,0,4,1,5632,21,2346515820
941,9232643,4374,9237017,0,2,1,4608,8,6814749865
942,9245575,147621,9393196,0,1,0,44544,36,7522796755
943,9246797,43904,9290701,0,0,0,512,38,9498079686
944,9267095,5802,9272897,0,1,1,6144,36,7676408920
945,9287468,91172,9378640,0,6,0,24576,42,4648219043
946,9288860,110591,9399451,0,1,0,20480,36,4435132617
947,9289046,104780,9393826,0,3,0,44032,4,8740873623
948,9293725,125284,9419009,0,6,0,61952,42,8705317374
949,9301638,7706,9309344,0,6,1,8192,42,1394757676
950,9301804,3422,9305226,0,1,1,3584,36,5749548871
951,9302728,128670,9431398,0,3,0,31232,4,7794339451
952,9310525,111332,9421857,0,5,0,65536,46,6148340390
953,9332029,74072,9406101,0,7,0,13824,41,7024787115
954,9345060,4374,9349434,0,0,1,4608,38,8927509141
955,9357075,113515,9470590,0,3,0,21504,4,7463073102
956,9357390,135466,9492856,0,3,0,60416,4,10689495974
957,9381059,1042,9382101,0,0,1,1024,38,4276993961
958,9426214,118976,9545190,0,7,0,90624,41,2605873997
959,9441679,78307,9519986,0,3,0,9728,4,6814559195
960,9441885,69284,9511169,0,5,0,8192,46,1299718753
961,9468904,6229,9475133,0,0,1,15360,38,8151735546
962,9480604,78992,9559596,0,6,0,14848,42,5042220425
963,9490344,95812,9586156,0,3,0,21504,4,3582795362
964,9504145,7706,9511851,0,1,1,8192,36,10689874031
965,9508004,94210,9602214,0,7,0,18432,41,9571459203
966,9521539,254513,9776052,0,7,0,199680,41,6347482656
967,9538245,2470,9540715,0,1,1,2560,36,1779383354
968,9548334,91904,9640238,0,3,0,16896,4,8538094808
969,9559506,151848,9711354,0,7,0,21504,41,620269231
970,9582894,104936,9687830,0,5,0,44544,46,5985185892
971,9586893,52364,9639257,0,9,0,3072,20,4390560321
972,9587324,60980,9648304,0,3,0,6144,4,10455666000
973,9588989,189574,9778563,0,7,0,8192,41,8288521944
974,9594289,115681,9709970,0,5,0,16384,46,2177929355
975,9606080,100724,9706804,0,1,0,30720,36,8958068480
976,9620529,106340,9726869,0,1,0,49152,36,1462047126
977,9625034,6278,9631312,0,5,1,6656,46,9067867087
978,9627625,43904,9671529,0,0,0,512,38,3741532465
979,9636543,566,9637109,0,5,1,512,46,7295362055
980,9639393,43904,9683297,0,9,0,512,20,2119645941
981,9647316,85960,9733276,0,3,0,14336,4,9044133049
982,9660093,62516,9722609,0,6,0,6144,42,10103916519
983,9665472,90419,9755891,0,1,0,7168,36,697991120
984,9668168,1042,9669210,0,5,1,1024,46,8301717386
985,9674622,47288,9721910,0,9,0,1536,20,2529895020
986,9678700,70688,9749388,0,3,0,12800,4,3938982703
987,9680729,103309,9784038,0,7,0,17920,41,4031238709
988,9693657,48980,9742637,0,9,0,2048,20,1413456525
989,9693727,45596,9739323,0,0,0,1024,38,4315446769
990,9735475,12566,9748041,0,1,1,20992,36,5133788185
991,9744553,152243,9896796,0,1,0,46080,36,6170020582
992,9746910,1994,9748904,0,5,1,2048,46,8893153868
993,9772795,45596,9818391,0,0,0,1024,38,10086587259
994,9781766,566,9782332,0,0,1,512,38,5497309184
995,9781849,5802,9787651,0,5,1,6144,46,9525400262
996,9785929,5196,9791125,0,0,1,13312,38,4590749802
997,9807762,5326,9813088,0,1,1,5632,36,9502839190
998,9810293,6278,9816571,0,0,1,6656,38,9720900493
999,9814917,102908,9917825,0,1,0,37888,36,6518051655
1000,9815608,119600,9935208,0,5,0,92672,46,2585031246
1001,9826412,1042,9827454,0,5,1,1024,46,1275566144
1002,9833245,110957,9944202,0,5,0,5120,46,9021670621
1003,9837634,110953,9948587,0,1,0,6656,36,6689923953
1004,9838633,105872,9944505,0,7,0,47616,41,9579650424
1005,9864329,155554,10019883,0,7,0,97280,41,10668842668
1006,9900866,61107,9961973,0,1,0,4096,36,7698247505
1007,9915875,124638,10040513,0,1,0,80384,36,6296628448
1008,9926672,123372,10050044,0,1,0,31232,36,5679775152
1009,9936154,85468,10021622,0,7,0,5632,41,651461046
1010,9959355,566,9959921,0,1,1,512,36,2570579217
1011,9960197,50672,10010869,0,5,0,2560,46,2394818337
1012,9972376,124280,10096656,0,7,0,108032,41,4653630649
1013,9990928,36455,10027383,0,7,1,6144,41,1096408428
1014,10015169,47288,10062457,0,0,0,1536,38,2624645557
1015,10031212,98540,10129752,0,3,0,23552,4,2204479454
1016,10034022,109785,10143807,0,3,0,46080,4,8677550177
1017,10054690,112892,10167582,0,5,0,70656,46,3561298529
1018,10066309,2470,10068779,0,5,1,2560,46,6633192655
1019,10079463,20131,10099594,0,7,1,3072,41,10139419781
1020,10097720,80552,10178272,0,6,0,19968,42,6726392776
1021,10100276,68060,10168336,0,3,0,9216,4,2933724348
1022,10102907,98384,10201291,0,1,0,23040,36,10551183859
1023,10107510,1994,10109504,0,5,1,2048,46,4674137415
1024,10154203,103376,10257579,0,7,0,39424,41,3298427190
1025,10173090,566,10173656,0,5,1,512,46,4540725074
1026,10173195,94664,10267859,0,1,0,15872,36,2400077599
1027,10182761,53300,10236061,0,1,0,6144,36,9179808406
1028,10202577,115544,10318121,0,3,0,79360,4,6567495736
1029,10203286,1994,10205280,0,6,1,2048,42,8344305222
1030,10226029,86408,10312437,0,6,0,24064,42,6880556774
1031,10227506,43904,10271410,0,1,0,512,36,556791125
1032,10238273,45596,10283869,0,0,0,1024,38,115969481
1033,10263724,129169,10392893,0,3,0,25088,4,7954217425
1034,10303402,119953,10423355,0,3,0,28160,4,5794253329
1035,10354002,73004,10427006,0,5,0,15360,46,5961887857
1036,10397962,566,10398528,0,5,1,512,46,6693728959
1037,10463052,111488,10574540,0,5,0,66048,46,2867269440
1038,10495600,131590,10627190,0,5,0,51200,46,9533754353
1039,10495696,157154,10652850,0,5,0,23552,46,9014121479
1040,10533816,108212,10642028,0,3,0,55296,4,838239117
1041,10550490,3898,10554388,0,2,1,4096,8,3031398356
1042,10572611,2470,10575081,0,2,1,2560,8,6031923439
1043,10580435,101036,10681471,0,6,0,31744,42,8429222976
1044,10616077,115388,10731465,0,6,0,78848,42,5448704140
1045,10616110,5196,10621306,0,2,1,13312,8,4670890532
1046,10636290,50672,10686962,0,1,0,2560,36,9905406307
1047,10639982,105404,10745386,0,7,0,46080,41,4674364174
1048,10672781,69152,10741933,0,3,0,12800,4,1202970838
1049,10674176,2946,10677122,0,1,1,3072,36,4264962303
1050,10676876,4420,10681296,0,2,1,11776,8,7036459060
1051,10677778,1994,10679772,0,5,1,2048,46,4741325159
1052,10712104,1994,10714098,0,1,1,2048,36,4627299845
1053,10713134,43904,10757038,0,1,0,512,36,9539328158
1054,10732701,4374,10737075,0,1,1,4608,36,10278282435
1055,10736841,7706,10744547,0,5,1,8192,46,9145051477
1056,10754763,153452,10908215,0,7,0,138240,41,4424696573
1057,10760980,1518,10762498,0,2,1,1536,8,2627104630
1058,10767154,4374,10771528,0,1,1,4608,36,9872248384
1059,10767751,48144,10815895,0,1,0,1536,36,850559354
1060,10769854,140872,10910726,0,7,0,8192,41,7177027238
1061,10785323,43904,10829227,0,9,0,512,20,6064591392
1062,10794445,214390,11008835,0,7,0,93184,41,4988934554
1063,10801414,2470,10803884,0,1,1,2560,36,7127150302
1064,10803192,45350,10848542,0,1,0,512,36,3368335250
1065,10808546,45752,10854298,0,1,0,1536,36,10072134266
1066,10813012,200986,11013998,0,7,0,16896,41,4625381298
1067,10814910,140592,10955502,0,5,0,34816,46,8745283915
1068,10829112,7230,10836342,0,1,1,7680,36,3816543434
1069,10846571,566,10847137,0,2,1,512,8,8227145804
1070,10859668,103688,10963356,0,6,0,40448,42,7943245385
1071,10875031,5326,10880357,0,2,1,5632,8,7965911486
1072,10881734,57440,10939174,0,0,0,4608,38,10418850958
1073,10901381,60083,10961464,0,0,0,1024,38,9395736469
1074,10904740,164432,11069172,0,6,0,88064,42,848011846
1075,10923331,108747,11032078,0,5,0,16896,46,7434948784
1076,10928875,1518,10930393,0,9,1,1536,20,3584711107
1077,10938407,3904,10942311,0,5,1,10752,46,3055512771
1078,10958881,150449,11109330,0,6,0,62464,42,7058461134
1079,10975388,106340,11081728,0,7,0,49152,41,3053097185
1080,10975475,13253,10988728,0,5,1,25600,46,3962939388
1081,10979258,6754,10986012,0,9,1,7168,20,202395735
1082,10979859,3387,10983246,0,3,1,9728,4,1048747673
1083,10982598,43904,11026502,0,1,0,512,36,5102655869
1084,10985264,5971,10991235,0,1,1,14848,36,9310226956
1085,11008919,6754,11015673,0,3,1,7168,4,7377238141
1086,11022261,1042,11023303,0,3,1,1024,4,5135026420
1087,11033464,84216,11117680,0,7,0,3584,41,8910292367
1088,11035247,5454,11040701,0,3,1,13824,4,5607223146
1089,11042462,6278,11048740,0,3,1,6656,4,8356117710
1090,11074061,62081,11136142,0,7,0,2560,41,10420915458
1091,11081037,45596,11126633,0,1,0,1024,36,6990271417
1092,11097327,43904,11141231,0,9,0,512,20,5612296650
1093,11112498,112138,11224636,0,7,0,65024,41,299992030
1094,11115610,4420,11120030,0,1,1,11776,36,1139299635
1095,11116830,71218,11188048,0,7,0,11776,41,9526110869
1096,11119378,1518,11120896,0,3,1,1536,4,7534998839
1097,11127761,1042,11128803,0,9,1,1024,20,60800780
1098,11128994,3387,11132381,0,1,1,9728,36,8483148689
1099,11142411,1994,11144405,0,5,1,2048,46,3841366872
1100,11143206,3387,11146593,0,9,1,9728,20,1496957909
1101,11146145,47165,11193310,0,9,0,1024,20,7495745843
1102,11157626,1042,11158668,0,9,1,1024,20,4667343647
1103,11162532,3898,11166430,0,2,1,4096,8,1037180583
1104,11181519,94532,11276051,0,7,0,20480,41,4636816192
1105,11187662,6278,11193940,0,3,1,6656,4,3194546376
1106,11193987,45752,11239739,0,1,0,1536,36,9130783418
1107,11194335,59132,11253467,0,9,0,5120,20,7143506412
1108,11201509,1994,11203503,0,9,1,2048,20,10722577715
1109,11224029,3387,11227416,0,9,1,9728,20,9605472342
1110,11227614,6278,11233892,0,2,1,6656,8,8445706407
1111,11232687,2870,11235557,0,1,1,8704,36,3153049554
1112,11233315,2946,11236261,0,3,1,3072,4,5348499594
1113,11250001,74576,11324577,0,9,0,512,20,6362634832
1114,11257428,4850,11262278,0,6,1,5120,42,5669916923
1115,11259560,43904,11303464,0,9,0,512,20,6926997178
1116,11260036,5788,11265824,0,6,1,5632,42,3729914621
1117,11278791,45596,11324387,0,0,0,1024,38,5059327084
1118,11280472,5326,11285798,0,1,1,5632,36,6250364021
1119,11282059,84692,11366751,0,3,0,18432,4,3239220
1120,11297037,566,11297603,0,3,1,512,4,9527417073
1121,11297864,2470,11300334,0,4,1,2560,21,3744848208
1122,11315778,99164,11414942,0,8,0,25600,27,1744380020
1123,11333964,4937,11338901,0,3,1,12800,4,8249591401
1124,11334426,3645,11338071,0,1,1,10240,36,7858205946
1125,11334445,101036,11435481,0,0,0,31744,38,6507852420
1126,11337924,103220,11441144,0,5,0,38912,46,6439710797
1127,11342269,108056,11450325,0,7,0,54784,41,7357135584
1128,11347921,264333,11612254,0,3,0,140800,4,3500902207
1129,11357762,1518,11359280,0,3,1,1536,4,8822387513
1130,11365597,231086,11596683,0,0,0,171520,38,9733715341
1131,11367495,95328,11462823,0,3,0,512,4,6122618775
1132,11368850,1518,11370368,0,9,1,1536,20,7642857028
1133,11391746,58750,11450496,0,7,0,512,41,1433131624
1134,11400684,1994,11402678,0,9,1,2048,20,10723020639
1135,11409395,4679,11414074,0,3,1,12288,4,8435904386
1136,11411026,4374,11415400,0,9,1,4608,20,6217357577
1137,11411964,4012,11415976,0,8,1,1024,27,619632647
1138,11414426,2870,11417296,0,5,1,8704,46,7743383677
1139,11424647,3422,11428069,0,1,1,3584,36,8137686090
1140,11460121,106652,11566773,0,6,0,50176,42,8623263285
1141,11480644,122918,11603562,0,0,0,22528,38,10239215196
1142,11494300,2946,11497246,0,1,1,3072,36,8444621301
1143,11500081,2470,11502551,0,4,1,2560,21,798264276
1144,11500295,10757,11511052,0,2,1,17408,8,6969306594
1145,11520927,101504,11622431,0,6,0,33280,42,3772839591
1146,11521544,43904,11565448,0,9,0,512,20,10612566315
1147,11523154,6278,11529432,0,3,1,6656,4,947041892
1148,11531090,142521,11673611,0,6,0,39936,42,2045886621
1149,11539848,2946,11542794,0,3,1,3072,4,9135553669
1150,11553127,566,11553693,0,4,1,512,21,2207005823
1151,11557459,1042,11558501,0,3,1,1024,4,4865119358
1152,11560511,2946,11563457,0,3,1,3072,4,4503376001
1153,11566457,5802,11572259,0,4,1,6144,21,4350598214
1154,11575886,39272,11615158,0,3,1,8704,4,1207643220
1155,11589202,32492,11621694,0,3,1,7168,4,9799013754
1156,11595092,208658,11803750,0,3,0,96256,4,634681796
1157,11604146,6278,11610424,0,1,1,6656,36,6036856629
1158,11612959,103688,11716647,0,7,0,40448,41,2889207902
1159,11627227,57440,11684667,0,5,0,4608,46,4303428929
1160,11629493,117572,11747065,0,0,0,86016,38,1419477593
1161,11638183,3422,11641605,0,1,1,3584,36,6880011229
1162,11640384,149119,11789503,0,0,0,22528,38,228065999
1163,11652423,99476,11751899,0,5,0,26624,46,6970376285
1164,11674158,1042,11675200,0,9,1,1024,20,8156413234
1165,11678940,1518,11680458,0,0,1,1536,38,6234941546
1166,11687961,1042,11689003,0,3,1,1024,4,2546776009
1167,11689554,1994,11691548,0,5,1,2048,46,3749803848
1168,11702618,47288,11749906,0,1,0,1536,36,760369908
1169,11707781,157136,11864917,0,0,0,47104,38,7102125984
1170,11708061,566,11708627,0,9,1,512,20,538344535
1171,11708324,7706,11716030,0,3,1,8192,4,1452112783
1172,11725626,10757,11736383,0,4,1,17408,21,8591222134
1173,11740150,1042,11741192,0,3,1,1024,4,10622910478
1174,11752431,134048,11886479,0,3,0,56832,4,6849344631
1175,11756141,7706,11763847,0,2,1,8192,8,10707613412
1176,11760949,140054,11901003,0,5,0,42496,46,928680470
1177,11766555,127289,11893844,0,0,0,38912,38,752960127
1178,11781338,167237,11948575,0,0,0,93696,38,7877570511
1179,11782800,190925,11973725,0,3,0,115200,4,1674116545
1180,11784682,566,11785248,0,5,1,512,46,4908322503
1181,11787584,117416,11905000,0,7,0,85504,41,7693550064
1182,11803298,1042,11804340,0,5,1,1024,46,8594364768
1183,11805071,2870,11807941,0,5,1,8704,46,8091937684
1184,11806666,79436,11886102,0,6,0,11264,42,6664208799
1185,11811515,566,11812081,0,3,1,512,4,8830042171
1186,11823019,1042,11824061,0,9,1,1024,20,80840528
1187,11854278,186569,12040847,0,3,0,107520,4,5245876014
1188,11880519,135411,12015930,0,0,0,24576,38,9024112940
1189,11881834,5802,11887636,0,1,1,6144,36,9797145997
1190,11903693,96980,12000673,0,6,0,18432,42,5545320316
1191,11911781,2470,11914251,0,9,1,2560,20,10584646469
1192,11918866,4374,11923240,0,5,1,4608,46,7072460596
1193,11922491,11016,11933507,0,2,1,17920,8,2836859829
1194,11939632,107900,12047532,0,5,0,54272,46,6753140001
1195,11939658,3898,11943556,0,9,1,4096,20,10369861902
1196,11952068,566,11952634,0,5,1,512,46,10548581598
1197,11955584,4679,11960263,0,2,1,12288,8,7365683639
1198,11957416,6278,11963694,0,9,1,6656,20,4409943691
1199,11974568,155944,12130512,0,5,0,47104,46,5922774930
1200,11978325,48980,12027305,0,1,0,2048,36,1184160556
1201,11987354,59132,12046486,0,6,0,5120,42,7940157055
1202,12009755,4374,12014129,0,4,1,4608,21,6601106778
1203,12012588,112789,12125377,0,9,0,1024,20,6634350467
1204,12018461,86586,12105047,0,3,0,6656,4,8333869244
1205,12019356,6754,12026110,0,5,1,7168,46,5151247075
1206,12028705,50672,12079377,0,6,0,2560,42,923819503
1207,12039853,2470,12042323,0,4,1,2560,21,5449763342
1208,12039890,3904,12043794,0,9,1,10752,20,985801276
1209,12047555,4162,12051717,0,1,1,11264,36,9118129640
1210,12056028,6278,12062306,0,1,1,6656,36,2337462019
1211,12056226,566,12056792,0,3,1,512,4,8521234442
1212,12070634,11791,12082425,0,1,1,19456,36,10123314693
1213,12078817,566,12079383,0,2,1,512,8,10102355699
1214,12091009,43904,12134913,0,9,0,512,20,9062341621
1215,12097359,1518,12098877,0,9,1,1536,20,6439314800
1216,12107263,1994,12109257,0,5,1,2048,46,5379427337
1217,12113641,72068,12185709,0,3,0,12288,4,5560614829
1218,12119898,3898,12123796,0,2,1,4096,8,1340434176
1219,12122746,3422,12126168,0,2,1,3584,8,3278906803
1220,12125559,47288,12172847,0,1,0,1536,36,4940117491
1221,12126978,4420,12131398,0,3,1,11776,4,7243841068
1222,12127403,48980,12176383,0,1,0,2048,36,1111404229
1223,12133336,103939,12237275,0,9,0,512,20,4081427488
1224,12134280,5971,12140251,0,5,1,14848,46,10178544996
1225,12150955,112580,12263535,0,0,0,69632,38,967208680
1226,12161670,87879,12249549,0,3,0,17920,4,593428073
1227,12167810,10241,12178051,0,9,1,16384,20,4459777424
1228,12184546,1518,12186064,0,1,1,1536,36,7282516512
1229,12185528,45596,12231124,0,5,0,1024,46,10284407102
1230,12199073,52364,12251437,0,1,0,3072,36,39448566
1231,12214832,2946,12217778,0,1,1,3072,36,3001831739
1232,12218956,5326,12224282,0,3,1,5632,4,2622042824
1233,12219459,117906,12337365,0,3,0,26624,4,4994346594
1234,12219719,3387,12223106,0,2,1,9728,8,3377799142
1235,12228890,5326,12234216,0,1,1,5632,36,1191423763
1236,12234086,7706,12241792,0,6,1,8192,42,5265489551
1237,12242255,98228,12340483,0,7,0,22528,41,6597487893
1238,12243355,1042,12244397,0,9,1,1024,20,10407468452
1239,12255064,2470,12257534,0,6,1,2560,42,10067453219
1240,12279042,197924,12476966,0,5,0,188416,46,9319225830
1241,12288224,104178,12392402,0,5,0,6656,46,8935190723
1242,12290877,2470,12293347,0,3,1,2560,4,8716814979
1243,12291081,2470,12293551,0,6,1,2560,42,4236344137
1244,12307770,566,12308336,0,3,1,512,4,387039213
1245,12324067,1042,12325109,0,2,1,1024,8,8496425512
1246,12332071,65900,12397971,0,0,0,7168,38,7971016541
1247,12341675,1042,12342717,0,1,1,1024,36,5536019098
1248,12343007,12308,12355315,0,1,1,20480,36,5663572746
1249,12361088,222942,12584030,0,5,0,174592,46,2618879527
1250,12362361,3422,12365783,0,9,1,3584,20,7012399943
1251,12364551,3422,12367973,0,3,1,3584,4,10103563761
1252,12370778,1042,12371820,0,4,1,1024,21,3686263250
1253,12371023,128940,12499963,0,6,0,112640,42,8769578934
1254,12373179,3422,12376601,0,6,1,3584,42,8395627269
1255,12378789,2870,12381659,0,1,1,8704,36,5344472467
1256,12387252,96980,12484232,0,7,0,18432,41,9626321948
1257,12397261,94712,12491973,0,3,0,26112,4,313759427
1258,12418431,106028,12524459,0,0,0,48128,38,2889054470
1259,12420454,45596,12466050,0,1,0,1024,36,8922310243
1260,12423550,7230,12430780,0,9,1,7680,20,6548030652
1261,12424391,6735,12431126,0,9,1,512,20,8105662490
1262,12440139,3645,12443784,0,6,1,10240,42,4270259482
1263,12443713,4937,12448650,0,4,1,12800,21,988156605
1264,12445513,7706,12453219,0,2,1,8192,8,4561581038
1265,12451419,1518,12452937,0,1,1,1536,36,2441928601
1266,12467682,566,12468248,0,3,1,512,4,4028407630
1267,12480562,210998,12691560,0,6,0,31744,42,3336249361
1268,12491844,123938,12615782,0,5,0,67072,46,6656111558
1269,12496314,97045,12593359,0,9,0,1024,20,277596622
1270,12501475,91640,12593115,0,0,0,26112,38,2099304967
1271,12506969,44060,12551029,0,1,0,1024,36,4892997853
1272,12524326,2946,12527272,0,3,1,3072,4,4808192863
1273,12533043,566,12533609,0,8,1,512,27,9757625334
1274,12559890,1042,12560932,0,9,1,1024,20,2002380137
1275,12566246,3128,12569374,0,2,1,9216,8,5054484126
1276,12594382,45596,12639978,0,1,0,1024,36,10062346538
1277,12598539,4937,12603476,0,9,1,12800,20,2073717062
1278,12620140,3645,12623785,0,5,1,10240,46,4570763340
1279,12623085,5802,12628887,0,2,1,6144,8,1687452811
1280,12630836,2470,12633306,0,2,1,2560,8,7784474796
1281,12646681,7230,12653911,0,8,1,7680,27,9403795564
1282,12650473,99944,12750417,0,7,0,28160,41,1764849022
1283,12681369,71444,12752813,0,0,0,10240,38,9503095851
1284,12685753,67148,12752901,0,3,0,11264,4,983112370
1285,12690668,1042,12691710,0,3,1,1024,4,2251515670
1286,12694616,566,12695182,0,1,1,512,36,5688867750
1287,12704404,5196,12709600,0,2,1,13312,8,6005914461
1288,12704821,2470,12707291,0,8,1,2560,27,5703128510
1289,12708460,132121,12840581,0,1,0,512,36,1201249708
1290,12741257,104624,12845881,0,0,0,43520,38,9071078354
1291,12753673,566,12754239,0,6,1,512,42,2905880650
1292,12757404,1518,12758922,0,9,1,1536,20,1723862163
1293,12772743,4850,12777593,0,8,1,5120,27,3911601295
1294,12777688,47288,12824976,0,9,0,1536,20,9334076407
1295,12787204,4850,12792054,0,3,1,5120,4,2679265665
1296,12789494,101348,12890842,0,0,0,32768,38,5820736936
1297,12797210,3422,12800632,0,3,1,3584,4,4172298261
1298,12801932,3128,12805060,0,3,1,9216,4,4955243367
1299,12816101,4374,12820475,0,9,1,4608,20,7182354333
1300,12816394,60824,12877218,0,5,0,5632,46,5833160271
1301,12822856,96692,12919548,0,6,0,22528,42,8003806895
1302,12834655,47444,12882099,0,3,0,2048,4,2832810172
1303,12847594,81128,12928722,0,7,0,11776,41,2531705311
1304,12854225,45596,12899821,0,1,0,1024,36,43509229
1305,12856337,3422,12859759,0,2,1,3584,8,892662797
1306,12893004,1994,12894998,0,2,1,2048,8,6548392301
1307,12895185,54056,12949241,0,3,0,3584,4,7780169199
1308,12896660,1994,12898654,0,9,1,2048,20,4083150897
1309,12903316,7706,12911022,0,8,1,8192,27,6437288722
1310,12936471,45596,12982067,0,1,0,1024,36,5690371954
1311,12955451,3898,12959349,0,3,1,4096,4,7835541910
1312,12956982,7706,12964688,0,9,1,8192,20,1704367916
1313,12969404,3645,12973049,0,3,1,10240,4,4072977606
1314,12980980,3898,12984878,0,6,1,4096,42,7344641807
1315,13000871,43904,13044775,0,9,0,512,20,515127431
1316,13019856,48980,13068836,0,1,0,2048,36,1962299400
1317,13025657,7706,13033363,0,8,1,8192,27,3699788497
1318,13027051,1518,13028569,0,2,1,1536,8,4672029753
1319,13028248,2470,13030718,0,0,1,2560,38,5967916919
1320,13035632,99320,13134952,0,5,0,26112,46,4741181754
1321,13035733,44060,13079793,0,3,0,1024,4,9793054875
1322,13039441,45596,13085037,0,1,0,1024,36,3715033749
1323,13050444,4850,13055294,0,9,1,5120,20,10530748546
1324,13073058,45596,13118654,0,1,0,1024,36,8773603846
1325,13084874,11791,13096665,0,9,1,19456,20,6328243699
1326,13085497,1518,13087015,0,6,1,1536,42,9914914335
1327,13088689,133752,13222441,0,6,0,118784,42,5550131520
1328,13089725,62402,13152127,0,9,0,1024,20,4288046816
1329,13111927,5971,13117898,0,0,1,14848,38,9735148212
1330,13120327,1994,13122321,0,6,1,2048,42,3023269510
1331,13124888,6754,13131642,0,9,1,7168,20,10252151136
1332,13132828,566,13133394,0,2,1,512,8,2138343806
1333,13146017,3645,13149662,0,2,1,10240,8,6842866381
1334,13151099,102908,13254007,0,7,0,37888,41,8402243672
1335,13174588,1042,13175630,0,1,1,1024,36,10718318096
1336,13193858,34377,13228235,0,6,1,6144,42,5928525792
1337,13197813,105560,13303373,0,5,0,46592,46,10499100359
1338,13202890,4937,13207827,0,2,1,12800,8,2196790808
1339,13203449,165257,13368706,0,7,0,33280,41,4292386295
1340,13213779,566,13214345,0,2,1,512,8,5029269854
1341,13216996,141555,13358551,0,7,0,76288,41,6974321757
1342,13234201,2946,13237147,0,9,1,3072,20,4899225623
1343,13238924,62984,13301908,0,7,0,7680,41,7043783706
1344,13240351,125631,13365982,0,6,0,103424,42,8882432722
1345,13242919,6278,13249197,0,1,1,6656,36,10718669848
1346,13248543,129284,13377827,0,5,0,62976,46,9965389734
1347,13291029,47288,13338317,0,1,0,1536,36,8870790378
1348,13300122,43904,13344026,0,9,0,512,20,10726070904
1349,13303448,6754,13310202,0,1,1,7168,36,4814453173
1350,13329316,1042,13330358,0,8,1,1024,27,7191262000
1351,13332746,65645,13398391,0,7,0,8192,41,10628375479
1352,13336050,31918,13367968,0,6,1,2048,42,2655968673
1353,13356732,1518,13358250,0,1,1,1536,36,7038039836
1354,13362974,100755,13463729,0,1,0,512,36,5460507067
1355,13370342,1518,13371860,0,9,1,1536,20,5440649056
1356,13376967,93440,13470407,0,0,0,16896,38,5222476411
1357,13380236,6229,13386465,0,1,1,15360,36,158009291
1358,13403004,50672,13453676,0,1,0,2560,36,6611772536
1359,13410401,5802,13416203,0,2,1,6144,8,4120424993
1360,13434244,566,13434810,0,1,1,512,36,10644726550
1361,13442729,71756,13514485,0,0,0,11264,38,10624056010
1362,13445840,72668,13518508,0,3,0,9216,4,4354566311
1363,13448034,1042,13449076,0,6,1,1024,42,2009830177
1364,13453328,1994,13455322,0,4,1,2048,21,6316458833
1365,13464846,6754,13471600,0,1,1,7168,36,8176427240
1366,13468546,108374,13576920,0,0,0,49664,38,1729847872
1367,13469003,140760,13609763,0,0,0,81920,38,6973271724
1368,13514634,78056,13592690,0,6,0,11776,42,3926802442
1369,13514764,1994,13516758,0,1,1,2048,36,3153277934
1370,13515197,5326,13520523,0,9,1,5632,20,10683799683
1371,13532353,134783,13667136,0,0,0,46080,38,1573134808
1372,13599980,170735,13770715,0,0,0,50176,38,4356203543
1373,13602004,121316,13723320,0,3,0,98304,4,2488844899
1374,13611596,566,13612162,0,1,1,512,36,5698560615
1375,13612416,1994,13614410,0,9,1,2048,20,10619634649
1376,13614911,111176,13726087,0,0,0,65024,38,6265020436
1377,13625823,78368,13704191,0,6,0,12800,42,4899195770
1378,13651629,104936,13756565,0,7,0,44544,41,6651504048
1379,13654524,43904,13698428,0,1,0,512,36,3950883682
1380,13658031,1042,13659073,0,1,1,1024,36,2542050173
1381,13661857,1994,13663851,0,1,1,2048,36,1040356731
1382,13668346,137702,13806048,0,3,0,70144,4,10072627358
1383,13668907,106035,13774942,0,0,0,13824,38,3492988621
1384,13684605,2946,13687551,0,1,1,3072,36,7449753370
1385,13686449,105248,13791697,0,5,0,45568,46,5866613884
1386,13687025,45596,13732621,0,1,0,1024,36,224834508
1387,13691525,138786,13830311,0,7,0,73728,41,4355649355
1388,13692504,2870,13695374,0,9,1,8704,20,1078008222
1389,13737533,48980,13786513,0,9,0,2048,20,2270398574
1390,13744967,112627,13857594,0,0,0,40448,38,656931284
1391,13748042,13341,13761383,0,9,1,22528,20,9707920664
1392,13756029,5508,13761537,0,9,1,8704,20,3136368050
1393,13787969,106496,13894465,0,7,0,49664,41,5703211389
1394,13811099,134684,13945783,0,5,0,132096,46,4300043237
1395,13824788,11791,13836579,0,8,1,19456,27,7736197552
1396,13825438,47444,13872882,0,1,0,2048,36,2437292380
1397,13829809,11596,13841405,0,8,1,7680,27,10214262784
1398,13840221,45596,13885817,0,9,0,1024,20,10169560979
1399,13860528,98540,13959068,0,3,0,23552,4,2296866201
1400,13870767,47288,13918055,0,1,0,1536,36,10046850636
1401,13875977,4850,13880827,0,2,1,5120,8,9487091446
1402,13901515,55104,13956619,0,5,0,4096,46,682264127
1403,13912649,5712,13918361,0,1,1,14336,36,5959266920
1404,13922570,2470,13925040,0,8,1,2560,27,3063316602
1405,13925175,3898,13929073,0,1,1,4096,36,3941780503
1406,13928793,101348,14030141,0,3,0,32768,4,5249938388
1407,13948295,188564,14136859,0,5,0,157696,46,8850665708
1408,13948552,130029,14078581,0,5,0,5632,46,2769368703
1409,13956909,319312,14276221,0,5,0,225792,46,91617451
1410,13961387,6229,13967616,0,8,1,15360,27,4019097871
1411,13966081,2946,13969027,0,1,1,3072,36,5846533028
1412,13972504,6278,13978782,0,0,1,6656,38,6025009052
1413,13975754,151311,14127065,0,3,0,51200,4,1408737955
1414,13989402,4374,13993776,0,7,1,4608,41,6355784725
1415,14005357,47288,14052645,0,1,0,1536,36,4157933639
1416,14006944,104312,14111256,0,6,0,42496,42,2464423592
1417,14017045,1994,14019039,0,7,1,2048,41,7040816741
1418,14018175,4850,14023025,0,1,1,5120,36,5920139311
1419,14020017,115809,14135826,0,7,0,66560,41,2613316176
1420,14031318,3422,14034740,0,7,1,3584,41,212120488
1421,14043070,242838,14285908,0,5,0,31744,46,2169758361
1422,14063882,74427,14138309,0,3,0,10240,4,7507214358
1423,14102812,99632,14202444,0,0,0,27136,38,10029777170
1424,14149399,210092,14359491,0,3,0,228352,4,6901205773
1425,14149540,2946,14152486,0,1,1,3072,36,5806293143
1426,14176998,106964,14283962,0,6,0,51200,42,4653135929
1427,14188605,6278,14194883,0,1,1,6656,36,1187359099
1428,14195907,3645,14199552,0,4,1,10240,21,9531462583
1429,14198103,2967,14201070,0,4,1,2048,21,7173857806
1430,14209802,1042,14210844,0,7,1,1024,41,3316955683
1431,14219100,96404,14315504,0,7,0,26624,41,750782210
1432,14229134,43904,14273038,0,0,0,512,38,674376012
1433,14234615,125679,14360294,0,3,0,2560,4,89878141
1434,14235365,2870,14238235,0,4,1,8704,21,7989741172
1435,14247938,45596,14293534,0,1,0,1024,36,4838351129
1436,14260962,4850,14265812,0,7,1,5120,41,4011467996
1437,14266933,67222,14334155,0,7,0,4608,41,2563872487
1438,14270300,44924,14315224,0,1,0,512,36,5690205456
1439,14278128,566,14278694,0,7,1,512,41,2879877276
1440,14283670,4224,14287894,0,5,1,2048,46,5856609791
1441,14298275,60824,14359099,0,0,0,5632,38,2954658145
1442,14310717,136530,14447247,0,3,0,18432,4,608389510
1443,14323033,4850,14327883,0,8,1,5120,27,8998038123
1444,14334789,47288,14382077,0,9,0,1536,20,8642322516
1445,14336750,95336,14432086,0,5,0,28160,46,4763097281
1446,14341984,43904,14385888,0,9,0,512,20,10194446298
1447,14355966,113048,14469014,0,6,0,71168,42,2260795867
1448,14370090,566,14370656,0,7,1,512,41,10080018855
1449,14372497,3898,14376395,0,8,1,4096,27,10412684998
1450,14399652,84068,14483720,0,3,0,16384,4,8740803412
1451,14405460,62540,14468000,0,0,0,11264,38,4837685779
1452,14412039,59132,14471171,0,7,0,5120,41,585730352
1453,14428541,43904,14472445,0,7,0,512,41,4844397295
1454,14436867,90524,14527391,0,6,0,17408,42,30812890
1455,14455117,2946,14458063,0,7,1,3072,41,2434882673
1456,14468308,2946,14471254,0,4,1,3072,21,9033274850
1457,14479601,105248,14584849,0,0,0,45568,38,8537710805
1458,14480992,4937,14485929,0,1,1,12800,36,281137853
1459,14504140,1994,14506134,0,4,1,2048,21,3206549219
1460,14516881,6754,14523635,0,4,1,7168,21,872023357
1461,14521194,2787,14523981,0,4,1,512,21,6254206949
1462,14537504,7706,14545210,0,1,1,8192,36,2426853959
1463,14544411,101036,14645447,0,0,0,31744,38,3204341837
1464,14558959,158840,14717799,0,3,0,140800,4,6787728058
1465,14561026,1518,14562544,0,8,1,1536,27,2168023306
1466,14585285,45596,14630881,0,9,0,1024,20,1929992431
1467,14592084,43904,14635988,0,9,0,512,20,9871044061
1468,14600423,566,14600989,0,1,1,512,36,5658655403
1469,14609987,47288,14657275,0,6,0,1536,42,7782892563
1470,14625983,92299,14718282,0,3,0,1536,4,4383726857
1471,14631073,86828,14717901,0,6,0,15360,42,5956002682
1472,14635887,103532,14739419,0,5,0,39936,46,6457933763
1473,14638563,124760,14763323,0,0,0,87040,38,5034831645
1474,14672648,4850,14677498,0,1,1,5120,36,10022434212
1475,14676660,6278,14682938,0,8,1,6656,27,850328961
1476,14707469,3422,14710891,0,4,1,3584,21,9948863512
1477,14748986,5326,14754312,0,6,1,5632,42,4325415422
1478,14760055,1518,14761573,0,1,1,1536,36,1388914600
1479,14764142,112580,14876722,0,0,0,69632,38,1282569503
1480,14767518,3898,14771416,0,4,1,4096,21,9565979316
1481,14774856,5971,14780827,0,4,1,14848,21,6930322117
1482,14782221,110396,14892617,0,5,0,62464,46,10521724854
1483,14792472,126308,14918780,0,3,0,114688,4,6600859043
1484,14795377,48980,14844357,0,1,0,2048,36,1716603597
1485,14795727,43904,14839631,0,9,0,512,20,5555838555
1486,14812635,99164,14911799,0,7,0,25600,41,3317897948
1487,14830703,12308,14843011,0,1,1,20480,36,1377036134
1488,14853007,133993,14987000,0,3,0,38912,4,3097695409
1489,14865581,101660,14967241,0,5,0,33792,46,6575363430
1490,14872359,59132,14931491,0,7,0,5120,41,5199515530
1491,14877221,48980,14926201,0,1,0,2048,36,9389429325
1492,14905137,2946,14908083,0,8,1,3072,27,225300488
1493,14905726,3023,14908749,0,8,1,1024,27,8501825607
1494,14919419,1042,14920461,0,4,1,1024,21,5162119821
1495,14919898,5712,14925610,0,4,1,14336,21,10379972913
1496,14926160,3420,14929580,0,1,1,9728,36,10378923214
1497,14946429,114304,15060733,0,5,0,40960,46,5235609527
1498,14962956,566,14963522,0,4,1,512,21,3297621759
1499,14982967,45596,15028563,0,1,0,1024,36,1353607513
1500,14988032,54966,15042998,0,1,0,512,36,3877990787
1501,15005730,44523,15050253,0,1,0,512,36,3963264344
1502,15023625,104468,15128093,0,3,0,43008,4,6771924650
1503,15031223,101348,15132571,0,5,0,32768,46,10736444861
1504,15037754,61916,15099670,0,0,0,9216,38,5129550259
1505,15062680,566,15063246,0,8,1,512,27,3146710180
1506,15075598,100724,15176322,0,6,0,30720,42,3508109795
1507,15098113,109380,15207493,0,5,0,50688,46,7854881206
1508,15107625,43904,15151529,0,1,0,512,36,3037159734
1509,15123938,5196,15129134,0,4,1,13312,21,2044476612
1510,15127898,11274,15139172,0,8,1,18432,27,4639212016
1511,15171392,45596,15216988,0,1,0,1024,36,5079519850
1512,15174876,43904,15218780,0,1,0,512,36,9812385329
1513,15187584,100568,15288152,0,0,0,30208,38,4923697085
1514,15188841,6278,15195119,0,0,1,6656,38,10354138964
1515,15220819,124957,15345776,0,0,0,20480,38,6417597638
1516,15232915,566,15233481,0,0,1,512,38,2429919496
1517,15233527,169991,15403518,0,0,0,38400,38,5908430912
1518,15237356,1042,15238398,0,0,1,1024,38,9484931934
1519,15259850,4850,15264700,0,0,1,5120,38,8119113920
1520,15279402,111644,15391046,0,6,0,66560,42,1500161407
1521,15293500,128024,15421524,0,7,0,120320,41,958147263
1522,15306728,121207,15427935,0,7,0,20992,41,7487915241
1523,15308695,165191,15473886,0,0,0,108032,38,7993968835
1524,15323415,101212,15424627,0,5,0,32256,46,4520869932
1525,15333644,4420,15338064,0,5,1,11776,46,5653617247
1526,15371715,60068,15431783,0,5,0,8192,46,8686937814
1527,15409317,1518,15410835,0,0,1,1536,38,8018960956
1528,15443429,45596,15489025,0,1,0,1024,36,244185397
1529,15447544,45596,15493140,0,7,0,1024,41,8138825097
1530,15448982,2946,15451928,0,4,1,3072,21,1960487894
1531,15450998,139984,15590982,0,0,0,84480,38,1446828427
1532,15466376,103532,15569908,0,3,0,39936,4,4952522237
1533,15473146,47288,15520434,0,9,0,1536,20,8959493327
1534,15489980,43904,15533884,0,9,0,512,20,9404449040
1535,15493666,121610,15615276,0,0,0,16896,38,10320788250
1536,15506399,129272,15635671,0,6,0,124416,42,172217419
1537,15507105,47444,15554549,0,1,0,2048,36,2309474652
1538,15519874,123032,15642906,0,5,0,103936,46,2318635640
1539,15534287,1518,15535805,0,7,1,1536,41,23359351
1540,15548916,2470,15551386,0,7,1,2560,41,5529751174
1541,15562288,107400,15669688,0,3,0,27648,4,1469092268
1542,15562825,28172,15590997,0,0,1,5632,38,1458514504
1543,15578209,17630,15595839,0,0,1,5120,38,5824935700
1544,15596044,116546,15712590,0,0,0,42496,38,6297312739
1545,15621077,4374,15625451,0,7,1,4608,41,8655746493
1546,15623567,247705,15871272,0,0,0,168960,38,10174558488
1547,15629575,117732,15747307,0,6,0,66560,42,6140307936
1548,15630557,1518,15632075,0,7,1,1536,41,1980235959
1549,15668254,123724,15791978,0,7,0,7680,41,1189970360
1550,15676129,43904,15720033,0,1,0,512,36,10456390226
1551,15677439,71590,15749029,0,6,0,512,42,1416993618
1552,15709933,69402,15779335,0,6,0,3072,42,6100651938
1553,15714081,566,15714647,0,0,1,512,38,5831563313
1554,15747831,4850,15752681,0,0,1,5120,38,595858495
1555,15765382,119122,15884504,0,7,0,78336,41,5022352162
1556,15771986,130208,15902194,0,5,0,127488,46,6385412595
1557,15799077,43904,15842981,0,1,0,512,36,8939107222
1558,15816163,116415,15932578,0,5,0,8192,46,2216981794
1559,15819002,107276,15926278,0,0,0,52224,38,10275937268
1560,15859600,24919,15884519,0,7,1,1536,41,4243532468
1561,15875973,140204,16016177,0,0,0,55808,38,8284267045
1562,15904110,48980,15953090,0,1,0,2048,36,2693475024
1563,15943122,86204,16029326,0,3,0,13312,4,3432710239
1564,15979513,3898,15983411,0,0,1,4096,38,6471822043
1565,16008896,45596,16054492,0,1,0,1024,36,9582429701
1566,16011867,5344,16017211,0,0,1,1024,38,7858374383
1567,16019831,47288,16067119,0,1,0,1536,36,9297580877
1568,16021972,2470,16024442,0,0,1,2560,38,7782398513
1569,16036706,566,16037272,0,0,1,512,38,5162308766
1570,16042592,100100,16142692,0,3,0,28672,4,4235454364
1571,16045489,185247,16230736,0,0,0,49152,38,2210119818
1572,16061267,150077,16211344,0,3,0,92672,4,7356327222
1573,16065441,3422,16068863,0,2,1,3584,8,6356276537
1574,16071879,173083,16244962,0,3,0,15360,4,6566622871
1575,16089874,54056,16143930,0,6,0,3584,42,3387704524
1576,16101951,53673,16155624,0,6,0,512,42,4403413013
1577,16105329,128776,16234105,0,3,0,39424,4,9486534415
1578,16128085,43904,16171989,0,6,0,512,42,8288359904
1579,16168927,98852,16267779,0,5,0,24576,46,8699141046
1580,16169090,43904,16212994,0,9,0,512,20,10266059768
1581,16180466,167357,16347823,0,3,0,1024,4,4842728878
1582,16208955,47288,16256243,0,1,0,1536,36,10102521836
1583,16209313,43904,16253217,0,9,0,512,20,10294239113
1584,16214216,133280,16347496,0,3,0,123904,4,10049535295
1585,16276158,106496,16382654,0,7,0,49664,41,2031191080
1586,16289325,52364,16341689,0,6,0,3072,42,2849802542
1587,16308305,75296,16383601,0,3,0,12800,4,1034106810
1588,16351034,5326,16356360,0,9,1,5632,20,9881630805
1589,16353796,71288,16425084,0,5,0,9728,46,2981139229
1590,16355199,62516,16417715,0,3,0,6144,4,8957795294
1591,16382234,43904,16426138,0,9,0,512,20,4568184831
1592,16391503,106964,16498467,0,0,0,51200,38,6774656868
1593,16395001,566,16395567,0,9,1,512,20,9282728147
1594,16415659,43904,16459563,0,6,0,512,42,4689488310
1595,16415803,43931,16459734,0,6,0,512,42,2781087335
1596,16438423,43904,16482327,0,9,0,512,20,9187390958
1597,16467896,117199,16585095,0,0,0,35840,38,9301828542
1598,16488520,566,16489086,0,9,1,512,20,9216737420
1599,16500302,100412,16600714,0,5,0,29696,46,6096915181
1600,16522687,107432,16630119,0,3,0,52736,4,10304869609
1601,16525349,99476,16624825,0,0,0,26624,38,3256108062
1602,16533057,160831,16693888,0,5,0,107520,46,9306615396
1603,16559828,101761,16661589,0,3,0,8704,4,3340445712
1604,16563103,43904,16607007,0,1,0,512,36,5403467075
1605,16591094,148669,16739763,0,3,0,32256,4,3690610374
1606,16638355,48980,16687335,0,1,0,2048,36,10395240210
1607,16651637,119288,16770925,0,5,0,91648,46,2326907040
1608,16652636,43904,16696540,0,6,0,512,42,10347628749
1609,16660493,126308,16786801,0,7,0,114688,41,7079849833
1610,16701155,45596,16746751,0,6,0,1024,42,207234984
1611,16718443,48980,16767423,0,6,0,2048,42,9393450421
1612,16719955,5196,16725151,0,9,1,13312,20,10395403824
1613,16721212,1518,16722730,0,1,1,1536,36,2799348210
1614,16736611,1518,16738129,0,9,1,1536,20,434965888
1615,16742033,118604,16860637,0,7,0,57344,41,999941377
1616,16742248,100724,16842972,0,0,0,30720,38,4707684079
1617,16757424,12737,16770161,0,9,1,24576,20,7311252041
1618,16762583,56684,16819267,0,3,0,7168,4,8903626420
1619,16771177,95288,16866465,0,1,0,17920,36,4929936026
1620,16776638,566,16777204,0,9,1,512,20,4322948036
1621,16791469,67148,16858617,0,1,0,11264,36,8360054798
1622,16799346,100256,16899602,0,5,0,29184,46,6208410348
1623,16802683,52364,16855047,0,5,0,3072,46,8543657643
1624,16803392,117022,16920414,0,0,0,61952,38,3811116197
1625,16808177,159183,16967360,0,5,0,58880,46,4576182789
1626,16811802,112493,16924295,0,9,0,1024,20,7867421895
1627,16812200,2946,16815146,0,9,1,3072,20,10193170525
1628,16840831,103064,16943895,0,5,0,38400,46,2636186273
1629,16846494,69127,16915621,0,7,0,6656,41,1978066234
1630,16855256,103141,16958397,0,1,0,27648,36,6491960762
1631,16866531,2946,16869477,0,9,1,3072,20,9571298148
1632,16877039,45596,16922635,0,9,0,1024,20,3402814266
1633,16903532,109128,17012660,0,5,0,8704,46,228646587
1634,16912366,3904,16916270,0,8,1,10752,27,7050135286
1635,16920282,105669,17025951,0,1,0,46592,36,9607700673
1636,16927005,43904,16970909,0,9,0,512,20,10546430498
1637,16945566,45596,16991162,0,6,0,1024,42,7366785599
1638,16953776,62516,17016292,0,9,0,6144,20,1158549620
1639,16968482,100568,17069050,0,0,0,30208,38,10380770005
1640,16973868,12566,16986434,0,9,1,20992,20,9049485836
1641,17014255,127556,17141811,0,7,0,118784,41,9200844309
1642,17023213,99944,17123157,0,5,0,28160,46,5055946121
1643,17051445,107432,17158877,0,0,0,52736,38,9915589353
1644,17063110,179999,17243109,0,9,0,1024,20,385472356
1645,17068124,190329,17258453,0,0,0,79872,38,6908845590
1646,17071949,6754,17078703,0,0,1,7168,38,4813519085
1647,17083160,74360,17157520,0,5,0,9728,46,3115110209
1648,17084065,4162,17088227,0,0,1,11264,38,1867043423
1649,17084636,5802,17090438,0,6,1,6144,42,6980567546
1650,17090879,102908,17193787,0,3,0,37888,4,3120238507
1651,17120707,87946,17208653,0,0,0,7168,38,9531707787
1652,17121564,101421,17222985,0,9,0,512,20,9003183635
1653,17122020,126747,17248767,0,7,0,51200,41,4812961511
1654,17128045,5454,17133499,0,9,1,13824,20,1108778775
1655,17137502,181617,17319119,0,0,0,71168,38,4875895075
1656,17162742,2946,17165688,0,5,1,3072,46,8501794919
1657,17184444,43904,17228348,0,9,0,512,20,5065883747
1658,17196921,3128,17200049,0,5,1,9216,46,2965406202
1659,17199293,9375,17208668,0,0,1,7680,38,9764741825
1660,17217771,566,17218337,0,5,1,512,46,3629693304
1661,17222674,566,17223240,0,0,1,512,38,551654652
1662,17227005,3422,17230427,0,0,1,3584,38,3553450511
1663,17235579,123344,17358923,0,1,0,104960,36,7950709308
1664,17245188,4420,17249608,0,9,1,11776,20,3814988091
1665,17262110,232371,17494481,0,1,0,180736,36,4460485113
1666,17276042,7706,17283748,0,0,1,8192,38,4898385672
1667,17286279,1518,17287797,0,5,1,1536,46,129883532
1668,17299659,45596,17345255,0,9,0,1024,20,4037760001
1669,17302682,2470,17305152,0,5,1,2560,46,10721517826
1670,17309050,10627,17319677,0,0,1,512,38,6086530334
1671,17309276,97916,17407192,0,5,0,21504,46,3673519226
1672,17325846,54953,17380799,0,9,0,1536,20,7728639012
1673,17326850,1994,17328844,0,9,1,2048,20,2629401115
1674,17343386,82868,17426254,0,3,0,22528,4,3355285705
1675,17351022,45596,17396618,0,9,0,1024,20,1817849218
1676,17353844,146128,17499972,0,1,0,17920,36,6414009604
1677,17364263,74672,17438935,0,5,0,10752,46,2299626412
1678,17368721,3422,17372143,0,0,1,3584,38,9033497843
1679,17372014,54836,17426850,0,7,0,6144,41,8123719639
1680,17372016,94966,17466982,0,0,0,12800,38,6342741056
1681,17381485,187940,17569425,0,3,0,155648,4,1327727859
1682,17427728,102596,17530324,0,7,0,36864,41,2672316518
1683,17453202,102095,17555297,0,1,0,5632,36,7418341515
1684,17455260,113598,17568858,0,1,0,9728,36,10152071841
1685,17470845,60430,17531275,0,7,0,3072,41,2701748716
1686,17486664,110708,17597372,0,0,0,63488,38,3363572685
1687,17505942,43904,17549846,0,6,0,512,42,2634861109
1688,17507024,1994,17509018,0,5,1,2048,46,4602077608
1689,17514314,2870,17517184,0,9,1,8704,20,9100443245
1690,17526954,1994,17528948,0,5,1,2048,46,1231149551
1691,17530729,1994,17532723,0,5,1,2048,46,5150427610
1692,17531885,1518,17533403,0,9,1,1536,20,2991351949
1693,17533227,169509,17702736,0,3,0,23552,4,10272369691
1694,17557877,67592,17625469,0,7,0,7680,41,2123062987
1695,17564371,131174,17695545,0,3,0,43520,4,4040012587
1696,17571547,4850,17576397,0,7,1,5120,41,4653652720
1697,17594202,4680,17598882,0,0,1,1536,38,2838477013
1698,17594743,7706,17602449,0,9,1,8192,20,3643131026
1699,17613342,112268,17725610,0,7,0,68608,41,643837292
1700,17613375,130207,17743582,0,5,0,47104,46,4957747603
1701,17622977,54056,17677033,0,6,0,3584,42,6888930333
1702,17633405,43904,17677309,0,9,0,512,20,6375858450
1703,17635190,47288,17682478,0,9,0,1536,20,5125641737
1704,17648705,1042,17649747,0,5,1,1024,46,7886068923
1705,17654611,45596,17700207,0,6,0,1024,42,10031319270
1706,17657713,118618,17776331,0,5,0,24576,46,4362052745
1707,17659670,121288,17780958,0,3,0,23552,4,4191077203
1708,17661631,45596,17707227,0,6,0,1024,42,5262554202
1709,17664366,94893,17759259,0,5,0,2048,46,2681502618
1710,17667259,6754,17674013,0,2,1,7168,8,8752054164
1711,17674288,47288,17721576,0,6,0,1536,42,4989164337
1712,17679289,2946,17682235,0,0,1,3072,38,789197135
1713,17692845,1994,17694839,0,9,1,2048,20,2954380213
1714,17698963,121196,17820159,0,3,0,30720,4,769365030
1715,17749955,4374,17754329,0,9,1,4608,20,8565058060
1716,17752026,47288,17799314,0,0,0,1536,38,2829204532
1717,17758552,57440,17815992,0,7,0,4608,41,1992170853
1718,17766991,116480,17883471,0,1,0,82432,36,3339971147
1719,17775515,7230,17782745,0,0,1,7680,38,1769200529
1720,17779620,5802,17785422,0,5,1,6144,46,2063415983
1721,17784975,6754,17791729,0,9,1,7168,20,2680556007
1722,17787901,1994,17789895,0,0,1,2048,38,2971431772
1723,17808382,61136,17869518,0,5,0,6656,46,7714210834
1724,17819147,45596,17864743,0,9,0,1024,20,4099774101
1725,17840678,47288,17887966,0,9,0,1536,20,4667889467
1726,17851047,2870,17853917,0,0,1,8704,38,3151402044
1727,17860390,114821,17975211,0,1,0,16384,36,8986805119
1728,17878684,43904,17922588,0,6,0,512,42,8096209270
1729,17882383,65924,17948307,0,5,0,12288,46,564947317
1730,17943563,4759,17948322,0,5,1,1536,46,380985052
1731,17945206,99008,18044214,0,1,0,25088,36,4937162575
1732,17952630,45596,17998226,0,9,0,1024,20,9089499819
1733,17957754,45596,18003350,0,9,0,1024,20,8567809963
1734,17963676,45596,18009272,0,9,0,1024,20,611536890
1735,17987646,115388,18103034,0,5,0,78848,46,7506647039
1736,17993680,2470,17996150,0,0,1,2560,38,1500223372
1737,18004850,100256,18105106,0,3,0,29184,4,8356764559
1738,18011858,166832,18178690,0,7,0,141824,41,6903166792
1739,18031432,136384,18167816,0,5,0,63488,46,9109490715
1740,18040079,50672,18090751,0,9,0,2560,20,2339969269
1741,18043316,47288,18090604,0,6,0,1536,42,1687684138
1742,18044699,96536,18141235,0,1,0,22016,36,28937236
1743,18053717,113048,18166765,0,0,0,71168,38,7758672209
1744,18058423,136248,18194671,0,1,0,51200,36,5743693783
1745,18062390,45596,18107986,0,6,0,1024,42,7856418668
1746,18077946,43904,18121850,0,6,0,512,42,10673969565
1747,18089183,43904,18133087,0,9,0,512,20,7383688237
1748,18101373,45596,18146969,0,6,0,1024,42,4551323555
1749,18116915,63506,18180421,0,7,0,5632,41,6700406725
1750,18129850,119912,18249762,0,3,0,93696,4,2857448319
1751,18135495,7706,18143201,0,0,1,8192,38,967928178
1752,18141177,250911,18392088,0,3,0,171520,4,1364343387
1753,18157119,114335,18271454,0,0,0,14848,38,9347279355
1754,18213135,96380,18309515,0,5,0,21504,46,2562768192
1755,18234670,98852,18333522,0,7,0,24576,41,10482039352
1756,18268365,45596,18313961,0,6,0,1024,42,10394026146
1757,18269823,131796,18401619,0,3,0,31232,4,9935990514
1758,18294669,82220,18376889,0,5,0,15360,46,6748890310
1759,18302258,60824,18363082,0,1,0,5632,36,1725356808
1760,18330572,109083,18439655,0,5,0,28672,46,7586963614
1761,18332820,80240,18413060,0,3,0,18944,4,4770416398
1762,18335570,5802,18341372,0,6,1,6144,42,8739187154
1763,18354411,59600,18414011,0,0,0,6656,38,7043276186
1764,18370834,95600,18466434,0,0,0,18944,38,9795296822
1765,18381302,72987,18454289,0,0,0,6656,38,5771758754
1766,18449086,43904,18492990,0,9,0,512,20,9574049863
1767,18451550,64978,18516528,0,9,0,1024,20,6098426489
1768,18463596,43904,18507500,0,6,0,512,42,709370024
1769,18477546,43904,18521450,0,6,0,512,42,6491371290
1770,18506706,109772,18616478,0,1,0,60416,36,7014636735
1771,18516809,1518,18518327,0,9,1,1536,20,8489433768
1772,18523945,566,18524511,0,9,1,512,20,5127687202
1773,18537458,45596,18583054,0,9,0,1024,20,7234758535
1774,18557154,71132,18628286,0,3,0,9216,4,5736008653
1775,18594111,43904,18638015,0,9,0,512,20,4875804583
1776,18613577,6488,18620065,0,9,1,15872,20,8562192690
1777,18629076,69284,18698360,0,3,0,8192,4,8399088412
1778,18629303,7706,18637009,0,9,1,8192,20,10343933518
1779,18649293,214616,18863909,0,7,0,243200,41,1262835626
1780,18653698,43904,18697602,0,9,0,512,20,1245696039
1781,18657086,105872,18762958,0,0,0,47616,38,7058731588
1782,18688633,3422,18692055,0,9,1,3584,20,221681774
1783,18692617,145887,18838504,0,0,0,67584,38,5896381821
1784,18714711,152052,18866763,0,7,0,7168,41,856238791
1785,18719118,171515,18890633,0,7,0,31232,41,9107880735
1786,18732019,132537,18864556,0,7,0,2048,41,2257586152
1787,18738312,195740,18934052,0,3,0,181248,4,8345856156
1788,18744939,1518,18746457,0,3,1,1536,4,4663041651
1789,18755233,1994,18757227,0,3,1,2048,4,5212266335
1790,18764088,45596,18809684,0,6,0,1024,42,7244997975
1791,18777802,109772,18887574,0,1,0,60416,36,7774154319
1792,18800764,110425,18911189,0,7,0,1536,41,8776325172
1793,18801727,93128,18894855,0,0,0,15872,38,10509994845
1794,18812659,5802,18818461,0,3,1,6144,4,3781843139
1795,18821771,45596,18867367,0,9,0,1024,20,5020688615
1796,18823066,103591,18926657,0,7,0,1024,41,839031305
1797,18874610,6754,18881364,0,9,1,7168,20,6452852747
1798,18892883,1994,18894877,0,9,1,2048,20,3550539995
1799,18922069,1518,18923587,0,9,1,1536,20,6328533356
1800,18930562,3898,18934460,0,9,1,4096,20,7580937284
1801,18948206,7230,18955436,0,1,1,7680,36,4376647108
1802,18973900,50672,19024572,0,3,0,2560,4,7415583104
1803,19006237,101192,19107429,0,0,0,32256,38,7581189366
1804,19014584,100256,19114840,0,1,0,29184,36,10216723821
1805,19018254,6333,19024587,0,3,1,14848,4,8363484324
1806,19023538,43904,19067442,0,6,0,512,42,2151185768
1807,19028719,45596,19074315,0,9,0,1024,20,1247241840
1808,19037964,153046,19191010,0,1,0,51200,36,58124115
1809,19042568,54056,19096624,0,3,0,3584,4,8349808082
1810,19067943,45596,19113539,0,7,0,1024,41,2670462867
1811,19076858,52520,19129378,0,5,0,3584,46,7784441047
1812,19083365,43904,19127269,0,6,0,512,42,6636836576
1813,19101399,48980,19150379,0,7,0,2048,41,8784923392
1814,19125083,54524,19179607,0,5,0,5120,46,7502289206
1815,19125904,7706,19133610,0,2,1,8192,8,792501010
1816,19126041,566,19126607,0,9,1,512,20,4163564165
1817,19145231,2470,19147701,0,3,1,2560,4,1436918829
1818,19146962,43904,19190866,0,7,0,512,41,8797446799
1819,19149014,47288,19196302,0,7,0,1536,41,1025415331
1820,19150371,119602,19269973,0,5,0,73728,46,2698938584
1821,19155744,60712,19216456,0,7,0,1024,41,641642304
1822,19158898,5326,19164224,0,3,1,5632,4,1187108447
1823,19162035,115232,19277267,0,9,0,78336,20,5662446980
1824,19167468,166649,19334117,0,9,0,41984,20,1568375788
1825,19186291,100568,19286859,0,0,0,30208,38,668421067
1826,19196764,86249,19283013,0,3,0,13824,4,4129277628
1827,19200263,43904,19244167,0,6,0,512,42,10256576691
1828,19203295,83132,19286427,0,8,0,13312,27,1312979198
1829,19221786,101816,19323602,0,3,0,34304,4,1242551050
1830,19223137,45596,19268733,0,7,0,1024,41,5132658480
1831,19231751,5802,19237553,0,3,1,6144,4,64923475
1832,19242449,110095,19352544,0,9,0,36864,20,537136303
1833,19253086,55748,19308834,0,1,0,4096,36,6390853889
1834,19266355,47288,19313643,0,0,0,1536,38,4558680827
1835,19274141,71343,19345484,0,3,0,9216,4,8829398522
1836,19300394,98384,19398778,0,9,0,23040,20,7149875986
1837,19312220,114608,19426828,0,1,0,76288,36,9038474452
1838,19325754,43904,19369658,0,7,0,512,41,10735687022
1839,19326668,55748,19382416,0,3,0,4096,4,9434975584
1840,19336612,43904,19380516,0,6,0,512,42,292031393
1841,19340437,43904,19384341,0,7,0,512,41,6588426141
1842,19357689,2470,19360159,0,9,1,2560,20,10138352611
1843,19370036,1994,19372030,0,8,1,2048,27,2552606824
1844,19375454,6229,19381683,0,9,1,15360,20,7124655252
1845,19376549,1042,19377591,0,3,1,1024,4,7696787716
1846,19385110,5454,19390564,0,3,1,13824,4,4422256827
1847,19392988,100100,19493088,0,0,0,28672,38,9258861560
1848,19400778,47288,19448066,0,5,0,1536,46,10462613937
1849,19403434,1042,19404476,0,9,1,1024,20,4815123203
1850,19417683,45596,19463279,0,6,0,1024,42,9318046534
1851,19433530,1042,19434572,0,9,1,1024,20,5841241172
1852,19439796,1994,19441790,0,9,1,2048,20,8860649362
1853,19472103,3645,19475748,0,9,1,10240,20,6486436052
1854,19478727,103376,19582103,0,3,0,39424,4,2325545141
1855,19481272,101002,19582274,0,3,0,512,4,1313253093
1856,19490409,3387,19493796,0,9,1,9728,20,2821615389
1857,19501896,43904,19545800,0,7,0,512,41,10446623131
1858,19541500,100724,19642224,0,5,0,30720,46,1069138802
1859,19546298,43904,19590202,0,7,0,512,41,3509451293
1860,19549339,101110,19650449,0,3,0,30720,4,9876169679
1861,19557539,7230,19564769,0,9,1,7680,20,7629200621
1862,19588913,3422,19592335,0,8,1,3584,27,5056985060
1863,19592204,11533,19603737,0,9,1,18944,20,1580307010
1864,19609078,5326,19614404,0,3,1,5632,4,8130545281
1865,19638977,101816,19740793,0,1,0,34304,36,7381885822
1866,19654705,5454,19660159,0,9,1,13824,20,8345460117
1867,19661163,2946,19664109,0,3,1,3072,4,133745796
1868,19661250,2470,19663720,0,9,1,2560,20,6995864166
1869,19671809,43904,19715713,0,7,0,512,41,3529742810
1870,19712985,74852,19787837,0,9,0,16384,20,661944626
1871,19734762,74360,19809122,0,3,0,9728,4,5324545991
1872,19740244,43904,19784148,0,7,0,512,41,151742245
1873,19743632,87896,19831528,0,1,0,13824,36,3985170303
1874,19749293,2470,19751763,0,9,1,2560,20,2912149390
1875,19759947,134463,19894410,0,3,0,31232,4,6683863204
1876,19769576,3422,19772998,0,4,1,3584,21,5468496563
1877,19783205,2470,19785675,0,4,1,2560,21,8775261640
1878,19783984,115076,19899060,0,0,0,77824,38,7410502048
1879,19794382,566,19794948,0,3,1,512,4,9138788802
1880,19820931,2946,19823877,0,3,1,3072,4,9980978922
1881,19834883,3128,19838011,0,4,1,9216,21,9187401341
1882,19840592,104312,19944904,0,1,0,42496,36,2550765486
1883,19842845,5802,19848647,0,9,1,6144,20,8272850816
1884,19846838,4715,19851553,0,9,1,4608,20,7119130780
1885,19855014,566,19855580,0,4,1,512,21,7909214496
1886,19856524,566,19857090,0,9,1,512,20,3511587832
1887,19860952,103220,19964172,0,5,0,38912,46,5836012455
1888,19867318,102344,19969662,0,3,0,13824,4,4428855644
1889,19880331,34300,19914631,0,0,1,30208,38,7664330996
1890,19894531,60824,19955355,0,9,0,5632,20,4776209408
1891,19931740,47288,19979028,0,7,0,1536,41,9944497028
1892,19941348,103688,20045036,0,3,0,40448,4,1704871642
1893,19948001,1518,19949519,0,8,1,1536,27,10629960129
1894,19996937,7230,20004167,0,4,1,7680,21,7818407811
1895,19996947,5326,20002273,0,5,1,5632,46,8255491005
1896,20001671,45596,20047267,0,5,0,1024,46,4519225392
1897,20017368,2470,20019838,0,3,1,2560,4,6789490176
1898,20022848,109616,20132464,0,0,0,59904,38,9178492303
1899,20028075,119118,20147193,0,3,0,49664,4,7886243053
1900,20030777,1518,20032295,0,9,1,1536,20,5325032868
1901,20040380,7706,20048086,0,5,1,8192,46,2921046397
1902,20041021,9245,20050266,0,3,1,13312,4,1076737772
1903,20043194,11644,20054838,0,3,1,14336,4,1401336523
1904,20044883,12985,20057868,0,3,1,4608,4,160143091
1905,20046617,3735,20050352,0,5,1,3584,46,9344400967
1906,20062118,4850,20066968,0,5,1,5120,46,4203863425
1907,20073918,101192,20175110,0,1,0,32256,36,10481060569
1908,20079490,180813,20260303,0,3,0,20992,4,4501371254
1909,20096749,99476,20196225,0,9,0,26624,20,16135822
1910,20101571,1042,20102613,0,5,1,1024,46,3615238140
1911,20107011,566,20107577,0,9,1,512,20,4137594028
1912,20134856,100724,20235580,0,5,0,30720,46,5338671030
1913,20137188,43904,20181092,0,6,0,512,42,2593920430
1914,20163521,3904,20167425,0,4,1,10752,21,2383599141
1915,20170988,94083,20265071,0,0,1,153088,38,7443358222
1916,20187841,64392,20252233,0,6,0,1024,42,6927542578
1917,20205271,60786,20266057,0,0,1,1536,38,2665611580
1918,20206476,2946,20209422,0,3,1,3072,4,6139232861
1919,20206637,43904,20250541,0,6,0,512,42,7510935452
1920,20209579,2470,20212049,0,9,1,2560,20,8433283962
1921,20221390,3645,20225035,0,2,1,10240,8,1437183429
1922,20243155,28087,20271242,0,0,1,24576,38,6231966057
1923,20251527,43904,20295431,0,7,0,512,41,9229442166
1924,20255267,43904,20299171,0,7,0,512,41,2911831151
1925,20261134,57440,20318574,0,3,0,4608,4,9580511004
1926,20262833,113360,20376193,0,5,0,72192,46,835469922
1927,20269101,45596,20314697,0,7,0,1024,41,10047766787
1928,20269181,45843,20315024,0,7,0,1024,41,7181511312
1929,20276065,7706,20283771,0,4,1,8192,21,1388076142
1930,20282141,1994,20284135,0,2,1,2048,8,8122857015
1931,20299743,43904,20343647,0,6,0,512,42,9349432457
1932,20308487,2470,20310957,0,5,1,2560,46,1739111311
1933,20316852,47288,20364140,0,7,0,1536,41,5212650308
1934,20318367,1994,20320361,0,2,1,2048,8,8193455804
1935,20319822,45596,20365418,0,6,0,1024,42,8970996246
1936,20328473,54056,20382529,0,7,0,3584,41,2988042224
1937,20333647,3898,20337545,0,0,1,4096,38,352731237
1938,20337261,4850,20342111,0,3,1,5120,4,4044565596
1939,20343476,3422,20346898,0,2,1,3584,8,5376150084
1940,20343566,49053,20392619,0,6,0,2048,42,7331492228
1941,20346116,3387,20349503,0,4,1,9728,21,1353777370
1942,20346164,112112,20458276,0,1,0,68096,36,821294328
1943,20361170,63191,20424361,0,0,1,102912,38,1966041274
1944,20366338,10413,20376751,0,5,1,512,46,8804796469
1945,20367230,48980,20416210,0,7,0,2048,41,9296872816
1946,20370071,45596,20415667,0,6,0,1024,42,9080950981
1947,20370104,4420,20374524,0,4,1,11776,21,3156303966
1948,20375551,3422,20378973,0,2,1,3584,8,6691614972
1949,20380513,43904,20424417,0,6,0,512,42,1580093313
1950,20396570,48682,20445252,0,0,1,75264,38,5059931105
1951,20400827,57932,20458759,0,1,0,1536,36,1223056635
1952,20406655,43904,20450559,0,7,0,512,41,8983193124
1953,20423663,43628,20467291,0,0,1,74752,38,184763041
1954,20438511,5971,20444482,0,3,1,14848,4,5472215889
1955,20451180,359327,20810507,0,0,0,62464,38,10712110466
1956,20460004,43904,20503908,0,6,0,512,42,9249251287
1957,20466769,122720,20589489,0,0,0,102912,38,1720884680
1958,20491799,1518,20493317,0,5,1,1536,46,2271489860
1959,20494700,1042,20495742,0,4,1,1024,21,10229870510
1960,20510434,1042,20511476,0,5,1,1024,46,9336575496
1961,20522194,1518,20523712,0,5,1,1536,46,2857552873
1962,20535948,2470,20538418,0,4,1,2560,21,7015739677
1963,20537767,1994,20539761,0,2,1,2048,8,10599205843
1964,20541686,1042,20542728,0,2,1,1024,8,9976574853
1965,20541949,54680,20596629,0,3,0,5632,4,71448572
1966,20572179,47288,20619467,0,6,0,1536,42,118096534
1967,20574002,1042,20575044,0,2,1,1024,8,602158445
1968,20594753,1994,20596747,0,4,1,2048,21,2796056801
1969,20598068,148677,20746745,0,0,0,66048,38,8890584248
1970,20605731,3128,20608859,0,5,1,9216,46,10158834629
1971,20612074,566,20612640,0,4,1,512,21,9433451265
1972,20642475,20624,20663099,0,0,1,33280,38,977574801
1973,20648926,4162,20653088,0,3,1,11264,4,3774304963
1974,20649304,10333,20659637,0,3,1,7680,4,8649514719
1975,20659940,119912,20779852,0,5,0,93696,46,6204596479
1976,20671796,159734,20831530,0,5,0,35328,46,8963559007
1977,20673777,68840,20742617,0,3,0,11776,4,10631375116
1978,20690341,99262,20789603,0,0,0,11776,38,4373514363
1979,20692360,3898,20696258,0,9,1,4096,20,2824856418
1980,20694859,4420,20699279,0,5,1,11776,46,4434833061
1981,20737882,1042,20738924,0,4,1,1024,21,440503262
1982,20743060,3422,20746482,0,3,1,3584,4,4414273066
1983,20747024,54056,20801080,0,6,0,3584,42,506301994
1984,20761768,48980,20810748,0,7,0,2048,41,140068577
1985,20767498,1042,20768540,0,3,1,1024,4,4369706135
1986,20777293,5454,20782747,0,0,1,13824,38,7043022486
1987,20786916,3128,20790044,0,9,1,9216,20,5608678714
1988,20795040,3898,20798938,0,4,1,4096,21,5055188021
1989,20829721,5326,20835047,0,3,1,5632,4,9426062561
1990,20833532,3898,20837430,0,5,1,4096,46,4643396894
1991,20851893,1994,20853887,0,4,1,2048,21,5077148780
1992,20857381,3904,20861285,0,4,1,10752,21,1965027685
1993,20862786,1994,20864780,0,4,1,2048,21,6233020403
1994,20871674,116012,20987686,0,3,0,80896,4,401335610
1995,20877102,43904,20921006,0,6,0,512,42,6007189853
1996,20886836,5802,20892638,0,5,1,6144,46,6661397828
1997,20887491,240086,21127577,0,5,0,94208,46,8131298739
1998,20901811,20366,20922177,0,2,1,32768,8,3507497574
1999,20907157,133928,21041085,0,5,0,37888,46,9970635453
2000,20911000,5454,20916454,0,9,1,13824,20,5182379063
2001,20917422,91640,21009062,0,0,0,26112,38,1267651176
2002,20950041,127283,21077324,0,0,0,32256,38,2673208004
2003,20951236,120426,21071662,0,3,0,56832,4,9054320624
2004,20951536,3898,20955434,0,9,1,4096,20,7492904718
2005,20966737,45596,21012333,0,7,0,1024,41,2125590509
2006,20982174,1518,20983692,0,5,1,1536,46,4464617387
2007,21014246,48980,21063226,0,6,0,2048,42,7621605453
2008,21021936,4850,21026786,0,7,1,5120,41,6355635179
2009,21039537,5438,21044975,0,5,1,4096,46,7057356916
2010,21049405,113516,21162921,0,3,0,72704,4,3982623891
2011,21052623,60824,21113447,0,1,0,5632,36,656992548
2012,21059250,1042,21060292,0,5,1,1024,46,10451505941
2013,21090608,4374,21094982,0,9,1,4608,20,1183817498
2014,21119373,65900,21185273,0,0,0,7168,38,5141657640
2015,21129671,110708,21240379,0,0,0,63488,38,9252760208
2016,21132379,223434,21355813,0,0,0,138752,38,702847408
2017,21149266,1994,21151260,0,4,1,2048,21,5976064531
2018,21155703,220924,21376627,0,0,0,49664,38,2845385015
2019,21162988,43904,21206892,0,6,0,512,42,3081824230
2020,21183274,3898,21187172,0,5,1,4096,46,2539809319
2021,21189263,2946,21192209,0,9,1,3072,20,9918260502
2022,21208244,64208,21272452,0,1,0,6656,36,3483147076
2023,21226491,45596,21272087,0,6,0,1024,42,7351014740
2024,21232992,144184,21377176,0,1,0,50688,36,7043393132
2025,21238109,1042,21239151,0,6,1,1024,42,4365857537
2026,21262308,62516,21324824,0,5,0,6144,46,4322300114
2027,21276069,45596,21321665,0,6,0,1024,42,3522720786
2028,21304741,6754,21311495,0,5,1,7168,46,4752851498
2029,21310948,566,21311514,0,4,1,512,21,2628968473
2030,21334680,43904,21378584,0,7,0,512,41,7597275233
2031,21352781,110396,21463177,0,1,0,62464,36,9935366883
2032,21377782,21399,21399181,0,5,1,34816,46,3578457799
2033,21399202,43904,21443106,0,7,0,512,41,7562464209
2034,21408770,137753,21546523,0,1,0,108032,36,3474904841
2035,21423854,47288,21471142,0,6,0,1536,42,1308381613
2036,21435785,57203,21492988,0,6,0,1536,42,6165307910
2037,21449992,5802,21455794,0,5,1,6144,46,7730401427
2038,21466671,7230,21473901,0,5,1,7680,46,3102597356
2039,21469334,2946,21472280,0,4,1,3072,21,9502850422
2040,21471515,2946,21474461,0,9,1,3072,20,3829415931
2041,21472315,45908,21518223,0,5,0,2048,46,1740351838
2042,21472793,4420,21477213,0,4,1,11776,21,9947984034
2043,21481189,3645,21484834,0,7,1,10240,41,1683453247
2044,21481274,84668,21565942,0,0,0,13312,38,9506578723
2045,21486083,3422,21489505,0,4,1,3584,21,1626826834
2046,21490943,566,21491509,0,5,1,512,46,4293327696
2047,21502817,47132,21549949,0,0,0,1024,38,4616811597
2048,21507609,152443,21660052,0,0,0,94208,38,6972457716
2049,21529934,1994,21531928,0,4,1,2048,21,651344293
2050,21538146,183702,21721848,0,5,0,124928,46,6015738479
2051,21565057,1518,21566575,0,5,1,1536,46,4443429891
2052,21575079,248223,21823302,0,5,0,68608,46,4724710811
2053,21575880,165012,21740892,0,5,0,26112,46,1958022870
2054,21578684,76052,21654736,0,3,0,10240,4,1354509665
2055,21629306,4162,21633468,0,2,1,11264,8,8360533876
2056,21650455,11791,21662246,0,5,1,19456,46,8189412692
2057,21664981,3128,21668109,0,5,1,9216,46,348038210
2058,21698766,23725,21722491,0,8,1,39424,27,2289943704
2059,21701878,45596,21747474,0,6,0,1024,42,9850332890
2060,21704517,115232,21819749,0,3,0,78336,4,4477738239
2061,21715464,8846,21724310,0,5,1,2560,46,4279547674
2062,21723626,3898,21727524,0,5,1,4096,46,9204244649
2063,21729354,99476,21828830,0,1,0,26624,36,2940975484
2064,21735208,45596,21780804,0,7,0,1024,41,7293491220
2065,21736351,114122,21850473,0,5,0,50176,46,1264470550
2066,21825515,2470,21827985,0,8,1,2560,27,6687978131
2067,21838928,4162,21843090,0,8,1,11264,27,3297742257
2068,21865826,62516,21928342,0,0,0,6144,38,948265127
2069,21866224,105872,21972096,0,3,0,47616,4,6378226852
2070,21869199,5802,21875001,0,5,1,6144,46,1916820678
2071,21875094,4850,21879944,0,8,1,5120,27,5739396319
2072,21883485,107744,21991229,0,0,0,53760,38,9378314008
2073,21889905,50672,21940577,0,3,0,2560,4,10450564199
2074,21891034,566,21891600,0,8,1,512,27,5562586759
2075,21903721,43904,21947625,0,6,0,512,42,9106387353
2076,21914482,3422,21917904,0,8,1,3584,27,5376836311
2077,21921287,84804,22006091,0,0,0,5632,38,6832458776
2078,21929005,168076,22097081,0,0,0,76288,38,1264071952
2079,21940373,4850,21945223,0,8,1,5120,27,5744894627
2080,21943155,52364,21995519,0,7,0,3072,41,107250705
2081,21945586,3904,21949490,0,4,1,10752,21,6347932608
2082,21963663,77109,22040772,0,3,0,11264,4,5593430159
2083,21963775,140965,22104740,0,0,0,25088,38,8071485533
2084,21965225,566,21965791,0,5,1,512,46,5582228474
2085,22016983,5802,22022785,0,8,1,6144,27,5300272509
2086,22029075,4374,22033449,0,8,1,4608,27,650775830
2087,22029591,5164,22034755,0,8,1,2048,27,7289598417
2088,22034786,161397,22196183,0,0,0,42496,38,4574400387
2089,22037570,5802,22043372,0,8,1,6144,27,93060658
2090,22060437,2946,22063383,0,4,1,3072,21,2666699364
2091,22083070,105560,22188630,0,3,0,46592,4,10620511824
2092,22087278,145926,22233204,0,3,0,45568,4,986172827
2093,22103519,5326,22108845,0,4,1,5632,21,4974389916
2094,22128750,43904,22172654,0,5,0,512,46,65142519
2095,22130927,4374,22135301,0,5,1,4608,46,5798475160
2096,22131834,5326,22137160,0,4,1,5632,21,6381519761
2097,22157374,566,22157940,0,4,1,512,21,2273131561
2098,22159572,6754,22166326,0,4,1,7168,21,2501729831
2099,22164596,120068,22284664,0,0,0,94208,38,9345468689
2100,22173104,156344,22329448,0,0,0,79872,38,10629542103
2101,22219307,1042,22220349,0,5,1,1024,46,1665073571
2102,22235968,1994,22237962,0,5,1,2048,46,10222617742
2103,22268660,2946,22271606,0,5,1,3072,46,131695080
2104,22297149,43904,22341053,0,6,0,512,42,1131609536
2105,22299188,43904,22343092,0,7,0,512,41,8047988990
2106,22320414,100724,22421138,0,1,0,30720,36,6344861533
2107,22340333,5196,22345529,0,4,1,13312,21,2215815499
2108,22350179,43904,22394083,0,6,0,512,42,8949748610
2109,22359768,118352,22478120,0,1,0,88576,36,2191591590
2110,22373047,3898,22376945,0,5,1,4096,46,3832685163
2111,22385726,3898,22389624,0,5,1,4096,46,5173045591
2112,22386705,123500,22510205,0,0,0,105472,38,3370562326
2113,22387153,1042,22388195,0,9,1,1024,20,8253350894
2114,22390735,10757,22401492,0,4,1,17408,21,5133009440
2115,22461876,116324,22578200,0,3,0,81920,4,5266472076
2116,22471535,122633,22594168,0,5,0,68608,46,9820614852
2117,22475847,1994,22477841,0,5,1,2048,46,8450807528
2118,22481537,5802,22487339,0,5,1,6144,46,5112553727
2119,22486192,161782,22647974,0,3,0,82944,4,4927182473
2120,22497099,71318,22568417,0,0,0,7168,38,10362841878
2121,22504660,111434,22616094,0,0,0,47616,38,3057563708
2122,22505602,45596,22551198,0,6,0,1024,42,8705520164
2123,22517468,47288,22564756,0,7,0,1536,41,8819331113
2124,22525792,6754,22532546,0,5,1,7168,46,9764481086
2125,22528242,4650,22532892,0,5,1,512,46,253515734
2126,22611697,43904,22655601,0,7,0,512,41,10415390305
2127,22637660,1994,22639654,0,9,1,2048,20,4262698136
2128,22640688,2870,22643558,0,9,1,8704,20,2830373869
2129,22645055,52832,22697887,0,7,0,4608,41,3778485020
2130,22650675,63514,22714189,0,7,0,1536,41,2924924808
2131,22673801,43904,22717705,0,7,0,512,41,6994370913
2132,22678230,50672,22728902,0,1,0,2560,36,8855593188
2133,22681938,45596,22727534,0,6,0,1024,42,462306932
2134,22689265,43904,22733169,0,3,0,512,4,7886132377
2135,22701194,1518,22702712,0,9,1,1536,20,7779695957
2136,22706953,5712,22712665,0,9,1,14336,20,6387001216
2137,22710379,107120,22817499,0,0,0,51712,38,4976531033
2138,22716636,43904,22760540,0,6,0,512,42,8999012135
2139,22743589,1042,22744631,0,9,1,1024,20,5715140930
2140,22745803,7230,22753033,0,9,1,7680,20,3374727804
2141,22754552,5196,22759748,0,9,1,13312,20,7725684297
2142,22781628,1518,22783146,0,5,1,1536,46,8775053654
2143,22797941,2470,22800411,0,9,1,2560,20,5668260622
2144,22821231,112112,22933343,0,3,0,68096,4,9713606661
2145,22821932,3898,22825830,0,4,1,4096,21,1052029206
2146,22824202,6229,22830431,0,5,1,15360,46,9050456996
2147,22838758,43904,22882662,0,6,0,512,42,230825384
2148,22856641,1042,22857683,0,4,1,1024,21,10002657674
2149,22856965,566,22857531,0,5,1,512,46,9867116768
2150,22875539,3422,22878961,0,4,1,3584,21,5631876993
2151,22881179,101660,22982839,0,3,0,33792,4,84322698
2152,22883864,6278,22890142,0,7,1,6656,41,4114988560
2153,22886103,2470,22888573,0,5,1,2560,46,7718578999
2154,22893076,153537,23046613,0,3,0,65536,4,3472041523
2155,22910481,566,22911047,0,6,1,512,42,946783289
2156,22920773,12995,22933768,0,7,1,25088,41,8136942296
2157,22921262,4850,22926112,0,4,1,5120,21,10282345877
2158,22924961,193088,23118049,0,1,0,172544,36,9341021642
2159,22932937,101504,23034441,0,0,0,33280,38,4764836522
2160,22936058,54056,22990114,0,6,0,3584,42,3107376134
2161,22948040,43904,22991944,0,7,0,512,41,8773767571
2162,22975063,566,22975629,0,7,1,512,41,8060292738
2163,22975720,116324,23092044,0,0,0,81920,38,1673309455
2164,22987868,2470,22990338,0,4,1,2560,21,3694967657
2165,22994209,1994,22996203,0,7,1,2048,41,977421615
2166,23003790,115678,23119468,0,1,0,4608,36,101273488
2167,23012861,156321,23169182,0,5,0,32256,46,8131106424
2168,23027118,236118,23263236,0,0,0,182784,38,2556737419
2169,23035422,57236,23092658,0,7,0,512,41,1412186889
2170,23041822,1994,23043816,0,5,1,2048,46,7221557933
2171,23085938,141266,23227204,0,1,0,53760,36,8336041434
2172,23089830,1994,23091824,0,6,1,2048,42,3777183034
2173,23108322,10241,23118563,0,7,1,16384,41,3535096939
2174,23119171,45596,23164767,0,6,0,1024,42,3147108294
2175,23143297,1994,23145291,0,7,1,2048,41,1542432037
2176,23165256,145290,23310546,0,0,0,110080,38,10486022158
2177,23174875,5802,23180677,0,7,1,6144,41,3305546774
2178,23175075,3422,23178497,0,5,1,3584,46,7985811203
2179,23180344,566,23180910,0,6,1,512,42,10004719880
2180,23182304,1518,23183822,0,5,1,1536,46,446211245
2181,23200809,43904,23244713,0,6,0,512,42,345950129
2182,23213154,101036,23314190,0,5,0,31744,46,6448745111
2183,23213497,1994,23215491,0,7,1,2048,41,9402161504
2184,23217809,84707,23302516,0,1,0,17920,36,7147818252
2185,23251413,52364,23303777,0,7,0,3072,41,8566047663
2186,23251820,5802,23257622,0,6,1,6144,42,7371937800
2187,23270496,101660,23372156,0,5,0,33792,46,8989131340
2188,23285595,51141,23336736,0,5,0,3584,46,1603401756
2189,23299017,2470,23301487,0,6,1,2560,42,424714467
2190,23327011,43904,23370915,0,6,0,512,42,7798026057
2191,23340588,43904,23384492,0,3,0,512,4,9264375838
2192,23344386,103242,23447628,0,1,0,38912,36,2731802103
2193,23353733,142849,23496582,0,1,0,22016,36,7330929703
2194,23364428,52520,23416948,0,1,0,3584,36,4619384280
2195,23389179,169173,23558352,0,1,0,52224,36,2851639850
2196,23408596,45596,23454192,0,7,0,1024,41,229557647
2197,23427118,47288,23474406,0,6,0,1536,42,841876108
2198,23438135,93908,23532043,0,5,0,18432,46,3402709729
2199,23452254,10241,23462495,0,7,1,16384,41,5014185603
2200,23467603,1994,23469597,0,6,1,2048,42,10601341297
2201,23479476,11016,23490492,0,6,1,17920,42,5208020760
2202,23498497,61118,23559615,0,1,0,4096,36,2542743519
2203,23527632,114140,23641772,0,0,0,74752,38,5280889953
2204,23548625,52364,23600989,0,6,0,3072,42,5665231375
2205,23584888,43904,23628792,0,7,0,512,41,3521938950
2206,23615787,107276,23723063,0,5,0,52224,46,3573456671
2207,23620643,43904,23664547,0,6,0,512,42,7895880582
2208,23627763,6278,23634041,0,6,1,6656,42,6280830378
2209,23684854,3128,23687982,0,4,1,9216,21,3566436889
2210,23692567,121336,23813903,0,5,0,50688,46,203141555
2211,23700685,43904,23744589,0,3,0,512,4,1474983609
2212,23708429,566,23708995,0,4,1,512,21,3245410792
2213,23710986,106584,23817570,0,6,0,1024,42,871744233
2214,23723548,45596,23769144,0,6,0,1024,42,3169694156
2215,23746258,112268,23858526,0,1,0,68608,36,453329284
2216,23767949,43904,23811853,0,6,0,512,42,8545747747
2217,23778116,49604,23827720,0,5,0,4096,46,347905980
2218,23799759,45596,23845355,0,6,0,1024,42,10729692742
2219,23801600,1994,23803594,0,6,1,2048,42,715104400
2220,23849385,2870,23852255,0,6,1,8704,42,6352829412
2221,23852783,4850,23857633,0,8,1,5120,27,7138690990
2222,23872188,92708,23964896,0,5,0,24576,46,6110399457
2223,23887993,43904,23931897,0,6,0,512,42,5332902123
2224,23897940,45596,23943536,0,6,0,1024,42,3663892755
2225,23913896,4850,23918746,0,6,1,5120,42,1753630141
2226,23930489,131325,24061814,0,5,0,114688,46,4807925042
2227,23941177,50672,23991849,0,0,0,2560,38,6074963370
2228,23951835,102596,24054431,0,0,0,36864,38,9946358130
2229,23953219,175249,24128468,0,5,0,105472,46,1154062259
2230,23961383,5326,23966709,0,6,1,5632,42,4135482756
2231,23977365,4420,23981785,0,6,1,11776,42,2542961813
2232,23982339,103658,24085997,0,0,0,13312,38,7430771055
2233,23986191,45596,24031787,0,7,0,1024,41,4139738018
2234,24009417,125896,24135313,0,5,0,7168,46,2301033295
2235,24017106,2870,24019976,0,6,1,8704,42,3091441730
2236,24030037,47288,24077325,0,3,0,1536,4,7599697784
2237,24033445,57440,24090885,0,8,0,4608,27,4394129568
2238,24040401,80684,24121085,0,1,0,15360,36,585510648
2239,24053569,2470,24056039,0,6,1,2560,42,2781902778
2240,24098694,43904,24142598,0,3,0,512,4,6923567219
2241,24110057,45596,24155653,0,7,0,1024,41,10708273646
2242,24111211,62098,24173309,0,6,0,1024,42,6031339530
2243,24122503,49292,24171795,0,3,0,3072,4,4637549338
2244,24126769,2946,24129715,0,6,1,3072,42,9184577465
2245,24129064,52364,24181428,0,6,0,3072,42,474392143
2246,24164966,108212,24273178,0,0,0,55296,38,2070905898
2247,24176871,7706,24184577,0,7,1,8192,41,9453384955
2248,24195663,101036,24296699,0,8,0,31744,27,2221522063
2249,24214077,45596,24259673,0,3,0,1024,4,10099717267
2250,24237657,139309,24376966,0,0,0,96256,38,10164308275
2251,24243636,106184,24349820,0,8,0,48640,27,7511101246
2252,24283043,100724,24383767,0,5,0,30720,46,6312345257
2253,24311211,79928,24391139,0,1,0,17920,36,6752990159
2254,24318806,167827,24486633,0,8,0,95232,27,1657570468
2255,24325975,64076,24390051,0,8,0,11264,27,4039907028
2256,24335814,5802,24341616,0,6,1,6144,42,1220117332
2257,24346424,67592,24414016,0,5,0,7680,46,811570016
2258,24360443,43904,24404347,0,3,0,512,4,4454203412
2259,24383890,126653,24510543,0,8,0,11264,27,8078797529
2260,24384328,148204,24532532,0,8,0,69120,27,3335533349
2261,24387312,106652,24493964,0,5,0,50176,46,74960900
2262,24422093,49604,24471697,0,3,0,4096,4,5254245466
2263,24433717,2470,24436187,0,6,1,2560,42,7014165908
2264,24454678,48980,24503658,0,7,0,2048,41,2298802481
2265,24459100,111176,24570276,0,0,0,65024,38,5153277106
2266,24475400,4374,24479774,0,6,1,4608,42,9341736440
2267,24485549,99711,24585260,0,5,0,19968,46,10599100432
2268,24493139,43904,24537043,0,7,0,512,41,7511519604
2269,24527726,50672,24578398,0,7,0,2560,41,10592851080
2270,24531277,5454,24536731,0,1,1,13824,36,7633311608
2271,24537882,3128,24541010,0,6,1,9216,42,10436023112
2272,24551113,45908,24597021,0,7,0,2048,41,4935142748
2273,24653614,1518,24655132,0,6,1,1536,42,8137692276
2274,24672466,59600,24732066,0,1,0,6656,36,3192905269
2275,24676533,111219,24787752,0,1,0,16896,36,2872735251
2276,24682848,566,24683414,0,1,1,512,36,667881405
2277,24686754,95312,24782066,0,0,0,23040,38,4480237967
2278,24731363,43904,24775267,0,3,0,512,4,7579671019
2279,24735087,43904,24778991,0,7,0,512,41,8949148861
2280,24747662,93752,24841414,0,8,0,17920,27,2899941530
2281,24749869,45596,24795465,0,3,0,1024,4,6948877300
2282,24759675,6278,24765953,0,6,1,6656,42,1655557456
2283,24768718,64502,24833220,0,1,0,2560,36,1936822374
2284,24784361,110084,24894445,0,0,0,61440,38,6838174847
2285,24789752,125831,24915583,0,0,0,8704,38,5388421098
2286,24800256,138193,24938449,0,0,0,44544,38,1667536005
2287,24845184,566,24845750,0,6,1,512,42,4599015562
2288,24846124,1042,24847166,0,1,1,1024,36,1652500560
2289,24871228,13858,24885086,0,6,1,23552,42,3080273499
2290,24895753,84512,24980265,0,8,0,12800,27,7787676769
2291,24921743,5802,24927545,0,6,1,6144,42,351246709
2292,24940063,45596,24985659,0,7,0,1024,41,6313795669
2293,24970100,117572,25087672,0,0,0,86016,38,6414107235
2294,24974933,1042,24975975,0,6,1,1024,42,2066247086
2295,24992181,3422,24995603,0,6,1,3584,42,3553639156
2296,25021326,147982,25169308,0,0,0,54272,38,5714471089
2297,25026703,45596,25072299,0,7,0,1024,41,4533022249
2298,25028491,45596,25074087,0,7,0,1024,41,4280782255
2299,25061684,119756,25181440,0,8,0,93184,27,10620105740
2300,25104698,1042,25105740,0,1,1,1024,36,10195186748
2301,25105834,6754,25112588,0,6,1,7168,42,1102490477
2302,25145625,43904,25189529,0,3,0,512,4,2590710010
2303,25162089,4374,25166463,0,3,1,4608,4,6377724596
2304,25225932,7230,25233162,0,6,1,7680,42,1380542171
2305,25227878,4374,25232252,0,1,1,4608,36,8729506632
2306,25265512,67772,25333284,0,1,0,13312,36,2305700689
2307,25300368,47288,25347656,0,7,0,1536,41,6974641492
2308,25315070,2470,25317540,0,1,1,2560,36,1099223199
2309,25315402,5044,25320446,0,1,1,4608,36,5826737579
2310,25327285,101816,25429101,0,0,0,34304,38,9211163710
2311,25345486,6754,25352240,0,6,1,7168,42,1198670027
2312,25349302,1518,25350820,0,3,1,1536,4,4130170278
2313,25368048,4850,25372898,0,1,1,5120,36,2591525085
2314,25378830,60441,25439271,0,0,0,1024,38,9394740814
2315,25392510,4850,25397360,0,3,1,5120,4,255957285
2316,25398837,2870,25401707,0,3,1,8704,4,3290855598
2317,25409731,566,25410297,0,1,1,512,36,4507488888
2318,25411600,48980,25460580,0,7,0,2048,41,3361302400
2319,25423347,76434,25499781,0,0,0,12800,38,10070379819
2320,25456245,2870,25459115,0,6,1,8704,42,2195830763
2321,25467503,1518,25469021,0,1,1,1536,36,9219046932
2322,25494259,1518,25495777,0,3,1,1536,4,2016169505
2323,25497956,12995,25510951,0,3,1,25088,4,1514236623
2324,25511553,153219,25664772,0,1,0,78336,36,8102115147
2325,25522041,45596,25567637,0,7,0,1024,41,6293639496
2326,25522068,2470,25524538,0,1,1,2560,36,3432412073
2327,25524607,2470,25527077,0,3,1,2560,4,10161250714
2328,25530370,566,25530936,0,6,1,512,42,3262648602
2329,25546256,3904,25550160,0,1,1,10752,36,540740332
2330,25556792,5802,25562594,0,6,1,6144,42,7452571946
2331,25556927,89588,25646515,0,9,0,14336,20,7626062048
2332,25564320,124390,25688710,0,1,0,10240,36,6196809937
2333,25577910,67713,25645623,0,3,0,1536,4,6317042911
2334,25588954,3904,25592858,0,3,1,10752,4,425208027
2335,25589320,7350,25596670,0,3,1,4608,4,3358168862
2336,25590162,7174,25597336,0,3,1,1024,4,845400596
2337,25596048,43904,25639952,0,7,0,512,41,6854189881
2338,25616159,1042,25617201,0,3,1,1024,4,2783604052
2339,25617507,75031,25692538,0,1,0,7680,36,6714743072
2340,25619175,105560,25724735,0,0,0,46592,38,3087814888
2341,25619448,566,25620014,0,3,1,512,4,8098993968
2342,25634666,93579,25728245,0,1,0,7680,36,3859250173
2343,25694108,2946,25697054,0,1,1,3072,36,1784081084
2344,25708524,77744,25786268,0,0,0,10752,38,10661303646
2345,25735111,106340,25841451,0,1,0,49152,36,5488371441
2346,25743034,73136,25816170,0,1,0,10752,36,6591498426
2347,25743457,43904,25787361,0,7,0,512,41,8879350430
2348,25753928,43904,25797832,0,3,0,512,4,6052513381
2349,25780608,2946,25783554,0,6,1,3072,42,166352901
2350,25793373,47288,25840661,0,3,0,1536,4,5759389823
2351,25812102,43904,25856006,0,3,0,512,4,10167296183
2352,25828772,3422,25832194,0,8,1,3584,27,7617033470
2353,25932838,11791,25944629,0,1,1,19456,36,7171112501
2354,25934360,100235,26034595,0,1,0,24576,36,3962391905
2355,25953273,64832,26018105,0,1,0,8704,36,89228316
2356,25954033,1042,25955075,0,3,1,1024,4,2871501647
2357,25970753,45596,26016349,0,3,0,1024,4,4478388390
2358,25972164,3898,25976062,0,3,1,4096,4,2230715089
2359,25999051,54680,26053731,0,0,0,5632,38,6941202105
2360,26012807,5802,26018609,0,1,1,6144,36,10048119456
2361,26058678,242726,26301404,0,1,0,268800,36,7438879154
2362,26073996,4850,26078846,0,6,1,5120,42,8662518563
2363,26136389,177214,26313603,0,1,0,39936,36,10141030501
2364,26166887,7230,26174117,0,6,1,7680,42,4316406316
2365,26174435,1042,26175477,0,3,1,1024,4,5633048801
2366,26177231,1518,26178749,0,3,1,1536,4,894805554
2367,26224153,200091,26424244,0,1,0,47104,36,8873904819
2368,26248014,69735,26317749,0,1,1,11264,36,942124713
2369,26251259,2470,26253729,0,3,1,2560,4,1585663507
2370,26262853,3128,26265981,0,3,1,9216,4,1324164388
2371,26271355,114452,26385807,0,0,0,75776,38,226534861
2372,26293755,158550,26452305,0,0,0,66048,38,130414739
2373,26297051,25422,26322473,0,1,1,13824,36,9070253073
2374,26302730,3898,26306628,0,3,1,4096,4,7066736688
2375,26321860,45596,26367456,0,7,0,1024,41,9332733695
2376,26323495,4162,26327657,0,1,1,11264,36,6446109322
2377,26330131,1994,26332125,0,3,1,2048,4,1527720810
2378,26353106,6278,26359384,0,1,1,6656,36,3937054549
2379,26388090,101679,26489769,0,0,0,15360,38,3465723340
2380,26394715,61346,26456061,0,0,0,512,38,9314491261
2381,26416435,566,26417001,0,6,1,512,42,2943583209
2382,26423276,52753,26476029,0,0,0,512,38,7703768560
2383,26442008,2946,26444954,0,6,1,3072,42,655985631
2384,26487973,45596,26533569,0,7,0,1024,41,2115766516
2385,26501865,43904,26545769,0,3,0,512,4,1243540293
2386,26517830,101972,26619802,0,1,0,34816,36,10424136969
2387,26529687,1994,26531681,0,6,1,2048,42,6516498558
2388,26551778,3898,26555676,0,1,1,4096,36,6950081344
2389,26575572,43904,26619476,0,0,0,512,38,10620576345
2390,26596460,3422,26599882,0,6,1,3584,42,5161270384
2391,26606428,7706,26614134,0,6,1,8192,42,8299954508
2392,26640392,3422,26643814,0,7,1,3584,41,8467843179
2393,26667309,48980,26716289,0,0,0,2048,38,4378183983
2394,26672131,3898,26676029,0,7,1,4096,41,9569609857
2395,26672223,44237,26716460,0,0,0,512,38,254947308
2396,26708750,62516,26771266,0,1,0,6144,36,2556518690
2397,26708803,3904,26712707,0,6,1,10752,42,6959098271
2398,26713530,1518,26715048,0,7,1,1536,41,2075657983
2399,26737826,4850,26742676,0,7,1,5120,41,1427443480
2400,26741004,5971,26746975,0,7,1,14848,41,9039139891
2401,26745963,45596,26791559,0,0,0,1024,38,298187514
2402,26787236,4374,26791610,0,6,1,4608,42,9631325499
2403,26804023,45596,26849619,0,3,0,1024,4,3083578290
2404,26865762,2946,26868708,0,6,1,3072,42,5987506773
2405,26872055,104312,26976367,0,1,0,42496,36,6322057641
2406,26914514,1042,26915556,0,1,1,1024,36,6468626602
2407,26923156,47288,26970444,0,3,0,1536,4,9233304933
2408,26977543,1518,26979061,0,6,1,1536,42,6678867225
2409,27020465,43904,27064369,0,0,0,512,38,9954376845
2410,27042481,45596,27088077,0,3,0,1024,4,4814110047
2411,27044935,3898,27048833,0,1,1,4096,36,4807885928
2412,27048151,5971,27054122,0,1,1,14848,36,6342907811
2413,27060579,566,27061145,0,1,1,512,36,8750314935
2414,27069489,1042,27070531,0,7,1,1024,41,5256546707
2415,27070438,4374,27074812,0,6,1,4608,42,5559867163
2416,27100510,1518,27102028,0,7,1,1536,41,404913251
2417,27111718,3128,27114846,0,1,1,9216,36,1779032936
2418,27127564,3387,27130951,0,7,1,9728,41,10493499446
2419,27131688,566,27132254,0,7,1,512,41,5957950818
2420,27146896,4374,27151270,0,6,1,4608,42,5044282242
2421,27154542,11533,27166075,0,1,1,18944,36,8189203560
2422,27157969,10052,27168021,0,1,1,3072,36,9187521199
2423,27168921,13083,27182004,0,8,1,22016,27,8762144711
2424,27169314,13356,27182670,0,8,1,11264,27,3714481905
2425,27178234,2870,27181104,0,1,1,8704,36,6295732894
2426,27178547,4858,27183405,0,1,1,2560,36,4200474088
2427,27233820,97448,27331268,0,1,0,19968,36,1757961467
2428,27290564,5326,27295890,0,1,1,5632,36,1282023085
2429,27306097,1042,27307139,0,6,1,1024,42,2540601853
2430,27312483,4850,27317333,0,6,1,5120,42,369814722
2431,27327192,43904,27371096,0,0,0,512,38,8852833643
2432,27336556,54056,27390612,0,0,0,3584,38,3363772721
2433,27348302,5802,27354104,0,7,1,6144,41,7951333919
2434,27349712,16613,27366325,0,9,1,32256,20,6970064591
2435,27361304,2870,27364174,0,7,1,8704,41,5493229964
2436,27381401,1042,27382443,0,6,1,1024,42,1141431977
2437,27383192,1994,27385186,0,6,1,2048,42,3408339550
2438,27407620,43904,27451524,0,3,0,512,4,5298832683
2439,27425674,107120,27532794,0,1,0,51712,36,1868251234
2440,27428044,182636,27610680,0,1,0,79360,36,10455274384
2441,27435763,2470,27438233,0,6,1,2560,42,6534185099
2442,27440279,2946,27443225,0,2,1,3072,8,9955046038
2443,27442244,45596,27487840,0,0,0,1024,38,7638272813
2444,27484853,1042,27485895,0,7,1,1024,41,5790363888
2445,27485631,4374,27490005,0,7,1,4608,41,6264090429
2446,27509902,1994,27511896,0,7,1,2048,41,6092963924
2447,27534486,77556,27612042,0,1,0,2048,36,1280035351
2448,27586806,94842,27681648,0,1,0,8704,36,3351919296
2449,27599189,43904,27643093,0,0,0,512,38,173660353
2450,27604891,3422,27608313,0,6,1,3584,42,2333646031
2451,27606653,5802,27612455,0,2,1,6144,8,7096837982
2452,27617069,2470,27619539,0,7,1,2560,41,8077477400
2453,27619759,45596,27665355,0,0,0,1024,38,1293164837
2454,27633672,1042,27634714,0,7,1,1024,41,10380334399
2455,27637816,43904,27681720,0,7,0,512,41,6791922874
2456,27675348,48980,27724328,0,3,0,2048,4,313380950
2457,27729800,54056,27783856,0,7,0,3584,41,5980451500
2458,27736286,116948,27853234,0,1,0,83968,36,8720369767
2459,27770377,47288,27817665,0,3,0,1536,4,8002633199
2460,27781005,7706,27788711,0,9,1,8192,20,9174748746
2461,27783519,895,27784414,0,7,1,512,41,2677647457
2462,27797456,5802,27803258,0,2,1,6144,8,105982324
2463,27847551,11274,27858825,0,2,1,18432,8,9944382421
2464,27855673,1518,27857191,0,9,1,1536,20,2536769207
2465,27923646,43904,27967550,0,7,0,512,41,8244099503
2466,27929520,3898,27933418,0,9,1,4096,20,6432363147
2467,27953431,43904,27997335,0,3,0,512,4,8134588330
2468,27970247,43904,28014151,0,0,0,512,38,6865599260
2469,27970282,7706,27977988,0,7,1,8192,41,7024504912
2470,27978112,43904,28022016,0,2,0,512,8,10550585085
2471,27993349,43904,28037253,0,7,0,512,41,6142719263
2472,28002505,1518,28004023,0,2,1,1536,8,4825514588
2473,28003865,84692,28088557,0,1,0,18432,36,8361395696
2474,28014682,124431,28139113,0,1,0,23040,36,5853827832
2475,28018198,4374,28022572,0,2,1,4608,8,46485222
2476,28020840,6278,28027118,0,2,1,6656,8,8221009818
2477,28021109,49104,28070213,0,2,0,1536,8,4729189234
2478,28038200,43904,28082104,0,7,0,512,41,4570287341
2479,28042440,112756,28155196,0,1,0,52736,36,5954844962
2480,28045941,43904,28089845,0,7,0,512,41,4689271906
2481,28055062,43904,28098966,0,7,0,512,41,7814302398
2482,28061441,2946,28064387,0,9,1,3072,20,8558500776
2483,28099437,43904,28143341,0,2,0,512,8,6117818475
2484,28102354,43904,28146258,0,0,0,512,38,3462117495
2485,28110251,2470,28112721,0,7,1,2560,41,1068808951
2486,28145850,45596,28191446,0,0,0,1024,38,5791937142
2487,28148826,119722,28268548,0,1,0,72192,36,1917707322
2488,28165393,3422,28168815,0,9,1,3584,20,2290721495
2489,28166880,115567,28282447,0,1,0,45568,36,6933752001
2490,28180200,43904,28224104,0,0,0,512,38,6153835617
2491,28190845,1518,28192363,0,3,1,1536,4,10526718373
2492,28196454,43904,28240358,0,0,0,512,38,6513576592
2493,28209586,5802,28215388,0,7,1,6144,41,15766643
2494,28226246,43904,28270150,0,0,0,512,38,6064005201
2495,28293662,5326,28298988,0,7,1,5632,41,10032297028
2496,28319010,45596,28364606,0,0,0,1024,38,4802274805
2497,28331268,43904,28375172,0,2,0,512,8,1398449004
2498,28349590,5196,28354786,0,2,1,13312,8,2952690228
2499,28423924,5802,28429726,0,3,1,6144,4,4445057683
2500,28428367,11274,28439641,0,7,1,18432,41,5495262136
2501,28463118,48980,28512098,0,3,0,2048,4,2838246921
2502,28465197,4850,28470047,0,7,1,5120,41,10625347611
2503,28479754,4374,28484128,0,7,1,4608,41,2738369131
2504,28489355,1042,28490397,0,9,1,1024,20,6192109481
2505,28511206,2946,28514152,0,9,1,3072,20,9949460762
2506,28515734,45596,28561330,0,2,0,1024,8,7869154843
2507,28626003,3645,28629648,0,3,1,10240,4,570763109
2508,28650018,1042,28651060,0,7,1,1024,41,3504597290
2509,28656784,91304,28748088,0,1,0,19968,36,8519284352
2510,28678115,43904,28722019,0,0,0,512,38,1097653127
2511,28683267,43904,28727171,0,3,0,512,4,207980484
2512,28698634,47288,28745922,0,3,0,1536,4,6551949978
2513,28720559,101036,28821595,0,1,0,31744,36,5731901619
2514,28761403,7230,28768633,0,9,1,7680,20,585119007
2515,28771963,1042,28773005,0,4,1,1024,21,1848216221
2516,28772711,4374,28777085,0,7,1,4608,41,7797109315
2517,28778889,5454,28784343,0,9,1,13824,20,4284868871
2518,28794032,1042,28795074,0,2,1,1024,8,3606653985
2519,28794155,5802,28799957,0,4,1,6144,21,5248793256
2520,28802082,50672,28852754,0,2,0,2560,8,4381949942
2521,28804484,2470,28806954,0,3,1,2560,4,2742236130
2522,28807039,6754,28813793,0,4,1,7168,21,5361543988
2523,28816721,45596,28862317,0,3,0,1024,4,5309897209
2524,28821129,1042,28822171,0,9,1,1024,20,8100810153
2525,28831323,1994,28833317,0,3,1,2048,4,5857878271
2526,28842630,6754,28849384,0,3,1,7168,4,6555080613
2527,28845342,1042,28846384,0,9,1,1024,20,1738071228
2528,28861429,12566,28873995,0,7,1,20992,41,8673657099
2529,28877910,43904,28921814,0,2,0,512,8,8025165815
2530,28884803,100724,28985527,0,1,0,30720,36,10357313833
2531,28887008,43904,28930912,0,0,0,512,38,4997923042
2532,28901512,3898,28905410,0,4,1,4096,21,5147558264
2533,28905535,43904,28949439,0,3,0,512,4,3622114164
2534,28909816,1042,28910858,0,7,1,1024,41,5058093684
2535,28933125,4374,28937499,0,7,1,4608,41,7966351872
2536,28943216,6278,28949494,0,7,1,6656,41,6965483284
2537,28948304,1518,28949822,0,4,1,1536,21,10237219034
2538,28983974,47288,29031262,0,3,0,1536,4,8481715213
2539,28996674,50672,29047346,0,0,0,2560,38,7197124856
2540,29001503,5326,29006829,0,9,1,5632,20,6093036479
2541,29010718,566,29011284,0,7,1,512,41,8360703010
2542,29046274,3422,29049696,0,7,1,3584,41,5567993276
2543,29048259,4023,29052282,0,7,1,4096,41,5638545410
2544,29060992,7230,29068222,0,9,1,7680,20,171150098
2545,29071300,7706,29079006,0,4,1,8192,21,781985812
2546,29097019,6754,29103773,0,3,1,7168,4,5620016305
2547,29108354,3422,29111776,0,1,1,3584,36,4106120240
2548,29113799,1994,29115793,0,9,1,2048,20,4958303308
2549,29125855,1518,29127373,0,3,1,1536,4,150931833
2550,29167546,2946,29170492,0,3,1,3072,4,4566767898
2551,29170854,566,29171420,0,9,1,512,20,8295687700
2552,29183772,43904,29227676,0,2,0,512,8,5525332626
2553,29209683,6754,29216437,0,7,1,7168,41,2172799628
2554,29211534,2946,29214480,0,3,1,3072,4,4611567483
2555,29214513,3904,29218417,0,4,1,10752,21,1649212596
2556,29222118,12566,29234684,0,4,1,20992,21,5315710833
2557,29245191,5802,29250993,0,7,1,6144,41,6652347807
2558,29268395,79118,29347513,0,3,0,2560,4,5178710776
2559,29312429,1994,29314423,0,5,1,2048,46,5129271253
2560,29319997,48980,29368977,0,3,0,2048,4,3492881420
2561,29325042,566,29325608,0,3,1,512,4,7874348055
2562,29325477,43904,29369381,0,2,0,512,8,607227718
2563,29325639,60108,29385747,0,3,0,512,4,466013747
2564,29340280,566,29340846,0,7,1,512,41,1043943960
2565,29355781,100256,29456037,0,1,0,29184,36,2553308280
2566,29369883,2470,29372353,0,4,1,2560,21,4316448059
2567,29408149,58519,29466668,0,3,0,2560,4,5807009852
2568,29414224,6488,29420712,0,3,1,15872,4,603099558
2569,29436705,46993,29483698,0,2,0,1024,8,8450159017
2570,29438102,47288,29485390,0,2,0,1536,8,588082712
2571,29439676,50672,29490348,0,0,0,2560,38,3998669492
2572,29446860,47600,29494460,0,2,0,2560,8,7956356154
2573,29468081,47288,29515369,0,1,0,1536,36,8741840116
2574,29475217,5712,29480929,0,3,1,14336,4,8415054521
2575,29491119,1042,29492161,0,4,1,1024,21,5718601073
2576,29497237,1518,29498755,0,4,1,1536,21,9080061860
2577,29504285,105092,29609377,0,1,0,45056,36,2295672532
2578,29521755,1042,29522797,0,8,1,1024,27,4998692963
2579,29535337,150459,29685796,0,3,0,1024,4,4576681779
2580,29559243,1042,29560285,0,9,1,1024,20,2327384713
2581,29592164,566,29592730,0,3,1,512,4,6792582679
2582,29598407,44060,29642467,0,2,0,1024,8,1143656031
2583,29611407,43904,29655311,0,3,0,512,4,1085408140
2584,29633344,3422,29636766,0,3,1,3584,4,3213849930
2585,29646737,5326,29652063,0,3,1,5632,4,5298803296
2586,29683187,2946,29686133,0,3,1,3072,4,6590252556
2587,29705797,52364,29758161,0,2,0,3072,8,9928249993
2588,29730517,4162,29734679,0,3,1,11264,4,4340401291
2589,29758746,99514,29858260,0,1,0,20992,36,1735776002
2590,29770229,81620,29851849,0,1,0,18432,36,10552534733
2591,29806481,47288,29853769,0,2,0,1536,8,9789268426
2592,29812481,7706,29820187,0,3,1,8192,4,1301077627
2593,29821427,2470,29823897,0,6,1,2560,42,296793653
2594,29850475,103221,29953696,0,1,0,18432,36,8519016247
2595,29854968,2470,29857438,0,3,1,2560,4,1769621298
2596,29865292,43904,29909196,0,0,0,512,38,6308548460
2597,29881264,6754,29888018,0,3,1,7168,4,6328380719
2598,29882777,43904,29926681,0,0,0,512,38,3185538870
2599,29894157,61114,29955271,0,1,0,5120,36,8351390506
2600,29895182,12737,29907919,0,2,1,24576,8,6382230128
2601,29908152,48120,29956272,0,0,0,1536,38,64224688
2602,29912469,43904,29956373,0,2,0,512,8,796309229
2603,29929546,43904,29973450,0,3,0,512,4,6803500131
2604,29955094,47288,30002382,0,0,0,1536,38,9526151882
2605,29993173,43904,30037077,0,2,0,512,8,125128477
2606,30030473,43904,30074377,0,2,0,512,8,7002256817
2607,30034478,54279,30088757,0,2,0,512,8,4323277668
2608,30041680,44060,30085740,0,2,0,1024,8,4173281181
2609,30078772,43904,30122676,0,2,0,512,8,1366380800
2610,30086406,3645,30090051,0,3,1,10240,4,5285633722
2611,30091941,43904,30135845,0,2,0,512,8,2891600485
2612,30092243,43904,30136147,0,0,0,512,38,6281434918
2613,30106898,566,30107464,0,5,1,512,46,1377382901
2614,30127508,43904,30171412,0,3,0,512,4,9324334954
2615,30142908,1518,30144426,0,5,1,1536,46,411833186
2616,30159937,43904,30203841,0,0,0,512,38,1221610839
2617,30257813,43904,30301717,0,0,0,512,38,10241704805
2618,30278188,45596,30323784,0,1,0,1024,36,3630320661
2619,30279879,44076,30323955,0,1,0,512,36,1538053874
2620,30287098,43904,30331002,0,2,0,512,8,2231503914
2621,30343618,43904,30387522,0,0,0,512,38,10002005147
2622,30350521,4679,30355200,0,5,1,12288,46,2123309830
2623,30368708,1042,30369750,0,6,1,1024,42,6346340906
2624,30376970,566,30377536,0,6,1,512,42,6272813693
2625,30381918,3645,30385563,0,1,1,10240,36,2892505394
2626,30401170,1042,30402212,0,1,1,1024,36,9924089026
2627,30408679,43904,30452583,0,3,0,512,4,2879813789
2628,30430855,1994,30432849,0,5,1,2048,46,1226158908
2629,30438317,1994,30440311,0,8,1,2048,27,7422123930
2630,30472901,3645,30476546,0,6,1,10240,42,9748550933
2631,30543415,45596,30589011,0,2,0,1024,8,733553955
2632,30547623,48980,30596603,0,2,0,2048,8,4997155072
2633,30563175,3387,30566562,0,6,1,9728,42,9703968649
2634,30569731,43904,30613635,0,3,0,512,4,3751606262
2635,30577601,5971,30583572,0,5,1,14848,46,8806661480
2636,30595837,50672,30646509,0,3,0,2560,4,198512730
2637,30605012,47600,30652612,0,0,0,2560,38,4367771772
2638,30658115,47288,30705403,0,0,0,1536,38,2929015650
2639,30667767,1042,30668809,0,1,1,1024,36,6041714554
2640,30669604,43904,30713508,0,0,0,512,38,133217197
2641,30678249,48980,30727229,0,3,0,2048,4,3003981686
2642,30701408,12308,30713716,0,5,1,20480,46,9333530844
2643,30708026,8596,30716622,0,5,1,4608,46,3511657595
2644,30718284,45596,30763880,0,0,0,1024,38,7961102634
2645,30733799,76052,30809851,0,0,0,10240,38,4537711265
2646,30745495,43904,30789399,0,2,0,512,8,4485255687
2647,30782064,3422,30785486,0,6,1,3584,42,3700823298
2648,30786214,4937,30791151,0,1,1,12800,36,5810363039
2649,30793669,54212,30847881,0,2,0,4096,8,9932709013
2650,30800816,78212,30879028,0,0,0,12288,38,2063348490
2651,30810099,1518,30811617,0,5,1,1536,46,5237499045
2652,30826946,47288,30874234,0,3,0,1536,4,2711243866
2653,30830838,566,30831404,0,1,1,512,36,2429429286
2654,30845985,78223,30924208,0,0,0,2048,38,3274909137
2655,30847750,4420,30852170,0,1,1,11776,36,3765786323
2656,30848794,43904,30892698,0,2,0,512,8,2518394593
2657,30853761,566,30854327,0,1,1,512,36,5940872313
2658,30868223,51627,30919850,0,1,0,1024,36,4247454310
2659,30903699,3128,30906827,0,6,1,9216,42,9258063075
2660,30905347,45596,30950943,0,2,0,1024,8,7634035492
2661,30910505,1518,30912023,0,1,1,1536,36,7144489581
2662,30967618,43904,31011522,0,1,0,512,36,3382111054
2663,30994458,1994,30996452,0,3,1,2048,4,6613475981
2664,30998338,5712,31004050,0,6,1,14336,42,210742289
2665,31004033,566,31004599,0,1,1,512,36,4932276914
2666,31006146,1994,31008140,0,6,1,2048,42,2978063156
2667,31029651,566,31030217,0,5,1,512,46,1068493193
2668,31037662,47288,31084950,0,1,0,1536,36,2886325162
2669,31050513,6278,31056791,0,5,1,6656,46,10166074015
2670,31073554,10241,31083795,0,5,1,16384,46,3733637342
2671,31079777,5188,31084965,0,1,1,12800,36,2353199561
2672,31112698,45596,31158294,0,1,0,1024,36,2587494795
2673,31115041,5326,31120367,0,6,1,5632,42,5526686448
2674,31167611,5454,31173065,0,6,1,13824,42,2317654363
2675,31201045,1042,31202087,0,6,1,1024,42,8403717291
2676,31210941,4374,31215315,0,6,1,4608,42,6287661993
2677,31243099,45596,31288695,0,1,0,1024,36,2470808999
2678,31266260,75764,31342024,0,0,0,14336,38,5390618229
2679,31277690,173708,31451398,0,0,0,74752,38,2575056127
2680,31284850,105798,31390648,0,0,0,32768,38,8593283712
2681,31292330,43904,31336234,0,3,0,512,4,7806182776
2682,31320418,172020,31492438,0,0,0,48128,38,10000486478
2683,31340011,5326,31345337,0,6,1,5632,42,7165809136
2684,31359544,566,31360110,0,7,1,512,41,2271632330
2685,31386299,45596,31431895,0,1,0,1024,36,5163211978
2686,31430437,43904,31474341,0,3,0,512,4,186305872
2687,31430715,45596,31476311,0,3,0,1024,4,4754659305
2688,31446502,1042,31447544,0,8,1,1024,27,1789556196
2689,31463133,45596,31508729,0,3,0,1024,4,4034252409
2690,31466131,566,31466697,0,6,1,512,42,7748073857
2691,31466472,566,31467038,0,7,1,512,41,9940194630
2692,31475494,113516,31589010,0,0,0,72704,38,6729780930
2693,31499359,1518,31500877,0,6,1,1536,42,7253584030
2694,31502052,1042,31503094,0,7,1,1024,41,669912480
2695,31529341,1994,31531335,0,7,1,2048,41,4928127866
2696,31539719,48980,31588699,0,1,0,2048,36,7010445571
2697,31544788,110090,31654878,0,0,0,19456,38,6333873745
2698,31562715,43904,31606619,0,3,0,512,4,7032228971
2699,31573419,6229,31579648,0,5,1,15360,46,5118895314
2700,31573545,45596,31619141,0,1,0,1024,36,6293723688
2701,31578133,94355,31672488,0,0,0,512,38,3946684900
2702,31604267,43904,31648171,0,3,0,512,4,6051744245
2703,31611756,2470,31614226,0,7,1,2560,41,6785808760
2704,31612771,7230,31620001,0,5,1,7680,46,6113160171
2705,31631909,54056,31685965,0,2,0,3584,8,909713849
2706,31638619,43904,31682523,0,3,0,512,4,5722675136
2707,31644612,4374,31648986,0,6,1,4608,42,6744436332
2708,31657211,43904,31701115,0,1,0,512,36,10240776761
2709,31668764,103300,31772064,0,0,0,27648,38,6281375608
2710,31670684,47288,31717972,0,1,0,1536,36,3165341824
2711,31688925,1042,31689967,0,5,1,1024,46,4693651570
2712,31697836,52520,31750356,0,1,0,3584,36,6956418076
2713,31712982,6229,31719211,0,6,1,15360,42,3213563086
2714,31736564,45596,31782160,0,1,0,1024,36,5229261389
2715,31748861,104156,31853017,0,0,0,41984,38,424778069
2716,31771720,105939,31877659,0,0,0,15872,38,7935197409
2717,31779111,43904,31823015,0,3,0,512,4,4895824084
2718,31822370,43904,31866274,0,2,0,512,8,854527188
2719,31829246,4162,31833408,0,1,1,11264,36,6340552336
2720,31864809,3422,31868231,0,7,1,3584,41,2530282340
2721,31873334,1518,31874852,0,7,1,1536,41,8967400018
2722,31873626,43904,31917530,0,1,0,512,36,6926003690
2723,31882795,45596,31928391,0,1,0,1024,36,8527783925
2724,31885766,43904,31929670,0,1,0,512,36,9001637998
2725,31917533,2946,31920479,0,7,1,3072,41,5012071533
2726,31936035,44060,31980095,0,2,0,1024,8,3936825502
2727,31965211,2470,31967681,0,7,1,2560,41,5988803424
2728,31968036,44060,32012096,0,2,0,1024,8,2528567134
2729,31983270,43904,32027174,0,1,0,512,36,4279554224
2730,31995960,43904,32039864,0,2,0,512,8,10627858510
2731,32013053,59505,32072558,0,1,0,1024,36,7853091609
2732,32036488,2470,32038958,0,5,1,2560,46,9095972808
2733,32089612,45596,32135208,0,3,0,1024,4,9655632981
2734,32093750,45596,32139346,0,3,0,1024,4,5984213005
2735,32095846,43904,32139750,0,2,0,512,8,7999309139
2736,32110896,43904,32154800,0,2,0,512,8,41952560
2737,32120743,1042,32121785,0,6,1,1024,42,7580054917
2738,32140090,118976,32259066,0,0,0,90624,38,3310028052
2739,32144174,50672,32194846,0,2,0,2560,8,7855539000
2740,32146221,43904,32190125,0,2,0,512,8,2612903924
2741,32150597,1994,32152591,0,5,1,2048,46,2501681136
2742,32199820,47288,32247108,0,2,0,1536,8,9198590085
2743,32244940,98942,32343882,0,0,0,13824,38,592153031
2744,32259892,2470,32262362,0,6,1,2560,42,5296958794
2745,32289515,43904,32333419,0,3,0,512,4,10093747778
2746,32296216,3128,32299344,0,5,1,9216,46,2763153881
2747,32309425,566,32309991,0,5,1,512,46,2696428741
2748,32317570,43904,32361474,0,3,0,512,4,9272241463
2749,32339814,1518,32341332,0,1,1,1536,36,7865914389
2750,32369713,43904,32413617,0,3,0,512,4,9002336546
2751,32369717,566,32370283,0,5,1,512,46,12243041
2752,32377479,43904,32421383,0,3,0,512,4,10071573281
2753,32378875,43904,32422779,0,1,0,512,36,6920004591
2754,32379117,105092,32484209,0,0,0,45056,38,6289509542
2755,32399307,1042,32400349,0,6,1,1024,42,8412426860
2756,32402562,3898,32406460,0,5,1,4096,46,6301947790
2757,32411230,4850,32416080,0,5,1,5120,46,6217744021
2758,32411271,1994,32413265,0,1,1,2048,36,408452513
2759,32432486,45596,32478082,0,3,0,1024,4,8166516277
2760,32433496,51196,32484692,0,0,0,1536,38,1047532171
2761,32445289,3422,32448711,0,5,1,3584,46,7559061782
2762,32457894,43904,32501798,0,1,0,512,36,3329579457
2763,32492131,43904,32536035,0,1,0,512,36,5410260005
2764,32495511,2470,32497981,0,6,1,2560,42,7264385539
2765,32497666,54368,32552034,0,2,0,4608,8,2193901144
2766,32498964,47288,32546252,0,1,0,1536,36,4454286906
2767,32502658,2470,32505128,0,5,1,2560,46,7693414827
2768,32514015,4374,32518389,0,6,1,4608,42,2717609599
2769,32525102,2470,32527572,0,7,1,2560,41,7061591059
2770,32525693,47288,32572981,0,1,0,1536,36,3321239184
2771,32532040,2470,32534510,0,7,1,2560,41,1271979144
2772,32556691,43904,32600595,0,3,0,512,4,284834586
2773,32560635,5802,32566437,0,1,1,6144,36,6830512830
2774,32565622,159590,32725212,0,1,0,512,36,6970649286
2775,32576599,43904,32620503,0,2,0,512,8,773540141
2776,32586964,43904,32630868,0,2,0,512,8,6027025300
2777,32587718,3898,32591616,0,1,1,4096,36,95335250
2778,32592255,3898,32596153,0,7,1,4096,41,1350455510
2779,32594525,43904,32638429,0,3,0,512,4,1115333564
2780,32605489,48980,32654469,0,0,0,2048,38,8908772766
2781,32607747,53652,32661399,0,1,0,1024,36,4821316861
2782,32610296,3898,32614194,0,2,1,4096,8,3551385807
2783,32613661,43904,32657565,0,2,0,512,8,3470264387
2784,32616160,1994,32618154,0,1,1,2048,36,5857455527
2785,32617710,566,32618276,0,7,1,512,41,4468018118
2786,32676911,12308,32689219,0,2,1,20480,8,5740623350
2787,32684887,1518,32686405,0,7,1,1536,41,39321444
2788,32703477,100100,32803577,0,0,0,28672,38,9341392432
2789,32720244,47288,32767532,0,1,0,1536,36,4372625406
2790,32720716,43904,32764620,0,3,0,512,4,4950651753
2791,32720830,45482,32766312,0,3,0,1024,4,6153235036
2792,32731278,1042,32732320,0,1,1,1024,36,8837217516
2793,32732296,1994,32734290,0,2,1,2048,8,7359895715
2794,32768075,4937,32773012,0,3,1,12800,4,3153500881
2795,32771107,4374,32775481,0,1,1,4608,36,10360582866
2796,32787453,3128,32790581,0,8,1,9216,27,4238420628
2797,32794315,47288,32841603,0,3,0,1536,4,7286731059
2798,32815592,3422,32819014,0,3,1,3584,4,10043510138
2799,32821302,5454,32826756,0,7,1,13824,41,8502036712
2800,32823118,61865,32884983,0,3,0,512,4,10569945044
2801,32833400,7230,32840630,0,3,1,7680,4,2517278340
2802,32836378,4508,32840886,0,3,1,9216,4,8220411125
2803,32837217,4374,32841591,0,2,1,4608,8,6614043202
2804,32838475,4422,32842897,0,2,1,2048,8,9130953638
2805,32839241,3904,32843145,0,3,1,10752,4,3450815798
2806,32852947,566,32853513,0,6,1,512,42,9830273832
2807,32853687,566,32854253,0,1,1,512,36,533436505
2808,32864446,135909,33000355,0,3,0,512,4,648783111
2809,32866333,566,32866899,0,6,1,512,42,5700030711
2810,32872086,48980,32921066,0,2,0,2048,8,3030964618
2811,32879210,6278,32885488,0,2,1,6656,8,9433254424
2812,32881974,43904,32925878,0,2,0,512,8,3837296475
2813,32901783,5802,32907585,0,1,1,6144,36,1851374949
2814,32932016,566,32932582,0,7,1,512,41,5667746175
2815,32940290,2946,32943236,0,2,1,3072,8,5967344663
2816,32957097,43904,33001001,0,1,0,512,36,4904693790
2817,32961649,7706,32969355,0,2,1,8192,8,8282450355
2818,32968436,52426,33020862,0,2,0,1024,8,5154816449
2819,32971067,10241,32981308,0,6,1,16384,42,338338979
2820,33008523,5454,33013977,0,3,1,13824,4,3355377671
2821,33036354,62516,33098870,0,0,0,6144,38,4492277159
2822,33064803,43904,33108707,0,1,0,512,36,7697719486
2823,33068139,3898,33072037,0,3,1,4096,4,6777080426
2824,33073821,566,33074387,0,6,1,512,42,136762376
2825,33093441,2946,33096387,0,7,1,3072,41,7033726813
2826,33104283,43904,33148187,0,2,0,512,8,464398198
2827,33108429,50828,33159257,0,1,0,3072,36,1276621951
2828,33116663,104468,33221131,0,0,0,43008,38,10045753018
2829,33138682,2470,33141152,0,2,1,2560,8,7553416057
2830,33143271,3387,33146658,0,8,1,9728,27,6612091572
2831,33143290,2470,33145760,0,7,1,2560,41,5737464977
2832,33150912,2946,33153858,0,7,1,3072,41,4248713111
2833,33175762,45596,33221358,0,3,0,1024,4,3018708915
2834,33175974,4850,33180824,0,9,1,5120,20,5428555039
2835,33199209,5326,33204535,0,2,1,5632,8,2012207582
2836,33244180,43904,33288084,0,1,0,512,36,1978257147
2837,33271039,101504,33372543,0,0,0,33280,38,8076332450
2838,33277452,43904,33321356,0,3,0,512,4,8204557280
2839,33280494,43904,33324398,0,3,0,512,4,3715401561
2840,33318423,43904,33362327,0,1,0,512,36,8453296409
2841,33319034,1994,33321028,0,3,1,2048,4,839875673
2842,33342208,3422,33345630,0,3,1,3584,4,8682585849
2843,33347769,566,33348335,0,3,1,512,4,2039724399
2844,33358402,4850,33363252,0,2,1,5120,8,6634425499
2845,33360196,2946,33363142,0,7,1,3072,41,1554872470
2846,33360536,566,33361102,0,3,1,512,4,728040366
2847,33367685,43904,33411589,0,1,0,512,36,8953473046
2848,33368236,7706,33375942,0,7,1,8192,41,9623413218
2849,33374447,3422,33377869,0,9,1,3584,20,14668847
2850,33376771,3422,33380193,0,3,1,3584,4,712220289
2851,33395214,3422,33398636,0,2,1,3584,8,3327209991
2852,33420538,566,33421104,0,4,1,512,21,6194122967
2853,33432013,4374,33436387,0,2,1,4608,8,7925618568
2854,33433378,99632,33533010,0,0,0,27136,38,5234504542
2855,33443207,566,33443773,0,2,1,512,8,6601606436
2856,33460927,2470,33463397,0,7,1,2560,41,6448044042
2857,33479864,2946,33482810,0,7,1,3072,41,2051753009
2858,33484779,4420,33489199,0,2,1,11776,8,6338045104
2859,33484977,566,33485543,0,7,1,512,41,2792534500
2860,33501558,56528,33558086,0,0,0,6656,38,5146077177
2861,33502301,105319,33607620,0,0,0,44032,38,2432918828
2862,33511496,1994,33513490,0,3,1,2048,4,247120961
2863,33524751,2470,33527221,0,7,1,2560,41,7934201538
2864,33525020,152686,33677706,0,0,0,46080,38,7960693328
2865,33541631,107720,33649351,0,0,0,10240,38,2023514086
2866,33543169,2870,33546039,0,2,1,8704,8,8774957057
2867,33551554,2470,33554024,0,7,1,2560,41,1767895054
2868,33573774,566,33574340,0,9,1,512,20,5295606403
2869,33575558,1994,33577552,0,3,1,2048,4,2935526179
2870,33575984,47535,33623519,0,3,0,1536,4,7483384919
2871,33577757,114505,33692262,0,0,0,18944,38,9067961372
2872,33595138,4162,33599300,0,7,1,11264,41,1881970469
2873,33597958,1042,33599000,0,2,1,1024,8,4665092073
2874,33624234,4374,33628608,0,9,1,4608,20,7959363830
2875,33650981,4374,33655355,0,7,1,4608,41,10280156756
2876,33661060,45596,33706656,0,2,0,1024,8,2175958191
2877,33683530,5326,33688856,0,4,1,5632,21,5357644828
2878,33707058,5196,33712254,0,4,1,13312,21,2872107427
2879,33711275,99476,33810751,0,0,0,26624,38,1437824890
2880,33727257,43904,33771161,0,2,0,512,8,791705038
2881,33732335,6754,33739089,0,4,1,7168,21,8262163627
2882,33751840,45596,33797436,0,2,0,1024,8,2789080757
2883,33752402,1994,33754396,0,9,1,2048,20,8095273706
2884,33761051,1042,33762093,0,3,1,1024,4,328081017
2885,33775468,43904,33819372,0,3,0,512,4,6472073334
2886,33777834,2470,33780304,0,2,1,2560,8,735947765
2887,33789313,4850,33794163,0,9,1,5120,20,9770664376
2888,33791837,4592,33796429,0,9,1,3584,20,3644795616
2889,33795727,5802,33801529,0,9,1,6144,20,7445113081
2890,33818594,47444,33866038,0,3,0,2048,4,850220125
2891,33849788,43904,33893692,0,1,0,512,36,2827142631
2892,33853079,3422,33856501,0,1,1,3584,36,10221364754
2893,33869096,4374,33873470,0,9,1,4608,20,3075840069
2894,33872643,50672,33923315,0,1,0,2560,36,3335979917
2895,33886426,566,33886992,0,7,1,512,41,9276387257
2896,33891642,1042,33892684,0,4,1,1024,21,820269959
2897,33898160,6488,33904648,0,3,1,15872,4,6148314724
2898,33909537,5326,33914863,0,3,1,5632,4,7659447183
2899,33921479,1042,33922521,0,3,1,1024,4,6412126087
2900,33948750,2470,33951220,0,1,1,2560,36,5381967894
2901,33980228,2470,33982698,0,3,1,2560,4,2029907839
2902,33986290,3128,33989418,0,4,1,9216,21,837421461
2903,33997946,4850,34002796,0,9,1,5120,20,3111472853
2904,34014652,43904,34058556,0,2,0,512,8,4539158048
2905,34017855,70074,34087929,0,3,0,512,4,939303182
2906,34026874,566,34027440,0,1,1,512,36,2965376525
2907,34027004,102908,34129912,0,0,0,37888,38,7861396470
2908,34054292,1994,34056286,0,2,1,2048,8,1549444569
2909,34056255,1994,34058249,0,9,1,2048,20,6033996033
2910,34068563,3422,34071985,0,2,1,3584,8,7794870381
2911,34068671,6220,34074891,0,2,1,4608,8,5834006344
2912,34072038,99632,34171670,0,0,0,27136,38,9340600697
2913,34080162,1518,34081680,0,7,1,1536,41,3706959639
2914,34098762,566,34099328,0,1,1,512,36,7915555465
2915,34112575,47288,34159863,0,1,0,1536,36,7105048688
2916,34146669,2470,34149139,0,2,1,2560,8,8204852663
2917,34147144,2470,34149614,0,4,1,2560,21,7472135857
2918,34169501,47288,34216789,0,1,0,1536,36,6342233018
2919,34182691,1994,34184685,0,3,1,2048,4,3618716510
2920,34188548,76052,34264600,0,0,0,10240,38,3282291619
2921,34188821,48980,34237801,0,1,0,2048,36,8654810493
2922,34190669,47288,34237957,0,2,0,1536,8,4009504736
2923,34193916,3422,34197338,0,3,1,3584,4,2943043653
2924,34195882,5802,34201684,0,3,1,6144,4,1325743594
2925,34197220,3422,34200642,0,9,1,3584,20,5897522624
2926,34210069,3128,34213197,0,3,1,9216,4,248381251
2927,34217644,50672,34268316,0,2,0,2560,8,10428760166
2928,34223292,126190,34349482,0,0,0,55808,38,3716653364
2929,34228042,5326,34233368,0,3,1,5632,4,5265046654
2930,34255405,7230,34262635,0,3,1,7680,4,4017241915
2931,34264648,88437,34353085,0,0,0,11776,38,10150317818
2932,34287691,94953,34382644,0,0,0,12288,38,5094343053
2933,34302311,1525,34303836,0,3,1,1536,4,4752707409
2934,34302359,4358,34306717,0,3,1,4096,4,5036586896
2935,34321064,2946,34324010,0,4,1,3072,21,10145626984
2936,34326817,1518,34328335,0,4,1,1536,21,9109989209
2937,34327825,3898,34331723,0,3,1,4096,4,3313936041
2938,34351892,5326,34357218,0,4,1,5632,21,5739185820
2939,34361669,49267,34410936,0,1,0,1536,36,6686530950
2940,34363648,43904,34407552,0,1,0,512,36,3374264670
2941,34378401,3422,34381823,0,4,1,3584,21,6453535613
2942,34389565,2946,34392511,0,3,1,3072,4,9180354060
2943,34392264,566,34392830,0,9,1,512,20,7234586862
2944,34397217,6754,34403971,0,1,1,7168,36,10464853504
2945,34423215,3898,34427113,0,4,1,4096,21,8820348547
2946,34425226,45596,34470822,0,1,0,1024,36,7823013848
2947,34432224,3128,34435352,0,4,1,9216,21,5453454983
2948,34461480,1994,34463474,0,4,1,2048,21,3871537435
2949,34493257,4937,34498194,0,1,1,12800,36,3885494515
2950,34501002,48980,34549982,0,2,0,2048,8,6366463271
2951,34532573,5802,34538375,0,1,1,6144,36,5418238972
2952,34564610,43904,34608514,0,2,0,512,8,8275994677
2953,34565162,1042,34566204,0,1,1,1024,36,10386051377
2954,34573286,3645,34576931,0,4,1,10240,21,7676655304
2955,34574115,4162,34578277,0,1,1,11264,36,3107216016
2956,34590049,53256,34643305,0,1,0,512,36,5360241403
2957,34604936,118352,34723288,0,8,0,88576,27,8342743380
2958,34613629,1518,34615147,0,4,1,1536,21,4630985550
2959,34649363,117343,34766706,0,1,0,512,36,10288583364
2960,34651223,4850,34656073,0,4,1,5120,21,466246490
2961,34681602,47288,34728890,0,1,0,1536,36,5562951166
2962,34695296,4420,34699716,0,1,1,11776,36,2569520031
2963,34703105,74384,34777489,0,0,0,14848,38,10087298640
2964,34717691,45596,34763287,0,3,0,1024,4,8449267395
2965,34722314,45596,34767910,0,3,0,1024,4,448553803
2966,34748131,48980,34797111,0,2,0,2048,8,786790755
2967,34748908,43904,34792812,0,3,0,512,4,1370256138
2968,34764367,45596,34809963,0,2,0,1024,8,7683541371
2969,34794643,5326,34799969,0,4,1,5632,21,3054050862
2970,34814919,47288,34862207,0,1,0,1536,36,4889462658
2971,34828464,107588,34936052,0,8,0,53248,27,7380150014
2972,34849696,43904,34893600,0,1,0,512,36,2395457105
2973,34851508,45596,34897104,0,2,0,1024,8,8091263617
2974,34852530,85409,34937939,0,8,0,6144,27,4837060575
2975,34881252,23983,34905235,0,1,1,39936,36,8794258375
2976,34885613,101348,34986961,0,0,0,32768,38,1374408967
2977,34886502,50994,34937496,0,1,0,512,36,1074795551
2978,34889322,15579,34904901,0,4,1,30208,21,1679457888
2979,34943623,1518,34945141,0,4,1,1536,21,3418843685
2980,34959542,163448,35122990,0,0,0,140800,38,3057625446
2981,34999715,4420,35004135,0,4,1,11776,21,3538310607
2982,35071088,45596,35116684,0,1,0,1024,36,6958747909
2983,35078173,45596,35123769,0,2,0,1024,8,315109239
2984,35093629,80025,35173654,0,0,0,2560,38,6211768693
2985,35094722,10757,35105479,0,1,1,17408,36,10368306680
2986,35123828,43904,35167732,0,2,0,512,8,248391258
2987,35152385,43904,35196289,0,2,0,512,8,8448171859
2988,35156209,5802,35162011,0,1,1,6144,36,665625870
2989,35158130,6754,35164884,0,7,1,7168,41,9385409016
2990,35165061,110303,35275364,0,0,0,56320,38,7715817128
2991,35166764,91425,35258189,0,0,0,15872,38,3385683593
2992,35175307,2946,35178253,0,4,1,3072,21,4764791853
2993,35180915,155300,35336215,0,8,0,139264,27,6080965679
2994,35188588,5802,35194390,0,3,1,6144,4,7307256129
2995,35191929,1994,35193923,0,7,1,2048,41,9995010511
2996,35227092,5802,35232894,0,4,1,6144,21,474162670
2997,35234587,566,35235153,0,4,1,512,21,5543273370
2998,35243125,13600,35256725,0,1,1,23040,36,6803499513
2999,35243374,23174,35266548,0,1,1,31744,36,2561395917
3000,35247525,1518,35249043,0,7,1,1536,41,8590914409
3001,35300280,12308,35312588,0,1,1,20480,36,9651812163
3002,35303426,58487,35361913,0,1,0,1024,36,2270479644
3003,35315271,43904,35359175,0,2,0,512,8,1981082459
3004,35326849,43904,35370753,0,2,0,512,8,4481167068
3005,35329284,3387,35332671,0,4,1,9728,21,2527840139
3006,35336031,114472,35450503,0,8,0,75264,27,6941490351
3007,35345293,7230,35352523,0,7,1,7680,41,10201973123
3008,35350136,43904,35394040,0,3,0,512,4,2945351236
3009,35381932,43904,35425836,0,2,0,512,8,10577434171
3010,35385801,5454,35391255,0,7,1,13824,41,2881496204
3011,35399378,139106,35538484,0,1,0,84992,36,9238711762
3012,35412697,14287,35426984,0,1,1,27648,36,2700888816
3013,35442517,1042,35443559,0,4,1,1024,21,2915424476
3014,35473290,47288,35520578,0,2,0,1536,8,6946357745
3015,35499824,3422,35503246,0,4,1,3584,21,5880360331
3016,35521957,45596,35567553,0,3,0,1024,4,5928215874
3017,35539185,11274,35550459,0,1,1,18432,36,1893074038
3018,35551354,1994,35553348,0,7,1,2048,41,9218301083
3019,35558966,2470,35561436,0,4,1,2560,21,10573774165
3020,35578094,45596,35623690,0,3,0,1024,4,5469921966
3021,35594522,48980,35643502,0,2,0,2048,8,3899082888
3022,35597584,3898,35601482,0,7,1,4096,41,7608963889
3023,35614097,100880,35714977,0,0,0,31232,38,3842242239
3024,35635845,4679,35640524,0,7,1,12288,41,2703833311
3025,35645303,96716,35742019,0,1,0,27648,36,7813925317
3026,35655046,55748,35710794,0,2,0,4096,8,5412182838
3027,35671797,43904,35715701,0,2,0,512,8,9503625261
3028,35672079,3128,35675207,0,7,1,9216,41,8388208923
3029,35722069,88100,35810169,0,0,0,24576,38,5581491109
3030,35726505,1518,35728023,0,7,1,1536,41,8238542631
3031,35727979,60224,35788203,0,0,0,8704,38,8165418037
3032,35763158,80372,35843530,0,1,0,14336,36,2134342809
3033,35772062,106141,35878203,0,0,0,24576,38,4105560685
3034,35787750,13341,35801091,0,1,1,22528,36,4889087207
3035,35802533,2946,35805479,0,8,1,3072,27,128250458
3036,35822909,3422,35826331,0,7,1,3584,41,2918925383
3037,35855999,1042,35857041,0,7,1,1024,41,1693958853
3038,35858516,48980,35907496,0,8,0,2048,27,3285393902
3039,35918066,7706,35925772,0,7,1,8192,41,616856749
3040,36000338,104000,36104338,0,0,0,41472,38,9857040855
3041,36001525,5454,36006979,0,7,1,13824,41,3427207814
3042,36026475,5802,36032277,0,7,1,6144,41,5517301902
3043,36032813,6754,36039567,0,5,1,7168,46,6764851868
3044,36046742,47288,36094030,0,8,0,1536,27,4120353221
3045,36091836,100256,36192092,0,8,0,29184,27,339045231
3046,36095309,144375,36239684,0,8,0,24064,27,843046262
3047,36104404,174382,36278786,0,8,0,35328,27,2717944900
3048,36116157,59132,36175289,0,1,0,5120,36,9532846802
3049,36116926,103064,36219990,0,1,0,38400,36,4469030624
3050,36168676,5454,36174130,0,5,1,13824,46,3135312639
3051,36176333,43904,36220237,0,2,0,512,8,10382984084
3052,36230473,113672,36344145,0,8,0,73216,27,5069239250
3053,36241663,3898,36245561,0,7,1,4096,41,3606513317
3054,36245437,74360,36319797,0,1,0,9728,36,3144757153
3055,36249227,121004,36370231,0,0,0,97280,38,7194202491
3056,36287075,45596,36332671,0,2,0,1024,8,3670420367
3057,36343431,4850,36348281,0,7,1,5120,41,4927544797
3058,36344992,1518,36346510,0,5,1,1536,46,8206296581
3059,36346307,98924,36445231,0,0,0,16896,38,5876521423
3060,36393824,4679,36398503,0,5,1,12288,46,1549548710
3061,36395380,5365,36400745,0,5,1,9216,46,6989140766
3062,36414988,94556,36509544,0,1,0,25600,36,8082968647
3063,36417610,566,36418176,0,7,1,512,41,10007870218
3064,36423585,566,36424151,0,5,1,512,46,4987813389
3065,36443295,10499,36453794,0,7,1,16896,41,6773267609
3066,36451080,43904,36494984,0,2,0,512,8,3187201638
3067,36456820,83000,36539820,0,0,0,17920,38,3173035272
3068,36508634,105214,36613848,0,1,0,42496,36,637508642
3069,36524550,4374,36528924,0,5,1,4608,46,4771515983
3070,36532218,71624,36603842,0,8,0,15872,27,47394256
3071,36536884,1042,36537926,0,7,1,1024,41,9212344441
3072,36540509,7230,36547739,0,7,1,7680,41,3980449962
3073,36560051,43904,36603955,0,2,0,512,8,7650158514
3074,36563773,5326,36569099,0,5,1,5632,46,2048194031
3075,36632211,118508,36750719,0,0,0,89088,38,6370767408
3076,36644441,4374,36648815,0,5,1,4608,46,10512577153
3077,36648936,105095,36754031,0,0,0,9216,38,10017215044
3078,36650250,87140,36737390,0,1,0,16384,36,8262132278
3079,36661519,2870,36664389,0,4,1,8704,21,2017443106
3080,36668272,99476,36767748,0,8,0,26624,27,1132204492
3081,36702907,47288,36750195,0,1,0,1536,36,5596479713
3082,36723127,50672,36773799,0,2,0,2560,8,3803229933
3083,36725675,1518,36727193,0,5,1,1536,46,9816137242
3084,36734931,7230,36742161,0,7,1,7680,41,9826305734
3085,36761198,9488,36770686,0,8,1,3072,27,8217187975
3086,36818846,49740,36868586,0,2,0,1024,8,7880652752
3087,36822990,43904,36866894,0,2,0,512,8,8960078570
3088,36853320,6754,36860074,0,5,1,7168,46,5393296049
3089,36883677,6754,36890431,0,7,1,7168,41,7726210929
3090,36910164,74360,36984524,0,0,0,9728,38,4823560608
3091,37012727,5802,37018529,0,5,1,6144,46,1157127570
3092,37051289,5802,37057091,0,7,1,6144,41,1104964062
3093,37055449,70976,37126425,0,0,0,8704,38,5518587403
3094,37070403,43904,37114307,0,2,0,512,8,7822386519
3095,37166977,34367,37201344,0,1,1,56832,36,3380442012
3096,37207308,3898,37211206,0,5,1,4096,46,7417794562
3097,37223126,3898,37227024,0,5,1,4096,46,4716243510
3098,37233224,566,37233790,0,7,1,512,41,5462661514
3099,37243703,6278,37249981,0,7,1,6656,41,10454857338
3100,37249285,113672,37362957,0,8,0,73216,27,3676422783
3101,37258565,2946,37261511,0,5,1,3072,46,8108867103
3102,37265299,13600,37278899,0,7,1,23040,41,614276537
3103,37299695,7230,37306925,0,5,1,7680,46,2579049690
3104,37320166,2470,37322636,0,6,1,2560,42,8265869990
3105,37339177,1994,37341171,0,4,1,2048,21,815752535
3106,37350158,47288,37397446,0,2,0,1536,8,3676635356
3107,37379332,52364,37431696,0,1,0,3072,36,9246116017
3108,37416000,79436,37495436,0,0,0,11264,38,9924984510
3109,37425291,5802,37431093,0,7,1,6144,41,3041717320
3110,37443592,566,37444158,0,5,1,512,46,10709650890
3111,37456945,3898,37460843,0,4,1,4096,21,29597784
3112,37458750,2870,37461620,0,5,1,8704,46,3332936521
3113,37469160,43904,37513064,0,2,0,512,8,6980442275
3114,37470215,1994,37472209,0,4,1,2048,21,1349679097
3115,37471047,3128,37474175,0,5,1,9216,46,10006980523
3116,37472364,3898,37476262,0,7,1,4096,41,9333874018
3117,37476273,110552,37586825,0,0,0,62976,38,8682916523
3118,37476704,1994,37478698,0,4,1,2048,21,4597973852
3119,37485421,101575,37586996,0,0,0,512,38,9874129925
3120,37505960,3904,37509864,0,7,1,10752,41,2813297758
3121,37508691,130508,37639199,0,0,0,22016,38,8895377389
3122,37509997,48980,37558977,0,2,0,2048,8,4229108335
3123,37523094,88076,37611170,0,8,0,19456,27,5559107762
3124,37525754,184464,37710218,0,1,0,87040,36,3417778501
3125,37530050,143190,37673240,0,8,0,15360,27,7401526715
3126,37539512,47288,37586800,0,2,0,1536,8,1527343885
3127,37543182,115576,37658758,0,1,0,35840,36,268789388
3128,37576943,2946,37579889,0,8,1,3072,27,1347038532
3129,37602939,159737,37762676,0,1,0,31232,36,9749474451
3130,37619644,101504,37721148,0,8,0,33280,27,10363258159
3131,37671243,43904,37715147,0,2,0,512,8,3243207740
3132,37691007,1042,37692049,0,8,1,1024,27,401108360
3133,37693042,163358,37856400,0,1,0,7168,36,4529428212
3134,37718701,4433,37723134,0,8,1,2048,27,810326502
3135,37727182,111020,37838202,0,1,0,64512,36,10478156491
3136,37753261,3645,37756906,0,9,1,10240,20,825054855
3137,37777231,103688,37880919,0,1,0,40448,36,7321814332
3138,37835709,97041,37932750,0,1,0,25600,36,2026625770
3139,37845081,43904,37888985,0,2,0,512,8,7459189190
3140,37846828,3898,37850726,0,9,1,4096,20,3122653649
3141,37847018,173884,38020902,0,1,0,153600,36,7393552968
3142,37871286,1994,37873280,0,8,1,2048,27,1595693159
3143,37894600,108056,38002656,0,0,0,54784,38,9978073263
3144,37903819,60980,37964799,0,2,0,6144,8,6133731250
3145,37947584,89012,38036596,0,8,0,22528,27,6007464491
3146,37952367,566,37952933,0,8,1,512,27,9153396465
3147,37971976,5326,37977302,0,8,1,5632,27,408324022
3148,37993539,114357,38107896,0,0,0,45568,38,2302669156
3149,38006997,2470,38009467,0,9,1,2560,20,6031347930
3150,38012837,130621,38143458,0,1,0,102400,36,2939900678
3151,38042753,43904,38086657,0,8,0,512,27,7760474876
3152,38066427,125907,38192334,0,0,0,94720,38,5197549103
3153,38073983,11016,38084999,0,8,1,17920,27,6168947574
3154,38097850,203951,38301801,0,8,0,65024,27,4598676124
3155,38107463,3898,38111361,0,9,1,4096,20,5883185734
3156,38112902,1518,38114420,0,9,1,1536,20,5542806571
3157,38198020,5971,38203991,0,8,1,14848,27,2613255305
3158,38205837,71912,38277749,0,0,0,11776,38,2814343022
3159,38234717,566,38235283,0,6,1,512,42,4830060676
3160,38239211,3898,38243109,0,8,1,4096,27,363220365
3161,38246714,5802,38252516,0,9,1,6144,20,10137714720
3162,38249248,45596,38294844,0,2,0,1024,8,398908449
3163,38252709,43904,38296613,0,2,0,512,8,3088060651
3164,38274989,4850,38279839,0,9,1,5120,20,9447011690
3165,38325262,7230,38332492,0,9,1,7680,20,4009628058
3166,38335517,23983,38359500,0,1,1,39936,36,2854003068
3167,38356103,63764,38419867,0,8,0,10240,27,9253177012
3168,38379680,3422,38383102,0,9,1,3584,20,3797473975
3169,38381621,106184,38487805,0,0,0,48640,38,6964607839
3170,38409925,20366,38430291,0,1,1,32768,36,9007949653
3171,38418356,43904,38462260,0,2,0,512,8,7278965462
3172,38421000,6754,38427754,0,9,1,7168,20,8509854293
3173,38427860,4162,38432022,0,8,1,11264,27,7336349512
3174,38432315,53483,38485798,0,2,0,1024,8,5480424916
3175,38466600,4850,38471450,0,6,1,5120,42,3101567411
3176,38473995,148486,38622481,0,0,0,132096,38,4433327673
3177,38475129,153295,38628424,0,0,0,19456,38,6105513447
3178,38492925,5326,38498251,0,8,1,5632,27,1822660506
3179,38493612,1042,38494654,0,9,1,1024,20,8843386998
3180,38512577,2470,38515047,0,8,1,2560,27,3415598921
3181,38521866,7706,38529572,0,9,1,8192,20,1619265787
3182,38582230,2470,38584700,0,4,1,2560,21,501545007
3183,38594828,5802,38600630,0,4,1,6144,21,949387187
3184,38653304,6754,38660058,0,4,1,7168,21,9662771698
3185,38671183,103220,38774403,0,0,0,38912,38,2735235664
3186,38691019,47600,38738619,0,2,0,2560,8,3370429852
3187,38694245,78080,38772325,0,8,0,16896,27,6650094832
3188,38731298,2470,38733768,0,4,1,2560,21,10652863038
3189,38732487,1627,38734114,0,4,1,512,21,1256308651
3190,38749074,6278,38755352,0,4,1,6656,21,5240647293
3191,38755000,1518,38756518,0,4,1,1536,21,1834546445
3192,38776219,98696,38874915,0,0,0,24064,38,8152939219
3193,38780526,52988,38833514,0,0,0,5120,38,1759239836
3194,38826284,113984,38940268,0,8,0,74240,27,6342104897
3195,38858068,150816,39008884,0,8,0,50176,27,5343767969
3196,38879850,1994,38881844,0,8,1,2048,27,2249428932
3197,38893915,194302,39088217,0,8,0,31744,27,3815321510
3198,38917332,24154,38941486,0,1,1,43520,36,7815803225
3199,38955768,1518,38957286,0,1,1,1536,36,3501063598
3200,38960732,47288,39008020,0,2,0,1536,8,6065181290
3201,38965701,11533,38977234,0,1,1,18944,36,4577258143
3202,38978094,15837,38993931,0,1,1,30720,36,8222480226
3203,38983046,13791,38996837,0,1,1,4608,36,10634000239
3204,39019556,7706,39027262,0,1,1,8192,36,8672032235
3205,39033343,43904,39077247,0,2,0,512,8,7101518457
3206,39050476,57440,39107916,0,2,0,4608,8,2838982130
3207,39082697,5802,39088499,0,1,1,6144,36,7219060316
3208,39109317,45596,39154913,0,2,0,1024,8,6674327226
3209,39124628,22691,39147319,0,1,1,37376,36,9302483858
3210,39124834,105872,39230706,0,8,0,47616,27,5771344962
3211,39201854,15837,39217691,0,1,1,30720,36,5313410717
3212,39205506,43904,39249410,0,2,0,512,8,4098558169
3213,39241623,13083,39254706,0,1,1,22016,36,2757084063
3214,39249936,50672,39300608,0,2,0,2560,8,4311142047
3215,39253055,101504,39354559,0,8,0,33280,27,506139289
3216,39302837,14029,39316866,0,1,1,27136,36,1029871600
3217,39314144,13083,39327227,0,1,1,22016,36,694693396
3218,39323836,83624,39407460,0,0,0,19968,38,8224699365
3219,39334176,1042,39335218,0,2,1,1024,8,10302156220
3220,39402268,6278,39408546,0,4,1,6656,21,323546374
3221,39433946,105716,39539662,0,8,0,47104,27,1405250370
3222,39441983,43904,39485887,0,2,0,512,8,947099777
3223,39470388,10499,39480887,0,1,1,16896,36,6543292722
3224,39497171,107276,39604447,0,8,0,52224,27,1529211539
3225,39536747,6278,39543025,0,1,1,6656,36,3096970870
3226,39559338,64912,39624250,0,1,1,109568,36,2345383381
3227,39567230,63229,39630459,0,1,1,29696,36,9361830727
3228,39611789,4679,39616468,0,2,1,12288,8,5537548066
3229,39624021,43904,39667925,0,2,0,512,8,1606613350
3230,39636039,112268,39748307,0,8,0,68608,27,3203946714
3231,39676387,2946,39679333,0,2,1,3072,8,4163372597
3232,39679641,107588,39787229,0,0,0,53248,38,6592023215
3233,39746654,105177,39851831,0,8,0,39936,27,655181544
3234,39760814,43904,39804718,0,2,0,512,8,8882952636
3235,39794275,50672,39844947,0,2,0,2560,8,8586349298
3236,39807482,566,39808048,0,2,1,512,8,7798254239
3237,39877808,4679,39882487,0,1,1,12288,36,550613527
3238,39932987,45596,39978583,0,8,0,1024,27,8363320844
3239,39933896,50672,39984568,0,2,0,2560,8,2543503087
3240,39942104,1042,39943146,0,6,1,1024,42,7851118518
3241,39944059,106808,40050867,0,0,0,50688,38,1815294231
3242,39944187,152088,40096275,0,0,0,38400,38,4287160880
3243,39976629,4162,39980791,0,1,1,11264,36,7591368896
3244,39979697,175754,40155451,0,1,1,284672,36,8933164769
3245,39987454,5196,39992650,0,8,1,13312,27,10284666631
3246,39995993,1042,39997035,0,2,1,1024,8,912688832
3247,40021678,3422,40025100,0,8,1,3584,27,3199955417
3248,40026476,116887,40143363,0,0,0,9216,38,10072544672
3249,40031311,1994,40033305,0,8,1,2048,27,9859259732
3250,40050117,93533,40143650,0,2,0,512,8,517652175
3251,40054162,112580,40166742,0,8,0,69632,27,5933432222
3252,40073414,102568,40175982,0,8,0,9216,27,3718220200
3253,40089062,87792,40176854,0,1,1,77824,36,2245869927
3254,40099826,5326,40105152,0,9,1,5632,20,2542663513
3255,40110099,566,40110665,0,8,1,512,27,5834232563
3256,40208275,73058,40281333,0,1,1,118784,36,2432597587
3257,40210443,43904,40254347,0,2,0,512,8,8776543278
3258,40216956,59237,40276193,0,2,0,512,8,5000302552
3259,40231855,3898,40235753,0,3,1,4096,4,5215256724
3260,40257357,99344,40356701,0,0,0,31232,38,852566785
3261,40262631,30556,40293187,0,1,1,48640,36,3089369020
3262,40272587,43904,40316491,0,2,0,512,8,1483515234
3263,40276388,138045,40414433,0,0,0,59392,38,1492065478
3264,40292044,7706,40299750,0,3,1,8192,4,7462175865
3265,40298877,6278,40305155,0,8,1,6656,27,3157269203
3266,40318647,83416,40402063,0,8,0,15872,27,5175407732
3267,40337825,101504,40439329,0,8,0,33280,27,3370594853
3268,40347714,174276,40521990,0,8,0,35840,27,6494653622
3269,40366906,4679,40371585,0,1,1,12288,36,9095147429
3270,40374639,11533,40386172,0,4,1,18944,21,5557503902
3271,40381539,5299,40386838,0,4,1,1024,21,3250897695
3272,40431489,5802,40437291,0,4,1,6144,21,5101295193
3273,40440136,5326,40445462,0,8,1,5632,27,9918501406
3274,40444900,1994,40446894,0,4,1,2048,21,5343943860
3275,40445639,3422,40449061,0,8,1,3584,27,4980209502
3276,40466288,3128,40469416,0,3,1,9216,4,3431941241
3277,40469047,3996,40473043,0,3,1,4096,4,10043559581
3278,40477032,43904,40520936,0,2,0,512,8,517719507
3279,40486703,2946,40489649,0,4,1,3072,21,446281872
3280,40499035,5802,40504837,0,1,1,6144,36,8608744193
3281,40504161,6229,40510390,0,8,1,15360,27,6174676863
3282,40506713,98245,40604958,0,8,0,20480,27,8859648253
3283,40508073,3904,40511977,0,3,1,10752,4,2464793831
3284,40576319,3904,40580223,0,3,1,10752,4,619294333
3285,40581375,156177,40737552,0,8,0,8192,27,3765909727
3286,40585240,6229,40591469,0,4,1,15360,21,10554129800
3287,40603658,92128,40695786,0,8,0,18432,27,3419513303
3288,40611547,5326,40616873,0,1,1,5632,36,6228264787
3289,40613211,1042,40614253,0,4,1,1024,21,5390775093
3290,40614357,45596,40659953,0,2,0,1024,8,3489132686
3291,40618169,5326,40623495,0,7,1,5632,41,3218569725
3292,40623410,43904,40667314,0,2,0,512,8,10521496885
3293,40637602,62516,40700118,0,8,0,6144,27,8301665130
3294,40670389,74483,40744872,0,8,0,10752,27,6902948982
3295,40672677,1042,40673719,0,7,1,1024,41,397087743
3296,40690801,6971,40697772,0,8,1,2048,27,3130231258
3297,40695841,31783,40727624,0,1,1,51712,36,1605187702
3298,40696996,1042,40698038,0,4,1,1024,21,221260056
3299,40717969,1994,40719963,0,4,1,2048,21,7045218133
3300,40724827,10241,40735068,0,4,1,16384,21,3241832937
3301,40754564,47288,40801852,0,2,0,1536,8,1246500739
3302,40760716,100880,40861596,0,8,0,31232,27,8084155259
3303,40762722,109809,40872531,0,8,0,35840,27,4558287332
3304,40786199,1042,40787241,0,8,1,1024,27,876027110
3305,40789813,5802,40795615,0,7,1,6144,41,7128189401
3306,40790320,66721,40857041,0,1,1,113152,36,10318641452
3307,40827337,5712,40833049,0,4,1,14336,21,8387388852
3308,40849816,1518,40851334,0,4,1,1536,21,8210093877
3309,40870046,6851,40876897,0,8,1,4608,27,7615577457
3310,40878867,5802,40884669,0,7,1,6144,41,1245384314
3311,40898390,1518,40899908,0,7,1,1536,41,1916460734
3312,40918704,3128,40921832,0,8,1,9216,27,4750976654
3313,40921020,10499,40931519,0,1,1,16896,36,10250474283
3314,40943431,2470,40945901,0,6,1,2560,42,4978028507
3315,40959406,4679,40964085,0,7,1,12288,41,3831094858
3316,40976278,206202,41182480,0,8,0,15360,27,117829409
3317,40978306,45596,41023902,0,2,0,1024,8,4964962436
3318,40985803,11533,40997336,0,7,1,18944,41,404702841
3319,40991614,3422,40995036,0,8,1,3584,27,530155703
3320,41005417,5454,41010871,0,3,1,13824,4,1390303244
3321,41016291,76052,41092343,0,0,0,10240,38,6007574750
3322,41018510,111332,41129842,0,8,0,65536,27,9798274249
3323,41026038,51257,41077295,0,1,1,82944,36,10208606804
3324,41065315,2946,41068261,0,8,1,3072,27,2738377628
3325,41096235,83700,41179935,0,1,1,136192,36,4543461599
3326,41099099,91973,41191072,0,1,1,45056,36,4813698358
3327,41104186,142260,41246446,0,8,0,22528,27,1423001125
3328,41132642,58789,41191431,0,1,1,9728,36,1947702778
3329,41135911,60824,41196735,0,0,0,5632,38,70716308
3330,41159103,4850,41163953,0,2,1,5120,8,3692494728
3331,41185527,4420,41189947,0,8,1,11776,27,5033090894
3332,41195262,217506,41412768,0,8,0,59392,27,4862677731
3333,41195732,6278,41202010,0,8,1,6656,27,2671253170
3334,41225450,83780,41309230,0,0,0,20480,38,449266479
3335,41230022,3387,41233409,0,1,1,9728,36,5831311739
3336,41239959,3422,41243381,0,6,1,3584,42,5119244766
3337,41244325,43904,41288229,0,2,0,512,8,8348028167
3338,41248053,2870,41250923,0,2,1,8704,8,9719102339
3339,41249926,51500,41301426,0,2,0,2560,8,2601480048
3340,41265310,1042,41266352,0,9,1,1024,20,540317941
3341,41279156,2470,41281626,0,8,1,2560,27,7454739123
3342,41290152,3645,41293797,0,3,1,10240,4,953191577
3343,41292036,86256,41378292,0,8,0,11776,27,8534098279
3344,41322198,45752,41367950,0,2,0,1536,8,1807002046
3345,41322605,2946,41325551,0,7,1,3072,41,9426162483
3346,41325606,1994,41327600,0,2,1,2048,8,7656274547
3347,41358358,6754,41365112,0,9,1,7168,20,6230410904
3348,41363722,1994,41365716,0,2,1,2048,8,4244334890
3349,41365264,3898,41369162,0,2,1,4096,8,6817190890
3350,41380755,103532,41484287,0,8,0,39936,27,1259766976
3351,41390840,1042,41391882,0,2,1,1024,8,295911375
3352,41418760,4374,41423134,0,8,1,4608,27,5454496587
3353,41427988,47288,41475276,0,2,0,1536,8,9058276117
3354,41434834,7230,41442064,0,9,1,7680,20,1731444145
3355,41448673,1518,41450191,0,9,1,1536,20,1592027575
3356,41456880,12308,41469188,0,7,1,20480,41,10721242591
3357,41461607,54692,41516299,0,2,0,512,8,9258346274
3358,41481353,6754,41488107,0,3,1,7168,4,3567773350
3359,41483853,1042,41484895,0,7,1,1024,41,3213557045
3360,41483974,7535,41491509,0,8,1,7680,27,7749943116
3361,41492760,2870,41495630,0,8,1,8704,27,1227470974
3362,41503536,43904,41547440,0,2,0,512,8,8336969171
3363,41509755,1518,41511273,0,6,1,1536,42,838804498
3364,41512225,1994,41514219,0,3,1,2048,4,7602217841
3365,41557103,5326,41562429,0,6,1,5632,42,1060367667
3366,41559313,113984,41673297,0,0,0,74240,38,9420385706
3367,41596350,566,41596916,0,8,1,512,27,458592641
3368,41603748,4374,41608122,0,6,1,4608,42,5794091466
3369,41606831,3237,41610068,0,6,1,3072,42,8096516594
3370,41608567,7706,41616273,0,3,1,8192,4,9399671989
3371,41615642,3898,41619540,0,3,1,4096,4,6252678749
3372,41620039,3422,41623461,0,3,1,3584,4,5872348364
3373,41637653,5802,41643455,0,6,1,6144,42,9844946974
3374,41642164,1042,41643206,0,8,1,1024,27,10225887727
3375,41650265,2470,41652735,0,2,1,2560,8,1178575986
3376,41656828,1042,41657870,0,6,1,1024,42,3101817570
3377,41659106,3898,41663004,0,6,1,4096,42,437542017
3378,41669549,47288,41716837,0,2,0,1536,8,3752826789
3379,41689440,4679,41694119,0,9,1,12288,20,3399280669
3380,41689636,6109,41695745,0,9,1,2560,20,1720448933
3381,41695815,3422,41699237,0,6,1,3584,42,6210675453
3382,41711431,1994,41713425,0,8,1,2048,27,7898808707
3383,41717376,2470,41719846,0,2,1,2560,8,2688776766
3384,41733835,196208,41930043,0,0,0,182784,38,9611723340
3385,41738812,566,41739378,0,7,1,512,41,6494656170
3386,41765817,3904,41769721,0,7,1,10752,41,1921169879
3387,41768209,138291,41906500,0,8,0,119808,27,6151737751
3388,41768289,5532,41773821,0,7,1,12288,41,3960809122
3389,41778097,6278,41784375,0,2,1,6656,8,1464930099
3390,41778650,45428,41824078,0,2,0,512,8,6933846868
3391,41779150,5379,41784529,0,2,1,8704,8,10720715495
3392,41786403,3422,41789825,0,2,1,3584,8,6295804427
3393,41805684,10757,41816441,0,1,1,17408,36,4607697560
3394,41822689,3898,41826587,0,7,1,4096,41,5911427364
3395,41823465,3387,41826852,0,9,1,9728,20,9782821744
3396,41845565,1042,41846607,0,3,1,1024,4,10541998571
3397,41846354,47288,41893642,0,2,0,1536,8,5097410951
3398,41847476,2946,41850422,0,9,1,3072,20,5722727167
3399,41852445,5802,41858247,0,9,1,6144,20,7969689430
3400,41870806,566,41871372,0,3,1,512,4,3850417077
3401,41874507,5326,41879833,0,2,1,5632,8,5353513769
3402,41878842,31337,41910179,0,8,1,10240,27,10216717744
3403,41886551,26748,41913299,0,8,1,10240,27,8655571342
3404,41897980,90650,41988630,0,8,0,19968,27,2163309769
3405,41919877,7230,41927107,0,1,1,7680,36,118570777
3406,41926970,5454,41932424,0,8,1,13824,27,8537339085
3407,41951251,1994,41953245,0,8,1,2048,27,5465778906
3408,41955270,2870,41958140,0,6,1,8704,42,9604319103
3409,41964138,108524,42072662,0,0,0,56320,38,2888159459
3410,41967239,43904,42011143,0,2,0,512,8,5859016606
3411,41979765,5802,41985567,0,6,1,6144,42,5327733550
3412,42014965,2470,42017435,0,2,1,2560,8,1841769387
3413,42024461,6278,42030739,0,8,1,6656,27,8605917547
3414,42033451,100256,42133707,0,0,0,29184,38,370962827
3415,42051417,1518,42052935,0,7,1,1536,41,39592978
3416,42058281,11791,42070072,0,8,1,19456,27,5030451261
3417,42067084,271046,42338130,0,8,0,264704,27,6760221528
3418,42074835,1518,42076353,0,3,1,1536,4,10426025536
3419,42089290,133961,42223251,0,0,0,78848,38,292824553
3420,42099512,41391,42140903,0,1,1,67072,36,4874917395
3421,42117414,566,42117980,0,7,1,512,41,5024196926
3422,42172395,4679,42177074,0,3,1,12288,4,4859133794
3423,42196309,5802,42202111,0,7,1,6144,41,4903395190
3424,42218530,52549,42271079,0,1,1,85504,36,1146506760
3425,42234062,38093,42272155,0,1,1,13312,36,928670303
3426,42236332,5196,42241528,0,3,1,13312,4,10043722615
3427,42244713,129198,42373911,0,8,0,7680,27,6108316633
3428,42245453,109148,42354601,0,0,0,58368,38,2988167050
3429,42249227,45596,42294823,0,2,0,1024,8,3826216612
3430,42251179,1042,42252221,0,8,1,1024,27,4299233560
3431,42264984,76592,42341576,0,8,1,9728,27,6812052565
3432,42265854,3387,42269241,0,6,1,9728,42,446297882
3433,42280260,166879,42447139,0,8,0,57856,27,1413853611
3434,42280745,135327,42416072,0,8,0,11264,27,5589991997
3435,42295884,137341,42433225,0,0,0,72192,38,805095568
3436,42309564,1518,42311082,0,6,1,1536,42,4227130058
3437,42310218,43904,42354122,0,2,0,512,8,9171166307
3438,42318300,45596,42363896,0,2,0,1024,8,179534017
3439,42333187,11388,42344575,0,8,1,3584,27,10311062363
3440,42362241,168094,42530335,0,8,0,31232,27,5863904527
3441,42375834,6754,42382588,0,7,1,7168,41,8702388897
3442,42400856,4850,42405706,0,6,1,5120,42,5041446912
3443,42413683,6754,42420437,0,6,1,7168,42,9404013137
3444,42424736,4374,42429110,0,8,1,4608,27,9439673686
3445,42445487,4850,42450337,0,6,1,5120,42,732322500
3446,42500543,3128,42503671,0,3,1,9216,4,5345143083
3447,42501153,4717,42505870,0,3,1,2560,4,2858041577
3448,42511068,7706,42518774,0,8,1,8192,27,6959636977
3449,42583468,1042,42584510,0,3,1,1024,4,8753545392
3450,42624711,6278,42630989,0,3,1,6656,4,790794926
3451,42627142,3422,42630564,0,8,1,3584,27,5833174740
3452,42628315,5155,42633470,0,8,1,4608,27,5562845474
3453,42641769,54680,42696449,0,0,0,5632,38,2323056027
3454,42651398,207401,42858799,0,8,0,92160,27,3379095937
3455,42654418,3128,42657546,0,6,1,9216,42,3616614005
3456,42659435,43904,42703339,0,2,0,512,8,356088834
3457,42727262,45596,42772858,0,2,0,1024,8,2950709765
3458,42736427,45596,42782023,0,2,0,1024,8,9234508492
3459,42745857,4850,42750707,0,1,1,5120,36,2283506751
3460,42752741,3645,42756386,0,6,1,10240,42,2691248532
3461,42820236,1994,42822230,0,6,1,2048,42,5004917066
3462,42847155,32299,42879454,0,1,1,52736,36,6552670026
3463,42850701,35269,42885970,0,1,1,31232,36,10094033434
3464,42866194,6754,42872948,0,3,1,7168,4,9592314500
3465,42871362,1994,42873356,0,7,1,2048,41,8884172433
3466,42872069,115856,42987925,0,0,0,80384,38,8471316207
3467,42886002,566,42886568,0,6,1,512,42,417367678
3468,42895622,2946,42898568,0,8,1,3072,27,3132049704
3469,42900328,90732,42991060,0,0,0,10240,38,1120761510
3470,42910347,20366,42930713,0,1,1,32768,36,1937312650
3471,42924514,566,42925080,0,6,1,512,42,4333069993
3472,42953103,6754,42959857,0,7,1,7168,41,7776838203
3473,42961622,2946,42964568,0,7,1,3072,41,10406315616
3474,42976747,5802,42982549,0,8,1,6144,27,5805054435
3475,42978242,13600,42991842,0,6,1,23040,42,4933695559
3476,42999905,2470,43002375,0,7,1,2560,41,9875340613
3477,43015569,43904,43059473,0,2,0,512,8,8971009716
3478,43018371,4374,43022745,0,3,1,4608,4,3879268412
3479,43041709,5454,43047163,0,3,1,13824,4,9031867629
3480,43063654,5802,43069456,0,5,1,6144,46,3243832603
3481,43075066,2946,43078012,0,3,1,3072,4,3488948287
3482,43093561,1042,43094603,0,8,1,1024,27,1179869710
3483,43097656,1518,43099174,0,3,1,1536,4,7624402245
3484,43101860,100880,43202740,0,8,0,31232,27,3671153022
3485,43145630,60824,43206454,0,2,0,5632,8,2438384164
3486,43156822,21919,43178741,0,1,1,35840,36,10252048554
3487,43156866,33862,43190728,0,1,1,37888,36,2238138512
3488,43192626,4937,43197563,0,7,1,12800,41,5302066299
3489,43193247,2470,43195717,0,3,1,2560,4,2208605035
3490,43205422,44928,43250350,0,2,0,512,8,5286241883
3491,43208872,3904,43212776,0,1,1,10752,36,2477142675
3492,43228410,12308,43240718,0,8,1,20480,27,4488446240
3493,43245785,1994,43247779,0,6,1,2048,42,2753386055
3494,43252042,1994,43254036,0,6,1,2048,42,8921216051
3495,43263472,3904,43267376,0,8,1,10752,27,10037924775
3496,43265789,5326,43271115,0,7,1,5632,41,6679096886
3497,43275252,566,43275818,0,7,1,512,41,2172567607
3498,43278203,114228,43392431,0,8,0,65536,27,10467025136
3499,43280782,5971,43286753,0,7,1,14848,41,3508311525
3500,43289128,43904,43333032,0,2,0,512,8,4689282335
3501,43298231,116792,43415023,0,0,0,83456,38,8807857602
3502,43312329,4374,43316703,0,8,1,4608,27,7638428995
3503,43315336,566,43315902,0,6,1,512,42,6773459532
3504,43332813,1994,43334807,0,8,1,2048,27,5440666778
3505,43333082,8110,43341192,0,8,1,8192,27,6930794205
3506,43334137,5802,43339939,0,3,1,6144,4,10421851837
3507,43338720,4850,43343570,0,7,1,5120,41,3657805993
3508,43349562,1994,43351556,0,3,1,2048,4,214758474
3509,43353069,7230,43360299,0,3,1,7680,4,7202106108
3510,43358093,2552,43360645,0,3,1,512,4,1634464523
3511,43360372,59685,43420057,0,0,0,3072,38,629955315
3512,43366566,5454,43372020,0,3,1,13824,4,4658290209
3513,43373351,16354,43389705,0,6,1,31744,42,6995091173
3514,43379269,16576,43395845,0,8,1,3584,27,5541644586
3515,43392732,1042,43393774,0,7,1,1024,41,2524201573
3516,43403573,90590,43494163,0,0,0,15360,38,10090389798
3517,43428867,89588,43518455,0,0,0,14336,38,4111631362
3518,43435695,33245,43468940,0,1,1,57856,36,5892505192
3519,43440003,1042,43441045,0,2,1,1024,8,1712677831
3520,43449184,566,43449750,0,7,1,512,41,8709223084
3521,43462144,4850,43466994,0,3,1,5120,4,7929580177
3522,43514047,1994,43516041,0,3,1,2048,4,7328627916
3523,43521022,566,43521588,0,6,1,512,42,7621106684
3524,43521584,1042,43522626,0,7,1,1024,41,380903893
3525,43522562,48980,43571542,0,2,0,2048,8,5997445183
3526,43524079,1518,43525597,0,8,1,1536,27,2067167255
3527,43535270,110708,43645978,0,0,0,63488,38,8845895053
3528,43546234,4374,43550608,0,3,1,4608,4,1605339497
3529,43546504,7706,43554210,0,8,1,8192,27,2058024774
3530,43577917,46988,43624905,0,8,1,81408,27,7712126184
3531,43601276,92274,43693550,0,1,1,149504,36,223932918
3532,43606336,2470,43608806,0,7,1,2560,41,1333473654
3533,43619049,130017,43749066,0,8,0,17920,27,8171781468
3534,43619196,1994,43621190,0,3,1,2048,4,7944266210
3535,43659792,40171,43699963,0,1,1,30720,36,1368209286
3536,43668755,4850,43673605,0,6,1,5120,42,6153607646
3537,43686457,20022,43706479,0,1,1,23040,36,9892979196
3538,43729402,1518,43730920,0,7,1,1536,41,9467186336
3539,43747505,125404,43872909,0,1,1,207360,36,6538829084
3540,43751141,52364,43803505,0,2,0,3072,8,337081284
3541,43765604,108931,43874535,0,1,1,2560,36,3632760186
3542,43775151,2470,43777621,0,8,1,2560,27,3535486334
3543,43778988,5326,43784314,0,6,1,5632,42,1151152813
3544,43785779,2946,43788725,0,2,1,3072,8,6740063869
3545,43791454,3387,43794841,0,4,1,9728,21,1169550705
3546,43796379,1042,43797421,0,6,1,1024,42,4914625839
3547,43796667,83974,43880641,0,1,1,29184,36,1925990932
3548,43817662,79249,43896911,0,1,1,61440,36,4421969859
3549,43848504,87608,43936112,0,0,0,17920,38,8398396979
3550,43858909,38668,43897577,0,1,1,1024,36,1231981772
3551,43891251,98072,43989323,0,0,0,22016,38,2547379130
3552,43892718,9685,43902403,0,1,1,7680,36,9487795383
3553,43904026,70991,43975017,0,8,1,114688,27,3630436327
3554,43922734,566,43923300,0,6,1,512,42,9399927897
3555,43947205,566,43947771,0,7,1,512,41,9457833595
3556,43961934,125233,44087167,0,8,1,203776,27,4163559779
3557,43966693,7706,43974399,0,1,1,8192,36,3546161414
3558,43969145,3422,43972567,0,6,1,3584,42,9670495202
3559,44004279,566,44004845,0,3,1,512,4,6964964316
3560,44004893,109322,44114215,0,8,1,88576,27,6627823813
3561,44030164,3898,44034062,0,7,1,4096,41,3435644100
3562,44034748,3422,44038170,0,1,1,3584,36,2046633595
3563,44075863,1994,44077857,0,6,1,2048,42,8099490226
3564,44084787,10241,44095028,0,6,1,16384,42,26634995
3565,44085617,1042,44086659,0,1,1,1024,36,9528260617
3566,44087542,9074,44096616,0,6,1,15872,42,9124210345
3567,44093217,1518,44094735,0,1,1,1536,36,10255118635
3568,44098062,47288,44145350,0,2,0,1536,8,8303002728
3569,44100944,107276,44208220,0,0,0,52224,38,2438720326
3570,44113384,4374,44117758,0,7,1,4608,41,7579422151
3571,44148152,10757,44158909,0,6,1,17408,42,168377627
3572,44152834,3898,44156732,0,7,1,4096,41,7460796526
3573,44181812,14804,44196616,0,8,1,28672,27,7166458817
3574,44182963,1042,44184005,0,5,1,1024,46,1001745047
3575,44187732,47357,44235089,0,8,1,73216,27,7440719396
3576,44198489,80855,44279344,0,0,0,9216,38,5077622157
3577,44232576,1518,44234094,0,6,1,1536,42,541541322
3578,44235699,4850,44240549,0,6,1,5120,42,5917296700
3579,44253246,107588,44360834,0,0,0,53248,38,6254801044
3580,44256173,1518,44257691,0,5,1,1536,46,8282727293
3581,44256325,31007,44287332,0,8,1,50176,27,544189630
3582,44276908,47288,44324196,0,2,0,1536,8,5296433234
3583,44283729,153511,44437240,0,8,0,23040,27,7785666031
3584,44293686,6278,44299964,0,5,1,6656,46,3773190909
3585,44304142,2470,44306612,0,5,1,2560,46,7250329024
3586,44305039,99889,44404928,0,0,0,15360,38,9830206948
3587,44318388,232648,44551036,0,8,0,36352,27,8066183362
3588,44318508,4374,44322882,0,7,1,4608,41,9362706582
3589,44322638,208579,44531217,0,8,0,26112,27,1703376024
3590,44353804,169434,44523238,0,8,0,77312,27,3883279262
3591,44365490,112644,44478134,0,0,0,27648,38,298531793
3592,44366664,3898,44370562,0,5,1,4096,46,4884510140
3593,44381258,1518,44382776,0,7,1,1536,41,2610057580
3594,44407607,1518,44409125,0,4,1,1536,21,9972298669
3595,44413903,1994,44415897,0,6,1,2048,42,8410831673
3596,44464071,6278,44470349,0,6,1,6656,42,8281480765
3597,44469317,118976,44588293,0,0,0,90624,38,5813693046
3598,44491697,68216,44559913,0,8,0,9728,27,4511017615
3599,44492547,152572,44645119,0,0,0,49152,38,3068355677
3600,44507580,4374,44511954,0,7,1,4608,41,6538883172
3601,44514059,43904,44557963,0,2,0,512,8,6073023532
3602,44515165,20948,44536113,0,8,1,12800,27,6553065953
3603,44516757,3898,44520655,0,6,1,4096,42,3752396739
3604,44531468,45596,44577064,0,2,0,1024,8,9561994937
3605,44536322,566,44536888,0,4,1,512,21,10093304327
3606,44555677,110826,44666503,0,8,0,31232,27,2657223598
3607,44555831,566,44556397,0,7,1,512,41,9772759763
3608,44562933,1518,44564451,0,4,1,1536,21,9760876865
3609,44569828,7230,44577058,0,4,1,7680,21,6092801082
3610,44580835,104156,44684991,0,8,0,41984,27,5891227693
3611,44589221,3387,44592608,0,7,1,9728,41,7398980462
3612,44624404,1518,44625922,0,6,1,1536,42,2043820953
3613,44632090,43904,44675994,0,2,0,512,8,2097446663
3614,44633771,566,44634337,0,2,1,512,8,6107778358
3615,44659036,70547,44729583,0,8,0,4608,27,2718241328
3616,44694630,6278,44700908,0,6,1,6656,42,3797536018
3617,44707873,1042,44708915,0,7,1,1024,41,6519478733
3618,44730629,47288,44777917,0,8,0,1536,27,5737373311
3619,44756670,6754,44763424,0,7,1,7168,41,5957221608
3620,44802257,4850,44807107,0,2,1,5120,8,8731056899
3621,44808271,123188,44931459,0,0,0,104448,38,7309858085
3622,44821944,144159,44966103,0,0,0,56832,38,1648522064
3623,44839253,4937,44844190,0,8,1,12800,27,4212496012
3624,44847056,1042,44848098,0,7,1,1024,41,9334643402
3625,44898106,566,44898672,0,4,1,512,21,2435028356
3626,44898272,1518,44899790,0,8,1,1536,27,8533458553
3627,44900195,1518,44901713,0,4,1,1536,21,4034059080
3628,44914100,56337,44970437,0,8,1,96256,27,3839114778
3629,44914962,181519,45096481,0,8,0,39936,27,9749272608
3630,44923796,96403,45020199,0,0,0,15360,38,6125907439
3631,44926288,1042,44927330,0,5,1,1024,46,6985401370
3632,44944235,4850,44949085,0,4,1,5120,21,8022057157
3633,44947394,5712,44953106,0,4,1,14336,21,7512747465
3634,44949329,1994,44951323,0,7,1,2048,41,1729291047
3635,44950400,43904,44994304,0,2,0,512,8,9123639139
3636,44950691,2470,44953161,0,5,1,2560,46,8340245060
3637,44952819,2470,44955289,0,2,1,2560,8,4925124095
3638,44961503,107116,45068619,0,0,0,23040,38,4205831123
3639,44989911,4408,44994319,0,2,1,4608,8,9246441800
3640,45000005,3422,45003427,0,8,1,3584,27,5369802718
3641,45002598,1815,45004413,0,8,1,1536,27,6659780357
3642,45015742,2946,45018688,0,7,1,3072,41,2210345819
3643,45015850,4850,45020700,0,2,1,5120,8,9727596671
3644,45035682,71624,45107306,0,0,0,15872,38,2693598832
3645,45049706,114433,45164139,0,0,0,36864,38,295660068
3646,45080647,96630,45177277,0,8,0,25600,27,6810580231
3647,45083494,6278,45089772,0,7,1,6656,41,6546018532
3648,45084444,43904,45128348,0,2,0,512,8,7291628562
3649,45088658,1042,45089700,0,4,1,1024,21,8721093744
3650,45093760,3898,45097658,0,7,1,4096,41,5164243298
3651,45102293,2470,45104763,0,2,1,2560,8,7230296696
3652,45106357,75140,45181497,0,8,0,12288,27,4616601049
3653,45119004,4679,45123683,0,7,1,12288,41,8892632076
3654,45142544,12308,45154852,0,8,1,20480,27,10521885344
3655,45159656,5802,45165458,0,7,1,6144,41,5967060659
3656,45166193,2946,45169139,0,4,1,3072,21,5566219333
3657,45167618,6754,45174372,0,2,1,7168,8,5559378835
3658,45173078,9645,45182723,0,8,1,13824,27,9810135388
3659,45173782,112892,45286674,0,0,0,70656,38,6982017714
3660,45181964,2870,45184834,0,4,1,8704,21,7487327668
3661,45182563,4420,45186983,0,5,1,11776,46,8446575664
3662,45197620,3422,45201042,0,7,1,3584,41,5945238721
3663,45199611,3422,45203033,0,4,1,3584,21,6635891834
3664,45204189,45596,45249785,0,8,0,1024,27,3410905236
3665,45243750,12566,45256316,0,5,1,20992,46,2939007570
3666,45271992,47288,45319280,0,2,0,1536,8,6487919405
3667,45273622,3898,45277520,0,5,1,4096,46,6154426289
3668,45276997,1994,45278991,0,2,1,2048,8,8189294199
3669,45287472,2946,45290418,0,4,1,3072,21,7598487020
3670,45316109,182060,45498169,0,9,0,146432,20,461957121
3671,45349162,2946,45352108,0,7,1,3072,41,8688442943
3672,45369261,2470,45371731,0,7,1,2560,41,3279264489
3673,45406570,4374,45410944,0,5,1,4608,46,8955734124
3674,45443595,47288,45490883,0,2,0,1536,8,3937604053
3675,45454705,4850,45459555,0,5,1,5120,46,2216229552
3676,45459033,65612,45524645,0,8,0,11264,27,4590703157
3677,45459831,101930,45561761,0,8,0,32256,27,4673554669
3678,45470817,71507,45542324,0,8,1,115712,27,4186550140
3679,45500784,48980,45549764,0,2,0,2048,8,8083963160
3680,45514205,57440,45571645,0,0,0,4608,38,10178268431
3681,45529244,13541,45542785,0,8,1,10240,27,7135261635
3682,45542613,10241,45552854,0,4,1,16384,21,1286517272
3683,45550892,10884,45561776,0,8,1,5120,27,7157994917
3684,45557733,99947,45657680,0,8,0,18944,27,1398633072
3685,45560514,566,45561080,0,2,1,512,8,9979941156
3686,45562737,179061,45741798,0,8,0,13312,27,5503657026
3687,45578263,3387,45581650,0,7,1,9728,41,9969923649
3688,45579616,3898,45583514,0,2,1,4096,8,5672484381
3689,45583904,254200,45838104,0,8,0,14336,27,379870616
3690,45605823,48980,45654803,0,2,0,2048,8,5906801035
3691,45627993,2946,45630939,0,1,1,3072,36,10061341634
3692,45650648,1518,45652166,0,5,1,1536,46,6185232664
3693,45668581,165140,45833721,0,8,0,141312,27,7360421508
3694,45671793,50672,45722465,0,0,0,2560,38,6675456205
3695,45702010,5712,45707722,0,2,1,14336,8,1517565779
3696,45704267,141496,45845763,0,8,0,25088,27,10076582661
3697,45712666,566,45713232,0,7,1,512,41,9824777067
3698,45730009,43904,45773913,0,2,0,512,8,5435376476
3699,45742635,36087,45778722,0,8,1,63488,27,3374747038
3700,45776244,4374,45780618,0,4,1,4608,21,1898054195
3701,45829161,1994,45831155,0,4,1,2048,21,941257795
3702,45837999,3422,45841421,0,2,1,3584,8,431537254
3703,45839808,3387,45843195,0,4,1,9728,21,9573129712
3704,45863295,566,45863861,0,2,1,512,8,10666270108
3705,45872946,110708,45983654,0,2,0,63488,8,2263446057
3706,45876481,156997,46033478,0,2,0,75776,8,5455129800
3707,45894342,101036,45995378,0,8,0,31744,27,3497849926
3708,45940678,5454,45946132,0,4,1,13824,21,6763091928
3709,45940891,162308,46103199,0,2,0,82944,8,2187467611
3710,45950999,1042,45952041,0,4,1,1024,21,10691002608
3711,45965348,140362,46105710,0,2,0,8192,8,3051490203
3712,46012434,111800,46124234,0,0,0,67072,38,103584329
3713,46018972,155194,46174166,0,0,0,69632,38,6892391569
3714,46065452,566,46066018,0,4,1,512,21,588378688
3715,46068953,180992,46249945,0,2,0,147968,8,8314955128
3716,46095392,3422,46098814,0,4,1,3584,21,8636142733
3717,46099820,72668,46172488,0,8,0,9216,27,5767636707
3718,46101860,2946,46104806,0,1,1,3072,36,3885764623
3719,46129085,170894,46299979,0,2,0,99328,8,541026435
3720,46136435,2470,46138905,0,4,1,2560,21,6119455522
3721,46155085,75913,46230998,0,0,0,7680,38,6218996150
3722,46178823,3898,46182721,0,4,1,4096,21,4383103869
3723,46301578,56684,46358262,0,0,0,7168,38,2615956281
3724,46446143,4162,46450305,0,6,1,11264,42,5928134411
3725,46453529,60824,46514353,0,0,0,5632,38,8777957250
3726,46476479,113516,46589995,0,2,0,72704,8,8154428190
3727,46476712,1518,46478230,0,4,1,1536,21,8371458055
3728,46561005,63452,46624457,0,0,0,9216,38,10348262613
3729,46564107,1518,46565625,0,4,1,1536,21,68270531
3730,46577697,3128,46580825,0,4,1,9216,21,1138279214
3731,46586940,1042,46587982,0,7,1,1024,41,5095889516
3732,46590835,3898,46594733,0,2,1,4096,8,2688111684
3733,46603078,4420,46607498,0,4,1,11776,21,1446172577
3734,46608036,102440,46710476,0,0,0,36352,38,8200820488
3735,46610673,1042,46611715,0,9,1,1024,20,1754344850
3736,46627038,2470,46629508,0,2,1,2560,8,10435996884
3737,46627418,43904,46671322,0,8,0,512,27,9178367237
3738,46651224,13083,46664307,0,2,1,22016,8,7789110885
3739,46667195,97604,46764799,0,8,0,20480,27,1860963808
3740,46675057,4850,46679907,0,4,1,5120,21,3006315046
3741,46681815,62516,46744331,0,8,0,6144,27,9399227452
3742,46716702,3387,46720089,0,4,1,9728,21,10550584569
3743,46744611,220418,46965029,0,2,0,195584,8,5059508501
3744,46748846,566,46749412,0,2,1,512,8,7806579881
3745,46767840,3898,46771738,0,6,1,4096,42,1739866806
3746,46772752,1042,46773794,0,9,1,1024,20,4623615459
3747,46795647,4374,46800021,0,9,1,4608,20,3910983410
3748,46815885,79436,46895321,0,8,0,11264,27,9350396414
3749,46818477,6278,46824755,0,2,1,6656,8,7628572796
3750,46837529,5454,46842983,0,2,1,13824,8,6862867773
3751,46839279,155612,46994891,0,8,0,110080,27,1931401197
3752,46840533,86024,46926557,0,8,0,5632,27,10065839553
3753,46848431,240175,47088606,0,2,0,32768,8,3393642081
3754,46898759,566,46899325,0,4,1,512,21,7454190129
3755,46918435,1994,46920429,0,6,1,2048,42,2759209134
3756,46962102,5389,46967491,0,2,1,2560,8,10323443353
3757,46963828,4850,46968678,0,6,1,5120,42,6448764520
3758,46973134,6278,46979412,0,4,1,6656,21,8676130827
3759,46973377,6803,46980180,0,4,1,11776,21,3760987313
3760,47005571,4850,47010421,0,2,1,5120,8,8129673047
3761,47019543,3898,47023441,0,6,1,4096,42,6520908058
3762,47036588,94820,47131408,0,8,0,16384,27,806695743
3763,47065478,1042,47066520,0,5,1,1024,46,8592196069
3764,47091753,4679,47096432,0,5,1,12288,46,10485009272
3765,47095682,3904,47099586,0,9,1,10752,20,6427139694
3766,47101207,100880,47202087,0,0,0,31232,38,8576109312
3767,47124343,4850,47129193,0,6,1,5120,42,2750028422
3768,47124956,1994,47126950,0,4,1,2048,21,1062949376
3769,47136640,2470,47139110,0,5,1,2560,46,3984819407
3770,47144469,6278,47150747,0,2,1,6656,8,10078872427
3771,47155959,95912,47251871,0,8,0,19968,27,8498862420
3772,47160629,4374,47165003,0,5,1,4608,46,2435930464
3773,47168296,3128,47171424,0,2,1,9216,8,9570751312
3774,47170368,7230,47177598,0,6,1,7680,42,6856871987
3775,47193959,3898,47197857,0,6,1,4096,42,10018658544
3776,47198472,7230,47205702,0,4,1,7680,21,2752356280
3777,47217242,5802,47223044,0,5,1,6144,46,7678051065
3778,47234257,3128,47237385,0,4,1,9216,21,7709616239
3779,47236269,2363,47238632,0,4,1,1536,21,1013718844
3780,47254814,1042,47255856,0,2,1,1024,8,4336569741
3781,47332818,566,47333384,0,5,1,512,46,1651996855
3782,47342605,108680,47451285,0,0,0,56832,38,5835195746
3783,47351666,5196,47356862,0,1,1,13312,36,2488816292
3784,47358023,66524,47424547,0,8,0,9216,27,8399564664
3785,47364808,152327,47517135,0,0,0,39936,38,9977546970
3786,47366711,566,47367277,0,3,1,512,4,9986761222
3787,47370280,1042,47371322,0,1,1,1024,36,2546610664
3788,47386588,91460,47478048,0,2,0,20480,8,3891612867
3789,47389544,10499,47400043,0,4,1,16896,21,5092399606
3790,47401644,139383,47541027,0,0,0,57856,38,2712715029
3791,47423898,3898,47427796,0,2,1,4096,8,3753873127
3792,47437417,2470,47439887,0,5,1,2560,46,8721655549
3793,47438685,5971,47444656,0,3,1,14848,4,5157948981
3794,47444006,99476,47543482,0,2,0,26624,8,6273223285
3795,47444572,5712,47450284,0,2,1,14336,8,1258966871
3796,47469086,8977,47478063,0,2,1,5632,8,383158407
3797,47494253,3422,47497675,0,3,1,3584,4,9242093278
3798,47495393,3898,47499291,0,1,1,4096,36,3863840840
3799,47495809,3422,47499231,0,4,1,3584,21,7726512733
3800,47499063,2946,47502009,0,6,1,3072,42,4114485040
3801,47515002,5802,47520804,0,4,1,6144,21,9024824914
3802,47537959,3645,47541604,0,5,1,10240,46,5794839181
3803,47553196,116792,47669988,0,8,0,83456,27,2828292009
3804,47558379,1042,47559421,0,1,1,1024,36,6540392180
3805,47558627,6084,47564711,0,1,1,14848,36,495921478
3806,47566363,1994,47568357,0,4,1,2048,21,1663234735
3807,47581525,147761,47729286,0,8,0,45056,27,8008032105
3808,47582227,237737,47819964,0,8,0,114688,27,4673260319
3809,47608696,101660,47710356,0,0,0,33792,38,1976412641
3810,47617682,2470,47620152,0,4,1,2560,21,4366376088
3811,47619025,566,47619591,0,1,1,512,36,9164690123
3812,47623822,104312,47728134,0,2,0,42496,8,8800650530
3813,47651905,566,47652471,0,1,1,512,36,2908993149
3814,47659118,4850,47663968,0,1,1,5120,36,6812709284
3815,47695040,3898,47698938,0,6,1,4096,42,4072209756
3816,47721960,224105,47946065,0,8,1,355328,27,1304711744
3817,47733922,3387,47737309,0,1,1,9728,36,10425560171
3818,47761309,98540,47859849,0,0,0,23552,38,5687855707
3819,47781321,1994,47783315,0,6,1,2048,42,9037768617
3820,47783047,174872,47957919,0,8,1,40448,27,5330340780
3821,47803203,105872,47909075,0,0,0,47616,38,8250792685
3822,47811166,211171,48022337,0,8,0,5632,27,2964610810
3823,47811394,1994,47813388,0,6,1,2048,42,2805794807
3824,47821756,162904,47984660,0,8,1,87040,27,562318434
3825,47829576,566,47830142,0,6,1,512,42,6967612348
3826,47832502,6754,47839256,0,4,1,7168,21,8104111718
3827,47864490,120734,47985224,0,8,1,10752,27,5028560643
3828,47873912,4162,47878074,0,6,1,11264,42,8747669034
3829,47874009,138365,48012374,0,8,1,89088,27,4065205684
3830,47875034,1994,47877028,0,7,1,2048,41,341902522
3831,47883209,1518,47884727,0,7,1,1536,41,1755827301
3832,47898697,116263,48014960,0,8,1,4096,27,2127885442
3833,47912720,3422,47916142,0,6,1,3584,42,2596946208
3834,47923669,98683,48022352,0,8,1,28160,27,4441205221
3835,47931086,118196,48049282,0,0,0,88064,38,5140984442
3836,47937071,5326,47942397,0,6,1,5632,42,8090596095
3837,47959276,1518,47960794,0,4,1,1536,21,2268498910
3838,47982271,1042,47983313,0,4,1,1024,21,5751786205
3839,47988904,209690,48198594,0,8,0,5632,27,3503280742
3840,47991965,30402,48022367,0,8,1,10752,27,8385334402
3841,47997077,5196,48002273,0,1,1,13312,36,2946209630
3842,48043391,3422,48046813,0,7,1,3584,41,6089245484
3843,48064493,6754,48071247,0,8,1,7168,27,255692201
3844,48146221,6278,48152499,0,1,1,6656,36,9653022042
3845,48161669,34020,48195689,0,8,1,59392,27,6633335045
3846,48163390,35219,48198609,0,8,1,2048,27,8042810894
3847,48163830,2470,48166300,0,7,1,2560,41,3617039507
3848,48164104,241945,48406049,0,8,0,66048,27,828211428
3849,48186023,1518,48187541,0,6,1,1536,42,661846753
3850,48193897,4420,48198317,0,7,1,11776,41,10084423120
3851,48208172,1042,48209214,0,7,1,1024,41,1106091353
3852,48224740,7706,48232446,0,3,1,8192,4,531918751
3853,48234315,94220,48328535,0,8,0,19456,27,6171179989
3854,48260353,97916,48358269,0,2,0,21504,8,3877004055
3855,48300814,1518,48302332,0,2,1,1536,8,1797907335
3856,48304775,105716,48410491,0,0,0,47104,38,1608468493
3857,48305955,3645,48309600,0,1,1,10240,36,10041036014
3858,48331755,1042,48332797,0,7,1,1024,41,2229708507
3859,48367397,4937,48372334,0,1,1,12800,36,3420979339
3860,48369954,4338,48374292,0,1,1,3072,36,8783275498
3861,48378752,1518,48380270,0,7,1,1536,41,2222541317
3862,48384183,566,48384749,0,3,1,512,4,3515338496
3863,48391806,112957,48504763,0,0,0,56832,38,8334834391
3864,48403827,86859,48490686,0,8,1,141312,27,8644479864
3865,48407565,179608,48587173,0,0,0,99328,38,4948576502
3866,48411978,111956,48523934,0,2,0,67584,8,7762182162
3867,48434386,56646,48491032,0,8,1,512,27,8821723996
3868,48458234,181469,48639703,0,0,0,58880,38,10125089566
3869,48472854,174352,48647206,0,0,0,24576,38,9641504376
3870,48473184,18834,48492018,0,8,1,1536,27,5651586200
3871,48479464,2470,48481934,0,3,1,2560,4,5588766805
3872,48498306,1994,48500300,0,3,1,2048,4,6787860888
3873,48523691,5326,48529017,0,7,1,5632,41,6091126949
3874,48540191,100100,48640291,0,2,0,28672,8,8297400660
3875,48545753,1994,48547747,0,8,1,2048,27,4899235802
3876,48562754,2470,48565224,0,3,1,2560,4,6384087551
3877,48568371,93933,48662304,0,8,0,18944,27,2294637543
3878,48602157,5454,48607611,0,3,1,13824,4,5637972771
3879,48633931,13600,48647531,0,8,1,23040,27,1274257885
3880,48637090,3387,48640477,0,3,1,9728,4,8197152410
3881,48648935,97136,48746071,0,0,0,18944,38,10436391961
3882,48649059,4374,48653433,0,1,1,4608,36,950419339
3883,48673037,74072,48747109,0,2,0,13824,8,10472244841
3884,48677735,7706,48685441,0,4,1,8192,21,3667724807
3885,48680353,151755,48832108,0,4,0,116736,21,7680198292
3886,48694941,75597,48770538,0,8,0,7168,27,8162115703
3887,48706713,100256,48806969,0,8,0,29184,27,9883482372
3888,48719928,114920,48834848,0,0,0,77312,38,10557546330
3889,48740574,119912,48860486,0,2,0,93696,8,3819413208
3890,48775371,97292,48872663,0,8,0,19456,27,6509454233
3891,48780098,32299,48812397,0,8,1,52736,27,3485190356
3892,48795507,32853,48828360,0,8,1,51712,27,6430935055
3893,48801935,5454,48807389,0,3,1,13824,4,5404293263
3894,48836902,13770,48850672,0,8,1,26624,27,2204302349
3895,48840863,185738,49026601,0,8,0,13312,27,5391414703
3896,48872728,204602,49077330,0,8,0,41984,27,4640394417
3897,48908221,11791,48920012,0,3,1,19456,4,354754805
3898,48913513,117884,49031397,0,2,0,87040,8,311646499
3899,48925285,98696,49023981,0,0,0,24064,38,4801809013
3900,48926035,136046,49062081,0,2,0,46592,8,1034868452
3901,48946070,193429,49139499,0,2,0,72704,8,9626403811
3902,48963400,6488,48969888,0,8,1,15872,27,7997430520
3903,48977400,73487,49050887,0,8,1,122880,27,764659227
3904,48987405,89940,49077345,0,8,1,62976,27,804120089
3905,48994090,4374,48998464,0,3,1,4608,4,9256100915
3906,49005108,103220,49108328,0,0,0,38912,38,3402510366
3907,49020146,57214,49077360,0,8,1,19968,27,9136672931
3908,49030815,126443,49157258,0,0,0,16896,38,1681888054
3909,49057011,20364,49077375,0,8,1,3072,27,2436788370
3910,49060434,1042,49061476,0,3,1,1024,4,6857377958
3911,49083936,7230,49091166,0,3,1,7680,4,10548786268
3912,49104601,99320,49203921,0,2,0,26112,8,460483574
3913,49141427,15837,49157264,0,8,1,30720,27,909645915
3914,49170670,103691,49274361,0,8,1,168448,27,9215983186
3915,49186539,89128,49275667,0,8,1,2048,27,10423974239
3916,49202516,4374,49206890,0,9,1,4608,20,2044943397
3917,49231418,11016,49242434,0,6,1,17920,42,1731804154
3918,49253961,4850,49258811,0,3,1,5120,4,9415575838
3919,49270041,106184,49376225,0,2,0,48640,8,3340290675
3920,49309475,5802,49315277,0,9,1,6144,20,2839991472
3921,49313004,116324,49429328,0,0,0,81920,38,1090889434
3922,49321785,1994,49323779,0,6,1,2048,42,9785767140
3923,49332922,74173,49407095,0,2,0,7680,8,9282261126
3924,49334230,7706,49341936,0,6,1,8192,42,5687360647
3925,49341162,287698,49628860,0,8,0,105472,27,3638791982
3926,49341903,3128,49345031,0,9,1,9216,20,6242544286
3927,49344866,566,49345432,0,9,1,512,20,5765322421
3928,49371602,86160,49457762,0,0,0,12800,38,5910365419
3929,49378133,5326,49383459,0,6,1,5632,42,6664168678
3930,49380620,3387,49384007,0,9,1,9728,20,5613693021
3931,49380841,566,49381407,0,3,1,512,4,2620431853
3932,49395062,1042,49396104,0,6,1,1024,42,5933897258
3933,49408883,3128,49412011,0,3,1,9216,4,335616310
3934,49418735,72024,49490759,0,8,1,116736,27,7311132135
3935,49421213,566,49421779,0,3,1,512,4,4483815898
3936,49430768,71845,49502613,0,8,1,48640,27,8783356143
3937,49435548,1518,49437066,0,6,1,1536,42,4431807406
3938,49482008,11791,49493799,0,3,1,19456,4,9009807470
3939,49482731,25374,49508105,0,8,1,17920,27,4605341397
3940,49483543,1042,49484585,0,9,1,1024,20,495115150
3941,49487714,1994,49489708,0,9,1,2048,20,4077669834
3942,49496074,116168,49612242,0,0,0,81408,38,10303395962
3943,49528225,84443,49612668,0,0,0,1024,38,3646039647
3944,49540297,3645,49543942,0,3,1,10240,4,4014128959
3945,49552862,5712,49558574,0,3,1,14336,4,9344569429
3946,49573999,291312,49865311,0,8,0,259072,27,2579921736
3947,49579882,4374,49584256,0,9,1,4608,20,4292740764
3948,49584147,5326,49589473,0,6,1,5632,42,7988221456
3949,49590406,79436,49669842,0,2,0,11264,8,9856928416
3950,49597051,3898,49600949,0,6,1,4096,42,8858159711
3951,49605285,566,49605851,0,3,1,512,4,7746969561
3952,49615245,1042,49616287,0,6,1,1024,42,6036951835
3953,49634136,566,49634702,0,3,1,512,4,6703883756
3954,49692484,184230,49876714,0,8,0,37376,27,7205044649
3955,49716661,3422,49720083,0,4,1,3584,21,6460045784
3956,49717453,2976,49720429,0,4,1,512,21,9502759148
3957,49747483,4850,49752333,0,3,1,5120,4,5193792040
3958,49766669,3387,49770056,0,3,1,9728,4,5367609579
3959,49781378,4162,49785540,0,3,1,11264,4,8005930505
3960,49782756,1994,49784750,0,4,1,2048,21,2263687784
3961,49786018,6229,49792247,0,3,1,15360,4,4393902108
3962,49791914,2470,49794384,0,4,1,2560,21,7758755260
3963,49799033,5326,49804359,0,9,1,5632,20,4826076681
3964,49804139,73292,49877431,0,2,0,11264,8,2743729165
3965,49845436,76866,49922302,0,8,0,1024,27,10724662369
3966,49855230,95624,49950854,0,2,0,24064,8,1338878095
3967,49874207,169017,50043224,0,2,0,94208,8,81609091
3968,49885618,6754,49892372,0,3,1,7168,4,1819497264
3969,49895485,73916,49969401,0,8,0,13312,27,7477817845
3970,49930175,169221,50099396,0,2,0,117248,8,1642197738
3971,49955149,6754,49961903,0,6,1,7168,42,10421369129
3972,49956457,50672,50007129,0,8,0,2560,27,8183821442
3973,49961090,2470,49963560,0,4,1,2560,21,8929166231
3974,49962975,5326,49968301,0,9,1,5632,20,3754777276
3975,49990625,1518,49992143,0,6,1,1536,42,7454725733
3976,50009137,6754,50015891,0,3,1,7168,4,8221034654
3977,50017716,1994,50019710,0,1,1,2048,36,10128850827
3978,50022357,12825,50035182,0,3,1,21504,4,2829169200
3979,50034567,1994,50036561,0,1,1,2048,36,3755520822
3980,50038257,3904,50042161,0,3,1,10752,4,9203296629
3981,50065355,1518,50066873,0,3,1,1536,4,2766948016
3982,50088152,5802,50093954,0,3,1,6144,4,8276501450
3983,50092483,11016,50103499,0,6,1,17920,42,2576571222
3984,50120694,3904,50124598,0,3,1,10752,4,6818072313
3985,50124162,3898,50128060,0,5,1,4096,46,9512779964
3986,50130833,57440,50188273,0,8,0,4608,27,3706681135
3987,50133295,2946,50136241,0,4,1,3072,21,7043778308
3988,50166602,566,50167168,0,5,1,512,46,1197059386
3989,50182175,566,50182741,0,6,1,512,42,2835409759
3990,50203642,106496,50310138,0,8,0,49664,27,7661641739
3991,50213290,6754,50220044,0,5,1,7168,46,7091537398
3992,50248132,70976,50319108,0,8,0,8704,27,6771991491
3993,50258822,82088,50340910,0,2,0,19968,8,1084805194
3994,50263227,107047,50370274,0,2,0,25600,8,4961528167
3995,50286654,10241,50296895,0,5,1,16384,46,6551842544
3996,50338270,3645,50341915,0,5,1,10240,46,5178890186
3997,50359348,88052,50447400,0,2,0,14336,8,7449557852
3998,50389121,1042,50390163,0,5,1,1024,46,6274975999
3999,50447425,6754,50454179,0,5,1,7168,46,7342084884
4000,50468932,121628,50590560,0,2,0,99328,8,1792030487
4001,50484116,6278,50490394,0,5,1,6656,46,5157527732
4002,50521954,4374,50526328,0,6,1,4608,42,2504267944
4003,50529522,5802,50535324,0,9,1,6144,20,1310077457
4004,50551429,566,50551995,0,6,1,512,42,4646190139
4005,50579631,5326,50584957,0,9,1,5632,20,1608818979
4006,50597669,1042,50598711,0,5,1,1024,46,8828995092
4007,50600423,187784,50788207,0,8,0,155136,27,3888437273
4008,50617830,120134,50737964,0,8,0,2560,27,828142471
4009,50620333,566,50620899,0,9,1,512,20,2910399585
4010,50621536,209914,50831450,0,8,0,81408,27,4106026355
4011,50622661,5326,50627987,0,5,1,5632,46,5795460516
4012,50630472,284948,50915420,0,8,0,129024,27,8118735484
4013,50662022,566,50662588,0,6,1,512,42,6169932693
4014,50692629,566,50693195,0,9,1,512,20,3859421076
4015,50693903,566,50694469,0,9,1,512,20,3900255856
4016,50706458,4850,50711308,0,5,1,5120,46,7464738212
4017,50712603,111332,50823935,0,1,0,65536,36,1555595445
4018,50752262,1042,50753304,0,6,1,1024,42,7506815806
4019,50773257,2946,50776203,0,6,1,3072,42,10571884167
4020,50816349,111110,50927459,0,1,0,39936,36,3729873931
4021,50830839,566,50831405,0,6,1,512,42,701503112
4022,50849345,4850,50854195,0,5,1,5120,46,9527260271
4023,50849775,1994,50851769,0,7,1,2048,41,57395178
4024,50854849,2870,50857719,0,9,1,8704,20,9794607162
4025,50871570,5802,50877372,0,7,1,6144,41,654225652
4026,50875251,2467,50877718,0,7,1,512,41,10195503214
4027,50875416,3128,50878544,0,9,1,9216,20,7012048997
4028,50875908,121316,50997224,0,8,0,98304,27,3656737292
4029,50877124,196558,51073682,0,8,0,116224,27,8742758563
4030,50882411,2946,50885357,0,7,1,3072,41,887957787
4031,50889200,1994,50891194,0,5,1,2048,46,7923996505
4032,50900612,2470,50903082,0,5,1,2560,46,1638068017
4033,50965274,99320,51064594,0,1,0,26112,36,656727856
4034,50969362,134752,51104114,0,8,0,7168,27,5994582080
4035,50981016,88429,51069445,0,1,0,15872,36,5428298871
4036,50989842,3422,50993264,0,5,1,3584,46,2874123717
4037,50996897,1518,50998415,0,6,1,1536,42,6778788510
4038,51025635,101660,51127295,0,2,0,33792,8,5314481185
4039,51044901,195520,51240421,0,8,0,43008,27,9208243468
4040,51046361,2470,51048831,0,6,1,2560,42,5026935946
4041,51053546,2946,51056492,0,6,1,3072,42,6464912910
4042,51063040,3898,51066938,0,9,1,4096,20,7674659634
4043,51074412,152882,51227294,0,8,0,43008,27,4354815261
4044,51097970,5802,51103772,0,9,1,6144,20,5888439365
4045,51159199,148621,51307820,0,8,0,44032,27,1088452095
4046,51163941,2946,51166887,0,6,1,3072,42,10530759016
4047,51170055,566,51170621,0,9,1,512,20,3949424568
4048,51179947,164287,51344234,0,8,0,67072,27,8408810549
4049,51204348,144893,51349241,0,8,0,16384,27,2491342294
4050,51206722,67148,51273870,0,1,0,11264,36,5109546064
4051,51216735,133145,51349880,0,8,0,2048,27,9478298585
4052,51234885,6754,51241639,0,9,1,7168,20,9768014242
4053,51247072,1994,51249066,0,5,1,2048,46,350592828
4054,51272177,1994,51274171,0,6,1,2048,42,3911425235
4055,51330985,3904,51334889,0,6,1,10752,42,9953369843
4056,51333742,118102,51451844,0,8,0,34816,27,4846204113
4057,51338548,7230,51345778,0,2,1,7680,8,3747153915
4058,51355785,105092,51460877,0,1,0,45056,36,1803975671
4059,51391653,4937,51396590,0,2,1,12800,8,738336594
4060,51411107,58220,51469327,0,2,0,7168,8,5565595573
4061,51444690,102659,51547349,0,1,0,29184,36,8412808082
4062,51473963,107120,51581083,0,2,0,51712,8,9268864604
4063,51478679,106808,51585487,0,1,0,50688,36,5823123507
4064,51532476,1518,51533994,0,2,1,1536,8,521358755
4065,51532700,133236,51665936,0,2,0,15360,8,5618403662
4066,51554871,4937,51559808,0,2,1,12800,8,730511517
4067,51562048,1994,51564042,0,4,1,2048,21,5301070736
4068,51579908,95783,51675691,0,1,0,16384,36,3585424283
4069,51606452,3904,51610356,0,2,1,10752,8,1459065047
4070,51647572,1994,51649566,0,2,1,2048,8,1991949996
4071,51659100,99944,51759044,0,1,0,28160,36,4825534996
4072,51670036,3645,51673681,0,2,1,10240,8,10289281919
4073,51673350,155179,51828529,0,2,0,5632,8,4305496235
4074,51679359,2946,51682305,0,2,1,3072,8,1756172959
4075,51681575,4850,51686425,0,6,1,5120,42,2381545473
4076,51683752,127868,51811620,0,8,0,119808,27,6948357064
4077,51702649,2946,51705595,0,6,1,3072,42,4129824786
4078,51707052,1042,51708094,0,2,1,1024,8,9748566350
4079,51725120,73506,51798626,0,1,0,10752,36,8815845676
4080,51738265,6278,51744543,0,6,1,6656,42,6335138005
4081,51761737,5802,51767539,0,3,1,6144,4,9710651986
4082,51766794,1042,51767836,0,6,1,1024,42,2578468084
4083,51788770,2470,51791240,0,1,1,2560,36,10542690712
4084,51788815,1042,51789857,0,6,1,1024,42,821495985
4085,51813509,6754,51820263,0,6,1,7168,42,8729803457
4086,51815625,5624,51821249,0,6,1,1536,42,3566402206
4087,51823724,101504,51925228,0,1,0,33280,36,7234390677
4088,51827318,118664,51945982,0,8,0,89600,27,3858436231
4089,51872415,4162,51876577,0,6,1,11264,42,641561000
4090,51896267,3387,51899654,0,6,1,9728,42,2904327690
4091,51915025,90212,52005237,0,2,0,16384,8,4476480570
4092,52008122,5712,52013834,0,6,1,14336,42,9075718861
4093,52080986,1518,52082504,0,5,1,1536,46,6717870317
4094,52086137,105404,52191541,0,1,0,46080,36,8124352352
4095,52092219,1042,52093261,0,6,1,1024,42,10166571672
4096,52109366,103688,52213054,0,1,0,40448,36,325203476
4097,52118349,566,52118915,0,6,1,512,42,3401610705
4098,52136067,1518,52137585,0,6,1,1536,42,2163956603
4099,52156374,122876,52279250,0,2,0,103424,8,6824598565
4100,52156386,104156,52260542,0,8,0,41984,27,9937738799
4101,52172643,4374,52177017,0,6,1,4608,42,1665106992
4102,52187672,169596,52357268,0,2,0,126464,8,979670354
4103,52224025,99476,52323501,0,8,0,26624,27,1332099263
4104,52257302,91748,52349050,0,1,0,16384,36,710012925
4105,52284377,101816,52386193,0,1,0,34304,36,7707442363
4106,52375733,127712,52503445,0,8,0,119296,27,7562660384
4107,52398625,3128,52401753,0,6,1,9216,42,4034670142
4108,52413787,115764,52529551,0,8,0,12288,27,685134694
4109,52438922,6278,52445200,0,6,1,6656,42,8246344188
4110,52455845,196676,52652521,0,2,0,184320,8,10557229818
4111,52487475,7706,52495181,0,6,1,8192,42,2067951738
4112,52516806,119185,52635991,0,8,0,61952,27,7423023070
4113,52533811,179322,52713133,0,8,0,127488,27,5445455336
4114,52566508,101504,52668012,0,2,0,33280,8,4904879499
4115,52584811,140532,52725343,0,8,0,5120,27,1894370755
4116,52616294,138035,52754329,0,2,0,34304,8,7463630629
4117,52649781,566,52650347,0,6,1,512,42,9460951873
4118,52650459,69152,52719611,0,1,0,12800,36,5883779988
4119,52663453,3904,52667357,0,6,1,10752,42,8802176897
4120,52690479,566,52691045,0,6,1,512,42,982020140
4121,52692004,566,52692570,0,6,1,512,42,7130447286
4122,52821329,103220,52924549,0,1,0,38912,36,3619907539
4123,52840868,2870,52843738,0,6,1,8704,42,7923337744
4124,52850022,12308,52862330,0,5,1,20480,46,5681100114
4125,52888867,566,52889433,0,5,1,512,46,454603474
4126,52893112,95312,52988424,0,2,0,23040,8,9308331789
4127,52899179,112466,53011645,0,1,0,25088,36,8032721995
4128,52900995,110552,53011547,0,8,0,62976,27,3676193584
4129,52905846,1518,52907364,0,5,1,1536,46,4533360828
4130,52926871,147742,53074613,0,8,0,41984,27,9593298214
4131,52945742,16613,52962355,0,8,1,32256,27,2983025283
4132,52954746,104993,53059739,0,8,1,172544,27,872237739
4133,52973266,153567,53126833,0,1,0,138752,36,8321718389
4134,52975647,5802,52981449,0,6,1,6144,42,6686358238
4135,52980580,161311,53141891,0,8,0,34816,27,8599541530
4136,52989323,102284,53091607,0,2,0,35840,8,3729969943
4137,52994636,233082,53227718,0,8,0,25600,27,2215388872
4138,53007974,165959,53173933,0,1,0,13824,36,1214556193
4139,53024626,114765,53139391,0,2,0,24064,8,1789940815
4140,53026742,47886,53074628,0,8,1,39424,27,417262321
4141,53053290,2470,53055760,0,6,1,2560,42,6068806481
4142,53059040,100601,53159641,0,1,0,12288,36,9074223242
4143,53097612,44294,53141906,0,8,1,61440,27,9541800732
4144,53099545,83148,53182693,0,2,0,13824,8,6720863340
4145,53115989,27199,53143188,0,8,1,33792,27,4697053382
4146,53167387,2946,53170333,0,8,1,3072,27,3080444489
4147,53194199,4374,53198573,0,5,1,4608,46,10013345849
4148,53224362,7230,53231592,0,5,1,7680,46,10002168263
4149,53231133,6488,53237621,0,5,1,15872,46,3186367996
4150,53250155,566,53250721,0,6,1,512,42,4065550484
4151,53257937,1994,53259931,0,6,1,2048,42,6198621070
4152,53296046,7706,53303752,0,5,1,8192,46,5400788758
4153,53307019,91772,53398791,0,1,0,21504,36,4147511810
4154,53340222,72668,53412890,0,2,0,9216,8,5607615977
4155,53356579,2470,53359049,0,7,1,2560,41,5061664301
4156,53370828,7230,53378058,0,6,1,7680,42,2942611670
4157,53380147,3422,53383569,0,5,1,3584,46,300389766
4158,53390601,104936,53495537,0,1,0,44544,36,8620120735
4159,53391608,2470,53394078,0,5,1,2560,46,4294111620
4160,53401889,57440,53459329,0,1,0,4608,36,9908494180
4161,53408546,128588,53537134,0,8,0,54784,27,4264781859
4162,53439103,5326,53444429,0,6,1,5632,42,5112801477
4163,53442611,5326,53447937,0,7,1,5632,41,3105461813
4164,53446264,1994,53448258,0,5,1,2048,46,5306652489
4165,53454366,159562,53613928,0,8,0,78848,27,4990217134
4166,53459482,566,53460048,0,5,1,512,46,371425963
4167,53461504,5454,53466958,0,6,1,13824,42,572081376
4168,53462266,113048,53575314,0,2,0,71168,8,697027386
4169,53468696,1042,53469738,0,7,1,1024,41,1958564780
4170,53473782,2946,53476728,0,6,1,3072,42,9742829900
4171,53477415,155475,53632890,0,2,0,98816,8,3278422245
4172,53479791,5454,53485245,0,8,1,13824,27,7458881861
4173,53492613,5802,53498415,0,7,1,6144,41,1980588645
4174,53495247,7230,53502477,0,5,1,7680,46,9722903155
4175,53500782,2681,53503463,0,5,1,1536,46,5363803198
4176,53501760,5196,53506956,0,6,1,13312,42,3035347493
4177,53509246,5326,53514572,0,7,1,5632,41,10307625676
4178,53523432,1518,53524950,0,1,1,1536,36,9660926872
4179,53557784,23208,53580992,0,8,1,38400,27,6871982633
4180,53570074,1994,53572068,0,5,1,2048,46,1101927736
4181,53577220,2946,53580166,0,1,1,3072,36,5287105945
4182,53592257,1518,53593775,0,9,1,1536,20,5469658423
4183,53596945,1518,53598463,0,5,1,1536,46,2376470277
4184,53605211,4374,53609585,0,5,1,4608,46,7578763698
4185,53614745,115585,53730330,0,2,0,19968,8,1909861087
4186,53643945,7706,53651651,0,8,1,8192,27,5819424118
4187,53644462,3898,53648360,0,6,1,4096,42,3477631518
4188,53644482,1994,53646476,0,1,1,2048,36,3965096472
4189,53644908,4621,53649529,0,1,1,4608,36,10605193127
4190,53667229,2946,53670175,0,7,1,3072,41,9591293240
4191,53680055,1994,53682049,0,1,1,2048,36,366384056
4192,53740326,566,53740892,0,6,1,512,42,6221191209
4193,53745111,1994,53747105,0,7,1,2048,41,6097593480
4194,53746268,6278,53752546,0,5,1,6656,46,1774147636
4195,53756904,566,53757470,0,1,1,512,36,9366158943
4196,53776120,2470,53778590,0,5,1,2560,46,1057965714
4197,53801947,1518,53803465,0,1,1,1536,36,10345531118
4198,53804834,5712,53810546,0,1,1,14336,36,6252109174
4199,53806362,3422,53809784,0,7,1,3584,41,1636074936
4200,53808762,5326,53814088,0,6,1,5632,42,6679702941
4201,53809447,102440,53911887,0,2,0,36352,8,1150802215
4202,53847211,161000,54008211,0,1,0,118272,36,4683432604
4203,53859544,214457,54074001,0,2,0,174080,8,1398117151
4204,53865799,4420,53870219,0,5,1,11776,46,7146918857
4205,53867989,3422,53871411,0,7,1,3584,41,5555589304
4206,53879859,1994,53881853,0,6,1,2048,42,1678066131
4207,53905135,185948,54091083,0,2,0,42496,8,9761916416
4208,53909936,167044,54076980,0,2,0,9728,8,4215798953
4209,53910408,566,53910974,0,4,1,512,21,10061500289
4210,53913450,106340,54019790,0,8,0,49152,27,3774016021
4211,53916182,5802,53921984,0,5,1,6144,46,3562284747
4212,53947794,1994,53949788,0,6,1,2048,42,580316344
4213,53962314,62169,54024483,0,1,0,3072,36,7787288759
4214,53966347,1042,53967389,0,1,1,1024,36,2729027246
4215,53991487,95624,54087111,0,8,0,24064,27,10448794506
4216,53998969,2946,54001915,0,6,1,3072,42,8991036395
4217,54004027,77336,54081363,0,1,0,15872,36,7986697228
4218,54014664,7706,54022370,0,1,1,8192,36,9942987776
4219,54038079,3645,54041724,0,4,1,10240,21,7925496497
4220,54039828,566,54040394,0,1,1,512,36,6446619572
4221,54044848,1042,54045890,0,4,1,1024,21,587393673
4222,54061850,125036,54186886,0,1,0,62464,36,5612161793
4223,54088258,566,54088824,0,4,1,512,21,8265695118
4224,54096321,4420,54100741,0,4,1,11776,21,7231814237
4225,54123947,566,54124513,0,4,1,512,21,1584629112
4226,54149169,91499,54240668,0,8,1,147968,27,6807521200
4227,54150757,2470,54153227,0,5,1,2560,46,3015270327
4228,54196008,99218,54295226,0,8,0,5120,27,7634984728
4229,54203733,105560,54309293,0,1,0,46592,36,4651607292
4230,54213054,4420,54217474,0,5,1,11776,46,71683126
4231,54224259,3904,54228163,0,3,1,10752,4,10110780353
4232,54225810,5712,54231522,0,6,1,14336,42,6434213575
4233,54245246,16354,54261600,0,8,1,31744,27,8121643871
4234,54248883,51140,54300023,0,2,0,4096,8,5676987963
4235,54258302,26479,54284781,0,8,1,48128,27,3196181251
4236,54267449,4850,54272299,0,5,1,5120,46,7086386465
4237,54279289,1042,54280331,0,4,1,1024,21,3101013172
4238,54285864,566,54286430,0,5,1,512,46,10639404848
4239,54287657,566,54288223,0,5,1,512,46,2805505049
4240,54317729,47288,54365017,0,2,0,1536,8,9531723658
4241,54322401,79372,54401773,0,8,0,4608,27,918667346
4242,54342051,56854,54398905,0,8,1,97280,27,1902358362
4243,54344723,1042,54345765,0,5,1,1024,46,8666735798
4244,54344953,4420,54349373,0,4,1,11776,21,9579307396
4245,54349222,3898,54353120,0,3,1,4096,4,8026662643
4246,54362520,4374,54366894,0,5,1,4608,46,5756333423
4247,54367788,2946,54370734,0,4,1,3072,21,8246053135
4248,54371392,98956,54470348,0,8,0,2560,27,4054900858
4249,54375813,97607,54473420,0,8,0,2560,27,10705174438
4250,54449548,107276,54556824,0,1,0,52224,36,4226916132
4251,54451224,5971,54457195,0,8,1,14848,27,5104322941
4252,54454467,1518,54455985,0,3,1,1536,4,2226581187
4253,54470107,141119,54611226,0,1,0,17920,36,7066085696
4254,54479256,30749,54510005,0,8,1,49664,27,9520968823
4255,54484733,48980,54533713,0,2,0,2048,8,6437009867
4256,54497766,6754,54504520,0,4,1,7168,21,9595317034
4257,54513361,6229,54519590,0,6,1,15360,42,7718203472
4258,54520374,7706,54528080,0,3,1,8192,4,7705484371
4259,54538145,54012,54592157,0,8,1,91648,27,4562008057
4260,54542277,3898,54546175,0,5,1,4096,46,6137937290
4261,54577467,20182,54597649,0,8,1,26112,27,2591126840
4262,54581791,1042,54582833,0,6,1,1024,42,10536736913
4263,54590358,5971,54596329,0,5,1,14848,46,4053692419
4264,54592745,221681,54814426,0,8,0,97280,27,2367789034
4265,54602665,13083,54615748,0,3,1,22016,4,7440507941
4266,54609688,3898,54613586,0,4,1,4096,21,221314450
4267,54623599,12737,54636336,0,3,1,24576,4,1588457649
4268,54634487,13341,54647828,0,8,1,22528,27,8432193327
4269,54635468,1214,54636682,0,3,1,512,4,7861288387
4270,54664403,7706,54672109,0,4,1,8192,21,7023747816
4271,54668618,1042,54669660,0,3,1,1024,4,10049974989
4272,54673864,6278,54680142,0,4,1,6656,21,9327727005
4273,54693016,115076,54808092,0,1,0,77824,36,8206314624
4274,54758563,1518,54760081,0,3,1,1536,4,7912193805
4275,54771713,1518,54773231,0,8,1,1536,27,3446022602
4276,54802920,1518,54804438,0,4,1,1536,21,9920367987
4277,54804532,88532,54893064,0,1,0,14336,36,10481712664
4278,54805251,97579,54902830,0,8,0,25600,27,4618744869
4279,54807017,146431,54953448,0,1,0,51200,36,330081304
4280,54815218,2470,54817688,0,4,1,2560,21,6020396437
4281,54822170,1518,54823688,0,5,1,1536,46,7778262640
4282,54824195,3645,54827840,0,3,1,10240,4,6683948968
4283,54860334,124282,54984616,0,8,0,66048,27,8835322384
4284,54860765,4162,54864927,0,4,1,11264,21,10681632303
4285,54869470,53325,54922795,0,8,1,87040,27,2598646630
4286,54879164,3898,54883062,0,4,1,4096,21,9019230934
4287,54894014,5971,54899985,0,5,1,14848,46,10643457466
4288,54911312,88520,54999832,0,2,0,15872,8,1548635909
4289,54912362,11099,54923461,0,8,1,1024,27,1176702840
4290,54926058,82868,55008926,0,2,0,22528,8,10590675109
4291,54926506,11016,54937522,0,4,1,17920,21,6708248062
4292,54929480,2946,54932426,0,5,1,3072,46,2061073031
4293,54930497,3422,54933919,0,8,1,3584,27,9793966004
4294,54946538,52498,54999036,0,1,0,1024,36,5525356667
4295,54959794,2946,54962740,0,3,1,3072,4,2099485756
4296,54975728,158421,55134149,0,8,0,89600,27,7081993292
4297,54995769,2946,54998715,0,8,1,3072,27,6142073548
4298,55028571,1042,55029613,0,4,1,1024,21,3061860814
4299,55048648,127394,55176042,0,2,0,100352,8,10018133754
4300,55050794,86749,55137543,0,8,0,512,27,4009031897
4301,55054102,126791,55180893,0,2,0,15872,8,4276648776
4302,55080206,1042,55081248,0,1,1,1024,36,4679994026
4303,55105923,566,55106489,0,8,1,512,27,4713459857
4304,55126155,9980,55136135,0,8,1,2048,27,6186472820
4305,55173070,62540,55235610,0,1,0,11264,36,2691047284
4306,55183433,1994,55185427,0,8,1,2048,27,10524436128
4307,55187108,1518,55188626,0,8,1,1536,27,9409222368
4308,55187455,97916,55285371,0,2,0,21504,8,8685630010
4309,55187655,109899,55297554,0,2,0,39936,8,9572459897
4310,55231717,104468,55336185,0,8,0,43008,27,3396635164
4311,55241837,103376,55345213,0,1,0,39424,36,6058496450
4312,55254681,1994,55256675,0,8,1,2048,27,1310781349
4313,55262398,6488,55268886,0,7,1,15872,41,5979786924
4314,55291192,47288,55338480,0,8,0,1536,27,1674060971
4315,55303201,106184,55409385,0,8,0,48640,27,5019874152
4316,55378603,91070,55469673,0,8,0,17408,27,2572009667
4317,55426401,101816,55528217,0,8,0,34304,27,7836664348
4318,55436994,3422,55440416,0,8,1,3584,27,6386579349
4319,55461063,8625,55469688,0,8,1,4608,27,6248594483
4320,55462450,100724,55563174,0,2,0,30720,8,6221900951
4321,55466573,100256,55566829,0,1,0,29184,36,7615760229
4322,55502954,5802,55508756,0,8,1,6144,27,4710602634
4323,55541834,1042,55542876,0,8,1,1024,27,10029185488
4324,55561029,4374,55565403,0,8,1,4608,27,4967153701
4325,55575098,7230,55582328,0,8,1,7680,27,4161547088
4326,55606459,6229,55612688,0,8,1,15360,27,10450439538
4327,55630679,566,55631245,0,7,1,512,41,5756763029
4328,55656013,114140,55770153,0,2,0,74752,8,10679936787
4329,55662635,101036,55763671,0,8,0,31744,27,5077645973
4330,55678561,1042,55679603,0,5,1,1024,46,5698985382
4331,55684729,131912,55816641,0,2,0,48640,8,1173370516
4332,55696597,47288,55743885,0,3,0,1536,4,9565860522
4333,55709724,56007,55765731,0,3,0,1536,4,9695874945
4334,55713456,93308,55806764,0,1,0,21504,36,4582946097
4335,55737978,3645,55741623,0,8,1,10240,27,6795382933
4336,55749825,101660,55851485,0,1,0,33792,36,4743759037
4337,55749979,133316,55883295,0,2,0,39424,8,169873086
4338,55756419,20327,55776746,0,8,1,22016,27,7369997202
4339,55763822,43904,55807726,0,3,0,512,4,3935785140
4340,55781190,161079,55942269,0,2,0,95744,8,816682514
4341,55795353,1994,55797347,0,8,1,2048,27,5694325239
4342,55807193,2946,55810139,0,8,1,3072,27,743127107
4343,55831099,111341,55942440,0,2,0,512,8,2768960401
4344,55834301,5802,55840103,0,8,1,6144,27,2669134390
4345,55849354,114557,55963911,0,2,0,19456,8,4416260515
4346,55877907,96980,55974887,0,1,0,18432,36,4878552506
4347,55879719,125316,56005035,0,2,0,43520,8,2725427808
4348,55893457,1994,55895451,0,2,1,2048,8,6826911909
4349,55914033,1042,55915075,0,8,1,1024,27,3306921942
4350,55931241,147312,56078553,0,2,0,56832,8,8224980611
4351,55955288,12566,55967854,0,8,1,20992,27,4296064195
4352,55962387,110708,56073095,0,1,0,63488,36,8876423948
4353,55966793,3387,55970180,0,8,1,9728,27,2842054777
4354,55978878,4420,55983298,0,7,1,11776,41,5356644607
4355,55990060,3645,55993705,0,4,1,10240,21,7856428420
4356,56016482,1042,56017524,0,7,1,1024,41,2203161154
4357,56022966,2470,56025436,0,1,1,2560,36,4438084093
4358,56024005,57440,56081445,0,8,0,4608,27,2641048296
4359,56025222,14117,56039339,0,8,1,24064,27,530448627
4360,56036264,12566,56048830,0,2,1,20992,8,8248357383
4361,56061722,14804,56076526,0,1,1,3584,36,7706237951
4362,56062170,16622,56078792,0,1,1,3584,36,5542897706
4363,56066665,12964,56079629,0,2,1,1024,8,5417745761
4364,56069874,14221,56084095,0,2,1,13312,8,3547614890
4365,56075567,9834,56085401,0,2,1,2048,8,7939167591
4366,56084486,43904,56128390,0,3,0,512,4,7168711820
4367,56092576,1042,56093618,0,7,1,1024,41,7685302605
4368,56105912,2470,56108382,0,7,1,2560,41,5095306047
4369,56106214,4114,56110328,0,7,1,3072,41,10260389474
4370,56126019,92089,56218108,0,1,0,6144,36,4024791538
4371,56133620,566,56134186,0,8,1,512,27,916298667
4372,56155369,81128,56236497,0,2,0,11776,8,8934663076
4373,56165057,1042,56166099,0,7,1,1024,41,7574198980
4374,56168271,4850,56173121,0,7,1,5120,41,8516421936
4375,56196454,2946,56199400,0,7,1,3072,41,218243654
4376,56198362,1704,56200066,0,7,1,1024,41,1438804202
4377,56203676,1994,56205670,0,8,1,2048,27,2654516117
4378,56206572,99632,56306204,0,2,0,27136,8,3295235064
4379,56215298,20366,56235664,0,1,1,32768,36,2917222146
4380,56236856,43904,56280760,0,3,0,512,4,5906718286
4381,56239749,104468,56344217,0,2,0,43008,8,6862311831
4382,56254003,43904,56297907,0,3,0,512,4,8381889765
4383,56260095,1518,56261613,0,8,1,1536,27,10011991934
4384,56295962,2946,56298908,0,7,1,3072,41,7974988126
4385,56309407,1042,56310449,0,1,1,1024,36,451250390
4386,56310239,23378,56333617,0,1,1,41984,36,6647662607
4387,56320951,43904,56364855,0,8,0,512,27,8669121098
4388,56364233,5971,56370204,0,7,1,14848,41,961936821
4389,56381663,1042,56382705,0,1,1,1024,36,1707747695
4390,56385295,10241,56395536,0,8,1,16384,27,6170444837
4391,56393524,1042,56394566,0,7,1,1024,41,3471789713
4392,56408692,4374,56413066,0,9,1,4608,20,3379464337
4393,56409122,73136,56482258,0,8,0,10752,27,6987155802
4394,56440617,1518,56442135,0,8,1,1536,27,9381240346
4395,56442059,74672,56516731,0,1,0,10752,36,1625610701
4396,56442460,5326,56447786,0,7,1,5632,41,5579795023
4397,56450487,1042,56451529,0,7,1,1024,41,9375025433
4398,56461142,142679,56603821,0,1,0,68608,36,5154338981
4399,56489303,1042,56490345,0,1,1,1024,36,3250801016
4400,56494730,7230,56501960,0,7,1,7680,41,5087656646
4401,56506844,107744,56614588,0,8,0,53760,27,1081936497
4402,56535073,3422,56538495,0,1,1,3584,36,4586322314
4403,56561309,566,56561875,0,8,1,512,27,6031112742
4404,56569378,4937,56574315,0,8,1,12800,27,3312964057
4405,56601176,3203,56604379,0,1,1,512,36,1154347168
4406,56619478,43904,56663382,0,3,0,512,4,1493421020
4407,56624170,1518,56625688,0,8,1,1536,27,10277899982
4408,56624222,43904,56668126,0,3,0,512,4,1903483064
4409,56643039,73316,56716355,0,2,0,16384,8,8241045003
4410,56665928,566,56666494,0,7,1,512,41,2143454943
4411,56680404,43904,56724308,0,3,0,512,4,2479348152
4412,56685668,1994,56687662,0,1,1,2048,36,2759134219
4413,56708292,3898,56712190,0,1,1,4096,36,3014256666
4414,56714461,114466,56828927,0,2,0,69632,8,4629566661
4415,56716751,103844,56820595,0,1,0,40960,36,3792484639
4416,56718207,43904,56762111,0,3,0,512,4,6523128655
4417,56750426,3387,56753813,0,1,1,9728,36,4849529595
4418,56781275,3387,56784662,0,1,1,9728,36,4082375487
4419,56801895,1042,56802937,0,1,1,1024,36,7457831274
4420,56813542,112736,56926278,0,8,0,70144,27,2586826687
4421,56843848,3422,56847270,0,7,1,3584,41,1437870211
4422,56854889,1994,56856883,0,7,1,2048,41,2758823065
4423,56872776,189878,57062654,0,1,0,26624,36,552049651
4424,56898309,566,56898875,0,7,1,512,41,3609024070
4425,56942867,6754,56949621,0,3,1,7168,4,1341145259
4426,56948984,3898,56952882,0,1,1,4096,36,4018963655
4427,56995112,1518,56996630,0,3,1,1536,4,2221586328
4428,57011577,566,57012143,0,1,1,512,36,887586421
4429,57031781,4162,57035943,0,7,1,11264,41,9393783069
4430,57041702,103688,57145390,0,1,0,40448,36,2679084317
4431,57042250,2946,57045196,0,3,1,3072,4,9592094413
4432,57043475,2067,57045542,0,3,1,512,4,9903313308
4433,57044432,45596,57090028,0,6,0,1024,42,9750650846
4434,57069536,45596,57115132,0,6,0,1024,42,3919755041
4435,57083520,5802,57089322,0,1,1,6144,36,8918924677
4436,57088996,6754,57095750,0,3,1,7168,4,5953832200
4437,57126314,124748,57251062,0,1,0,109568,36,8907600579
4438,57137956,7230,57145186,0,3,1,7680,4,9713327524
4439,57154577,5326,57159903,0,1,1,5632,36,7443975103
4440,57192699,47288,57239987,0,6,0,1536,42,1953336529
4441,57194141,54056,57248197,0,2,0,3584,8,8220812487
4442,57250266,52676,57302942,0,6,0,4096,42,9346541530
4443,57271651,5326,57276977,0,1,1,5632,36,9094852092
4444,57276766,2946,57279712,0,1,1,3072,36,6819078523
4445,57282329,5802,57288131,0,4,1,6144,21,1449561221
4446,57288111,566,57288677,0,7,1,512,41,6300532967
4447,57293112,54122,57347234,0,6,0,1024,42,10042907077
4448,57316737,5326,57322063,0,1,1,5632,36,3698784903
4449,57318596,54056,57372652,0,1,0,3584,36,8861086051
4450,57326872,125087,57451959,0,1,0,79360,36,5688440401
4451,57333340,104156,57437496,0,8,0,41984,27,8906762600
4452,57351946,5712,57357658,0,7,1,14336,41,847422038
4453,57373294,4850,57378144,0,7,1,5120,41,9559628522
4454,57387193,45596,57432789,0,6,0,1024,42,4801163363
4455,57431344,131296,57562640,0,1,0,52736,36,751396159
4456,57486892,4679,57491571,0,4,1,12288,21,5319181229
4457,57487889,4679,57492568,0,7,1,12288,41,8585051786
4458,57505566,1518,57507084,0,1,1,1536,36,1068856093
4459,57524017,93602,57617619,0,1,0,9728,36,5414834568
4460,57532167,7230,57539397,0,4,1,7680,21,6859592134
4461,57565719,99632,57665351,0,2,0,27136,8,2069605004
4462,57583451,5802,57589253,0,7,1,6144,41,2680595288
4463,57597978,6278,57604256,0,1,1,6656,36,7258178324
4464,57620355,6754,57627109,0,1,1,7168,36,4646276190
4465,57632019,2946,57634965,0,7,1,3072,41,3645421639
4466,57639548,2870,57642418,0,1,1,8704,36,5907210584
4467,57642655,4850,57647505,0,7,1,5120,41,268330058
4468,57645162,219787,57864949,0,1,0,18944,36,3238595658
4469,57692131,89012,57781143,0,8,0,22528,27,9425368994
4470,57701295,12308,57713603,0,1,1,20480,36,5810898015
4471,57703249,2470,57705719,0,7,1,2560,41,4892044921
4472,57743697,11274,57754971,0,1,1,18432,36,9806433888
4473,57761231,50672,57811903,0,6,0,2560,42,1191593669
4474,57761590,4374,57765964,0,4,1,4608,21,9372808314
4475,57771794,2470,57774264,0,4,1,2560,21,5003632645
4476,57784726,3422,57788148,0,4,1,3584,21,6503725745
4477,57798930,77744,57876674,0,1,0,10752,36,2058056424
4478,57817533,135598,57953131,0,1,0,80384,36,7038595570
4479,57820920,135970,57956890,0,1,0,12288,36,10306521908
4480,57835648,47288,57882936,0,6,0,1536,42,1163098275
4481,57839273,87920,57927193,0,2,0,18944,8,6851030994
4482,57877718,112851,57990569,0,1,0,8704,36,6639567398
4483,57880298,3645,57883943,0,7,1,10240,41,10283198121
4484,57901626,6278,57907904,0,4,1,6656,21,2836926472
4485,57901801,72668,57974469,0,8,0,9216,27,6614824997
4486,57936235,73011,58009246,0,1,0,3072,36,8294157540
4487,57944315,3422,57947737,0,7,1,3584,41,3575889781
4488,57945181,80254,58025435,0,1,0,10752,36,6615681271
4489,57978672,195252,58173924,0,1,0,34816,36,6644987503
4490,58046200,7706,58053906,0,7,1,8192,41,1790916898
4491,58059684,4937,58064621,0,4,1,12800,21,5257753722
4492,58080844,1518,58082362,0,7,1,1536,41,5740594880
4493,58093893,111644,58205537,0,8,0,66560,27,5140427610
4494,58123676,47756,58171432,0,6,0,3072,42,984899933
4495,58132865,3128,58135993,0,6,1,9216,42,2631657967
4496,58150143,1518,58151661,0,7,1,1536,41,10070444567
4497,58190358,4162,58194520,0,6,1,11264,42,4898612724
4498,58216997,4162,58221159,0,4,1,11264,21,9109297433
4499,58225108,11533,58236641,0,1,1,18944,36,7912661724
4500,58231915,93176,58325091,0,8,0,26112,27,2937025507
4501,58232830,7706,58240536,0,6,1,8192,42,2584251196
4502,58236255,7230,58243485,0,1,1,7680,36,9051002326
4503,58243723,45596,58289319,0,8,0,1024,27,7656786531
4504,58255657,181239,58436896,0,8,0,15872,27,3657093225
4505,58264748,74389,58339137,0,8,0,512,27,975584227
4506,58285984,116622,58402606,0,8,0,80896,27,9351701307
4507,58332058,4374,58336432,0,1,1,4608,36,9301905327
4508,58344580,143718,58488298,0,8,0,62464,27,8337473181
4509,58345286,566,58345852,0,3,1,512,4,8781988431
4510,58360342,5326,58365668,0,7,1,5632,41,4508604966
4511,58363799,43904,58407703,0,6,0,512,42,1409950233
4512,58380633,166543,58547176,0,8,0,32768,27,3550112907
4513,58382616,566,58383182,0,3,1,512,4,2153574462
4514,58388533,3422,58391955,0,1,1,3584,36,9328792710
4515,58435866,568,58436434,0,9,1,512,20,1268692546
4516,58436403,3422,58439825,0,9,1,3584,20,594685179
4517,58441702,6754,58448456,0,6,1,7168,42,8020165545
4518,58452807,5971,58458778,0,6,1,14848,42,10192871659
4519,58456069,1518,58457587,0,1,1,1536,36,4873136330
4520,58466203,13341,58479544,0,1,1,22528,36,3430329672
4521,58505261,2870,58508131,0,6,1,8704,42,4319204639
4522,58507739,54839,58562578,0,8,0,1536,27,9448711861
4523,58528577,1994,58530571,0,3,1,2048,4,8420765298
4524,58556793,4374,58561167,0,3,1,4608,4,2733607785
4525,58557563,566,58558129,0,1,1,512,36,4759546537
4526,58567541,1518,58569059,0,3,1,1536,4,5699702089
4527,58574738,1518,58576256,0,3,1,1536,4,3006448715
4528,58576749,5326,58582075,0,9,1,5632,20,9041801900
4529,58578411,105716,58684127,0,1,0,47104,36,3961717754
4530,58588641,4850,58593491,0,1,1,5120,36,10158480280
4531,58617663,7706,58625369,0,3,1,8192,4,7721344578
4532,58620109,6278,58626387,0,8,1,6656,27,7135570658
4533,58689474,566,58690040,0,1,1,512,36,347009675
4534,58712167,1994,58714161,0,6,1,2048,42,5287021996
4535,58712978,68542,58781520,0,6,0,1024,42,8306983496
4536,58716226,2470,58718696,0,6,1,2560,42,214900998
4537,58732357,2946,58735303,0,6,1,3072,42,10268179575
4538,58765497,1042,58766539,0,9,1,1024,20,7092096426
4539,58775897,3904,58779801,0,9,1,10752,20,903521773
4540,58781286,4646,58785932,0,6,1,11776,42,140421020
4541,58812711,64208,58876919,0,8,0,6656,27,10476963142
4542,58821366,5802,58827168,0,3,1,6144,4,6913161040
4543,58826617,111208,58937825,0,8,0,49152,27,3451351373
4544,58839802,566,58840368,0,8,1,512,27,10293309367
4545,58862794,1042,58863836,0,9,1,1024,20,10703677962
4546,58871937,4162,58876099,0,9,1,11264,20,10451333219
4547,58873739,7230,58880969,0,3,1,7680,4,7664594625
4548,58889764,16354,58906118,0,1,1,31744,36,5646445054
4549,58915376,7706,58923082,0,6,1,8192,42,3498125182
4550,58915980,1042,58917022,0,8,1,1024,27,7715639389
4551,58953014,1518,58954532,0,9,1,1536,20,9087697650
4552,58974433,4374,58978807,0,6,1,4608,42,7443975284
4553,58977751,3904,58981655,0,6,1,10752,42,4923529704
4554,58979213,1518,58980731,0,3,1,1536,4,9414516697
4555,58984065,4374,58988439,0,1,1,4608,36,3277329062
4556,58996050,7230,59003280,0,9,1,7680,20,2194930271
4557,59025106,3898,59029004,0,3,1,4096,4,10729651503
4558,59035544,2870,59038414,0,3,1,8704,4,543536122
4559,59048897,1994,59050891,0,2,1,2048,8,1439398449
4560,59073074,3422,59076496,0,3,1,3584,4,7537228879
4561,59080878,2946,59083824,0,1,1,3072,36,10310936246
4562,59122602,103844,59226446,0,8,0,40960,27,1823125232
4563,59187690,566,59188256,0,3,1,512,4,163321047
4564,59273626,566,59274192,0,1,1,512,36,7882099824
4565,59277241,2946,59280187,0,1,1,3072,36,320601306
4566,59303178,1518,59304696,0,3,1,1536,4,5622154987
4567,59318897,566,59319463,0,3,1,512,4,8319443732
4568,59333636,110905,59444541,0,8,0,64000,27,5707713804
4569,59333673,113223,59446896,0,8,0,7680,27,10128057864
4570,59363362,108732,59472094,0,8,0,12288,27,7714377043
4571,59396239,138297,59534536,0,8,0,54784,27,1971445721
4572,59469408,47288,59516696,0,6,0,1536,42,10405242026
4573,59473403,1994,59475397,0,3,1,2048,4,1716359859
4574,59476674,102034,59578708,0,8,0,26112,27,10617455952
4575,59491672,1042,59492714,0,6,1,1024,42,9665725416
4576,59498772,4374,59503146,0,2,1,4608,8,10330973657
4577,59512071,5802,59517873,0,3,1,6144,4,885683243
4578,59527332,5802,59533134,0,2,1,6144,8,5635529992
4579,59541961,3387,59545348,0,1,1,9728,36,3151740844
4580,59546297,5196,59551493,0,1,1,13312,36,2508760265
4581,59552995,2470,59555465,0,1,1,2560,36,170817681
4582,59573557,100299,59673856,0,8,0,22528,27,7433099183
4583,59592763,4374,59597137,0,2,1,4608,8,3971243342
4584,59598960,1042,59600002,0,2,1,1024,8,3755761320
4585,59602996,4162,59607158,0,1,1,11264,36,6404540469
4586,59628390,6229,59634619,0,2,1,15360,8,1566634905
4587,59641467,12566,59654033,0,1,1,20992,36,7796314310
4588,59649465,118352,59767817,0,8,0,88576,27,3265584466
4589,59678344,114787,59793131,0,8,0,9216,27,7273640611
4590,59684281,173632,59857913,0,8,0,59392,27,5849024317
4591,59692942,4162,59697104,0,1,1,11264,36,9477847459
4592,59711671,54056,59765727,0,6,0,3584,42,250122912
4593,59731285,43904,59775189,0,6,0,512,42,701057807
4594,59760045,166154,59926199,0,8,0,70656,27,1187294169
4595,59781043,1042,59782085,0,1,1,1024,36,8568391640
4596,59818127,10499,59828626,0,1,1,16896,36,2907440039
4597,59834035,2946,59836981,0,1,1,3072,36,6717321712
4598,59852990,3422,59856412,0,1,1,3584,36,706589566
4599,59891981,3422,59895403,0,1,1,3584,36,3594459701
4600,59926491,2946,59929437,0,9,1,3072,20,2046075490
4601,59934305,3422,59937727,0,1,1,3584,36,3835949708
4602,59947148,566,59947714,0,4,1,512,21,339001358
4603,59961667,6278,59967945,0,1,1,6656,36,1657119740
4604,59980552,99632,60080184,0,8,0,27136,27,3784586611
4605,59983408,566,59983974,0,1,1,512,36,3909975594
4606,59995148,5802,60000950,0,2,1,6144,8,1383922115
4607,59996358,566,59996924,0,9,1,512,20,4167068463
4608,60005360,2470,60007830,0,6,1,2560,42,8478651175
4609,60011403,3422,60014825,0,1,1,3584,36,752816300
4610,60018183,108836,60127019,0,8,0,57344,27,6773127098
4611,60040655,2470,60043125,0,6,1,2560,42,3888944307
4612,60046263,2946,60049209,0,2,1,3072,8,3820308908
4613,60050392,2470,60052862,0,2,1,2560,8,3236231308
4614,60066396,1994,60068390,0,6,1,2048,42,1369128248
4615,60113427,3387,60116814,0,2,1,9728,8,956849200
4616,60144006,3898,60147904,0,9,1,4096,20,8675381712
4617,60147757,566,60148323,0,6,1,512,42,10606550500
4618,60148219,2870,60151089,0,2,1,8704,8,4133507303
4619,60155358,47288,60202646,0,6,0,1536,42,9362323904
4620,60205289,1994,60207283,0,6,1,2048,42,2772817451
4621,60228504,566,60229070,0,9,1,512,20,1103155522
4622,60249979,1518,60251497,0,2,1,1536,8,5106373717
4623,60266255,2946,60269201,0,2,1,3072,8,2652056686
4624,60284326,3422,60287748,0,9,1,3584,20,4551886655
4625,60293864,4937,60298801,0,2,1,12800,8,6051948239
4626,60325577,1518,60327095,0,2,1,1536,8,2909404241
4627,60378178,117260,60495438,0,8,0,84992,27,918701083
4628,60435765,2470,60438235,0,9,1,2560,20,7071414929
4629,60436298,151852,60588150,0,8,0,89600,27,7450227401
4630,60456828,47444,60504272,0,6,0,2048,42,5253726459
4631,60497096,127732,60624828,0,8,0,42496,27,131907482
4632,60544612,224255,60768867,0,8,0,94720,27,3794293105
4633,60599491,98696,60698187,0,8,0,24064,27,2441097334
4634,60656644,121628,60778272,0,8,0,12288,27,2587011372
4635,60664437,50343,60714780,0,8,0,512,27,3409168498
4636,60705420,1042,60706462,0,9,1,1024,20,7791387045
4637,60731563,120071,60851634,0,8,0,25088,27,4392799248
4638,60737908,4374,60742282,0,1,1,4608,36,3862426066
4639,60759636,2946,60762582,0,6,1,3072,42,9855569314
4640,60776072,1518,60777590,0,9,1,1536,20,1938011640
4641,60868678,10241,60878919,0,6,1,16384,42,10550139518
4642,60869309,94870,60964179,0,6,0,1024,42,3354106248
4643,60891312,13083,60904395,0,9,1,22016,20,10536579402
4644,61012126,198860,61210986,0,8,0,191488,27,7426699983
4645,61023991,3422,61027413,0,4,1,3584,21,3845377472
4646,61048481,185857,61234338,0,8,0,13824,27,9543112920
4647,61055730,566,61056296,0,8,1,512,27,6632970374
4648,61135917,48980,61184897,0,6,0,2048,42,1670894517
4649,61156308,60708,61217016,0,8,1,14848,27,2867799253
4650,61177335,5802,61183137,0,4,1,6144,21,2906516200
4651,61179853,43422,61223275,0,8,1,8192,27,4182189380
4652,61180204,107306,61287510,0,8,0,4608,27,3045729640
4653,61195914,28347,61224261,0,8,1,1536,27,1597270427
4654,61202141,47288,61249429,0,4,0,1536,21,3394261352
4655,61211653,195965,61407618,0,4,0,18432,21,10198623457
4656,61248600,2946,61251546,0,8,1,3072,27,5058029457
4657,61263544,43904,61307448,0,6,0,512,42,10336542916
4658,61302732,2870,61305602,0,4,1,8704,21,1428749683
4659,61305908,234109,61540017,0,4,0,75264,21,10694106668
4660,61317278,2946,61320224,0,4,1,3072,21,4484377298
4661,61322307,54056,61376363,0,6,0,3584,42,8553512529
4662,61345601,7706,61353307,0,8,1,8192,27,5642516184
4663,61350076,95394,61445470,0,8,0,23552,27,4129994054
4664,61372848,3898,61376746,0,4,1,4096,21,569227222
4665,61383865,220777,61604642,0,8,0,162304,27,10493935957
4666,61423000,185089,61608089,0,8,0,11264,27,3976294006
4667,61434492,43904,61478396,0,6,0,512,42,1198898896
4668,61443529,7259,61450788,0,8,1,5632,27,5283466818
4669,61478583,12049,61490632,0,4,1,19968,21,7511871578
4670,61496891,48980,61545871,0,6,0,2048,42,6802900447
4671,61498791,566,61499357,0,1,1,512,36,9544815706
4672,61511098,48980,61560078,0,6,0,2048,42,2146671876
4673,61514772,1042,61515814,0,4,1,1024,21,2249481571
4674,61537404,111585,61648989,0,4,0,28672,21,4767481833
4675,61541347,43904,61585251,0,6,0,512,42,2650618998
4676,61548889,196687,61745576,0,4,0,31232,21,6667853914
4677,61588965,52364,61641329,0,6,0,3072,42,1951797877
4678,61596905,5802,61602707,0,7,1,6144,41,2268907129
4679,61598931,11144,61610075,0,8,1,2048,27,3951770732
4680,61643305,52988,61696293,0,8,0,5120,27,185151196
4681,61650329,109780,61760109,0,8,0,53248,27,5626472855
4682,61654705,3898,61658603,0,7,1,4096,41,3367794215
4683,61693005,3303,61696308,0,8,1,2560,27,7442285213
4684,61758688,3407,61762095,0,8,1,2048,27,936802716
4685,61763083,106496,61869579,0,8,0,49664,27,8289277123
4686,61798690,2470,61801160,0,8,1,2560,27,7559951764
4687,61800645,1994,61802639,0,7,1,2048,41,5424393176
4688,61822186,43904,61866090,0,6,0,512,42,1327193956
4689,61829845,6278,61836123,0,7,1,6656,41,3657544139
4690,61835259,13770,61849029,0,8,1,26624,27,3247772578
4691,61835999,16256,61852255,0,8,1,5120,27,9559239962
4692,61843812,47288,61891100,0,6,0,1536,42,1450296459
4693,61891279,153137,62044416,0,8,0,20480,27,8865462993
4694,61909622,45596,61955218,0,6,0,1024,42,2944361448
4695,61920924,192114,62113038,0,8,0,37888,27,4173987849
4696,61966246,104312,62070558,0,4,0,42496,21,2987333216
4697,61996317,54524,62050841,0,4,0,5120,21,4069225271
4698,62043085,1042,62044127,0,7,1,1024,41,3753396924
4699,62047716,3422,62051138,0,7,1,3584,41,5494807530
4700,62090383,3422,62093805,0,8,1,3584,27,3951648144
4701,62100096,7706,62107802,0,9,1,8192,20,5116936418
4702,62106053,8019,62114072,0,8,1,1024,27,391065515
4703,62107389,45596,62152985,0,6,0,1024,42,7136996564
4704,62113726,50672,62164398,0,8,0,2560,27,2259306866
4705,62118872,1518,62120390,0,9,1,1536,20,6394063841
4706,62172142,7706,62179848,0,7,1,8192,41,4856297810
4707,62194633,5196,62199829,0,8,1,13312,27,249041856
4708,62200731,4420,62205151,0,8,1,11776,27,2668064954
4709,62246035,5802,62251837,0,9,1,6144,20,8813724098
4710,62250709,45596,62296305,0,6,0,1024,42,4795306350
4711,62296620,5802,62302422,0,7,1,6144,41,1485737748
4712,62349569,10499,62360068,0,7,1,16896,41,10032854129
4713,62355073,101036,62456109,0,4,0,31744,21,6980231510
4714,62377177,43904,62421081,0,6,0,512,42,9240766212
4715,62379608,4850,62384458,0,8,1,5120,27,5535366428
4716,62388880,67305,62456185,0,8,0,5632,27,5222304740
4717,62425901,1994,62427895,0,2,1,2048,8,8787347402
4718,62448125,8075,62456200,0,8,1,7168,27,9753289889
4719,62502868,2470,62505338,0,8,1,2560,27,6084837884
4720,62546515,119444,62665959,0,8,0,92160,27,8087173004
4721,62579672,157621,62737293,0,8,0,98304,27,3323739842
4722,62588687,2470,62591157,0,8,1,2560,27,1565229205
4723,62594123,43904,62638027,0,6,0,512,42,2864293837
4724,62619762,5326,62625088,0,8,1,5632,27,9272921519
4725,62641628,146719,62788347,0,8,0,37888,27,6320471229
4726,62653967,15431,62669398,0,8,1,3584,27,4580048875
4727,62683039,64208,62747247,0,4,0,6656,21,4958629311
4728,62686733,3128,62689861,0,8,1,9216,27,8774224668
4729,62689863,566,62690429,0,9,1,512,20,7847831119
4730,62724627,3387,62728014,0,9,1,9728,20,9097563761
4731,62739055,119600,62858655,0,4,0,92672,21,8038011757
4732,62742380,3422,62745802,0,8,1,3584,27,1177123903
4733,62763166,168539,62931705,0,4,0,104448,21,337251914
4734,62772329,200830,62973159,0,4,0,27648,21,855523526
4735,62778594,566,62779160,0,2,1,512,8,9787568048
4736,62782170,93153,62875323,0,8,0,15872,27,6111860824
4737,62815997,101192,62917189,0,8,0,32256,27,77401272
4738,62821801,50672,62872473,0,6,0,2560,42,1203572949
4739,62823997,4374,62828371,0,9,1,4608,20,9145390902
4740,62826175,1518,62827693,0,2,1,1536,8,179915606
4741,62835853,45596,62881449,0,6,0,1024,42,6891621477
4742,62887509,3422,62890931,0,2,1,3584,8,9446609227
4743,62924852,48980,62973832,0,6,0,2048,42,2091142281
4744,62979020,5802,62984822,0,2,1,6144,8,1036214141
4745,62997274,5326,63002600,0,2,1,5632,8,3743579148
4746,63008107,1518,63009625,0,2,1,1536,8,8521595956
4747,63014479,68684,63083163,0,8,0,11264,27,3018754040
4748,63031363,1042,63032405,0,2,1,1024,8,85858455
4749,63035123,43904,63079027,0,6,0,512,42,1608495135
4750,63059822,5971,63065793,0,2,1,14848,8,9178968174
4751,63144696,45752,63190448,0,6,0,1536,42,5773102492
4752,63145235,2946,63148181,0,2,1,3072,8,2063891022
4753,63175397,1042,63176439,0,2,1,1024,8,9956023270
4754,63194540,43904,63238444,0,6,0,512,42,880385940
4755,63208141,45596,63253737,0,6,0,1024,42,10417794376
4756,63236645,75402,63312047,0,8,0,4608,27,4226702036
4757,63254607,107588,63362195,0,8,0,53248,27,6520413410
4758,63262532,4374,63266906,0,2,1,4608,8,5105722063
4759,63272042,1994,63274036,0,6,1,2048,42,5549209263
4760,63287369,7706,63295075,0,6,1,8192,42,9950479769
4761,63291711,63931,63355642,0,6,0,512,42,7409524744
4762,63312563,143904,63456467,0,8,0,62976,27,7907305304
4763,63332169,6278,63338447,0,2,1,6656,8,2258631636
4764,63344076,65900,63409976,0,4,0,7168,21,2923801663
4765,63368960,129393,63498353,0,8,0,12800,27,3583636382
4766,63418740,3128,63421868,0,2,1,9216,8,306506459
4767,63451701,45596,63497297,0,6,0,1024,42,413407121
4768,63469646,103532,63573178,0,8,0,39936,27,313731305
4769,63494715,3422,63498137,0,2,1,3584,8,9874437877
4770,63501977,48980,63550957,0,6,0,2048,42,5125929200
4771,63505378,66957,63572335,0,6,0,512,42,103666426
4772,63510134,6754,63516888,0,6,1,7168,42,7529266725
4773,63513568,43904,63557472,0,6,0,512,42,4378233970
4774,63552334,4679,63557013,0,2,1,12288,8,8945187942
4775,63590193,2470,63592663,0,6,1,2560,42,8290205891
4776,63632286,3898,63636184,0,2,1,4096,8,9945552857
4777,63647865,3898,63651763,0,9,1,4096,20,8634740919
4778,63648469,2946,63651415,0,2,1,3072,8,5721168763
4779,63707420,50672,63758092,0,8,0,2560,27,7649210468
4780,63725919,43904,63769823,0,6,0,512,42,8473628913
4781,63774917,4850,63779767,0,6,1,5120,42,2807537607
4782,63805849,5326,63811175,0,2,1,5632,8,7114296582
4783,63845202,5802,63851004,0,2,1,6144,8,9599375423
4784,63851019,176720,64027739,0,4,0,154112,21,1576631527
4785,63852147,12308,63864455,0,6,1,20480,42,3886484144
4786,63912577,55405,63967982,0,6,0,2048,42,318140262
4787,63930253,130270,64060523,0,4,0,22528,21,8714296681
4788,63932326,57440,63989766,0,8,0,4608,27,5872120926
4789,63996815,98696,64095511,0,8,0,24064,27,9077956655
4790,64023830,4374,64028204,0,2,1,4608,8,8377208064
4791,64098414,100412,64198826,0,4,0,29696,21,3835637270
4792,64105864,7706,64113570,0,1,1,8192,36,4438659210
4793,64120397,2946,64123343,0,2,1,3072,8,3359251540
4794,64121381,3422,64124803,0,1,1,3584,36,543100467
4795,64138593,43904,64182497,0,6,0,512,42,9588850810
4796,64182524,101660,64284184,0,8,0,33792,27,9681999533
4797,64189545,141877,64331422,0,8,0,11264,27,7171134911
4798,64198658,3645,64202303,0,2,1,10240,8,2913057029
4799,64261684,47288,64308972,0,6,0,1536,42,1140269968
4800,64275423,4850,64280273,0,2,1,5120,8,1608623530
4801,64275546,4850,64280396,0,3,1,5120,4,6465939473
4802,64307306,2946,64310252,0,3,1,3072,4,2426962948
4803,64317096,47600,64364696,0,8,0,2560,27,6473117787
4804,64353904,1518,64355422,0,3,1,1536,4,7298263375
4805,64360683,2946,64363629,0,3,1,3072,4,8626463605
4806,64369264,566,64369830,0,3,1,512,4,2720770088
4807,64374300,43904,64418204,0,3,0,512,4,4747865009
4808,64384752,104312,64489064,0,4,0,42496,21,759280472
4809,64384872,114488,64499360,0,4,0,10752,21,4013888625
4810,64417123,2946,64420069,0,3,1,3072,4,2998663505
4811,64490045,566,64490611,0,2,1,512,8,556960312
4812,64522071,117416,64639487,0,4,0,85504,21,5125748870
4813,64563415,198392,64761807,0,8,0,189952,27,4611281596
4814,64578060,47288,64625348,0,3,0,1536,4,10034516470
4815,64606825,1518,64608343,0,2,1,1536,8,6694551672
4816,64611615,1042,64612657,0,2,1,1024,8,669207697
4817,64637289,48980,64686269,0,3,0,2048,4,8742397161
4818,64642815,4850,64647665,0,1,1,5120,36,7515902737
4819,64664158,3387,64667545,0,3,1,9728,4,3854064921
4820,64665575,120610,64786185,0,8,0,41984,27,5032147155
4821,64700546,1518,64702064,0,3,1,1536,4,2366498904
4822,64716273,1518,64717791,0,2,1,1536,8,6572468079
4823,64745619,1518,64747137,0,2,1,1536,8,7771363890
4824,64757514,3904,64761418,0,7,1,10752,41,4494012802
4825,64757934,45596,64803530,0,3,0,1024,4,513076366
4826,64765289,119132,64884421,0,4,0,91136,21,9373736863
4827,64771460,6754,64778214,0,3,1,7168,4,2021643530
4828,64781934,104374,64886308,0,4,0,6144,21,6154233024
4829,64782551,43904,64826455,0,6,0,512,42,1180971384
4830,64792385,2470,64794855,0,2,1,2560,8,5486282285
4831,64823580,43904,64867484,0,6,0,512,42,3138564436
4832,64858824,3422,64862246,0,5,1,3584,46,6005780133
4833,64920279,47600,64967879,0,6,0,2560,42,201148669
4834,64942196,123656,65065852,0,8,0,105984,27,1051267974
4835,64958926,3422,64962348,0,2,1,3584,8,8689463195
4836,64967867,43904,65011771,0,3,0,512,4,4873681168
4837,64973209,47288,65020497,0,6,0,1536,42,10078812240
4838,64997448,117430,65114878,0,8,0,38912,27,7449732381
4839,65021847,2870,65024717,0,2,1,8704,8,10502709441
4840,65026042,99788,65125830,0,4,0,27648,21,5022887689
4841,65053269,125779,65179048,0,8,0,71680,27,4668870736
4842,65071548,48980,65120528,0,6,0,2048,42,9123620849
4843,65123964,43904,65167868,0,6,0,512,42,1598626854
4844,65131850,188462,65320312,0,8,0,144896,27,5355232149
4845,65134666,1042,65135708,0,3,1,1024,4,1536944029
4846,65159369,169226,65328595,0,8,0,27136,27,3205745916
4847,65182346,43904,65226250,0,3,0,512,4,3444915479
4848,65214588,1994,65216582,0,2,1,2048,8,3385707971
4849,65220128,48980,65269108,0,3,0,2048,4,6926099935
4850,65267945,62849,65330794,0,8,0,7168,27,4997048023
4851,65304109,1042,65305151,0,2,1,1024,8,2085797623
4852,65332748,7230,65339978,0,2,1,7680,8,6632278283
4853,65341126,5326,65346452,0,2,1,5632,8,2155552192
4854,65347188,100724,65447912,0,3,0,30720,4,6677157827
4855,65349915,98696,65448611,0,4,0,24064,21,1152828023
4856,65359667,43904,65403571,0,6,0,512,42,9082757542
4857,65395009,48980,65443989,0,8,0,2048,27,8131123415
4858,65417273,51322,65468595,0,8,0,1024,27,7694299038
4859,65444204,103800,65548004,0,3,0,28672,4,8574845774
4860,65466181,108212,65574393,0,4,0,55296,21,6616776608
4861,65478912,1518,65480430,0,5,1,1536,46,4383716919
4862,65487476,50672,65538148,0,6,0,2560,42,6017316784
4863,65516519,43904,65560423,0,8,0,512,27,9959489877
4864,65539606,2470,65542076,0,9,1,2560,20,382881089
4865,65544538,65974,65610512,0,3,0,6144,4,7342623686
4866,65550253,103376,65653629,0,4,0,39424,21,3290697334
4867,65550948,3387,65554335,0,5,1,9728,46,774379776
4868,65562643,130676,65693319,0,3,0,129024,4,8767616447
4869,65564899,1518,65566417,0,9,1,1536,20,1961847221
4870,65570256,3904,65574160,0,9,1,10752,20,6082464420
4871,65584559,5326,65589885,0,9,1,5632,20,5047281093
4872,65585726,3422,65589148,0,3,1,3584,4,7440738188
4873,65593009,3128,65596137,0,9,1,9216,20,7977927336
4874,65604894,2470,65607364,0,5,1,2560,46,1111849542
4875,65637532,3898,65641430,0,5,1,4096,46,4693064469
4876,65651626,3898,65655524,0,9,1,4096,20,7559430668
4877,65656480,48381,65704861,0,3,1,18944,4,2286831164
4878,65660786,43904,65704690,0,6,0,512,42,1156429964
4879,65673316,34771,65708087,0,3,1,5120,4,10090933195
4880,65697846,566,65698412,0,9,1,512,20,3195344024
4881,65763710,6754,65770464,0,3,1,7168,4,2000234442
4882,65772495,7706,65780201,0,1,1,8192,36,3571565534
4883,65784259,5802,65790061,0,1,1,6144,36,7903602630
4884,65793299,1994,65795293,0,8,1,2048,27,5186644847
4885,65801045,7706,65808751,0,3,1,8192,4,5875250743
4886,65810164,4420,65814584,0,1,1,11776,36,4932508894
4887,65814198,7706,65821904,0,4,1,8192,21,105451056
4888,65826430,99008,65925438,0,4,0,25088,21,6946265709
4889,65843894,566,65844460,0,8,1,512,27,3107471625
4890,65846102,3898,65850000,0,1,1,4096,36,6021615946
4891,65859923,2470,65862393,0,1,1,2560,36,6297347047
4892,65865884,3904,65869788,0,8,1,10752,27,10179067176
4893,65879919,111632,65991551,0,8,0,1024,27,3222266139
4894,65880500,4679,65885179,0,8,1,12288,27,4186503896
4895,65904980,95756,66000736,0,3,0,19456,4,9970778613
4896,65911670,1518,65913188,0,5,1,1536,46,396991572
4897,65918384,100256,66018640,0,3,0,29184,4,10381598555
4898,65926208,43904,65970112,0,8,0,512,27,4433172413
4899,65931407,5454,65936861,0,5,1,13824,46,7595953774
4900,65946453,5196,65951649,0,9,1,13312,20,1551884358
4901,65958724,4374,65963098,0,1,1,4608,36,8245226882
4902,65960445,90680,66051125,0,3,0,17920,4,3149651672
4903,65967666,47288,66014954,0,4,0,1536,21,10059593601
4904,65970339,1518,65971857,0,8,1,1536,27,1935452505
4905,65983027,6754,65989781,0,5,1,7168,46,5026398914
4906,65996174,566,65996740,0,9,1,512,20,6130153123
4907,66016767,43904,66060671,0,8,0,512,27,7324178661
4908,66024575,7706,66032281,0,1,1,8192,36,8798462972
4909,66055782,4850,66060632,0,9,1,5120,20,9945168231
4910,66073702,566,66074268,0,5,1,512,46,9835868926
4911,66084367,43904,66128271,0,8,0,512,27,7648979868
4912,66123287,64988,66188275,0,4,0,9216,21,1214342139
4913,66129263,52364,66181627,0,8,0,3072,27,9388680616
4914,66136319,1994,66138313,0,9,1,2048,20,5505332526
4915,66143101,101816,66244917,0,4,0,34304,21,3476248418
4916,66148068,4420,66152488,0,8,1,11776,27,42853894
4917,66157576,7230,66164806,0,1,1,7680,36,3396715565
4918,66200845,121490,66322335,0,4,0,60416,21,7304639289
4919,66210817,108056,66318873,0,3,0,54784,4,2260698583
4920,66215003,1518,66216521,0,9,1,1536,20,2163767241
4921,66217409,566,66217975,0,1,1,512,36,221435458
4922,66222076,1518,66223594,0,4,1,1536,21,6173068621
4923,66234114,3422,66237536,0,1,1,3584,36,3593552168
4924,66247112,215466,66462578,0,4,0,118784,21,646579498
4925,66256062,7706,66263768,0,1,1,8192,36,1409874964
4926,66257317,106159,66363476,0,4,0,21504,21,6209090862
4927,66261609,1042,66262651,0,8,1,1024,27,915435113
4928,66263678,1042,66264720,0,9,1,1024,20,2668492165
4929,66263992,4850,66268842,0,5,1,5120,46,8232396491
4930,66269404,3128,66272532,0,3,1,9216,4,7214170885
4931,66272666,43904,66316570,0,8,0,512,27,338299719
4932,66274923,43904,66318827,0,6,0,512,42,7769895642
4933,66287369,3422,66290791,0,5,1,3584,46,9443643355
4934,66308412,4937,66313349,0,8,1,12800,27,1870936903
4935,66313012,566,66313578,0,5,1,512,46,8953109608
4936,66317208,3645,66320853,0,9,1,10240,20,1141942006
4937,66338223,7706,66345929,0,8,1,8192,27,3753342206
4938,66341967,1518,66343485,0,5,1,1536,46,1389482391
4939,66342881,2470,66345351,0,5,1,2560,46,7508767893
4940,66350425,566,66350991,0,5,1,512,46,9371261507
4941,66359978,4162,66364140,0,8,1,11264,27,606440600
4942,66365364,7230,66372594,0,5,1,7680,46,10718957426
4943,66372837,94664,66467501,0,3,0,15872,4,10051352539
4944,66385579,2470,66388049,0,4,1,2560,21,5331666798
4945,66389198,6754,66395952,0,3,1,7168,4,993679977
4946,66397669,2946,66400615,0,9,1,3072,20,10539905910
4947,66403620,3422,66407042,0,3,1,3584,4,2559366584
4948,66422491,5712,66428203,0,1,1,14336,36,3743679055
4949,66422686,2470,66425156,0,4,1,2560,21,406204902
4950,66426230,36363,66462593,0,4,1,2048,21,7457580675
4951,66439441,3645,66443086,0,8,1,10240,27,10631927935
4952,66463954,4374,66468328,0,8,1,4608,27,10147612661
4953,66470781,43904,66514685,0,6,0,512,42,5692589611
4954,66471072,99632,66570704,0,4,0,27136,21,7097572760
4955,66472072,43904,66515976,0,6,0,512,42,8257637182
4956,66498085,5326,66503411,0,4,1,5632,21,10039203191
4957,66502850,5802,66508652,0,4,1,6144,21,3942933350
4958,66505655,48762,66554417,0,8,0,1536,27,5353321894
4959,66523642,1042,66524684,0,3,1,1024,4,8574261142
4960,66538105,2870,66540975,0,7,1,8704,41,632749532
4961,66559624,45596,66605220,0,8,0,1024,27,10709020116
4962,66568370,2946,66571316,0,5,1,3072,46,9067174471
4963,66568636,43904,66612540,0,8,0,512,27,2628440749
4964,66605525,1042,66606567,0,4,1,1024,21,9413363603
4965,66697600,4679,66702279,0,5,1,12288,46,5200494522
4966,66700790,1042,66701832,0,4,1,1024,21,4883446276
4967,66717605,1994,66719599,0,4,1,2048,21,6337654765
4968,66743123,1994,66745117,0,9,1,2048,20,3624914452
4969,66774225,566,66774791,0,9,1,512,20,9226879309
4970,66784399,108524,66892923,0,3,0,56320,4,9653182267
4971,66785663,1994,66787657,0,4,1,2048,21,9163401186
4972,66810762,13858,66824620,0,8,1,23552,27,2343386139
4973,66824252,2470,66826722,0,9,1,2560,20,10122883218
4974,66831545,14029,66845574,0,4,1,27136,21,6698111779
4975,66866006,67592,66933598,0,4,0,7680,21,3174134536
4976,66871927,50672,66922599,0,6,0,2560,42,10228811394
4977,66879364,1042,66880406,0,2,1,1024,8,4676612423
4978,66922289,1994,66924283,0,7,1,2048,41,1158782284
4979,66946657,1042,66947699,0,4,1,1024,21,6060694157
4980,66948082,566,66948648,0,3,1,512,4,7051682802
4981,66948816,50672,66999488,0,6,0,2560,42,7155186464
4982,66950586,4850,66955436,0,8,1,5120,27,8721694496
4983,66965809,1042,66966851,0,3,1,1024,4,5727164758
4984,66985318,1042,66986360,0,7,1,1024,41,3256495720
4985,67015066,3898,67018964,0,8,1,4096,27,6816364698
4986,67018447,863,67019310,0,8,1,512,27,4212949103
4987,67049595,5326,67054921,0,3,1,5632,4,10638664309
4988,67050894,11791,67062685,0,4,1,19456,21,375063559
4989,67051351,43904,67095255,0,6,0,512,42,2566705201
4990,67058445,1994,67060439,0,5,1,2048,46,9280661342
4991,67081429,2470,67083899,0,7,1,2560,41,6310873116
4992,67084762,5326,67090088,0,9,1,5632,20,4677450401
4993,67106962,1518,67108480,0,3,1,1536,4,2111585898
4994,67108233,566,67108799,0,7,1,512,41,10305594895
4995,67139112,4374,67143486,0,9,1,4608,20,6510036174
4996,67151262,43904,67195166,0,8,0,512,27,6868785858
4997,67159013,566,67159579,0,4,1,512,21,3548787019
4998,67159585,47288,67206873,0,6,0,1536,42,3072829307
4999,67164462,1042,67165504,0,3,1,1024,4,4737597019
5000,67173280,6754,67180034,0,5,1,7168,46,2236937525
5001,67188991,3904,67192895,0,9,1,10752,20,1695574822
5002,67190755,7706,67198461,0,4,1,8192,21,557601408
5003,67191081,1042,67192123,0,5,1,1024,46,10072876645
5004,67211651,566,67212217,0,7,1,512,41,9588337551
5005,67213081,566,67213647,0,6,1,512,42,1180359982
5006,67221494,566,67222060,0,7,1,512,41,3659296325
5007,67229132,3387,67232519,0,4,1,9728,21,104043033
5008,67231141,80916,67312057,0,4,0,11776,21,3078944784
5009,67231475,1737,67233212,0,4,1,1024,21,8495416288
5010,67265679,4679,67270358,0,3,1,12288,4,8317587069
5011,67292999,4850,67297849,0,5,1,5120,46,4650410259
5012,67298939,1042,67299981,0,3,1,1024,4,5782711063
5013,67309839,6114,67315953,0,4,1,10752,21,809306604
5014,67316888,1518,67318406,0,4,1,1536,21,2986056307
5015,67355031,566,67355597,0,9,1,512,20,3554794224
5016,67355421,3387,67358808,0,3,1,9728,4,5225359171
5017,67362007,5712,67367719,0,9,1,14336,20,1413695121
5018,67386151,1518,67387669,0,4,1,1536,21,10034329087
5019,67423482,13253,67436735,0,5,1,25600,46,4190025753
5020,67425053,142247,67567300,0,4,0,79872,21,9195862381
5021,67431518,97778,67529296,0,4,0,512,21,7805953289
5022,67437452,45596,67483048,0,8,0,1024,27,5191464266
5023,67441560,131354,67572914,0,4,0,512,21,1769985614
5024,67448952,1994,67450946,0,3,1,2048,4,9966700627
5025,67450051,4162,67454213,0,5,1,11264,46,764325941
5026,67460174,1994,67462168,0,9,1,2048,20,5608654631
5027,67470949,3898,67474847,0,9,1,4096,20,6158700316
5028,67473359,94120,67567479,0,4,0,512,21,2251515507
5029,67492703,113204,67605907,0,3,0,71680,4,3054004652
5030,67504671,3898,67508569,0,4,1,4096,21,9202659655
5031,67507560,4374,67511934,0,1,1,4608,36,9970914518
5032,67521692,146189,67667881,0,3,0,47104,4,390297762
5033,67547478,3422,67550900,0,2,1,3584,8,4589312028
5034,67551373,18535,67569908,0,4,1,2560,21,9029564866
5035,67552648,43904,67596552,0,8,0,512,27,8057297912
5036,67569998,1994,67571992,0,4,1,2048,21,6524116815
5037,67577677,91467,67669144,0,3,0,4096,4,6219751896
5038,67581773,7230,67589003,0,9,1,7680,20,3720924814
5039,67582767,43904,67626671,0,4,0,512,21,6841368950
5040,67588858,45596,67634454,0,6,0,1024,42,948720403
5041,67599132,7230,67606362,0,4,1,7680,21,6361899661
5042,67606260,43904,67650164,0,4,0,512,21,9957370455
5043,67611104,7706,67618810,0,5,1,8192,46,7950103963
5044,67618110,43904,67662014,0,8,0,512,27,8754625325
5045,67627003,1042,67628045,0,9,1,1024,20,1676537356
5046,67644128,3904,67648032,0,4,1,10752,21,10545186417
5047,67671428,59132,67730560,0,6,0,5120,42,10594996329
5048,67675422,45596,67721018,0,4,0,1024,21,4920699692
5049,67677208,113423,67790631,0,4,0,512,21,10411271226
5050,67682826,47749,67730575,0,4,0,1024,21,5853684478
5051,67705021,43904,67748925,0,6,0,512,42,2937175634
5052,67708081,566,67708647,0,9,1,512,20,10565419705
5053,67730495,43961,67774456,0,6,0,512,42,6973813280
5054,67752614,4850,67757464,0,5,1,5120,46,1441797769
5055,67763428,1518,67764946,0,9,1,1536,20,191247309
5056,67771717,47288,67819005,0,4,0,1536,21,9398971983
5057,67771765,45596,67817361,0,8,0,1024,27,5287271667
5058,67773419,6278,67779697,0,4,1,6656,21,8997218491
5059,67782009,1042,67783051,0,9,1,1024,20,6379348166
5060,67794904,3422,67798326,0,4,1,3584,21,5059061368
5061,67798418,45596,67844014,0,8,0,1024,27,4291891016
5062,67805371,5802,67811173,0,8,1,6144,27,6485621300
5063,67810213,43904,67854117,0,6,0,512,42,2270617723
5064,67817398,50672,67868070,0,8,0,2560,27,1823295394
5065,67828426,45752,67874178,0,8,0,1536,27,4265185500
5066,67863944,101504,67965448,0,3,0,33280,4,8375106799
5067,67864599,5454,67870053,0,5,1,13824,46,8550154093
5068,67869481,45596,67915077,0,8,0,1024,27,9996880790
5069,67892292,43904,67936196,0,6,0,512,42,2896244462
5070,67893873,11016,67904889,0,4,1,17920,21,5781159104
5071,67897952,47026,67944978,0,4,0,1024,21,10031131737
5072,67917148,49635,67966783,0,4,0,1024,21,6887042564
5073,67918188,43904,67962092,0,6,0,512,42,525073015
5074,67937260,2946,67940206,0,9,1,3072,20,5717515052
5075,67940815,43904,67984719,0,6,0,512,42,9852904619
5076,67944819,50672,67995491,0,8,0,2560,27,7422134122
5077,67958841,3422,67962263,0,8,1,3584,27,4108222678
5078,67966408,47288,68013696,0,8,0,1536,27,4830334906
5079,67983203,43904,68027107,0,8,0,512,27,943414149
5080,68030624,1518,68032142,0,5,1,1536,46,1023089059
5081,68032729,45596,68078325,0,4,0,1024,21,4601027945
5082,68036784,48980,68085764,0,6,0,2048,42,4806208775
5083,68112451,5326,68117777,0,4,1,5632,21,9505062408
5084,68115800,4374,68120174,0,8,1,4608,27,7336776373
5085,68117375,3387,68120762,0,8,1,9728,27,5910563709
5086,68136688,43904,68180592,0,8,0,512,27,6356188618
5087,68137985,5802,68143787,0,7,1,6144,41,4033463418
5088,68171213,3387,68174600,0,8,1,9728,27,2500061400
5089,68206550,75296,68281846,0,3,0,12800,4,1984691962
5090,68224049,5326,68229375,0,4,1,5632,21,4242597443
5091,68262307,6278,68268585,0,5,1,6656,46,3255785162
5092,68263830,43904,68307734,0,6,0,512,42,9889747676
5093,68265524,3422,68268946,0,7,1,3584,41,1957193538
5094,68285317,43904,68329221,0,8,0,512,27,5835156645
5095,68296103,1518,68297621,0,5,1,1536,46,1948330791
5096,68316006,1518,68317524,0,8,1,1536,27,2367387340
5097,68334357,55748,68390105,0,4,0,4096,21,8010680296
5098,68342375,3128,68345503,0,5,1,9216,46,4025239006
5099,68345711,45596,68391307,0,4,0,1024,21,846486151
5100,68380252,566,68380818,0,8,1,512,27,8691478709
5101,68406672,45596,68452268,0,4,0,1024,21,4950025020
5102,68434761,45596,68480357,0,4,0,1024,21,6732002752
5103,68435409,5196,68440605,0,5,1,13312,46,9624426556
5104,68443768,1994,68445762,0,7,1,2048,41,1281216269
5105,68447673,4374,68452047,0,7,1,4608,41,467433491
5106,68452472,104312,68556784,0,3,0,42496,4,9254560222
5107,68464811,4420,68469231,0,8,1,11776,27,1212694996
5108,68466764,2946,68469710,0,7,1,3072,41,4654658008
5109,68498921,566,68499487,0,8,1,512,27,1754734816
5110,68508815,47288,68556103,0,6,0,1536,42,10288134651
5111,68516837,65900,68582737,0,3,0,7168,4,2008424228
5112,68564061,94664,68658725,0,3,0,15872,4,6943448157
5113,68579343,2470,68581813,0,7,1,2560,41,3615119218
5114,68579642,6754,68586396,0,1,1,7168,36,10266473217
5115,68582495,1042,68583537,0,6,1,1024,42,9312451011
5116,68610091,3898,68613989,0,8,1,4096,27,467858798
5117,68613456,56136,68669592,0,8,0,1024,27,5512455780
5118,68619224,6278,68625502,0,5,1,6656,46,5731128044
5119,68626256,103896,68730152,0,6,0,512,42,4758178778
5120,68633524,5454,68638978,0,6,1,13824,42,1010364182
5121,68639941,107120,68747061,0,3,0,51712,4,5690737063
5122,68643928,7706,68651634,0,5,1,8192,46,9726165380
5123,68660003,1518,68661521,0,8,1,1536,27,4225982596
5124,68664058,566,68664624,0,7,1,512,41,2880636354
5125,68666360,1994,68668354,0,5,1,2048,46,2866983475
5126,68688982,2946,68691928,0,5,1,3072,46,445261072
5127,68697588,1994,68699582,0,6,1,2048,42,4528574955
5128,68721449,4162,68725611,0,8,1,11264,27,7837225824
5129,68728685,7230,68735915,0,5,1,7680,46,10195136105
5130,68733544,1042,68734586,0,8,1,1024,27,6117163873
5131,68737318,3387,68740705,0,6,1,9728,42,8435614061
5132,68744636,4420,68749056,0,5,1,11776,46,9168449814
5133,68746537,124796,68871333,0,3,0,108032,4,2983668574
5134,68749782,3898,68753680,0,6,1,4096,42,9914661222
5135,68753525,3898,68757423,0,6,1,4096,42,2568483392
5136,68756014,1042,68757056,0,9,1,1024,20,8062884915
5137,68771845,5326,68777171,0,6,1,5632,42,7375069271
5138,68783683,92189,68875872,0,3,0,14848,4,5711556657
5139,68785297,43904,68829201,0,4,0,512,21,2997793911
5140,68805849,6754,68812603,0,6,1,7168,42,10693205558
5141,68833643,4850,68838493,0,8,1,5120,27,2599834328
5142,68837268,1891,68839159,0,8,1,1024,27,11719673
5143,68850528,1518,68852046,0,7,1,1536,41,5715235295
5144,68855630,1518,68857148,0,5,1,1536,46,4002366722
5145,68860533,12308,68872841,0,9,1,20480,20,1009051243
5146,68861327,1994,68863321,0,5,1,2048,46,2867808496
5147,68863723,47288,68911011,0,8,0,1536,27,2744958790
5148,68880679,566,68881245,0,5,1,512,46,4329131517
5149,68886664,97604,68984268,0,3,0,20480,4,4499903863
5150,68905661,3422,68909083,0,5,1,3584,46,5639413381
5151,68919196,7230,68926426,0,5,1,7680,46,10450155540
5152,68920142,6754,68926896,0,6,1,7168,42,3661671434
5153,68936440,566,68937006,0,5,1,512,46,7662553401
5154,68941472,6278,68947750,0,8,1,6656,27,5408098150
5155,68948574,5971,68954545,0,9,1,14848,20,9813691872
5156,68959288,2470,68961758,0,6,1,2560,42,1741294464
5157,68971283,2470,68973753,0,9,1,2560,20,4535143230
5158,68974024,1042,68975066,0,6,1,1024,42,6569599092
5159,68987885,6278,68994163,0,9,1,6656,20,3333380239
5160,69008141,1994,69010135,0,9,1,2048,20,8512002268
5161,69009641,1518,69011159,0,7,1,1536,41,3420739508
5162,69009990,68788,69078778,0,6,0,1536,42,3577261223
5163,69031170,1042,69032212,0,6,1,1024,42,8479239461
5164,69059474,43904,69103378,0,8,0,512,27,5316673669
5165,69065173,43904,69109077,0,8,0,512,27,3147311075
5166,69083887,7230,69091117,0,9,1,7680,20,3861397291
5167,69108679,70064,69178743,0,3,0,10752,4,2331248794
5168,69109486,43904,69153390,0,4,0,512,21,5196925150
5169,69109667,1042,69110709,0,5,1,1024,46,5129815357
5170,69172061,566,69172627,0,7,1,512,41,2025752807
5171,69179738,1994,69181732,0,7,1,2048,41,364493012
5172,69180836,43904,69224740,0,6,0,512,42,4897719751
5173,69192924,110864,69303788,0,6,0,64000,42,3663414206
5174,69214568,1994,69216562,0,6,1,2048,42,9325136384
5175,69226026,1994,69228020,0,6,1,2048,42,6161923687
5176,69235280,1518,69236798,0,5,1,1536,46,4229444421
5177,69252933,114920,69367853,0,3,0,77312,4,7824512710
5178,69254424,1994,69256418,0,5,1,2048,46,2869539894
5179,69262537,43904,69306441,0,8,0,512,27,10022136564
5180,69279944,1518,69281462,0,9,1,1536,20,840576268
5181,69285285,54056,69339341,0,8,0,3584,27,699082798
5182,69297580,6766,69304346,0,6,1,512,42,1176377606
5183,69385621,3904,69389525,0,6,1,10752,42,9117933770
5184,69395490,2470,69397960,0,9,1,2560,20,7750265722
5185,69404259,5326,69409585,0,6,1,5632,42,2559815090
5186,69429809,43904,69473713,0,8,0,512,27,2435335994
5187,69432147,21916,69454063,0,9,1,35840,20,5812339005
5188,69439904,2946,69442850,0,5,1,3072,46,4806732318
5189,69446188,3422,69449610,0,5,1,3584,46,3338411722
5190,69463094,72145,69535239,0,3,0,6656,4,7074548249
5191,69466549,5802,69472351,0,5,1,6144,46,2908180436
5192,69470915,3645,69474560,0,3,1,10240,4,3616439048
5193,69473309,98847,69572156,0,3,0,22016,4,2626333301
5194,69480350,3128,69483478,0,6,1,9216,42,3008353316
5195,69490478,2946,69493424,0,3,1,3072,4,10436639559
5196,69511981,5454,69517435,0,5,1,13824,46,636107196
5197,69527221,4679,69531900,0,6,1,12288,42,8668811421
5198,69534370,43904,69578274,0,4,0,512,21,6759554996
5199,69548532,1042,69549574,0,3,1,1024,4,9205285161
5200,69552280,1994,69554274,0,6,1,2048,42,7135976897
5201,69568817,128987,69697804,0,6,0,54272,42,2986223853
5202,69578501,1994,69580495,0,6,1,2048,42,5402627021
5203,69587088,3128,69590216,0,6,1,9216,42,757111867
5204,69639482,97916,69737398,0,6,0,21504,42,7812745173
5205,69646575,566,69647141,0,6,1,512,42,3404647036
5206,69678532,47288,69725820,0,4,0,1536,21,9942407346
5207,69689081,5802,69694883,0,9,1,6144,20,5516659733
5208,69691648,13512,69705160,0,9,1,26112,20,6559181185
5209,69716434,78080,69794514,0,3,0,16896,4,303469516
5210,69748172,52364,69800536,0,4,0,3072,21,4938555662
5211,69801197,43904,69845101,0,8,0,512,27,1388534333
5212,69804883,1518,69806401,0,6,1,1536,42,7142641672
5213,69820539,15062,69835601,0,9,1,29184,20,2886626206
5214,69842718,122564,69965282,0,3,0,102400,4,6932566473
5215,69850293,66524,69916817,0,6,0,9216,42,9479323096
5216,69855186,124892,69980078,0,3,0,14848,4,9490003489
5217,69867034,41391,69908425,0,9,1,67072,20,8651205485
5218,69880257,120308,70000565,0,6,0,34816,42,9619075099
5219,69881562,45596,69927158,0,8,0,1024,27,326143625
5220,69886003,25008,69911011,0,9,1,4096,20,10395668907
5221,69899391,22552,69921943,0,9,1,35840,20,3161252731
5222,69972548,52291,70024839,0,9,1,84992,20,10712700490
5223,69982320,45596,70027916,0,4,0,1024,21,574645942
5224,70017259,101504,70118763,0,6,0,33280,42,34132133
5225,70027973,43904,70071877,0,4,0,512,21,7515067346
5226,70062731,43904,70106635,0,8,0,512,27,4923361135
5227,70065337,108056,70173393,0,6,0,54784,42,8290798834
5228,70067081,12566,70079647,0,9,1,20992,20,10419537286
5229,70104902,4374,70109276,0,5,1,4608,46,3989968146
5230,70139361,61641,70201002,0,9,1,99840,20,4808697338
5231,70145134,43904,70189038,0,8,0,512,27,5655807946
5232,70148157,99632,70247789,0,3,0,27136,4,8978214695
5233,70167355,60695,70228050,0,9,1,88576,20,1449618058
5234,70187855,96092,70283947,0,6,0,25600,42,8745073982
5235,70201180,47288,70248468,0,4,0,1536,21,8055267269
5236,70226462,54529,70280991,0,9,1,92672,20,3809124205
5237,70237041,4850,70241891,0,5,1,5120,46,2068023317
5238,70275365,5882,70281247,0,9,1,9216,20,2811838792
5239,70292516,35312,70327828,0,9,1,61952,20,10592376874
5240,70299527,111956,70411483,0,3,0,67584,4,1622375170
5241,70342735,108711,70451446,0,6,0,48128,42,2433506877
5242,70351562,77924,70429486,0,6,0,16384,42,7948948425
5243,70366128,51774,70417902,0,9,1,83968,20,5971384184
5244,70391041,31687,70422728,0,9,1,7680,20,9997322210
5245,70391394,1518,70392912,0,5,1,1536,46,3847587525
5246,70396854,97433,70494287,0,5,0,19968,46,3175149655
5247,70398118,7706,70405824,0,5,1,8192,46,2667255505
5248,70404015,45596,70449611,0,4,0,1024,21,4286630956
5249,70420293,2946,70423239,0,5,1,3072,46,5652187248
5250,70434630,1042,70435672,0,5,1,1024,46,7800016036
5251,70451422,36087,70487509,0,9,1,63488,20,6388055153
5252,70515574,6278,70521852,0,5,1,6656,46,5440041350
5253,70530912,3645,70534557,0,5,1,10240,46,3667635547
5254,70533929,31007,70564936,0,9,1,50176,20,7207628348
5255,70534531,48980,70583511,0,4,0,2048,21,9239186917
5256,70550843,102440,70653283,0,6,0,36352,42,6628823536
5257,70573203,566,70573769,0,5,1,512,46,7524790292
5258,70589439,45596,70635035,0,4,0,1024,21,2270253239
5259,70599177,101816,70700993,0,3,0,34304,4,191731946
5260,70606557,48632,70655189,0,4,0,512,21,2826042457
5261,70627480,11791,70639271,0,9,1,19456,20,6692283473
5262,70629434,11143,70640577,0,9,1,2048,20,2007403904
5263,70636029,5326,70641355,0,5,1,5632,46,9348020270
5264,70656837,43904,70700741,0,8,0,512,27,5723596623
5265,70683515,33245,70716760,0,9,1,57856,20,757944079
5266,70689460,110708,70800168,0,6,0,63488,42,5907386732
5267,70695841,73760,70769601,0,5,0,12800,46,2344327533
5268,70746551,45596,70792147,0,4,0,1024,21,2048485509
5269,70757243,128929,70886172,0,6,0,46080,42,2618815778
5270,70797929,7706,70805635,0,5,1,8192,46,10181092762
5271,70811038,93566,70904604,0,9,1,152064,20,9096733939
5272,70811988,6278,70818266,0,5,1,6656,46,9976606533
5273,70815176,4396,70819572,0,5,1,2048,46,1792100401
5274,70875233,87476,70962709,0,3,0,22528,4,6945129258
5275,70882032,150794,71032826,0,5,0,57856,46,5111419515
5276,70896095,6754,70902849,0,4,1,7168,21,3749284890
5277,70925147,64208,70989355,0,6,0,6656,42,8132998205
5278,70979401,112424,71091825,0,6,0,69120,42,5915931305
5279,71045594,4374,71049968,0,7,1,4608,41,4356472075
5280,71053619,102440,71156059,0,5,0,36352,46,2252564264
5281,71054304,13083,71067387,0,9,1,22016,20,4519520307
5282,71054800,13560,71068360,0,9,1,12800,20,356830022
5283,71056768,21205,71077973,0,9,1,25088,20,113519235
5284,71071689,3898,71075587,0,1,1,4096,36,4665745698
5285,71072856,43904,71116760,0,4,0,512,21,1456289755
5286,71073480,3733,71077213,0,1,1,2560,36,5433312891
5287,71107728,13341,71121069,0,9,1,22528,20,4078834217
5288,71124006,3898,71127904,0,1,1,4096,36,2774447767
5289,71161009,14287,71175296,0,9,1,27648,20,5073740046
5290,71176186,1518,71177704,0,3,1,1536,4,1726420030
5291,71192901,52291,71245192,0,9,1,84992,20,9413111710
5292,71280567,3422,71283989,0,3,1,3584,4,1865615407
5293,71282495,109772,71392267,0,5,0,60416,46,9094920308
5294,71301407,2946,71304353,0,3,1,3072,4,1721711193
5295,71317805,51257,71369062,0,9,1,82944,20,4440566275
5296,71322328,114452,71436780,0,3,0,75776,4,9011696294
5297,71339019,35740,71374759,0,9,1,18944,20,3566606491
5298,71356944,2470,71359414,0,1,1,2560,36,69832731
5299,71374944,1042,71375986,0,1,1,1024,36,5224778929
5300,71385768,148560,71534328,0,3,0,96256,4,3538440740
5301,71395681,1042,71396723,0,7,1,1024,41,10468897463
5302,71400107,6278,71406385,0,1,1,6656,36,9391481670
5303,71410735,100412,71511147,0,5,0,29696,46,6002196765
5304,71417749,1042,71418791,0,1,1,1024,36,5632740925
5305,71434055,64208,71498263,0,6,0,6656,42,10302682532
5306,71440671,54787,71495458,0,9,1,93184,20,2637339185
5307,71444140,47288,71491428,0,4,0,1536,21,3278164692
5308,71447612,48980,71496592,0,4,0,2048,21,3728779950
5309,71450742,93180,71543922,0,3,0,5632,4,7445814118
5310,71468834,5326,71474160,0,1,1,5632,36,3615430150
5311,71473360,1042,71474402,0,3,1,1024,4,4581520085
5312,71475332,121004,71596336,0,5,0,97280,46,6008266061
5313,71485316,566,71485882,0,5,1,512,46,10600562295
5314,71489675,5326,71495001,0,1,1,5632,36,3267493678
5315,71512005,43904,71555909,0,4,0,512,21,2696847091
5316,71512407,118040,71630447,0,6,0,87552,42,2956177226
5317,71514910,4937,71519847,0,1,1,12800,36,3922424729
5318,71525831,112177,71638008,0,3,0,40448,4,88690756
5319,71563192,11016,71574208,0,1,1,17920,36,5230484546
5320,71570832,1994,71572826,0,3,1,2048,4,9271846818
5321,71584532,66189,71650721,0,5,0,4608,46,3036078269
5322,71586257,49136,71635393,0,4,0,2560,21,1918121596
5323,71593446,50663,71644109,0,5,0,3072,46,6920405498
5324,71597916,45596,71643512,0,4,0,1024,21,5298835935
5325,71606434,7230,71613664,0,1,1,7680,36,7958701282
5326,71611133,4797,71615930,0,1,1,3584,36,3011006445
5327,71621129,121004,71742133,0,3,0,97280,4,7135137887
5328,71623377,5802,71629179,0,5,1,6144,46,8215844041
5329,71625539,57440,71682979,0,3,0,4608,4,3255111979
5330,71627722,107185,71734907,0,6,0,43008,42,1308659610
5331,71654375,1518,71655893,0,1,1,1536,36,9667003867
5332,71657409,136222,71793631,0,3,0,33280,4,8247953421
5333,71659516,12825,71672341,0,9,1,21504,20,1129916562
5334,71663536,221616,71885152,0,5,0,156160,46,5142662758
5335,71668301,76071,71744372,0,9,1,128000,20,4024442564
5336,71668888,101815,71770703,0,9,1,93184,20,1582106673
5337,71696661,61216,71757877,0,3,0,512,4,2570501498
5338,71713901,87008,71800909,0,6,0,20992,42,8684936547
5339,71717926,199430,71917356,0,5,0,72192,46,4804392032
5340,71750377,83612,71833989,0,9,1,139264,20,5143712491
5341,71752783,217101,71969884,0,5,0,111616,46,2703241254
5342,71764822,88076,71852898,0,6,0,19456,42,161392166
5343,71785739,53947,71839686,0,9,1,18944,20,3522820153
5344,71806246,209150,72015396,0,5,0,15872,46,6601888124
5345,71850959,45596,71896555,0,4,0,1024,21,3565784063
5346,71851540,133392,71984932,0,5,0,27648,46,4455728777
5347,71862782,12995,71875777,0,8,1,25088,27,1088074906
5348,71880447,74672,71955119,0,6,0,10752,42,379805837
5349,71918850,2946,71921796,0,5,1,3072,46,4480436536
5350,71942253,68216,72010469,0,3,0,9728,4,2378124379
5351,71963674,103064,72066738,0,3,0,38400,4,10333286667
5352,71980022,106964,72086986,0,6,0,51200,42,4136231086
5353,71995130,114694,72109824,0,3,0,10240,4,5085998804
5354,71996755,3898,72000653,0,5,1,4096,46,1104003511
5355,72002604,124984,72127588,0,6,0,22016,42,5221993382
5356,72027407,2946,72030353,0,1,1,3072,36,10386811156
5357,72027628,67148,72094776,0,3,0,11264,4,4678507984
5358,72038501,43904,72082405,0,5,0,512,46,590433052
5359,72050669,55748,72106417,0,5,0,4096,46,3061349493
5360,72051481,2470,72053951,0,8,1,2560,27,6313539197
5361,72081989,1042,72083031,0,5,1,1024,46,6996508294
5362,72089811,3422,72093233,0,8,1,3584,27,3679628799
5363,72091480,4374,72095854,0,1,1,4608,36,4683646947
5364,72098424,4679,72103103,0,5,1,12288,46,6473374954
5365,72142534,4850,72147384,0,8,1,5120,27,2392902075
5366,72164995,4374,72169369,0,8,1,4608,27,2330396844
5367,72201407,4374,72205781,0,5,1,4608,46,6433038557
5368,72213259,7230,72220489,0,1,1,7680,36,2190836454
5369,72229275,45596,72274871,0,5,0,1024,46,7113913420
5370,72237611,4679,72242290,0,8,1,12288,27,6416222650
5371,72249385,1994,72251379,0,8,1,2048,27,4081485541
5372,72286247,4937,72291184,0,1,1,12800,36,1198815178
5373,72329299,6754,72336053,0,3,1,7168,4,8735093405
5374,72331774,5047,72336821,0,3,1,11776,4,10407856658
5375,72381701,5802,72387503,0,1,1,6144,36,1445896579
5376,72420027,4162,72424189,0,3,1,11264,4,7933828724
5377,72432068,4850,72436918,0,5,1,5120,46,2760816395
5378,72479326,43904,72523230,0,4,0,512,21,7043404039
5379,72502855,1042,72503897,0,5,1,1024,46,2733063099
5380,72516836,101212,72618048,0,3,0,19456,4,559083343
5381,72533328,3128,72536456,0,3,1,9216,4,7980950812
5382,72537597,47288,72584885,0,6,0,1536,42,4778207104
5383,72538369,2946,72541315,0,7,1,3072,41,1742039711
5384,72550404,146278,72696682,0,5,0,129536,46,9566717111
5385,72560405,1518,72561923,0,5,1,1536,46,2427547888
5386,72568428,3898,72572326,0,7,1,4096,41,1620376449
5387,72577359,4374,72581733,0,5,1,4608,46,5865134515
5388,72583420,4162,72587582,0,3,1,11264,4,1695909122
5389,72601730,125274,72727004,0,5,0,15360,46,10407942678
5390,72618139,99632,72717771,0,6,0,27136,42,9285773400
5391,72625866,105652,72731518,0,5,0,9728,46,10511121536
5392,72633743,3128,72636871,0,5,1,9216,46,4195310086
5393,72634293,187628,72821921,0,3,0,154624,4,1475295101
5394,72644901,47444,72692345,0,4,0,2048,21,8785162043
5395,72659494,3898,72663392,0,7,1,4096,41,10205271432
5396,72666335,31857,72698192,0,5,1,1536,46,2546099313
5397,72702649,124468,72827117,0,3,0,3072,4,5192090358
5398,72707757,2470,72710227,0,5,1,2560,46,3834119868
5399,72724105,181131,72905236,0,5,0,52224,46,5172783301
5400,72726513,104581,72831094,0,5,0,36864,46,1954299618
5401,72728841,566,72729407,0,7,1,512,41,8490119132
5402,72731995,97448,72829443,0,6,0,19968,42,1592787229
5403,72738765,4679,72743444,0,7,1,12288,41,8795338988
5404,72748849,1994,72750843,0,7,1,2048,41,10408705358
5405,72763145,43904,72807049,0,4,0,512,21,7587023609
5406,72799935,24448,72824383,0,3,1,2560,4,1307951869
5407,72828023,123352,72951375,0,6,0,100352,42,2758279397
5408,72845818,169145,73014963,0,6,0,132608,42,1408958766
5409,72908350,1994,72910344,0,7,1,2048,41,920071747
5410,72930710,97940,73028650,0,3,0,26624,4,9475467421
5411,72965804,5326,72971130,0,3,1,5632,4,826840982
5412,72976234,1042,72977276,0,7,1,1024,41,10306909650
5413,72977708,125167,73102875,0,6,0,18944,42,4620384836
5414,72987828,147399,73135227,0,6,0,39424,42,934158160
5415,72990236,6278,72996514,0,3,1,6656,4,2129992923
5416,73012294,566,73012860,0,7,1,512,41,2127835814
5417,73024424,43904,73068328,0,4,0,512,21,213384974
5418,73044639,62516,73107155,0,3,0,6144,4,4276827049
5419,73047945,3898,73051843,0,7,1,4096,41,6413353992
5420,73073135,43904,73117039,0,4,0,512,21,1909115522
5421,73113725,4850,73118575,0,3,1,5120,4,3294652886
5422,73146398,3422,73149820,0,3,1,3584,4,10386878083
5423,73150776,69284,73220060,0,6,0,8192,42,6174337068
5424,73183136,3422,73186558,0,7,1,3584,41,2897901583
5425,73202301,43904,73246205,0,4,0,512,21,10020955498
5426,73215991,2470,73218461,0,7,1,2560,41,3639940543
5427,73223463,74360,73297823,0,3,0,9728,4,7362417154
5428,73232748,2470,73235218,0,7,1,2560,41,6867885369
5429,73251141,4374,73255515,0,3,1,4608,4,6679254831
5430,73275637,1042,73276679,0,3,1,1024,4,3896796892
5431,73306930,104624,73411554,0,5,0,43520,46,4323359793
5432,73321013,99476,73420489,0,6,0,26624,42,5198993652
5433,73332285,4850,73337135,0,4,1,5120,21,4575874805
5434,73352469,12308,73364777,0,7,1,20480,41,9408014628
5435,73374528,11016,73385544,0,7,1,17920,41,6886981750
5436,73384181,68684,73452865,0,6,0,11264,42,5639281263
5437,73384643,2470,73387113,0,4,1,2560,21,3455517472
5438,73386553,3645,73390198,0,3,1,10240,4,4467353176
5439,73393124,130222,73523346,0,3,0,67072,4,579864373
5440,73415382,566,73415948,0,3,1,512,4,4121186928
5441,73459016,5802,73464818,0,3,1,6144,4,151684500
5442,73502998,5454,73508452,0,4,1,13824,21,9047375516
5443,73541644,51467,73593111,0,4,0,1024,21,6980329404
5444,73550756,105092,73655848,0,3,0,45056,4,9514650081
5445,73551870,166783,73718653,0,4,0,3072,21,7217623290
5446,73564514,3898,73568412,0,3,1,4096,4,1280001732
5447,73564818,3422,73568240,0,7,1,3584,41,5204914560
5448,73585952,5802,73591754,0,7,1,6144,41,7901752984
5449,73592471,2470,73594941,0,3,1,2560,4,1146830047
5450,73603472,85448,73688920,0,5,0,15872,46,10191440130
5451,73638385,1042,73639427,0,4,1,1024,21,3379116150
5452,73640212,3422,73643634,0,7,1,3584,41,9169177212
5453,73641271,3128,73644399,0,4,1,9216,21,3294509135
5454,73641878,2102,73643980,0,7,1,512,41,6436268762
5455,73643374,131388,73774762,0,5,0,69632,46,8825037528
5456,73655739,5802,73661541,0,4,1,6144,21,9868729233
5457,73656689,44875,73701564,0,4,0,512,21,3494958322
5458,73670681,2870,73673551,0,4,1,8704,21,5028024633
5459,73672944,4420,73677364,0,8,1,11776,27,2625064450
5460,73705082,5196,73710278,0,8,1,13312,27,4885211057
5461,73764398,1042,73765440,0,8,1,1024,27,7170707020
5462,73764594,76032,73840626,0,4,0,512,21,4247836768
5463,73772064,105404,73877468,0,3,0,46080,4,5525560903
5464,73782367,103532,73885899,0,6,0,39936,42,2903949556
5465,73793248,13770,73807018,0,4,1,26624,21,999846704
5466,73796084,77509,73873593,0,4,0,1536,21,3675339045
5467,73830510,4374,73834884,0,4,1,4608,21,9302860699
5468,73832585,3422,73836007,0,6,1,3584,42,6250210812
5469,73838064,107276,73945340,0,3,0,52224,4,2588993035
5470,73845482,1042,73846524,0,8,1,1024,27,7441623210
5471,73865290,122110,73987400,0,3,0,21504,4,10360637266
5472,73944433,49314,73993747,0,4,0,1024,21,9879839127
5473,73955292,3898,73959190,0,7,1,4096,41,10178001672
5474,73963347,63764,74027111,0,3,0,10240,4,1385993720
5475,73984215,111488,74095703,0,6,0,66048,42,272497418
5476,74042362,3898,74046260,0,6,1,4096,42,6853391003
5477,74045334,100412,74145746,0,6,0,29696,42,2300162005
5478,74052063,45596,74097659,0,4,0,1024,21,1789032296
5479,74059593,107897,74167490,0,6,0,15360,42,3920118226
5480,74065094,45596,74110690,0,4,0,1024,21,1873779660
5481,74082541,1518,74084059,0,4,1,1536,21,2822489666
5482,74095285,1928,74097213,0,6,1,1536,42,1412315297
5483,74096342,2497,74098839,0,6,1,2560,42,5460403394
5484,74111385,1994,74113379,0,4,1,2048,21,7372467771
5485,74139005,566,74139571,0,8,1,512,27,7239301362
5486,74156535,54056,74210591,0,4,0,3584,21,9216027859
5487,74164149,4375,74168524,0,6,1,1024,42,875923747
5488,74165527,121030,74286557,0,3,0,39936,4,8568324932
5489,74182375,155294,74337669,0,3,0,87552,4,1268496236
5490,74220923,5326,74226249,0,6,1,5632,42,5360093145
5491,74241525,3422,74244947,0,8,1,3584,27,673122280
5492,74241704,57440,74299144,0,3,0,4608,4,6160375340
5493,74252646,5326,74257972,0,4,1,5632,21,7693627237
5494,74259711,45596,74305307,0,4,0,1024,21,7473142202
5495,74264646,45596,74310242,0,6,0,1024,42,3771083269
5496,74275207,7706,74282913,0,6,1,8192,42,7199327279
5497,74281619,43904,74325523,0,4,0,512,21,9594061953
5498,74282851,2470,74285321,0,4,1,2560,21,9073347911
5499,74303310,4374,74307684,0,6,1,4608,42,2528038588
5500,74318239,6278,74324517,0,6,1,6656,42,5084191358
5501,74322613,3530,74326143,0,6,1,2560,42,3268061067
5502,74351824,104156,74455980,0,3,0,41984,4,1369666184
5503,74359625,87803,74447428,0,4,0,4096,21,379346257
5504,74380635,105872,74486507,0,6,0,47616,42,10634381346
5505,74384434,5802,74390236,0,4,1,6144,21,9707915606
5506,74415523,6754,74422277,0,4,1,7168,21,6887095104
5507,74424467,2870,74427337,0,8,1,8704,27,6045708362
5508,74428523,3898,74432421,0,4,1,4096,21,4854357635
5509,74460482,130926,74591408,0,4,0,2048,21,1475149980
5510,74480019,70976,74550995,0,5,0,8704,46,5545351840
5511,74489247,3904,74493151,0,8,1,10752,27,4651251630
5512,74520979,116571,74637550,0,6,0,69120,42,6582009688
5513,74528147,4850,74532997,0,6,1,5120,42,1036723877
5514,74566790,122468,74689258,0,6,0,9728,42,10718592873
5515,74570307,4937,74575244,0,4,1,12800,21,9763005372
5516,74577233,106652,74683885,0,5,0,50176,46,10094640172
5517,74597601,7706,74605307,0,8,1,8192,27,6143328598
5518,74618336,43904,74662240,0,4,0,512,21,7622070950
5519,74620410,77744,74698154,0,3,0,10752,4,904811174
5520,74623129,102128,74725257,0,3,0,35328,4,8764590086
5521,74688182,1518,74689700,0,4,1,1536,21,3763066414
5522,74730606,43904,74774510,0,4,0,512,21,2763466117
5523,74814588,43904,74858492,0,4,0,512,21,10257348256
5524,74863520,111332,74974852,0,6,0,65536,42,2089235262
5525,74865209,1994,74867203,0,4,1,2048,21,3885823543
5526,74872704,1042,74873746,0,4,1,1024,21,4130930792
5527,74879636,103688,74983324,0,3,0,40448,4,1877690447
5528,74880210,2946,74883156,0,4,1,3072,21,8393001409
5529,74887081,13083,74900164,0,4,1,22016,21,4483240776
5530,74894422,14804,74909226,0,3,1,28672,4,1017007493
5531,74924535,76212,75000747,0,3,0,4096,4,689252541
5532,74942801,130126,75072927,0,4,0,512,21,595070301
5533,74979545,6241,74985786,0,3,1,2560,4,6603845318
5534,74996866,1994,74998860,0,3,1,2048,4,7200517058
5535,74997136,103769,75100905,0,3,0,34304,4,9762273582
5536,75011377,57908,75069285,0,3,0,6144,4,1986734205
5537,75051410,11533,75062943,0,3,1,18944,4,4230022678
5538,75072834,67592,75140426,0,6,0,7680,42,2835977421
5539,75084235,47288,75131523,0,4,0,1536,21,7990275437
5540,75093199,5971,75099170,0,1,1,14848,36,2492837103
5541,75192776,47288,75240064,0,4,0,1536,21,732358159
5542,75207917,55373,75263290,0,4,0,1024,21,3034641164
5543,75225830,99164,75324994,0,6,0,25600,42,38836511
5544,75244826,3898,75248724,0,4,1,4096,21,1793266236
5545,75285044,4937,75289981,0,4,1,12800,21,364792801
5546,75314269,100412,75414681,0,6,0,29696,42,9370433430
5547,75325482,45596,75371078,0,6,0,1024,42,9967612554
5548,75365871,3422,75369293,0,4,1,3584,21,10705531646
5549,75426276,5196,75431472,0,4,1,13312,21,6967942611
5550,75459194,189500,75648694,0,6,0,160768,42,10346284207
5551,75466172,3898,75470070,0,4,1,4096,21,208893894
5552,75520353,1042,75521395,0,4,1,1024,21,2168973528
5553,75615541,227637,75843178,0,6,0,177152,42,10000460228
5554,75622828,1518,75624346,0,4,1,1536,21,10476940519
5555,75650854,1518,75652372,0,4,1,1536,21,4116005935
5556,75653479,64388,75717867,0,3,0,12288,4,42608820
5557,75714333,47288,75761621,0,8,0,1536,27,4626904890
5558,75714814,4937,75719751,0,8,1,12800,27,2839829775
5559,75741716,1994,75743710,0,2,1,2048,8,4307409733
5560,75750397,566,75750963,0,5,1,512,46,4936620142
5561,75788166,4679,75792845,0,5,1,12288,46,2401710542
5562,75815266,566,75815832,0,5,1,512,46,3320017971
5563,75823919,2470,75826389,0,2,1,2560,8,2334221693
5564,75826604,47288,75873892,0,4,0,1536,21,2698633577
5565,75831387,566,75831953,0,5,1,512,46,9959913383
5566,75841076,11016,75852092,0,5,1,17920,46,1622398861
5567,75841948,3898,75845846,0,2,1,4096,8,8095005404
5568,75849359,5971,75855330,0,2,1,14848,8,6011108338
5569,75851794,47288,75899082,0,8,0,1536,27,1831357335
5570,75873544,45936,75919480,0,4,0,1024,21,9857750560
5571,75884960,3422,75888382,0,4,1,3584,21,3822133400
5572,75886657,47288,75933945,0,3,0,1536,4,6401074833
5573,75890873,60937,75951810,0,4,0,512,21,8511247102
5574,75903753,5326,75909079,0,2,1,5632,8,7128188321
5575,75962830,197612,76160442,0,3,0,187392,4,7503343405
5576,75968650,1994,75970644,0,4,1,2048,21,7015188728
5577,75991502,3387,75994889,0,7,1,9728,41,8281121819
5578,75995578,1994,75997572,0,4,1,2048,21,8744753174
5579,76000667,49336,76050003,0,4,0,1536,21,4978861850
5580,76038129,43904,76082033,0,8,0,512,27,8917078873
5581,76046093,1518,76047611,0,4,1,1536,21,8000633650
5582,76050949,6229,76057178,0,5,1,15360,46,2495197516
5583,76054876,43904,76098780,0,4,0,512,21,9302578223
5584,76082676,6754,76089430,0,4,1,7168,21,2593716093
5585,76085863,7706,76093569,0,7,1,8192,41,6408050669
5586,76108974,43904,76152878,0,4,0,512,21,1953020678
5587,76120311,4850,76125161,0,2,1,5120,8,216622209
5588,76139564,5971,76145535,0,5,1,14848,46,3780341143
5589,76147575,566,76148141,0,5,1,512,46,3193053812
5590,76176494,566,76177060,0,4,1,512,21,8042831698
5591,76180302,566,76180868,0,7,1,512,41,5305978059
5592,76192841,2946,76195787,0,2,1,3072,8,8107907486
5593,76200833,44060,76244893,0,8,0,1024,27,7888220828
5594,76200891,4162,76205053,0,7,1,11264,41,7011451333
5595,76223674,4850,76228524,0,2,1,5120,8,8891120360
5596,76249894,107744,76357638,0,3,0,53760,4,4496342820
5597,76302298,3422,76305720,0,4,1,3584,21,686708292
5598,76304783,566,76305349,0,5,1,512,46,2210283207
5599,76306624,47288,76353912,0,6,0,1536,42,9888416060
5600,76307472,43904,76351376,0,8,0,512,27,4214762781
5601,76308223,4420,76312643,0,2,1,11776,8,7663221500
5602,76313027,169219,76482246,0,3,0,47104,4,7842474019
5603,76319976,107120,76427096,0,3,0,51712,4,4960619111
5604,76326619,54056,76380675,0,8,0,3584,27,1093125345
5605,76326829,1994,76328823,0,2,1,2048,8,7296161568
5606,76327362,108992,76436354,0,6,0,57856,42,8149659875
5607,76331672,3898,76335570,0,7,1,4096,41,9658316902
5608,76342387,108043,76450430,0,6,0,13312,42,9095875338
5609,76364567,120957,76485524,0,6,0,21504,42,3840992221
5610,76366192,566,76366758,0,7,1,512,41,6575818139
5611,76368262,82064,76450326,0,3,0,14848,4,5742307832
5612,76398307,157277,76555584,0,3,0,54784,4,10046854621
5613,76407519,122735,76530254,0,6,0,20992,42,3432411335
5614,76412055,48980,76461035,0,4,0,2048,21,2151167561
5615,76426263,50672,76476935,0,4,0,2560,21,9529023947
5616,76432556,43904,76476460,0,8,0,512,27,662343193
5617,76452108,2946,76455054,0,2,1,3072,8,4081401388
5618,76456524,43904,76500428,0,8,0,512,27,4173532457
5619,76458783,1994,76460777,0,7,1,2048,41,230391236
5620,76476116,3387,76479503,0,7,1,9728,41,2426790983
5621,76497178,114290,76611468,0,3,0,34304,4,846395301
5622,76502350,12995,76515345,0,2,1,25088,8,5954667826
5623,76515247,2470,76517717,0,5,1,2560,46,7382921266
5624,76521701,4850,76526551,0,5,1,5120,46,6953839481
5625,76529102,43904,76573006,0,4,0,512,21,6475425647
5626,76538735,2946,76541681,0,7,1,3072,41,4664629299
5627,76546856,43904,76590760,0,4,0,512,21,3144983056
5628,76562257,6229,76568486,0,2,1,15360,8,3653623208
5629,76611669,5326,76616995,0,2,1,5632,8,4914947464
5630,76618055,2470,76620525,0,2,1,2560,8,1403769209
5631,76619393,2118,76621511,0,2,1,1536,8,10381346613
5632,76635604,1042,76636646,0,7,1,1024,41,4001676745
5633,76655967,45596,76701563,0,8,0,1024,27,5289113641
5634,76662223,3422,76665645,0,2,1,3584,8,2113793332
5635,76703264,67928,76771192,0,3,0,13824,4,3801146993
5636,76718512,48980,76767492,0,4,0,2048,21,5485051182
5637,76739685,5802,76745487,0,5,1,6144,46,2644255309
5638,76768345,86129,76854474,0,6,0,23040,42,4825994345
5639,76799001,87788,76886789,0,3,0,23552,4,8116350371
5640,76810244,120064,76930308,0,6,0,38912,42,6578425006
5641,76831241,97290,76928531,0,3,0,8192,4,3651618756
5642,76867384,1042,76868426,0,6,1,1024,42,2303862543
5643,76879883,2946,76882829,0,7,1,3072,41,3736841628
5644,76897561,1518,76899079,0,6,1,1536,42,2288745897
5645,76899304,566,76899870,0,6,1,512,42,9291618722
5646,76906758,43904,76950662,0,4,0,512,21,8762718205
5647,76908295,43904,76952199,0,4,0,512,21,7516070382
5648,76915122,47288,76962410,0,8,0,1536,27,6422628459
5649,76922973,43904,76966877,0,4,0,512,21,445358693
5650,76942590,5326,76947916,0,7,1,5632,41,3413283895
5651,76946236,3626,76949862,0,7,1,3072,41,2959833659
5652,76951658,566,76952224,0,7,1,512,41,5305665624
5653,76968837,566,76969403,0,7,1,512,41,7352720079
5654,77074741,108851,77183592,0,6,0,37376,42,5202350491
5655,77074970,65456,77140426,0,6,0,10752,42,5966356529
5656,77077093,6754,77083847,0,6,1,7168,42,5766876075
5657,77124755,45596,77170351,0,8,0,1024,27,3559661258
5658,77191193,73760,77264953,0,3,0,12800,4,1636517838
5659,77194932,566,77195498,0,7,1,512,41,6623187223
5660,77232682,1518,77234200,0,7,1,1536,41,6128560217
5661,77233199,117284,77350483,0,3,0,65536,4,8403209145
5662,77317977,45596,77363573,0,4,0,1024,21,9040508706
5663,77350807,54056,77404863,0,3,0,3584,4,6616067912
5664,77368147,48980,77417127,0,4,0,2048,21,9876069666
5665,77389663,48842,77438505,0,4,0,512,21,2321731103
5666,77431854,566,77432420,0,7,1,512,41,6681904789
5667,77493500,50672,77544172,0,6,0,2560,42,9583784876
5668,77519618,566,77520184,0,4,1,512,21,10606148357
5669,77555191,5196,77560387,0,7,1,13312,41,3717242379
5670,77559249,45596,77604845,0,8,0,1024,27,2822571047
5671,77605301,76052,77681353,0,6,0,10240,42,3330123045
5672,77608672,48980,77657652,0,8,0,2048,27,8485206216
5673,77678617,43904,77722521,0,4,0,512,21,8405539803
5674,77679633,4850,77684483,0,7,1,5120,41,4334571317
5675,77703973,43887,77747860,0,9,1,75264,20,4830751427
5676,77718313,104000,77822313,0,6,0,41472,42,9199378966
5677,77727724,45596,77773320,0,8,0,1024,27,10399828194
5678,77736441,47288,77783729,0,4,0,1536,21,4282234270
5679,77835427,2470,77837897,0,6,1,2560,42,1697002417
5680,77840297,97136,77937433,0,6,0,18944,42,6351433660
5681,77841995,43904,77885899,0,8,0,512,27,3846055259
5682,77876557,2946,77879503,0,7,1,3072,41,4695225193
5683,77879483,43904,77923387,0,8,0,512,27,9390157812
5684,77884402,1994,77886396,0,7,1,2048,41,6506141982
5685,77907312,5802,77913114,0,7,1,6144,41,3458806332
5686,77939845,105248,78045093,0,6,0,45568,42,622089989
5687,77951813,3387,77955200,0,3,1,9728,4,2075484360
5688,77966679,43904,78010583,0,4,0,512,21,242619555
5689,77989379,45596,78034975,0,4,0,1024,21,3785063531
5690,78009633,43904,78053537,0,8,0,512,27,10689878298
5691,78015563,23983,78039546,0,7,1,39936,41,5916175608
5692,78022230,103844,78126074,0,6,0,40960,42,7148904307
5693,78033746,47288,78081034,0,4,0,1536,21,4719308059
5694,78037610,10241,78047851,0,9,1,16384,20,1566481400
5695,78091759,43904,78135663,0,8,0,512,27,6798950248
5696,78100454,62516,78162970,0,6,0,6144,42,349193491
5697,78110759,45596,78156355,0,4,0,1024,21,2134309361
5698,78111200,60090,78171290,0,6,0,5632,42,4814632597
5699,78129651,43904,78173555,0,8,0,512,27,10601146103
5700,78137531,566,78138097,0,7,1,512,41,10700250460
5701,78172664,91499,78264163,0,7,1,147968,41,9206395381
5702,78177400,45596,78222996,0,4,0,1024,21,7043107939
5703,78183072,107934,78291006,0,7,1,95744,41,9915138232
5704,78186898,131258,78318156,0,7,1,97280,41,7969703870
5705,78207538,127400,78334938,0,7,1,55808,41,4727477342
5706,78262435,73169,78335604,0,7,1,11264,41,2040693676
5707,78322351,36087,78358438,0,7,1,63488,41,10684971851
5708,78362617,43904,78406521,0,4,0,512,21,699131597
5709,78399152,83288,78482440,0,6,0,13824,42,9366495961
5710,78428762,47288,78476050,0,4,0,1536,21,6612085763
5711,78454063,2946,78457009,0,9,1,3072,20,1759666367
5712,78469910,5326,78475236,0,7,1,5632,41,5164339607
5713,78484144,3422,78487566,0,2,1,3584,8,10026262630
5714,78486943,2470,78489413,0,9,1,2560,20,7210539962
5715,78496994,72541,78569535,0,7,1,117760,41,10358144277
5716,78510568,79616,78590184,0,6,0,16896,42,9265322384
5717,78511958,566,78512524,0,9,1,512,20,8140695039
5718,78522830,57535,78580365,0,7,1,43520,41,6211176709
5719,78533832,1518,78535350,0,2,1,1536,8,5998827819
5720,78536716,1042,78537758,0,2,1,1024,8,1837473412
5721,78560661,5326,78565987,0,1,1,5632,36,2963818019
5722,78566693,104936,78671629,0,6,0,44544,42,954658445
5723,78566813,43716,78610529,0,7,1,71680,41,2655232328
5724,78581155,30040,78611195,0,7,1,11264,41,2171788951
5725,78594688,20693,78615381,0,7,1,6656,41,4593896128
5726,78605721,94253,78699974,0,7,1,156672,41,6483200811
5727,78613565,92720,78706285,0,7,1,30208,41,3321080490
5728,78646002,4374,78650376,0,9,1,4608,20,10736063332
5729,78668913,43904,78712817,0,8,0,512,27,830320881
5730,78687384,566,78687950,0,9,1,512,20,4729190964
5731,78721302,43904,78765206,0,4,0,512,21,3401075225
5732,78779913,73058,78852971,0,7,1,118784,41,7497569817
5733,78794221,113690,78907911,0,7,1,148480,41,9588248060
5734,78811533,92396,78903929,0,6,0,23552,42,1551597572
5735,78815676,77744,78893420,0,6,0,10752,42,4204364488
5736,78914926,1518,78916444,0,6,1,1536,42,649609816
5737,78935919,72068,79007987,0,6,0,12288,42,2551035470
5738,78946452,47288,78993740,0,8,0,1536,27,5218164238
5739,78946494,2470,78948964,0,9,1,2560,20,8822528327
5740,78970041,3645,78973686,0,9,1,10240,20,617568608
5741,78976369,12566,78988935,0,7,1,20992,41,3461639717
5742,78984472,3904,78988376,0,9,1,10752,20,4074445986
5743,78987594,3904,78991498,0,6,1,10752,42,7123712880
5744,78995262,15062,79010324,0,7,1,29184,41,5195294229
5745,79007927,43904,79051831,0,4,0,512,21,5449527842
5746,79012134,1518,79013652,0,9,1,1536,20,2701819493
5747,79036063,566,79036629,0,9,1,512,20,814742848
5748,79058599,6754,79065353,0,8,1,7168,27,10345183284
5749,79081578,21141,79102719,0,9,1,34304,20,2866974265
5750,79085396,47288,79132684,0,4,0,1536,21,9482065642
5751,79120968,3422,79124390,0,6,1,3584,42,3919588763
5752,79126683,1994,79128677,0,9,1,2048,20,3859746703
5753,79134628,33591,79168219,0,7,1,55296,41,2891026779
5754,79196835,2470,79199305,0,9,1,2560,20,6125211453
5755,79216646,5712,79222358,0,7,1,14336,41,1988296508
5756,79241720,26738,79268458,0,7,1,48640,41,4115006420
5757,79242350,31907,79274257,0,7,1,27648,41,5118852072
5758,79254363,4162,79258525,0,9,1,11264,20,1988007162
5759,79254531,5971,79260502,0,6,1,14848,42,3702553012
5760,79269508,1994,79271502,0,6,1,2048,42,9410803058
5761,79279119,5326,79284445,0,6,1,5632,42,2720683092
5762,79322605,50672,79373277,0,8,0,2560,27,9614645175
5763,79361521,45596,79407117,0,8,0,1024,27,5372137044
5764,79433063,15837,79448900,0,9,1,30720,20,8886855272
5765,79433474,113984,79547458,0,6,0,74240,42,2172816770
5766,79462219,2946,79465165,0,9,1,3072,20,7772445755
5767,79473480,4162,79477642,0,6,1,11264,42,8208486386
5768,79522590,47288,79569878,0,8,0,1536,27,5092456479
5769,79529629,45596,79575225,0,8,0,1024,27,9270674904
5770,79532181,5802,79537983,0,1,1,6144,36,6966010820
5771,79540402,4420,79544822,0,4,1,11776,21,9671873708
5772,79545015,13341,79558356,0,7,1,22528,41,8652183239
5773,79553310,2946,79556256,0,6,1,3072,42,3749918462
5774,79574242,1518,79575760,0,6,1,1536,42,4701048023
5775,79574529,2217,79576746,0,6,1,1536,42,9533533910
5776,79583388,5454,79588842,0,9,1,13824,20,9792815264
5777,79605335,3422,79608757,0,9,1,3584,20,8496086106
5778,79628831,43904,79672735,0,8,0,512,27,4699109679
5779,79630560,2870,79633430,0,9,1,8704,20,581837107
5780,79633191,4420,79637611,0,6,1,11776,42,4236402781
5781,79638789,13512,79652301,0,7,1,26112,41,203135918
5782,79677332,566,79677898,0,1,1,512,36,8150690294
5783,79688930,43904,79732834,0,8,0,512,27,10247633037
5784,79698464,2470,79700934,0,6,1,2560,42,5302087711
5785,79703402,3422,79706824,0,6,1,3584,42,9014141966
5786,79714033,99788,79813821,0,6,0,27648,42,9910258481
5787,79721425,3128,79724553,0,7,1,9216,41,205487377
5788,79723814,182909,79906723,0,6,0,13824,42,3021135810
5789,79733115,1518,79734633,0,6,1,1536,42,4676433787
5790,79747829,209070,79956899,0,6,0,163840,42,3623272576
5791,79752710,566,79753276,0,1,1,512,36,5838019397
5792,79756311,50999,79807310,0,7,1,82432,41,6841667449
5793,79788752,43904,79832656,0,8,0,512,27,5136197491
5794,79797981,1518,79799499,0,6,1,1536,42,6513871558
5795,79799188,3422,79802610,0,6,1,3584,42,9977765829
5796,79802190,56079,79858269,0,7,1,95744,41,4852174173
5797,79806735,45596,79852331,0,8,0,1024,27,1758506260
5798,79817062,1042,79818104,0,1,1,1024,36,5473729151
5799,79818025,58323,79876348,0,8,0,512,27,8895365807
5800,79818155,10241,79828396,0,9,1,16384,20,4278929492
5801,79854071,566,79854637,0,1,1,512,36,1168771208
5802,79871073,119032,79990105,0,6,0,34304,42,5761517333
5803,79875826,43904,79919730,0,4,0,512,21,5354574072
5804,79904219,1518,79905737,0,9,1,1536,20,9935276829
5805,79935964,43904,79979868,0,4,0,512,21,2378908089
5806,79944637,1518,79946155,0,1,1,1536,36,9832534232
5807,79956885,86696,80043581,0,8,0,19968,27,5163000144
5808,79963979,2946,79966925,0,6,1,3072,42,1131363665
5809,80010397,45596,80055993,0,4,0,1024,21,5730513804
5810,80012421,71766,80084187,0,7,1,116224,41,1149418526
5811,80020685,89935,80110620,0,7,1,93696,41,730965689
5812,80033442,1994,80035436,0,6,1,2048,42,10103958221
5813,80034802,43904,80078706,0,4,0,512,21,4051478988
5814,80049327,57440,80106767,0,8,0,4608,27,7454271042
5815,80053808,43904,80097712,0,4,0,512,21,6802573487
5816,80063952,48294,80112246,0,7,1,2560,41,5054114971
5817,80066865,7230,80074095,0,9,1,7680,20,1865983155
5818,80075748,1518,80077266,0,1,1,1536,36,9400287923
5819,80079747,88361,80168108,0,8,0,9216,27,606738949
5820,80080080,75920,80156000,0,8,0,14848,27,6912582378
5821,80082051,45596,80127647,0,4,0,1024,21,9530701987
5822,80107771,3422,80111193,0,5,1,3584,46,5126829587
5823,80125966,566,80126532,0,6,1,512,42,4968092209
5824,80177031,47288,80224319,0,4,0,1536,21,7013530058
5825,80177749,43904,80221653,0,4,0,512,21,4875659394
5826,80183926,2470,80186396,0,1,1,2560,36,457058999
5827,80190714,7706,80198420,0,6,1,8192,42,2775449097
5828,80194721,66680,80261401,0,8,0,9728,27,4701167769
5829,80200800,1994,80202794,0,9,1,2048,20,5508533485
5830,80217439,5326,80222765,0,6,1,5632,42,10633305073
5831,80219049,1518,80220567,0,9,1,1536,20,603674426
5832,80223599,4850,80228449,0,5,1,5120,46,9931242019
5833,80225364,108992,80334356,0,6,0,57856,42,10318577213
5834,80246401,3904,80250305,0,1,1,10752,36,7641942030
5835,80250607,1518,80252125,0,1,1,1536,36,8591289238
5836,80255499,143839,80399338,0,6,0,4608,42,561441549
5837,80259353,3422,80262775,0,5,1,3584,46,8560214511
5838,80277423,93308,80370731,0,7,1,151552,41,1209154867
5839,80311610,2470,80314080,0,9,1,2560,20,5948754206
5840,80316484,50672,80367156,0,4,0,2560,21,9269252067
5841,80341461,6278,80347739,0,6,1,6656,42,10380778415
5842,80348476,50741,80399217,0,7,1,81920,41,4343244240
5843,80361690,2470,80364160,0,9,1,2560,20,1545703330
5844,80369282,107276,80476558,0,8,0,52224,27,5467968002
5845,80372881,3898,80376779,0,9,1,4096,20,3052397927
5846,80401125,45752,80446877,0,4,0,1536,21,2836853982
5847,80417857,5971,80423828,0,5,1,14848,46,9038495327
5848,80425488,11791,80437279,0,7,1,19456,41,9142501787
5849,80439304,48980,80488284,0,4,0,2048,21,785971017
5850,80440239,48528,80488767,0,4,0,1536,21,9061335298
5851,80477231,7706,80484937,0,4,1,8192,21,6207872877
5852,80497282,7230,80504512,0,1,1,7680,36,1133121276
5853,80505129,3422,80508551,0,9,1,3584,20,8825155104
5854,80519166,101972,80621138,0,8,0,34816,27,4278489093
5855,80541659,566,80542225,0,5,1,512,46,9870640942
5856,80547124,1042,80548166,0,9,1,1024,20,5679108190
5857,80572238,3128,80575366,0,1,1,9216,36,8519656096
5858,80578366,4420,80582786,0,5,1,11776,46,7229611254
5859,80592607,6229,80598836,0,5,1,15360,46,8242253317
5860,80607819,3898,80611717,0,3,1,4096,4,2561180612
5861,80609936,11225,80621161,0,8,1,6144,27,5947961923
5862,80613058,9590,80622648,0,8,1,1536,27,5408718075
5863,80623703,566,80624269,0,9,1,512,20,4696546003
5864,80624824,3898,80628722,0,3,1,4096,4,9508342153
5865,80629677,2470,80632147,0,9,1,2560,20,3334243205
5866,80644648,1994,80646642,0,9,1,2048,20,1082733992
5867,80652410,100882,80753292,0,8,0,31232,27,10333005930
5868,80655723,50672,80706395,0,4,0,2560,21,3605330458
5869,80666432,3904,80670336,0,7,1,10752,41,4864126043
5870,80669506,7230,80676736,0,8,1,7680,27,10087886601
5871,80672370,2870,80675240,0,5,1,8704,46,7410769127
5872,80682462,566,80683028,0,7,1,512,41,7980347900
5873,80687305,5802,80693107,0,5,1,6144,46,5240105242
5874,80696144,22862,80719006,0,7,1,40960,41,7641400291
5875,80735979,3645,80739624,0,7,1,10240,41,8133038975
5876,80743745,13880,80757625,0,8,1,4608,27,769146923
5877,80747909,62527,80810436,0,8,0,4096,27,4675757396
5878,80768954,3898,80772852,0,1,1,4096,36,683863119
5879,80800513,10499,80811012,0,8,1,16896,27,4844665164
5880,80813659,77744,80891403,0,8,0,10752,27,5103561888
5881,80825286,3422,80828708,0,1,1,3584,36,5119798217
5882,80849665,1994,80851659,0,3,1,2048,4,9729836122
5883,80850698,48980,80899678,0,4,0,2048,21,4087089702
5884,80856848,3128,80859976,0,9,1,9216,20,1547936862
5885,80872093,31266,80903359,0,7,1,50688,41,950083192
5886,80890291,3898,80894189,0,5,1,4096,46,4156010949
5887,80915919,6278,80922197,0,8,1,6656,27,1752111534
5888,80922765,70688,80993453,0,8,0,12800,27,2484252246
5889,80933186,100724,81033910,0,8,0,30720,27,1239928537
5890,80943230,48980,80992210,0,4,0,2048,21,4068305998
5891,80958891,2470,80961361,0,9,1,2560,20,8432182789
5892,80980556,2946,80983502,0,6,1,3072,42,8576453533
5893,80987901,43904,81031805,0,4,0,512,21,359545972
5894,81002425,105701,81108126,0,6,0,44032,42,4905642472
5895,81004621,71312,81075933,0,8,0,14848,27,9043137839
5896,81007293,2470,81009763,0,1,1,2560,36,3404958884
5897,81015475,6278,81021753,0,3,1,6656,4,5589162726
5898,81018268,43904,81062172,0,4,0,512,21,7073139659
5899,81041194,134678,81175872,0,6,0,38400,42,8029321736
5900,81053149,5196,81058345,0,5,1,13312,46,801872710
5901,81056346,20624,81076970,0,7,1,33280,41,7126914156
5902,81069911,1042,81070953,0,1,1,1024,36,7456769454
5903,81098963,4850,81103813,0,5,1,5120,46,150896116
5904,81103138,120788,81223926,0,6,0,45568,42,5950083401
5905,81104005,20366,81124371,0,7,1,32768,41,1590858136
5906,81106559,90680,81197239,0,8,0,17920,27,7422099297
5907,81138464,1518,81139982,0,9,1,1536,20,2747876227
5908,81140070,3128,81143198,0,1,1,9216,36,9900271879
5909,81145275,3645,81148920,0,3,1,10240,4,4540762783
5910,81159879,16096,81175975,0,7,1,31232,41,2606069445
5911,81175923,5802,81181725,0,1,1,6144,36,10368093552
5912,81197950,3128,81201078,0,1,1,9216,36,10690704043
5913,81203347,43904,81247251,0,4,0,512,21,5120976322
5914,81209589,32299,81241888,0,7,1,52736,41,2320749579
5915,81226533,5802,81232335,0,1,1,6144,36,3358974196
5916,81233465,5802,81239267,0,3,1,6144,4,9209084586
5917,81248231,3645,81251876,0,3,1,10240,4,6741964180
5918,81251480,47288,81298768,0,8,0,1536,27,1439186292
5919,81259749,1518,81261267,0,5,1,1536,46,8977367735
5920,81262280,2470,81264750,0,1,1,2560,36,3650066825
5921,81280839,3645,81284484,0,9,1,10240,20,8637021348
5922,81301141,6278,81307419,0,5,1,6656,46,4012967235
5923,81340928,81128,81422056,0,8,0,11776,27,3801010563
5924,81370053,147829,81517882,0,8,0,98304,27,1593571841
5925,81376509,5196,81381705,0,9,1,13312,20,745037972
5926,81386927,3422,81390349,0,9,1,3584,20,3233104250
5927,81395719,16613,81412332,0,5,1,32256,46,7230472128
5928,81424755,566,81425321,0,9,1,512,20,8284978678
5929,81440674,43904,81484578,0,4,0,512,21,7450774942
5930,81445071,191275,81636346,0,8,0,26112,27,9944523708
5931,81447492,154366,81601858,0,8,0,74240,27,9091502216
5932,81450080,45596,81495676,0,4,0,1024,21,4172787703
5933,81451286,3422,81454708,0,3,1,3584,4,7628984657
5934,81451541,566,81452107,0,9,1,512,20,9814912719
5935,81460595,12737,81473332,0,3,1,24576,4,4333166812
5936,81490971,6229,81497200,0,1,1,15360,36,2516666200
5937,81503311,226371,81729682,0,8,0,32768,27,9314474290
5938,81518045,12308,81530353,0,1,1,20480,36,9720235749
5939,81521164,9855,81531019,0,1,1,1024,36,5282294317
5940,81524613,32816,81557429,0,5,1,53760,46,2660544214
5941,81532723,3898,81536621,0,1,1,4096,36,3410046615
5942,81543156,50672,81593828,0,4,0,2560,21,2667998533
5943,81582423,5326,81587749,0,3,1,5632,4,8364768186
5944,81618107,23466,81641573,0,5,1,38912,46,8029148212
5945,81642726,16096,81658822,0,5,1,31232,46,8744752457
5946,81646575,96536,81743111,0,6,0,22016,42,592162068
5947,81673859,4162,81678021,0,5,1,11264,46,8068687687
5948,81679131,124716,81803847,0,5,1,202752,46,8690991732
5949,81684206,140327,81824533,0,5,1,74240,46,6432518380
5950,81689462,566,81690028,0,1,1,512,36,6765037243
5951,81704950,2946,81707896,0,9,1,3072,20,4549597181
5952,81742381,4679,81747060,0,1,1,12288,36,7933807659
5953,81780532,43904,81824436,0,4,0,512,21,10335375182
5954,81795047,48980,81844027,0,4,0,2048,21,9151900180
5955,81810942,52364,81863306,0,4,0,3072,21,6515737827
5956,81812887,51214,81864101,0,4,0,2560,21,5067298368
5957,81829370,566,81829936,0,8,1,512,27,8956049254
5958,81842375,122876,81965251,0,6,0,103424,42,3078407648
5959,81851905,5326,81857231,0,1,1,5632,36,1567907793
5960,81862707,24154,81886861,0,5,1,43520,46,4222532546
5961,81871541,206474,82078015,0,6,0,27648,42,3451034721
5962,81872004,3422,81875426,0,1,1,3584,36,9914891263
5963,81884117,137024,82021141,0,6,0,58880,42,3664295487
5964,81898250,6754,81905004,0,3,1,7168,4,8482520824
5965,81913430,7706,81921136,0,1,1,8192,36,966226206
5966,81914837,101366,82016203,0,7,1,163840,41,6473255406
5967,81923419,23120,81946539,0,5,1,41472,46,6919867141
5968,81935507,1994,81937501,0,3,1,2048,4,626168298
5969,81937452,43904,81981356,0,4,0,512,21,8194058121
5970,81939489,2470,81941959,0,3,1,2560,4,5117349649
5971,81946187,67148,82013335,0,8,0,11264,27,2603921169
5972,81949934,5802,81955736,0,5,1,6144,46,8166874627
5973,81953389,32816,81986205,0,5,1,53760,46,3338114047
5974,81979953,73948,82053901,0,8,0,7168,27,9572655366
5975,81991144,1518,81992662,0,3,1,1536,4,5295738150
5976,82006812,107744,82114556,0,2,0,53760,8,2872865668
5977,82011307,47288,82058595,0,4,0,1536,21,8170143634
5978,82035942,14029,82049971,0,5,1,27136,46,4733008581
5979,82049056,42941,82091997,0,7,1,70144,41,5490026275
5980,82052772,3128,82055900,0,6,1,9216,42,3036359041
5981,82052912,45703,82098615,0,7,1,23552,41,9682815057
5982,82076524,566,82077090,0,9,1,512,20,4323825037
5983,82087040,45596,82132636,0,4,0,1024,21,1913557830
5984,82088826,99788,82188614,0,6,0,27648,42,5062514674
5985,82097547,1042,82098589,0,3,1,1024,4,9838997945
5986,82103434,1518,82104952,0,3,1,1536,4,5440493329
5987,82114771,51257,82166028,0,5,1,82944,46,8768323149
5988,82123556,117952,82241508,0,5,1,163840,46,7368444895
5989,82129214,143144,82272358,0,5,1,106496,46,1249243352
5990,82133018,10757,82143775,0,7,1,17408,41,9811233745
5991,82139415,144285,82283700,0,5,1,37888,46,240361794
5992,82167503,3422,82170925,0,7,1,3584,41,2874861901
5993,82176212,47288,82223500,0,6,0,1536,42,9799831940
5994,82182066,4679,82186745,0,3,1,12288,4,2947719761
5995,82187959,98647,82286606,0,5,1,4608,46,3308033071
5996,82200589,88283,82288872,0,5,1,3584,46,10561828529
5997,82209029,59132,82268161,0,0,0,5120,38,9160820972
5998,82218451,101578,82320029,0,5,1,108032,46,10026549352
5999,82241824,52364,82294188,0,8,0,3072,27,8385603426
6000,82249695,58688,82308383,0,6,0,8704,42,10622968082
6001,82251378,43904,82295282,0,4,0,512,21,10256669903
6002,82252149,107744,82359893,0,8,0,53760,27,3538487303
6003,82257861,4374,82262235,0,1,1,4608,36,6895275383
6004,82259014,62295,82321309,0,5,1,14336,46,8225332132
6005,82282907,4374,82287281,0,1,1,4608,36,7764310259
6006,82291598,117728,82409326,0,2,0,86528,8,9408661627
6007,82308589,5454,82314043,0,1,1,13824,36,6985716263
6008,82343217,157900,82501117,0,2,0,60416,8,3836833922
6009,82381224,101470,82482694,0,2,0,27648,8,9030684945
6010,82389085,112671,82501756,0,2,0,2048,8,3640437450
6011,82404134,111692,82515826,0,2,0,3072,8,8714229426
6012,82438931,92274,82531205,0,7,1,149504,41,10714119961
6013,82448212,98696,82546908,0,6,0,24064,42,7276504307
6014,82461028,71662,82532690,0,7,1,15360,41,4877796734
6015,82480479,30491,82510970,0,5,1,49152,46,6529814912
6016,82493236,566,82493802,0,9,1,512,20,767824099
6017,82530362,1042,82531404,0,1,1,1024,36,6534444035
6018,82534561,45179,82579740,0,5,1,77824,46,6378965520
6019,82539122,83595,82622717,0,5,1,108544,46,6142856240
6020,82547910,91241,82639151,0,7,1,147456,41,7252081685
6021,82564814,76923,82641737,0,7,1,4096,41,4574159780
6022,82607654,25995,82633649,0,5,1,44032,46,6724921222
6023,82628392,44233,82672625,0,5,1,72704,46,2882834517
6024,82631860,101036,82732896,0,6,0,31744,42,8856829320
6025,82632310,6754,82639064,0,2,1,7168,8,6176434482
6026,82633970,60263,82694233,0,5,1,70656,46,7333761737
6027,82639965,59760,82699725,0,5,1,17920,46,2732889996
6028,82679354,2870,82682224,0,2,1,8704,8,7842991399
6029,82692858,65612,82758470,0,2,0,11264,8,9053464915
6030,82698455,22691,82721146,0,5,1,37376,46,8366953277
6031,82722968,54368,82777336,0,4,0,4608,21,976330846
6032,82732241,88100,82820341,0,8,0,24576,27,10057603012
6033,82736382,1994,82738376,0,2,1,2048,8,1616578160
6034,82771202,144785,82915987,0,8,0,105472,27,3196710512
6035,82771219,13253,82784472,0,5,1,25600,46,3499240649
6036,82790893,47288,82838181,0,4,0,1536,21,8729622320
6037,82797557,84645,82882202,0,5,1,141312,46,1372401628
6038,82801306,117572,82918878,0,2,0,86016,8,9684912458
6039,82810790,87682,82898472,0,5,1,53248,46,1461815570
6040,82819577,59132,82878709,0,4,0,5120,21,4005860863
6041,82835697,43904,82879601,0,4,0,512,21,5268500918
6042,82840930,134750,82975680,0,2,0,39424,8,9263069196
6043,82853871,566,82854437,0,1,1,512,36,4215063578
6044,82856059,113048,82969107,0,6,0,71168,42,7587277862
6045,82871862,53325,82925187,0,7,1,87040,41,3063069530
6046,82889850,166101,83055951,0,6,0,101888,42,1634301381
6047,82914650,62137,82976787,0,2,0,3584,8,1253793975
6048,82923878,566,82924444,0,1,1,512,36,1647578028
6049,82933839,12566,82946405,0,1,1,20992,36,4504701173
6050,82943955,113984,83057939,0,8,0,74240,27,5850178264
6051,83003368,2946,83006314,0,9,1,3072,20,8737947423
6052,83012745,2946,83015691,0,2,1,3072,8,8244935070
6053,83047759,44662,83092421,0,7,1,76800,41,9274464876
6054,83049810,157745,83207555,0,8,0,140800,27,5762111412
6055,83052256,2946,83055202,0,2,1,3072,8,834840705
6056,83069245,1042,83070287,0,2,1,1024,8,4715649976
6057,83087940,45596,83133536,0,2,0,1024,8,2550030060
6058,83088335,101504,83189839,0,2,0,33280,8,31678287
6059,83114299,566,83114865,0,8,1,512,27,1337466909
6060,83125875,31007,83156882,0,1,1,50176,36,9579587072
6061,83157041,20366,83177407,0,7,1,32768,41,10680275480
6062,83208014,7230,83215244,0,3,1,7680,4,7727967533
6063,83216885,6278,83223163,0,1,1,6656,36,4952624008
6064,83227466,54358,83281824,0,5,1,89088,46,1504157364
6065,83231520,61850,83293370,0,5,1,47104,46,1090978948
6066,83250347,98384,83348731,0,6,0,23040,42,9031350101
6067,83252377,52744,83305121,0,5,1,39936,46,10258001206
6068,83261993,112580,83374573,0,2,0,69632,8,4802056553
6069,83267408,79057,83346465,0,5,1,110080,46,2248562224
6070,83278501,93988,83372489,0,5,1,83456,46,1963904240
6071,83279260,119662,83398922,0,5,1,85504,46,9682379108
6072,83323731,4937,83328668,0,1,1,12800,36,2382612350
6073,83340902,63614,83404516,0,5,1,18432,46,9334306485
6074,83346411,120388,83466799,0,5,1,157696,46,8127448948
6075,83355508,22202,83377710,0,2,1,9216,8,9624433649
6076,83356507,89059,83445566,0,2,0,8704,8,3406556782
6077,83383607,1042,83384649,0,2,1,1024,8,1340699034
6078,83413441,4162,83417603,0,2,1,11264,8,6045333930
6079,83414330,166388,83580718,0,8,0,145408,27,195883756
6080,83422683,21141,83443824,0,1,1,34304,36,5512731403
6081,83430431,14379,83444810,0,1,1,1536,36,6304637411
6082,83431012,14464,83445476,0,1,1,1024,36,6875703391
6083,83452462,47288,83499750,0,4,0,1536,21,10498281716
6084,83452537,20368,83472905,0,5,1,20992,46,5848866942
6085,83469218,5326,83474544,0,1,1,5632,36,5047228122
6086,83492950,177756,83670706,0,2,0,108032,8,4872924184
6087,83617264,102752,83720016,0,8,0,37376,27,3991430
6088,83625880,1994,83627874,0,2,1,2048,8,7052175767
6089,83630370,2870,83633240,0,1,1,8704,36,3203168457
6090,83659393,130905,83790298,0,2,0,92672,8,3890169267
6091,83718662,102538,83821200,0,8,0,32256,27,9922946774
6092,83733019,1042,83734061,0,1,1,1024,36,6761503544
6093,83750880,173038,83923918,0,2,0,140800,8,6899555083
6094,83780697,1042,83781739,0,1,1,1024,36,3058788725
6095,83798027,10499,83808526,0,5,1,16896,46,6199848527
6096,83872461,42941,83915402,0,5,1,70144,46,2613328479
6097,83883343,33237,83916580,0,5,1,13824,46,1544111519
6098,83885868,47288,83933156,0,4,0,1536,21,2596886960
6099,83889353,62858,83952211,0,5,1,88576,46,7804419297
6100,83909345,106496,84015841,0,6,0,49664,42,3141981375
6101,83927098,29939,83957037,0,5,1,7680,46,4384717759
6102,83939178,43904,83983082,0,4,0,512,21,7995079511
6103,83951996,566,83952562,0,1,1,512,36,1059590962
6104,84013483,128190,84141673,0,6,0,113152,42,1455916955
6105,84017914,75608,84093522,0,2,0,13824,8,1106142424
6106,84036020,2470,84038490,0,2,1,2560,8,4379840007
6107,84084292,90528,84174820,0,6,0,7680,42,8432175705
6108,84089641,82824,84172465,0,6,0,15360,42,5038437866
6109,84102432,43904,84146336,0,4,0,512,21,2301354687
6110,84210579,43904,84254483,0,4,0,512,21,9722049658
6111,84212039,48980,84261019,0,4,0,2048,21,7174160050
6112,84235194,69049,84304243,0,4,0,512,21,4560402074
6113,84241025,43904,84284929,0,8,0,512,27,1670963503
6114,84283358,45596,84328954,0,6,0,1024,42,59777815
6115,84356717,50672,84407389,0,6,0,2560,42,4802740769
6116,84358695,45596,84404291,0,4,0,1024,21,2157396297
6117,84362628,2946,84365574,0,1,1,3072,36,203854911
6118,84365066,7706,84372772,0,1,1,8192,36,10483410458
6119,84366407,130256,84496663,0,6,0,67584,42,3177098436
6120,84372821,118508,84491329,0,2,0,89088,8,7696157831
6121,84412538,122927,84535465,0,6,0,52224,42,3909601933
6122,84437998,113055,84551053,0,2,0,35840,8,2514430779
6123,84459530,3422,84462952,0,1,1,3584,36,7368884165
6124,84464346,246979,84711325,0,2,0,100864,8,7601248972
6125,84471803,45596,84517399,0,8,0,1024,27,5140551857
6126,84490944,148291,84639235,0,2,0,97280,8,2662954291
6127,84519773,193508,84713281,0,2,0,2560,8,9329994715
6128,84534871,45596,84580467,0,8,0,1024,27,6712448568
6129,84545636,104156,84649792,0,6,0,41984,42,8535658052
6130,84550639,48980,84599619,0,6,0,2048,42,7242931992
6131,84613051,43904,84656955,0,4,0,512,21,674663643
6132,84627938,142061,84769999,0,2,0,60416,8,2122305871
6133,84631287,45596,84676883,0,8,0,1024,27,7584651352
6134,84631868,46395,84678263,0,8,0,512,27,9464533065
6135,84642503,4679,84647182,0,1,1,12288,36,2772283089
6136,84644603,45596,84690199,0,8,0,1024,27,2591487940
6137,84660784,43904,84704688,0,4,0,512,21,6187692524
6138,84680416,30924,84711340,0,2,1,512,8,3582240289
6139,84695489,3387,84698876,0,1,1,9728,36,7219971887
6140,84779865,566,84780431,0,1,1,512,36,7095765511
6141,84792313,4374,84796687,0,2,1,4608,8,6086621069
6142,84793807,48980,84842787,0,4,0,2048,21,10685761711
6143,84904821,43904,84948725,0,8,0,512,27,3282432841
6144,84920437,1042,84921479,0,2,1,1024,8,5459746564
6145,84925363,2470,84927833,0,2,1,2560,8,8005592488
6146,84958299,67928,85026227,0,2,0,13824,8,4111892305
6147,84983473,55748,85039221,0,2,0,4096,8,10161774272
6148,85004467,114356,85118823,0,2,0,37376,8,5369387452
6149,85015975,5802,85021777,0,1,1,6144,36,1404875014
6150,85087145,566,85087711,0,4,1,512,21,704720352
6151,85095688,3645,85099333,0,1,1,10240,36,6105755149
6152,85106622,4850,85111472,0,1,1,5120,36,6607860831
6153,85120696,2870,85123566,0,3,1,8704,4,3946455595
6154,85123824,50672,85174496,0,8,0,2560,27,2830014869
6155,85126006,49129,85175135,0,8,0,2048,27,4696367146
6156,85134365,1994,85136359,0,2,1,2048,8,4599332311
6157,85148463,50672,85199135,0,8,0,2560,27,7299099633
6158,85168118,64208,85232326,0,6,0,6656,42,6904230635
6159,85172615,43904,85216519,0,4,0,512,21,4334934393
6160,85180546,3898,85184444,0,1,1,4096,36,4516614541
6161,85205847,2946,85208793,0,4,1,3072,21,3129193996
6162,85211201,50672,85261873,0,4,0,2560,21,1174235212
6163,85217258,1042,85218300,0,1,1,1024,36,3477979085
6164,85226371,2470,85228841,0,1,1,2560,36,4632033288
6165,85230296,3387,85233683,0,4,1,9728,21,5554474978
6166,85232899,43904,85276803,0,8,0,512,27,1588505869
6167,85240131,98072,85338203,0,2,0,22016,8,5493427318
6168,85260524,133653,85394177,0,2,0,93696,8,10224469959
6169,85267117,5326,85272443,0,2,1,5632,8,9521146777
6170,85269284,47288,85316572,0,8,0,1536,27,6602510848
6171,85271071,3387,85274458,0,1,1,9728,36,10065826850
6172,85271257,1852,85273109,0,2,1,1024,8,1638380729
6173,85281028,120028,85401056,0,2,0,22528,8,6048348322
6174,85291276,1518,85292794,0,2,1,1536,8,6624013207
6175,85310220,3422,85313642,0,4,1,3584,21,8622421025
6176,85315432,3422,85318854,0,4,1,3584,21,8478884375
6177,85329784,101504,85431288,0,6,0,33280,42,3800698908
6178,85336903,566,85337469,0,1,1,512,36,1763158674
6179,85349700,43904,85393604,0,4,0,512,21,9968772321
6180,85360314,3898,85364212,0,8,1,4096,27,3061264986
6181,85365589,566,85366155,0,8,1,512,27,1708716837
6182,85389617,102398,85492015,0,4,0,1024,21,7013853398
6183,85390986,43904,85434890,0,4,0,512,21,2332883274
6184,85398394,7980,85406374,0,2,1,5632,8,4446910831
6185,85422566,48980,85471546,0,4,0,2048,21,81662309
6186,85438232,43904,85482136,0,4,0,512,21,3332211089
6187,85464000,3387,85467387,0,4,1,9728,21,5959430098
6188,85488513,2946,85491459,0,4,1,3072,21,8259051057
6189,85489398,3687,85493085,0,4,1,2560,21,7669345222
6190,85507516,73472,85580988,0,6,0,16896,42,3125789038
6191,85528264,53363,85581627,0,6,0,2048,42,4313224761
6192,85549950,69288,85619238,0,6,0,7680,42,6134227760
6193,85552919,4420,85557339,0,8,1,11776,27,9101556338
6194,85566717,2870,85569587,0,4,1,8704,21,10423811113
6195,85572039,4374,85576413,0,1,1,4608,36,6020573403
6196,85572764,45596,85618360,0,8,0,1024,27,92298471
6197,85592991,1042,85594033,0,1,1,1024,36,4852314958
6198,85609705,11533,85621238,0,8,1,18944,27,9778445838
6199,85635713,6229,85641942,0,8,1,15360,27,4837587310
6200,85636437,7230,85643667,0,4,1,7680,21,3888050941
6201,85636767,69403,85706170,0,8,0,512,27,6863314048
6202,85639794,111332,85751126,0,6,0,65536,42,4834567428
6203,85640290,566,85640856,0,2,1,512,8,9917210091
6204,85642735,5802,85648537,0,1,1,6144,36,1163544853
6205,85659174,1518,85660692,0,1,1,1536,36,998672311
6206,85668551,6278,85674829,0,5,1,6656,46,8870999995
6207,85670913,43904,85714817,0,8,0,512,27,6915092174
6208,85692445,1518,85693963,0,6,1,1536,42,3398924266
6209,85705882,1994,85707876,0,4,1,2048,21,1433331336
6210,85728179,13341,85741520,0,5,1,22528,46,5440335715
6211,85744121,43904,85788025,0,4,0,512,21,10478740969
6212,85747043,3898,85750941,0,2,1,4096,8,8793405360
6213,85767288,1518,85768806,0,1,1,1536,36,5316600490
6214,85784025,113516,85897541,0,9,0,72704,20,5218977091
6215,85785744,1042,85786786,0,5,1,1024,46,2412083557
6216,85800987,3422,85804409,0,3,1,3584,4,4183074472
6217,85822644,4374,85827018,0,1,1,4608,36,8445449461
6218,85832100,3898,85835998,0,8,1,4096,27,9169890364
6219,85836845,89588,85926433,0,6,0,14336,42,26114180
6220,85837329,4420,85841749,0,1,1,11776,36,6247516781
6221,85844502,14029,85858531,0,2,1,27136,8,9283266864
6222,85849966,43904,85893870,0,8,0,512,27,7955496275
6223,85893682,43904,85937586,0,4,0,512,21,6670816075
6224,85911372,4420,85915792,0,2,1,11776,8,4726340728
6225,85920828,566,85921394,0,8,1,512,27,10207297507
6226,85937607,43904,85981511,0,8,0,512,27,3764509131
6227,85958904,100256,86059160,0,2,0,29184,8,1624265607
6228,85960867,5454,85966321,0,5,1,13824,46,7973165304
6229,85962173,45596,86007769,0,4,0,1024,21,10056655411
6230,85977022,3422,85980444,0,2,1,3584,8,5606101696
6231,85977109,56596,86033705,0,5,1,96768,46,5308211267
6232,85987950,1042,85988992,0,8,1,1024,27,10519140615
6233,85996131,104341,86100472,0,2,0,23552,8,1722249787
6234,86022581,4937,86027518,0,2,1,12800,8,3688387930
6235,86041649,4162,86045811,0,8,1,11264,27,299979322
6236,86057834,90774,86148608,0,2,0,18944,8,1124203301
6237,86087876,3422,86091298,0,2,1,3584,8,1035330374
6238,86088731,14545,86103276,0,5,1,28160,46,419550780
6239,86149193,86204,86235397,0,9,0,13312,20,3947599746
6240,86166516,43904,86210420,0,4,0,512,21,5895259583
6241,86260450,103220,86363670,0,9,0,38912,20,1969424473
6242,86266415,4850,86271265,0,2,1,5120,8,7712291130
6243,86274470,5454,86279924,0,8,1,13824,27,6416226378
6244,86282950,45596,86328546,0,4,0,1024,21,5163826406
6245,86290222,108680,86398902,0,2,0,56832,8,7180952482
6246,86317860,566,86318426,0,8,1,512,27,10520922
6247,86339892,1994,86341886,0,8,1,2048,27,6084955393
6248,86361879,91050,86452929,0,9,0,22528,20,2574765157
6249,86364512,57440,86421952,0,8,0,4608,27,219080809
6250,86383937,125824,86509761,0,9,0,88064,20,7059983725
6251,86385100,4374,86389474,0,8,1,4608,27,2988785588
6252,86385891,58195,86444086,0,8,0,512,27,7710582628
6253,86385917,5183,86391100,0,8,1,2560,27,1714760357
6254,86430211,2870,86433081,0,8,1,8704,27,2256612069
6255,86455276,57440,86512716,0,2,0,4608,8,8948205565
6256,86463151,43904,86507055,0,8,0,512,27,7545556061
6257,86474118,43904,86518022,0,8,0,512,27,1859685801
6258,86482993,7706,86490699,0,8,1,8192,27,5327359093
6259,86487139,128018,86615157,0,9,0,46080,20,4987539789
6260,86493323,43904,86537227,0,8,0,512,27,4010482755
6261,86503028,10241,86513269,0,3,1,16384,4,3793129248
6262,86522812,2470,86525282,0,4,1,2560,21,5829213785
6263,86544283,58965,86603248,0,8,0,512,27,4157707253
6264,86544522,43904,86588426,0,4,0,512,21,380112701
6265,86550316,10241,86560557,0,3,1,16384,4,6050507898
6266,86560382,44402,86604784,0,8,0,512,27,6602865649
6267,86581887,10499,86592386,0,3,1,16896,4,2797390850
6268,86592185,113048,86705233,0,9,0,71168,20,8265993215
6269,86610763,1042,86611805,0,4,1,1024,21,2385743709
6270,86624396,43904,86668300,0,8,0,512,27,5380258123
6271,86624459,1042,86625501,0,4,1,1024,21,3121220279
6272,86631332,106184,86737516,0,2,0,48640,8,7638374915
6273,86660489,5802,86666291,0,8,1,6144,27,8179658461
6274,86662912,54056,86716968,0,4,0,3584,21,9061228691
6275,86683100,82820,86765920,0,6,0,12288,42,4821426560
6276,86701426,3904,86705330,0,3,1,10752,4,8269966737
6277,86705035,4850,86709885,0,1,1,5120,36,232378533
6278,86707432,3898,86711330,0,4,1,4096,21,4973751758
6279,86747005,43904,86790909,0,4,0,512,21,5525807815
6280,86748072,102908,86850980,0,9,0,37888,20,1437235357
6281,86754164,3387,86757551,0,8,1,9728,27,9687001533
6282,86771712,1994,86773706,0,8,1,2048,27,7796987083
6283,86780770,5802,86786572,0,3,1,6144,4,9987897869
6284,86780819,165041,86945860,0,9,0,18432,20,10128273558
6285,86788889,5454,86794343,0,4,1,13824,21,2652212735
6286,86800489,3422,86803911,0,1,1,3584,36,4812588555
6287,86812016,3128,86815144,0,8,1,9216,27,9773470562
6288,86814904,125325,86940229,0,9,0,93184,20,8801604275
6289,86815108,74360,86889468,0,6,0,9728,42,3760828258
6290,86818214,113516,86931730,0,6,0,72704,42,4514862483
6291,86820473,140095,86960568,0,9,0,16896,20,2378327583
6292,86827621,566,86828187,0,6,1,512,42,982944724
6293,86829580,3645,86833225,0,4,1,10240,21,10019313461
6294,86843634,43904,86887538,0,8,0,512,27,1896260114
6295,86846803,170775,87017578,0,6,0,54784,42,2844680077
6296,86851888,3898,86855786,0,6,1,4096,42,8118582039
6297,86860975,5802,86866777,0,4,1,6144,21,8937471813
6298,86877309,1042,86878351,0,6,1,1024,42,179660545
6299,86891170,2470,86893640,0,3,1,2560,4,9087179491
6300,86902174,4850,86907024,0,1,1,5120,36,3729029070
6301,86914413,4850,86919263,0,4,1,5120,21,902342507
6302,86937430,6754,86944184,0,4,1,7168,21,1633947532
6303,86945541,566,86946107,0,3,1,512,4,8218634498
6304,86954892,1042,86955934,0,1,1,1024,36,1505204714
6305,86955281,166208,87121489,0,4,0,2048,21,9756807006
6306,86955691,109025,87064716,0,9,0,41984,20,587309490
6307,86992079,43904,87035983,0,4,0,512,21,10533987254
6308,87006825,43904,87050729,0,8,0,512,27,4630263462
6309,87013646,92528,87106174,0,2,0,18944,8,1981327160
6310,87062307,110552,87172859,0,5,0,62976,46,6368864267
6311,87073452,4162,87077614,0,4,1,11264,21,3209469391
6312,87073736,102596,87176332,0,9,0,36864,20,1292836342
6313,87088551,101660,87190211,0,2,0,33792,8,8471309618
6314,87102692,60824,87163516,0,9,0,5632,20,3110596263
6315,87120829,89792,87210621,0,5,0,25088,46,7363864486
6316,87134955,143850,87278805,0,5,0,87552,46,7284735142
6317,87137485,47288,87184773,0,4,0,1536,21,7221640584
6318,87149504,5326,87154830,0,3,1,5632,4,5978299723
6319,87164832,116328,87281160,0,5,0,7680,46,1734916481
6320,87210500,566,87211066,0,1,1,512,36,3453190331
6321,87216587,5802,87222389,0,4,1,6144,21,9997763414
6322,87219520,566,87220086,0,1,1,512,36,9744254168
6323,87225802,11533,87237335,0,3,1,18944,4,861340300
6324,87230292,12566,87242858,0,1,1,20992,36,8544556650
6325,87230318,12899,87243217,0,1,1,9728,36,7538719008
6326,87236118,43904,87280022,0,8,0,512,27,5688235741
6327,87240954,1042,87241996,0,4,1,1024,21,7498244415
6328,87249723,52145,87301868,0,8,0,512,27,8416350404
6329,87311901,45596,87357497,0,4,0,1024,21,4654603053
6330,87326836,95288,87422124,0,2,0,17920,8,5883592319
6331,87334186,5712,87339898,0,1,1,14336,36,1696915525
6332,87351665,4374,87356039,0,1,1,4608,36,8159038803
6333,87363084,566,87363650,0,3,1,512,4,10387529050
6334,87377550,47288,87424838,0,4,0,1536,21,9090752211
6335,87383748,104624,87488372,0,2,0,43520,8,6720697555
6336,87435889,104780,87540669,0,5,0,44032,46,6582847452
6337,87444472,43904,87488376,0,8,0,512,27,1869041860
6338,87451162,43904,87495066,0,4,0,512,21,4693238679
6339,87457811,64208,87522019,0,9,0,6656,20,1162356514
6340,87489324,43904,87533228,0,8,0,512,27,578231151
6341,87504063,43904,87547967,0,4,0,512,21,4393650130
6342,87504795,1994,87506789,0,3,1,2048,4,489044043
6343,87530269,52520,87582789,0,8,0,3584,27,7349386711
6344,87537559,1994,87539553,0,3,1,2048,4,2304655875
6345,87581925,2946,87584871,0,1,1,3072,36,8023039181
6346,87589662,24412,87614074,0,7,1,44032,41,9040784804
6347,87595620,2870,87598490,0,3,1,8704,4,9987052422
6348,87605394,76052,87681446,0,4,0,10240,21,8481982178
6349,87620585,1042,87621627,0,3,1,1024,4,5593967835
6350,87624643,47288,87671931,0,8,0,1536,27,5247477782
6351,87654229,4162,87658391,0,3,1,11264,4,2903381191
6352,87707656,4374,87712030,0,2,1,4608,8,6492998767
6353,87753094,566,87753660,0,9,1,512,20,1731965457
6354,87764857,2470,87767327,0,4,1,2560,21,2195885217
6355,87786058,81128,87867186,0,4,0,11776,21,2932468932
6356,87790759,96257,87887016,0,4,0,25600,21,10040673892
6357,87792087,5802,87797889,0,3,1,6144,4,4168018420
6358,87826388,50672,87877060,0,5,0,2560,46,3445454506
6359,87835244,99632,87934876,0,9,0,27136,20,3327664974
6360,87874332,4850,87879182,0,9,1,5120,20,9470227768
6361,87893022,45596,87938618,0,8,0,1024,27,3128442446
6362,87912692,2870,87915562,0,9,1,8704,20,2606596027
6363,87983409,59132,88042541,0,4,0,5120,21,4206363872
6364,88012099,3422,88015521,0,9,1,3584,20,733128035
6365,88030452,566,88031018,0,9,1,512,20,8424650895
6366,88042518,6754,88049272,0,3,1,7168,4,2727321806
6367,88054498,90392,88144890,0,5,0,22016,46,3229845124
6368,88058024,6754,88064778,0,9,1,7168,20,4922845211
6369,88079407,124191,88203598,0,9,0,4608,20,3616922179
6370,88087065,43904,88130969,0,8,0,512,27,7269803901
6371,88106997,62672,88169669,0,9,0,6656,20,5201119933
6372,88121624,1518,88123142,0,9,1,1536,20,321777201
6373,88123627,45596,88169223,0,8,0,1024,27,5738558786
6374,88127279,63955,88191234,0,9,0,1536,20,4142010847
6375,88127917,5802,88133719,0,9,1,6144,20,2243382685
6376,88158351,106496,88264847,0,9,0,49664,20,7014017197
6377,88159483,6278,88165761,0,9,1,6656,20,8225248126
6378,88173218,141239,88314457,0,9,0,55808,20,8006166109
6379,88184171,6754,88190925,0,3,1,7168,4,9007244636
6380,88196435,176876,88373311,0,9,0,20992,20,10382151577
6381,88201367,63764,88265131,0,4,0,10240,21,5634879314
6382,88215441,566,88216007,0,9,1,512,20,3838741471
6383,88219322,167202,88386524,0,9,0,7168,20,670350747
6384,88222089,566,88222655,0,3,1,512,4,1093625409
6385,88259053,13858,88272911,0,3,1,23552,4,1811904959
6386,88264272,115856,88380128,0,2,0,80384,8,8189709648
6387,88267720,1518,88269238,0,5,1,1536,46,7052606203
6388,88281115,204900,88486015,0,5,0,53760,46,3010020537
6389,88283760,180139,88463899,0,9,0,111616,20,9527400176
6390,88291549,566,88292115,0,9,1,512,20,5622557757
6391,88296002,103376,88399378,0,5,0,39424,46,6655403613
6392,88302436,59132,88361568,0,4,0,5120,21,9381921169
6393,88305279,90527,88395806,0,2,0,9728,8,8019328915
6394,88318185,7230,88325415,0,3,1,7680,4,10015157119
6395,88334096,1518,88335614,0,9,1,1536,20,2106054687
6396,88346940,122680,88469620,0,5,0,41984,46,7985443397
6397,88369259,98875,88468134,0,9,0,13824,20,2928927109
6398,88376340,43904,88420244,0,8,0,512,27,6529234307
6399,88387351,153252,88540603,0,9,0,56320,20,5647916160
6400,88410958,5326,88416284,0,9,1,5632,20,8910942828
6401,88414538,4162,88418700,0,3,1,11264,4,6974570393
6402,88416989,6832,88423821,0,3,1,6144,4,2109317086
6403,88418987,64232,88483219,0,4,0,11776,21,6870146833
6404,88440012,5326,88445338,0,3,1,5632,4,9119124932
6405,88440820,30219,88471039,0,9,1,3072,20,10488932944
6406,88478980,5802,88484782,0,3,1,6144,4,6041269819
6407,88500239,99632,88599871,0,5,0,27136,46,4053862942
6408,88512187,100100,88612287,0,4,0,28672,21,8303548946
6409,88521104,98228,88619332,0,4,0,22528,21,1528215445
6410,88533491,10050,88543541,0,9,1,3072,20,2113319157
6411,88539185,43904,88583089,0,8,0,512,27,6123054703
6412,88560691,58376,88619067,0,2,0,7680,8,7850404887
6413,88561492,105560,88667052,0,5,0,46592,46,707244696
6414,88574249,566,88574815,0,9,1,512,20,5116862089
6415,88579384,110426,88689810,0,9,0,36352,20,4236101454
6416,88605047,70976,88676023,0,5,0,8704,46,8433807720
6417,88606327,129764,88736091,0,4,0,106496,21,3762476117
6418,88665552,155052,88820604,0,9,0,136704,20,8514756284
6419,88675177,71814,88746991,0,5,0,8704,46,1440343398
6420,88689629,739,88690368,0,9,1,512,20,3991448318
6421,88694702,70976,88765678,0,8,0,8704,27,2683827877
6422,88721637,195448,88917085,0,9,0,39424,20,1664044394
6423,88739996,7706,88747702,0,3,1,8192,4,4068326351
6424,88740178,8907,88749085,0,3,1,14848,4,3697136488
6425,88765258,49392,88814650,0,8,0,2048,27,4007107851
6426,88771047,5326,88776373,0,3,1,5632,4,9547886132
6427,88813839,114649,88928488,0,9,0,37376,20,938505414
6428,88821608,1518,88823126,0,3,1,1536,4,1252173054
6429,88837251,99632,88936883,0,5,0,27136,46,5780644011
6430,88841533,1518,88843051,0,3,1,1536,4,10331479623
6431,88865577,3645,88869222,0,9,1,10240,20,4293125537
6432,88873283,4850,88878133,0,3,1,5120,4,8704486449
6433,88874086,6278,88880364,0,9,1,6656,20,7308155251
6434,88947724,116792,89064516,0,4,0,83456,21,5813166472
6435,88952845,45596,88998441,0,2,0,1024,8,3779712554
6436,88956866,100724,89057590,0,2,0,30720,8,996344686
6437,88983954,3387,88987341,0,3,1,9728,4,9372020959
6438,89000356,4374,89004730,0,9,1,4608,20,7017501503
6439,89015973,3387,89019360,0,3,1,9728,4,342011005
6440,89054681,130457,89185138,0,2,0,118784,8,1352597147
6441,89066124,56840,89122964,0,5,0,7680,46,2361313431
6442,89121163,6488,89127651,0,3,1,15872,4,2189247076
6443,89129595,48980,89178575,0,5,0,2048,46,5913305894
6444,89139277,111488,89250765,0,9,0,66048,20,9135376514
6445,89178978,6278,89185256,0,3,1,6656,4,3928476982
6446,89188258,127556,89315814,0,5,0,118784,46,6640018540
6447,89206780,3387,89210167,0,3,1,9728,4,1376677806
6448,89253274,3898,89257172,0,3,1,4096,4,2190474225
6449,89271854,6278,89278132,0,9,1,6656,20,9044639763
6450,89337864,104000,89441864,0,5,0,41472,46,7274002414
6451,89353363,1994,89355357,0,9,1,2048,20,4700545769
6452,89359605,54836,89414441,0,9,0,6144,20,8292386229
6453,89374066,3422,89377488,0,3,1,3584,4,4859663302
6454,89392327,87764,89480091,0,2,0,18432,8,2816206613
6455,89406832,1994,89408826,0,3,1,2048,4,6209988402
6456,89458246,13341,89471587,0,3,1,22528,4,5127306269
6457,89461776,10499,89472275,0,9,1,16896,20,111280468
6458,89486767,99320,89586087,0,4,0,26112,21,1160051478
6459,89518116,68528,89586644,0,9,0,10752,20,1249275514
6460,89530538,107744,89638282,0,5,0,53760,46,2553795700
6461,89534976,34279,89569255,0,5,1,59904,46,9219173145
6462,89552031,105716,89657747,0,4,0,47104,21,5597219137
6463,89571348,148865,89720213,0,4,0,29184,21,9757695082
6464,89580141,3904,89584045,0,2,1,10752,8,9144083937
6465,89599668,43904,89643572,0,7,0,512,41,9193373509
6466,89606204,73448,89679652,0,9,0,11776,20,4215577356
6467,89623583,142535,89766118,0,9,0,67584,20,3447508454
6468,89632602,10998,89643600,0,5,1,5632,46,2894818964
6469,89653026,11791,89664817,0,5,1,19456,46,329699856
6470,89661852,149902,89811754,0,9,0,23552,20,5720910758
6471,89677430,194309,89871739,0,2,0,83456,8,10461856453
6472,89710210,136086,89846296,0,2,0,76800,8,9588092002
6473,89732197,42941,89775138,0,5,1,70144,46,1819661376
6474,89747255,22753,89770008,0,9,1,4096,20,2902073170
6475,89765692,98228,89863920,0,5,0,22528,46,220241881
6476,89767786,155222,89923008,0,5,0,22016,46,2749365108
6477,89775394,2470,89777864,0,9,1,2560,20,3513403283
6478,89785002,221550,90006552,0,2,0,172544,8,2664421349
6479,89827918,56216,89884134,0,4,0,5632,21,6781889658
6480,89844627,7706,89852333,0,9,1,8192,20,1156558696
6481,89844929,11274,89856203,0,7,1,18432,41,5778438245
6482,89870734,3422,89874156,0,9,1,3584,20,2271972467
6483,89875221,566,89875787,0,9,1,512,20,6810338771
6484,89881573,103607,89985180,0,5,0,32256,46,4998013781
6485,89889775,43112,89932887,0,7,1,73728,41,7283332470
6486,89893079,106962,90000041,0,5,1,178176,46,8998695920
6487,89898729,88596,89987325,0,7,1,125952,41,5298024528
6488,89906410,145013,90051423,0,5,1,163840,46,9219614051
6489,89913712,89576,90003288,0,7,1,59904,41,3733699152
6490,89931723,202555,90134278,0,7,0,2560,41,274120617
6491,89935579,68055,90003634,0,7,1,512,41,9612038829
6492,89941042,3645,89944687,0,8,1,10240,27,185739194
6493,89970062,86507,90056569,0,5,1,8192,46,4635955584
6494,89970066,49019,90019085,0,7,1,49152,41,8797086923
6495,89985439,69988,90055427,0,7,0,512,41,5435699674
6496,89986423,58688,90045111,0,4,0,8704,21,7937877044
6497,89992755,111496,90104251,0,5,1,154624,46,766327041
6498,90002832,178872,90181704,0,2,0,148992,8,4375174725
6499,90051025,149111,90200136,0,2,0,35840,8,7929356881
6500,90083082,7230,90090312,0,4,1,7680,21,3831339611
6501,90093341,4850,90098191,0,7,1,5120,41,8653405660
6502,90096073,150749,90246822,0,2,0,74240,8,6091417567
6503,90101645,1994,90103639,0,8,1,2048,27,8481648381
6504,90142684,52364,90195048,0,9,0,3072,20,9971167445
6505,90150246,74520,90224766,0,7,0,512,41,7426686525
6506,90152440,253400,90405840,0,2,0,159232,8,10385026044
6507,90154848,1042,90155890,0,8,1,1024,27,5359986702
6508,90162749,13083,90175832,0,5,1,22016,46,1669031602
6509,90163150,3128,90166278,0,8,1,9216,27,2258591834
6510,90180561,5971,90186532,0,8,1,14848,27,10175415816
6511,90181450,92489,90273939,0,4,0,6656,21,2155128732
6512,90205510,2470,90207980,0,4,1,2560,21,3631033777
6513,90228778,6278,90235056,0,7,1,6656,41,5660189716
6514,90235173,4850,90240023,0,4,1,5120,21,6178853302
6515,90273618,134265,90407883,0,2,0,6656,8,4522483918
6516,90276190,2946,90279136,0,8,1,3072,27,189271016
6517,90278536,4374,90282910,0,9,1,4608,20,959043287
6518,90280899,4162,90285061,0,7,1,11264,41,5086363214
6519,90289815,12049,90301864,0,4,1,19968,21,10009026043
6520,90290773,3898,90294671,0,5,1,4096,46,1229242224
6521,90296025,43904,90339929,0,7,0,512,41,936125166
6522,90311298,5326,90316624,0,7,1,5632,41,787295250
6523,90313053,55904,90368957,0,5,0,4608,46,7828569884
6524,90321785,68654,90390439,0,7,0,512,41,10241950471
6525,90336569,1042,90337611,0,7,1,1024,41,9540873438
6526,90337943,2001,90339944,0,7,1,2048,41,5706405086
6527,90346266,46157,90392423,0,7,0,1024,41,5858256881
6528,90364103,1042,90365145,0,9,1,1024,20,7131519278
6529,90387500,119851,90507351,0,2,0,26624,8,10524006932
6530,90397997,7706,90405703,0,9,1,8192,20,5949143188
6531,90408824,10499,90419323,0,4,1,16896,21,10520824281
6532,90414475,5802,90420277,0,8,1,6144,27,9854005171
6533,90422650,4850,90427500,0,9,1,5120,20,3733056798
6534,90442629,7230,90449859,0,8,1,7680,27,10137664991
6535,90467119,45596,90512715,0,7,0,1024,41,4737864762
6536,90482554,45596,90528150,0,7,0,1024,41,7496882698
6537,90491835,107276,90599111,0,4,0,52224,21,10454239764
6538,90491907,114452,90606359,0,5,0,75776,46,9772988944
6539,90502619,1518,90504137,0,7,1,1536,41,6304384492
6540,90510247,1042,90511289,0,9,1,1024,20,3513437873
6541,90511330,52364,90563694,0,2,0,3072,8,6703894281
6542,90589505,142062,90731567,0,5,0,111104,46,3993590146
6543,90635912,58688,90694600,0,9,0,8704,20,8738057908
6544,90646164,2470,90648634,0,4,1,2560,21,3102255844
6545,90649942,6754,90656696,0,8,1,7168,27,8466237180
6546,90652806,117701,90770507,0,5,0,14848,46,969075915
6547,90657520,3422,90660942,0,7,1,3584,41,2749302615
6548,90676491,2470,90678961,0,8,1,2560,27,1572248210
6549,90679507,4850,90684357,0,8,1,5120,27,8430794373
6550,90699901,99320,90799221,0,9,0,26112,20,4059910646
6551,90702065,1042,90703107,0,4,1,1024,21,3926215307
6552,90720403,112334,90832737,0,4,0,10752,21,50169322
6553,90722230,1518,90723748,0,7,1,1536,41,141924540
6554,90724778,112513,90837291,0,9,0,13824,20,5912292849
6555,90734848,101348,90836196,0,5,0,32768,46,2134048075
6556,90737420,5802,90743222,0,8,1,6144,27,1446479005
6557,90759525,65900,90825425,0,4,0,7168,21,939495848
6558,90779996,3898,90783894,0,4,1,4096,21,6853602895
6559,90783122,45596,90828718,0,7,0,1024,41,3029072412
6560,90798659,109772,90908431,0,2,0,60416,8,5049710626
6561,90836281,129452,90965733,0,4,0,52224,21,3824072153
6562,90840994,10499,90851493,0,4,1,16896,21,3953280010
6563,90856021,3128,90859149,0,4,1,9216,21,934767051
6564,90901067,4374,90905441,0,4,1,4608,21,2764798463
6565,90918441,6278,90924719,0,7,1,6656,41,5689791487
6566,90928726,1518,90930244,0,4,1,1536,21,2233324796
6567,90929226,2004,90931230,0,4,1,1536,21,189004529
6568,90951231,3898,90955129,0,8,1,4096,27,3982630309
6569,90955923,250753,91206676,0,4,0,52224,21,8800229962
6570,90959499,99164,91058663,0,9,0,25600,20,1089796699
6571,90968596,4850,90973446,0,4,1,5120,21,10425431993
6572,91005307,4374,91009681,0,4,1,4608,21,3198360391
6573,91023372,62516,91085888,0,2,0,6144,8,6153373925
6574,91026509,43904,91070413,0,7,0,512,41,6553554267
6575,91026674,1518,91028192,0,8,1,1536,27,10094679061
6576,91053621,43904,91097525,0,7,0,512,41,7172919843
6577,91060807,112147,91172954,0,2,0,58880,8,3056689925
6578,91101412,3128,91104540,0,4,1,9216,21,8916946957
6579,91104645,104156,91208801,0,9,0,41984,20,889612277
6580,91112318,226235,91338553,0,2,0,69632,8,8007625999
6581,91129613,15837,91145450,0,4,1,30720,21,6123537516
6582,91132407,87743,91220150,0,4,0,11776,21,1566634756
6583,91134225,95936,91230161,0,2,0,25088,8,1782430957
6584,91151737,165577,91317314,0,2,0,71680,8,1371342522
6585,91151863,47288,91199151,0,7,0,1536,41,10683298248
6586,91153693,3645,91157338,0,8,1,10240,27,484854128
6587,91168651,5454,91174105,0,9,1,13824,20,1678520936
6588,91184537,5454,91189991,0,8,1,13824,27,9566434568
6589,91193365,3898,91197263,0,8,1,4096,27,8955221539
6590,91233956,105860,91339816,0,2,0,4096,8,8269626914
6591,91251058,101504,91352562,0,5,0,33280,46,4975330705
6592,91251452,91460,91342912,0,4,0,20480,21,4294063858
6593,91260846,3422,91264268,0,8,1,3584,27,4030176995
6594,91273486,43904,91317390,0,7,0,512,41,10689687874
6595,91287268,113875,91401143,0,2,0,73728,8,5976424987
6596,91296074,161068,91457142,0,2,0,29696,8,10151527478
6597,91301795,45596,91347391,0,7,0,1024,41,8816530810
6598,91323153,3904,91327057,0,4,1,10752,21,516975356
6599,91340293,50984,91391277,0,5,0,3584,46,7453489656
6600,91346513,2946,91349459,0,6,1,3072,42,8641673491
6601,91350474,566,91351040,0,4,1,512,21,9755447536
6602,91359279,43904,91403183,0,7,0,512,41,3680609611
6603,91362884,108368,91471252,0,4,0,55808,21,7599683379
6604,91366414,43904,91410318,0,7,0,512,41,10283375846
6605,91404974,3422,91408396,0,4,1,3584,21,6775863989
6606,91451515,1042,91452557,0,4,1,1024,21,8836308756
6607,91455272,113662,91568934,0,2,0,67072,8,543526428
6608,91474261,4162,91478423,0,9,1,11264,20,2056532611
6609,91478748,7706,91486454,0,6,1,8192,42,7777762491
6610,91513712,106468,91620180,0,2,0,47616,8,92641243
6611,91517322,43904,91561226,0,7,0,512,41,945449917
6612,91518174,4850,91523024,0,8,1,5120,27,4160476114
6613,91525559,566,91526125,0,9,1,512,20,5489802704
6614,91544051,155135,91699186,0,2,0,80896,8,8098605267
6615,91550421,12737,91563158,0,5,1,24576,46,309137854
6616,91559232,2470,91561702,0,8,1,2560,27,8321599436
6617,91569326,1042,91570368,0,9,1,1024,20,7492764430
6618,91574401,1994,91576395,0,5,1,2048,46,8033502514
6619,91608507,3128,91611635,0,5,1,9216,46,9305254765
6620,91608895,13083,91621978,0,3,1,22016,4,5769905674
6621,91623829,3128,91626957,0,5,1,9216,46,3648316048
6622,91625250,3422,91628672,0,9,1,3584,20,3606648983
6623,91646533,5326,91651859,0,6,1,5632,42,3526146816
6624,91650452,112736,91763188,0,4,0,70144,21,2973866311
6625,91660004,1042,91661046,0,9,1,1024,20,1507119327
6626,91663682,139508,91803190,0,4,0,44032,21,5793137921
6627,91665532,244994,91910526,0,5,0,33792,46,8807346654
6628,91666054,10241,91676295,0,3,1,16384,4,8229407095
6629,91666472,104468,91770940,0,9,0,43008,20,9593118451
6630,91702808,1518,91704326,0,6,1,1536,42,9620182650
6631,91717558,113360,91830918,0,5,0,72192,46,5166234183
6632,91720021,4374,91724395,0,9,1,4608,20,72295327
6633,91721873,89903,91811776,0,4,0,512,21,1479158879
6634,91727534,3898,91731432,0,4,1,4096,21,9146849365
6635,91738332,6754,91745086,0,5,1,7168,46,8997312461
6636,91752601,6278,91758879,0,8,1,6656,27,1734868882
6637,91771256,6278,91777534,0,8,1,6656,27,1551833135
6638,91782269,43904,91826173,0,7,0,512,41,10669035627
6639,91807045,23888,91830933,0,5,1,17408,46,2817990845
6640,91821493,62516,91884009,0,2,0,6144,8,2772121223
6641,91874320,36221,91910541,0,5,1,59392,46,4854659941
6642,91881695,3387,91885082,0,8,1,9728,27,4163418958
6643,91890422,3128,91893550,0,6,1,9216,42,8422666366
6644,91896612,98852,91995464,0,2,0,24576,8,43459040
6645,91902155,6278,91908433,0,9,1,6656,20,3794370473
6646,91913116,55045,91968161,0,5,1,93696,46,7646922042
6647,91915789,7706,91923495,0,8,1,8192,27,297228907
6648,91932520,13512,91946032,0,9,1,26112,20,6764463964
6649,91946395,100256,92046651,0,4,0,29184,21,1254473304
6650,91952862,4420,91957282,0,8,1,11776,27,3557740050
6651,91956080,2946,91959026,0,9,1,3072,20,8227998936
6652,91959663,11791,91971454,0,4,1,19456,21,4566625024
6653,91960476,7706,91968182,0,9,1,8192,20,5426794973
6654,91983443,76318,92059761,0,4,0,512,21,7963860081
6655,91991835,132761,92124596,0,4,0,64512,21,1158341308
6656,91992250,6278,91998528,0,3,1,6656,4,10341107728
6657,92010390,4374,92014764,0,6,1,4608,42,1223585657
6658,92013363,117332,92130695,0,4,0,19968,21,457549871
6659,92014714,60824,92075538,0,5,0,5632,46,427837937
6660,92049334,3898,92053232,0,9,1,4096,20,2318716421
6661,92054925,1518,92056443,0,6,1,1536,42,3750608297
6662,92055543,166076,92221619,0,2,0,144384,8,5509320888
6663,92077620,95545,92173165,0,5,1,159232,46,5694918099
6664,92079096,3422,92082518,0,6,1,3584,42,3882943223
6665,92079672,48980,92128652,0,7,0,2048,41,4621952794
6666,92082974,6754,92089728,0,9,1,7168,20,4230146728
6667,92096379,2470,92098849,0,8,1,2560,27,9937172189
6668,92122861,7230,92130091,0,9,1,7680,20,8343381672
6669,92124427,214575,92339002,0,9,0,22016,20,9209758348
6670,92125574,3898,92129472,0,6,1,4096,42,3779293797
6671,92134342,3128,92137470,0,9,1,9216,20,2010205374
6672,92134401,1518,92135919,0,3,1,1536,4,9494060581
6673,92136818,566,92137384,0,8,1,512,27,5062941529
6674,92138923,82820,92221743,0,4,0,12288,21,4034311620
6675,92140323,1994,92142317,0,3,1,2048,4,2095823605
6676,92167422,45596,92213018,0,4,0,1024,21,4119366324
6677,92171613,22174,92193787,0,5,1,36352,46,3208552200
6678,92187568,1994,92189562,0,6,1,2048,42,6362162865
6679,92191367,6278,92197645,0,8,1,6656,27,3280913058
6680,92193488,1042,92194530,0,4,1,1024,21,1744536281
6681,92213020,3128,92216148,0,6,1,9216,42,3748399024
6682,92213368,5326,92218694,0,5,1,5632,46,4982319954
6683,92217523,2870,92220393,0,9,1,8704,20,5839955107
6684,92226180,2946,92229126,0,9,1,3072,20,349759645
6685,92229212,1042,92230254,0,6,1,1024,42,7330978747
6686,92236222,1042,92237264,0,3,1,1024,4,9777122830
6687,92246857,186255,92433112,0,9,0,102912,20,4591251472
6688,92255589,1042,92256631,0,8,1,1024,27,5246605696
6689,92271612,566,92272178,0,9,1,512,20,9569570910
6690,92275665,7706,92283371,0,8,1,8192,27,7885242818
6691,92287545,63450,92350995,0,4,1,103424,21,9466188205
6692,92289844,43904,92333748,0,7,0,512,41,6010480075
6693,92300768,566,92301334,0,6,1,512,42,5102654792
6694,92313827,63397,92377224,0,4,1,84480,21,9114088139
6695,92325887,123382,92449269,0,5,0,12800,46,3342277391
6696,92330995,566,92331561,0,6,1,512,42,9086525762
6697,92359928,3898,92363826,0,8,1,4096,27,2430110554
6698,92363379,24470,92387849,0,4,1,34304,21,747768903
6699,92369270,4374,92373644,0,8,1,4608,27,8002960096
6700,92387648,105404,92493052,0,5,0,46080,46,9927164819
6701,92396820,3422,92400242,0,9,1,3584,20,2084516957
6702,92401757,95756,92497513,0,2,0,19456,8,7158762422
6703,92403532,105852,92509384,0,2,0,38912,8,10381272104
6704,92419109,4937,92424046,0,8,1,12800,27,3338624963
6705,92424995,6754,92431749,0,3,1,7168,4,207391079
6706,92447366,216925,92664291,0,2,0,12800,8,4722803032
6707,92449167,138123,92587290,0,2,0,75264,8,3758714839
6708,92453785,5196,92458981,0,9,1,13312,20,3119768428
6709,92468313,4937,92473250,0,4,1,12800,21,9797215136
6710,92470490,2946,92473436,0,6,1,3072,42,2798576704
6711,92480543,1518,92482061,0,6,1,1536,42,6613463046
6712,92482702,127135,92609837,0,2,0,65024,8,244138356
6713,92483211,5196,92488407,0,9,1,13312,20,2799322299
6714,92486444,4374,92490818,0,3,1,4608,4,5837352334
6715,92486988,4850,92491838,0,6,1,5120,42,4278555499
6716,92490301,566,92490867,0,9,1,512,20,5298220782
6717,92490509,655,92491164,0,3,1,512,4,5958882062
6718,92504639,1994,92506633,0,9,1,2048,20,6651321115
6719,92512010,148366,92660376,0,2,0,55296,8,4990192483
6720,92517685,138325,92656010,0,9,0,70144,20,8323040261
6721,92569107,566,92569673,0,6,1,512,42,4101727877
6722,92583018,50828,92633846,0,7,0,3072,41,5916020121
6723,92591920,1518,92593438,0,8,1,1536,27,4883721689
6724,92593925,3898,92597823,0,3,1,4096,4,9706424835
6725,92594108,54660,92648768,0,7,0,512,41,3866385063
6726,92606890,2946,92609836,0,8,1,3072,27,8232911924
6727,92626551,133557,92760108,0,2,0,82944,8,8486472854
6728,92648252,14504,92662756,0,9,1,7168,20,2014856350
6729,92653551,3898,92657449,0,8,1,4096,27,10151219627
6730,92667002,102752,92769754,0,5,0,37376,46,4452154551
6731,92669852,45596,92715448,0,7,0,1024,41,9152962275
6732,92694073,1518,92695591,0,3,1,1536,4,3750902156
6733,92705450,123754,92829204,0,2,0,30208,8,3661873866
6734,92714548,6488,92721036,0,8,1,15872,27,1064254669
6735,92715686,129302,92844988,0,5,0,56320,46,581075085
6736,92716496,4886,92721382,0,8,1,512,27,7706985642
6737,92717423,71156,92788579,0,4,0,14336,21,6129180685
6738,92731419,70532,92801951,0,9,0,12288,20,2814339887
6739,92749022,2470,92751492,0,3,1,2560,4,3535642114
6740,92766259,95312,92861571,0,2,0,23040,8,472243505
6741,92767490,3387,92770877,0,8,1,9728,27,3800083273
6742,92782387,1518,92783905,0,8,1,1536,27,1117301009
6743,92784129,3387,92787516,0,3,1,9728,4,6401965566
6744,92786181,5802,92791983,0,8,1,6144,27,6324266675
6745,92793118,85249,92878367,0,9,0,13824,20,7273459207
6746,92798709,1994,92800703,0,3,1,2048,4,8812507009
6747,92805142,5802,92810944,0,6,1,6144,42,3549959280
6748,92836006,3422,92839428,0,6,1,3584,42,3651993971
6749,92874099,1994,92876093,0,2,1,2048,8,1700454620
6750,92880005,6278,92886283,0,2,1,6656,8,10451480219
6751,92886902,45596,92932498,0,7,0,1024,41,5510932046
6752,92895823,1518,92897341,0,3,1,1536,4,544679852
6753,92909031,1994,92911025,0,8,1,2048,27,5598189510
6754,92918572,5454,92924026,0,6,1,13824,42,6994107602
6755,92925117,43904,92969021,0,7,0,512,41,5954010238
6756,92940912,566,92941478,0,9,1,512,20,4970107931
6757,92947811,2470,92950281,0,6,1,2560,42,1155412823
6758,92949761,1042,92950803,0,2,1,1024,8,8995232873
6759,92979929,109460,93089389,0,2,0,59392,8,2793408544
6760,92993049,110708,93103757,0,9,0,63488,20,4298619330
6761,93025993,43904,93069897,0,7,0,512,41,4063251471
6762,93026658,3904,93030562,0,9,1,10752,20,4479298132
6763,93041457,1994,93043451,0,9,1,2048,20,3908964480
6764,93045753,6754,93052507,0,2,1,7168,8,1317422673
6765,93055158,4374,93059532,0,6,1,4608,42,3843626038
6766,93058572,2470,93061042,0,9,1,2560,20,9755164635
6767,93083654,102440,93186094,0,4,0,36352,21,4857428326
6768,93102303,3422,93105725,0,6,1,3584,42,3841894580
6769,93131017,11016,93142033,0,6,1,17920,42,6381554672
6770,93131576,98852,93230428,0,2,0,24576,8,2047037621
6771,93135998,135002,93271000,0,4,0,87040,21,4428056081
6772,93143033,10241,93153274,0,9,1,16384,20,6202336021
6773,93156847,12737,93169584,0,2,1,24576,8,1963299660
6774,93158695,15715,93174410,0,2,1,7680,8,3523047168
6775,93158719,13083,93171802,0,4,1,22016,21,5966932329
6776,93162800,144110,93306910,0,2,0,47616,8,2919563400
6777,93168926,179834,93348760,0,2,0,22528,8,8449675171
6778,93172401,4915,93177316,0,2,1,4608,8,4958282592
6779,93226462,1518,93227980,0,3,1,1536,4,2033735813
6780,93236902,98228,93335130,0,9,0,22528,20,2207871193
6781,93241975,3387,93245362,0,9,1,9728,20,10422176829
6782,93253479,2946,93256425,0,8,1,3072,27,5296553426
6783,93262446,1518,93263964,0,9,1,1536,20,9088396715
6784,93263284,13679,93276963,0,4,1,14848,21,10024912157
6785,93276571,145452,93422023,0,4,0,14336,21,3704510613
6786,93279534,135213,93414747,0,2,0,36864,8,990197582
6787,93280634,54787,93335421,0,4,1,93184,21,10540680671
6788,93292999,169236,93462235,0,4,0,40448,21,9273675316
6789,93294896,1994,93296890,0,8,1,2048,27,7593170745
6790,93307835,94688,93402523,0,5,0,20992,46,2301694305
6791,93353170,69284,93422454,0,5,0,8192,46,5585601415
6792,93362041,1994,93364035,0,2,1,2048,8,1763403712
6793,93374922,13600,93388522,0,2,1,23040,8,8223309990
6794,93375473,1994,93377467,0,8,1,2048,27,1619735559
6795,93384051,116673,93500724,0,5,0,52224,46,1687670583
6796,93404306,16235,93420541,0,2,1,6144,8,10351136744
6797,93412596,43904,93456500,0,7,0,512,41,9194625474
6798,93420894,5326,93426220,0,3,1,5632,4,10432428152
6799,93422437,91289,93513726,0,5,0,14848,46,9071740415
6800,93433842,1042,93434884,0,8,1,1024,27,10349010335
6801,93443105,312729,93755834,0,2,0,148992,8,6134459120
6802,93455281,1042,93456323,0,2,1,1024,8,1572919093
6803,93457914,1042,93458956,0,3,1,1024,4,1287887121
6804,93462224,82220,93544444,0,9,0,15360,20,8704724597
6805,93466771,6754,93473525,0,8,1,7168,27,7302462249
6806,93468774,4374,93473148,0,2,1,4608,8,9500032841
6807,93480602,130516,93611118,0,5,0,34816,46,10209163969
6808,93492126,90860,93582986,0,4,0,23552,21,3796154852
6809,93515820,189939,93705759,0,2,0,48128,8,9511736024
6810,93518958,1042,93520000,0,2,1,1024,8,7189571943
6811,93543223,3422,93546645,0,3,1,3584,4,7615746265
6812,93576835,1042,93577877,0,8,1,1024,27,9632865454
6813,93601757,5971,93607728,0,2,1,14848,8,10472976860
6814,93606674,14545,93621219,0,4,1,28160,21,5857631826
6815,93618622,114452,93733074,0,9,0,75776,20,274341684
6816,93629111,57440,93686551,0,5,0,4608,46,8836896477
6817,93631733,15321,93647054,0,4,1,29696,21,291219892
6818,93640973,566,93641539,0,6,1,512,42,5420313474
6819,93642313,1518,93643831,0,2,1,1536,8,6191398635
6820,93658544,3422,93661966,0,3,1,3584,4,8173110786
6821,93715780,150779,93866559,0,2,0,63488,8,9710333685
6822,93717937,3422,93721359,0,3,1,3584,4,473802908
6823,93719311,3674,93722985,0,3,1,2560,4,2428672100
6824,93749853,177095,93926948,0,2,0,33792,8,6564669921
6825,93775704,55748,93831452,0,5,0,4096,46,423083318
6826,93785428,68060,93853488,0,9,0,9216,20,2099417372
6827,93825156,101036,93926192,0,4,0,31744,21,7964757237
6828,93840437,100568,93941005,0,9,0,30208,20,9601387788
6829,93843797,103463,93947260,0,9,0,20480,20,46305176
6830,93849211,104936,93954147,0,4,0,44544,21,5461431415
6831,93890100,2870,93892970,0,3,1,8704,4,4478577323
6832,93895134,2946,93898080,0,3,1,3072,4,9675511152
6833,93913647,75852,93989499,0,4,0,2048,21,4553049387
6834,93945156,81308,94026464,0,2,0,17408,8,9984043238
6835,93950931,43904,93994835,0,7,0,512,41,1097639395
6836,93952972,6278,93959250,0,3,1,6656,4,5970647682
6837,93956437,3799,93960236,0,3,1,1536,4,3533600242
6838,93968887,107432,94076319,0,5,0,52736,46,7115536686
6839,93975714,140889,94116603,0,2,0,19968,8,4393510929
6840,93986899,113048,94099947,0,2,0,71168,8,322043173
6841,93994187,1994,93996181,0,3,1,2048,4,8646052048
6842,94023870,136532,94160402,0,9,0,133120,20,1356495069
6843,94062995,43904,94106899,0,7,0,512,41,3230666975
6844,94066657,117517,94184174,0,9,0,12288,20,6851874222
6845,94089612,122595,94212207,0,2,0,68608,8,7733045537
6846,94094560,100412,94194972,0,5,0,29696,46,5892881243
6847,94108863,105551,94214414,0,2,0,7168,8,7362892202
6848,94115380,170270,94285650,0,5,0,99328,46,6925350748
6849,94120216,138430,94258646,0,9,0,27648,20,10581990596
6850,94121235,185055,94306290,0,5,0,46080,46,1544851823
6851,94145500,45596,94191096,0,7,0,1024,41,6391961038
6852,94184537,104936,94289473,0,9,0,44544,20,9315100953
6853,94192700,139879,94332579,0,2,0,95232,8,5414371593
6854,94248348,5802,94254150,0,7,1,6144,41,5778201397
6855,94255555,97292,94352847,0,4,0,19456,21,8276302967
6856,94272432,45596,94318028,0,7,0,1024,41,5621691875
6857,94285488,124278,94409766,0,5,0,107520,46,3830282189
6858,94294588,103844,94398432,0,9,0,40960,20,3201834540
6859,94310786,3645,94314431,0,6,1,10240,42,6475372358
6860,94354084,4850,94358934,0,3,1,5120,4,1810553249
6861,94421017,6754,94427771,0,6,1,7168,42,3399839539
6862,94430965,3128,94434093,0,3,1,9216,4,8637984899
6863,94435654,43904,94479558,0,7,0,512,41,8835062167
6864,94446891,102752,94549643,0,4,0,37376,21,1010579165
6865,94447568,47288,94494856,0,7,0,1536,41,7069189878
6866,94449952,236839,94686791,0,4,0,164864,21,6561926093
6867,94455631,101972,94557603,0,2,0,34816,8,8365632164
6868,94504264,45596,94549860,0,7,0,1024,41,8501047652
6869,94549202,151644,94700846,0,4,0,46080,21,8467135570
6870,94574456,7706,94582162,0,3,1,8192,4,1844556226
6871,94586516,4679,94591195,0,6,1,12288,42,10016450965
6872,94587870,136376,94724246,0,5,0,132608,46,4082053833
6873,94603496,43904,94647400,0,7,0,512,41,6378692304
6874,94622317,2470,94624787,0,6,1,2560,42,10058697930
6875,94623191,102638,94725829,0,5,0,5120,46,5962446729
6876,94652843,55748,94708591,0,9,0,4096,20,769691319
6877,94658628,146210,94804838,0,4,0,41472,21,8140033510
6878,94668304,103532,94771836,0,9,0,39936,20,10251044046
6879,94683830,151584,94835414,0,5,0,65024,46,726718384
6880,94693730,121348,94815078,0,9,0,49664,20,8672441724
6881,94699275,4420,94703695,0,3,1,11776,4,4357862589
6882,94702089,47288,94749377,0,7,0,1536,41,3973862874
6883,94719274,74360,94793634,0,9,0,9728,20,791856228
6884,94726902,122650,94849552,0,9,0,13824,20,9248351395
6885,94748973,90200,94839173,0,5,0,12288,46,9263936819
6886,94751872,136814,94888686,0,9,0,22016,20,10088211537
6887,94760740,2946,94763686,0,3,1,3072,4,5970159766
6888,94761178,100880,94862058,0,2,0,31232,8,4183782662
6889,94763179,141122,94904301,0,9,0,51200,20,7106882224
6890,94810904,96376,94907280,0,9,0,9728,20,2052371227
6891,94815310,566,94815876,0,3,1,512,4,1761150524
6892,94827780,4420,94832200,0,6,1,11776,42,7070490561
6893,94884655,57440,94942095,0,5,0,4608,46,6611032709
6894,94890882,7706,94898588,0,2,1,8192,8,9779192974
6895,94921761,5326,94927087,0,3,1,5632,4,3700647220
6896,94936891,5326,94942217,0,6,1,5632,42,2453712990
6897,94954233,69284,95023517,0,5,0,8192,46,589488171
6898,94955256,112424,95067680,0,9,0,69120,20,9463064616
6899,94982524,4162,94986686,0,2,1,11264,8,9308190742
6900,94983794,232979,95216773,0,2,0,47616,8,53936110
6901,95011600,59132,95070732,0,4,0,5120,21,9858237726
6902,95027235,5802,95033037,0,3,1,6144,4,7298628929
6903,95027270,121451,95148721,0,2,0,35328,8,6836767092
6904,95032663,87764,95120427,0,2,0,18432,8,4026727700
6905,95032763,3898,95036661,0,2,1,4096,8,1341290726
6906,95051139,5326,95056465,0,6,1,5632,42,1792595118
6907,95055770,149629,95205399,0,4,0,11264,21,3342070591
6908,95062109,84536,95146645,0,5,0,17920,46,7087153842
6909,95062312,1042,95063354,0,3,1,1024,4,3324944196
6910,95069085,132867,95201952,0,4,0,131072,21,4499333323
6911,95076008,43904,95119912,0,7,0,512,41,9417356698
6912,95084363,2470,95086833,0,2,1,2560,8,5557808905
6913,95086742,566,95087308,0,3,1,512,4,3344447825
6914,95090643,4679,95095322,0,3,1,12288,4,1583234482
6915,95110986,566,95111552,0,2,1,512,8,9226784195
6916,95126811,5326,95132137,0,2,1,5632,8,3042406215
6917,95142114,10021,95152135,0,2,1,3584,8,10025197984
6918,95150102,82180,95232282,0,4,0,7680,21,4233979193
6919,95161122,105716,95266838,0,9,0,47104,20,5397238828
6920,95181222,102440,95283662,0,5,0,36352,46,1460443644
6921,95195314,6278,95201592,0,3,1,6656,4,7347240954
6922,95210830,89711,95300541,0,9,0,9216,20,9423942768
6923,95222619,1518,95224137,0,6,1,1536,42,4977121619
6924,95226634,71756,95298390,0,2,0,11264,8,10194073610
6925,95227387,1994,95229381,0,9,1,2048,20,4938529141
6926,95227879,87788,95315667,0,4,0,23552,21,8717691879
6927,95234451,49292,95283743,0,2,0,3072,8,1864361086
6928,95250632,48980,95299612,0,7,0,2048,41,3959360855
6929,95256265,566,95256831,0,3,1,512,4,10398937598
6930,95286557,60824,95347381,0,2,0,5632,8,2129562499
6931,95293304,113369,95406673,0,2,0,38912,8,6137810014
6932,95297365,45908,95343273,0,5,0,2048,46,5965506524
6933,95315356,173259,95488615,0,2,0,79872,8,10109924670
6934,95329248,566,95329814,0,9,1,512,20,5286114371
6935,95351493,1994,95353487,0,9,1,2048,20,6662545160
6936,95369351,566,95369917,0,6,1,512,42,7634377683
6937,95383023,61292,95444315,0,9,0,7168,20,1393431453
6938,95401792,5439,95407231,0,2,1,512,8,1389963035
6939,95444282,1518,95445800,0,2,1,1536,8,594724408
6940,95454746,101972,95556718,0,4,0,34816,21,7910605059
6941,95479193,15216,95494409,0,2,1,6144,8,6583589978
6942,95483368,50783,95534151,0,7,0,512,41,9936307697
6943,95490247,52364,95542611,0,7,0,3072,41,1894726170
6944,95494288,2946,95497234,0,3,1,3072,4,7991469182
6945,95502625,98852,95601477,0,9,0,24576,20,120369942
6946,95503607,1042,95504649,0,2,1,1024,8,974696242
6947,95520954,4374,95525328,0,3,1,4608,4,3470543638
6948,95524456,4937,95529393,0,3,1,12800,4,8938735117
6949,95533495,161262,95694757,0,2,0,55808,8,10661450810
6950,95537829,566,95538395,0,3,1,512,4,9965812097
6951,95537896,3560,95541456,0,3,1,3584,4,9723080513
6952,95539320,5362,95544682,0,3,1,5120,4,8714974896
6953,95544073,43975,95588048,0,5,1,72192,46,1586739958
6954,95577669,4679,95582348,0,3,1,12288,4,6409101525
6955,95577936,6278,95584214,0,1,1,6656,36,9765419867
6956,95620242,104817,95725059,0,2,0,29184,8,10388597072
6957,95621641,114041,95735682,0,2,0,34816,8,1806380943
6958,95623235,2870,95626105,0,3,1,8704,4,1758922027
6959,95626609,13253,95639862,0,3,1,25600,4,4839062213
6960,95635572,102900,95738472,0,5,0,31744,46,5429906489
6961,95681745,1994,95683739,0,3,1,2048,4,5569602297
6962,95692568,1042,95693610,0,1,1,1024,36,3115369780
6963,95707262,566,95707828,0,3,1,512,4,512396080
6964,95714194,89900,95804094,0,9,0,15360,20,8897246368
6965,95733718,62516,95796234,0,4,0,6144,21,5973094570
6966,95742370,43904,95786274,0,5,0,512,46,1940488105
6967,95751702,116012,95867714,0,9,0,80896,20,7384232890
6968,95758897,59132,95818029,0,9,0,5120,20,10063500124
6969,95767400,143070,95910470,0,9,0,59904,20,3079305202
6970,95779992,47288,95827280,0,7,0,1536,41,1479615636
6971,95783438,4374,95787812,0,2,1,4608,8,2350525481
6972,95835593,100256,95935849,0,2,0,29184,8,5040803949
6973,95837561,566,95838127,0,6,1,512,42,4676671839
6974,95849718,4162,95853880,0,2,1,11264,8,4553581308
6975,95895751,3898,95899649,0,2,1,4096,8,8320338326
6976,95901830,5326,95907156,0,3,1,5632,4,9010774210
6977,95914440,6278,95920718,0,8,1,6656,27,4355090935
6978,95925832,43904,95969736,0,2,0,512,8,3635950342
6979,95932139,125798,96057937,0,2,0,100864,8,7111590204
6980,95949468,1994,95951462,0,2,1,2048,8,491512481
6981,95957271,1518,95958789,0,3,1,1536,4,4903563351
6982,95985317,59132,96044449,0,4,0,5120,21,9025269997
6983,96002612,2470,96005082,0,2,1,2560,8,3507394687
6984,96051888,4850,96056738,0,3,1,5120,4,5701445006
6985,96052571,6433,96059004,0,3,1,3584,4,8853781563
6986,96071448,43904,96115352,0,7,0,512,41,5345639512
6987,96074664,1518,96076182,0,1,1,1536,36,8236203935
6988,96078333,141375,96219708,0,2,0,54272,8,5898431624
6989,96126256,111800,96238056,0,4,0,67072,21,8550594434
6990,96175773,128841,96304614,0,2,0,104960,8,6419875386
6991,96178240,144289,96322529,0,2,0,20480,8,3561939800
6992,96182079,162573,96344652,0,4,0,117248,21,4010003120
6993,96214512,99320,96313832,0,5,0,26112,46,9719716875
6994,96225841,264867,96490708,0,2,0,30208,8,7668412014
6995,96244233,5326,96249559,0,1,1,5632,36,8170996728
6996,96257798,5326,96263124,0,1,1,5632,36,178977201
6997,96259465,3898,96263363,0,2,1,4096,8,8887794073
6998,96267134,566,96267700,0,2,1,512,8,675233744
6999,96267982,43904,96311886,0,7,0,512,41,1599074803
7000,96268157,3128,96271285,0,2,1,9216,8,398499676
7001,96280942,5802,96286744,0,6,1,6144,42,1709267073
7002,96289005,2946,96291951,0,3,1,3072,4,3129320512
7003,96298958,7642,96306600,0,2,1,2048,8,10067979175
7004,96313671,21141,96334812,0,6,1,34304,42,3401167271
7005,96316590,1042,96317632,0,9,1,1024,20,3310393536
7006,96318745,86360,96405105,0,5,0,13824,46,4293342429
7007,96321599,4850,96326449,0,1,1,5120,36,538410455
7008,96338736,68880,96407616,0,5,0,8192,46,6566255183
7009,96348633,11274,96359907,0,6,1,18432,42,6213197635
7010,96355412,566,96355978,0,2,1,512,8,3738402632
7011,96375065,4420,96379485,0,3,1,11776,4,6957457584
7012,96376919,1994,96378913,0,6,1,2048,42,8280309836
7013,96386731,13858,96400589,0,6,1,23552,42,4031782552
7014,96394103,6278,96400381,0,2,1,6656,8,9004460550
7015,96435508,71756,96507264,0,5,0,11264,46,8015736727
7016,96438127,122199,96560326,0,2,0,30720,8,1428592207
7017,96445786,4850,96450636,0,9,1,5120,20,6868425822
7018,96451210,2946,96454156,0,2,1,3072,8,2092906911
7019,96488178,4516,96492694,0,2,1,2048,8,7282942228
7020,96488307,48980,96537287,0,7,0,2048,41,6294621208
7021,96501548,5802,96507350,0,6,1,6144,42,9687150075
7022,96566441,2946,96569387,0,3,1,3072,4,5037599253
7023,96568940,43904,96612844,0,7,0,512,41,4588524806
7024,96582203,5802,96588005,0,6,1,6144,42,5702110724
7025,96605021,6754,96611775,0,7,1,7168,41,7350872928
7026,96611506,64548,96676054,0,7,0,512,41,4227091557
7027,96614979,59539,96674518,0,7,0,512,41,3460130421
7028,96645328,4374,96649702,0,2,1,4608,8,8085243348
7029,96648314,2870,96651184,0,7,1,8704,41,7181125487
7030,96651313,11274,96662587,0,2,1,18432,8,2501373661
7031,96653275,1042,96654317,0,7,1,1024,41,2133797488
7032,96691730,3387,96695117,0,6,1,9728,42,2113105091
7033,96715905,13858,96729763,0,3,1,23552,4,6711812114
7034,96762396,6754,96769150,0,6,1,7168,42,3503824817
7035,96782600,21399,96803999,0,6,1,34816,42,578910927
7036,96785551,13512,96799063,0,3,1,26112,4,9863963980
7037,96793007,14149,96807156,0,3,1,23040,4,5745394713
7038,96797756,45596,96843352,0,7,0,1024,41,10322583186
7039,96803767,96716,96900483,0,4,0,27648,21,6671075071
7040,96808308,3422,96811730,0,2,1,3584,8,9535961902
7041,96808667,179221,96987888,0,2,0,38912,8,6116153576
7042,96810304,6278,96816582,0,2,1,6656,8,8820429431
7043,96821045,6754,96827799,0,3,1,7168,4,7116847193
7044,96823036,1518,96824554,0,6,1,1536,42,8638270493
7045,96846362,1994,96848356,0,3,1,2048,4,6287253560
7046,96857536,11016,96868552,0,6,1,17920,42,7355616751
7047,96858034,43904,96901938,0,7,0,512,41,10599912194
7048,96898641,45596,96944237,0,7,0,1024,41,7587698752
7049,96909337,52364,96961701,0,4,0,3072,21,4092065869
7050,96924103,566,96924669,0,3,1,512,4,521635947
7051,96958087,2470,96960557,0,3,1,2560,4,2751197475
7052,96963313,99788,97063101,0,2,0,27648,8,152109422
7053,96965276,114920,97080196,0,4,0,77312,21,1188502214
7054,96980463,86712,97067175,0,6,1,145408,42,10318805483
7055,96992413,116553,97108966,0,4,0,14336,21,2133881162
7056,96997847,4374,97002221,0,2,1,4608,8,10585057705
7057,97031767,110240,97142007,0,5,0,61952,46,4596523417
7058,97042565,1994,97044559,0,1,1,2048,36,9480958055
7059,97045948,100568,97146516,0,2,0,30208,8,3084710952
7060,97087105,4374,97091479,0,2,1,4608,8,4457745296
7061,97145957,6754,97152711,0,3,1,7168,4,732475788
7062,97146122,1428,97147550,0,2,1,1024,8,1927800980
7063,97186787,2946,97189733,0,3,1,3072,4,525489836
7064,97200031,3645,97203676,0,2,1,10240,8,2251272766
7065,97202910,6229,97209139,0,3,1,15360,4,1911515564
7066,97204169,43904,97248073,0,7,0,512,41,7272482320
7067,97218532,63708,97282240,0,6,1,103936,42,10553442133
7068,97219888,43904,97263792,0,7,0,512,41,3728258487
7069,97241147,4374,97245521,0,3,1,4608,4,6844815031
7070,97250255,104000,97354255,0,2,0,41472,8,673432130
7071,97307868,1994,97309862,0,3,1,2048,4,5833603957
7072,97313958,43112,97357070,0,6,1,73728,42,7706587632
7073,97319604,43904,97363508,0,7,0,512,41,7718898667
7074,97323431,110396,97433827,0,4,0,62464,21,1989717488
7075,97345942,43904,97389846,0,7,0,512,41,9624145459
7076,97369601,1042,97370643,0,3,1,1024,4,10222285272
7077,97372808,57440,97430248,0,5,0,4608,46,1929028104
7078,97403947,566,97404513,0,2,1,512,8,10005603071
7079,97411871,57440,97469311,0,2,0,4608,8,6407564842
7080,97413313,43904,97457217,0,7,0,512,41,10168645254
7081,97422951,4850,97427801,0,3,1,5120,4,9550329294
7082,97423935,5812,97429747,0,3,1,3072,4,184694917
7083,97432202,566,97432768,0,6,1,512,42,7348701338
7084,97450877,566,97451443,0,2,1,512,8,9252963383
7085,97465605,199601,97665206,0,2,0,68608,8,6062317242
7086,97468419,1926,97470345,0,2,1,1024,8,7385951028
7087,97477242,164609,97641851,0,2,0,45568,8,5686977974
7088,97509917,99320,97609237,0,4,0,26112,21,2445805612
7089,97525799,43904,97569703,0,5,0,512,46,4132100273
7090,97542999,5326,97548325,0,3,1,5632,4,4529683326
7091,97556363,59994,97616357,0,2,0,6144,8,7888286579
7092,97574493,64208,97638701,0,4,0,6656,21,6844824523
7093,97588131,566,97588697,0,2,1,512,8,6061736833
7094,97591254,3898,97595152,0,2,1,4096,8,2039771210
7095,97598786,2470,97601256,0,3,1,2560,4,8762911017
7096,97615242,4850,97620092,0,3,1,5120,4,2213855780
7097,97617742,110923,97728665,0,2,0,33792,8,5464618428
7098,97638752,2470,97641222,0,3,1,2560,4,5396862661
7099,97652347,54056,97706403,0,7,0,3584,41,6626999779
7100,97687762,11016,97698778,0,3,1,17920,4,5151587846
7101,97721313,11242,97732555,0,2,1,4096,8,7371664198
7102,97726426,74360,97800786,0,7,0,9728,41,3481089314
7103,97753679,114608,97868287,0,5,0,76288,46,1935833489
7104,97758748,2470,97761218,0,2,1,2560,8,10145189424
7105,97761124,1518,97762642,0,3,1,1536,4,9145001318
7106,97761989,1994,97763983,0,3,1,2048,4,6726362455
7107,97809586,62672,97872258,0,4,0,6656,21,3771825566
7108,97831899,65900,97897799,0,4,0,7168,21,4691146213
7109,97834259,54056,97888315,0,7,0,3584,41,7115599525
7110,97839660,95468,97935128,0,2,0,23552,8,1437094274
7111,97860642,112417,97973059,0,5,0,44032,46,2939933009
7112,97864456,215113,98079569,0,4,0,209408,21,7930252423
7113,97875646,1994,97877640,0,2,1,2048,8,1680406902
7114,97939824,163745,98103569,0,4,0,38912,21,5971717220
7115,97948704,1042,97949746,0,2,1,1024,8,199429995
7116,97983743,111020,98094763,0,5,0,64512,46,1897559319
7117,98002031,13253,98015284,0,2,1,25600,8,2465212757
7118,98004552,167045,98171597,0,4,0,100864,21,7112270306
7119,98043704,566,98044270,0,3,1,512,4,170950497
7120,98046880,65900,98112780,0,7,0,7168,41,6502003305
7121,98051796,5326,98057122,0,3,1,5632,4,8699440623
7122,98056541,3898,98060439,0,3,1,4096,4,5572844462
7123,98060675,7706,98068381,0,3,1,8192,4,5706466416
7124,98064407,111488,98175895,0,5,0,66048,46,4485444977
7125,98075731,162682,98238413,0,4,0,20480,21,8355962395
7126,98122043,146404,98268447,0,5,0,69632,46,7852449142
7127,98126949,7230,98134179,0,2,1,7680,8,7707501894
7128,98131436,4049,98135485,0,2,1,2048,8,9825025234
7129,98137636,4374,98142010,0,2,1,4608,8,1572223588
7130,98165385,132486,98297871,0,5,0,55296,46,9816957734
7131,98173870,1994,98175864,0,3,1,2048,4,3531454076
7132,98177642,4420,98182062,0,3,1,11776,4,9553174201
7133,98189116,3128,98192244,0,2,1,9216,8,7013183569
7134,98189613,107119,98296732,0,2,0,43520,8,10695961522
7135,98202622,128709,98331331,0,2,0,40448,8,6113389432
7136,98211318,3422,98214740,0,2,1,3584,8,516922803
7137,98212052,3898,98215950,0,7,1,4096,41,4463234899
7138,98233868,70688,98304556,0,5,0,12800,46,5857157582
7139,98247009,51345,98298354,0,5,0,1536,46,8898113547
7140,98254885,259956,98514841,0,2,0,9216,8,9935561564
7141,98255894,566,98256460,0,7,1,512,41,3442707908
7142,98271519,125093,98396612,0,2,0,61952,8,6050402647
7143,98296072,1518,98297590,0,9,1,1536,20,5449683009
7144,98307612,97136,98404748,0,7,0,18944,41,6632290396
7145,98316732,135715,98452447,0,2,0,42496,8,1307473753
7146,98338342,55748,98394090,0,4,0,4096,21,8568843540
7147,98355230,123197,98478427,0,2,0,47104,8,198484500
7148,98356961,566,98357527,0,9,1,512,20,7209542649
7149,98359654,101192,98460846,0,5,0,32256,46,3823058952
7150,98398077,5326,98403403,0,9,1,5632,20,9639004368
7151,98404119,80685,98484804,0,2,0,5632,8,4104478368
7152,98404251,74828,98479079,0,4,0,11264,21,5583155739
7153,98466230,107588,98573818,0,4,0,53248,21,2633987212
7154,98502387,66680,98569067,0,7,0,9728,41,2222211226
7155,98505363,1994,98507357,0,9,1,2048,20,119086597
7156,98514209,125684,98639893,0,5,0,112640,46,2532255555
7157,98528319,147310,98675629,0,5,0,68608,46,2400255380
7158,98545182,132022,98677204,0,5,0,5120,46,7227946370
7159,98570508,3128,98573636,0,6,1,9216,42,1769131655
7160,98585282,91460,98676742,0,2,0,20480,8,1460679044
7161,98598756,91640,98690396,0,7,0,26112,41,4978379814
7162,98644972,566,98645538,0,9,1,512,20,9778430109
7163,98654760,31007,98685767,0,9,1,50176,20,425244007
7164,98663736,26217,98689953,0,9,1,6656,20,9662831889
7165,98678080,14459,98692539,0,9,1,4096,20,2769520722
7166,98683788,12937,98696725,0,9,1,6656,20,10298713488
7167,98730827,6754,98737581,0,9,1,7168,20,8933219493
7168,98731617,6630,98738247,0,9,1,1024,20,6165413776
7169,98745322,1518,98746840,0,7,1,1536,41,2055340586
7170,98762701,10499,98773200,0,7,1,16896,41,9356856954
7171,98774038,75608,98849646,0,7,0,13824,41,2736553463
7172,98781468,3422,98784890,0,7,1,3584,41,2559707224
7173,98799072,3904,98802976,0,7,1,10752,41,4107343209
7174,98803804,1994,98805798,0,9,1,2048,20,6018736610
7175,98835429,11791,98847220,0,5,1,19456,46,8575648887
7176,98861910,184244,99046154,0,7,0,153600,41,9809295630
7177,98879540,120486,99000026,0,5,0,58368,46,9261299059
7178,98929277,5802,98935079,0,7,1,6144,41,10021432292
7179,98930617,61604,98992221,0,4,0,8192,21,6678081144
7180,98964131,88256,99052387,0,2,0,25088,8,3563944454
7181,98996452,1042,98997494,0,7,1,1024,41,1959327226
7182,99024588,27571,99052159,0,7,1,14848,41,8445781161
7183,99033685,19460,99053145,0,7,1,1536,41,3556848630
7184,99037157,18574,99055731,0,7,1,4096,41,2203144757
7185,99119923,97340,99217263,0,5,0,29696,46,6809842207
7186,99141848,5802,99147650,0,3,1,6144,4,1932180171
7187,99153791,4374,99158165,0,7,1,4608,41,5163748159
7188,99228261,1518,99229779,0,7,1,1536,41,3783990564
7189,99291864,101660,99393524,0,7,0,33792,41,9231989191
7190,99295001,103064,99398065,0,5,0,38400,46,6326202832
7191,99317760,3898,99321658,0,7,1,4096,41,9648459483
7192,99330475,1042,99331517,0,7,1,1024,41,9891104985
7193,99371752,99632,99471384,0,5,0,27136,46,2107871192
7194,99387048,86852,99473900,0,4,0,20480,21,10364265250
7195,99432239,41676,99473915,0,4,1,64000,21,7198655026
7196,99452389,65687,99518076,0,4,1,111104,21,588231231
7197,99452571,76130,99528701,0,4,1,34304,21,3607929970
7198,99484885,44072,99528957,0,4,1,9216,21,8789007832
7199,99493039,125000,99618039,0,7,0,74752,41,9802096946
7200,99494009,57440,99551449,0,7,0,4608,41,6783891439
7201,99498276,21658,99519934,0,6,1,35328,42,9882537435
7202,99500461,114608,99615069,0,5,0,76288,46,9924759090
7203,99524209,168301,99692510,0,7,0,95232,41,7962516404
7204,99556962,305970,99862932,0,4,0,70144,21,9740995487
7205,99588450,124628,99713078,0,4,1,205824,21,6413172948
7206,99600361,97106,99697467,0,7,0,11264,41,3820170435
7207,99623599,95380,99718979,0,4,1,19968,21,1210744893
7208,99639065,297205,99936270,0,4,0,77824,21,5161914477
7209,99659797,70216,99730013,0,4,1,36352,21,2198332757
7210,99690400,51262,99741662,0,4,1,39424,21,675675143
7211,99705075,102596,99807671,0,7,0,36864,41,947183130
7212,99749184,63362,99812546,0,4,1,106496,21,10340687534
7213,99756122,140199,99896321,0,7,0,99840,41,65784346
7214,99804524,118508,99923032,0,9,0,89088,20,5863868862
7215,99817299,153944,99971243,0,7,0,117760,41,2018091051
7216,99844586,325779,100170365,0,7,0,220672,41,5760902452
7217,99897774,202696,100100470,0,7,0,51712,41,4645463064
7218,99918238,21453,99939691,0,4,1,9728,21,3181397135
7219,99920983,85006,100005989,0,4,1,113152,21,8698467181
7220,99928240,262966,100191206,0,4,0,31744,21,7667523226
7221,99951181,116186,100067367,0,4,1,152064,21,4968689339
7222,99963782,243915,100207697,0,7,0,43520,41,10722084336
7223,100001198,112112,100113310,0,9,0,68096,20,2907842043
7224,100098475,235534,100334009,0,4,0,50176,21,8703712487
7225,100108897,66921,100175818,0,9,0,6144,20,8511289853
7226,100121121,220391,100341512,0,4,0,24576,21,3046157168
7227,100141439,110240,100251679,0,5,0,61952,46,4656114551
7228,100146036,566,100146602,0,4,1,512,21,6497847539
7229,100146537,104000,100250537,0,9,0,41472,20,7449960817
7230,100157959,193324,100351283,0,4,0,25088,21,6055003962
7231,100174831,78111,100252942,0,5,0,4096,46,1742963939
7232,100200369,66462,100266831,0,4,1,112640,21,9304030034
7233,100213270,103376,100316646,0,7,0,39424,41,8337141108
7234,100217131,60325,100277456,0,4,1,34304,21,9600112626
7235,100218444,110708,100329152,0,9,0,63488,20,2311611856
7236,100235819,47026,100282845,0,4,1,25600,21,332003698
7237,100244462,270612,100515074,0,4,0,76288,21,6773489534
7238,100290950,109460,100400410,0,5,0,59392,46,8129605472
7239,100297613,194202,100491815,0,4,0,40448,21,7519968712
7240,100306008,10499,100316507,0,4,1,16896,21,313295927
7241,100308631,119941,100428572,0,9,0,90112,20,8135389554
7242,100346098,120906,100467004,0,5,0,70144,46,4786646018
7243,100349612,198704,100548316,0,7,0,190976,41,141584390
7244,100393760,102324,100496084,0,9,0,27136,20,7241720064
7245,100395557,181241,100576798,0,4,0,76800,21,1067023335
7246,100396768,189994,100586762,0,9,0,96768,20,2245663340
7247,100424759,170442,100595201,0,9,0,27648,20,3655028392
7248,100431650,25446,100457096,0,4,1,46080,21,3076183333
7249,100435311,200029,100635340,0,4,0,40960,21,527753208
7250,100435589,102082,100537671,0,4,0,6144,21,4186383515
7251,100455437,149143,100604580,0,4,0,1024,21,1543272981
7252,100466277,129319,100595596,0,7,0,71680,41,2283158703
7253,100553638,201741,100755379,0,4,0,105472,21,6209751225
7254,100603304,152098,100755402,0,4,1,243712,21,2473359636
7255,100611120,56060,100667180,0,7,0,5120,41,3704622973
7256,100643174,285004,100928178,0,4,0,112640,21,6949796623
7257,100666680,102128,100768808,0,5,0,35328,46,3028902834
7258,100698866,184822,100883688,0,4,0,33280,21,614279860
7259,100701365,101036,100802401,0,9,0,31744,20,8978165595
7260,100725451,319551,101045002,0,4,0,32768,21,3857554880
7261,100766698,6229,100772927,0,4,1,15360,21,6433937109
7262,100780465,16354,100796819,0,4,1,31744,21,4737026569
7263,100791616,6483,100798099,0,4,1,14336,21,6262517589
7264,100799298,275200,101074498,0,4,0,33792,21,6848041194
7265,100837662,97496,100935158,0,9,0,30208,20,2330301153
7266,100886688,7706,100894394,0,3,1,8192,4,9900361184
7267,100984480,1518,100985998,0,3,1,1536,4,34230523
7268,101018326,113828,101132154,0,5,0,73728,46,3383726874
7269,101023461,73316,101096777,0,4,0,16384,21,5330579853
7270,101025978,188252,101214230,0,9,0,156672,20,4467231995
7271,101047380,2946,101050326,0,8,1,3072,27,8253976888
7272,101058688,7706,101066394,0,2,1,8192,8,814625482
7273,101064028,188620,101252648,0,9,0,54784,20,329203895
7274,101065408,54056,101119464,0,7,0,3584,41,8107844455
7275,101068651,5802,101074453,0,8,1,6144,27,6094782415
7276,101073499,1940,101075439,0,8,1,1536,27,4385832711
7277,101126807,94911,101221718,0,9,0,2560,20,8606651841
7278,101152355,125139,101277494,0,9,0,39424,20,8881758486
7279,101188658,131592,101320250,0,9,0,48128,20,4671481505
7280,101191147,73160,101264307,0,4,0,15872,21,7324240268
7281,101268295,101504,101369799,0,5,0,33280,46,7118881444
7282,101277777,121187,101398964,0,9,0,88576,20,345820642
7283,101280809,3422,101284231,0,8,1,3584,27,10225586855
7284,101291686,5712,101297398,0,8,1,14336,27,5532451194
7285,101294674,110552,101405226,0,7,0,62976,41,7022540329
7286,101345055,13858,101358913,0,2,1,23552,8,6024743871
7287,101353770,166568,101520338,0,7,0,16896,41,1771709428
7288,101354843,30749,101385592,0,6,1,49664,42,3000502926
7289,101363470,109970,101473440,0,7,0,58880,41,3855707954
7290,101366088,125288,101491376,0,4,0,24576,21,257136650
7291,101371810,89612,101461422,0,4,0,19456,21,4737234307
7292,101385388,105872,101491260,0,0,0,47616,38,2240623828
7293,101419140,104156,101523296,0,9,0,41984,20,6744645454
7294,101428434,70976,101499410,0,7,0,8704,41,1388401125
7295,101432856,30491,101463347,0,6,1,49152,42,8172966485
7296,101434656,566,101435222,0,2,1,512,8,591836614
7297,101451497,1042,101452539,0,2,1,1024,8,9014901491
7298,101465990,23466,101489456,0,6,1,38912,42,2638079485
7299,101468070,566,101468636,0,8,1,512,27,9244446466
7300,101476088,566,101476654,0,2,1,512,8,6600926824
7301,101486504,46792,101533296,0,7,0,1024,41,865913102
7302,101488452,3387,101491839,0,2,1,9728,8,1910241930
7303,101490126,6793,101496919,0,2,1,13824,8,7111512005
7304,101535042,113828,101648870,0,9,0,73728,20,1151288604
7305,101564756,136844,101701600,0,4,0,134144,21,6262743642
7306,101608599,67592,101676191,0,9,0,7680,20,142610310
7307,101611701,158347,101770048,0,4,0,74240,21,9698741574
7308,101614534,108524,101723058,0,9,0,56320,20,1436972067
7309,101618276,110881,101729157,0,9,0,19968,20,7999136441
7310,101624739,107120,101731859,0,5,0,51712,46,8550425706
7311,101648427,106808,101755235,0,7,0,50688,41,1522617429
7312,101663405,5802,101669207,0,8,1,6144,27,5530726387
7313,101708148,102908,101811056,0,5,0,37888,46,10012070672
7314,101710962,6229,101717191,0,8,1,15360,27,6323682279
7315,101731905,106028,101837933,0,4,0,48128,21,1582350046
7316,101735008,103532,101838540,0,7,0,39936,41,1851800365
7317,101749603,1518,101751121,0,8,1,1536,27,6666824554
7318,101752105,65612,101817717,0,9,0,11264,20,9062597199
7319,101755787,1042,101756829,0,8,1,1024,27,9437861799
7320,101769334,166771,101936105,0,4,0,70656,21,6548795716
7321,101773888,5326,101779214,0,6,1,5632,42,696307877
7322,101774506,3128,101777634,0,8,1,9216,27,2890303838
7323,101778276,1042,101779318,0,7,1,1024,41,2616869355
7324,101785791,100724,101886515,0,9,0,30720,20,1121229045
7325,101787493,1994,101789487,0,8,1,2048,27,4856008483
7326,101805911,4374,101810285,0,7,1,4608,41,3038471538
7327,101850117,52549,101902666,0,6,1,85504,42,2768086664
7328,101881964,7965,101889929,0,9,1,3584,20,8059589977
7329,101937559,1994,101939553,0,8,1,2048,27,10343299255
7330,101942671,5802,101948473,0,8,1,6144,27,10412552873
7331,101951767,126696,102078463,0,6,1,209920,42,9393370600
7332,101951995,2946,101954941,0,7,1,3072,41,9666444668
7333,101960729,102596,102063325,0,7,0,36864,41,9008755338
7334,101968428,1518,101969946,0,7,1,1536,41,7957269176
7335,101972560,105092,102077652,0,4,0,45056,21,1030488081
7336,101978299,566,101978865,0,9,1,512,20,8367271556
7337,102007059,5802,102012861,0,9,1,6144,20,4139101868
7338,102008715,12566,102021281,0,5,1,20992,46,5709106736
7339,102027833,3422,102031255,0,9,1,3584,20,7290092534
7340,102031604,60824,102092428,0,5,0,5632,46,2817501714
7341,102103266,5326,102108592,0,8,1,5632,27,6364586632
7342,102110037,3128,102113165,0,8,1,9216,27,6978882565
7343,102116591,566,102117157,0,6,1,512,42,6147798629
7344,102117763,198704,102316467,0,9,0,190976,20,9387488902
7345,102122491,100568,102223059,0,7,0,30208,41,3569927156
7346,102124556,61382,102185938,0,6,1,99328,42,2457489412
7347,102130414,42683,102173097,0,5,1,69632,46,4318306362
7348,102131604,75430,102207034,0,6,1,68096,42,340255260
7349,102136311,57882,102194193,0,5,1,68096,46,2846147007
7350,102145556,108829,102254385,0,7,0,20992,41,4592426789
7351,102149504,3422,102152926,0,7,1,3584,41,7723556752
7352,102150512,49070,102199582,0,5,1,17408,46,4737278835
7353,102152222,3422,102155644,0,7,1,3584,41,7820915852
7354,102173164,1042,102174206,0,8,1,1024,27,3228202860
7355,102181376,3387,102184763,0,7,1,9728,41,7756811959
7356,102200220,117978,102318198,0,9,0,5632,20,10530115923
7357,102207278,34537,102241815,0,5,1,60416,46,6541114393
7358,102214525,62072,102276597,0,4,0,9728,21,9544140753
7359,102219890,32243,102252133,0,5,1,40960,46,2924646500
7360,102221731,32028,102253759,0,5,1,2560,46,6281117824
7361,102244553,10486,102255039,0,5,1,14336,46,232784718
7362,102255118,3898,102259016,0,8,1,4096,27,154572584
7363,102255140,68684,102323824,0,4,0,11264,21,3276781784
7364,102266763,114140,102380903,0,7,0,74752,41,6216961881
7365,102280375,45596,102325971,0,5,0,1024,46,9764590724
7366,102286633,119633,102406266,0,9,0,19456,20,1862833780
7367,102286881,4850,102291731,0,8,1,5120,27,2648142644
7368,102300702,23484,102324186,0,9,1,14848,20,1921013347
7369,102302800,13341,102316141,0,7,1,22528,41,462890811
7370,102339943,105761,102445704,0,9,0,36864,20,6554378644
7371,102340029,142899,102482928,0,6,1,231424,42,1161746397
7372,102380589,3898,102384487,0,9,1,4096,20,1253421163
7373,102402600,80994,102483594,0,6,1,1024,42,7899029476
7374,102450858,63878,102514736,0,6,1,107520,42,8429211180
7375,102488329,114608,102602937,0,7,0,76288,41,6657589672
7376,102504223,104000,102608223,0,4,0,41472,21,5651575273
7377,102504913,87896,102592809,0,5,0,13824,46,9540828284
7378,102505191,102908,102608099,0,9,0,37888,20,3802533887
7379,102520856,3898,102524754,0,8,1,4096,27,4045460241
7380,102523012,5712,102528724,0,6,1,14336,42,1786991653
7381,102524006,110919,102634925,0,9,0,18944,20,10186970164
7382,102546530,7706,102554236,0,9,1,8192,20,1166408108
7383,102547201,1518,102548719,0,7,1,1536,41,9734931814
7384,102549837,73704,102623541,0,7,0,512,41,3275403784
7385,102566911,102596,102669507,0,5,0,36864,46,705684985
7386,102567747,193417,102761164,0,9,0,128000,20,9747283883
7387,102570554,88700,102659254,0,9,0,21504,20,4281912164
7388,102571380,47600,102618980,0,5,0,2560,46,10723471736
7389,102572325,3128,102575453,0,8,1,9216,27,4073401971
7390,102573285,16613,102589898,0,6,1,32256,42,1957508470
7391,102599890,182691,102782581,0,5,0,6656,46,9752112682
7392,102621830,158708,102780538,0,5,0,145408,46,8267230317
7393,102623271,82400,102705671,0,4,0,20992,21,8922417062
7394,102624711,41132,102665843,0,6,1,66560,42,3122506798
7395,102628689,138262,102766951,0,9,0,18944,20,1783689088
7396,102629233,8554,102637787,0,9,1,8704,20,3353927689
7397,102639572,1042,102640614,0,8,1,1024,27,1242913409
7398,102641724,85465,102727189,0,6,1,133120,42,3735578792
7399,102760605,6904,102767509,0,9,1,512,20,1745303408
7400,102769855,3422,102773277,0,7,1,3584,41,5910204562
7401,102780204,1994,102782198,0,9,1,2048,20,5668085201
7402,102784540,3422,102787962,0,9,1,3584,20,6078181325
7403,102784663,64912,102849575,0,6,1,109568,42,9895299554
7404,102792258,84716,102876974,0,7,0,23552,41,4439668423
7405,102803425,566,102803991,0,8,1,512,27,5932372496
7406,102808266,1994,102810260,0,9,1,2048,20,2822119964
7407,102832064,3387,102835451,0,7,1,9728,41,2493306007
7408,102855458,4850,102860308,0,7,1,5120,41,5737473773
7409,102861914,4850,102866764,0,6,1,5120,42,5694148008
7410,102874103,99320,102973423,0,9,0,26112,20,4386870169
7411,102892039,2946,102894985,0,8,1,3072,27,1218418093
7412,102923186,97292,103020478,0,7,0,19456,41,817123136
7413,102940517,5454,102945971,0,5,1,13824,46,2181356528
7414,102942487,4790,102947277,0,5,1,2048,46,7391668376
7415,102955387,105560,103060947,0,7,0,46592,41,9510236896
7416,102988059,132574,103120633,0,6,0,33280,42,526423583
7417,102997495,1518,102999013,0,7,1,1536,41,276138293
7418,103008040,1042,103009082,0,8,1,1024,27,522613275
7419,103011857,100100,103111957,0,5,0,28672,46,8796516934
7420,103027384,2946,103030330,0,5,1,3072,46,4107798501
7421,103027539,4417,103031956,0,5,1,2560,46,8731750725
7422,103030609,25446,103056055,0,6,1,46080,42,1609863784
7423,103045575,71132,103116707,0,9,0,9216,20,2886631102
7424,103051481,75278,103126759,0,5,0,512,46,2098581639
7425,103053885,106185,103160070,0,6,0,7168,42,10400609663
7426,103058234,6603,103064837,0,7,1,4096,41,3179083449
7427,103058450,3422,103061872,0,5,1,3584,46,5317145634
7428,103058490,14287,103072777,0,6,1,27648,42,4215827225
7429,103073741,98656,103172397,0,6,0,6656,42,4099856917
7430,103082039,55748,103137787,0,9,0,4096,20,2256344910
7431,103083243,1042,103084285,0,9,1,1024,20,5390523123
7432,103094365,83088,103177453,0,6,0,15872,42,2104665645
7433,103107752,2470,103110222,0,9,1,2560,20,4073828023
7434,103113243,59132,103172375,0,9,0,5120,20,9603711964
7435,103117679,3422,103121101,0,8,1,3584,27,8748059453
7436,103149128,143205,103292333,0,9,0,44544,20,8006537391
7437,103162618,110603,103273221,0,6,0,37888,42,9131658159
7438,103163443,85372,103248815,0,9,0,11776,20,1719118411
7439,103167918,111020,103278938,0,5,0,64512,46,10144935818
7440,103167923,2870,103170793,0,9,1,8704,20,4041984324
7441,103177469,2946,103180415,0,3,1,3072,4,2170237506
7442,103199055,106652,103305707,0,4,0,50176,21,8389398121
7443,103202764,166093,103368857,0,5,0,31232,46,2016761236
7444,103203755,107276,103311031,0,3,0,52224,4,1210303466
7445,103236489,269894,103506383,0,4,0,247808,21,1448424398
7446,103238024,121302,103359326,0,5,0,28672,46,6094573561
7447,103244018,1042,103245060,0,9,1,1024,20,4621010780
7448,103246632,5326,103251958,0,8,1,5632,27,757129298
7449,103251064,3904,103254968,0,3,1,10752,4,8339078808
7450,103266344,125057,103391401,0,9,0,81920,20,10537963235
7451,103273384,101366,103374750,0,6,1,163840,42,4404758985
7452,103276323,6754,103283077,0,3,1,7168,4,4824515495
7453,103278625,13723,103292348,0,9,1,4096,20,4437307501
7454,103290631,5196,103295827,0,7,1,13312,41,8979555310
7455,103293482,207932,103501414,0,6,0,65536,42,4029552627
7456,103323963,48980,103372943,0,5,0,2048,46,10524686784
7457,103334507,3128,103337635,0,5,1,9216,46,9338749312
7458,103338333,105092,103443425,0,7,0,45056,41,9338013796
7459,103357027,122218,103479245,0,5,0,62464,46,9401751993
7460,103373657,135776,103509433,0,9,0,87552,20,1388706793
7461,103378397,5802,103384199,0,7,1,6144,41,4925774078
7462,103382368,566,103382934,0,8,1,512,27,5698636596
7463,103383880,156921,103540801,0,9,0,29184,20,4205930220
7464,103389901,2870,103392771,0,7,1,8704,41,8893785627
7465,103400236,41649,103441885,0,6,1,67584,42,5736334465
7466,103408665,116442,103525107,0,6,0,12288,42,6583764290
7467,103415984,4162,103420146,0,3,1,11264,4,5658881519
7468,103424580,93533,103518113,0,5,0,16384,46,8785123884
7469,103425640,2470,103428110,0,8,1,2560,27,2521489484
7470,103432509,136454,103568963,0,5,0,10752,46,7493489986
7471,103464698,256176,103720874,0,6,0,26624,42,6728894616
7472,103477320,4937,103482257,0,3,1,12800,4,8916483921
7473,103487620,79401,103567021,0,9,0,5120,20,5778288469
7474,103497115,2470,103499585,0,8,1,2560,27,4998189561
7475,103500300,445783,103946083,0,6,0,136704,42,7024647383
7476,103509850,1994,103511844,0,9,1,2048,20,9643541308
7477,103517804,7706,103525510,0,3,1,8192,4,4945378992
7478,103523193,36014,103559207,0,6,1,56320,42,3059796827
7479,103532563,4374,103536937,0,8,1,4608,27,7232732898
7480,103536439,10156,103546595,0,9,1,6144,20,8580117524
7481,103601260,4374,103605634,0,9,1,4608,20,5649267905
7482,103642074,67304,103709378,0,9,0,3584,20,8460452873
7483,103659838,123656,103783494,0,5,0,105984,46,1640482822
7484,103663681,4850,103668531,0,8,1,5120,27,9218859170
7485,103669940,566,103670506,0,3,1,512,4,5564879123
7486,103707360,13529,103720889,0,6,1,16896,42,798181731
7487,103725454,92528,103817982,0,7,0,18944,41,7868738144
7488,103736201,5802,103742003,0,3,1,6144,4,8716910311
7489,103737860,51516,103789376,0,6,1,83456,42,1304719698
7490,103744927,3387,103748314,0,8,1,9728,27,4072034611
7491,103770358,105092,103875450,0,9,0,45056,20,7171150317
7492,103781260,4374,103785634,0,3,1,4608,4,2718810454
7493,103786034,566,103786600,0,8,1,512,27,8558656121
7494,103813669,2470,103816139,0,9,1,2560,20,8684631081
7495,103827323,3898,103831221,0,8,1,4096,27,520844191
7496,103838549,108680,103947229,0,4,0,56832,21,9253643756
7497,103848534,86228,103934762,0,9,0,18432,20,4990160677
7498,103861164,14301,103875465,0,9,1,5632,20,10069484685
7499,103872041,67592,103939633,0,5,0,7680,46,6814387491
7500,103872636,3898,103876534,0,3,1,4096,4,10531590667
7501,103872987,3898,103876885,0,8,1,4096,27,7846211225
7502,103884638,116861,104001499,0,4,0,27136,21,10431760958
7503,103893330,57547,103950877,0,4,0,1024,21,1909942232
7504,103899822,103376,104003198,0,7,0,39424,41,2792761
7505,103912911,13341,103926252,0,3,1,22528,4,7901292050
7506,103913016,6278,103919294,0,8,1,6656,27,7841657733
7507,103915453,78368,103993821,0,9,0,12800,20,4069765321
7508,103924392,185967,104110359,0,9,0,55808,20,518438736
7509,103941994,2946,103944940,0,9,1,3072,20,4557061686
7510,103944922,1994,103946916,0,3,1,2048,4,4230588891
7511,103946751,47288,103994039,0,6,0,1536,42,1843139048
7512,103956321,1518,103957839,0,9,1,1536,20,974963372
7513,103960669,7706,103968375,0,8,1,8192,27,2499210426
7514,103972836,3422,103976258,0,9,1,3584,20,4026616186
7515,103995975,26221,104022196,0,6,1,47616,42,1216602810
7516,103997887,195269,104193156,0,6,1,295424,42,7492770918
7517,103998470,4850,104003320,0,8,1,5120,27,977197742
7518,104003019,4679,104007698,0,8,1,12288,27,10301597863
7519,104005915,4162,104010077,0,9,1,11264,20,7335030710
7520,104037603,47288,104084891,0,7,0,1536,41,5553508729
7521,104045960,108992,104154952,0,5,0,57856,46,4860502255
7522,104049345,146077,104195422,0,6,1,3584,42,5840578915
7523,104072704,128927,104201631,0,6,1,29696,42,7176233439
7524,104077695,2870,104080565,0,8,1,8704,27,10192130020
7525,104096434,104468,104200902,0,4,0,43008,21,10691003323
7526,104104208,116053,104220261,0,4,0,63488,21,6239561010
7527,104104455,98731,104203186,0,5,0,18432,46,2337162805
7528,104120312,218134,104338446,0,4,0,43520,21,9938942123
7529,104124072,3898,104127970,0,3,1,4096,4,9477697066
7530,104124496,148544,104273040,0,4,0,56832,21,2548809071
7531,104135966,105716,104241682,0,9,0,47104,20,9351068628
7532,104140855,192214,104333069,0,6,0,55296,42,5414261176
7533,104141965,4420,104146385,0,8,1,11776,27,10611998126
7534,104174281,7230,104181511,0,8,1,7680,27,1149522813
7535,104186098,21230,104207328,0,6,1,27136,42,2268936170
7536,104194681,26479,104221160,0,6,1,48128,42,3225899356
7537,104212911,211263,104424174,0,6,0,9728,42,3501943536
7538,104254524,2946,104257470,0,8,1,3072,27,9004646449
7539,104276927,5802,104282729,0,9,1,6144,20,5197313586
7540,104283157,102752,104385909,0,9,0,37376,20,6394686617
7541,104286258,57440,104343698,0,4,0,4608,21,9372776742
7542,104303886,71132,104375018,0,4,0,9216,21,1929162879
7543,104320080,120413,104440493,0,6,0,52736,42,9669295376
7544,104412105,566,104412671,0,8,1,512,27,2651529675
7545,104426597,1518,104428115,0,8,1,1536,27,3039140632
7546,104450712,60380,104511092,0,4,0,9216,21,9486149810
7547,104514974,1042,104516016,0,6,1,1024,42,900988864
7548,104523968,5326,104529294,0,9,1,5632,20,4878595357
7549,104553089,4937,104558026,0,3,1,12800,4,9059161958
7550,104553539,141328,104694867,0,9,0,9216,20,7574233584
7551,104570607,80956,104651563,0,9,0,11776,20,5711691740
7552,104575564,116480,104692044,0,9,0,82432,20,10302674744
7553,104585856,2946,104588802,0,9,1,3072,20,4774508687
7554,104586185,108524,104694709,0,1,0,56320,36,490794535
7555,104595573,99164,104694737,0,5,0,25600,46,4680451603
7556,104598479,155671,104754150,0,9,0,53248,20,7809559794
7557,104606025,4374,104610399,0,3,1,4608,4,879980310
7558,104615656,114764,104730420,0,7,0,76800,41,8398040111
7559,104617358,40616,104657974,0,6,1,65536,42,4707559444
7560,104618333,207600,104825933,0,5,0,15360,46,266467358
7561,104619427,50401,104669828,0,6,1,40448,42,3483420806
7562,104657744,118623,104776367,0,5,0,65536,46,9953537508
7563,104661459,309746,104971205,0,6,0,72192,42,7046867163
7564,104662986,126988,104789974,0,5,0,27136,46,3788014423
7565,104717998,1042,104719040,0,6,1,1024,42,3213625362
7566,104743267,4679,104747946,0,6,1,12288,42,5829749913
7567,104749987,235593,104985580,0,6,0,47104,42,9170568504
7568,104751943,84733,104836676,0,6,1,138240,42,9418089009
7569,104762233,4850,104767083,0,9,1,5120,20,5832258987
7570,104764322,128972,104893294,0,5,0,66560,46,1828421461
7571,104812268,7230,104819498,0,9,1,7680,20,3497002836
7572,104814174,6229,104820403,0,8,1,15360,27,784445923
7573,104824934,1994,104826928,0,3,1,2048,4,9291919219
7574,104826142,207440,105033582,0,4,0,219648,21,7467488872
7575,104848993,113094,104962087,0,9,0,55808,20,4611555008
7576,104866564,3422,104869986,0,9,1,3584,20,7068864939
7577,104871185,284647,105155832,0,6,0,31232,42,9229792864
7578,104874303,128755,105003058,0,5,0,60416,46,5992190175
7579,104886103,26479,104912582,0,6,1,48128,42,501576164
7580,104890686,3645,104894331,0,3,1,10240,4,588376623
7581,104938410,4679,104943089,0,6,1,12288,42,2119053649
7582,104952361,160253,105112614,0,6,0,26624,42,6515713083
7583,104962896,54056,105016952,0,7,0,3584,41,2519769826
7584,104963699,1518,104965217,0,3,1,1536,4,6822493430
7585,105008536,187472,105196008,0,9,0,154112,20,2328110204
7586,105040006,2470,105042476,0,9,1,2560,20,4106641365
7587,105048100,150107,105198207,0,9,0,7168,20,9168857909
7588,105065170,274139,105339309,0,6,0,34304,42,7926195055
7589,105083295,100568,105183863,0,7,0,30208,41,5783915465
7590,105083698,245144,105328842,0,6,0,68608,42,2959745721
7591,105085972,4374,105090346,0,3,1,4608,4,4227137106
7592,105093920,5712,105099632,0,9,1,14336,20,1025073305
7593,105096681,1994,105098675,0,3,1,2048,4,2730848647
7594,105128467,27380,105155847,0,6,1,47104,42,118549917
7595,105140361,2946,105143307,0,9,1,3072,20,352297867
7596,105159548,32816,105192364,0,6,1,53760,42,7045404957
7597,105164153,1042,105165195,0,3,1,1024,4,4718690533
7598,105177566,142160,105319726,0,5,0,75776,46,4857984591
7599,105186842,107588,105294430,0,5,0,53248,46,2142290643
7600,105188951,5326,105194277,0,8,1,5632,27,10185887339
7601,105193871,103960,105297831,0,9,0,27136,20,8489378504
7602,105196282,2946,105199228,0,8,1,3072,27,10048079535
7603,105201453,4850,105206303,0,8,1,5120,27,6276109645
7604,105207012,172887,105379899,0,9,0,135168,20,3292023064
7605,105220570,3422,105223992,0,3,1,3584,4,10628112181
7606,105248771,1994,105250765,0,3,1,2048,4,1869132893
7607,105277829,143813,105421642,0,5,0,110592,46,917932379
7608,105300759,119218,105419977,0,6,0,27648,42,2098507817
7609,105302784,4374,105307158,0,8,1,4608,27,3379036299
7610,105315672,201559,105517231,0,6,0,21504,42,1595930210
7611,105319889,93800,105413689,0,7,0,28160,41,7365022561
7612,105328545,62516,105391061,0,9,0,6144,20,343027019
7613,105336271,151119,105487390,0,5,0,31744,46,8212019197
7614,105337509,66987,105404496,0,6,1,110080,42,6712889878
7615,105356097,135252,105491349,0,9,0,49152,20,7101606994
7616,105366726,62516,105429242,0,4,0,6144,21,4881449201
7617,105379978,96380,105476358,0,9,0,21504,20,10199243216
7618,105385492,12825,105398317,0,8,1,21504,27,865227378
7619,105389651,35881,105425532,0,5,1,4096,46,9397635817
7620,105393687,58810,105452497,0,7,0,2048,41,10556025355
7621,105451462,1042,105452504,0,9,1,1024,20,4281775705
7622,105454692,2470,105457162,0,9,1,2560,20,5067209239
7623,105457764,4374,105462138,0,6,1,4608,42,785805658
7624,105479401,12506,105491907,0,9,1,512,20,2047014919
7625,105500720,1042,105501762,0,3,1,1024,4,4633667204
7626,105507552,92372,105599924,0,5,0,18432,46,691432931
7627,105533462,123344,105656806,0,7,0,104960,41,3965271137
7628,105537276,90392,105627668,0,6,0,22016,42,2156592271
7629,105538392,7230,105545622,0,7,1,7680,41,3297827190
7630,105543167,1042,105544209,0,8,1,1024,27,1930012629
7631,105543309,48980,105592289,0,6,0,2048,42,8070851189
7632,105551301,224426,105775727,0,7,0,53248,41,7137138564
7633,105558663,2870,105561533,0,7,1,8704,41,196793985
7634,105573551,566,105574117,0,6,1,512,42,6078264502
7635,105579243,3645,105582888,0,9,1,10240,20,3713274608
7636,105582608,108836,105691444,0,4,0,57344,21,10381249924
7637,105623813,134291,105758104,0,7,0,48128,41,4351454091
7638,105628935,12049,105640984,0,6,1,19968,42,4035828617
7639,105639841,4374,105644215,0,5,1,4608,46,1589769250
7640,105650607,566,105651173,0,9,1,512,20,9186354263
7641,105658087,1042,105659129,0,7,1,1024,41,5895983561
7642,105669968,3898,105673866,0,7,1,4096,41,7054546933
7643,105691773,1042,105692815,0,5,1,1024,46,2229399312
7644,105695182,47288,105742470,0,7,0,1536,41,2998538055
7645,105703244,114140,105817384,0,9,0,74752,20,4031302766
7646,105707689,3898,105711587,0,6,1,4096,42,3242241513
7647,105720159,1518,105721677,0,6,1,1536,42,7225310879
7648,105754705,3128,105757833,0,5,1,9216,46,9424372348
7649,105779002,3422,105782424,0,9,1,3584,20,1699540451
7650,105783725,108056,105891781,0,4,0,54784,21,1980608419
7651,105794608,102752,105897360,0,0,0,37376,38,6500924399
7652,105806617,122559,105929176,0,9,0,67072,20,3213692846
7653,105809730,4374,105814104,0,8,1,4608,27,6806830075
7654,105837781,96224,105934005,0,4,0,20992,21,1396505185
7655,105843366,104156,105947522,0,7,0,41984,41,6897415147
7656,105860118,7230,105867348,0,8,1,7680,27,3723225378
7657,105888522,81752,105970274,0,5,0,13824,46,251115196
7658,105906239,79436,105985675,0,6,0,11264,42,9015214758
7659,105908014,5454,105913468,0,8,1,13824,27,2169955833
7660,105938603,6229,105944832,0,6,1,15360,42,10149818813
7661,105940604,11284,105951888,0,7,1,4608,41,1612008594
7662,105968929,2379,105971308,0,5,1,1024,46,10292091483
7663,105972316,250475,106222791,0,5,0,188416,46,6879803415
7664,105975318,1518,105976836,0,8,1,1536,27,3384954249
7665,106001170,566,106001736,0,9,1,512,20,8811147312
7666,106010019,4374,106014393,0,6,1,4608,42,5965126666
7667,106028393,3422,106031815,0,5,1,3584,46,5429174321
7668,106037013,3422,106040435,0,3,1,3584,4,10723802038
7669,106046044,108212,106154256,0,4,0,55296,21,3828370344
7670,106070014,102908,106172922,0,6,0,37888,42,9863003792
7671,106080080,82558,106162638,0,4,0,1024,21,9561425830
7672,106093107,162704,106255811,0,6,0,53248,42,7420186661
7673,106096838,6754,106103592,0,6,1,7168,42,10956670
7674,106098913,237502,106336415,0,6,0,139776,42,5282626757
7675,106102711,109772,106212483,0,7,0,60416,41,4403398142
7676,106119619,4374,106123993,0,6,1,4608,42,2860494403
7677,106124407,134227,106258634,0,6,0,9216,42,2776708628
7678,106133987,3898,106137885,0,6,1,4096,42,4483200284
7679,106137624,566,106138190,0,8,1,512,27,4468313295
7680,106140640,99320,106239960,0,5,0,26112,46,7312032730
7681,106152702,4850,106157552,0,8,1,5120,27,8440774799
7682,106161236,11701,106172937,0,6,1,512,42,2296104704
7683,106174479,5326,106179805,0,8,1,5632,27,8259656499
7684,106196108,92602,106288710,0,6,0,17408,42,9582938327
7685,106217356,111800,106329156,0,4,0,67072,21,2514744497
7686,106225615,2946,106228561,0,5,1,3072,46,7635433380
7687,106231951,4374,106236325,0,6,1,4608,42,1377214885
7688,106236231,52364,106288595,0,9,0,3072,20,9263503550
7689,106256990,144632,106401622,0,6,0,9728,42,2870763068
7690,106272439,10757,106283196,0,8,1,17408,27,359928749
7691,106289619,86516,106376135,0,5,0,14336,46,3130254269
7692,106305879,1042,106306921,0,4,1,1024,21,2179783055
7693,106323852,4374,106328226,0,5,1,4608,46,2552431332
7694,106324602,113933,106438535,0,6,0,35328,42,2507060305
7695,106331849,2946,106334795,0,8,1,3072,27,8927382286
7696,106335401,4420,106339821,0,4,1,11776,21,7977155240
7697,106343751,87476,106431227,0,7,0,22528,41,7597534442
7698,106369845,64208,106434053,0,5,0,6656,46,643629807
7699,106371198,99788,106470986,0,9,0,27648,20,9057935708
7700,106372188,11645,106383833,0,5,1,8192,46,8338455730
7701,106372908,13341,106386249,0,4,1,22528,21,9059073117
7702,106401177,4420,106405597,0,5,1,11776,46,5627418870
7703,106413382,5326,106418708,0,5,1,5632,46,7226379957
7704,106436305,7706,106444011,0,8,1,8192,27,5704336174
7705,106438414,173796,106612210,0,5,0,7680,46,10580477926
7706,106441636,127363,106568999,0,4,0,47104,21,4008683983
7707,106449199,124436,106573635,0,7,0,108544,41,8375645345
7708,106482313,5326,106487639,0,8,1,5632,27,9091494037
7709,106490121,111956,106602077,0,5,0,67584,46,6411042829
7710,106490379,122252,106612631,0,9,0,101376,20,3929211724
7711,106547311,131564,106678875,0,7,0,45568,41,10320914652
7712,106592060,56840,106648900,0,6,0,7680,42,850117049
7713,106595611,113918,106709529,0,7,0,24064,41,9998000938
7714,106599078,3645,106602723,0,8,1,10240,27,8265455607
7715,106603934,47444,106651378,0,6,0,2048,42,3243719486
7716,106610326,55748,106666074,0,4,0,4096,21,2549606049
7717,106615064,108992,106724056,0,5,0,57856,46,6877175214
7718,106627416,105235,106732651,0,5,0,28160,46,6295386689
7719,106627698,32987,106660685,0,4,1,57344,21,9732625786
7720,106640744,78737,106719481,0,4,1,124416,21,3873354771
7721,106654115,129325,106783440,0,4,0,29184,21,615560766
7722,106665172,122418,106787590,0,5,0,38400,46,7680862916
7723,106665216,101504,106766720,0,9,0,33280,20,10231964531
7724,106718765,2870,106721635,0,3,1,8704,4,7400581146
7725,106728160,102596,106830756,0,6,0,36864,42,78396282
7726,106733771,102596,106836367,0,7,0,36864,41,6077163832
7727,106745025,566,106745591,0,3,1,512,4,9382782196
7728,106760345,2470,106762815,0,3,1,2560,4,8960934135
7729,106768753,129117,106897870,0,4,0,11264,21,1873430261
7730,106781195,117865,106899060,0,6,0,11776,42,322273151
7731,106785502,104052,106889554,0,5,0,34816,46,7699675344
7732,106815198,3898,106819096,0,3,1,4096,4,9512027565
7733,106832126,152703,106984829,0,4,0,5632,21,7423477074
7734,106835794,2470,106838264,0,3,1,2560,4,4709258516
7735,106864274,54056,106918330,0,9,0,3584,20,10216127252
7736,106885771,1994,106887765,0,3,1,2048,4,7180890930
7737,106907452,196364,107103816,0,9,0,183296,20,9832424481
7738,106915133,115232,107030365,0,7,0,78336,41,5047179897
7739,106917482,50672,106968154,0,5,0,2560,46,2519443769
7740,106932542,262544,107195086,0,4,0,189440,21,8707528659
7741,106946850,5326,106952176,0,1,1,5632,36,4327258899
7742,106953842,265439,107219281,0,4,0,79360,21,796924289
7743,106954630,160004,107114634,0,9,0,26112,20,3207194657
7744,106965764,105872,107071636,0,5,0,47616,46,1294948997
7745,106970131,121316,107091447,0,6,0,98304,42,7523959917
7746,107004570,134944,107139514,0,5,0,37376,46,10108344079
7747,107018686,138603,107157289,0,7,0,116736,41,3369549851
7748,107025725,135658,107161383,0,6,0,28160,42,7293297834
7749,107052840,5802,107058642,0,3,1,6144,4,9559467610
7750,107085889,69464,107155353,0,5,0,13824,46,6985892494
7751,107090693,141953,107232646,0,4,0,28160,21,1179174886
7752,107095597,4374,107099971,0,1,1,4608,36,5036687944
7753,107157564,64076,107221640,0,5,0,11264,46,7878043313
7754,107185003,103064,107288067,0,7,0,38400,41,3501242872
7755,107201618,4937,107206555,0,3,1,12800,4,3357278248
7756,107241010,131939,107372949,0,7,0,83968,41,4803147503
7757,107245554,168630,107414184,0,7,0,45568,41,5042398047
7758,107259305,58220,107317525,0,9,0,7168,20,793514903
7759,107261620,111500,107373120,0,7,0,512,41,10295997186
7760,107268278,2946,107271224,0,1,1,3072,36,9832502078
7761,107269377,149034,107418411,0,7,0,13824,41,2564597284
7762,107282279,36087,107318366,0,4,1,63488,21,475199926
7763,107285809,143859,107429668,0,4,0,13312,21,3145735642
7764,107287469,4850,107292319,0,1,1,5120,36,9083597612
7765,107324653,6488,107331141,0,1,1,15872,36,5418484705
7766,107328971,3422,107332393,0,3,1,3584,4,10434915368
7767,107337067,3387,107340454,0,1,1,9728,36,1718913686
7768,107344282,125114,107469396,0,7,0,12800,41,2778068208
7769,107354388,1518,107355906,0,1,1,1536,36,4440398447
7770,107356643,7230,107363873,0,3,1,7680,4,5385929140
7771,107361346,151356,107512702,0,4,0,57856,21,1064022223
7772,107405354,3422,107408776,0,4,1,3584,21,9022973011
7773,107429955,2946,107432901,0,1,1,3072,36,1290429632
7774,107437262,566,107437828,0,3,1,512,4,8145521483
7775,107448048,6278,107454326,0,2,1,6656,8,3167748865
7776,107521195,79436,107600631,0,4,0,11264,21,7942064895
7777,107526700,1042,107527742,0,3,1,1024,4,3905398340
7778,107529508,67592,107597100,0,9,0,7680,20,1529685285
7779,107529951,4679,107534630,0,8,1,12288,27,3526908099
7780,107531289,4937,107536226,0,3,1,12800,4,6831381527
7781,107571559,4850,107576409,0,1,1,5120,36,2534780526
7782,107597431,78212,107675643,0,9,0,12288,20,2684301564
7783,107600922,5326,107606248,0,4,1,5632,21,4143270717
7784,107618386,1518,107619904,0,3,1,1536,4,5851533143
7785,107660988,1518,107662506,0,8,1,1536,27,78535354
7786,107675620,3422,107679042,0,8,1,3584,27,8726130231
7787,107704080,3422,107707502,0,7,1,3584,41,1981359892
7788,107712788,99944,107812732,0,7,0,28160,41,3431447102
7789,107718769,118664,107837433,0,6,0,89600,42,8053620779
7790,107775462,104468,107879930,0,4,0,43008,21,8598680939
7791,107778428,107276,107885704,0,9,0,52224,20,1791431986
7792,107808121,95024,107903145,0,6,0,27136,42,7225743717
7793,107828992,96252,107925244,0,9,0,18432,20,2270412008
7794,107843812,1042,107844854,0,8,1,1024,27,10351710941
7795,107844393,103688,107948081,0,4,0,40448,21,9790814902
7796,107876785,10429,107887214,0,9,1,1536,20,9816537668
7797,107884913,566,107885479,0,8,1,512,27,2219102502
7798,107902444,95336,107997780,0,9,0,28160,20,5510787713
7799,107916761,80084,107996845,0,7,0,18432,41,10129550182
7800,107918223,75164,107993387,0,6,0,17408,42,796445966
7801,107944704,2870,107947574,0,8,1,8704,27,5091130360
7802,107955564,79843,108035407,0,7,0,12800,41,5733854290
7803,107960821,4420,107965241,0,8,1,11776,27,3784937107
7804,107976943,118769,108095712,0,9,0,65024,20,3267347299
7805,108026539,1994,108028533,0,6,1,2048,42,7884542861
7806,108029376,36863,108066239,0,4,1,65024,21,588387846
7807,108036999,107306,108144305,0,4,0,1024,21,3576271438
7808,108040167,102128,108142295,0,7,0,35328,41,6278896102
7809,108048479,94923,108143402,0,7,0,3584,41,10562614351
7810,108063665,3898,108067563,0,9,1,4096,20,8592352456
7811,108114650,119481,108234131,0,7,0,82432,41,1302817921
7812,108117362,10499,108127861,0,6,1,16896,42,4144050892
7813,108132550,3128,108135678,0,9,1,9216,20,2278788330
7814,108192210,138401,108330611,0,7,0,104448,41,9089954360
7815,108196893,6754,108203647,0,6,1,7168,42,3542008484
7816,108199193,49448,108248641,0,9,0,3584,20,9951885176
7817,108213685,78236,108291921,0,6,0,17408,42,1814040370
7818,108217151,566,108217717,0,9,1,512,20,9402377949
7819,108223100,14287,108237387,0,4,1,27648,21,1878873361
7820,108225382,122641,108348023,0,7,0,3072,41,7257427515
7821,108225466,57106,108282572,0,4,1,82432,21,5967658719
7822,108228330,1042,108229372,0,9,1,1024,20,7953010730
7823,108266857,3422,108270279,0,6,1,3584,42,10511635455
7824,108271738,5712,108277450,0,9,1,14336,20,9175006119
7825,108277776,3422,108281198,0,6,1,3584,42,5346054963
7826,108302535,4162,108306697,0,9,1,11264,20,4279296823
7827,108307532,124419,108431951,0,7,0,32768,41,680603852
7828,108351105,148507,108499612,0,6,0,24064,42,6435557596
7829,108377873,2870,108380743,0,6,1,8704,42,2443217110
7830,108402221,12308,108414529,0,9,1,20480,20,1207656901
7831,108426530,156180,108582710,0,6,0,34304,42,9927806948
7832,108442015,4679,108446694,0,4,1,12288,21,4036247234
7833,108449862,4420,108454282,0,6,1,11776,42,5075225420
7834,108462780,55562,108518342,0,4,1,94720,21,6988682688
7835,108480344,12737,108493081,0,9,1,24576,20,7724553961
7836,108509009,216364,108725373,0,4,0,112640,21,4883268981
7837,108517320,1518,108518838,0,9,1,1536,20,6294049226
7838,108518062,2946,108521008,0,9,1,3072,20,791223984
7839,108519740,115101,108634841,0,4,0,2560,21,4833441597
7840,108523063,566,108523629,0,9,1,512,20,6088070457
7841,108566383,1994,108568377,0,6,1,2048,42,3138938208
7842,108570424,5802,108576226,0,9,1,6144,20,10052435762
7843,108597338,94688,108692026,0,9,0,20992,20,10010415101
7844,108683997,8044,108692041,0,9,1,2560,20,3900987139
7845,108685350,40038,108725388,0,4,1,8192,21,3611765433
7846,108697779,2470,108700249,0,9,1,2560,20,3411851180
7847,108699446,7230,108706676,0,6,1,7680,42,9509823287
7848,108700045,105248,108805293,0,7,0,45568,41,8680140294
7849,108726682,156005,108882687,0,7,0,66560,41,2533371184
7850,108734127,101366,108835493,0,4,1,163840,21,6243739114
7851,108747871,566,108748437,0,9,1,512,20,8455121377
7852,108755015,3645,108758660,0,6,1,10240,42,6108847292
7853,108787827,55605,108843432,0,7,0,1536,41,3645176186
7854,108801384,3128,108804512,0,6,1,9216,42,9576202846
7855,108856753,1518,108858271,0,6,1,1536,42,4481785418
7856,108863687,1518,108865205,0,6,1,1536,42,8286966813
7857,108870969,64020,108934989,0,6,0,2048,42,786965658
7858,108873674,1994,108875668,0,6,1,2048,42,9893552680
7859,108873694,5316,108879010,0,6,1,12288,42,9704202203
7860,108894779,5971,108900750,0,4,1,14848,21,1232720106
7861,108926448,2946,108929394,0,9,1,3072,20,8056780430
7862,108944374,43904,108988278,0,4,0,512,21,3673680039
7863,108971549,4420,108975969,0,9,1,11776,20,9437989964
7864,108976004,5196,108981200,0,4,1,13312,21,5915761174
7865,108995016,3898,108998914,0,9,1,4096,20,4671816588
7866,109035916,3645,109039561,0,7,1,10240,41,1618865645
7867,109061593,25187,109086780,0,4,1,45568,21,7840424809
7868,109064749,257898,109322647,0,7,0,129024,41,6063893699
7869,109092432,4374,109096806,0,6,1,4608,42,8880600706
7870,109115649,207637,109323286,0,7,0,2048,41,888123135
7871,109123357,155200,109278557,0,4,0,1536,21,5653401670
7872,109131690,3422,109135112,0,7,1,3584,41,3328935098
7873,109135338,6278,109141616,0,9,1,6656,20,4393473880
7874,109143655,83288,109226943,0,9,0,13824,20,3742945244
7875,109145178,6278,109151456,0,8,1,6656,27,3785855580
7876,109148645,13083,109161728,0,7,1,22016,41,8543644935
7877,109180559,4937,109185496,0,4,1,12800,21,7249633968
7878,109192240,1994,109194234,0,7,1,2048,41,900109165
7879,109193071,4937,109198008,0,4,1,12800,21,4771240758
7880,109208122,10757,109218879,0,7,1,17408,41,6812995508
7881,109224567,99054,109323621,0,7,0,1024,41,6475282079
7882,109242299,80552,109322851,0,9,0,19968,20,2326432429
7883,109250040,1042,109251082,0,7,1,1024,41,9095308394
7884,109252300,72426,109324726,0,7,0,512,41,496369409
7885,109315836,10499,109326335,0,4,1,16896,21,7314842479
7886,109317318,72008,109389326,0,7,0,512,41,2835387485
7887,109332602,4850,109337452,0,6,1,5120,42,9254327275
7888,109336201,43904,109380105,0,7,0,512,41,6614616720
7889,109362311,43904,109406215,0,7,0,512,41,73933957
7890,109383987,6278,109390265,0,6,1,6656,42,8222153888
7891,109394102,566,109394668,0,6,1,512,42,2585826074
7892,109405347,43904,109449251,0,4,0,512,21,4258744885
7893,109417895,68840,109486735,0,9,0,11776,20,8338098317
7894,109437554,107900,109545454,0,9,0,54272,20,3968152110
7895,109441874,7706,109449580,0,6,1,8192,42,222121443
7896,109452572,566,109453138,0,7,1,512,41,6236400502
7897,109474713,566,109475279,0,6,1,512,42,7539137720
7898,109482650,50672,109533322,0,4,0,2560,21,816847411
7899,109499895,4374,109504269,0,7,1,4608,41,2037532200
7900,109509437,2470,109511907,0,7,1,2560,41,10116761366
7901,109518280,43904,109562184,0,7,0,512,41,7208500627
7902,109556188,1518,109557706,0,6,1,1536,42,818900022
7903,109572947,4850,109577797,0,6,1,5120,42,2127259062
7904,109585998,48980,109634978,0,7,0,2048,41,6343592608
7905,109587473,99164,109686637,0,9,0,25600,20,3554205106
7906,109616531,22691,109639222,0,4,1,37376,21,1076564683
7907,109630017,4976,109634993,0,7,1,11776,41,5566550160
7908,109637644,2870,109640514,0,3,1,8704,4,7840849004
7909,109643085,5326,109648411,0,6,1,5632,42,6321361957
7910,109647225,1042,109648267,0,7,1,1024,41,10265152907
7911,109664355,12049,109676404,0,7,1,19968,41,7277934717
7912,109675343,43904,109719247,0,4,0,512,21,5782864933
7913,109729315,43904,109773219,0,7,0,512,41,5132882722
7914,109744721,99008,109843729,0,9,0,25088,20,2080687187
7915,109745252,79436,109824688,0,5,0,11264,46,10607815040
7916,109746683,43904,109790587,0,7,0,512,41,2781224130
7917,109750384,103812,109854196,0,9,0,34304,20,9262640811
7918,109758325,47288,109805613,0,4,0,1536,21,3744561680
7919,109796055,101192,109897247,0,5,0,32256,46,9264261555
7920,109821984,6754,109828738,0,7,1,7168,41,10668499831
7921,109829157,1518,109830675,0,6,1,1536,42,8492176258
7922,109833284,566,109833850,0,7,1,512,41,8127674943
7923,109837452,14545,109851997,0,4,1,28160,21,1053003350
7924,109849278,3385,109852663,0,4,1,1024,21,5977220113
7925,109867767,566,109868333,0,7,1,512,41,6542028252
7926,109888421,43904,109932325,0,7,0,512,41,10330342180
7927,109888776,4162,109892938,0,7,1,11264,41,8115342789
7928,109932754,107432,110040186,0,9,0,52736,20,1164315645
7929,109933408,3422,109936830,0,6,1,3584,42,6866122153
7930,109951533,3422,109954955,0,9,1,3584,20,866754503
7931,109959337,5802,109965139,0,9,1,6144,20,8298724405
7932,109967755,63620,110031375,0,4,1,107008,21,2111063535
7933,109970657,123127,110093784,0,4,0,512,21,44869558
7934,110003744,97604,110101348,0,5,0,20480,46,9948100251
7935,110019088,77924,110097012,0,4,0,1024,21,5760197711
7936,110019126,18560,110037686,0,4,1,22016,21,6267169026
7937,110026226,47288,110073514,0,7,0,1536,41,1424502573
7938,110032172,43904,110076076,0,7,0,512,41,2951707814
7939,110050540,70207,110120747,0,4,0,2048,21,8241653481
7940,110053005,107744,110160749,0,9,0,53760,20,77150404
7941,110069035,97189,110166224,0,9,0,17920,20,8244275023
7942,110071454,45712,110117166,0,4,0,512,21,5399527073
7943,110102068,35829,110137897,0,4,1,62976,21,1024864737
7944,110139330,2470,110141800,0,7,1,2560,41,1975723183
7945,110141991,566,110142557,0,9,1,512,20,3925341365
7946,110147644,21994,110169638,0,9,1,3584,20,10652256410
7947,110168107,3157,110171264,0,9,1,2560,20,8940454688
7948,110185372,43904,110229276,0,7,0,512,41,10142884911
7949,110187571,3904,110191475,0,7,1,10752,41,4349891201
7950,110187706,1994,110189700,0,2,1,2048,8,10570274481
7951,110187937,3069,110191006,0,2,1,2048,8,3796436618
7952,110191022,566,110191588,0,9,1,512,20,4650902325
7953,110213059,12825,110225884,0,9,1,21504,20,4251149694
7954,110235856,3898,110239754,0,2,1,4096,8,1999438298
7955,110243200,566,110243766,0,2,1,512,8,5435726051
7956,110263591,566,110264157,0,6,1,512,42,6219839607
7957,110270613,48980,110319593,0,4,0,2048,21,2932044965
7958,110298030,106808,110404838,0,9,0,50688,20,5250771675
7959,110306844,7706,110314550,0,2,1,8192,8,5649345560
7960,110333084,566,110333650,0,2,1,512,8,3874574923
7961,110333638,1042,110334680,0,9,1,1024,20,2218827105
7962,110336086,6278,110342364,0,6,1,6656,42,6231831806
7963,110340098,4162,110344260,0,9,1,11264,20,2967101501
7964,110354029,2470,110356499,0,7,1,2560,41,957156613
7965,110357821,1994,110359815,0,2,1,2048,8,8289109016
7966,110371644,1518,110373162,0,2,1,1536,8,8407133761
7967,110374215,77104,110451319,0,4,1,130048,21,2754325782
7968,110387620,1042,110388662,0,9,1,1024,20,8446415399
7969,110387847,1518,110389365,0,7,1,1536,41,8515942166
7970,110388252,118335,110506587,0,9,0,38400,20,482673674
7971,110395155,115337,110510492,0,4,0,1024,21,4286482940
7972,110413155,1518,110414673,0,2,1,1536,8,5986715209
7973,110426310,25573,110451883,0,4,1,10752,21,5861028779
7974,110433894,113984,110547878,0,5,0,74240,46,5754035611
7975,110435543,17620,110453163,0,4,1,14336,21,4462057757
7976,110436936,95607,110532543,0,4,0,512,21,5990702230
7977,110463395,1994,110465389,0,6,1,2048,42,2150056944
7978,110473227,22950,110496177,0,4,1,37888,21,9830951058
7979,110489423,2470,110491893,0,2,1,2560,8,4804996808
7980,110531095,566,110531661,0,9,1,512,20,5849817568
7981,110550015,6754,110556769,0,9,1,7168,20,1758882263
7982,110556648,4850,110561498,0,7,1,5120,41,2425550862
7983,110572496,2470,110574966,0,2,1,2560,8,6159795891
7984,110577944,3898,110581842,0,2,1,4096,8,771308867
7985,110582829,7706,110590535,0,2,1,8192,8,2005084496
7986,110583807,48980,110632787,0,7,0,2048,41,2103927415
7987,110598014,6754,110604768,0,6,1,7168,42,1032428171
7988,110615360,106496,110721856,0,5,0,49664,46,6458406321
7989,110616559,2946,110619505,0,2,1,3072,8,7885286165
7990,110623130,3387,110626517,0,2,1,9728,8,5985422371
7991,110639385,22691,110662076,0,4,1,37376,21,2168841801
7992,110655784,115962,110771746,0,5,0,35840,46,8903043828
7993,110656228,120068,110776296,0,9,0,94208,20,9804283840
7994,110684958,43904,110728862,0,7,0,512,41,7894812688
7995,110687232,3128,110690360,0,9,1,9216,20,10367809867
7996,110698592,2870,110701462,0,2,1,8704,8,8749538301
7997,110704994,3128,110708122,0,6,1,9216,42,3216419202
7998,110726985,43904,110770889,0,7,0,512,41,7401713163
7999,110732730,2946,110735676,0,2,1,3072,8,5906555576
8000,110758946,47288,110806234,0,7,0,1536,41,839749827
8001,110789264,2946,110792210,0,6,1,3072,42,4156102297
8002,110812688,2470,110815158,0,9,1,2560,20,1101266203
8003,110864095,48980,110913075,0,5,0,2048,46,1143746028
8004,110866922,54012,110920934,0,4,1,91648,21,7300037662
8005,110871913,74984,110946897,0,9,0,11776,20,6312575306
8006,110890132,566,110890698,0,2,1,512,8,9533508554
8007,110895432,1042,110896474,0,6,1,1024,42,2017930863
8008,110897838,7706,110905544,0,9,1,8192,20,2775140094
8009,110906220,1994,110908214,0,2,1,2048,8,4518848841
8010,110949585,79928,111029513,0,9,0,17920,20,8152348967
8011,110962100,23637,110985737,0,4,1,42496,21,8247352231
8012,110981388,6935,110988323,0,4,1,4096,21,6179502719
8013,110983285,1994,110985279,0,6,1,2048,42,8893533370
8014,111026327,37198,111063525,0,9,1,59392,20,3905088061
8015,111032922,41637,111074559,0,9,1,44544,20,6810548789
8016,111036910,1042,111037952,0,2,1,1024,8,2599548094
8017,111049389,2470,111051859,0,6,1,2560,42,2211648509
8018,111051961,5712,111057673,0,4,1,14336,21,7578066320
8019,111063538,2946,111066484,0,4,1,3072,21,7364331832
8020,111065783,43904,111109687,0,7,0,512,41,2812470120
8021,111078604,1994,111080598,0,4,1,2048,21,6053481870
8022,111087186,43904,111131090,0,7,0,512,41,6867933903
8023,111103040,111019,111214059,0,9,0,37376,20,7075132663
8024,111103398,3422,111106820,0,2,1,3584,8,10150776180
8025,111106459,45596,111152055,0,4,0,1024,21,6740803327
8026,111118025,3387,111121412,0,2,1,9728,8,1817659900
8027,111119613,107116,111226729,0,4,0,1024,21,72883780
8028,111140578,566,111141144,0,2,1,512,8,4954387688
8029,111144117,258549,111402666,0,9,0,2560,20,3250918051
8030,111149870,106514,111256384,0,9,0,34816,20,3189356734
8031,111160557,74867,111235424,0,9,1,122368,20,1004124854
8032,111184607,217249,111401856,0,9,0,126464,20,5951175753
8033,111187026,116168,111303194,0,5,0,81408,46,4539893090
8034,111194193,4850,111199043,0,6,1,5120,42,1866952720
8035,111196612,4374,111200986,0,4,1,4608,21,6967077748
8036,111222099,1518,111223617,0,4,1,1536,21,5265481099
8037,111234733,256200,111490933,0,9,0,145408,20,1310954621
8038,111248686,3898,111252584,0,2,1,4096,8,5760184865
8039,111250279,43904,111294183,0,7,0,512,41,9020876535
8040,111251014,10212,111261226,0,9,1,5120,20,4278457852
8041,111267624,3387,111271011,0,4,1,9728,21,9175876209
8042,111271610,1042,111272652,0,6,1,1024,42,4953815805
8043,111273576,102674,111376250,0,5,0,21504,46,402520246
8044,111276298,566,111276864,0,6,1,512,42,4961214517
8045,111280416,273706,111554122,0,9,0,8704,20,8799581922
8046,111295993,4850,111300843,0,6,1,5120,42,8630521274
8047,111304915,48980,111353895,0,7,0,2048,41,7863996672
8048,111306525,2946,111309471,0,2,1,3072,8,684482077
8049,111312155,89716,111401871,0,9,1,82944,20,10606025540
8050,111328039,566,111328605,0,2,1,512,8,1293195110
8051,111343526,192752,111536278,0,9,0,35840,20,9453321189
8052,111344247,566,111344813,0,2,1,512,8,6988641720
8053,111357058,82149,111439207,0,9,1,133120,20,10259563659
8054,111360258,566,111360824,0,6,1,512,42,4816610991
8055,111409139,1042,111410181,0,4,1,1024,21,6827367628
8056,111437756,4850,111442606,0,4,1,5120,21,9124588865
8057,111442360,3904,111446264,0,2,1,10752,8,2467151431
8058,111469298,33418,111502716,0,9,1,19456,20,919030396
8059,111471651,45596,111517247,0,7,0,1024,41,8911250561
8060,111486181,43904,111530085,0,7,0,512,41,7082202134
8061,111487273,3387,111490660,0,2,1,9728,8,3576696818
8062,111501435,43904,111545339,0,7,0,512,41,5205040678
8063,111502272,566,111502838,0,2,1,512,8,4415803582
8064,111506078,43904,111549982,0,4,0,512,21,8973719267
8065,111510803,566,111511369,0,6,1,512,42,4237410390
8066,111512607,4374,111516981,0,4,1,4608,21,5401398204
8067,111515629,2978,111518607,0,4,1,2560,21,1733935732
8068,111521142,43904,111565046,0,4,0,512,21,6930658720
8069,111550356,3422,111553778,0,2,1,3584,8,5896651197
8070,111567294,21141,111588435,0,9,1,34304,20,7485106909
8071,111568334,5326,111573660,0,5,1,5632,46,10140170650
8072,111591574,47288,111638862,0,4,0,1536,21,9101954535
8073,111600825,2946,111603771,0,4,1,3072,21,4688479385
8074,111609416,111192,111720608,0,6,0,53760,42,1657264659
8075,111655333,1042,111656375,0,6,1,1024,42,2481008529
8076,111656422,3422,111659844,0,1,1,3584,36,4180453719
8077,111679924,2946,111682870,0,2,1,3072,8,4251596746
8078,111701697,3422,111705119,0,2,1,3584,8,6461414392
8079,111711186,45596,111756782,0,4,0,1024,21,9575008194
8080,111732355,47288,111779643,0,7,0,1536,41,3271079649
8081,111743266,15579,111758845,0,9,1,30208,20,5409008301
8082,111753736,48274,111802010,0,4,0,1024,21,4751281603
8083,111760004,4937,111764941,0,6,1,12800,42,8323802351
8084,111798780,127244,111926024,0,5,0,117760,46,7296638819
8085,111819089,73916,111893005,0,9,0,13312,20,5614725206
8086,111823149,45596,111868745,0,9,0,1024,20,5628099638
8087,111837979,4374,111842353,0,2,1,4608,8,1364352891
8088,111842629,14287,111856916,0,9,1,27648,20,1118802730
8089,111863029,3128,111866157,0,2,1,9216,8,4037019887
8090,111864591,43904,111908495,0,7,0,512,41,2948949417
8091,111869154,58609,111927763,0,5,0,5632,46,3607425948
8092,111915154,2870,111918024,0,9,1,8704,20,4825704107
8093,111922469,90843,112013312,0,5,0,16896,46,8483412642
8094,111943236,107627,112050863,0,2,0,32256,8,2518240164
8095,111986492,45596,112032088,0,7,0,1024,41,787573858
8096,112023761,43904,112067665,0,4,0,512,21,8668707208
8097,112055521,6754,112062275,0,3,1,7168,4,3543994113
8098,112068694,45752,112114446,0,7,0,1536,41,6053823675
8099,112129275,102128,112231403,0,9,0,35328,20,5278513804
8100,112163381,4420,112167801,0,3,1,11776,4,10275330800
8101,112191755,50672,112242427,0,4,0,2560,21,3553314839
8102,112241029,99788,112340817,0,9,0,27648,20,6093362359
8103,112256842,104000,112360842,0,5,0,41472,46,6985971586
8104,112262107,86252,112348359,0,9,0,23552,20,7571758951
8105,112275834,7706,112283540,0,4,1,8192,21,5630779274
8106,112294858,7706,112302564,0,3,1,8192,4,998223797
8107,112304095,94688,112398783,0,5,0,20992,46,8097705822
8108,112330518,43904,112374422,0,4,0,512,21,7269928955
8109,112351983,7230,112359213,0,3,1,7680,4,8443835866
8110,112352630,43904,112396534,0,4,0,512,21,4566407172
8111,112363537,24154,112387691,0,9,1,43520,20,9283537285
8112,112364897,119381,112484278,0,9,0,52736,20,8766686196
8113,112366207,159527,112525734,0,9,0,46592,20,1882510433
8114,112401081,20366,112421447,0,9,1,32768,20,8648268934
8115,112404921,23247,112428168,0,9,1,32256,20,8499801031
8116,112421897,129740,112551637,0,5,0,125952,46,8029208205
8117,112441380,5802,112447182,0,9,1,6144,20,758874458
8118,112448804,14804,112463608,0,9,1,28672,20,1687563380
8119,112453359,2470,112455829,0,3,1,2560,4,3833906641
8120,112478182,4162,112482344,0,3,1,11264,4,359265569
8121,112510192,1042,112511234,0,4,1,1024,21,2878404394
8122,112511243,202060,112713303,0,9,0,30720,20,7690229415
8123,112539790,10499,112550289,0,3,1,16896,4,2278270193
8124,112548082,30491,112578573,0,9,1,49152,20,8398996122
8125,112576883,3422,112580305,0,4,1,3584,21,9521751005
8126,112607282,4850,112612132,0,3,1,5120,4,4885204377
8127,112629459,260937,112890396,0,9,0,87552,20,7221988107
8128,112644194,43904,112688098,0,4,0,512,21,149227582
8129,112657400,7230,112664630,0,4,1,7680,21,8571052514
8130,112690294,43904,112734198,0,4,0,512,21,2887775184
8131,112700839,43975,112744814,0,9,1,72192,20,9379851581
8132,112711653,1518,112713171,0,3,1,1536,4,10253224469
8133,112749452,95312,112844764,0,9,0,23040,20,33533713
8134,112781535,124147,112905682,0,9,0,35328,20,7232978672
8135,112782802,401084,113183886,0,9,0,55296,20,10173118107
8136,112800519,1518,112802037,0,3,1,1536,4,2184690678
8137,112848677,94868,112943545,0,9,0,26624,20,10417153342
8138,112862679,3904,112866583,0,4,1,10752,21,9947914260
8139,112889207,2470,112891677,0,2,1,2560,8,3768544091
8140,112894818,1994,112896812,0,2,1,2048,8,205142449
8141,112901934,26948,112928882,0,9,1,38400,20,6788074717
8142,112921392,45596,112966988,0,4,0,1024,21,486742458
8143,112933905,70976,113004881,0,5,0,8704,46,5840943170
8144,112944656,1042,112945698,0,3,1,1024,4,1503231941
8145,112959904,43904,113003808,0,4,0,512,21,3217220297
8146,112961708,45596,113007304,0,4,0,1024,21,1468248789
8147,112962889,129550,113092439,0,5,0,68096,46,9209957679
8148,112973215,3128,112976343,0,2,1,9216,8,10040602629
8149,112998277,15062,113013339,0,9,1,29184,20,926723824
8150,113015574,10499,113026073,0,7,1,16896,41,2295728888
8151,113019157,164744,113183901,0,9,1,247296,20,8928540017
8152,113030209,566,113030775,0,2,1,512,8,912939124
8153,113031039,45596,113076635,0,4,0,1024,21,9795341526
8154,113045047,47288,113092335,0,4,0,1536,21,8283995267
8155,113090828,93088,113183916,0,9,1,2048,20,6982235765
8156,113113189,3898,113117087,0,7,1,4096,41,6138894031
8157,113150895,33036,113183931,0,9,1,1536,20,822411713
8158,113172440,47288,113219728,0,4,0,1536,21,112425673
8159,113174593,566,113175159,0,6,1,512,42,3811322264
8160,113216282,1518,113217800,0,7,1,1536,41,8343605035
8161,113229138,239172,113468310,0,9,0,65024,20,5877089494
8162,113237834,10499,113248333,0,7,1,16896,41,5633780773
8163,113252748,566,113253314,0,2,1,512,8,6689775428
8164,113283138,1042,113284180,0,2,1,1024,8,7563138619
8165,113302406,183235,113485641,0,9,0,56832,20,7509310042
8166,113313702,112424,113426126,0,5,0,69120,46,9666822382
8167,113330687,4374,113335061,0,2,1,4608,8,2552553443
8168,113338952,5802,113344754,0,8,1,6144,27,9041956041
8169,113344710,201813,113546523,0,9,0,50176,20,4051996896
8170,113363643,167577,113531220,0,9,0,43520,20,4895185789
8171,113377166,2946,113380112,0,7,1,3072,41,799354547
8172,113382357,1042,113383399,0,7,1,1024,41,4811688030
8173,113382810,127916,113510726,0,5,0,47104,46,482919257
8174,113389219,1042,113390261,0,6,1,1024,42,4291656636
8175,113411545,1518,113413063,0,9,1,1536,20,8481363888
8176,113444085,50672,113494757,0,4,0,2560,21,5477494192
8177,113450747,1042,113451789,0,2,1,1024,8,5867617037
8178,113469474,1994,113471468,0,7,1,2048,41,6599499820
8179,113474295,86855,113561150,0,5,0,8704,46,5778206970
8180,113475375,5802,113481177,0,3,1,6144,4,2435687903
8181,113507002,6754,113513756,0,9,1,7168,20,4884494873
8182,113512215,45596,113557811,0,4,0,1024,21,4976519720
8183,113536642,16151,113552793,0,9,1,6656,20,3851243804
8184,113543244,1518,113544762,0,2,1,1536,8,5583135873
8185,113560489,45596,113606085,0,4,0,1024,21,80018525
8186,113591159,43904,113635063,0,4,0,512,21,9024153028
8187,113593877,78368,113672245,0,5,0,12800,46,1493026091
8188,113600788,105955,113706743,0,9,0,47104,20,1770234766
8189,113663941,7706,113671647,0,3,1,8192,4,4592343258
8190,113672920,566,113673486,0,7,1,512,41,9841280594
8191,113696225,12504,113708729,0,9,1,2048,20,8588971238
8192,113716215,6278,113722493,0,9,1,6656,20,8137125303
8193,113717892,45596,113763488,0,4,0,1024,21,165439963
8194,113726939,1518,113728457,0,7,1,1536,41,2464803499
8195,113753118,1042,113754160,0,9,1,1024,20,749119373
8196,113794720,100412,113895132,0,9,0,29696,20,733146645
8197,113819627,54524,113874151,0,5,0,5120,46,2010149212
8198,113823120,11274,113834394,0,7,1,18432,41,6594423820
8199,113839036,4162,113843198,0,3,1,11264,4,6881019550
8200,113870023,2470,113872493,0,3,1,2560,4,9596578832
8201,113957021,110084,114067105,0,5,0,61440,46,6381693840
8202,113973610,99944,114073554,0,9,0,28160,20,4598729235
8203,114002257,43904,114046161,0,4,0,512,21,456467567
8204,114114982,2470,114117452,0,9,1,2560,20,4905704247
8205,114132824,566,114133390,0,7,1,512,41,9628576076
8206,114221587,4679,114226266,0,3,1,12288,4,9035625308
8207,114239067,3422,114242489,0,6,1,3584,42,169639043
8208,114243565,45596,114289161,0,4,0,1024,21,1658579173
8209,114268453,1518,114269971,0,6,1,1536,42,5903732407
8210,114280714,1042,114281756,0,9,1,1024,20,9898449940
8211,114330050,3128,114333178,0,6,1,9216,42,3442010768
8212,114429696,566,114430262,0,4,1,512,21,2247812826
8213,114431262,43904,114475166,0,4,0,512,21,3420702909
8214,114444474,43904,114488378,0,4,0,512,21,6866136808
8215,114486503,3387,114489890,0,8,1,9728,27,2643537585
8216,114491459,47288,114538747,0,9,0,1536,20,6305496913
8217,114531765,43904,114575669,0,4,0,512,21,2229824370
8218,114544654,83288,114627942,0,5,0,13824,46,5201134054
8219,114565707,125805,114691512,0,5,0,34816,46,2893178803
8220,114605119,93596,114698715,0,9,0,17408,20,8060729752
8221,114679568,43904,114723472,0,4,0,512,21,10691714544
8222,114684860,114211,114799071,0,9,0,47104,20,1562228182
8223,114735376,43904,114779280,0,4,0,512,21,9796857234
8224,114772931,2470,114775401,0,8,1,2560,27,8131831610
8225,114773642,5444,114779086,0,8,1,5632,27,3148039010
8226,114792872,43904,114836776,0,4,0,512,21,7816086897
8227,114873680,566,114874246,0,8,1,512,27,1199894767
8228,114885521,87320,114972841,0,1,0,22016,36,4892212357
8229,114887076,43904,114930980,0,5,0,512,46,7517011062
8230,114920733,11274,114932007,0,8,1,18432,27,441146594
8231,114948644,45596,114994240,0,5,0,1024,46,288325810
8232,115012037,4420,115016457,0,8,1,11776,27,4355432888
8233,115027221,115388,115142609,0,9,0,78848,20,1264652507
8234,115035917,45596,115081513,0,5,0,1024,46,792273031
8235,115066543,566,115067109,0,8,1,512,27,9859660546
8236,115084623,48980,115133603,0,5,0,2048,46,2058948063
8237,115084672,7706,115092378,0,8,1,8192,27,4193528559
8238,115089354,1042,115090396,0,5,1,1024,46,495889661
8239,115095465,45596,115141061,0,4,0,1024,21,2702675892
8240,115158386,45596,115203982,0,4,0,1024,21,2695736120
8241,115165647,4162,115169809,0,5,1,11264,46,1228537492
8242,115178701,47288,115225989,0,5,0,1536,46,2789755987
8243,115210648,3898,115214546,0,8,1,4096,27,4006444440
8244,115247280,100100,115347380,0,9,0,28672,20,2510931594
8245,115247408,4850,115252258,0,5,1,5120,46,4485142693
8246,115263111,566,115263677,0,8,1,512,27,5668035126
8247,115266328,57795,115324123,0,5,0,512,46,6916570807
8248,115290239,2470,115292709,0,7,1,2560,41,5727079993
8249,115297304,3387,115300691,0,7,1,9728,41,2327039852
8250,115302328,1042,115303370,0,5,1,1024,46,268151893
8251,115336102,566,115336668,0,7,1,512,41,2977235544
8252,115347677,43904,115391581,0,5,0,512,46,3825734258
8253,115359943,45596,115405539,0,4,0,1024,21,93264868
8254,115366799,5326,115372125,0,5,1,5632,46,1041592138
8255,115387320,2946,115390266,0,7,1,3072,41,3142441090
8256,115397485,43904,115441389,0,5,0,512,46,6777565172
8257,115424014,101504,115525518,0,9,0,33280,20,2147226960
8258,115428816,2470,115431286,0,5,1,2560,46,6944690136
8259,115461306,122230,115583536,0,5,0,512,46,3043962951
8260,115471136,1994,115473130,0,7,1,2048,41,7314450058
8261,115604398,4374,115608772,0,5,1,4608,46,9852192452
8262,115642755,94400,115737155,0,9,0,25088,20,9433867272
8263,115647700,5326,115653026,0,1,1,5632,36,3453910081
8264,115658524,47288,115705812,0,4,0,1536,21,6235283122
8265,115674244,3898,115678142,0,1,1,4096,36,7079691890
8266,115682657,3898,115686555,0,1,1,4096,36,9163336380
8267,115693000,1518,115694518,0,1,1,1536,36,8750932239
8268,115702010,124731,115826741,0,9,0,91136,20,3907419361
8269,115732476,6278,115738754,0,1,1,6656,36,1851012635
8270,115734411,4374,115738785,0,5,1,4608,46,10471710466
8271,115760226,45596,115805822,0,5,0,1024,46,8677568002
8272,115771170,1994,115773164,0,1,1,2048,36,4551270862
8273,115773991,43904,115817895,0,5,0,512,46,803589375
8274,115809041,45596,115854637,0,4,0,1024,21,9996195202
8275,115820869,47444,115868313,0,4,0,2048,21,3601439614
8276,115870487,120692,115991179,0,9,0,96256,20,4783472096
8277,115876540,13083,115889623,0,1,1,22016,36,4058976034
8278,115895915,45596,115941511,0,4,0,1024,21,9678098294
8279,115926544,566,115927110,0,7,1,512,41,1704878766
8280,115937569,2470,115940039,0,5,1,2560,46,633234784
8281,115938659,68732,116007391,0,9,0,1024,20,9260067172
8282,115960143,1994,115962137,0,1,1,2048,36,6651981840
8283,116006250,54056,116060306,0,9,0,3584,20,2723697063
8284,116017389,94759,116112148,0,5,0,512,46,6692671072
8285,116035922,7230,116043152,0,7,1,7680,41,95334228
8286,116042016,1042,116043058,0,9,1,1024,20,9859510481
8287,116049660,110240,116159900,0,9,0,61952,20,9059202652
8288,116083327,2946,116086273,0,1,1,3072,36,4030925839
8289,116094044,52364,116146408,0,4,0,3072,21,10161961845
8290,116098117,11274,116109391,0,1,1,18432,36,6597101970
8291,116121225,6278,116127503,0,9,1,6656,20,6290562731
8292,116155454,4850,116160304,0,7,1,5120,41,3614114967
8293,116156133,6705,116162838,0,9,1,3072,20,2774590481
8294,116161663,3898,116165561,0,9,1,4096,20,1633380573
8295,116199822,5326,116205148,0,5,1,5632,46,620169644
8296,116225803,43904,116269707,0,4,0,512,21,702985333
8297,116257213,43904,116301117,0,5,0,512,46,6299018830
8298,116263704,20882,116284586,0,7,1,33792,41,7792267976
8299,116314392,47288,116361680,0,4,0,1536,21,2480530580
8300,116336814,10241,116347055,0,9,1,16384,20,3186477201
8301,116345220,7230,116352450,0,9,1,7680,20,3406019999
8302,116347672,4850,116352522,0,5,1,5120,46,10151093604
8303,116352171,3898,116356069,0,9,1,4096,20,9750822872
8304,116365818,1994,116367812,0,1,1,2048,36,10388633924
8305,116369023,566,116369589,0,7,1,512,41,3603547368
8306,116396067,2470,116398537,0,4,1,2560,21,4103332981
8307,116402623,1042,116403665,0,1,1,1024,36,7676614842
8308,116412201,6754,116418955,0,4,1,7168,21,4216718086
8309,116420954,1994,116422948,0,7,1,2048,41,3817949605
8310,116422805,43904,116466709,0,5,0,512,46,2119280890
8311,116431537,1042,116432579,0,9,1,1024,20,2575156613
8312,116449546,3904,116453450,0,7,1,10752,41,7046397331
8313,116454014,4850,116458864,0,1,1,5120,36,2168817267
8314,116455076,6374,116461450,0,1,1,4096,36,4165289365
8315,116456084,5802,116461886,0,7,1,6144,41,7771478405
8316,116469937,1518,116471455,0,5,1,1536,46,1061597512
8317,116477599,3128,116480727,0,5,1,9216,46,4736886834
8318,116478890,168668,116647558,0,9,0,68608,20,8622964845
8319,116481384,43904,116525288,0,5,0,512,46,9207453713
8320,116500289,3128,116503417,0,9,1,9216,20,10474977467
8321,116520213,43904,116564117,0,4,0,512,21,5994666357
8322,116523755,43904,116567659,0,5,0,512,46,1782135791
8323,116554020,6278,116560298,0,4,1,6656,21,3209269891
8324,116577668,1518,116579186,0,7,1,1536,41,10303263675
8325,116580513,1042,116581555,0,9,1,1024,20,5933766532
8326,116582501,1042,116583543,0,4,1,1024,21,6546229994
8327,116587205,43904,116631109,0,5,0,512,46,8666394744
8328,116600952,3898,116604850,0,1,1,4096,36,1744345218
8329,116608126,1994,116610120,0,1,1,2048,36,6358604858
8330,116647168,2946,116650114,0,3,1,3072,4,3513318408
8331,116667485,2470,116669955,0,9,1,2560,20,3581205348
8332,116691578,7230,116698808,0,1,1,7680,36,2543399292
8333,116694794,82982,116777776,0,9,0,16896,20,9574846919
8334,116723002,1042,116724044,0,9,1,1024,20,2967973333
8335,116744933,43904,116788837,0,5,0,512,46,7809805450
8336,116748574,45596,116794170,0,4,0,1024,21,5031582278
8337,116756999,81284,116838283,0,9,0,12288,20,7832949030
8338,116769728,4420,116774148,0,4,1,11776,21,7915027152
8339,116780182,4374,116784556,0,7,1,4608,41,6919296083
8340,116782634,566,116783200,0,1,1,512,36,2832689331
8341,116804828,3898,116808726,0,9,1,4096,20,5689234826
8342,116839367,3422,116842789,0,4,1,3584,21,707024899
8343,116844453,43904,116888357,0,5,0,512,46,5129118384
8344,116847477,183800,117031277,0,9,0,157184,20,511917962
8345,116850046,43904,116893950,0,4,0,512,21,4964206721
8346,116850739,3387,116854126,0,7,1,9728,41,944880360
8347,116858357,7706,116866063,0,7,1,8192,41,1654583860
8348,116859889,3422,116863311,0,1,1,3584,36,6307014878
8349,116860888,4304,116865192,0,1,1,11264,36,2827194976
8350,116863626,566,116864192,0,4,1,512,21,718683227
8351,116872673,3645,116876318,0,9,1,10240,20,3089988712
8352,116873958,566,116874524,0,1,1,512,36,2108588200
8353,116887963,4679,116892642,0,9,1,12288,20,4820790776
8354,116920311,101816,117022127,0,4,0,34304,21,8087649609
8355,116950705,6754,116957459,0,4,1,7168,21,9242319001
8356,116961868,70516,117032384,0,9,0,3584,20,9333422131
8357,116966263,566,116966829,0,4,1,512,21,5360502578
8358,116971252,100303,117071555,0,4,0,12800,21,9385081536
8359,117005185,45596,117050781,0,5,0,1024,46,5098641317
8360,117068917,45596,117114513,0,5,0,1024,46,7028595133
8361,117095155,43904,117139059,0,5,0,512,46,10482146141
8362,117097551,87452,117185003,0,4,0,17408,21,5584646294
8363,117098165,52988,117151153,0,9,0,5120,20,2886237049
8364,117113820,43904,117157724,0,5,0,512,46,10263188843
8365,117120962,100256,117221218,0,4,0,29184,21,8869396436
8366,117136626,1042,117137668,0,4,1,1024,21,4744807595
8367,117228331,2470,117230801,0,1,1,2560,36,5717793497
8368,117251450,54056,117305506,0,9,0,3584,20,10643760712
8369,117258745,1518,117260263,0,1,1,1536,36,6079661064
8370,117287934,7706,117295640,0,4,1,8192,21,7184326206
8371,117303817,4850,117308667,0,4,1,5120,21,231215804
8372,117317790,1994,117319784,0,4,1,2048,21,8676913836
8373,117326037,4850,117330887,0,1,1,5120,36,3279444338
8374,117335136,2470,117337606,0,4,1,2560,21,365064823
8375,117338804,4679,117343483,0,4,1,12288,21,4758242076
8376,117381010,2946,117383956,0,4,1,3072,21,7641140261
8377,117383646,5454,117389100,0,8,1,13824,27,4752024239
8378,117434595,1042,117435637,0,1,1,1024,36,2243953122
8379,117447319,122564,117569883,0,9,0,102400,20,1508431538
8380,117492246,2946,117495192,0,1,1,3072,36,6942970842
8381,117586674,64520,117651194,0,4,0,7680,21,2334367250
8382,117600592,2946,117603538,0,2,1,3072,8,430141079
8383,117669411,69284,117738695,0,4,0,8192,21,9867566632
8384,117670255,4679,117674934,0,2,1,12288,8,4974207188
8385,117675017,1994,117677011,0,8,1,2048,27,6611161735
8386,117690476,1994,117692470,0,5,1,2048,46,1276265171
8387,117714826,2470,117717296,0,5,1,2560,46,2823315126
8388,117731480,43904,117775384,0,5,0,512,46,4290512604
8389,117745004,4374,117749378,0,5,1,4608,46,3712539572
8390,117772023,122408,117894431,0,4,0,101888,21,5135830046
8391,117794469,2470,117796939,0,1,1,2560,36,4949584111
8392,117798453,106052,117904505,0,5,0,512,46,8070828710
8393,117817810,1518,117819328,0,5,1,1536,46,73197381
8394,117829108,121472,117950580,0,9,0,98816,20,2474688593
8395,117833686,127873,117961559,0,4,0,22528,21,6400730332
8396,117847321,5326,117852647,0,8,1,5632,27,3735327585
8397,117850297,145883,117996180,0,9,0,14336,20,10111228626
8398,117857572,3422,117860994,0,5,1,3584,46,291139998
8399,117860076,5802,117865878,0,8,1,6144,27,7355468805
8400,117877160,122623,117999783,0,9,0,11776,20,323953054
8401,117883944,2470,117886414,0,8,1,2560,27,7951494471
8402,117884601,5039,117889640,0,8,1,5120,27,5438900120
8403,117902620,2946,117905566,0,8,1,3072,27,3554393276
8404,117905077,4937,117910014,0,1,1,12800,36,394752145
8405,117915628,52076,117967704,0,9,0,1536,20,1266985496
8406,117929926,120746,118050672,0,9,0,28672,20,1880891898
8407,117943552,80493,118024045,0,9,0,11776,20,1428395131
8408,117956984,566,117957550,0,8,1,512,27,7656950004
8409,117984650,43904,118028554,0,5,0,512,46,7387123188
8410,118006366,114920,118121286,0,4,0,77312,21,9356016313
8411,118013033,124759,118137792,0,9,0,85504,20,8259817474
8412,118018502,169252,118187754,0,9,0,21504,20,8170582293
8413,118029671,43904,118073575,0,5,0,512,46,190811097
8414,118045640,145864,118191504,0,4,0,74752,21,2006504089
8415,118053943,566,118054509,0,5,1,512,46,6797646416
8416,118067024,3904,118070928,0,1,1,10752,36,8387012035
8417,118082903,4162,118087065,0,8,1,11264,27,9621229260
8418,118094732,43904,118138636,0,5,0,512,46,1724008534
8419,118115952,4850,118120802,0,8,1,5120,27,9871949759
8420,118138955,79436,118218391,0,6,0,11264,42,8165660032
8421,118210044,1994,118212038,0,1,1,2048,36,865331380
8422,118211612,6278,118217890,0,5,1,6656,46,1783495116
8423,118212043,113204,118325247,0,9,0,71680,20,2187952337
8424,118228100,76052,118304152,0,4,0,10240,21,3665651013
8425,118229417,43904,118273321,0,5,0,512,46,10721615699
8426,118265224,566,118265790,0,5,1,512,46,4576801386
8427,118270410,77313,118347723,0,9,0,2048,20,3918809950
8428,118276798,1518,118278316,0,5,1,1536,46,2755378957
8429,118299287,48980,118348267,0,5,0,2048,46,10628834493
8430,118318889,3422,118322311,0,1,1,3584,36,5651943007
8431,118343902,75920,118419822,0,9,0,14848,20,10256150225
8432,118358052,566,118358618,0,7,1,512,41,4953002712
8433,118374585,60224,118434809,0,1,0,8704,36,1326747542
8434,118387939,7230,118395169,0,8,1,7680,27,5553963844
8435,118388253,1994,118390247,0,6,1,2048,42,4384803996
8436,118393725,2470,118396195,0,9,1,2560,20,5966390083
8437,118414948,3898,118418846,0,3,1,4096,4,2525016958
8438,118418299,4937,118423236,0,8,1,12800,27,364871386
8439,118422846,13512,118436358,0,9,1,26112,20,3229787838
8440,118423892,43904,118467796,0,1,0,512,36,4175731058
8441,118423897,2946,118426843,0,8,1,3072,27,3576897660
8442,118425432,5712,118431144,0,8,1,14336,27,1811802669
8443,118428935,86828,118515763,0,6,0,15360,42,1767536572
8444,118437447,45596,118483043,0,5,0,1024,46,9852890860
8445,118438487,95336,118533823,0,1,0,28160,36,8260463810
8446,118462706,182917,118645623,0,9,0,10240,20,3521059538
8447,118484183,4374,118488557,0,5,1,4608,46,5918772896
8448,118485924,7230,118493154,0,1,1,7680,36,5967828864
8449,118491791,3422,118495213,0,7,1,3584,41,7073323215
8450,118494856,1042,118495898,0,7,1,1024,41,5564875929
8451,118514046,566,118514612,0,1,1,512,36,1730752332
8452,118514883,2470,118517353,0,1,1,2560,36,2653249437
8453,118531199,566,118531765,0,7,1,512,41,633453554
8454,118537610,2870,118540480,0,5,1,8704,46,2865046675
8455,118549674,3645,118553319,0,1,1,10240,36,7368602519
8456,118564106,2470,118566576,0,7,1,2560,41,2686457364
8457,118566019,146606,118712625,0,1,0,112128,36,5614343859
8458,118575290,55748,118631038,0,4,0,4096,21,9538531622
8459,118581177,2470,118583647,0,9,1,2560,20,7746119642
8460,118584124,5326,118589450,0,7,1,5632,41,6570016879
8461,118598565,117888,118716453,0,1,0,11264,36,7446863847
8462,118606440,101625,118708065,0,4,0,14848,21,4632572539
8463,118607569,147331,118754900,0,4,0,56320,21,1308836677
8464,118613639,154521,118768160,0,4,0,34304,21,7727247504
8465,118629253,2470,118631723,0,5,1,2560,46,3146715340
8466,118632641,49345,118681986,0,5,0,512,46,5528373198
8467,118640226,5412,118645638,0,9,1,4608,20,7175453474
8468,118648194,147376,118795570,0,1,0,53248,36,5073095514
8469,118660457,112268,118772725,0,6,0,68608,42,4363299094
8470,118665519,566,118666085,0,7,1,512,41,10372969231
8471,118688625,1042,118689667,0,8,1,1024,27,4870211805
8472,118705151,1518,118706669,0,5,1,1536,46,10265749032
8473,118718891,180111,118899002,0,1,0,64512,36,8106369030
8474,118745667,566,118746233,0,5,1,512,46,8142980087
8475,118746311,2870,118749181,0,9,1,8704,20,9656187922
8476,118769255,114608,118883863,0,4,0,76288,21,649072371
8477,118782782,6278,118789060,0,9,1,6656,20,3123343944
8478,118783484,3422,118786906,0,8,1,3584,27,594651062
8479,118806670,114764,118921434,0,9,0,76800,20,8736674616
8480,118810546,114826,118925372,0,1,0,13824,36,5916656945
8481,118830836,5802,118836638,0,7,1,6144,41,8072348356
8482,118844475,3422,118847897,0,5,1,3584,46,2761566093
8483,118846995,99320,118946315,0,6,0,26112,42,4854348788
8484,118851236,93240,118944476,0,1,0,26112,36,6681857637
8485,118851312,107342,118958654,0,6,0,40448,42,5893147484
8486,118881329,566,118881895,0,8,1,512,27,9903724310
8487,118883488,2946,118886434,0,9,1,3072,20,9668224597
8488,118884680,4850,118889530,0,4,1,5120,21,1261301860
8489,118889090,1994,118891084,0,8,1,2048,27,1581752781
8490,118891035,107900,118998935,0,4,0,54272,21,1410311031
8491,118892265,72064,118964329,0,4,0,5632,21,8393076544
8492,118899873,1518,118901391,0,7,1,1536,41,9624238159
8493,118906544,19732,118926276,0,9,1,5120,20,7822207457
8494,118913257,107731,119020988,0,6,0,12800,42,2025722171
8495,118928403,1518,118929921,0,9,1,1536,20,2784521326
8496,118935338,195035,119130373,0,9,0,33792,20,2471783097
8497,118938338,3898,118942236,0,7,1,4096,41,939673112
8498,118943875,161395,119105270,0,6,0,61440,42,3802297618
8499,118957528,3128,118960656,0,7,1,9216,41,7506467719
8500,118961661,88256,119049917,0,1,0,25088,36,9993199426
8501,118987928,1518,118989446,0,5,1,1536,46,976559612
8502,118990685,119730,119110415,0,4,0,66048,21,176050327
8503,118992359,2470,118994829,0,5,1,2560,46,3951739891
8504,118993568,139784,119133352,0,9,0,9728,20,6770729718
8505,119045471,156096,119201567,0,4,0,65536,21,8838460674
8506,119056405,2870,119059275,0,8,1,8704,27,5471451376
8507,119059361,2946,119062307,0,8,1,3072,27,5036414117
8508,119080191,145208,119225399,0,4,0,37888,21,7101848014
8509,119081159,2470,119083629,0,9,1,2560,20,5781859733
8510,119139794,3422,119143216,0,7,1,3584,41,9592243342
8511,119145335,13083,119158418,0,4,1,22016,21,9455564497
8512,119158988,5802,119164790,0,5,1,6144,46,7621627300
8513,119171590,1042,119172632,0,5,1,1024,46,6299932339
8514,119184336,4850,119189186,0,7,1,5120,41,741807972
8515,119195494,4162,119199656,0,9,1,11264,20,7708669156
8516,119210990,98696,119309686,0,1,0,24064,36,7927857563
8517,119213344,99008,119312352,0,9,0,25088,20,2179348253
8518,119217320,10065,119227385,0,4,1,2048,21,9411594587
8519,119221303,120224,119341527,0,6,0,94720,42,5971707915
8520,119224460,4850,119229310,0,9,1,5120,20,2880871927
8521,119275705,43904,119319609,0,4,0,512,21,6418554487
8522,119284395,5802,119290197,0,5,1,6144,46,5388223497
8523,119285170,117728,119402898,0,4,0,86528,21,2601068280
8524,119287305,129417,119416722,0,4,0,20992,21,2942827145
8525,119289679,3422,119293101,0,9,1,3584,20,10722313205
8526,119294054,7230,119301284,0,8,1,7680,27,5225082961
8527,119318878,4420,119323298,0,8,1,11776,27,8959229165
8528,119325775,2470,119328245,0,7,1,2560,41,10681741805
8529,119333230,71624,119404854,0,1,0,15872,36,4761517391
8530,119350026,1518,119351544,0,9,1,1536,20,8573428506
8531,119386264,1042,119387306,0,3,1,1024,4,10735258216
8532,119392230,4162,119396392,0,7,1,11264,41,510666166
8533,119413030,7588,119420618,0,4,1,10752,21,7979918412
8534,119423235,111546,119534781,0,9,0,9728,20,6070735219
8535,119425752,2470,119428222,0,3,1,2560,4,7531671201
8536,119426300,4508,119430808,0,3,1,4096,4,8342352561
8537,119445856,4937,119450793,0,8,1,12800,27,9740092580
8538,119446641,121472,119568113,0,1,0,98816,36,4833892873
8539,119449878,47444,119497322,0,6,0,2048,42,190204223
8540,119454473,4850,119459323,0,7,1,5120,41,5851503365
8541,119456377,163546,119619923,0,1,0,35840,36,9128101822
8542,119473849,1042,119474891,0,3,1,1024,4,4614533757
8543,119478896,4937,119483833,0,8,1,12800,27,967824337
8544,119506442,93573,119600015,0,1,0,15872,36,7131692581
8545,119518144,1994,119520138,0,7,1,2048,41,2336735258
8546,119528217,1994,119530211,0,1,1,2048,36,3701297024
8547,119528862,128947,119657809,0,4,0,59392,21,8759027577
8548,119529123,1994,119531117,0,8,1,2048,27,5993490570
8549,119536891,1994,119538885,0,9,1,2048,20,10700275793
8550,119547773,77868,119625641,0,1,0,3072,36,6484601886
8551,119555966,125060,119681026,0,9,0,110592,20,3621944417
8552,119557374,193450,119750824,0,9,0,51200,20,7195425405
8553,119561617,142977,119704594,0,9,0,26624,20,2748051411
8554,119580835,12737,119593572,0,4,1,24576,21,7316840026
8555,119582099,3422,119585521,0,7,1,3584,41,7980584079
8556,119587238,7640,119594878,0,4,1,2048,21,3621394024
8557,119604336,4374,119608710,0,8,1,4608,27,7640519423
8558,119612573,91640,119704213,0,6,0,26112,42,10009090336
8559,119625399,6278,119631677,0,4,1,6656,21,2460575117
8560,119648418,35070,119683488,0,9,1,2560,20,1648958488
8561,119653834,566,119654400,0,5,1,512,46,10053265161
8562,119670273,2946,119673219,0,3,1,3072,4,6740098654
8563,119675718,1042,119676760,0,5,1,1024,46,5731325792
8564,119688675,3422,119692097,0,5,1,3584,46,8718630851
8565,119702302,76388,119778690,0,1,0,16384,36,9424914959
8566,119712626,1518,119714144,0,8,1,1536,27,2785510395
8567,119724720,139914,119864634,0,1,0,18944,36,6846144161
8568,119725930,73004,119798934,0,4,0,15360,21,2872234414
8569,119729630,99788,119829418,0,6,0,27648,42,4109852661
8570,119735376,7230,119742606,0,3,1,7680,4,5492825709
8571,119764399,4420,119768819,0,4,1,11776,21,7732087100
8572,119770890,7230,119778120,0,4,1,7680,21,3504511274
8573,119776870,5802,119782672,0,5,1,6144,46,8825754140
8574,119782729,2470,119785199,0,5,1,2560,46,9984436516
8575,119793332,566,119793898,0,9,1,512,20,483782650
8576,119807962,2870,119810832,0,3,1,8704,4,9041779496
8577,119811361,167282,119978643,0,4,0,100352,21,8210266974
8578,119812818,4374,119817192,0,7,1,4608,41,8311273090
8579,119824416,126154,119950570,0,6,0,97792,42,10361912722
8580,119841782,1518,119843300,0,9,1,1536,20,470485536
8581,119843082,7230,119850312,0,6,1,7680,42,4642383552
8582,119860732,171299,120032031,0,4,0,119296,21,5829645140
8583,119874177,566,119874743,0,7,1,512,41,9311261744
8584,119876996,5326,119882322,0,4,1,5632,21,2388762541
8585,119884828,1042,119885870,0,5,1,1024,46,1093850905
8586,119919030,2470,119921500,0,5,1,2560,46,7739650757
8587,119944009,1042,119945051,0,3,1,1024,4,3427271845
8588,119959145,2946,119962091,0,5,1,3072,46,10234483914
8589,119959540,4497,119964037,0,5,1,3072,46,3253714187
8590,119978378,4631,119983009,0,4,1,4608,21,10659320724
8591,119978998,1042,119980040,0,8,1,1024,27,1940862811
8592,119996053,1518,119997571,0,6,1,1536,42,8664557044
8593,119997399,3128,120000527,0,7,1,9216,41,1417321671
8594,119999881,7129,120007010,0,7,1,7168,41,2988120713
8595,120000582,37719,120038301,0,4,1,6656,21,10220437706
8596,120008459,1042,120009501,0,3,1,1024,4,667193903
8597,120037428,109772,120147200,0,6,0,60416,42,5030356060
8598,120040681,122387,120163068,0,4,0,56832,21,2277240469
8599,120074914,4374,120079288,0,4,1,4608,21,7114785401
8600,120093182,66374,120159556,0,9,0,2560,20,8189215387
8601,120114512,103424,120217936,0,9,0,37888,20,9709672738
8602,120130701,4850,120135551,0,7,1,5120,41,8495301902
8603,120151810,3898,120155708,0,6,1,4096,42,3368045959
8604,120155272,94664,120249936,0,1,0,15872,36,6125837501
8605,120157501,2470,120159971,0,3,1,2560,4,367414598
8606,120163153,5196,120168349,0,6,1,13312,42,955616196
8607,120164883,76676,120241559,0,4,0,12288,21,668827932
8608,120175897,1994,120177891,0,5,1,2048,46,10129984019
8609,120188603,11274,120199877,0,6,1,18432,42,32519863
8610,120208488,3898,120212386,0,3,1,4096,4,5975783421
8611,120210661,5802,120216463,0,6,1,6144,42,1641882733
8612,120237105,4469,120241574,0,4,1,9728,21,9069741335
8613,120244633,5712,120250345,0,5,1,14336,46,6436299814
8614,120249321,108992,120358313,0,0,0,57856,38,3831426161
8615,120262464,566,120263030,0,6,1,512,42,7052628256
8616,120283240,116168,120399408,0,9,0,81408,20,4562511302
8617,120289754,4374,120294128,0,7,1,4608,41,1401007994
8618,120308368,2870,120311238,0,9,1,8704,20,5828221255
8619,120310902,219924,120530826,0,9,0,158720,20,2572753259
8620,120320338,7230,120327568,0,5,1,7680,46,150519425
8621,120321125,2470,120323595,0,9,1,2560,20,1503903312
8622,120345926,5326,120351252,0,5,1,5632,46,7640915019
8623,120352475,102284,120454759,0,6,0,35840,42,8575040612
8624,120356343,5326,120361669,0,9,1,5632,20,6785861062
8625,120368242,3422,120371664,0,9,1,3584,20,4597968045
8626,120372566,45596,120418162,0,1,0,1024,36,3770045449
8627,120391339,1994,120393333,0,3,1,2048,4,9432694380
8628,120399345,48980,120448325,0,4,0,2048,21,7578152177
8629,120407166,3387,120410553,0,6,1,9728,42,4389646734
8630,120418717,113502,120532219,0,6,0,30720,42,37961450
8631,120424893,98072,120522965,0,0,0,22016,38,7298524957
8632,120425566,1994,120427560,0,9,1,2048,20,2068817128
8633,120437706,64232,120501938,0,4,0,11776,21,2915199828
8634,120488291,3898,120492189,0,6,1,4096,42,3732789692
8635,120528020,218934,120746954,0,9,0,84480,20,4046058735
8636,120540082,1042,120541124,0,7,1,1024,41,8643796318
8637,120545842,1518,120547360,0,9,1,1536,20,7823473531
8638,120547141,3904,120551045,0,5,1,10752,46,3150849078
8639,120556943,164256,120721199,0,9,0,78848,20,3851171554
8640,120576826,126464,120703290,0,4,0,115200,21,8865662234
8641,120601250,6278,120607528,0,5,1,6656,46,2433727128
8642,120612127,3645,120615772,0,9,1,10240,20,9290476558
8643,120615236,101972,120717208,0,1,0,34816,36,771806445
8644,120632654,105092,120737746,0,0,0,45056,38,7168470929
8645,120633228,2470,120635698,0,5,1,2560,46,8286550941
8646,120650920,566,120651486,0,6,1,512,42,5386756249
8647,120685943,1042,120686985,0,5,1,1024,46,426705637
8648,120686698,80173,120766871,0,9,0,9728,20,8966149309
8649,120692563,566,120693129,0,8,1,512,27,10448444322
8650,120707118,3422,120710540,0,6,1,3584,42,4328119226
8651,120711460,122220,120833680,0,1,0,82432,36,9633254404
8652,120729368,79436,120808804,0,6,0,11264,42,8680908067
8653,120735996,85366,120821362,0,0,0,19968,38,1432103472
8654,120742918,6498,120749416,0,9,1,2560,20,1363260060
8655,120743370,47288,120790658,0,4,0,1536,21,9899054992
8656,120746264,103062,120849326,0,4,0,32768,21,4221095025
8657,120782401,3645,120786046,0,6,1,10240,42,8093984686
8658,120787910,99944,120887854,0,1,0,28160,36,10443307735
8659,120789052,3128,120792180,0,9,1,9216,20,7553296832
8660,120800449,4850,120805299,0,6,1,5120,42,5579335330
8661,120813238,62516,120875754,0,6,0,6144,42,7552016925
8662,120814797,104737,120919534,0,9,0,18944,20,9708318792
8663,120825065,1518,120826583,0,5,1,1536,46,3411363474
8664,120840309,55904,120896213,0,6,0,4608,42,72234328
8665,120863987,115544,120979531,0,4,0,79360,21,7419573592
8666,120878554,101928,120980482,0,4,0,3072,21,1511594851
8667,120907030,566,120907596,0,9,1,512,20,621742690
8668,120915425,5802,120921227,0,6,1,6144,42,5555564202
8669,120918332,2236,120920568,0,9,1,1024,20,1659009509
8670,120920915,69752,120990667,0,0,0,9728,38,2332421935
8671,120963867,45596,121009463,0,0,0,1024,38,3998357605
8672,121006807,50672,121057479,0,6,0,2560,42,9661621766
8673,121008064,1042,121009106,0,9,1,1024,20,7374229377
8674,121043965,103376,121147341,0,6,0,39424,42,6730496170
8675,121050221,7230,121057451,0,5,1,7680,46,5300220743
8676,121061389,2946,121064335,0,5,1,3072,46,3141580032
8677,121083033,105404,121188437,0,1,0,46080,36,1503464502
8678,121097754,87944,121185698,0,9,0,24064,20,9354935299
8679,121131924,7230,121139154,0,9,1,7680,20,940624283
8680,121155029,116324,121271353,0,4,0,81920,21,3369966056
8681,121169182,14117,121183299,0,5,1,24064,46,8877100793
8682,121180434,4679,121185113,0,2,1,12288,8,10296473754
8683,121202072,5802,121207874,0,5,1,6144,46,5763637445
8684,121208784,2470,121211254,0,7,1,2560,41,8434907037
8685,121213379,52364,121265743,0,9,0,3072,20,4785519105
8686,121245130,4850,121249980,0,5,1,5120,46,1395293730
8687,121258409,60224,121318633,0,4,0,1536,21,5883082943
8688,121262143,109795,121371938,0,4,0,30208,21,7800738903
8689,121277238,113360,121390598,0,6,0,72192,42,7761504966
8690,121297542,2946,121300488,0,9,1,3072,20,4218035028
8691,121303084,131287,121434371,0,9,0,114688,20,2859019942
8692,121331648,1042,121332690,0,9,1,1024,20,6219561333
8693,121343798,3898,121347696,0,4,1,4096,21,7784345839
8694,121357988,3904,121361892,0,9,1,10752,20,7227299470
8695,121358799,238316,121597115,0,9,0,92672,20,7782323530
8696,121365742,5326,121371068,0,9,1,5632,20,3568336818
8697,121366620,5114,121371734,0,9,1,1024,20,9803066933
8698,121369096,99944,121469040,0,1,0,28160,36,9971078695
8699,121376461,124057,121500518,0,6,0,60928,42,6022060190
8700,121377425,144067,121521492,0,1,0,109568,36,216012647
8701,121382686,3898,121386584,0,9,1,4096,20,9176200469
8702,121383973,5837,121389810,0,9,1,5120,20,1231229847
8703,121419484,13341,121432825,0,4,1,22528,21,6469988157
8704,121423194,566,121423760,0,5,1,512,46,6835473510
8705,121425177,150988,121576165,0,1,0,52736,36,6884151836
8706,121429341,135454,121564795,0,9,0,9728,20,9253503217
8707,121434655,5712,121440367,0,2,1,14336,8,7575391685
8708,121447686,2470,121450156,0,2,1,2560,8,4078738752
8709,121449962,134293,121584255,0,4,0,19456,21,6042472912
8710,121463838,166003,121629841,0,1,0,67584,36,2951886326
8711,121468511,1518,121470029,0,5,1,1536,46,5700644458
8712,121504287,83132,121587419,0,0,0,13312,38,10594152707
8713,121507660,7706,121515366,0,5,1,8192,46,4096089675
8714,121534021,7706,121541727,0,9,1,8192,20,6980269969
8715,121542257,7706,121549963,0,5,1,8192,46,7745626199
8716,121557276,7230,121564506,0,5,1,7680,46,8620486407
8717,121575107,28754,121603861,0,9,1,7168,20,4589031215
8718,121594349,7706,121602055,0,4,1,8192,21,4478599746
8719,121631630,93620,121725250,0,1,0,22528,36,8584728877
8720,121663773,43904,121707677,0,0,0,512,38,6449198351
8721,121682242,91436,121773678,0,9,0,15360,20,7860585024
8722,121698539,1994,121700533,0,1,1,2048,36,2860600430
8723,121700510,57440,121757950,0,9,0,4608,20,7231051460
8724,121709433,6488,121715921,0,2,1,15872,8,3018196316
8725,121748110,43904,121792014,0,9,0,512,20,5002198684
8726,121754997,3898,121758895,0,5,1,4096,46,7369588775
8727,121762016,6754,121768770,0,4,1,7168,21,7565203808
8728,121765179,1994,121767173,0,2,1,2048,8,1030940957
8729,121789950,145622,121935572,0,1,0,126464,36,10554410031
8730,121790330,6278,121796608,0,1,1,6656,36,7239988745
8731,121797115,3898,121801013,0,9,1,4096,20,6226373062
8732,121842302,147636,121989938,0,1,0,56832,36,470429144
8733,121849980,48980,121898960,0,9,0,2048,20,10077070823
8734,121873653,1042,121874695,0,2,1,1024,8,4183102794
8735,121884625,43904,121928529,0,9,0,512,20,9585583108
8736,121888808,64208,121953016,0,4,0,6656,21,8620307164
8737,121892316,3387,121895703,0,9,1,9728,20,4323685436
8738,121892412,50361,121942773,0,9,0,2048,20,9530192793
8739,121898117,69152,121967269,0,6,0,12800,42,3412226096
8740,121928645,1518,121930163,0,2,1,1536,8,1715911630
8741,121941639,165349,122106988,0,1,0,77312,36,1139396037
8742,121946237,4850,121951087,0,9,1,5120,20,2907277071
8743,121958869,53637,122012506,0,9,0,2048,20,6129319951
8744,121961650,106755,122068405,0,6,0,45056,42,1474910005
8745,121970390,140381,122110771,0,6,0,31744,42,8331749135
8746,121987888,5946,121993834,0,1,1,10752,36,462308390
8747,121993291,13083,122006374,0,2,1,22016,8,7637775137
8748,122006153,3898,122010051,0,1,1,4096,36,4805283007
8749,122015815,2470,122018285,0,9,1,2560,20,1688236182
8750,122030074,1994,122032068,0,4,1,2048,21,2795315911
8751,122042832,142053,122184885,0,1,0,61952,36,2035477479
8752,122085693,3904,122089597,0,2,1,10752,8,9422643596
8753,122094699,47288,122141987,0,9,0,1536,20,6014410594
8754,122099202,272425,122371627,0,1,0,30720,36,3987453294
8755,122112102,4850,122116952,0,1,1,5120,36,7203814282
8756,122118460,4850,122123310,0,9,1,5120,20,600838955
8757,122125566,4937,122130503,0,2,1,12800,8,4426814892
8758,122133089,149770,122282859,0,1,0,67584,36,6080258373
8759,122153772,3128,122156900,0,4,1,9216,21,7343028118
8760,122167710,5802,122173512,0,4,1,6144,21,9607464293
8761,122202557,110240,122312797,0,0,0,61952,38,6002324033
8762,122205489,7230,122212719,0,9,1,7680,20,6372359532
8763,122205525,7962,122213487,0,9,1,11776,20,6898870063
8764,122210986,4374,122215360,0,4,1,4608,21,5139602744
8765,122236761,52364,122289125,0,1,0,3072,36,7487350467
8766,122260413,45596,122306009,0,9,0,1024,20,10277994288
8767,122260871,22011,122282882,0,1,1,4608,36,10586199387
8768,122264110,19783,122283893,0,1,1,1024,36,7688306375
8769,122269691,43904,122313595,0,7,0,512,41,7662150959
8770,122280741,45596,122326337,0,9,0,1024,20,2434946829
8771,122302371,133474,122435845,0,1,0,58880,36,1788748068
8772,122306753,5802,122312555,0,9,1,6144,20,10178118968
8773,122307748,46522,122354270,0,9,0,1024,20,67372391
8774,122326074,4153,122330227,0,9,1,4096,20,3823205823
8775,122327176,1994,122329170,0,4,1,2048,21,9498441643
8776,122328148,43904,122372052,0,7,0,512,41,6106483446
8777,122332223,65612,122397835,0,4,0,11264,21,1978396019
8778,122332671,1042,122333713,0,1,1,1024,36,7908632305
8779,122335842,102128,122437970,0,0,0,35328,38,6550935876
8780,122348176,43904,122392080,0,7,0,512,41,8473475142
8781,122360936,12308,122373244,0,4,1,20480,21,8145795802
8782,122369614,127556,122497170,0,6,0,118784,42,9695207846
8783,122445179,4937,122450116,0,1,1,12800,36,9101439362
8784,122449463,3422,122452885,0,2,1,3584,8,5999030354
8785,122460926,1518,122462444,0,1,1,1536,36,4155011451
8786,122463930,210280,122674210,0,4,0,131072,21,3487662070
8787,122464482,90120,122554602,0,6,0,4608,42,6908868745
8788,122484414,4374,122488788,0,1,1,4608,36,4632313415
8789,122504955,101816,122606771,0,6,0,34304,42,8860908748
8790,122516920,1994,122518914,0,2,1,2048,8,10424690240
8791,122525661,43904,122569565,0,7,0,512,41,9118541485
8792,122533805,1042,122534847,0,1,1,1024,36,7504858862
8793,122556083,1994,122558077,0,4,1,2048,21,8414825971
8794,122574677,142475,122717152,0,4,0,44032,21,3831566523
8795,122582145,43904,122626049,0,7,0,512,41,3127331797
8796,122613752,5802,122619554,0,6,1,6144,42,2468800063
8797,122614558,7230,122621788,0,2,1,7680,8,10623318948
8798,122620721,1994,122622715,0,1,1,2048,36,6101724637
8799,122654695,6754,122661449,0,2,1,7168,8,8928376959
8800,122682332,73472,122755804,0,2,0,16896,8,10214245451
8801,122688758,74672,122763430,0,4,0,10752,21,2723637853
8802,122700853,96872,122797725,0,0,0,28160,38,987809767
8803,122703454,117728,122821182,0,4,0,86528,21,10003367594
8804,122741527,54680,122796207,0,2,0,5632,8,1712889756
8805,122797188,1042,122798230,0,2,1,1024,8,2945544112
8806,122851690,43904,122895594,0,7,0,512,41,8284818509
8807,122872897,7230,122880127,0,7,1,7680,41,6043146194
8808,122880844,6278,122887122,0,2,1,6656,8,6103297510
8809,122882464,58514,122940978,0,7,0,1024,41,8427111750
8810,122886067,110240,122996307,0,0,0,61952,38,6437411662
8811,122888377,4374,122892751,0,2,1,4608,8,7470738788
8812,122900660,124994,123025654,0,7,0,512,41,1390712047
8813,122909448,185655,123095103,0,0,0,86528,38,172297633
8814,122957866,105716,123063582,0,2,0,47104,8,5021669276
8815,122993815,88388,123082203,0,4,0,20480,21,2415877221
8816,123019277,566,123019843,0,1,1,512,36,6808437676
8817,123020251,3422,123023673,0,1,1,3584,36,3702427353
8818,123100567,12049,123112616,0,2,1,19968,8,2762896414
8819,123126488,10241,123136729,0,2,1,16384,8,8569326568
8820,123143524,103688,123247212,0,1,0,40448,36,399814303
8821,123151997,2946,123154943,0,1,1,3072,36,8957559922
8822,123174114,55748,123229862,0,7,0,4096,41,7469908285
8823,123199909,43904,123243813,0,7,0,512,41,7686705339
8824,123212907,4374,123217281,0,1,1,4608,36,6266671977
8825,123243582,9851,123253433,0,1,1,15360,36,1362691376
8826,123249570,99944,123349514,0,2,0,28160,8,9978934102
8827,123267217,55748,123322965,0,2,0,4096,8,217136684
8828,123269375,60824,123330199,0,4,0,5632,21,911138311
8829,123291306,4420,123295726,0,1,1,11776,36,2904571351
8830,123308019,50672,123358691,0,7,0,2560,41,1871570486
8831,123324963,54950,123379913,0,7,0,512,41,6263211297
8832,123344848,129874,123474722,0,2,0,111104,8,6318227104
8833,123375143,45596,123420739,0,7,0,1024,41,813323988
8834,123419298,1042,123420340,0,4,1,1024,21,9831000381
8835,123442001,1518,123443519,0,4,1,1536,21,2056169924
8836,123445179,4374,123449553,0,8,1,4608,27,10155114059
8837,123450072,79322,123529394,0,2,0,5632,8,123841628
8838,123464499,125372,123589871,0,4,0,111616,21,1290260266
8839,123468181,90524,123558705,0,1,0,17408,36,9458373494
8840,123468488,3128,123471616,0,4,1,9216,21,4007317410
8841,123474169,197095,123671264,0,4,0,100352,21,6142976780
8842,123476533,6754,123483287,0,8,1,7168,27,5420606761
8843,123480208,45596,123525804,0,7,0,1024,41,2986483194
8844,123516415,83468,123599883,0,1,0,19456,36,7564693038
8845,123545727,60824,123606551,0,0,0,5632,38,2030069171
8846,123581749,103220,123684969,0,1,0,38912,36,10538495564
8847,123613015,116698,123729713,0,4,0,37888,21,2918112339
8848,123640655,11016,123651671,0,8,1,17920,27,8707566710
8849,123641262,31512,123672774,0,4,1,1536,21,7192048196
8850,123643309,5326,123648635,0,5,1,5632,46,5369414684
8851,123655555,52832,123708387,0,1,0,4608,36,7131424058
8852,123677858,1042,123678900,0,8,1,1024,27,10234634216
8853,123700945,43904,123744849,0,7,0,512,41,4404523667
8854,123707018,104269,123811287,0,1,0,37888,36,894611866
8855,123715648,14080,123729728,0,4,1,10752,21,6126530065
8856,123736381,99788,123836169,0,2,0,27648,8,6095064392
8857,123779637,45596,123825233,0,7,0,1024,41,8366889719
8858,123788439,104936,123893375,0,0,0,44544,38,5895686600
8859,123799777,114920,123914697,0,4,0,77312,21,3385582873
8860,123805123,141426,123946549,0,1,0,120320,36,9653456900
8861,123811104,59513,123870617,0,7,0,1536,41,5298214780
8862,123818525,201698,124020223,0,1,0,134144,36,9861521428
8863,123826615,148628,123975243,0,4,0,43008,21,7864010649
8864,123844432,45596,123890028,0,7,0,1024,41,6676124052
8865,123911119,172106,124083225,0,1,0,65024,36,9363523301
8866,123928875,109772,124038647,0,2,0,60416,8,5731132057
8867,123978025,103156,124081181,0,2,0,17408,8,6196553906
8868,123991492,163913,124155405,0,1,0,47616,36,4444094896
8869,124034039,98664,124132703,0,2,0,18944,8,10318682132
8870,124063182,98478,124161660,0,1,0,20480,36,4111595107
8871,124070858,192547,124263405,0,1,0,102400,36,5421603477
8872,124107786,43904,124151690,0,7,0,512,41,7685376992
8873,124118116,99863,124217979,0,1,0,10240,36,10695124301
8874,124147597,76676,124224273,0,4,0,12288,21,3253381435
8875,124201382,156680,124358062,0,2,0,138752,8,1446206792
8876,124211114,78860,124289974,0,4,0,19456,21,6505911947
8877,124224815,157805,124382620,0,2,0,61952,8,3662942910
8878,124229245,45596,124274841,0,7,0,1024,41,6825229563
8879,124254567,104624,124359191,0,0,0,43520,38,2550703006
8880,124280823,43904,124324727,0,7,0,512,41,4237475810
8881,124301632,147463,124449095,0,0,0,38912,38,7867724891
8882,124315861,43904,124359765,0,7,0,512,41,3970223633
8883,124324296,99632,124423928,0,4,0,27136,21,2734253780
8884,124347946,96804,124444750,0,2,0,19968,8,1446794226
8885,124418798,117260,124536058,0,0,0,84992,38,4933486949
8886,124420243,4719,124424962,0,4,1,1024,21,10068120734
8887,124487590,77168,124564758,0,1,0,18944,36,7081828106
8888,124492382,45596,124537978,0,7,0,1024,41,8652914955
8889,124515155,54665,124569820,0,7,0,3584,41,8108427797
8890,124525644,126243,124651887,0,4,0,73216,21,9128743189
8891,124525927,178141,124704068,0,4,0,124416,21,7661699427
8892,124559787,47288,124607075,0,7,0,1536,41,2577132334
8893,124565487,143596,124709083,0,4,0,16384,21,7737168106
8894,124588982,52364,124641346,0,7,0,3072,41,2016909898
8895,124604250,90080,124694330,0,2,0,20992,8,5399167856
8896,124629812,114764,124744576,0,1,0,76800,36,4815204432
8897,124640905,44337,124685242,0,7,0,512,41,8834560158
8898,124648048,141312,124789360,0,1,0,62464,36,9750812987
8899,124660072,55748,124715820,0,0,0,4096,38,8665617921
8900,124660442,112440,124772882,0,2,0,19456,8,981749384
8901,124681688,66276,124747964,0,4,0,512,21,2039633304
8902,124708870,96246,124805116,0,1,0,1024,36,2383943146
8903,124732552,4420,124736972,0,4,1,11776,21,3811189436
8904,124752464,100568,124853032,0,2,0,30208,8,5949378053
8905,124777563,7706,124785269,0,4,1,8192,21,7993262509
8906,124779994,8181,124788175,0,4,1,4608,21,5399647238
8907,124806078,127088,124933166,0,0,0,117248,38,4720078618
8908,124818466,123812,124942278,0,4,0,106496,21,7072883224
8909,124850932,156587,125007519,0,4,0,512,21,4795597227
8910,124857139,3898,124861037,0,4,1,4096,21,4995600639
8911,124866875,140473,125007348,0,4,0,87040,21,587783186
8912,124883363,113048,124996411,0,2,0,71168,8,5076499422
8913,124909885,45596,124955481,0,7,0,1024,41,1429599186
8914,124911527,158419,125069946,0,4,0,64512,21,4635492939
8915,124927884,47288,124975172,0,1,0,1536,36,1162444346
8916,124929619,18019,124947638,0,4,1,5632,21,10280203913
8917,124938181,96716,125034897,0,2,0,27648,8,2979013729
8918,124940191,8113,124948304,0,4,1,1024,21,8561665812
8919,124957174,102908,125060082,0,0,0,37888,38,188629983
8920,124957633,7706,124965339,0,3,1,8192,4,8431304968
8921,124965233,162784,125128017,0,4,0,26112,21,6867394194
8922,124971675,6754,124978429,0,4,1,7168,21,2478030170
8923,124985449,48980,125034429,0,7,0,2048,41,8474539499
8924,125021379,45596,125066975,0,7,0,1024,41,2262771105
8925,125032949,80264,125113213,0,4,0,2560,21,5161768331
8926,125051465,215928,125267393,0,4,0,124928,21,1660020112
8927,125054298,52364,125106662,0,7,0,3072,41,8611207683
8928,125057633,3645,125061278,0,3,1,10240,4,5716288380
8929,125060400,55478,125115878,0,7,0,3072,41,5065449229
8930,125146336,50672,125197008,0,1,0,2560,36,3780135073
8931,125147482,67592,125215074,0,2,0,7680,8,7014773159
8932,125169803,43904,125213707,0,7,0,512,41,8631659079
8933,125227329,43904,125271233,0,7,0,512,41,3012792352
8934,125258106,108056,125366162,0,0,0,54784,38,908344522
8935,125265710,150870,125416580,0,0,0,22528,38,5142947532
8936,125301575,45596,125347171,0,0,0,1024,38,4377279121
8937,125313870,86204,125400074,0,2,0,13312,8,8660057121
8938,125373988,43904,125417892,0,1,0,512,36,10078056176
8939,125402539,89900,125492439,0,0,0,15360,38,7377330139
8940,125405081,6488,125411569,0,8,1,15872,27,1902711988
8941,125420192,1518,125421710,0,8,1,1536,27,8823453928
8942,125432322,107120,125539442,0,7,0,51712,41,899766076
8943,125434130,43904,125478034,0,1,0,512,36,1315632459
8944,125494061,43904,125537965,0,1,0,512,36,881032133
8945,125515812,85448,125601260,0,2,0,15872,8,4049165957
8946,125520066,45596,125565662,0,1,0,1024,36,2669695612
8947,125524912,90992,125615904,0,4,0,18944,21,2926271171
8948,125588593,81308,125669901,0,0,0,17408,38,2574654185
8949,125604996,34367,125639363,0,3,1,56832,4,9366376389
8950,125652809,125716,125778525,0,0,0,74240,38,9590306278
8951,125670545,113984,125784529,0,7,0,74240,41,2226314258
8952,125709240,148269,125857509,0,0,0,33792,38,5780053621
8953,125780876,71237,125852113,0,7,0,7680,41,8040059398
8954,125784647,101036,125885683,0,7,0,31744,41,1085342319
8955,125787005,99788,125886793,0,0,0,27648,38,10640177930
8956,125794082,2470,125796552,0,5,1,2560,46,7099023286
8957,125846304,72668,125918972,0,0,0,9216,38,8506576643
8958,125892837,98696,125991533,0,2,0,24064,8,2445005040
8959,125912800,49136,125961936,0,7,0,2560,41,1415294556
8960,125928653,91904,126020557,0,4,0,16896,21,2833224507
8961,125952373,59132,126011505,0,7,0,5120,41,4010709427
8962,126031299,101623,126132922,0,0,0,33280,38,8760583778
8963,126051438,83995,126135433,0,0,0,8192,38,1129987995
8964,126085013,72668,126157681,0,2,0,9216,8,5466819943
8965,126085823,100256,126186079,0,4,0,29184,21,4371519901
8966,126126558,129427,126255985,0,4,0,25600,21,9333263899
8967,126189376,87579,126276955,0,4,0,2560,21,7700821544
8968,126198109,50672,126248781,0,1,0,2560,36,3305724127
8969,126218680,5971,126224651,0,1,1,14848,36,2797646905
8970,126232190,91772,126323962,0,0,0,21504,38,7556543695
8971,126267410,2470,126269880,0,4,1,2560,21,9519934975
8972,126268789,118040,126386829,0,7,0,87552,41,1232949169
8973,126283947,119929,126403876,0,0,0,55808,38,7418898103
8974,126302307,151332,126453639,0,7,0,78848,41,2442963934
8975,126341171,43904,126385075,0,1,0,512,36,4616999694
8976,126342783,99632,126442415,0,2,0,27136,8,4992427755
8977,126348901,110525,126459426,0,7,0,18944,41,7204091064
8978,126355452,114285,126469737,0,4,0,53760,21,420660999
8979,126357876,106808,126464684,0,2,0,50688,8,4062072193
8980,126370183,156829,126527012,0,4,0,101888,21,1298939434
8981,126371489,3898,126375387,0,4,1,4096,21,9609241051
8982,126380857,161414,126542271,0,7,0,65024,41,7659699128
8983,126461779,43904,126505683,0,1,0,512,36,8915055278
8984,126487973,109906,126597879,0,7,0,18432,41,6396119211
8985,126495218,31809,126527027,0,4,1,2048,21,9447739679
8986,126498300,65900,126564200,0,0,0,7168,38,10005831401
8987,126503764,29533,126533297,0,4,1,6656,21,5164559128
8988,126505775,4937,126510712,0,8,1,12800,27,6787959741
8989,126517078,108524,126625602,0,2,0,56320,8,2183286980
8990,126518647,45596,126564243,0,1,0,1024,36,4378694657
8991,126538706,106789,126645495,0,7,0,18432,41,5279525049
8992,126544983,6754,126551737,0,1,1,7168,36,4412940205
8993,126634639,43904,126678543,0,1,0,512,36,2390623668
8994,126637304,67693,126704997,0,1,0,512,36,9348853419
8995,126650024,53749,126703773,0,1,0,1536,36,3277909436
8996,126672308,45596,126717904,0,1,0,1024,36,2770371314
8997,126703148,4374,126707522,0,5,1,4608,46,1435723822
8998,126722096,3422,126725518,0,1,1,3584,36,7484473211
8999,126742482,99320,126841802,0,2,0,26112,8,7753528125
9000,126776097,85136,126861233,0,2,0,14848,8,1287204775
9001,126781727,48980,126830707,0,7,0,2048,41,2297881253
9002,126805367,45596,126850963,0,1,0,1024,36,4264253724
9003,126827854,2946,126830800,0,1,1,3072,36,3896377109
9004,126832010,3422,126835432,0,1,1,3584,36,1865871963
9005,126834343,128026,126962369,0,2,0,47104,8,7657479489
9006,126845469,192596,127038065,0,4,0,165888,21,9553470428
9007,126850254,227945,127078199,0,4,0,69632,21,3974515929
9008,126859096,103064,126962160,0,7,0,38400,41,8063713115
9009,126866328,3422,126869750,0,4,1,3584,21,2436550405
9010,126877799,2946,126880745,0,1,1,3072,36,8863814271
9011,126901608,3898,126905506,0,1,1,4096,36,3033672897
9012,126919667,111800,127031467,0,2,0,67072,8,8765130634
9013,126932043,1994,126934037,0,1,1,2048,36,239255154
9014,126936444,566,126937010,0,1,1,512,36,7358497646
9015,126940145,2470,126942615,0,8,1,2560,27,1384787859
9016,126946037,105560,127051597,0,0,0,46592,38,5042380699
9017,126959303,1518,126960821,0,1,1,1536,36,5026375956
9018,126989114,47288,127036402,0,1,0,1536,36,4132163440
9019,127019240,6278,127025518,0,1,1,6656,36,8401257258
9020,127166099,5712,127171811,0,1,1,14336,36,3426930378
9021,127248003,3898,127251901,0,1,1,4096,36,232222909
9022,127282613,93596,127376209,0,0,0,17408,38,1800156636
9023,127294527,1518,127296045,0,1,1,1536,36,3597013296
9024,127294829,100724,127395553,0,7,0,30720,41,571976158
9025,127298782,6754,127305536,0,1,1,7168,36,1404736553
9026,127331866,43904,127375770,0,1,0,512,36,6999319241
9027,127333768,47288,127381056,0,1,0,1536,36,4437520773
9028,127353549,71566,127425115,0,7,0,5632,41,9532786911
9029,127371422,11533,127382955,0,1,1,18944,36,8437294051
9030,127379828,96692,127476520,0,2,0,22528,8,1707445633
9031,127478276,43904,127522180,0,1,0,512,36,1512206522
9032,127486564,47288,127533852,0,2,0,1536,8,8885088712
9033,127531395,1042,127532437,0,5,1,1024,46,1598109931
9034,127598580,2870,127601450,0,8,1,8704,27,1556691836
9035,127606323,55748,127662071,0,7,0,4096,41,8180050173
9036,127616828,60824,127677652,0,7,0,5632,41,6023194091
9037,127622135,106340,127728475,0,0,0,49152,38,7982143196
9038,127653425,1518,127654943,0,8,1,1536,27,1050699165
9039,127673168,106652,127779820,0,0,0,50176,38,4315408966
9040,127715860,5454,127721314,0,5,1,13824,46,2960238173
9041,127790320,2946,127793266,0,8,1,3072,27,7308333627
9042,127936949,101192,128038141,0,2,0,32256,8,7000985011
9043,127957556,72668,128030224,0,0,0,9216,38,6430942435
9044,128041201,148376,128189577,0,7,0,136704,41,9069952818
9045,128041807,2946,128044753,0,8,1,3072,27,2451040087
9046,128054623,1994,128056617,0,5,1,2048,46,10553181229
9047,128089738,4850,128094588,0,8,1,5120,27,10487947062
9048,128101301,2870,128104171,0,8,1,8704,27,378829981
9049,128110803,121160,128231963,0,2,0,97792,8,1916186524
9050,128155209,1042,128156251,0,5,1,1024,46,3800419475
9051,128172914,82555,128255469,0,7,0,7168,41,6220490057
9052,128225016,206192,128431208,0,0,0,215552,38,10073278877
9053,128228174,108145,128336319,0,7,0,44544,41,1522252558
9054,128234827,3422,128238249,0,8,1,3584,27,10211499884
9055,128236501,3694,128240195,0,8,1,3072,27,4426384182
9056,128250270,194385,128444655,0,0,0,44032,38,10564385831
9057,128254477,1042,128255519,0,5,1,1024,46,7602301364
9058,128260375,1994,128262369,0,5,1,2048,46,4753645862
9059,128262689,166180,128428869,0,7,0,120320,41,5135493255
9060,128347495,206192,128553687,0,7,0,215552,41,7807331438
9061,128374422,5326,128379748,0,5,1,5632,46,9963583398
9062,128380849,57440,128438289,0,2,0,4608,8,1725322963
9063,128395999,96805,128492804,0,0,0,8192,38,8206194519
9064,128406925,119120,128526045,0,0,0,16384,38,10367892922
9065,128519880,4374,128524254,0,5,1,4608,46,6928611799
9066,128550624,104559,128655183,0,7,0,33280,41,10721288690
9067,128551217,105716,128656933,0,2,0,47104,8,8290926236
9068,128559646,81149,128640795,0,7,0,11264,41,8411249721
9069,128562467,108212,128670679,0,0,0,55296,38,3995006479
9070,128586017,1518,128587535,0,5,1,1536,46,6776365960
9071,128595302,140135,128735437,0,0,0,34816,38,3846494976
9072,128661451,50672,128712123,0,7,0,2560,41,5384948693
9073,128679410,69284,128748694,0,2,0,8192,8,369192390
9074,128692790,5802,128698592,0,5,1,6144,46,5207921479
9075,128709636,52832,128762468,0,7,0,4608,41,7840691351
9076,128737824,129206,128867030,0,7,0,119808,41,5078065402
9077,128891017,139760,129030777,0,7,0,133632,41,1521142547
9078,128911368,95156,129006524,0,0,0,22528,38,329220434
9079,128912797,161546,129074343,0,7,0,48640,41,8239066837
9080,128918874,100250,129019124,0,0,0,23552,38,6995809141
9081,128918953,79436,128998389,0,2,0,11264,8,4543557662
9082,128919183,3128,128922311,0,5,1,9216,46,2306787556
9083,128980577,93813,129074390,0,0,0,6656,38,42737267
9084,129045805,101504,129147309,0,2,0,33280,8,4980464485
9085,129060286,64721,129125007,0,7,0,2560,41,4348506258
9086,129077911,1994,129079905,0,5,1,2048,46,4568387296
9087,129099325,2870,129102195,0,5,1,8704,46,136866299
9088,129146517,56688,129203205,0,2,0,4608,8,3634159607
9089,129170048,1518,129171566,0,5,1,1536,46,9050321812
9090,129181351,107204,129288555,0,2,0,51712,8,5592287089
9091,129189590,99008,129288598,0,7,0,25088,41,2100565717
9092,129215053,65900,129280953,0,0,0,7168,38,7881640078
9093,129238977,114738,129353715,0,0,0,23040,38,1906749810
9094,129325667,63966,129389633,0,3,1,104448,4,1556699311
9095,129365620,6754,129372374,0,8,1,7168,27,3538643707
9096,129378063,18188,129396251,0,3,1,31744,4,6786218294
9097,129399299,114920,129514219,0,0,0,77312,38,10702185395
9098,129428606,48980,129477586,0,7,0,2048,41,9334823017
9099,129435661,47600,129483261,0,2,0,2560,8,9034823834
9100,129477311,78323,129555634,0,7,0,11776,41,367916875
9101,129490047,26479,129516526,0,3,1,48128,4,10294287504
9102,129512319,133213,129645532,0,7,0,78848,41,4256275937
9103,129526862,189656,129716518,0,0,0,161280,38,4332645001
9104,129616348,109701,129726049,0,0,0,31232,38,6768181993
9105,129623723,46212,129669935,0,3,1,79872,4,3975237682
9106,129623835,56520,129680355,0,3,1,41472,4,6388883242
9107,129632669,122096,129754765,0,2,0,100864,8,857967742
9108,129639738,202066,129841804,0,0,0,160768,38,4490607897
9109,129662051,110708,129772759,0,7,0,63488,41,10048672771
9110,129716449,124116,129840565,0,2,0,72704,8,7888683489
9111,129720092,56249,129776341,0,2,0,3072,8,7271578352
9112,129755438,4679,129760117,0,3,1,12288,4,8794958168
9113,129796503,148357,129944860,0,0,0,38400,38,6711375922
9114,129805892,49604,129855496,0,2,0,4096,8,5795989210
9115,129806302,6278,129812580,0,8,1,6656,27,6010083161
9116,129808378,99459,129907837,0,2,0,24064,8,7938842154
9117,129814990,114903,129929893,0,2,0,10752,8,7768525113
9118,129819198,121628,129940826,0,7,0,99328,41,9506055398
9119,129850925,1042,129851967,0,8,1,1024,27,1041668166
9120,129854550,1518,129856068,0,8,1,1536,27,2887677798
9121,129955191,86852,130042043,0,2,0,20480,8,439911633
9122,129965700,84536,130050236,0,2,0,17920,8,8116939620
9123,129983896,115969,130099865,0,7,0,44544,41,7137892646
9124,129994929,123515,130118444,0,7,0,60928,41,9868871024
9125,130007940,1994,130009934,0,8,1,2048,27,8909722030
9126,130013727,132497,130146224,0,2,0,98816,8,823434816
9127,130157031,11016,130168047,0,8,1,17920,27,9714380847
9128,130214792,60824,130275616,0,0,0,5632,38,1921089044
9129,130237983,113672,130351655,0,7,0,73216,41,21845803
9130,130308442,79981,130388423,0,7,0,5120,41,619398378
9131,130338780,73160,130411940,0,0,0,15872,38,5720619085
9132,130362788,48980,130411768,0,7,0,2048,41,10473767856
9133,130377850,45596,130423446,0,2,0,1024,8,8426651351
9134,130384831,66080,130450911,0,2,0,12800,8,7953482481
9135,130387101,88676,130475777,0,0,0,16384,38,3889758756
9136,130403286,47952,130451238,0,2,0,1024,8,6140141455
9137,130417650,4162,130421812,0,3,1,11264,4,3386615488
9138,130419993,7706,130427699,0,8,1,8192,27,10353145039
9139,130437097,99320,130536417,0,2,0,26112,8,2479633438
9140,130492959,566,130493525,0,8,1,512,27,9817446513
9141,130511954,3128,130515082,0,7,1,9216,41,5361803257
9142,130534402,3645,130538047,0,8,1,10240,27,7271298498
9143,130534838,108691,130643529,0,2,0,51712,8,8733318135
9144,130555611,1518,130557129,0,8,1,1536,27,1419128548
9145,130573401,134754,130708155,0,2,0,35840,8,10609023274
9146,130602286,1518,130603804,0,8,1,1536,27,1509274337
9147,130604188,1518,130605706,0,8,1,1536,27,455470121
9148,130608431,1994,130610425,0,8,1,2048,27,7114606627
9149,130662595,1042,130663637,0,8,1,1024,27,1855062208
9150,130717907,120536,130838443,0,7,0,95744,41,276857779
9151,130722574,7706,130730280,0,8,1,8192,27,1188699934
9152,130726101,5454,130731555,0,8,1,13824,27,8220416749
9153,130727327,104156,130831483,0,2,0,41984,8,782119631
9154,130761751,245074,131006825,0,2,0,116736,8,3278005714
9155,130790620,6278,130796898,0,8,1,6656,27,9086352463
9156,130808895,130988,130939883,0,2,0,130048,8,3488082489
9157,130819401,100724,130920125,0,0,0,30720,38,5402709625
9158,130865487,1042,130866529,0,8,1,1024,27,6261657255
9159,130887472,133039,131020511,0,2,0,14336,8,9953390867
9160,130960952,139161,131100113,0,2,0,47616,8,3229495326
9161,130994474,145893,131140367,0,2,0,42496,8,652992900
9162,131002075,2470,131004545,0,8,1,2560,27,4175703753
9163,131073910,1518,131075428,0,8,1,1536,27,6660152792
9164,131089707,102956,131192663,0,2,0,10240,8,939789231
9165,131115787,88520,131204307,0,7,0,15872,41,7375270265
9166,131208085,102752,131310837,0,2,0,37376,8,3619071704
9167,131248521,125684,131374205,0,0,0,112640,38,8199053629
9168,131266916,151605,131418521,0,0,0,96768,38,664777340
9169,131359439,193302,131552741,0,0,0,150016,38,7688257858
9170,131395461,103532,131498993,0,2,0,39936,8,6497149704
9171,131445288,101816,131547104,0,7,0,34304,41,4829471892
9172,131455156,66056,131521212,0,2,0,7680,8,6622683804
9173,131461078,111892,131572970,0,7,0,7168,41,7205000628
9174,131491486,5712,131497198,0,8,1,14336,27,1076066886
9175,131511172,101816,131612988,0,2,0,34304,8,4323191429
9176,131515850,139479,131655329,0,0,0,36864,38,2267811666
9177,131530915,4679,131535594,0,8,1,12288,27,8509937995
9178,131536269,1518,131537787,0,8,1,1536,27,452843978
9179,131538706,184706,131723412,0,0,0,32256,38,6582629784
9180,131574037,89324,131663361,0,2,0,23552,8,5707400132
9181,131577598,184844,131762442,0,0,0,62976,38,4275693544
9182,131606836,136403,131743239,0,0,0,65024,38,7982774851
9183,131610429,113628,131724057,0,2,0,13824,8,8572625198
9184,131660420,2946,131663366,0,8,1,3072,27,9743534337
9185,131739412,138722,131878134,0,0,0,79872,38,7192438023
9186,131756986,110084,131867070,0,2,0,61440,8,1485138933
9187,131765567,149821,131915388,0,0,0,24576,38,3714525942
9188,131828641,12566,131841207,0,3,1,20992,4,1668588087
9189,131830073,114764,131944837,0,2,0,76800,8,4887641800
9190,131964044,94532,132058576,0,7,0,20480,41,2475420129
9191,131980854,10757,131991611,0,8,1,17408,27,10162864536
9192,132002231,1042,132003273,0,8,1,1024,27,4186839199
9193,132036721,1042,132037763,0,8,1,1024,27,2480455775
9194,132057172,101504,132158676,0,0,0,33280,38,9579693234
9195,132088032,7230,132095262,0,5,1,7680,46,8410707335
9196,132146967,77744,132224711,0,7,0,10752,41,1323071013
9197,132189188,68996,132258184,0,2,0,12288,8,8023730419
9198,132190712,3128,132193840,0,8,1,9216,27,10130798822
9199,132193021,47288,132240309,0,2,0,1536,8,7457543204
9200,132246302,3898,132250200,0,2,1,4096,8,7787556582
9201,132252356,1042,132253398,0,8,1,1024,27,6633598443
9202,132263325,2470,132265795,0,5,1,2560,46,5006186611
9203,132314162,6754,132320916,0,8,1,7168,27,7307079613
9204,132334568,2470,132337038,0,5,1,2560,46,10261768931
9205,132407325,566,132407891,0,2,1,512,8,8537571954
9206,132430714,6278,132436992,0,2,1,6656,8,7745153752
9207,132451237,57440,132508677,0,7,0,4608,41,8463002542
9208,132476709,6754,132483463,0,2,1,7168,8,6700404825
9209,132480770,1994,132482764,0,5,1,2048,46,10154188170
9210,132527109,566,132527675,0,2,1,512,8,3210966108
9211,132540973,84560,132625533,0,7,0,23040,41,3219171081
9212,132556392,4850,132561242,0,5,1,5120,46,5904556524
9213,132657670,4420,132662090,0,8,1,11776,27,8581554438
9214,132714982,566,132715548,0,5,1,512,46,6265097414
9215,132734627,102908,132837535,0,0,0,37888,38,4987799945
9216,132761892,43904,132805796,0,2,0,512,8,1112231050
9217,132763524,13858,132777382,0,7,1,23552,41,1072354336
9218,132765808,47288,132813096,0,0,0,1536,38,2379020864
9219,132839561,43904,132883465,0,2,0,512,8,22168139
9220,132850731,1518,132852249,0,8,1,1536,27,1623055863
9221,132862532,45596,132908128,0,2,0,1024,8,4662334581
9222,132879261,2946,132882207,0,5,1,3072,46,4525913356
9223,132924107,5712,132929819,0,5,1,14336,46,2057210501
9224,132927281,3844,132931125,0,5,1,2048,46,6555427237
9225,132958091,45596,133003687,0,2,0,1024,8,8836898192
9226,132977979,1518,132979497,0,8,1,1536,27,6693590490
9227,133011667,4374,133016041,0,8,1,4608,27,5793511443
9228,133054891,3898,133058789,0,7,1,4096,41,3894650577
9229,133057751,1042,133058793,0,8,1,1024,27,4891859108
9230,133072887,98072,133170959,0,7,0,22016,41,10192022969
9231,133102847,95624,133198471,0,0,0,24064,38,3729502382
9232,133106578,43904,133150482,0,8,0,512,27,5839776295
9233,133154268,566,133154834,0,8,1,512,27,2277819635
9234,133193607,43904,133237511,0,8,0,512,27,7846051583
9235,133193800,1042,133194842,0,7,1,1024,41,4562856965
9236,133214913,119756,133334669,0,7,0,93184,41,1044794125
9237,133244532,566,133245098,0,7,1,512,41,6770681338
9238,133251186,5326,133256512,0,8,1,5632,27,7899636101
9239,133301562,88700,133390262,0,0,0,21504,38,10245855019
9240,133310293,43904,133354197,0,2,0,512,8,9867232857
9241,133312358,111564,133423922,0,0,0,26112,38,934755596
9242,133375568,115544,133491112,0,7,0,79360,41,1424321939
9243,133406811,84560,133491371,0,0,0,23040,38,3044840840
9244,133417734,43904,133461638,0,8,0,512,27,8134906932
9245,133419667,1994,133421661,0,8,1,2048,27,10139086108
9246,133463248,45596,133508844,0,8,0,1024,27,8543908594
9247,133468917,2946,133471863,0,8,1,3072,27,2538630408
9248,133498777,48980,133547757,0,2,0,2048,8,1801853740
9249,133523281,3422,133526703,0,7,1,3584,41,6279665931
9250,133534282,47288,133581570,0,2,0,1536,8,6398227074
9251,133545972,6278,133552250,0,7,1,6656,41,10439207087
9252,133550825,3691,133554516,0,7,1,3584,41,2765638289
9253,133558784,47444,133606228,0,8,0,2048,27,2737073628
9254,133603346,43904,133647250,0,2,0,512,8,7973830939
9255,133623159,43904,133667063,0,2,0,512,8,3323949476
9256,133662845,96980,133759825,0,0,0,18432,38,6883688669
9257,133822680,57440,133880120,0,0,0,4608,38,10136732970
9258,133825559,2470,133828029,0,8,1,2560,27,7236990810
9259,133868565,90935,133959500,0,0,0,15872,38,9406421766
9260,133913665,43904,133957569,0,2,0,512,8,882444586
9261,133997232,50828,134048060,0,0,0,3072,38,1427431867
9262,134050802,113204,134164006,0,0,0,71680,38,10447771386
9263,134051173,148881,134200054,0,0,0,28672,38,9366328596
9264,134054022,183082,134237104,0,0,0,28160,38,6943536194
9265,134068467,2870,134071337,0,8,1,8704,27,9061755172
9266,134134209,6278,134140487,0,2,1,6656,8,2777270985
9267,134150553,112797,134263350,0,8,0,512,27,623509315
9268,134207734,1518,134209252,0,8,1,1536,27,9981928502
9269,134222036,1994,134224030,0,8,1,2048,27,3348782132
9270,134248511,4679,134253190,0,2,1,12288,8,2012891035
9271,134253461,43904,134297365,0,8,0,512,27,8761990413
9272,134285030,4850,134289880,0,8,1,5120,27,2953923935
9273,134304121,6754,134310875,0,8,1,7168,27,2724676969
9274,134320249,3904,134324153,0,2,1,10752,8,10344080513
9275,134332216,3898,134336114,0,2,1,4096,8,4528491113
9276,134362798,47288,134410086,0,2,0,1536,8,8309605099
9277,134369136,2470,134371606,0,8,1,2560,27,7508594045
9278,134414052,45596,134459648,0,8,0,1024,27,4088799505
9279,134421598,43904,134465502,0,2,0,512,8,10072226013
9280,134462630,45596,134508226,0,2,0,1024,8,7273927862
9281,134490749,5802,134496551,0,2,1,6144,8,1800167919
9282,134503323,4374,134507697,0,2,1,4608,8,8046744926
9283,134536582,1518,134538100,0,2,1,1536,8,4457670806
9284,134540534,50672,134591206,0,2,0,2560,8,7619941442
9285,134551763,4420,134556183,0,2,1,11776,8,1074836684
9286,134565175,147770,134712945,0,2,0,1024,8,3666848243
9287,134581502,43904,134625406,0,2,0,512,8,2792030364
9288,134640233,115388,134755621,0,0,0,78848,38,6597688767
9289,134645636,6754,134652390,0,8,1,7168,27,9979323618
9290,134697509,58439,134755948,0,0,0,1024,38,9192253820
9291,134779848,4374,134784222,0,2,1,4608,8,2580575347
9292,134834442,92684,134927126,0,0,0,19456,38,119419747
9293,134847529,43904,134891433,0,8,0,512,27,4272005840
9294,134849302,13341,134862643,0,2,1,22528,8,5869672292
9295,134879628,3128,134882756,0,8,1,9216,27,8937438546
9296,134881368,6054,134887422,0,8,1,12800,27,5774797782
9297,134886928,5802,134892730,0,2,1,6144,8,1517748303
9298,134893563,5326,134898889,0,8,1,5632,27,6119864017
9299,134897254,60824,134958078,0,0,0,5632,38,1159551508
9300,134909877,55730,134965607,0,8,0,1024,27,5897651546
9301,134914781,5802,134920583,0,8,1,6144,27,7145707460
9302,134953926,3645,134957571,0,8,1,10240,27,5921999785
9303,135007461,108836,135116297,0,0,0,57344,38,4306490494
9304,135017549,43904,135061453,0,2,0,512,8,3636776181
9305,135031387,5196,135036583,0,8,1,13312,27,9777475738
9306,135051595,3904,135055499,0,8,1,10752,27,8348127100
9307,135054222,3168,135057390,0,8,1,2560,27,6885306395
9308,135085926,110603,135196529,0,0,0,20992,38,4265725021
9309,135090553,60180,135150733,0,8,0,512,27,166693274
9310,135109981,47288,135157269,0,8,0,1536,27,10623740174
9311,135154779,3904,135158683,0,3,1,10752,4,3918420095
9312,135157465,566,135158031,0,2,1,512,8,2871692907
9313,135202637,3898,135206535,0,2,1,4096,8,3363431553
9314,135253974,1994,135255968,0,2,1,2048,8,2966991083
9315,135278066,15837,135293903,0,3,1,30720,4,6552010147
9316,135317200,4420,135321620,0,3,1,11776,4,7844600979
9317,135330211,43904,135374115,0,2,0,512,8,1323912753
9318,135346037,47288,135393325,0,8,0,1536,27,10482252339
9319,135360527,10499,135371026,0,2,1,16896,8,2589718168
9320,135366343,6754,135373097,0,8,1,7168,27,4364963917
9321,135380397,84733,135465130,0,3,1,138240,4,10401190491
9322,135391379,3422,135394801,0,8,1,3584,27,8765181654
9323,135524981,63966,135588947,0,3,1,104448,4,230658732
9324,135530636,59591,135590227,0,3,1,14336,4,8016186501
9325,135616284,107120,135723404,0,0,0,51712,38,7586282674
9326,135619865,43904,135663769,0,2,0,512,8,4890079156
9327,135622219,45596,135667815,0,2,0,1024,8,2978544244
9328,135626228,62771,135688999,0,2,0,1536,8,692346097
9329,135644411,33850,135678261,0,3,1,55808,4,2345511104
9330,135684383,104637,135789020,0,3,1,173568,4,2749574282
9331,135696039,73313,135769352,0,0,0,8704,38,79183981
9332,135702937,43904,135746841,0,2,0,512,8,9900013722
9333,135720872,99919,135820791,0,3,1,102912,4,5546947602
9334,135721706,46981,135768687,0,2,0,512,8,5016134280
9335,135730270,43904,135774174,0,2,0,512,8,953412579
9336,135759286,66894,135826180,0,3,1,25600,4,4742126086
9337,135760138,43904,135804042,0,2,0,512,8,8235141673
9338,135799389,43904,135843293,0,2,0,512,8,2204273351
9339,135859520,7230,135866750,0,5,1,7680,46,6701698320
9340,135886394,11274,135897668,0,3,1,18432,4,3859721698
9341,135889333,51140,135940473,0,0,0,4096,38,5704580827
9342,135910551,86520,135997071,0,0,0,12288,38,1705227714
9343,135914135,104378,136018513,0,3,1,173056,4,3427120967
9344,135918696,105309,136024005,0,3,1,17920,4,6629903417
9345,135924674,43904,135968578,0,2,0,512,8,192677228
9346,135968879,71396,136040275,0,3,1,53248,4,8153039165
9347,135990463,47288,136037751,0,2,0,1536,8,5694808538
9348,135994029,97096,136091125,0,3,1,162304,4,10147966596
9349,136009790,43904,136053694,0,2,0,512,8,8091675009
9350,136043982,58177,136102159,0,3,1,36352,4,2717505799
9351,136044758,94510,136139268,0,3,1,120320,4,8068791129
9352,136103118,110864,136213982,0,0,0,64000,38,9332266997
9353,136225655,156812,136382467,0,3,1,258560,4,1289989390
9354,136238105,99944,136338049,0,0,0,28160,38,9766234586
9355,136278014,98228,136376242,0,0,0,22528,38,9282212464
9356,136420524,84733,136505257,0,3,1,138240,4,7913347241
9357,136438274,88488,136526762,0,3,1,78336,4,6185732452
9358,136601808,32558,136634366,0,3,1,53248,4,2822837166
9359,136602820,61990,136664810,0,3,1,80896,4,1656137213
9360,136700779,104725,136805504,0,3,1,170496,4,10618492277
9361,136711689,47288,136758977,0,0,0,1536,38,7463455221
9362,136722350,104147,136826497,0,3,1,67584,4,9655324125
9363,136759374,60224,136819598,0,0,0,8704,38,5709498388
9364,136772683,117821,136890504,0,3,1,194560,4,6167375352
9365,136789526,43904,136833430,0,2,0,512,8,10068051478
9366,136857659,43904,136901563,0,2,0,512,8,4328806930
9367,136904984,101036,137006020,0,0,0,31744,38,7424968996
9368,136922981,5326,136928307,0,3,1,5632,4,2265547168
9369,136954079,6278,136960357,0,3,1,6656,4,4267977465
9370,137008704,64208,137072912,0,0,0,6656,38,1152533634
9371,137067266,62516,137129782,0,0,0,6144,38,6370464260
9372,137121295,45596,137166891,0,2,0,1024,8,8925610008
9373,137131308,43904,137175212,0,2,0,512,8,462258948
9374,137139070,99632,137238702,0,0,0,27136,38,4624498972
9375,137235704,45596,137281300,0,2,0,1024,8,4167460172
9376,137239533,43904,137283437,0,2,0,512,8,5272725547
9377,137251635,53753,137305388,0,3,1,91136,4,7169282289
9378,137329624,43904,137373528,0,2,0,512,8,5080100558
9379,137403744,47600,137451344,0,5,0,2560,46,4798885052
9380,137422141,2946,137425087,0,2,1,3072,8,4509162004
9381,137442534,16613,137459147,0,3,1,32256,4,1314546680
9382,137455460,43904,137499364,0,5,0,512,46,10207181268
9383,137507811,80552,137588363,0,0,0,19968,38,3447455373
9384,137552214,5802,137558016,0,5,1,6144,46,9099137894
9385,137557124,25446,137582570,0,3,1,46080,4,5248426738
9386,137566269,110552,137676821,0,0,0,62976,38,8011759496
9387,137603573,43904,137647477,0,5,0,512,46,7942224884
9388,137637621,110708,137748329,0,0,0,63488,38,8330587044
9389,137667852,162731,137830583,0,0,0,105472,38,6712644798
9390,137675299,43904,137719203,0,5,0,512,46,7288829734
9391,137745785,136008,137881793,0,0,0,45568,38,6020905949
9392,137785054,50672,137835726,0,5,0,2560,46,2521665202
9393,137795971,43904,137839875,0,2,0,512,8,886707795
9394,137809183,43904,137853087,0,5,0,512,46,4642088565
9395,137848418,25962,137874380,0,3,1,47104,4,3018526294
9396,137864089,48980,137913069,0,5,0,2048,46,4503607776
9397,137942732,1518,137944250,0,3,1,1536,4,379078944
9398,137948039,54270,138002309,0,3,1,92160,4,5759576688
9399,137967108,41922,138009030,0,3,1,32256,4,6366584936
9400,138012231,43904,138056135,0,5,0,512,46,3942374728
9401,138036041,43904,138079945,0,2,0,512,8,7305267860
9402,138179800,6754,138186554,0,2,1,7168,8,9166859357
9403,138201457,43904,138245361,0,2,0,512,8,7947037469
9404,138306414,43904,138350318,0,5,0,512,46,9716483725
9405,138402263,45596,138447859,0,5,0,1024,46,6877820737
9406,138446629,104468,138551097,0,0,0,43008,38,5539875267
9407,138453641,43904,138497545,0,2,0,512,8,793736225
9408,138465984,47288,138513272,0,0,0,1536,38,8377140663
9409,138495814,43904,138539718,0,2,0,512,8,4946913572
9410,138516968,44596,138561564,0,2,0,512,8,7487774246
9411,138562505,84980,138647485,0,0,0,14336,38,8997933785
9412,138585995,48980,138634975,0,2,0,2048,8,4196059494
9413,138610001,55748,138665749,0,0,0,4096,38,4669007495
9414,138627332,50672,138678004,0,2,0,2560,8,3463747726
9415,138644717,43904,138688621,0,2,0,512,8,6064868009
9416,138674619,99008,138773627,0,0,0,25088,38,1002899830
9417,138680315,127392,138807707,0,0,0,20992,38,178673774
9418,138703046,43904,138746950,0,5,0,512,46,2503412494
9419,138740939,43904,138784843,0,5,0,512,46,1523006450
9420,138782294,43904,138826198,0,5,0,512,46,6517782748
9421,138783621,43904,138827525,0,5,0,512,46,3113107750
9422,138860753,44060,138904813,0,5,0,1024,46,4675971997
9423,138922623,45596,138968219,0,5,0,1024,46,10396653157
9424,138998740,43904,139042644,0,5,0,512,46,1459002577
9425,139084096,45596,139129692,0,5,0,1024,46,2410111085
9426,139093634,45596,139139230,0,2,0,1024,8,9080670996
9427,139095451,57623,139153074,0,5,0,1024,46,511614834
9428,139102769,121160,139223929,0,0,0,97792,38,3352263316
9429,139129731,153184,139282915,0,0,0,58368,38,7505998657
9430,139146401,192812,139339213,0,0,0,35328,38,8349781807
9431,139174721,6278,139180999,0,5,1,6656,46,1078652708
9432,139190486,2470,139192956,0,5,1,2560,46,6094594579
9433,139191148,45596,139236744,0,2,0,1024,8,8458723727
9434,139191214,6855,139198069,0,5,1,7168,46,6271440782
9435,139199493,1994,139201487,0,5,1,2048,46,9772915031
9436,139242349,116618,139358967,0,0,0,6144,38,9591280841
9437,139256339,86477,139342816,0,0,0,11776,38,7587858875
9438,139314581,1994,139316575,0,5,1,2048,46,9058672278
9439,139337331,566,139337897,0,5,1,512,46,7975692467
9440,139383682,45596,139429278,0,5,0,1024,46,2541712109
9441,139397024,130208,139527232,0,0,0,127488,38,6435606735
9442,139440647,5802,139446449,0,3,1,6144,4,10550064391
9443,139451567,114509,139566076,0,0,0,10752,38,1701555300
9444,139472848,43904,139516752,0,5,0,512,46,9775117530
9445,139529010,48980,139577990,0,5,0,2048,46,2081921217
9446,139557542,49448,139606990,0,0,0,3584,38,9249672440
9447,139576034,566,139576600,0,3,1,512,4,9851947895
9448,139579358,4850,139584208,0,3,1,5120,4,9323978748
9449,139597951,3422,139601373,0,5,1,3584,46,9437666535
9450,139598515,7364,139605879,0,5,1,7168,46,5981820277
9451,139600545,3387,139603932,0,3,1,9728,4,46959428
9452,139608104,32987,139641091,0,3,1,57344,4,8264213395
9453,139608823,2470,139611293,0,5,1,2560,46,8805760271
9454,139620172,62516,139682688,0,0,0,6144,38,2663261298
9455,139626496,19421,139645917,0,3,1,7680,4,695180340
9456,139633107,45596,139678703,0,2,0,1024,8,751281742
9457,139661185,45596,139706781,0,5,0,1024,46,5398641109
9458,139731527,4374,139735901,0,5,1,4608,46,10603349838
9459,139741025,6754,139747779,0,5,1,7168,46,2311882023
9460,139747602,46517,139794119,0,5,0,512,46,7349419061
9461,139749501,43904,139793405,0,2,0,512,8,1022344392
9462,139759236,14804,139774040,0,3,1,28672,4,579804076
9463,139765567,43904,139809471,0,5,0,512,46,83841404
9464,139790820,110240,139901060,0,0,0,61952,38,5616114234
9465,139859275,43904,139903179,0,5,0,512,46,285957248
9466,139861684,13512,139875196,0,3,1,26112,4,6242786132
9467,139862959,1518,139864477,0,5,1,1536,46,3983365265
9468,139990168,47288,140037456,0,2,0,1536,8,1239963952
9469,140006379,47288,140053667,0,5,0,1536,46,10097792899
9470,140006632,53841,140060473,0,3,1,88064,4,3551589565
9471,140037318,2470,140039788,0,5,1,2560,46,7957369683
9472,140069403,45596,140114999,0,5,0,1024,46,5510010626
9473,140174141,5802,140179943,0,5,1,6144,46,3570967863
9474,140185704,1042,140186746,0,5,1,1024,46,2381304641
9475,140230747,86204,140316951,0,0,0,13312,38,1817456006
9476,140261792,45596,140307388,0,5,0,1024,46,6123580592
9477,140263706,104624,140368330,0,0,0,43520,38,9643241969
9478,140296572,73177,140369749,0,0,0,4608,38,3083133424
9479,140304322,43904,140348226,0,5,0,512,46,8296880331
9480,140352834,2946,140355780,0,2,1,3072,8,1305538903
9481,140372581,104624,140477205,0,0,0,43520,38,5040601264
9482,140394821,47600,140442421,0,2,0,2560,8,2614234045
9483,140452970,48980,140501950,0,2,0,2048,8,9372176839
9484,140473061,82060,140555121,0,0,0,16384,38,5636518738
9485,140473300,161092,140634392,0,0,0,41984,38,1804746064
9486,140475600,43904,140519504,0,2,0,512,8,7065436432
9487,140485097,45596,140530693,0,5,0,1024,46,5496141207
9488,140545665,75920,140621585,0,0,0,14848,38,6100975859
9489,140559844,45596,140605440,0,2,0,1024,8,4850923748
9490,140559953,7230,140567183,0,5,1,7680,46,1088337436
9491,140565659,161187,140726846,0,5,0,1536,46,3857171239
9492,140580306,7230,140587536,0,5,1,7680,46,281619283
9493,140609348,4679,140614027,0,5,1,12288,46,4780509139
9494,140656845,77711,140734556,0,5,0,512,46,5582954141
9495,140715926,44060,140759986,0,5,0,1024,46,4340335069
9496,140728780,47600,140776380,0,2,0,2560,8,10555022777
9497,140833515,47288,140880803,0,2,0,1536,8,5898646819
9498,140842805,43904,140886709,0,0,0,512,38,4524552092
9499,140879747,43904,140923651,0,5,0,512,46,5217945340
9500,140881789,45596,140927385,0,5,0,1024,46,6530448295
9501,140884436,54056,140938492,0,0,0,3584,38,4558840513
9502,141003785,48980,141052765,0,5,0,2048,46,636498072
9503,141015489,1518,141017007,0,3,1,1536,4,9334717174
9504,141025851,43904,141069755,0,2,0,512,8,436716684
9505,141028304,43904,141072208,0,5,0,512,46,1920856536
9506,141171085,77324,141248409,0,0,0,19456,38,6443230026
9507,141178210,43904,141222114,0,2,0,512,8,4707731233
9508,141254232,1518,141255750,0,5,1,1536,46,9711126551
9509,141257866,104468,141362334,0,0,0,43008,38,6125847913
9510,141330872,119338,141450210,0,0,0,31744,38,1957432431
9511,141357117,45596,141402713,0,5,0,1024,46,9501732331
9512,141401761,47600,141449361,0,2,0,2560,8,2154613085
9513,141408146,45596,141453742,0,5,0,1024,46,6466419015
9514,141439485,1994,141441479,0,5,1,2048,46,6632586316
9515,141539099,3387,141542486,0,5,1,9728,46,10051859129
9516,141554197,1994,141556191,0,5,1,2048,46,7316192808
9517,141557037,3898,141560935,0,5,1,4096,46,4224600362
9518,141560634,7230,141567864,0,5,1,7680,46,2318453585
9519,141573324,566,141573890,0,5,1,512,46,6310966935
9520,141583921,43904,141627825,0,2,0,512,8,5808091958
9521,141593684,45596,141639280,0,2,0,1024,8,398757878
9522,141603774,45596,141649370,0,2,0,1024,8,938420339
9523,141640923,45596,141686519,0,5,0,1024,46,6987751534
9524,141736979,1042,141738021,0,5,1,1024,46,10233982217
9525,141804293,50672,141854965,0,5,0,2560,46,8174819427
9526,141879151,56840,141935991,0,0,0,7680,38,5680662007
9527,141888215,48259,141936474,0,0,0,1536,38,504636096
9528,141928434,43904,141972338,0,0,0,512,38,2392809113
9529,142089221,47288,142136509,0,0,0,1536,38,9863283174
9530,142148240,43904,142192144,0,0,0,512,38,3384272217
9531,142181419,2470,142183889,0,5,1,2560,46,4603605437
9532,142226192,103508,142329700,0,5,0,1024,46,5869422003
9533,142272238,43904,142316142,0,5,0,512,46,8237935873
9534,142294781,50672,142345453,0,5,0,2560,46,6825700492
9535,142360128,43904,142404032,0,5,0,512,46,10240271363
9536,142426642,45596,142472238,0,5,0,1024,46,4236728148
9537,142451888,45752,142497640,0,5,0,1536,46,10150004186
9538,142503218,45596,142548814,0,5,0,1024,46,5993239758
9539,142538832,43904,142582736,0,5,0,512,46,8628141549
9540,142587409,45596,142633005,0,5,0,1024,46,10256626400
9541,142671990,43904,142715894,0,5,0,512,46,1874847725
9542,142927677,47288,142974965,0,5,0,1536,46,42642780
9543,143214917,45596,143260513,0,5,0,1024,46,10606064085
9544,143620146,45596,143665742,0,5,0,1024,46,5556902268
9545,143829425,5454,143834879,0,3,1,13824,4,1885389082
9546,143842753,47288,143890041,0,5,0,1536,46,2909884308
9547,144013541,45596,144059137,0,5,0,1024,46,6427924618
9548,144032859,45596,144078455,0,5,0,1024,46,2388190499
9549,144052338,45596,144097934,0,5,0,1024,46,7948166102
9550,144177068,43904,144220972,0,5,0,512,46,2850949197
9551,144228146,10241,144238387,0,3,1,16384,4,1305612991
9552,144269095,22691,144291786,0,3,1,37376,4,6984981495
9553,144290738,14545,144305283,0,3,1,28160,4,3010851218
9554,144431973,2470,144434443,0,3,1,2560,4,9654099472
9555,144501836,20366,144522202,0,3,1,32768,4,7093694580
9556,144558080,45596,144603676,0,5,0,1024,46,7355965888
9557,144619052,43904,144662956,0,5,0,512,46,5432278256
9558,144654673,20882,144675555,0,3,1,33792,4,2994292945
9559,144878047,45596,144923643,0,5,0,1024,46,9884580465
9560,144928550,47288,144975838,0,5,0,1536,46,2346103265
9561,144950160,43975,144994135,0,3,1,72192,4,9915226237
9562,145061718,45596,145107314,0,5,0,1024,46,7473814420
9563,145108548,43904,145152452,0,5,0,512,46,960960003
9564,145153497,55045,145208542,0,3,1,93696,4,6931578731
9565,145190784,19384,145210168,0,3,1,2560,4,7514211132
9566,145245680,52364,145298044,0,5,0,3072,46,2301823439
9567,145248676,53495,145302171,0,3,1,90624,4,1258080851
9568,145274489,48980,145323469,0,5,0,2048,46,2089120686
9569,145504585,45596,145550181,0,5,0,1024,46,9962131176
9570,145556875,47288,145604163,0,0,0,1536,38,5980593359
9571,145591655,54056,145645711,0,0,0,3584,38,1117466137
9572,145634775,60460,145695235,0,0,0,2560,38,3483560866
9573,145695669,43904,145739573,0,0,0,512,38,903531896
9574,145705811,43904,145749715,0,0,0,512,38,830013566
9575,145746786,43904,145790690,0,5,0,512,46,4341729410
9576,145818638,45596,145864234,0,5,0,1024,46,8281723861
9577,146040766,51452,146092218,0,0,0,5120,38,7151726744
9578,146058730,3422,146062152,0,5,1,3584,46,932806877
9579,146071865,43904,146115769,0,5,0,512,46,2067738234
9580,146098240,64208,146162448,0,5,0,6656,46,2962561572
9581,146147303,3898,146151201,0,5,1,4096,46,4370025969
9582,146228198,1042,146229240,0,5,1,1024,46,10167276880
9583,146400978,3422,146404400,0,5,1,3584,46,4187312375
9584,146693916,103064,146796980,0,5,0,38400,46,1714468380
9585,146744563,89035,146833598,0,5,0,11264,46,6957582413
9586,146810283,45596,146855879,0,0,0,1024,38,9509260900
9587,146817334,61927,146879261,0,0,0,1024,38,10651534197
9588,146918049,47288,146965337,0,5,0,1536,46,2680924768
9589,146975808,45596,147021404,0,0,0,1024,38,5217066926
9590,147010085,58532,147068617,0,5,0,8192,46,2890284982
9591,147032714,99269,147131983,0,5,0,18432,46,1335752117
9592,147032819,45596,147078415,0,0,0,1024,38,10007351397
9593,147060065,104624,147164689,0,5,0,43520,46,7070407201
9594,147220494,3128,147223622,0,5,1,9216,46,8076460662
9595,147264894,118352,147383246,0,5,0,88576,46,10320773471
9596,147307490,45596,147353086,0,0,0,1024,38,3585634393
9597,147588002,47288,147635290,0,0,0,1536,38,10182435702
9598,147647269,54056,147701325,0,5,0,3584,46,3925603400
9599,147824373,116012,147940385,0,5,0,80896,46,1288019636
9600,147948957,74672,148023629,0,5,0,10752,46,9774256538
9601,147956374,45596,148001970,0,0,0,1024,38,8619030101
9602,147986078,112761,148098839,0,5,0,24576,46,3446120407
9603,148078780,43904,148122684,0,0,0,512,38,3882227684
9604,148132304,1042,148133346,0,5,1,1024,46,10529810280
9605,148158335,43904,148202239,0,0,0,512,38,8752737858
9606,148206623,50672,148257295,0,0,0,2560,38,1405968311
9607,148380404,43904,148424308,0,0,0,512,38,574596044
9608,148540203,48980,148589183,0,0,0,2048,38,9063327084
9609,148616893,45908,148662801,0,0,0,2048,38,10282254489
9610,148656097,43904,148700001,0,0,0,512,38,4182982444
9611,148672994,47288,148720282,0,0,0,1536,38,3815046256
9612,148796311,108368,148904679,0,0,0,55808,38,221546673
9613,148886266,116324,149002590,0,0,0,81920,38,7240088281
9614,148896004,108317,149004321,0,0,0,5632,38,785850208
9615,148908084,108272,149016356,0,0,0,39424,38,9419865988
9616,148989323,122266,149111589,0,0,0,52224,38,6443552613
9617,149260652,72668,149333320,0,0,0,9216,38,10301937735
9618,149274123,107276,149381399,0,0,0,52224,38,401625176
9619,149391524,101816,149493340,0,0,0,34304,38,6968642531
9620,149901869,95444,149997313,0,0,0,18432,38,6774708152
9621,149956495,134304,150090799,0,0,0,97280,38,10530772665
9622,149990088,147060,150137148,0,0,0,6144,38,2976578649
9623,150003025,132236,150135261,0,0,0,58880,38,2853627431
9624,150039973,142346,150182319,0,0,0,30720,38,10340753150
9625,150078311,143686,150221997,0,0,0,33792,38,9591597792
9626,150144931,122222,150267153,0,0,0,66048,38,744683811
9627,150150261,151122,150301383,0,0,0,20992,38,7787949099
9628,150208551,145728,150354279,0,0,0,33280,38,10547069704
9629,150329049,105248,150434297,0,0,0,45568,38,9675044594
9630,150380108,59600,150439708,0,0,0,6656,38,7206712243
9631,150412053,197924,150609977,0,0,0,188416,38,6436073178
9632,150505698,159239,150664937,0,0,0,69120,38,225568107
9633,150590114,129003,150719117,0,0,0,58368,38,10181438213
9634,150673893,224840,150898733,0,0,0,186880,38,587311445
9635,150834550,95912,150930462,0,0,0,19968,38,9758218653
9636,150865753,138869,151004622,0,0,0,47616,38,6877303114
9637,150881266,174848,151056114,0,0,0,55296,38,3453365849
9638,150996625,124895,151121520,0,0,0,41984,38,331717687
9639,151007545,75140,151082685,0,0,0,12288,38,408894363
9640,151205976,105404,151311380,0,0,0,46080,38,3139667090
9641,151343899,111644,151455543,0,0,0,66560,38,3997071576
9642,151400984,127141,151528125,0,0,0,76800,38,1008953250
9643,151424928,153639,151578567,0,0,0,49664,38,1656340024
9644,151544347,111332,151655679,0,0,0,65536,38,442358293
9645,151780752,55748,151836500,0,0,0,4096,38,9821539346
9646,151917896,85760,152003656,0,0,0,16896,38,3473909670
9647,152063108,64208,152127316,0,0,0,6656,38,9491466605
9648,152068615,104468,152173083,0,0,0,43008,38,3830443444
9649,152185164,95156,152280320,0,0,0,22528,38,3489295745
9650,152207335,171151,152378486,0,0,0,116736,38,4488532290
9651,152348609,97329,152445938,0,0,0,12288,38,6659273075
9652,152443000,58678,152501678,0,0,0,4096,38,163206950
9653,152759580,80528,152840108,0,0,0,14848,38,3745154968
9654,153112551,54992,153167543,0,0,0,6656,38,5054411607
9655,153154160,104156,153258316,0,0,0,41984,38,7357986364
9656,153188607,100027,153288634,0,0,0,14336,38,1968093829
9657,153321582,112268,153433850,0,0,0,68608,38,7474645137
9658,153431017,110725,153541742,0,0,0,54272,38,9606067994
9659,153491361,55748,153547109,0,0,0,4096,38,4146269172
9660,153515131,131491,153646622,0,0,0,98816,38,8585529884
9661,153682403,101972,153784375,0,0,0,34816,38,2239903587
9662,153949678,73472,154023150,0,0,0,16896,38,2678134030
9663,154399888,99632,154499520,0,0,0,27136,38,3724940601
9664,154480652,103532,154584184,0,0,0,39936,38,3929372598
9665,154816450,62516,154878966,0,0,0,6144,38,10567301219
9666,154910599,99320,155009919,0,0,0,26112,38,2983651409
9667,154913402,104956,155018358,0,0,0,27648,38,9167113709
9668,154924193,129100,155053293,0,0,0,31232,38,9140840302
9669,155077378,47600,155124978,0,0,0,2560,38,8128748377
9670,155113473,196208,155309681,0,0,0,182784,38,6210860664
9671,155124100,102733,155226833,0,0,0,6656,38,3199542058
9672,155146160,241083,155387243,0,0,0,126464,38,8735035750
9673,155180607,134081,155314688,0,0,0,16384,38,97132853
9674,155394514,114764,155509278,0,0,0,76800,38,7133722715
9675,155415956,99889,155515845,0,0,0,21504,38,7563759879
9676,155514812,66925,155581737,0,0,0,7168,38,2614332049
9677,155538694,124229,155662923,0,0,0,45056,38,7517821043
9678,155546272,102908,155649180,0,0,0,37888,38,88980720
9679,155622764,140647,155763411,0,0,0,75776,38,3598109706
9680,155699802,143997,155843799,0,0,0,39936,38,815340630
9681,155791601,221512,156013113,0,0,0,206336,38,9739415025
9682,155848279,181853,156030132,0,0,0,55808,38,9563999116
9683,155892536,149007,156041543,0,0,0,37376,38,8060625422
9684,155993790,135498,156129288,0,0,0,25600,38,8506559058
9685,156120261,108992,156229253,0,0,0,57856,38,8017106370
9686,156154111,139768,156293879,0,0,0,41984,38,3054410702
9687,156165204,151415,156316619,0,0,0,10752,38,6443222760
9688,156231507,123566,156355073,0,0,0,14848,38,7551150539
9689,156247496,179199,156426695,0,0,0,16896,38,5997712540
9690,156433214,114296,156547510,0,0,0,75264,38,8924732557
9691,156718564,43904,156762468,0,0,0,512,38,9458386797
9692,157459228,100724,157559952,0,0,0,30720,38,2709847706
9693,157657862,93752,157751614,0,0,0,17920,38,4570117721
9694,157727309,81464,157808773,0,0,0,17920,38,3327753097
9695,157889577,57752,157947329,0,0,0,5632,38,3558864029
9696,158035482,115856,158151338,0,0,0,80384,38,1997987493
9697,158117514,62108,158179622,0,0,0,4608,38,9175199670
9698,158119218,112952,158232170,0,0,0,40960,38,9715218768
9699,158201669,116817,158318486,0,0,0,24576,38,6082466453
9700,158244823,102877,158347700,0,0,0,23552,38,5408197121
9701,158246057,63140,158309197,0,0,0,8192,38,7481127537
9702,158247033,160607,158407640,0,0,0,64000,38,9954997757
9703,158307083,230511,158537594,0,0,0,156672,38,6404537568
9704,158349538,129057,158478595,0,0,0,28160,38,5550118037
9705,158411645,138756,158550401,0,0,0,41984,38,8666810442
9706,158543836,93565,158637401,0,0,0,20992,38,9569202284
9707,158665269,107588,158772857,0,0,0,53248,38,2645595477
9708,158775405,101192,158876597,0,0,0,32256,38,8688201894
9709,158819720,98049,158917769,0,0,0,18944,38,8219809923
9710,158853402,136637,158990039,0,0,0,28160,38,10120130671
9711,159151706,97760,159249466,0,0,0,20992,38,10668235797
9712,159304853,101504,159406357,0,0,0,33280,38,5842530177
9713,159536900,109460,159646360,0,0,0,59392,38,7632879243
9714,159692948,116948,159809896,0,0,0,83968,38,6960353471
9715,159738019,133169,159871188,0,0,0,51712,38,10285987237
9716,159747780,107637,159855417,0,0,0,8704,38,9641071767
9717,159901606,110552,160012158,0,0,0,62976,38,7400485241
9718,160119740,59132,160178872,0,0,0,5120,38,3946636392
9719,160131716,82820,160214536,0,0,0,12288,38,8557012156
9720,160236752,87296,160324048,0,0,0,16896,38,10611331617
9721,160255474,125058,160380532,0,0,0,40960,38,7295180027
9722,160403268,112892,160516160,0,0,0,70656,38,1143112513
9723,160429513,146569,160576082,0,0,0,34304,38,9874863898
9724,160457129,192783,160649912,0,0,0,48640,38,3782178366
9725,160536534,145964,160682498,0,0,0,13312,38,5312389939
9726,160688399,60980,160749379,0,0,0,6144,38,2991960702
9727,160803969,55748,160859717,0,0,0,4096,38,9695455692
9728,160821174,60824,160881998,0,0,0,5632,38,960970578
9729,161041913,54056,161095969,0,0,0,3584,38,607139398
9730,161145423,100256,161245679,0,0,0,29184,38,6962375412
9731,161303362,126464,161429826,0,0,0,115200,38,500898823
9732,161308874,144676,161453550,0,0,0,31744,38,9199927083
9733,161354261,140881,161495142,0,0,0,9728,38,10321440546
9734,161419775,202819,161622594,0,0,0,171520,38,6677222488
9735,161683390,109772,161793162,0,0,0,60416,38,8586086088
9736,162224489,70976,162295465,0,0,0,8704,38,7281585888
9737,162263144,96980,162360124,0,0,0,18432,38,9576086714
9738,162270820,180339,162451159,0,0,0,72704,38,3556366946
9739,162279315,204415,162483730,0,0,0,34816,38,1552935096
9740,162359066,105371,162464437,0,0,0,14336,38,7933268841
9741,162624850,80060,162704910,0,0,0,13312,38,4457376744
9742,162653540,43904,162697444,0,0,0,512,38,6420147710
9743,162868984,127712,162996696,0,0,0,119296,38,4142125079
9744,163117206,86204,163203410,0,0,0,13312,38,6543063455
9745,163187674,105248,163292922,0,0,0,45568,38,8969857111
9746,163219972,97208,163317180,0,0,0,3072,38,464261732
9747,163237120,101972,163339092,0,0,0,34816,38,7764504350
9748,163268636,116194,163384830,0,0,0,42496,38,2864659137
9749,163809382,79436,163888818,0,0,0,11264,38,860114535
9750,164098555,100880,164199435,0,0,0,31232,38,6467958824
9751,164240946,45596,164286542,0,0,0,1024,38,2913735368
9752,164278220,109616,164387836,0,0,0,59904,38,7480851740
9753,164296429,129483,164425912,0,0,0,23552,38,4689586484
9754,164658887,115388,164774275,0,0,0,78848,38,3618502206
9755,165378735,128804,165507539,0,0,0,122880,38,6544607580
9756,165740547,101348,165841895,0,0,0,32768,38,2455802127
9757,166130708,115544,166246252,0,0,0,79360,38,1681635797
9758,166575826,121472,166697298,0,0,0,98816,38,1959099424
9759,166802878,107744,166910622,0,0,0,53760,38,1830973350
9760,166846788,151710,166998498,0,0,0,42496,38,1902090949
9761,166943851,77867,167021718,0,0,0,512,38,2526056164
9762,167102515,96356,167198871,0,0,0,16384,38,2042294047
9763,167165272,99944,167265216,0,0,0,28160,38,6908884985
9764,167187657,101829,167289486,0,0,0,20992,38,4455651252
9765,167705918,116948,167822866,0,0,0,83968,38,7769662370
9766,167951551,119444,168070995,0,0,0,92160,38,6777795295
9767,168045398,124129,168169527,0,0,0,23552,38,9991861938
9768,168085829,161710,168247539,0,0,0,118272,38,2711321502
9769,168195545,116636,168312181,0,0,0,82944,38,8851947165
9770,168455336,110552,168565888,0,0,0,62976,38,8535121617
9771,168517463,173761,168691224,0,0,0,61440,38,4657093849
9772,168531988,105248,168637236,0,0,0,45568,38,8243103143
9773,168608015,60824,168668839,0,0,0,5632,38,5386629804
9774,168668468,86591,168755059,0,0,0,18432,38,3464924436
9775,168671282,206603,168877885,0,0,0,32256,38,1468279813
9776,168683439,73507,168756946,0,0,0,6144,38,1795903311
9777,168719525,135416,168854941,0,0,0,52736,38,7819048155
9778,168877461,73084,168950545,0,0,0,9216,38,2074201989
9779,169018904,104780,169123684,0,0,0,44032,38,5352092919
9780,169167741,56528,169224269,0,0,0,6656,38,829782744
9781,169319051,115700,169434751,0,0,0,79872,38,7578166099
9782,169646842,108992,169755834,0,0,0,57856,38,5382058925
9783,169819279,202916,170022195,0,0,0,204800,38,2390298860
9784,170393204,111644,170504848,0,0,0,66560,38,5606195305
9785,170495736,114040,170609776,0,0,0,44544,38,5941155883
9786,170990054,76700,171066754,0,0,0,17408,38,5070533615
9787,171153201,96947,171250148,0,0,0,14848,38,5462552735
9788,171165213,80396,171245609,0,0,0,19456,38,3593437130
9789,171238868,80373,171319241,0,0,0,16896,38,310273012
9790,171262411,109772,171372183,0,0,0,60416,38,5332090435
9791,171321466,77873,171399339,0,0,0,6144,38,1047663194
9792,171485700,113048,171598748,0,0,0,71168,38,2124438642
9793,171768797,108212,171877009,0,0,0,55296,38,4289986979
9794,171986313,73604,172059917,0,0,0,12288,38,4848680684
9795,172215713,43904,172259617,0,0,0,512,38,902474061
9796,172237701,71444,172309145,0,0,0,10240,38,3688747036
9797,172304735,124592,172429327,0,0,0,109056,38,8579738039
9798,172715550,109460,172825010,0,0,0,59392,38,3188152414
9799,172720481,105636,172826117,0,0,0,3584,38,2878236309
9800,172802997,94376,172897373,0,0,0,19968,38,3037859585
9801,172984299,110708,173095007,0,0,0,63488,38,4905623283
9802,173341617,62672,173404289,0,0,0,6656,38,10075246671
9803,173346270,101660,173447930,0,0,0,33792,38,2789674314
9804,173388699,70976,173459675,0,0,0,8704,38,2916287657
9805,173495796,79436,173575232,0,0,0,11264,38,6872082589
9806,173543031,128501,173671532,0,0,0,27648,38,9685597015
9807,173589748,218074,173807822,0,0,0,161280,38,2529240958
9808,173625539,191034,173816573,0,0,0,28672,38,4966523342
9809,173681659,143041,173824700,0,0,0,26624,38,3823900346
9810,173824578,56330,173880908,0,0,0,5632,38,3909734807
9811,174145397,82088,174227485,0,0,0,19968,38,808595567
9812,174466396,103376,174569772,0,0,0,39424,38,6840175722
9813,174878454,97340,174975794,0,0,0,29696,38,6923535521
9814,174995033,55748,175050781,0,0,0,4096,38,8796211539
9815,175122711,101660,175224371,0,0,0,33792,38,4420027053
9816,175204361,104312,175308673,0,0,0,42496,38,10459824896
9817,175615406,117416,175732822,0,0,0,85504,38,2091692248
9818,175620063,124519,175744582,0,0,0,38400,38,10599903082
9819,175866252,70976,175937228,0,0,0,8704,38,7247211883
9820,190624078,110084,190734162,0,0,0,61440,38,4694965741
9821,216529400,67772,216597172,0,0,0,13312,38,10085500205
9822,218058338,65900,218124238,0,0,0,7168,38,1288053575
9823,229057117,103688,229160805,0,0,0,40448,38,1227577286
9824,281662377,100412,281762789,0,0,0,29696,38,3530575141
9825,297488436,86252,297574688,0,0,0,23552,38,9968869732
9826,301209143,75296,301284439,0,0,0,12800,38,7729245514
9827,301288801,92972,301381773,0,0,0,15360,38,810061410
9828,301423773,123812,301547585,0,0,0,106496,38,2138659773
9829,301460123,87633,301547756,0,0,0,512,38,10137741123
9830,301542327,108329,301650656,0,0,0,37888,38,6374379343
9831,301602779,118587,301721366,0,0,0,41984,38,6195073854
9832,301834025,196208,302030233,0,0,0,182784,38,9047096738
9833,302084757,82820,302167577,0,0,0,12288,38,7452271101
9834,302539516,112112,302651628,0,0,0,68096,38,2867493540
9835,302740917,97916,302838833,0,0,0,21504,38,4650518327
9836,302787113,80528,302867641,0,0,0,14848,38,3430829688
9837,302813851,105872,302919723,0,0,0,47616,38,7815356143
9838,303063398,64208,303127606,0,0,0,6656,38,8443443461
9839,303558723,130520,303689243,0,0,0,128512,38,10693529808
9840,303582290,159177,303741467,0,0,0,15360,38,4064825761
9841,303636331,60832,303697163,0,0,0,1024,38,2875696603
9842,303690995,165452,303856447,0,0,0,142336,38,3430219869
9843,303727827,191062,303918889,0,0,0,119296,38,4469196007
9844,304010733,101504,304112237,0,0,0,33280,38,9269188236
9845,304062280,72668,304134948,0,0,0,9216,38,4349229382
9846,304232947,104312,304337259,0,0,0,42496,38,8444819412
9847,304587469,81440,304668909,0,0,0,12800,38,9919028773
9848,304632643,101972,304734615,0,0,0,34816,38,9060166285
9849,304678061,192012,304870073,0,0,0,37888,38,9532574424
9850,304697703,98228,304795931,0,0,0,22528,38,7581838835
9851,304834041,133730,304967771,0,0,0,130560,38,235093419
9852,304847806,122788,304970594,0,0,0,9216,38,3849792435
9853,305123840,99008,305222848,0,0,0,25088,38,1485363968
9854,305517619,64208,305581827,0,0,0,6656,38,8083158432
9855,305557283,92552,305649835,0,0,0,24064,38,7128440042
9856,305574643,142782,305717425,0,0,0,17920,38,7798085885
9857,305633111,137678,305770789,0,0,0,31744,38,10670637026
9858,305845345,67592,305912937,0,0,0,7680,38,6030760994
9859,306393606,111644,306505250,0,0,0,66560,38,6494098312
9860,306811522,101348,306912870,0,0,0,32768,38,10429887438
9861,306893100,79436,306972536,0,0,0,11264,38,68518758
9862,307122931,103376,307226307,0,0,0,39424,38,958713677
9863,307208591,73136,307281727,0,0,0,10752,38,6549405963
9864,307329348,79904,307409252,0,0,0,12800,38,6483018567
9865,307351863,74360,307426223,0,0,0,9728,38,2869883020
9866,307564342,86696,307651038,0,0,0,19968,38,4298604325
9867,307613699,86696,307700395,0,0,0,19968,38,5722831685
9868,307681648,91172,307772820,0,0,0,24576,38,1723320773
9869,307740538,123740,307864278,0,0,0,96768,38,2294148918
9870,307972054,70976,308043030,0,0,0,8704,38,3175821763
9871,308031087,45596,308076683,0,0,0,1024,38,606071077
9872,308150161,45596,308195757,0,0,0,1024,38,1058835029
9873,308415013,43904,308458917,0,0,0,512,38,10398167549
9874,308420388,45596,308465984,0,0,0,1024,38,9291318237
9875,308526785,43904,308570689,0,0,0,512,38,4647702053
9876,308890588,47288,308937876,0,0,0,1536,38,10440607424
9877,308921098,43904,308965002,0,0,0,512,38,6611161537
9878,308966871,43904,309010775,0,0,0,512,38,3999369407
9879,309011991,43904,309055895,0,0,0,512,38,435833974
9880,309107620,43904,309151524,0,0,0,512,38,4201438373
9881,309157720,45596,309203316,0,0,0,1024,38,10721566795
9882,309436054,45596,309481650,0,0,0,1024,38,2891188855
9883,309552877,43904,309596781,0,0,0,512,38,6749437673
9884,309616987,45596,309662583,0,0,0,1024,38,2708272293
9885,309620801,43904,309664705,0,0,0,512,38,7527161087
9886,309692160,45596,309737756,0,0,0,1024,38,2461366262
9887,309816933,43904,309860837,0,0,0,512,38,2974614089
9888,310333143,88232,310421375,0,0,0,19968,38,4381172785
9889,310421707,45596,310467303,0,0,0,1024,38,8472213805
9890,310454581,117758,310572339,0,0,0,46080,38,7061660034
9891,310650894,100568,310751462,0,0,0,30208,38,2888764127
9892,310688888,128100,310816988,0,0,0,42496,38,10020037369
9893,310798067,72848,310870915,0,0,0,14848,38,5160943826
9894,310981546,47288,311028834,0,0,0,1536,38,6930268036
9895,311005947,43904,311049851,0,0,0,512,38,405932044
9896,311363380,47444,311410824,0,0,0,2048,38,8097045945
9897,311365537,50672,311416209,0,0,0,2560,38,901105626
9898,311466313,43904,311510217,0,0,0,512,38,3253900772
9899,312168723,47288,312216011,0,0,0,1536,38,6517730894
9900,312229771,50672,312280443,0,0,0,2560,38,5848989006
9901,312722579,43904,312766483,0,0,0,512,38,2437364795
9902,312786207,48980,312835187,0,0,0,2048,38,6865999394
9903,312813263,43904,312857167,0,0,0,512,38,3062860030
9904,312888074,45596,312933670,0,0,0,1024,38,10545056502
9905,313037553,45596,313083149,0,0,0,1024,38,8395368776
9906,313202622,43904,313246526,0,0,0,512,38,395444468
9907,313242560,47288,313289848,0,0,0,1536,38,7069562632
9908,313338856,43904,313382760,0,0,0,512,38,311246211
9909,313341813,47288,313389101,0,0,0,1536,38,2761192282
9910,313488282,47288,313535570,0,0,0,1536,38,8285755558
9911,313719299,43904,313763203,0,0,0,512,38,9332724146
9912,314098362,45596,314143958,0,0,0,1024,38,2663623637
9913,314362032,45596,314407628,0,0,0,1024,38,7359387515
9914,314571557,43904,314615461,0,0,0,512,38,1277592154
9915,314771597,45596,314817193,0,0,0,1024,38,5618220026
9916,314973170,43904,315017074,0,0,0,512,38,3784399230
9917,315002418,43904,315046322,0,0,0,512,38,5001664551
9918,315071461,43904,315115365,0,0,0,512,38,324485042
9919,315298849,43904,315342753,0,0,0,512,38,2659519388
9920,315462645,54056,315516701,0,0,0,3584,38,7327402894
9921,315525717,48980,315574697,0,0,0,2048,38,2748136660
9922,315604435,43904,315648339,0,0,0,512,38,8034283280
9923,315680895,43904,315724799,0,0,0,512,38,2547577821
9924,316094809,107588,316202397,0,0,0,53248,38,1196053982
9925,316154790,90459,316245249,0,0,0,5120,38,5633181479
9926,316289360,124748,316414108,0,0,0,109568,38,4229943689
9927,316333689,145831,316479520,0,0,0,24576,38,3915021393
9928,316611687,60824,316672511,0,0,0,5632,38,8438829759
9929,316628084,108836,316736920,0,0,0,57344,38,4199646183
9930,316653318,144856,316798174,0,0,0,75776,38,1890305665
9931,317409112,55748,317464860,0,0,0,4096,38,49143000
9932,317819138,108992,317928130,0,0,0,57856,38,8813437099
9933,317860800,128680,317989480,0,0,0,31232,38,6881921466
9934,318456941,81284,318538225,0,0,0,12288,38,1790840169
9935,318524966,54056,318579022,0,0,0,3584,38,1028146028
9936,318748689,80552,318829241,0,0,0,19968,38,3598823594
9937,318876041,48980,318925021,0,0,0,2048,38,6124950640
9938,318898928,61448,318960376,0,0,0,7680,38,4493563347
9939,318955923,90056,319045979,0,0,0,15872,38,4263012642
9940,318978940,89324,319068264,0,0,0,23552,38,1159480966
9941,319053125,106447,319159572,0,0,0,23552,38,5747853275
9942,319124678,118708,319243386,0,0,0,70656,38,4820882825
9943,319179156,130450,319309606,0,0,0,22528,38,10591773580
9944,319206205,57440,319263645,0,0,0,4608,38,1526733205
9945,319234779,77182,319311961,0,0,0,7680,38,4639942706
9946,319362135,115388,319477523,0,0,0,78848,38,2647842698
9947,319535362,116948,319652310,0,0,0,83968,38,6463713308
9948,319743014,97136,319840150,0,0,0,18944,38,6242321596
9949,319763506,87201,319850707,0,0,0,17920,38,2331392807
9950,319786139,95156,319881295,0,0,0,22528,38,3273448833
9951,319833863,110117,319943980,0,0,0,28672,38,4511860814
9952,319879584,149458,320029042,0,0,0,79872,38,4180396878
9953,320281454,127586,320409040,0,0,0,117760,38,8598651577
9954,320303584,66840,320370424,0,0,0,6144,38,8806352296
9955,320321701,144267,320465968,0,0,0,72704,38,2242932638
9956,320408174,117272,320525446,0,0,0,39936,38,5799664357
9957,320559193,66212,320625405,0,0,0,8192,38,5749666556
9958,320935053,47288,320982341,0,0,0,1536,38,3727734209
9959,321087895,99788,321187683,0,0,0,27648,38,7661516629
9960,321233988,101816,321335804,0,0,0,34304,38,8248465614
9961,321272196,139598,321411794,0,0,0,50688,38,8614629233
9962,321448433,101192,321549625,0,0,0,32256,38,7292335871
9963,321565624,99788,321665412,0,0,0,27648,38,6355751433
9964,321698891,89744,321788635,0,0,0,14848,38,3693988931
9965,321804610,57440,321862050,0,0,0,4608,38,9974135692
9966,322011146,97916,322109062,0,0,0,21504,38,9429842651
9967,322147554,102752,322250306,0,0,0,37376,38,9340625037
9968,322178160,162668,322340828,0,0,0,106496,38,10109039862
9969,322283140,120286,322403426,0,0,0,83968,38,4466695488
9970,322530812,84692,322615504,0,0,0,18432,38,10155876847
9971,322733816,103376,322837192,0,0,0,39424,38,245304494
9972,322747572,122512,322870084,0,0,0,76800,38,5856808740
9973,322752588,144080,322896668,0,0,0,28160,38,7682990418
9974,322839502,101972,322941474,0,0,0,34816,38,7731645139
9975,322878698,101192,322979890,0,0,0,32256,38,10568657968
9976,322884157,58268,322942425,0,0,0,3072,38,3907989206
9977,322937028,80266,323017294,0,0,0,1536,38,129152898
9978,323026714,194492,323221206,0,0,0,177152,38,8471731794
9979,323255165,69284,323324449,0,0,0,8192,38,9858250405
9980,323338832,128960,323467792,0,0,0,123392,38,9953356903
9981,323381484,144328,323525812,0,0,0,34304,38,2344893696
9982,323445026,97118,323542144,0,0,0,9728,38,1870430116
9983,323467006,120204,323587210,0,0,0,17920,38,590765057
9984,323481974,118214,323600188,0,0,0,38912,38,8914685049
9985,323525469,113653,323639122,0,0,0,14336,38,858345903
9986,323727633,112268,323839901,0,0,0,68608,38,853003163
9987,323936054,103064,324039118,0,0,0,38400,38,6851895810
9988,323991343,152706,324144049,0,0,0,53248,38,10114891241
9989,324011134,59132,324070266,0,0,0,5120,38,4398438372
9990,324021101,76832,324097933,0,0,0,12800,38,4210824761
9991,324107912,97136,324205048,0,0,0,18944,38,4030736857
9992,324446121,73760,324519881,0,0,0,12800,38,7139453419
9993,324574292,105560,324679852,0,0,0,46592,38,257010514
9994,324752501,118508,324871009,0,0,0,89088,38,7711144381
9995,325102506,106808,325209314,0,0,0,50688,38,5194310368
9996,325196486,121812,325318298,0,0,0,57856,38,5949823672
9997,325197796,141629,325339425,0,0,0,30208,38,6318450566
9998,325263537,108053,325371590,0,0,0,8704,38,2224705509
9999,325382385,43904,325426289,0,0,0,512,38,5605353091
