RequestID,ArrivalTime,DelayTime,FinishTime,InitiatorID,TargetID,IOType,Size,VolumeID,Offset
0,161782538,103743,161886281,7,0,0,28160,7,837216788
1,161791050,4374,161795424,27,0,1,4608,27,2365696549
2,161810395,140631,161951026,9,0,0,54272,9,5847191689
3,161816760,2470,161819230,21,0,1,2560,21,3753485423
4,161846670,137524,161984194,4,0,0,4608,4,3007257723
5,161856584,164983,162021567,26,0,0,77312,26,2231039488
6,161879417,172083,162051500,32,0,0,48640,32,4678316402
7,161913170,171452,162084622,9,0,0,31744,9,2987415011
8,161914318,276852,162191170,1,0,0,6144,1,1967328990
9,161916445,153909,162070354,4,0,0,35328,4,5418188005
10,161923808,210260,162134068,6,0,0,21504,6,9735232144
11,161938975,216825,162155800,34,0,0,37376,34,3218115053
12,161948244,188343,162136587,6,0,0,8192,6,5214309607
13,161952518,121751,162074269,30,0,0,12800,30,3072103326
14,161994543,181579,162176122,21,0,0,7168,21,3903710705
15,162044986,252534,162297520,23,0,0,11264,23,1876885220
16,162070078,100025,162170103,28,0,0,15872,28,1137801843
17,162095592,123124,162218716,14,0,0,9728,14,2658288035
18,162128676,153990,162282666,23,0,0,13312,23,2453579647
19,162136335,142260,162278595,9,0,0,34304,9,10335423938
20,162146341,10969,162157310,21,0,1,1536,21,7098004705
21,162163348,104780,162268128,26,0,0,44032,26,8555559458
22,162173943,174994,162348937,38,0,0,20480,38,10508007362
23,162175294,149753,162325047,34,0,0,10752,34,5058577030
24,162175679,3907,162179586,31,0,1,3584,31,4233809824
25,162181966,289592,162471558,5,0,0,45568,5,1871460039
26,162228133,55180,162283313,19,0,0,2048,19,9836055085
27,162250783,206876,162457659,11,0,0,40448,11,4938477173
28,162273823,213704,162487527,2,0,0,35840,2,5263619982
29,162279999,87306,162367305,25,0,0,7168,25,10344193372
30,162284906,35312,162320218,29,0,1,61952,29,8626193633
31,162303591,261564,162565155,0,0,0,58368,0,2901649931
32,162309760,276556,162586316,28,0,0,13824,28,5578716191
33,162312373,297964,162610337,17,0,0,43008,17,8140707019
34,162338462,374135,162712597,1,0,0,58368,1,7993756953
35,162380747,1994,162382741,25,0,1,2048,25,5160199741
36,162385887,101967,162487854,20,0,0,1024,20,3950743525
37,162392689,136993,162529682,20,0,0,30720,20,4268586526
38,162399052,376718,162775770,6,0,0,18432,6,3627095516
39,162423089,250470,162673559,32,0,0,22528,32,6264302833
40,162474088,13781,162487869,36,0,1,5632,36,1639101273
41,162479520,234348,162713868,15,0,0,4096,15,7013842761
42,162497717,197073,162694790,28,0,0,69632,28,4135048507
43,162505538,149475,162655013,37,0,0,10752,37,2213627511
44,162512848,294706,162807554,6,0,0,44544,6,1187376409
45,162530893,5454,162536347,2,0,1,13824,2,4350643005
46,162531768,295316,162827084,35,0,0,36864,35,10253324347
47,162556588,14854,162571442,1,0,1,6656,1,819029767
48,162564409,11219,162575628,25,0,1,6656,25,5649377662
49,162566062,261201,162827263,34,0,0,512,34,5353638479
50,162594424,175715,162770139,34,0,0,28160,34,4730100824
51,162615703,144277,162759980,18,0,0,52224,18,10304902848
52,162671158,144679,162815837,0,0,0,27136,0,10431351428
53,162676055,256822,162932877,7,0,0,36864,7,7963686211
54,162695849,20974,162716823,14,0,1,3072,14,6154997866
55,162701123,131781,162832904,13,0,0,5632,13,7745167886
56,162717869,3898,162721767,12,0,1,4096,12,3090413226
57,162723258,3898,162727156,32,0,1,4096,32,2134969607
58,162726481,230292,162956773,23,0,0,64000,23,2452734459
59,162734877,6488,162741365,6,0,1,15872,6,3493275790
60,162740882,229790,162970672,38,0,0,45568,38,8067537550
61,162742151,17844,162759995,25,0,1,9728,25,1191989250
62,162750734,109997,162860731,6,0,0,13824,6,3851261081
63,162767209,337641,163104850,13,0,0,63488,13,5195974693
64,162780131,566,162780697,28,0,1,512,28,8468202718
65,162783950,248684,163032634,8,0,0,29184,8,973430420
66,162811718,38957,162850675,29,0,1,41984,29,4227290615
67,162813222,306962,163120184,3,0,0,15872,3,10231504000
68,162820377,32884,162853261,6,0,1,4096,6,9743110485
69,162824963,192045,163017008,6,0,0,7168,6,7097680515
70,162827375,226215,163053590,6,0,0,5120,6,720292755
71,162836398,183753,163020151,2,0,0,10240,2,1284293447
72,162853726,7020,162860746,35,0,1,11264,35,1175622876
73,162868401,146195,163014596,23,0,0,3072,23,8035578972
74,162909385,566,162909951,9,0,1,512,9,9117707109
75,162916577,533108,163449685,4,0,0,20480,4,3851632197
76,162963155,292767,163255922,4,0,0,97280,4,6665467148
77,162984260,240132,163224392,29,0,0,1536,29,1308773348
78,162998510,464660,163463170,10,0,0,17920,10,4531604588
79,162999988,336700,163336688,6,0,0,83968,6,1838188309
80,163002551,261186,163263737,37,0,0,25600,37,2459237001
81,163012347,275141,163287488,33,0,0,9216,33,7652079267
82,163015175,93761,163108936,5,0,0,13312,5,3367605949
83,163020325,179399,163199724,35,0,0,47616,35,1933817285
84,163064672,482951,163547623,32,0,0,52736,32,6443073228
85,163068344,370375,163438719,3,0,0,140288,3,9434177934
86,163070301,235345,163305646,29,0,0,24576,29,268694613
87,163075520,29345,163104865,32,0,1,18944,32,9836599525
88,163080609,195516,163276125,36,0,0,31232,36,6444652753
89,163082645,398420,163481065,7,0,0,5632,7,8359805940
90,163109941,156619,163266560,31,0,0,9216,31,5031740115
91,163123603,407929,163531532,37,0,0,21504,37,5811892742
92,163125659,215264,163340923,37,0,0,13824,37,6727392744
93,163130817,312613,163443430,35,0,0,15360,35,4729652908
94,163145484,145607,163291091,9,0,0,11776,9,767026469
95,163187512,381029,163568541,9,0,0,40960,9,5325993168
96,163202580,250396,163452976,17,0,0,10752,17,8110366479
97,163217151,1518,163218669,33,0,1,1536,33,227438852
98,163221225,356879,163578104,5,0,0,28160,5,1258539299
99,163244290,110560,163354850,17,0,0,5120,17,948354289
100,163267495,190176,163457671,6,0,0,15360,6,164115821
101,163267911,226518,163494429,5,0,0,24576,5,6452741140
102,163268542,89824,163358366,39,0,0,1536,39,2218031855
103,163274408,242797,163517205,31,0,0,33792,31,1122835
104,163312575,156093,163468668,8,0,0,1024,8,4493331914
105,163319112,23338,163342450,31,0,1,1536,31,4862731093
106,163321099,281383,163602482,32,0,0,11264,32,7251830327
107,163356046,316385,163672431,24,0,0,12800,24,7283838212
108,163361299,393117,163754416,9,0,0,26624,9,7874581230
109,163363622,221220,163584842,36,0,0,22016,36,7025593421
110,163392923,131745,163524668,22,0,0,15872,22,8070332267
111,163394702,382410,163777112,29,0,0,35328,29,5208713480
112,163398617,234117,163632734,17,0,0,26624,17,1129821317
113,163399390,324113,163723503,8,0,0,29696,8,3386205735
114,163434182,377306,163811488,3,0,0,30208,3,4664235494
115,163436586,30441,163467027,14,0,1,4096,14,9103631451
116,163439202,275230,163714432,34,0,0,81920,34,200656699
117,163462350,13851,163476201,1,0,1,19456,1,10721744116
118,163469606,254068,163723674,35,0,0,512,35,1015044455
119,163479736,424103,163903839,36,0,0,26112,36,564293610
120,163485059,249090,163734149,38,0,0,34304,38,9208687185
121,163527720,25316,163553036,32,0,1,13824,32,2353320530
122,163550738,3284,163554022,6,0,1,1536,6,4334472357
123,163564962,13157,163578119,1,0,1,2048,1,2464941712
124,163567971,16886,163584857,9,0,1,4096,9,3701727415
125,163596042,7230,163603272,32,0,1,7680,32,1305299110
126,163598800,242448,163841248,35,0,0,19456,35,2874354747
127,163609852,148487,163758339,13,0,0,12800,13,7029638532
128,163621075,159328,163780403,26,0,0,10752,26,5664736466
129,163641650,124668,163766318,5,0,0,26112,5,4944764618
130,163657565,217492,163875057,1,0,0,13312,1,9159213537
131,163668145,253724,163921869,36,0,0,5632,36,937005022
132,163682251,3422,163685673,28,0,1,3584,28,1350616929
133,163683725,243389,163927114,0,0,0,12800,0,1711364436
134,163691412,223965,163915377,10,0,0,29696,10,3849970364
135,163704152,62181,163766333,1,0,1,40960,1,4668535128
136,163712319,183541,163895860,7,0,0,37376,7,8614007850
137,163719777,106326,163826103,11,0,0,15360,11,5065744553
138,163727676,103899,163831575,30,0,0,3072,30,1917955514
139,163733345,148553,163881898,6,0,0,4608,6,6696183710
140,163742207,543722,164285929,33,0,0,9216,33,132068434
141,163752173,284991,164037164,10,0,0,28672,10,7528917078
142,163784049,284659,164068708,10,0,0,32768,10,6215282450
143,163802548,147450,163949998,24,0,0,12288,24,2115346257
144,163808585,528254,164336839,28,0,0,25600,28,4554186265
145,163814097,2946,163817043,22,0,1,3072,22,6549010978
146,163820888,207509,164028397,10,0,0,89088,10,8564076205
147,163832646,167877,164000523,30,0,0,512,30,3675965690
148,163850746,103495,163954241,1,0,0,13824,1,7487190216
149,163860754,244413,164105167,31,0,0,4096,31,6104891451
150,163880298,234094,164114392,38,0,0,17920,38,858856897
151,163880853,275395,164156248,33,0,0,3072,33,852044998
152,163882487,199618,164082105,15,0,0,30208,15,7052120777
153,163884133,243879,164128012,28,0,0,7168,28,9994344688
154,163886340,384509,164270849,31,0,0,20480,31,5616556334
155,163921307,290132,164211439,8,0,0,17408,8,5273413292
156,163930379,1994,163932373,9,0,1,2048,9,5556981709
157,163931033,5821,163936854,0,0,1,6144,0,2811310599
158,163932176,162237,164094413,2,0,0,5120,2,538297861
159,163945018,9246,163954264,33,0,1,14848,33,3977431865
160,163945287,20704,163965991,9,0,1,19456,9,5215713561
161,163947160,208137,164155297,23,0,0,40960,23,1633360773
162,163953563,14374,163967937,25,0,1,3072,25,7416464375
163,163956220,13663,163969883,2,0,1,3072,2,4401913031
164,163956723,316489,164273212,28,0,0,2560,28,7543560941
165,163957126,130263,164087389,11,0,0,4608,11,3778149226
166,163992272,255249,164247521,27,0,0,86016,27,120617756
167,164015651,246112,164261763,13,0,0,34816,13,6682300615
168,164018313,232811,164251124,29,0,0,11776,29,4922205591
169,164032629,296380,164329009,29,0,0,24064,29,10669568415
170,164058746,11965,164070711,8,0,1,2048,8,598066327
171,164059062,399572,164458634,38,0,0,5632,38,2521611309
172,164077133,379770,164456903,32,0,0,44544,32,9493966878
173,164091826,188416,164280242,8,0,0,2560,8,394650926
174,164111693,202533,164314226,38,0,0,43520,38,9768968917
175,164128776,10241,164139017,20,0,1,16384,20,7762922379
176,164139543,265775,164405318,19,0,0,29696,19,10380651725
177,164154316,233575,164387891,17,0,0,14848,17,1342195025
178,164156409,1994,164158403,1,0,1,2048,1,8358871041
179,164171911,92675,164264586,35,0,0,9216,35,185954695
180,164175916,350878,164526794,33,0,0,37888,33,1011544105
181,164178119,167876,164345995,8,0,0,3072,8,9559482296
182,164178968,204384,164383352,13,0,0,37376,13,5937916153
183,164199689,274872,164474561,5,0,0,52224,5,9996352686
184,164231323,54621,164285944,9,0,1,23040,9,1808614167
185,164235223,194526,164429749,6,0,0,4608,6,8466050508
186,164245939,197377,164443316,29,0,0,2048,29,9080172703
187,164272102,28725,164300827,19,0,1,37888,19,3627973666
188,164278954,35287,164314241,14,0,1,512,14,5457247516
189,164288063,104589,164392652,22,0,0,2048,22,9964297622
190,164299880,91005,164390885,32,0,0,9728,32,8714913425
191,164302849,26175,164329024,16,0,1,8192,16,3554124907
192,164338999,566780,164905779,39,0,0,55808,39,860935999
193,164348373,127935,164476308,38,0,0,5632,38,4468771520
194,164355884,172953,164528837,1,0,0,6656,1,10448918966
195,164362394,25512,164387906,16,0,1,20992,16,7909991729
196,164363036,137832,164500868,19,0,0,24576,19,3467630311
197,164363484,233188,164596672,11,0,0,83456,11,6369632404
198,164366084,429183,164795267,31,0,0,24576,31,3313818521
199,164388359,174939,164563298,19,0,0,26624,19,2740428323
200,164396046,319145,164715191,35,0,0,61440,35,4172262386
201,164415308,6278,164421586,9,0,1,6656,9,5182707927
202,164418699,11274,164429973,9,0,1,18432,9,3747404145
203,164426630,172093,164598723,1,0,0,6656,1,8996248913
204,164434358,3898,164438256,12,0,1,4096,12,10333685285
205,164458794,409961,164868755,13,0,0,38912,13,8542933488
206,164464168,15521,164479689,8,0,1,3584,8,5923246319
207,164480157,407948,164888105,34,0,0,30720,34,3167008366
208,164480248,118490,164598738,29,0,1,186368,29,8223762404
209,164486300,402452,164888752,10,0,0,2048,10,5149428898
210,164491565,107188,164598753,12,0,1,3584,12,6073052447
211,164495532,274247,164769779,18,0,0,74240,18,9998229659
212,164530075,247234,164777309,7,0,0,2048,7,10032317718
213,164568628,410631,164979259,3,0,0,61440,3,4742491764
214,164570977,255507,164826484,0,0,0,10240,0,3579522017
215,164574300,508345,165082645,20,0,0,56832,20,484789851
216,164602275,204872,164807147,2,0,0,3072,2,1249197333
217,164620989,233754,164854743,17,0,0,45056,17,4658553220
218,164634629,284870,164919499,0,0,0,26624,0,7084659045
219,164658002,3898,164661900,6,0,1,4096,6,5507471879
220,164693399,296974,164990373,11,0,0,31744,11,7538491152
221,164697056,72738,164769794,39,0,1,57856,39,2305082093
222,164697142,72667,164769809,19,0,1,7680,19,402509046
223,164707642,203692,164911334,15,0,0,5120,15,9959203060
224,164708838,271848,164980686,1,0,0,4608,1,1690063916
225,164736410,185452,164921862,28,0,0,7680,28,1161700337
226,164760489,11323,164771812,27,0,1,2048,27,220230789
227,164762632,11126,164773758,20,0,1,3072,20,9364437118
228,164777938,404390,165182328,15,0,0,32256,15,3793440394
229,164805523,319506,165125029,6,0,0,7168,6,5657785754
230,164807184,10241,164817425,32,0,1,16384,32,1388688109
231,164818129,8370,164826499,6,0,1,7680,6,7591196718
232,164818610,279305,165097915,5,0,0,30208,5,1516683591
233,164864011,6730,164870741,19,0,1,2048,19,558700866
234,164872829,232261,165105090,3,0,0,11776,3,6394646426
235,164881495,24315,164905810,11,0,1,4096,11,8383194380
236,164888679,33198,164921877,34,0,1,30208,34,6940339870
237,164890379,217378,165107757,17,0,0,8704,17,3005277118
238,164893900,27992,164921892,14,0,1,9728,14,9401207286
239,164910292,138589,165048881,5,0,0,6656,5,5151375728
240,164944202,205261,165149463,3,0,0,25088,3,10697635117
241,164954856,204424,165159280,39,0,0,10752,39,7264228810
242,164967235,255878,165223113,20,0,0,33792,20,5273381430
243,165004255,580595,165584850,20,0,0,15872,20,3323728697
244,165017388,337889,165355277,31,0,0,19968,31,3510128377
245,165025926,294149,165320075,2,0,0,21504,2,8008579604
246,165032634,336542,165369176,18,0,0,45568,18,8675616443
247,165039311,203365,165242676,39,0,0,3072,39,1040047374
248,165057708,2470,165060178,1,0,1,2560,1,1172919334
249,165064242,18418,165082660,1,0,1,3072,1,1310426060
250,165077240,21508,165098748,9,0,1,31232,9,8610742268
251,165085012,148952,165233964,9,0,0,23040,9,5383940285
252,165086115,343460,165429575,26,0,0,35840,26,8629054990
253,165100550,602266,165702816,29,0,0,25600,29,2378479358
254,165114855,13858,165128713,19,0,1,23552,19,9726389045
255,165137276,116522,165253798,8,0,0,12800,8,600864910
256,165182344,397655,165579999,36,0,0,1536,36,10035832755
257,165191075,328714,165519789,15,0,0,51200,15,9473845440
258,165194576,129882,165324458,30,0,0,14336,30,4251449814
259,165198690,305484,165504174,0,0,0,63488,0,3422702404
260,165214721,21913,165236634,27,0,1,26112,27,109593368
261,165220065,170391,165390456,4,0,0,35328,4,9664590996
262,165226416,360641,165587057,1,0,0,7168,1,7387021635
263,165231810,347706,165579516,19,0,0,48640,19,3299687334
264,165237559,229331,165466890,36,0,0,4608,36,9029084163
265,165238012,551483,165789495,20,0,0,17408,20,5221893178
266,165249260,210189,165459449,30,0,0,7680,30,642784651
267,165252743,442242,165694985,15,0,0,74752,15,214878314
268,165254626,269554,165524180,18,0,0,14336,18,7604242246
269,165254935,581589,165836524,16,0,0,32768,16,7826189194
270,165268054,4850,165272904,12,0,1,5120,12,3150386308
271,165268075,187655,165455730,23,0,0,26624,23,6364870311
272,165278061,12308,165290369,34,0,1,20480,34,273497657
273,165294704,599306,165894010,18,0,0,58368,18,3101046587
274,165295885,447155,165743040,31,0,0,53760,31,7737625556
275,165309154,713552,166022706,39,0,0,61952,39,2083814207
276,165315011,929980,166244991,7,0,0,21504,7,3338776387
277,165316451,799559,166116010,0,0,0,43520,0,1243176482
278,165325309,536675,165861984,35,0,0,24576,35,7199422785
279,165336159,580190,165916349,20,0,0,30720,20,7483950457
280,165339821,700266,166040087,32,0,0,42496,32,10032217947
281,165346024,365675,165711699,15,0,0,11264,15,83281612
282,165372796,4937,165377733,35,0,1,12800,35,4869906538
283,165393247,210220,165603467,21,0,0,512,21,9913761622
284,165398723,307087,165705810,39,0,0,5120,39,3583945663
285,165399948,214275,165614223,0,0,0,6144,0,2842435309
286,165406222,437819,165844041,21,0,0,8704,21,1574185704
287,165407623,2946,165410569,31,0,1,3072,31,8558835460
288,165426129,177167,165603296,14,0,0,53248,14,4372540206
289,165440834,732906,166173740,21,0,0,49664,21,2519723883
290,165443369,228825,165672194,28,0,0,31232,28,5907898927
291,165445712,10041,165455753,8,0,1,5632,8,5508369315
292,165447523,378979,165826502,0,0,0,36352,0,8476749544
293,165447713,11751,165459464,34,0,1,2560,34,3014626342
294,165451313,298138,165749451,14,0,0,20992,14,6907376343
295,165451472,332704,165784176,30,0,0,71680,30,8522488599
296,165469476,5326,165474802,9,0,1,5632,9,3874521468
297,165480569,145730,165626299,26,0,0,5120,26,7540755713
298,165501286,466978,165968264,33,0,0,92160,33,1267611382
299,165512197,192038,165704235,24,0,0,4608,24,9393322078
300,165521919,7604,165529523,27,0,1,5632,27,6640590274
301,165552543,1518,165554061,14,0,1,1536,14,9241620566
302,165571948,687358,166259306,6,0,0,11776,6,198682254
303,165609193,570030,166179223,36,0,0,17920,36,1923403578
304,165633445,5326,165638771,37,0,1,5632,37,9104452743
305,165647784,228411,165876195,1,0,0,46592,1,1848121725
306,165655988,320270,165976258,11,0,0,26112,11,4876901914
307,165668053,228812,165896865,29,0,0,9216,29,4407815869
308,165668278,314711,165982989,30,0,0,22016,30,6992308864
309,165742337,244411,165986748,33,0,0,12288,33,2584411738
310,165785067,265833,166050900,29,0,0,7168,29,408689999
311,165814815,11702,165826517,10,0,1,11776,10,1496107818
312,165823320,171297,165994617,10,0,0,15872,10,10514124481
313,165835885,207977,166043862,27,0,0,12288,27,7267595936
314,165849621,140145,165989766,15,0,0,8704,15,3497125227
315,165859226,41021,165900247,9,0,1,6656,9,9963551976
316,165859976,41475,165901451,34,0,1,13824,34,5772767998
317,165881914,315656,166197570,5,0,0,28672,5,2566211096
318,165884737,410155,166294892,35,0,0,18432,35,6213944671
319,165922145,64946,165987091,26,0,0,1024,26,4747627140
320,165930909,171826,166102735,20,0,0,19456,20,4156900003
321,165936435,31844,165968279,19,0,1,5632,19,7352933191
322,165946239,48393,165994632,35,0,1,3072,35,6306012056
323,165948631,52815,166001446,37,0,1,26624,37,7345522353
324,165964825,482839,166447664,37,0,0,1024,37,10682788954
325,165990649,456680,166447329,25,0,0,79872,25,10608276536
326,165997513,186576,166184089,9,0,0,3072,9,4321275137
327,166000744,297283,166298027,25,0,0,10240,25,9275795245
328,166001836,287409,166289245,16,0,0,38400,16,1928613593
329,166009756,13525,166023281,22,0,1,512,22,3799211975
330,166022277,475206,166497483,1,0,0,13824,1,160300286
331,166027013,337724,166364737,8,0,0,38912,8,9622242586
332,166030502,26389,166056891,31,0,1,25088,31,1715573091
333,166034988,413791,166448779,1,0,0,3584,1,7072091211
334,166036679,201737,166238416,39,0,0,33792,39,6336545203
335,166038175,280447,166318622,33,0,0,2560,33,2147683220
336,166039889,511090,166550979,27,0,0,66048,27,1885304581
337,166041039,142099,166183138,10,0,0,12800,10,5197540814
338,166059868,254625,166314493,21,0,0,35328,21,9456726016
339,166099147,561374,166660521,35,0,0,31232,35,5236431176
340,166107258,422602,166529860,18,0,0,17920,18,9617195976
341,166118225,184623,166302848,0,0,0,5120,0,10519433673
342,166136715,490320,166627035,36,0,0,5120,36,10678805054
343,166146618,321528,166468146,7,0,0,63488,7,8393888429
344,166151410,5326,166156736,16,0,1,5632,16,2098660266
345,166160723,730375,166891098,8,0,0,88064,8,4676414612
346,166184641,567218,166751859,26,0,0,52736,26,2578618088
347,166199350,189856,166389206,32,0,0,5120,32,1568423119
348,166203821,421639,166625460,2,0,0,33280,2,222127310
349,166229987,534367,166764354,10,0,0,40960,10,4144526162
350,166242700,838323,167081023,15,0,0,112128,15,10595811356
351,166248383,581027,166829410,9,0,0,34816,9,6131978998
352,166270438,207820,166478258,17,0,0,30208,17,3821507205
353,166270497,2470,166272967,23,0,1,2560,23,8152568994
354,166283872,482377,166766249,6,0,0,6144,6,1179190865
355,166284950,579301,166864251,7,0,0,13312,7,2082157405
356,166302285,657599,166959884,33,0,0,110592,33,9413254030
357,166303579,10929,166314508,25,0,1,6656,25,7958927495
358,166337164,522533,166859697,21,0,0,99328,21,3720006977
359,166355130,505050,166860180,34,0,0,1536,34,4743010131
360,166383574,3645,166387219,14,0,1,10240,14,3849496444
361,166391421,180706,166572127,13,0,0,5632,13,561468457
362,166397164,218141,166615305,27,0,0,18944,27,10606554816
363,166404817,410202,166815019,35,0,0,34304,35,4980654624
364,166424223,476890,166901113,18,0,0,32768,18,1502038815
365,166429176,359385,166788561,20,0,0,35840,20,5108782217
366,166435359,42914,166478273,34,0,1,10752,34,2478511500
367,166467256,526525,166993781,33,0,0,65024,33,1098026038
368,166481748,485639,166967387,0,0,0,24576,0,5685984928
369,166485048,561796,167046844,22,0,0,20480,22,1747382447
370,166509819,415059,166924878,32,0,0,59904,32,385833626
371,166532535,374068,166906603,31,0,0,4608,31,4451348621
372,166540418,486193,167026611,22,0,0,92160,22,3728767564
373,166587623,446179,167033802,35,0,0,23552,35,7254481757
374,166590758,314426,166905184,25,0,0,13312,25,1326449761
375,166618371,592459,167210830,28,0,0,22528,28,5716969146
376,166618597,631107,167249704,26,0,0,29184,26,3247392075
377,166630705,4162,166634867,14,0,1,11264,14,6488191061
378,166652986,521231,167174217,5,0,0,13824,5,8363670846
379,166654070,344422,166998492,34,0,0,15360,34,6814144903
380,166692597,123529,166816126,26,0,0,3584,26,1651111649
381,166705200,220949,166926149,30,0,0,4096,30,7070413440
382,166715177,258777,166973954,37,0,0,21504,37,4593625081
383,166726905,434913,167161818,19,0,0,32256,19,1486223023
384,166745136,22615,166767751,14,0,1,1536,14,1865324780
385,166762852,508787,167271639,25,0,0,14848,25,9857485881
386,166793176,247357,167040533,39,0,0,22016,39,7838797417
387,166801612,288824,167090436,20,0,0,30720,20,5504918450
388,166813063,282863,167095926,7,0,0,16384,7,10611237765
389,166822881,576077,167398958,39,0,0,28160,39,1779883638
390,166837909,259904,167097813,2,0,0,6144,2,2646333540
391,166882034,249069,167131103,14,0,0,1536,14,10311074217
392,166891940,529840,167421780,16,0,0,15360,16,5467385460
393,166901106,339691,167240797,20,0,0,98304,20,3725081238
394,166906902,184017,167090919,4,0,0,1536,4,7682540276
395,166912071,291880,167203951,28,0,0,42496,28,4103459906
396,166920032,210565,167130597,30,0,0,9216,30,3133991960
397,166938781,687697,167626478,4,0,0,87040,4,8001819173
398,166941552,139486,167081038,11,0,1,512,11,2269432840
399,166960923,120138,167081061,31,0,1,1536,31,7829432753
400,166973146,151280,167124426,29,0,1,135680,29,4893776076
401,166974515,401926,167376441,16,0,0,50176,16,282956624
402,166994639,157336,167151975,6,0,0,7680,6,3799227900
403,167010960,535139,167546099,19,0,0,33280,19,8836140157
404,167015187,247218,167262405,7,0,0,3584,7,2006095046
405,167021344,724684,167746028,38,0,0,24576,38,7264547181
406,167029983,100637,167130620,8,0,1,16896,8,5581324410
407,167035028,272305,167307333,33,0,0,19968,33,8451375329
408,167076539,340530,167417069,5,0,0,59392,5,8434969968
409,167109324,419550,167528874,24,0,0,31232,24,711829541
410,167110612,470770,167581382,5,0,0,100352,5,7067632582
411,167112010,20289,167132299,19,0,1,4096,19,5953524070
412,167125905,457528,167583433,4,0,0,6656,4,1981515888
413,167126890,323174,167450064,20,0,0,27136,20,2444508065
414,167128135,313646,167441781,19,0,0,15360,19,2012330988
415,167138295,2870,167141165,21,0,1,8704,21,4011049297
416,167144397,195462,167339859,36,0,0,4608,36,5436010212
417,167155478,356028,167511506,13,0,0,9216,13,9442522816
418,167248952,247336,167496288,8,0,0,1024,8,6267842656
419,167265424,366405,167631829,27,0,0,17408,27,3739789513
420,167266363,389676,167656039,10,0,0,52736,10,8013762625
421,167274525,192440,167466965,20,0,0,1536,20,5495334051
422,167287023,136877,167423900,10,0,0,5120,10,1001053650
423,167289674,7706,167297380,37,0,1,8192,37,8464797638
424,167306260,4487,167310747,1,0,1,3584,1,2512290852
425,167345687,818476,168164163,31,0,0,108032,31,1567361067
426,167347569,387082,167734651,3,0,0,44544,3,194228176
427,167351393,236587,167587980,32,0,0,14848,32,9557678756
428,167371353,399490,167770843,24,0,0,32256,24,6294916896
429,167404501,125792,167530293,23,0,0,4608,23,7237436430
430,167410717,262610,167673327,27,0,0,40960,27,1960308197
431,167431481,566,167432047,28,0,1,512,28,8965472214
432,167431559,342754,167774313,31,0,0,2560,31,10037078371
433,167433866,206090,167639956,9,0,0,26624,9,1954392617
434,167441595,498722,167940317,21,0,0,46080,21,8057795761
435,167451843,12049,167463892,29,0,1,19968,29,7203757775
436,167453591,319919,167773510,7,0,0,8704,7,6874783130
437,167461209,292790,167753999,15,0,0,26112,15,7779792560
438,167469934,10499,167480433,6,0,1,16896,6,738967768
439,167489619,2470,167492089,5,0,1,2560,5,8354584223
440,167514824,360775,167875599,33,0,0,22016,33,1663730930
441,167515206,768265,168283471,28,0,0,35840,28,5521511934
442,167517112,174460,167691572,27,0,0,7168,27,7902953596
443,167528564,289405,167817969,13,0,0,55808,13,1975676408
444,167528943,17171,167546114,33,0,1,6144,33,4022196746
445,167544788,322072,167866860,14,0,0,49664,14,7348444632
446,167551134,41225,167592359,22,0,1,11776,22,2922951400
447,167563225,791481,168354706,21,0,0,9728,21,7104029486
448,167609286,500131,168109417,2,0,0,116736,2,5261081476
449,167611140,334340,167945480,1,0,0,16896,1,954613326
450,167612686,298089,167910775,38,0,0,14336,38,7317523949
451,167616563,277766,167894329,12,0,0,23040,12,5642204171
452,167636640,23595,167660235,22,0,1,11264,22,2345651616
453,167649546,23796,167673342,27,0,1,2048,27,2701183683
454,167651464,21893,167673357,16,0,1,512,16,1494550312
455,167666416,339880,168006296,1,0,0,14336,1,7909076981
456,167679512,146429,167825941,29,0,1,241664,29,5860743571
457,167681835,443602,168125437,24,0,0,35840,24,1149285667
458,167683051,668676,168351727,25,0,0,46592,25,9806204844
459,167689015,342415,168031430,11,0,0,15872,11,1604043024
460,167699847,126555,167826402,31,0,1,10240,31,2840086476
461,167708241,360854,168069095,9,0,0,1024,9,4721901171
462,167715965,550316,168266281,4,0,0,44544,4,5070352104
463,167732572,779302,168511874,15,0,0,35840,15,7433498342
464,167734246,232416,167966662,28,0,0,5120,28,238817098
465,167740001,166391,167906392,10,0,0,26112,10,9247571335
466,167752955,378269,168131224,37,0,0,18944,37,9625013819
467,167754179,412484,168166663,25,0,0,1024,25,8672640276
468,167770209,344090,168114299,23,0,0,7680,23,7563586012
469,167788987,271453,168060440,13,0,0,4096,13,4320730412
470,167801273,724040,168525313,9,0,0,44032,9,5875734154
471,167815881,715219,168531100,35,0,0,18944,35,7334955011
472,167819732,220348,168040080,39,0,0,26112,39,5115153315
473,167826341,367266,168193607,31,0,0,49152,31,6305237585
474,167858712,253232,168111944,11,0,0,8192,11,9902338504
475,167875737,1042,167876779,6,0,1,1024,6,2344591950
476,167878526,341346,168219872,28,0,0,1024,28,9490312105
477,167879002,1042,167880044,32,0,1,1024,32,1833449536
478,167886532,157669,168044201,37,0,0,6144,37,3077208928
479,167895096,662357,168557453,0,0,0,29696,0,9237821858
480,167912904,5802,167918706,28,0,1,6144,28,8487897190
481,167923519,190983,168114502,34,0,0,512,34,9881413491
482,167943412,299092,168242504,2,0,0,26112,2,1344389849
483,167944487,283781,168228268,33,0,0,6144,33,478570635
484,167945846,6278,167952124,32,0,1,6656,32,5647658140
485,167955491,498584,168454075,28,0,0,90112,28,4417658855
486,167957519,438909,168396428,24,0,0,33792,24,5197730697
487,168007760,480973,168488733,20,0,0,26112,20,2133285910
488,168008563,263973,168272536,34,0,0,20480,34,4198840651
489,168034428,388779,168423207,2,0,0,13824,2,473054281
490,168046049,641773,168687822,15,0,0,59392,15,10245434010
491,168048415,482864,168531279,23,0,0,512,23,4778820650
492,168049940,314485,168364425,29,0,0,31744,29,7505823017
493,168056514,582848,168639362,11,0,0,33280,11,8972169227
494,168066313,603398,168669711,11,0,0,59392,11,5010240767
495,168068376,1042,168069418,20,0,1,1024,20,5660342891
496,168069585,842011,168911596,33,0,0,11264,33,4620370242
497,168076405,532426,168608831,11,0,0,5632,11,10654874007
498,168077554,627302,168704856,5,0,0,52736,5,5115085395
499,168087770,635674,168723444,33,0,0,32768,33,7215000255
500,168089860,74334,168164194,9,0,1,4608,9,10017757021
501,168090888,406752,168497640,21,0,0,29184,21,1080516321
502,168094012,635444,168729456,30,0,0,19456,30,118733830
503,168118603,56101,168174704,0,0,1,16896,0,7015578963
504,168133461,648912,168782373,27,0,0,34816,27,5042952491
505,168148575,432405,168580980,10,0,0,30208,10,1026143823
506,168185450,196549,168381999,1,0,0,4608,1,4329834561
507,168186270,148772,168335042,32,0,0,2048,32,9567496828
508,168191005,400785,168591790,3,0,0,8704,3,9671062192
509,168210216,386927,168597143,0,0,0,2560,0,6105413287
510,168220080,13253,168233333,21,0,1,25600,21,9267556651
511,168239004,215086,168454090,29,0,1,298496,29,547001697
512,168278712,470306,168749018,4,0,0,11264,4,9923696203
513,168290885,454654,168745539,1,0,0,52736,1,10161664569
514,168295393,538339,168833732,9,0,0,6656,9,10209267300
515,168298054,269675,168567729,29,0,0,4608,29,8394011075
516,168299678,154427,168454105,34,0,1,512,34,2148969091
517,168300445,678782,168979227,39,0,0,14336,39,7742707971
518,168301974,652348,168954322,10,0,0,9216,10,4633207120
519,168324280,129840,168454120,34,0,1,8192,34,8066031728
520,168332466,121677,168454143,8,0,1,3072,8,1969000028
521,168349094,240021,168589115,5,0,0,26624,5,8661696258
522,168349717,104441,168454158,31,0,1,37888,31,3337439504
523,168350741,1075649,169426390,5,0,0,1536,5,4904824670
524,168352447,101726,168454173,2,0,1,512,2,2178811535
525,168354266,146673,168500939,27,0,0,10752,27,6915052742
526,168360145,516593,168876738,6,0,0,24576,6,7833830728
527,168370060,84128,168454188,12,0,1,2560,12,3890067038
528,168374174,903281,169277455,28,0,0,24576,28,2093606995
529,168400271,313166,168713437,28,0,0,20480,28,5601291500
530,168407698,1017531,169425229,4,0,0,12800,4,2594566757
531,168411661,295418,168707079,22,0,0,7168,22,7012770011
532,168413731,417950,168831681,1,0,0,35328,1,8922616866
533,168413855,210836,168624691,11,0,0,2560,11,4954671890
534,168433348,214381,168647729,26,0,0,6144,26,6963308958
535,168462603,612441,169075044,21,0,0,71168,21,3952030962
536,168473166,660202,169133368,19,0,0,56320,19,5742785840
537,168491426,561919,169053345,7,0,0,42496,7,7608607703
538,168501926,186847,168688773,1,0,0,3072,1,9029444775
539,168518264,569462,169087726,7,0,0,26624,7,7745410264
540,168523690,555901,169079591,13,0,0,14848,13,9277204091
541,168543786,809898,169353684,11,0,0,101888,11,1670431455
542,168545833,12308,168558141,8,0,1,20480,8,3256386904
543,168559328,685902,169245230,19,0,0,23552,19,6324130122
544,168566556,546339,169112895,20,0,0,7168,20,10456671999
545,168576718,15226,168591944,34,0,1,8704,34,527736463
546,168608608,629423,169238031,14,0,0,95232,14,9303868344
547,168612822,4850,168617672,27,0,1,5120,27,2325015413
548,168628125,556871,169184996,16,0,0,1536,16,8438172970
549,168634527,88932,168723459,39,0,1,122368,39,8563210933
550,168635905,87569,168723474,6,0,1,3584,6,10130332260
551,168644606,317339,168961945,25,0,0,15360,25,9285313667
552,168645973,611806,169257779,26,0,0,17408,26,6159713336
553,168664650,473159,169137809,24,0,0,12288,24,8525100675
554,168698591,24914,168723505,32,0,1,5632,32,7780953040
555,168707050,545402,169252452,31,0,0,23040,31,7375292247
556,168711113,710201,169421314,18,0,0,38400,18,1147245131
557,168717695,183512,168901207,18,0,0,8704,18,10325915023
558,168719262,130993,168850255,10,0,0,3584,10,10711005354
559,168721643,392983,169114626,11,0,0,5632,11,6854398419
560,168732323,301708,169034031,26,0,0,35328,26,2076915627
561,168732976,16592,168749568,28,0,1,512,28,10200351978
562,168736678,731829,169468507,34,0,0,4096,34,1964163899
563,168738718,726498,169465216,3,0,0,4096,3,8617058870
564,168743742,681658,169425400,11,0,0,512,11,984314465
565,168746203,1350546,170096749,16,0,0,43008,16,9845388106
566,168752992,492409,169245401,24,0,0,512,24,324207174
567,168763676,1139397,169903073,19,0,0,9216,19,5205749041
568,168766519,1046991,169813510,27,0,0,25088,27,8408108882
569,168775668,7263,168782931,2,0,1,512,2,8945091760
570,168791289,727234,169518523,33,0,0,11776,33,6762365519
571,168795120,1025974,169821094,19,0,0,4608,19,1111728961
572,168803164,553671,169356835,25,0,0,10240,25,1907527581
573,168820614,540760,169361374,36,0,0,14848,36,730721368
574,168827389,195733,169023122,32,0,0,8704,32,3357683364
575,168872661,449964,169322625,3,0,0,13824,3,7267543563
576,168878182,770715,169648897,20,0,0,141312,20,7820600807
577,168888239,883015,169771254,31,0,0,62464,31,6145894513
578,168888244,787764,169676008,25,0,0,37376,25,7284097845
579,168915940,378101,169294041,37,0,0,10752,37,8749863444
580,168919161,490438,169409599,25,0,0,73728,25,3747193261
581,168950823,566,168951389,1,0,1,512,1,650620023
582,168981958,7230,168989188,8,0,1,7680,8,1875385116
583,168987621,330728,169318349,7,0,0,43008,7,7547898248
584,168990403,566,168990969,22,0,1,512,22,1699197248
585,169009667,1486373,170496040,23,0,0,54784,23,2982465594
586,169048449,805256,169853705,27,0,0,4608,27,774779233
587,169066777,442185,169508962,37,0,0,88576,37,7057633931
588,169077804,1196935,170274739,26,0,0,65024,26,8369211151
589,169083196,1031832,170115028,15,0,0,34816,15,7252806650
590,169085368,5270,169090638,37,0,1,8704,37,1760626851
591,169089689,272652,169362341,29,0,0,3072,29,7581852563
592,169094407,419874,169514281,8,0,0,17408,8,2125418193
593,169128845,297038,169425883,24,0,0,1536,24,8850661602
594,169129553,8271,169137824,29,0,1,1024,29,415656413
595,169159155,1429099,170588254,31,0,0,58880,31,174567251
596,169159865,497315,169657180,36,0,0,27136,36,118435590
597,169180871,621959,169802830,27,0,0,40448,27,4638431273
598,169184820,178332,169363152,7,0,0,2560,7,10033161864
599,169212742,251211,169463953,7,0,0,29184,7,1902058433
600,169225881,32924,169258805,25,0,1,1024,25,4361028587
601,169226975,434588,169661563,35,0,0,14336,35,1022353899
602,169234603,280317,169514920,25,0,0,2048,25,8860768397
603,169242933,208522,169451455,33,0,0,3072,33,10562775746
604,169246182,704787,169950969,32,0,0,49664,32,2198681373
605,169259505,647528,169907033,27,0,0,2048,27,951843670
606,169259602,311124,169570726,23,0,0,2048,23,1156163720
607,169260756,306976,169567732,37,0,0,9728,37,1617046246
608,169278575,1039652,170318227,38,0,0,113664,38,1933186263
609,169296635,273452,169570087,33,0,0,7680,33,221611432
610,169297259,144557,169441816,27,0,0,25600,27,336901260
611,169298637,3387,169302024,25,0,1,9728,25,236985721
612,169327999,41133,169369132,20,0,1,14848,20,5268445807
613,169329474,332424,169661898,22,0,0,1024,22,7749376379
614,169332645,331936,169664581,6,0,0,8704,6,4033009808
615,169337559,35928,169373487,2,0,1,6144,2,3162023311
616,169341656,775290,170116946,5,0,0,5632,5,4686999407
617,169344419,507867,169852286,11,0,0,22528,11,9872395149
618,169349302,1086198,170435500,11,0,0,18432,11,4072168152
619,169351876,1012398,170364274,8,0,0,2560,8,5522587364
620,169395470,329328,169724798,26,0,0,4608,26,6990660992
621,169413700,361485,169775185,35,0,0,12800,35,2254326044
622,169418703,8287,169426990,31,0,1,512,31,940735896
623,169419933,786505,170206438,10,0,0,21504,10,10703747631
624,169420314,1223242,170643556,11,0,0,52736,11,4011540696
625,169423506,860074,170283580,11,0,0,21504,11,2805742124
626,169431723,1066516,170498239,19,0,0,7168,19,7329171481
627,169444904,627746,170072650,0,0,0,68608,0,9219418030
628,169468488,531097,169999585,30,0,0,10752,30,1815354357
629,169472663,720818,170193481,30,0,0,18944,30,5123045893
630,169509617,378124,169887741,30,0,0,81920,30,4025066650
631,169513829,8150,169521979,22,0,1,3584,22,9200567509
632,169516427,567203,170083630,32,0,0,18944,32,4938761226
633,169588384,401202,169989586,6,0,0,52736,6,8578174865
634,169620044,58869,169678913,1,0,1,3072,1,10366522203
635,169624552,299220,169923772,33,0,0,44544,33,6182740124
636,169626445,980604,170607049,16,0,0,7680,16,4062200946
637,169634787,155155,169789942,31,0,0,3072,31,10551795913
638,169644264,291387,169935651,13,0,0,38912,13,4929576567
639,169652483,578134,170230617,7,0,0,15360,7,1145223301
640,169679995,3904,169683899,28,0,1,10752,28,7674647169
641,169680833,713171,170394004,36,0,0,47104,36,8635812903
642,169684119,503575,170187694,38,0,0,20480,38,3274327355
643,169696669,3422,169700091,1,0,1,3584,1,3624278063
644,169696849,976821,170673670,37,0,0,14336,37,3221213229
645,169703965,3422,169707387,11,0,1,3584,11,755305998
646,169725003,879691,170604694,38,0,0,20480,38,2274459143
647,169749278,569588,170318866,35,0,0,2048,35,7562843120
648,169753902,416509,170170411,13,0,0,8192,13,1760529767
649,169756338,135786,169892124,13,0,0,14336,13,1687454448
650,169782510,153312,169935822,13,0,0,512,13,6414451881
651,169792650,322549,170115199,6,0,0,512,6,9411051764
652,169799700,1171517,170971217,15,0,0,9728,15,6059877396
653,169806806,851303,170658109,25,0,0,4096,25,1176496745
654,169812399,2646,169815045,16,0,1,1536,16,2014045100
655,169820292,256741,170077033,24,0,0,14336,24,851927187
656,169824886,923246,170748132,15,0,0,25600,15,5859175204
657,169829223,297373,170126596,17,0,0,2560,17,1760307756
658,169838747,4374,169843121,37,0,1,4608,37,4601191870
659,169840283,194351,170034634,16,0,0,29184,16,3901647832
660,169844335,332247,170176582,28,0,0,9216,28,49061676
661,169847193,982040,170829233,15,0,0,45056,15,10522947090
662,169849263,405649,170254912,7,0,0,33280,7,5179486445
663,169890896,1786,169892682,2,0,1,512,2,10660702952
664,169896005,430840,170326845,13,0,0,26112,13,7789389547
665,169903750,322164,170225914,37,0,0,24576,37,3549684683
666,169914208,253692,170167900,31,0,0,41984,31,4840481737
667,169947812,389812,170337624,7,0,0,35328,7,9703321251
668,169964664,187477,170152141,4,0,0,7168,4,1130908845
669,170011195,795759,170806954,33,0,0,13312,33,2005253995
670,170015043,384124,170399167,27,0,0,16896,27,7788074742
671,170034177,409346,170443523,17,0,0,5632,17,9039146853
672,170044380,831635,170876015,29,0,0,56320,29,9498860847
673,170062575,66814,170129389,8,0,0,3072,8,9429178036
674,170076999,521440,170598439,7,0,0,22528,7,1193580905
675,170097491,264095,170361586,25,0,0,18944,25,1540484802
676,170106068,547019,170653087,25,0,0,31232,25,10521792770
677,170107989,440269,170548258,10,0,0,79872,10,1041057866
678,170113027,447102,170560129,23,0,0,38912,23,3129464125
679,170158746,267751,170426497,1,0,0,15872,1,6840000412
680,170160581,349044,170509625,18,0,0,1536,18,7939033652
681,170165190,237424,170402614,3,0,0,11264,3,7357890990
682,170188475,468371,170656846,35,0,0,12288,35,6043071013
683,170189584,262320,170451904,7,0,0,2048,7,212531412
684,170206492,266232,170472724,18,0,0,29696,18,9034756536
685,170207233,531501,170738734,8,0,0,66560,8,8710652904
686,170222403,157234,170379637,15,0,0,13312,15,10648225960
687,170261858,353186,170615044,31,0,0,26112,31,3138470179
688,170295737,264563,170560300,11,0,0,512,11,2782092863
689,170351029,10572,170361601,28,0,1,14336,28,1712864951
690,170359038,232522,170591560,36,0,0,1536,36,2898475726
691,170411407,34279,170445686,29,0,1,59904,29,5247162780
692,170422120,168957,170591077,30,0,0,9216,30,10028180728
693,170423402,23910,170447312,28,0,1,2560,28,8029009094
694,170442381,331903,170774284,28,0,0,32256,28,36011108
695,170455025,1518,170456543,14,0,1,1536,14,8996642605
696,170470185,332698,170802883,32,0,0,1536,32,4027698770
697,170472036,451766,170923802,5,0,0,19456,5,8357006689
698,170489217,175270,170664487,2,0,0,7168,2,10200837875
699,170501362,173571,170674933,4,0,0,4096,4,2778031563
700,170504602,116769,170621371,6,0,0,10240,6,7554335950
701,170541258,261142,170802400,29,0,0,42496,29,1992090422
702,170547126,154825,170701951,13,0,0,15360,13,163461530
703,170599384,441559,171040943,27,0,0,512,27,3390450227
704,170601971,16160,170618131,0,0,1,9216,0,1452450786
705,170604991,224725,170829716,4,0,0,1536,4,5536768100
706,170655398,6125,170661523,28,0,1,3584,28,7948803980
707,170672320,67989,170740309,20,0,0,5120,20,1104699549
708,170677039,336882,171013921,28,0,0,29696,28,3937245940
709,170677846,1994,170679840,33,0,1,2048,33,4707766482
710,170696482,182512,170878994,8,0,0,9728,8,547066525
711,170707274,239370,170946644,30,0,0,2560,30,8186312034
712,170728506,33210,170761716,20,0,1,23040,20,4686929
713,170738993,205040,170944033,39,0,0,16384,39,9295350975
714,170745170,518957,171264127,38,0,0,21504,38,6784224557
715,170760409,15837,170776246,31,0,1,30720,31,2477477839
716,170764374,124151,170888525,5,0,0,31232,5,9032450254
717,170772090,273773,171045863,6,0,0,1536,6,9308056117
718,170776630,565820,171342450,20,0,0,128512,20,889200679
719,170787193,151833,170939026,34,0,0,17920,34,5366623449
720,170787629,204701,170992330,26,0,0,11776,26,1031340405
721,170800932,417278,171218210,10,0,0,22016,10,4802029303
722,170804311,220545,171024856,4,0,0,35840,4,6494145024
723,170832085,291200,171123285,38,0,0,47616,38,2910468756
724,170836052,4374,170840426,29,0,1,4608,29,1415838881
725,170837808,530271,171368079,13,0,0,56320,13,3315574560
726,170854706,294201,171148907,11,0,0,62464,11,6424612368
727,170876075,380713,171256788,0,0,0,6656,0,2883038664
728,170880719,11262,170891981,20,0,1,3584,20,6602329505
729,170885159,244701,171129860,38,0,0,21504,38,9092163714
730,170917821,428544,171346365,10,0,0,12800,10,8895884570
731,170924161,159800,171083961,20,0,0,14336,20,8061966560
732,170931439,323306,171254745,14,0,0,14336,14,227207288
733,170948472,301890,171250362,2,0,0,16384,2,7756035026
734,170960239,190906,171151145,3,0,0,2048,3,6211806474
735,170963249,2946,170966195,8,0,1,3072,8,7581827850
736,170969117,408702,171377819,39,0,0,11264,39,6888509031
737,170975202,422522,171397724,5,0,0,44032,5,1697261066
738,170986681,364223,171350904,8,0,0,14848,8,6036778374
739,170986779,455504,171442283,5,0,0,15872,5,7505413984
740,170999385,151113,171150498,35,0,0,5120,35,8674854803
741,171000276,182839,171183115,32,0,0,9728,32,1938409938
742,171015645,195842,171211487,29,0,0,11776,29,222295900
743,171024019,458208,171482227,31,0,0,69632,31,1494553887
744,171028527,216820,171245347,24,0,0,47616,24,6860914344
745,171058394,315978,171374372,24,0,0,13312,24,921115804
746,171092304,316363,171408667,10,0,0,35840,10,5534774475
747,171112773,455624,171568397,27,0,0,10240,27,2841808223
748,171125736,28314,171154050,0,0,1,3072,0,8933876068
749,171137930,358137,171496067,33,0,0,20992,33,5759504477
750,171139407,17229,171156636,9,0,1,4096,9,3970772915
751,171160207,284899,171445106,0,0,0,9216,0,4307108732
752,171179148,4420,171183568,32,0,1,11776,32,9646727316
753,171203967,453066,171657033,24,0,0,18944,24,6880727955
754,171206376,310991,171517367,2,0,0,10240,2,3416349807
755,171217720,6284,171224004,32,0,1,6144,32,4866275726
756,171230911,319518,171550429,25,0,0,30208,25,6957889290
757,171254404,326565,171580969,32,0,0,24576,32,8399239425
758,171276249,93265,171369514,35,0,0,4608,35,1668816912
759,171283524,171122,171454646,17,0,0,23040,17,1198571566
760,171338823,219514,171558337,22,0,0,20992,22,7277404846
761,171345086,32748,171377834,28,0,1,4608,28,5500456555
762,171374590,126655,171501245,10,0,0,16896,10,10396362753
763,171381899,105335,171487234,16,0,0,16384,16,2209829812
764,171388148,24376,171412524,9,0,1,4096,9,1785867292
765,171402816,312830,171715646,38,0,0,24576,38,1278783778
766,171412330,209003,171621333,23,0,0,37888,23,5846536330
767,171423924,203352,171627276,20,0,0,19456,20,6876414293
768,171443587,156918,171600505,6,0,0,38400,6,4285804427
769,171468176,266972,171735148,5,0,0,13312,5,9535881571
770,171473664,183852,171657516,38,0,0,1536,38,593654356
771,171487043,9039,171496082,37,0,1,11264,37,902760458
772,171521687,229622,171751309,22,0,0,16896,22,4563294671
773,171538194,345371,171883565,38,0,0,18432,38,7948359588
774,171539090,11354,171550444,2,0,1,2560,2,8004413657
775,171541963,16389,171558352,34,0,1,13824,34,10213203067
776,171544313,328271,171872584,30,0,0,75776,30,8775599009
777,171547606,190858,171738464,14,0,0,2560,14,3009698104
778,171562278,283444,171845722,2,0,0,39936,2,8942895719
779,171565768,15216,171580984,6,0,1,6656,6,9271936204
780,171570808,10191,171580999,9,0,1,5120,9,4488166666
781,171571862,495768,172067630,30,0,0,2048,30,10256472229
782,171581602,177443,171759045,14,0,0,8704,14,10492465826
783,171586407,184877,171771284,30,0,0,24576,30,2339696174
784,171588708,260773,171849481,28,0,0,12288,28,6484997147
785,171597315,454787,172052102,3,0,0,141312,3,7545849801
786,171604692,126385,171731077,22,0,0,26112,22,396656298
787,171605839,288493,171894332,10,0,0,12800,10,8936246553
788,171613578,188360,171801938,5,0,0,3072,5,10705234203
789,171640582,237352,171877934,17,0,0,13824,17,854536714
790,171646423,11108,171657531,8,0,1,14848,8,9611548113
791,171664082,310788,171974870,28,0,0,49152,28,10261241079
792,171671580,4162,171675742,22,0,1,11264,22,6430775528
793,171678635,119584,171798219,33,0,0,3072,33,2344310607
794,171686626,187081,171873707,19,0,0,3584,19,7842225002
795,171688721,206796,171895517,34,0,0,1024,34,1766516576
796,171719924,266349,171986273,10,0,0,37376,10,4254103728
797,171721754,349955,172071709,3,0,0,13312,3,2618444775
798,171741484,322216,172063700,36,0,0,36864,36,4536195912
799,171746276,8923,171755199,31,0,1,4096,31,4796743342
800,171779608,330592,172110200,23,0,0,17408,23,7386921505
801,171794282,310108,172104390,37,0,0,22528,37,3323032709
802,171798601,15837,171814438,32,0,1,30720,32,9020080773
803,171803501,301380,172104881,9,0,0,1536,9,8829968826
804,171811698,353355,172165053,39,0,0,54272,39,4640325073
805,171818321,2946,171821267,34,0,1,3072,34,5548154115
806,171822846,164846,171987692,14,0,0,4608,14,10536517326
807,171838612,228379,172066991,6,0,0,10752,6,4946184910
808,171841462,432053,172273515,34,0,0,51200,34,4130544863
809,171876194,258634,172134828,32,0,0,20480,32,2885435517
810,171878339,395503,172273842,19,0,0,1024,19,4632227349
811,171914100,419879,172333979,25,0,0,74752,25,1148472525
812,171918802,315885,172234687,36,0,0,20992,36,1688623014
813,171937095,2470,171939565,25,0,1,2560,25,2081836188
814,171942224,368948,172311172,1,0,0,58880,1,831428251
815,171955857,116179,172072036,39,0,0,1024,39,9331539375
816,171975976,76477,172052453,32,0,0,1024,32,9001049677
817,171986163,233212,172219375,38,0,0,24576,38,9886572066
818,171986282,225590,172211872,10,0,0,12288,10,8912531899
819,172008780,284437,172293217,14,0,0,10240,14,7964139529
820,172026780,384104,172410884,10,0,0,90624,10,8169296333
821,172027176,344070,172371246,17,0,0,28672,17,9925198006
822,172030765,41286,172072051,32,0,1,3584,32,8954066314
823,172079933,566,172080499,28,0,1,512,28,540967289
824,172101576,12957,172114533,34,0,1,4608,34,10264867055
825,172122110,162211,172284321,29,0,0,21504,29,7098156365
826,172137953,90323,172228276,27,0,0,8704,27,8751804025
827,172138720,236457,172375177,11,0,0,12800,11,2257035481
828,172176637,6488,172183125,12,0,1,15872,12,7139076411
829,172185269,104813,172290082,24,0,0,10752,24,10102954559
830,172189305,7230,172196535,34,0,1,7680,34,9438516577
831,172201520,377375,172578895,0,0,0,11264,0,7862648128
832,172239749,171462,172411211,1,0,0,1024,1,3380585527
833,172247255,87831,172335086,5,0,0,3584,5,4019167915
834,172275012,267082,172542094,26,0,0,30208,26,3414371354
835,172303400,176952,172480352,13,0,0,18944,13,3234080631
836,172304358,334591,172638949,37,0,0,35840,37,8928260681
837,172332257,200096,172532353,23,0,0,51200,23,5272910870
838,172364636,262186,172626822,11,0,0,50176,11,10511242473
839,172364735,91750,172456485,14,0,0,512,14,7397267042
840,172375102,269770,172644872,5,0,0,7168,5,4805936170
841,172391127,23530,172414657,27,0,1,9728,27,4482926671
842,172396736,136123,172532859,6,0,0,1536,6,7144377427
843,172396753,19475,172416228,9,0,1,2048,9,10511948842
844,172397347,198697,172596044,28,0,0,43520,28,5454840967
845,172438780,172723,172611503,4,0,0,50688,4,1726932382
846,172459957,268531,172728488,11,0,0,22016,11,1577771961
847,172460247,363114,172823361,0,0,0,14848,0,6806318940
848,172473130,282694,172755824,9,0,0,20992,9,4479480509
849,172473222,188273,172661495,14,0,0,39424,14,1199791757
850,172491323,68158,172559481,3,0,0,3584,3,1446013299
851,172495632,201008,172696640,9,0,0,40960,9,1837906923
852,172513577,18799,172532376,13,0,1,15360,13,5526995573
853,172514871,200039,172714910,21,0,0,1536,21,1605914015
854,172523141,21382,172544523,19,0,1,2560,19,7617057362
855,172523243,406903,172930146,27,0,0,15872,27,10254727102
856,172542122,199704,172741826,32,0,0,9216,32,751116034
857,172547653,352168,172899821,35,0,0,40448,35,3586244342
858,172579975,195349,172775324,26,0,0,19456,26,9708392911
859,172591308,545415,173136723,32,0,0,127488,32,876159255
860,172596738,370711,172967449,11,0,0,6144,11,6239812028
861,172604320,283162,172887482,28,0,0,18432,28,2251716023
862,172610248,157354,172767602,6,0,0,3072,6,6173543157
863,172613082,305630,172918712,36,0,0,61952,36,733444352
864,172615478,317491,172932969,23,0,0,9216,23,377706289
865,172619813,558498,173178311,31,0,0,30208,31,1878203110
866,172632999,410586,173043585,38,0,0,90112,38,8055170342
867,172666561,2946,172669507,32,0,1,3072,32,2312345699
868,172676716,125482,172802198,19,0,0,10752,19,6661738465
869,172680636,191156,172871792,4,0,0,6144,4,2254046692
870,172688546,9128,172697674,21,0,1,1024,21,9384259060
871,172698961,280069,172979030,38,0,0,4096,38,2235639565
872,172719881,245673,172965554,23,0,0,45568,23,3237821667
873,172731148,194147,172925295,0,0,0,21504,0,7648931723
874,172731205,49292,172780497,1,0,0,3072,1,2669125275
875,172744103,110817,172854920,30,0,0,11264,30,3416190173
876,172750395,296208,173046603,3,0,0,5120,3,6835188903
877,172754713,3598,172758311,12,0,1,2560,12,7045795476
878,172845361,340921,173186282,23,0,0,26112,23,6205309583
879,172848998,306772,173155770,19,0,0,62464,19,1162483658
880,172852955,146043,172998998,32,0,0,4096,32,31148246
881,172853259,343833,173197092,36,0,0,29696,36,7315213359
882,172872046,297030,173169076,27,0,0,16384,27,4802666509
883,172879934,165070,173045004,8,0,0,4608,8,1189578553
884,172881615,282438,173164053,9,0,0,27136,9,9188099204
885,172893056,408589,173301645,30,0,0,30208,30,8013930747
886,172898990,101580,173000570,25,0,0,512,25,1261703316
887,172944402,284148,173228550,21,0,0,20992,21,6951442423
888,172959345,12437,172971782,25,0,1,4608,25,6187815140
889,172988012,331584,173319596,26,0,0,7168,26,5819239179
890,173014527,192758,173207285,2,0,0,4608,2,1772645332
891,173029511,176347,173205858,21,0,0,20992,21,9596632468
892,173033863,188276,173222139,1,0,0,17408,1,4461318673
893,173035113,152900,173188013,38,0,0,5632,38,6746476030
894,173075670,123777,173199447,6,0,0,7680,6,10561131217
895,173081446,2470,173083916,17,0,1,2560,17,248840877
896,173087513,119982,173207495,6,0,0,512,6,7352612794
897,173109735,97581,173207316,21,0,1,13312,21,7904906063
898,173113675,198913,173312588,23,0,0,35840,23,6084199490
899,173122226,193753,173315979,5,0,0,512,5,9761980705
900,173129628,321454,173451082,17,0,0,4096,17,8402744629
901,173143961,233584,173377545,4,0,0,70144,4,204628538
902,173179261,377247,173556508,11,0,0,41472,11,8179080267
903,173187636,23240,173210876,21,0,1,3584,21,101773474
904,173192759,19174,173211933,22,0,1,9728,22,5223748758
905,173193718,210420,173404138,30,0,0,16384,30,9125578816
906,173223013,377937,173600950,19,0,0,58880,19,2197449080
907,173227468,189556,173417024,23,0,0,2048,23,702419064
908,173234445,330870,173565315,7,0,0,12800,7,940652832
909,173248210,162196,173410406,29,0,0,6656,29,10363046847
910,173249005,321289,173570294,13,0,0,7680,13,9732559601
911,173256657,278682,173535339,32,0,0,40448,32,6245901781
912,173280608,192794,173473402,17,0,0,47104,17,577709546
913,173286266,231552,173517818,34,0,0,99840,34,10563064840
914,173288316,365012,173653328,2,0,0,52224,2,6896651760
915,173292794,317786,173610580,19,0,0,8704,19,4123626875
916,173296453,284541,173580994,3,0,0,28672,3,10575387221
917,173324868,6278,173331146,21,0,1,6656,21,1481178808
918,173333264,7230,173340494,22,0,1,7680,22,6698823764
919,173345047,221733,173566780,23,0,0,4608,23,6269393212
920,173366818,257615,173624433,22,0,0,512,22,9894683779
921,173372248,284691,173656939,1,0,0,11776,1,453453929
922,173380187,7706,173387893,20,0,1,8192,20,637521802
923,173381117,8722,173389839,11,0,1,3072,11,971895224
924,173392292,126450,173518742,29,0,0,2048,29,1824436491
925,173410322,4755,173415077,34,0,1,12288,34,9713937006
926,173437443,245869,173683312,35,0,0,25600,35,1602819395
927,173439201,4679,173443880,1,0,1,12288,1,4237109120
928,173445709,337001,173782710,22,0,0,40960,22,9599107137
929,173452243,181862,173634105,3,0,0,512,3,5078124330
930,173465324,304891,173770215,19,0,0,62976,19,3047210435
931,173467327,253119,173720446,36,0,0,10240,36,2708653174
932,173469536,232262,173701798,30,0,0,12800,30,7813622939
933,173495646,246100,173741746,8,0,0,512,8,5723509693
934,173521084,484631,174005715,3,0,0,87552,3,2602047945
935,173557667,232874,173790541,20,0,0,25600,20,7187690612
936,173569158,323601,173892759,35,0,0,87040,35,6375205048
937,173573288,9692,173582980,35,0,1,2048,35,3196919260
938,173626733,298636,173925369,30,0,0,56832,30,4906208438
939,173627127,491852,174118979,30,0,0,12288,30,6860696717
940,173637781,22245,173660026,9,0,1,9216,9,9536985797
941,173664282,6278,173670560,4,0,1,6656,4,2935720292
942,173671170,222228,173893398,31,0,0,2048,31,10649388977
943,173679702,434552,174114254,16,0,0,69632,16,2629637566
944,173697308,94028,173791336,16,0,0,2560,16,2372999584
945,173703289,241439,173944728,7,0,0,63488,7,5192124970
946,173704542,359290,174063832,11,0,0,92160,11,6854793047
947,173705899,381805,174087704,1,0,0,21504,1,7276371467
948,173711367,187202,173898569,30,0,0,16896,30,9864519192
949,173713838,321891,174035729,29,0,0,2560,29,4276871078
950,173742730,292172,174034902,39,0,0,95744,39,10517314529
951,173744072,3128,173747200,14,0,1,9216,14,3707255764
952,173748826,197821,173946647,1,0,0,6144,1,965178690
953,173767029,551298,174318327,27,0,0,12288,27,6181000912
954,173774331,298096,174072427,27,0,0,28160,27,7910136703
955,173798522,439975,174238497,35,0,0,16384,35,8954132743
956,173810827,282196,174093023,10,0,0,17408,10,4990527970
957,173842204,10241,173852445,25,0,1,16384,25,7451008543
958,173854932,220802,174075734,34,0,0,10752,34,1338552974
959,173859476,255261,174114737,18,0,0,1536,18,8471897087
960,173864645,365287,174229932,28,0,0,12288,28,7866045405
961,173876625,372354,174248979,10,0,0,34304,10,178623182
962,173893027,553557,174446584,28,0,0,25088,28,5955103984
963,173899347,293979,174193326,0,0,0,14336,0,9821770694
964,173902969,397706,174300675,25,0,0,14848,25,112629447
965,173916545,208713,174125258,35,0,0,20480,35,4699827141
966,173920740,402303,174323043,17,0,0,2560,17,7832057076
967,173925390,263553,174188943,28,0,0,12800,28,8279448892
968,173926976,22100,173949076,6,0,1,2560,6,9388178055
969,173951099,272235,174223334,2,0,0,7680,2,6270895114
970,173958935,156285,174115220,19,0,0,1536,19,5271885220
971,173974109,585148,174559257,9,0,0,46080,9,5742767322
972,173998748,142465,174141213,17,0,0,4608,17,972098719
973,174002269,267896,174270165,34,0,0,1536,34,5494777564
974,174002966,435959,174438925,36,0,0,43520,36,836303965
975,174009100,211871,174220971,17,0,0,53760,17,4129953293
976,174019325,56440,174075765,21,0,1,1536,21,8092257578
977,174033874,97406,174131280,31,0,1,94720,31,1862130828
978,174066209,159948,174226157,34,0,0,9216,34,638128976
979,174077089,533192,174610281,32,0,0,52224,32,7537822449
980,174095304,37602,174132906,25,0,1,2560,25,4460907577
981,174100414,593766,174694180,30,0,0,62976,30,6785009018
982,174146739,214206,174360945,9,0,0,19968,9,9421415414
983,174148696,364232,174512928,25,0,0,18432,25,9551778973
984,174160527,255568,174416095,32,0,0,30208,32,1958391311
985,174179900,462499,174642399,14,0,0,15360,14,7031616234
986,174197223,265147,174462370,37,0,0,11264,37,1107168344
987,174207412,169466,174376878,35,0,0,13312,35,867249810
988,174214589,292708,174507297,3,0,0,36864,3,4704631763
989,174219411,487006,174706417,37,0,0,5632,37,8656739335
990,174228098,250774,174478872,19,0,0,39424,19,5147991876
991,174230558,7954,174238512,28,0,1,11264,28,4793815313
992,174236643,222280,174458923,37,0,0,40448,37,1016989571
993,174247201,215972,174463173,33,0,0,2560,33,7934892206
994,174257065,379848,174636913,17,0,0,4608,17,1657592934
995,174260361,255858,174516219,10,0,0,10752,10,92431402
996,174261886,5802,174267688,0,0,1,6144,0,5046172193
997,174265072,522420,174787492,28,0,0,74752,28,1109588964
998,174276669,1042,174277711,7,0,1,1024,7,8561582058
999,174282308,304721,174587029,6,0,0,3072,6,2872064160
1000,174297056,5129,174302185,25,0,1,1536,25,704660769
1001,174303438,2470,174305908,25,0,1,2560,25,7682247504
1002,174311977,323517,174635494,38,0,0,22528,38,1729602616
1003,174312484,573930,174886414,4,0,0,35328,4,8385969144
1004,174313247,153217,174466464,32,0,0,10752,32,9670686053
1005,174321196,652356,174973552,38,0,0,37888,38,173136919
1006,174349921,271370,174621291,27,0,0,1536,27,6806099468
1007,174356124,10139,174366263,32,0,1,5632,32,7272019581
1008,174365093,215808,174580901,9,0,0,2048,9,2855145506
1009,174390533,255789,174646322,39,0,0,12800,39,10707444664
1010,174392457,282520,174674977,17,0,0,87552,17,7302026293
1011,174397344,164892,174562236,1,0,0,9728,1,2459330946
1012,174407313,209242,174616555,21,0,0,3072,21,1395456170
1013,174449900,250847,174700747,17,0,0,21504,17,685234602
1014,174510794,9321,174520115,12,0,1,10752,12,1529924069
1015,174535759,177537,174713296,31,0,0,22528,31,4772044943
1016,174542354,162308,174704662,2,0,0,12800,2,7015727169
1017,174566905,152030,174718935,1,0,0,18432,1,8942453602
1018,174568114,177246,174745360,7,0,0,24064,7,10010817336
1019,174640461,90088,174730549,27,0,0,512,27,3793692787
1020,174668801,282416,174951217,6,0,0,26624,6,4096309221
1021,174678115,363892,175042007,3,0,0,17920,3,9459780729
1022,174680967,109847,174790814,11,0,0,10752,11,7697284991
1023,174698536,23770,174722306,21,0,1,9728,21,4488117815
1024,174709388,139958,174849346,31,0,0,16384,31,5378268999
1025,174722080,306951,175029031,28,0,0,38912,28,9392805812
1026,174748149,190868,174939017,27,0,0,8704,27,4238462778
1027,174761161,26346,174787507,28,0,1,6656,28,329543568
1028,174774758,233768,175008526,3,0,0,20480,3,3670583315
1029,174781306,69615,174850921,23,0,0,5120,23,6993216686
1030,174791946,310795,175102741,13,0,0,45568,13,2748638714
1031,174798324,380720,175179044,2,0,0,59392,2,1419551425
1032,174810813,3904,174814717,16,0,1,10752,16,1162621048
1033,174820764,340169,175160933,29,0,0,18944,29,4059072893
1034,174826641,3387,174830028,28,0,1,9728,28,3946465736
1035,174833156,175853,175009009,36,0,0,1536,36,5648506660
1036,174846496,569986,175416482,33,0,0,10752,33,9606599432
1037,174862716,120835,174983551,35,0,0,32768,35,6734530677
1038,174866496,358180,175224676,29,0,0,53248,29,7665998855
1039,174875441,354250,175229691,25,0,0,16384,25,9765423314
1040,174877933,241351,175119284,23,0,0,10240,23,733572621
1041,174899848,383867,175283715,10,0,0,3072,10,7233209304
1042,174904432,124934,175029366,35,0,0,1024,35,3398976631
1043,174913858,202291,175116149,24,0,0,33280,24,6029310304
1044,174921378,323992,175245370,13,0,0,4096,13,9395729162
1045,174928926,273611,175202537,13,0,0,7680,13,3530668895
1046,174930129,1042,174931171,8,0,1,1024,8,8240433304
1047,174933521,263946,175197467,1,0,0,60416,1,9892273358
1048,174939914,260260,175200174,24,0,0,8704,24,2171613459
1049,175016067,298430,175314497,33,0,0,61952,33,6562414884
1050,175022384,221058,175243442,32,0,0,45056,32,8288220267
1051,175042632,217879,175260511,39,0,0,12800,39,3281897765
1052,175047939,2470,175050409,2,0,1,2560,2,8544017130
1053,175052561,377843,175430404,39,0,0,30208,39,8940875769
1054,175056698,259382,175316080,33,0,0,5120,33,7365810648
1055,175062103,278288,175340391,10,0,0,29696,10,5072821929
1056,175121978,324741,175446719,38,0,0,512,38,7299374891
1057,175131671,275086,175406757,10,0,0,55296,10,1770235534
1058,175133287,287890,175421177,26,0,0,15360,26,3566453694
1059,175159075,254093,175413168,10,0,0,20992,10,2742134888
1060,175160081,205898,175365979,0,0,0,18944,0,4444385334
1061,175164110,303185,175467295,19,0,0,21504,19,8267264846
1062,175169150,269404,175438554,11,0,0,26624,11,5030621919
1063,175171109,218761,175389870,20,0,0,78336,20,1462416869
1064,175177549,170950,175348499,33,0,0,1024,33,3950656914
1065,175196028,289846,175485874,11,0,0,60928,11,5699371635
1066,175210086,236462,175446548,17,0,0,7680,17,138039850
1067,175218054,312930,175530984,32,0,0,17408,32,10692254896
1068,175244840,242149,175486989,19,0,0,3584,19,5361536550
1069,175278675,1518,175280193,21,0,1,1536,21,1752511796
1070,175306373,12794,175319167,25,0,1,9216,25,4174591524
1071,175361383,51808,175413191,1,0,1,2560,1,3720757385
1072,175369160,247299,175616459,8,0,0,41472,8,5186519535
1073,175370139,60288,175430427,29,0,1,14336,29,3573279559
1074,175396183,306998,175703181,6,0,0,46080,6,7089085714
1075,175418598,221984,175640582,20,0,0,26112,20,7012937459
1076,175447263,311190,175758453,39,0,0,52736,39,1787476419
1077,175450564,75101,175525665,20,0,0,5120,20,1083684774
1078,175456786,3898,175460684,21,0,1,4096,21,420233369
1079,175459457,144351,175603808,32,0,0,48640,32,5341781839
1080,175467656,214248,175681904,13,0,0,15360,13,3089260658
1081,175517934,123443,175641377,0,0,0,2560,0,4504187797
1082,175518300,104967,175623267,35,0,0,11776,35,1859033155
1083,175521891,109482,175631373,6,0,0,6144,6,2093267398
1084,175522440,120177,175642617,29,0,0,3584,29,9169119459
1085,175525308,188907,175714215,13,0,0,512,13,9257653338
1086,175532649,193116,175725765,34,0,0,14336,34,3397105577
1087,175537542,280771,175818313,17,0,0,40448,17,2442141414
1088,175539758,302282,175842040,23,0,0,77824,23,4870396797
1089,175545744,488811,176034555,38,0,0,36352,38,2450686693
1090,175547521,181532,175729053,11,0,0,6656,11,5780785970
1091,175549020,442743,175991763,4,0,0,18432,4,10722629116
1092,175562670,5326,175567996,25,0,1,5632,25,5544428253
1093,175576639,86443,175663082,8,0,0,9216,8,7581969957
1094,175611318,11964,175623282,27,0,1,3584,27,4376552305
1095,175620499,95252,175715751,21,0,0,512,21,671232340
1096,175643291,342841,175986132,22,0,0,1024,22,7227088110
1097,175651773,324961,175976734,3,0,0,35840,3,9271984290
1098,175658693,778152,176436845,8,0,0,18944,8,4163415040
1099,175659297,278178,175937475,11,0,0,47104,11,10680325393
1100,175661145,6779,175667924,25,0,1,5120,25,9226546038
1101,175663540,186362,175849902,19,0,0,2048,19,9679164707
1102,175677434,128540,175805974,14,0,0,27136,14,10611744685
1103,175695580,290225,175985805,1,0,0,29696,1,1688795124
1104,175710291,52194,175762485,5,0,0,1536,5,1087864455
1105,175720656,198311,175918967,15,0,0,12800,15,6436598599
1106,175737182,369025,176106207,25,0,0,49152,25,4183845381
1107,175740685,108578,175849263,18,0,0,23552,18,642011231
1108,175754089,160947,175915036,6,0,0,20992,6,4645121245
1109,175760036,179482,175939518,32,0,0,6656,32,9394664266
1110,175772204,372175,176144379,38,0,0,42496,38,244354250
1111,175773742,221484,175995226,27,0,0,11264,27,10008463043
1112,175791141,107634,175898775,3,0,0,15872,3,10579378810
1113,175814976,365716,176180692,25,0,0,23552,25,1645314078
1114,175815191,45427,175860618,2,0,1,17408,2,9091341782
1115,175829546,324103,176153649,21,0,0,17408,21,9197548740
1116,175830159,124251,175954410,20,0,0,9728,20,5947045763
1117,175855468,6021,175861489,22,0,1,12288,22,8046372372
1118,175857438,6317,175863755,0,0,1,3584,0,9390787724
1119,175864755,444475,176309230,34,0,0,10752,34,9331936506
1120,175870230,212133,176082363,29,0,0,1024,29,8262569366
1121,175909014,333122,176242136,0,0,0,73216,0,5963379459
1122,175909388,172648,176082036,7,0,0,16896,7,9803386503
1123,175922930,140629,176063559,33,0,0,1024,33,1687570080
1124,175922952,320479,176243431,5,0,0,4096,5,6108901669
1125,175938631,350643,176289274,5,0,0,46080,5,411417535
1126,175943442,170199,176113641,4,0,0,10240,4,8329179838
1127,175949127,182289,176131416,18,0,0,32768,18,2630075738
1128,175967622,287711,176255333,39,0,0,7168,39,9174649314
1129,175976105,32333,176008438,9,0,1,25600,9,3952407515
1130,175987556,399863,176387419,10,0,0,6656,10,9073851609
1131,175997991,11625,176009616,9,0,1,13824,9,2293562474
1132,176027094,600323,176627417,36,0,0,48640,36,1441817015
1133,176046699,206435,176253134,9,0,0,31744,9,7105405754
1134,176071935,540615,176612550,2,0,0,153600,2,5622598152
1135,176085299,134514,176219813,37,0,0,23040,37,5843742084
1136,176091028,15202,176106230,29,0,1,7168,29,4057674862
1137,176093777,418963,176512740,6,0,0,3584,6,9119923734
1138,176106460,244508,176350968,4,0,0,15360,4,609384919
1139,176113906,1042,176114948,16,0,1,1024,16,449091834
1140,176129931,17862,176147793,12,0,1,3584,12,5022873852
1141,176179556,246462,176426018,32,0,0,5120,32,4309656668
1142,176180198,196179,176376377,4,0,0,26624,4,7996032069
1143,176197580,357326,176554906,11,0,0,17408,11,9390315381
1144,176209435,272752,176482187,14,0,0,80384,14,3447597616
1145,176218313,464528,176682841,1,0,0,24064,1,2360340179
1146,176221276,190699,176411975,21,0,0,11264,21,5556524364
1147,176221844,226512,176448356,31,0,1,332288,31,7686347069
1148,176228389,299512,176527901,34,0,0,27648,34,9494418017
1149,176239706,470297,176710003,30,0,0,21504,30,8859057602
1150,176245263,939304,177184567,22,0,0,41472,22,3910124420
1151,176248987,758683,177007670,36,0,0,44032,36,7021455579
1152,176254427,409827,176664254,39,0,0,3072,39,9402363509
1153,176280517,488495,176769012,16,0,0,17920,16,664963760
1154,176292626,542624,176835250,37,0,0,7680,37,875647113
1155,176296736,516269,176813005,10,0,0,37888,10,8531070121
1156,176306866,142156,176449022,2,0,1,11264,2,1573726171
1157,176307424,435219,176742643,3,0,0,9728,3,1029976222
1158,176320892,313427,176634319,22,0,0,20992,22,3076975743
1159,176329588,214592,176544180,21,0,0,8192,21,3479511227
1160,176333063,534080,176867143,38,0,0,78336,38,5711457202
1161,176348022,101871,176449893,0,0,1,12288,0,1017353118
1162,176367468,651137,177018605,3,0,0,35840,3,6505314167
1163,176425006,362804,176787810,38,0,0,31744,38,3417175227
1164,176445096,182812,176627908,19,0,0,1536,19,5561252677
1165,176464093,30911,176495004,1,0,1,21504,1,4232631047
1166,176485052,293071,176778123,1,0,0,20480,1,3171896187
1167,176490049,5314,176495363,19,0,1,9728,19,3541826975
1168,176498080,221310,176719390,35,0,0,30720,35,3332226639
1169,176583491,54126,176637617,8,0,1,16384,8,1689993418
1170,176590769,399391,176990160,28,0,0,126464,28,10425003996
1171,176598428,500546,177098974,28,0,0,25600,28,8847628167
1172,176598909,518972,177117881,30,0,0,61952,30,10479205813
1173,176625354,274318,176899672,7,0,0,512,7,10566118126
1174,176650477,4937,176655414,32,0,1,12800,32,9917903231
1175,176675130,146082,176821212,10,0,0,22528,10,3973811245
1176,176684523,578632,177263155,16,0,0,98816,16,4797685878
1177,176695632,298599,176994231,30,0,0,13312,30,8384931689
1178,176723978,447938,177171916,39,0,0,22528,39,5534453215
1179,176759069,529241,177288310,34,0,0,17408,34,10099562998
1180,176761300,431394,177192694,10,0,0,26624,10,93953149
1181,176761702,260552,177022254,15,0,0,2048,15,4596222852
1182,176766653,279488,177046141,13,0,0,2560,13,7523733453
1183,176775863,103286,176879149,22,0,0,10752,22,4425140031
1184,176785387,426117,177211504,11,0,0,23552,11,7768936398
1185,176786955,378082,177165037,11,0,0,50176,11,5734326513
1186,176807359,337212,177144571,4,0,0,22016,4,5668377760
1187,176818810,202805,177021615,17,0,0,7168,17,2704115714
1188,176824219,566765,177390984,27,0,0,12800,27,4671097963
1189,176835451,196181,177031632,0,0,0,13312,0,4006148926
1190,176839572,286436,177126008,24,0,0,26624,24,3139334962
1191,176855849,502472,177358321,19,0,0,11776,19,6268268941
1192,176858274,549292,177407566,32,0,0,31744,32,5673343178
1193,176898610,120798,177019408,29,0,0,2560,29,8467914869
1194,176904723,565012,177469735,31,0,0,114176,31,10177227582
1195,176909862,181297,177091159,39,0,0,45056,39,2367083223
1196,176913930,4850,176918780,2,0,1,5120,2,1317620651
1197,176939413,3904,176943317,16,0,1,10752,16,10242085645
1198,176963241,186493,177149734,0,0,0,16896,0,6470597439
1199,176975141,362215,177337356,6,0,0,1536,6,8217664226
1200,177002315,395548,177397863,15,0,0,22528,15,4835876942
1201,177028208,450933,177479141,3,0,0,18944,3,9471110716
1202,177050002,223472,177273474,38,0,0,33792,38,5734662440
1203,177051041,335389,177386430,9,0,0,85504,9,2983485694
1204,177052878,254507,177307385,23,0,0,9216,23,897764769
1205,177057058,279807,177336865,19,0,0,22016,19,4642224997
1206,177089161,265483,177354644,32,0,0,17408,32,1764529416
1207,177089218,224036,177313254,0,0,0,6656,0,2947813467
1208,177099641,385607,177485248,9,0,0,19968,9,2115762718
1209,177203159,8360,177211519,25,0,1,6144,25,97613582
1210,177212519,174550,177387069,9,0,0,2048,9,3875039466
1211,177215337,2870,177218207,3,0,1,8704,3,8406176416
1212,177217576,12511,177230087,16,0,1,19968,16,5734670244
1213,177233763,329251,177563014,23,0,0,1536,23,8257444444
1214,177263350,354815,177618165,20,0,0,4096,20,6877378929
1215,177264467,345392,177609859,24,0,0,108032,24,5913613283
1216,177281735,566,177282301,17,0,1,512,17,697533939
1217,177330582,226016,177556598,28,0,0,33792,28,9473988700
1218,177342476,130862,177473338,38,0,0,11776,38,5003342274
1219,177344640,327815,177672455,29,0,0,32768,29,1017592276
1220,177366146,296310,177662456,9,0,0,32256,9,4746439041
1221,177378751,238143,177616894,32,0,0,23040,32,7347719212
1222,177418942,290104,177709046,33,0,0,49152,33,3764897766
1223,177442360,244953,177687313,32,0,0,34304,32,2074537241
1224,177456311,231337,177687648,34,0,0,1024,34,8823487281
1225,177469287,166217,177635504,23,0,0,56832,23,7818453681
1226,177495189,300308,177795497,36,0,0,22016,36,9855271342
1227,177529600,147246,177676846,39,0,0,14336,39,6204987230
1228,177530025,188708,177718733,1,0,0,31744,1,5691652248
1229,177542937,376544,177919481,8,0,0,13312,8,289364858
1230,177545913,472400,178018313,36,0,0,12800,36,3619877306
1231,177555203,4333,177559536,19,0,1,3072,19,7917693369
1232,177560699,338367,177899066,1,0,0,48640,1,457765788
1233,177562657,554304,178116961,13,0,0,71168,13,243620959
1234,177574651,326458,177901109,33,0,0,6656,33,6432237064
1235,177593046,308858,177901904,29,0,0,2560,29,4236356021
1236,177609035,36669,177645704,2,0,1,16384,2,3789678669
1237,177636421,83107,177719528,7,0,0,2560,7,865376822
1238,177637970,246261,177884231,18,0,0,70144,18,1528040855
1239,177661006,114527,177775533,5,0,0,11776,5,5126685242
1240,177671107,174145,177845252,27,0,0,19968,27,5014055921
1241,177725369,211905,177937274,4,0,0,40448,4,1006472525
1242,177737024,5971,177742995,1,0,1,14848,1,1351029378
1243,177742043,2258,177744301,6,0,1,2048,6,9209025494
1244,177744291,6490,177750781,2,0,1,15872,2,10510425709
1245,177752674,3128,177755802,0,0,1,9216,0,5114202104
1246,177763076,412037,178175113,10,0,0,90624,10,6564551461
1247,177768227,1042,177769269,25,0,1,1024,25,10084949021
1248,177771709,293729,178065438,1,0,0,4096,1,9522622107
1249,177785601,156212,177941813,18,0,0,14848,18,1931498796
1250,177790889,156882,177947771,7,0,0,7168,7,1001533103
1251,177799856,4374,177804230,8,0,1,4608,8,7101210575
1252,177832411,174136,178006547,33,0,0,512,33,7360981855
1253,177832584,208604,178041188,30,0,0,17408,30,7329115248
1254,177841062,186483,178027545,0,0,0,29696,0,2910826193
1255,177852126,212019,178064145,28,0,0,29184,28,10553585813
1256,177857309,88263,177945572,23,0,0,12288,23,5749237000
1257,177895391,364692,178260083,14,0,0,48640,14,9263597864
1258,177903748,160412,178064160,31,0,1,246784,31,7299040121
1259,177915119,293099,178208218,16,0,0,4608,16,5690328676
1260,177943277,460817,178404094,3,0,0,28160,3,6260724882
1261,177949946,114229,178064175,6,0,1,1536,6,4249086631
1262,177952456,112997,178065453,12,0,1,10752,12,3726021263
1263,177972259,265394,178237653,23,0,0,67072,23,4398469310
1264,177983358,310741,178294099,10,0,0,512,10,6219508744
1265,177985414,133902,178119316,23,0,0,7680,23,7801926491
1266,177987486,158969,178146455,14,0,0,13824,14,7278264403
1267,178001590,272891,178274481,33,0,0,18944,33,7472713616
1268,178007515,285598,178293113,13,0,0,9728,13,1715733904
1269,178014538,192261,178206799,29,0,0,27136,29,2140484782
1270,178020680,221769,178242449,2,0,0,5120,2,1880517985
1271,178020959,258256,178279215,16,0,0,2048,16,2257044811
1272,178026834,381963,178408797,6,0,0,15360,6,2310542131
1273,178029906,337643,178367549,39,0,0,62464,39,6885952790
1274,178037743,230935,178268678,3,0,0,28160,3,4142072363
1275,178047340,18128,178065468,25,0,1,16384,25,3510644007
1276,178088296,360744,178449040,17,0,0,11264,17,2250540713
1277,178116137,121999,178238136,19,0,0,1536,19,7034588565
1278,178118256,203101,178321357,23,0,0,8192,23,5250935025
1279,178123539,214753,178338292,21,0,0,31744,21,3124941057
1280,178131509,263990,178395499,27,0,0,23552,27,3751293939
1281,178142742,451228,178593970,37,0,0,22016,37,7414068129
1282,178145731,132829,178278560,32,0,0,13312,32,7271096895
1283,178152277,400926,178553203,19,0,0,16896,19,8336262572
1284,178176643,538161,178714804,29,0,0,4096,29,2095634081
1285,178178606,476457,178655063,18,0,0,3584,18,964976749
1286,178188878,5712,178194590,34,0,1,14336,34,1846719626
1287,178208041,348453,178556494,38,0,0,10752,38,6519562074
1288,178208129,208652,178416781,4,0,0,1536,4,7158495490
1289,178251667,116053,178367720,35,0,0,512,35,9525558566
1290,178253958,294082,178548040,31,0,0,94208,31,9816418902
1291,178258300,24923,178283223,20,0,1,12288,20,1474797361
1292,178274489,12657,178287146,29,0,1,5120,29,8841375136
1293,178290946,76789,178367735,18,0,1,103424,18,772319845
1294,178318122,120262,178438384,14,0,0,5120,14,346110314
1295,178322036,325798,178647834,27,0,0,59904,27,2070420525
1296,178322530,239774,178562304,21,0,0,13312,21,4745156601
1297,178347826,583069,178930895,34,0,0,16384,34,7731769221
1298,178390092,29680,178419772,9,0,1,17920,9,6831397432
1299,178412774,241182,178653956,9,0,0,19968,9,6964085137
1300,178437706,177976,178615682,13,0,0,6144,13,3342047370
1301,178447293,110940,178558233,23,0,0,5632,23,1450921457
1302,178448274,122057,178570331,27,0,0,5120,27,7183435994
1303,178448408,574038,179022446,5,0,0,7680,5,9738543729
1304,178474528,7706,178482234,6,0,1,8192,6,10656024439
1305,178494939,403748,178898687,2,0,0,8192,2,8903082350
1306,178495772,160882,178656654,4,0,0,5120,4,4002853469
1307,178502603,477891,178980494,25,0,0,28672,25,10191618398
1308,178516067,2870,178518937,32,0,1,8704,32,877177334
1309,178531632,278941,178810573,38,0,0,21504,38,10315725690
1310,178562098,120386,178682484,17,0,0,6144,17,4390590805
1311,178564235,183896,178748131,1,0,0,44544,1,6753801855
1312,178566427,560209,179126636,3,0,0,10752,3,3226369925
1313,178567712,182462,178750174,8,0,0,6656,8,7921211681
1314,178591333,78744,178670077,11,0,0,1024,11,6122954019
1315,178592306,458039,179050345,0,0,0,17920,0,1735432373
1316,178601275,4937,178606212,9,0,1,12800,9,5850363560
1317,178604352,269300,178873652,3,0,0,8704,3,7971950602
1318,178627711,533320,179161031,29,0,0,25088,29,535150936
1319,178628857,19000,178647857,34,0,1,6656,34,3571725676
1320,178629785,72183,178701968,39,0,0,2560,39,3315659576
1321,178650117,196672,178846789,38,0,0,14336,38,1505753992
1322,178653453,130901,178784354,24,0,0,4096,24,591583751
1323,178657205,387657,179044862,35,0,0,73216,35,428683069
1324,178679454,415067,179094521,36,0,0,65024,36,4878438122
1325,178685958,100088,178786046,26,0,0,4608,26,10052820802
1326,178691277,280466,178971743,2,0,0,14336,2,4980133
1327,178693946,157850,178851796,24,0,0,16384,24,3197136889
1328,178694831,490909,179185740,33,0,0,45568,33,2081344553
1329,178698738,357862,179056600,11,0,0,20480,11,9181105234
1330,178727177,219774,178946951,8,0,0,15360,8,10361215835
1331,178748979,186767,178935746,37,0,0,15872,37,3569570567
1332,178764625,147025,178911650,11,0,0,42496,11,4949009319
1333,178768242,305845,179074087,13,0,0,57344,13,1847934432
1334,178773268,334372,179107640,31,0,0,43008,31,3212556559
1335,178783989,201200,178985189,16,0,0,15360,16,1075499262
1336,178791172,125728,178916900,5,0,0,12288,5,9892500956
1337,178798599,397460,179196059,6,0,0,33792,6,8055018601
1338,178819366,347772,179167138,25,0,0,19968,25,8102828822
1339,178826371,3128,178829499,29,0,1,9216,29,5206119934
1340,178839666,368123,179207789,1,0,0,15872,1,2353706046
1341,178857801,360775,179218576,37,0,0,35328,37,5498129887
1342,178881552,1518,178883070,12,0,1,1536,12,3462821755
1343,178922537,2870,178925407,0,0,1,8704,0,2478052547
1344,178923147,248694,179171841,4,0,0,15360,4,5547758238
1345,178936065,266873,179202938,28,0,0,22528,28,806230298
1346,178942577,171635,179114212,6,0,0,2560,6,10440577321
1347,178948429,313050,179261479,26,0,0,54272,26,9434873266
1348,178953059,4679,178957738,1,0,1,12288,1,137898481
1349,178997254,7706,179004960,27,0,1,8192,27,1414640169
1350,179029904,242826,179272730,39,0,0,27648,39,10501499534
1351,179043616,178259,179221875,23,0,0,10752,23,2117840688
1352,179062613,170464,179233077,31,0,0,17920,31,7271388856
1353,179064578,251333,179315911,11,0,0,2048,11,6511939352
1354,179083908,229633,179313541,6,0,0,12288,6,1668064749
1355,179084361,211140,179295501,27,0,0,32768,27,2976848413
1356,179087508,500719,179588227,19,0,0,33280,19,8028871581
1357,179093758,221514,179315272,32,0,0,5632,32,3238701192
1358,179135686,304019,179439705,26,0,0,103936,26,5630302543
1359,179148877,259122,179407999,9,0,0,34816,9,5782060790
1360,179155983,129480,179285463,15,0,0,12288,15,6404058554
1361,179158353,318097,179476450,30,0,0,41472,30,5518215491
1362,179169496,520545,179690041,3,0,0,53760,3,4273223139
1363,179197874,35226,179233100,37,0,1,16896,37,2506394560
1364,179221141,136863,179358004,1,0,0,11776,1,7161650776
1365,179228384,667455,179895839,23,0,0,32256,23,2788922081
1366,179249282,262403,179511685,11,0,0,30208,11,8306488777
1367,179261778,280923,179542701,4,0,0,13824,4,3485047458
1368,179262685,313744,179576429,13,0,0,19456,13,5769081255
1369,179272569,187852,179460421,10,0,0,38400,10,1543986241
1370,179279572,5930,179285502,6,0,1,13312,6,95966864
1371,179280565,198567,179479132,36,0,0,8704,36,4692722540
1372,179281111,257363,179538474,34,0,0,4608,34,10119396742
1373,179284007,269226,179553233,30,0,0,18944,30,236157603
1374,179304557,334001,179638558,30,0,0,103424,30,7283291997
1375,179320027,344941,179664968,24,0,0,39936,24,5496465623
1376,179353931,318890,179672821,0,0,0,17408,0,10619433307
1377,179359680,377360,179737040,19,0,0,33280,19,8424532712
1378,179370885,430990,179801875,18,0,0,16384,18,8450012267
1379,179392178,323067,179715245,13,0,0,12800,13,531311404
1380,179394984,13038,179408022,14,0,1,5632,14,3851419705
1381,179399460,62378,179461838,27,0,1,36352,27,10632402610
1382,179415760,60705,179476465,8,0,1,4608,8,6212670604
1383,179419833,460532,179880365,24,0,0,82944,24,7131560931
1384,179448049,437947,179885996,4,0,0,18432,4,8172114632
1385,179448386,492275,179940661,9,0,0,27136,9,6336080711
1386,179448837,297166,179746003,7,0,0,24576,7,4321947739
1387,179459500,213492,179672992,31,0,0,512,31,7341839466
1388,179495485,281058,179776543,24,0,0,18944,24,822742864
1389,179495641,285091,179780732,24,0,0,4608,24,4450975625
1390,179502258,150511,179652769,29,0,0,46592,29,9863598640
1391,179521976,400243,179922219,5,0,0,6144,5,9592643827
1392,179525004,380226,179905230,5,0,0,30720,5,5008196724
1393,179533539,296531,179830070,39,0,0,14848,39,10661575703
1394,179538366,214382,179752748,8,0,0,9216,8,6025367310
1395,179553122,484025,180037147,4,0,0,32256,4,5198632826
1396,179553719,4679,179558398,32,0,1,12288,32,10470381193
1397,179567662,8782,179576444,21,0,1,6144,21,2216751971
1398,179568558,241042,179809600,20,0,0,18432,20,7030952405
1399,179584200,7406,179591606,16,0,1,9728,16,1825553512
1400,179617329,291215,179908544,23,0,0,5632,23,8393837825
1401,179623276,304387,179927663,33,0,0,3072,33,483290294
1402,179634871,285453,179920324,20,0,0,31744,20,4057854103
1403,179635844,354259,179990103,33,0,0,6656,33,6170706072
1404,179647083,327470,179974553,27,0,0,4608,27,3205757087
1405,179656809,267921,179924730,1,0,0,8192,1,9211771811
1406,179687148,8597,179695745,19,0,1,14336,19,8026277759
1407,179691607,163471,179855078,22,0,0,30720,22,7287802502
1408,179722665,184148,179906813,35,0,0,5120,35,6964570615
1409,179762113,2470,179764583,16,0,1,2560,16,3484142391
1410,179771932,229418,180001350,1,0,0,36864,1,714834376
1411,179775091,252205,180027296,8,0,0,41984,8,2942950441
1412,179798193,4716,179802909,28,0,1,1024,28,1256957656
1413,179810385,5454,179815839,37,0,1,13824,37,5144362299
1414,179837142,338471,180175613,9,0,0,22016,9,2071606990
1415,179874130,105681,179979811,30,0,0,1024,30,7616743227
1416,179875805,346137,180221942,0,0,0,16384,0,8525725746
1417,179890802,408095,180298897,4,0,0,22016,4,5851486114
1418,179913198,157321,180070519,7,0,0,51712,7,8989885589
1419,179924383,354736,180279119,9,0,0,43008,9,3762720138
1420,179926235,236211,180162446,25,0,0,12288,25,10216826009
1421,179948580,2470,179951050,2,0,1,2560,2,2822303005
1422,179953024,261361,180214385,18,0,0,68608,18,4623329869
1423,179958116,283535,180241651,29,0,0,8704,29,6946212475
1424,179958491,1042,179959533,2,0,1,1024,2,7491891680
1425,179971070,187601,180158671,38,0,0,48640,38,8305347520
1426,179973927,140267,180114194,6,0,0,11264,6,3939868479
1427,179975574,434634,180410208,27,0,0,31232,27,5436368587
1428,179982029,256152,180238181,17,0,0,53248,17,1794714928
1429,180017719,328389,180346108,24,0,0,26624,24,4881900539
1430,180049466,285147,180334613,22,0,0,12288,22,9976714402
1431,180050347,424789,180475136,8,0,0,41472,8,5575143808
1432,180065902,173074,180238976,30,0,0,2560,30,6036698589
1433,180091021,3387,180094408,28,0,1,9728,28,2287312893
1434,180094560,197614,180292174,27,0,0,25600,27,1566752113
1435,180095164,219812,180314976,9,0,0,7168,9,545341747
1436,180097792,2946,180100738,29,0,1,3072,29,7909930319
1437,180113528,233375,180346903,4,0,0,2560,4,3186063687
1438,180120641,195130,180315771,9,0,0,2560,9,9677152910
1439,180129153,3422,180132575,0,0,1,3584,0,2144128733
1440,180136067,176710,180312777,16,0,0,9728,16,9341360184
1441,180141654,224794,180366448,13,0,0,9216,13,419369460
1442,180146396,301344,180447740,25,0,0,28160,25,700461052
1443,180147468,28160,180175628,2,0,1,7168,2,8216125144
1444,180177099,437648,180614747,16,0,0,15872,16,192062870
1445,180203850,221890,180425740,5,0,0,42496,5,1902784252
1446,180204068,294066,180498134,31,0,0,35840,31,3626387847
1447,180210725,291021,180501746,33,0,0,7680,33,7463470885
1448,180225103,369207,180594310,16,0,0,29696,16,1178429303
1449,180235575,86785,180322360,38,0,0,2560,38,6294863999
1450,180237941,222797,180460738,10,0,0,30208,10,7543466001
1451,180255434,5196,180260630,31,0,1,13312,31,10707674302
1452,180257991,229208,180487199,36,0,0,17920,36,4001479593
1453,180303463,159014,180462477,37,0,0,5632,37,4526678066
1454,180313635,445166,180758801,36,0,0,18432,36,975723945
1455,180348465,286502,180634967,7,0,0,36864,7,3378624780
1456,180349310,209055,180558365,13,0,0,53760,13,8865197114
1457,180373728,205487,180579215,28,0,0,5120,28,1264989110
1458,180374866,185550,180560416,16,0,0,6656,16,261465801
1459,180421631,178293,180599924,32,0,0,9728,32,6471997666
1460,180432146,289443,180721589,16,0,0,93184,16,594351859
1461,180451772,220311,180672083,6,0,0,10240,6,4121515276
1462,180460655,281424,180742079,39,0,0,26624,39,6770343367
1463,180499903,141055,180640958,35,0,0,7168,35,8287144682
1464,180543500,209670,180753170,3,0,0,36352,3,8301922965
1465,180553019,119391,180672410,24,0,0,1024,24,7753242371
1466,180582608,151344,180733952,6,0,0,40448,6,7188524871
1467,180600461,166007,180766468,25,0,0,25088,25,1543019848
1468,180616925,2870,180619795,20,0,1,8704,20,115387363
1469,180663706,161518,180825224,6,0,0,25600,6,2217686590
1470,180663719,4391,180668110,27,0,1,4608,27,3656872322
1471,180679839,215764,180895603,19,0,0,33280,19,1600236946
1472,180680304,137105,180817409,11,0,0,19456,11,312592052
1473,180706141,102195,180808336,29,0,0,5632,29,9069023529
1474,180708312,82487,180790799,39,0,0,6656,39,4282703261
1475,180711986,127268,180839254,1,0,0,13312,1,879792279
1476,180752992,132456,180885448,37,0,0,6656,37,3129153911
1477,180763940,182817,180946757,11,0,0,43520,11,7389015661
1478,180766536,416945,181183481,14,0,0,19456,14,1721198981
1479,180775133,239370,181014503,2,0,0,37888,2,9360140701
1480,180778955,125046,180904001,11,0,0,16896,11,10419008840
1481,180798047,297055,181095102,1,0,0,14848,1,236059834
1482,180835167,123595,180958762,33,0,0,9216,33,8072118897
1483,180838967,235176,181074143,29,0,0,47104,29,6436068986
1484,180840317,215555,181055872,22,0,0,9216,22,7518896517
1485,180873045,155924,181028969,5,0,0,15872,5,4702315460
1486,180878910,100880,180979790,23,0,0,31232,23,9013103364
1487,180880621,256714,181137335,4,0,0,45568,4,5608785225
1488,180893164,122134,181015298,36,0,0,2560,36,1767899828
1489,180925564,126192,181051756,32,0,0,33792,32,5399762730
1490,180927572,2470,180930042,2,0,1,2560,2,5049634845
1491,180938028,152519,181090547,0,0,0,10752,0,9612392798
1492,180988217,87360,181075577,9,0,0,4608,9,1511738619
1493,180989758,172459,181162217,28,0,0,5120,28,9403013280
1494,180992836,219751,181212587,13,0,0,28160,13,9619551593
1495,181011482,8199,181019681,9,0,1,4608,9,8009464027
1496,181015177,87322,181102499,31,0,0,4608,31,9178574441
1497,181051791,292016,181343807,28,0,0,45056,28,1011640634
1498,181055926,135915,181191841,16,0,0,20992,16,5258396871
1499,181055941,18217,181074158,38,0,1,13312,38,4411085280
1500,181068062,162387,181230449,21,0,0,48128,21,202421519
1501,181072161,193105,181265266,6,0,0,15360,6,8184574337
1502,181072346,202731,181275077,20,0,0,10752,20,5907275572
1503,181087336,8767,181096103,12,0,1,1024,12,4364174981
1504,181087689,11329,181099018,26,0,1,10240,26,5265451500
1505,181104695,135137,181239832,2,0,0,7168,2,6924547904
1506,181112010,4850,181116860,34,0,1,5120,34,7983088951
1507,181114381,253011,181367392,38,0,0,40448,38,419576823
1508,181122867,231578,181354445,20,0,0,5632,20,698332487
1509,181144268,1042,181145310,8,0,1,1024,8,9227448262
1510,181144761,115810,181260571,2,0,0,28672,2,1864249058
1511,181147239,155571,181302810,27,0,0,1536,27,4699204873
1512,181198063,221979,181420042,39,0,0,25600,39,256206920
1513,181208257,238322,181446579,25,0,0,3072,25,6713067671
1514,181208911,4259,181213170,34,0,1,512,34,8064750143
1515,181222197,17650,181239847,36,0,1,8192,36,4442603957
1516,181231416,214212,181445628,29,0,0,45568,29,7521097834
1517,181241050,190663,181431713,14,0,0,37888,14,8951327926
1518,181243270,109444,181352714,19,0,0,29184,19,7092328624
1519,181262611,301468,181564079,31,0,1,488448,31,2781014312
1520,181284523,282782,181567305,29,0,1,5120,29,8045049098
1521,181292251,482722,181774973,24,0,0,16896,24,3862146143
1522,181311483,624581,181936064,23,0,0,2048,23,652697940
1523,181314875,686712,182001587,18,0,0,6144,18,4889229122
1524,181316100,411437,181727537,27,0,0,22528,27,2146222928
1525,181328045,496977,181825022,22,0,0,70144,22,1079991669
1526,181338530,422184,181760714,5,0,0,15360,5,825887735
1527,181342577,333558,181676135,35,0,0,41472,35,3114284252
1528,181351061,217870,181568931,11,0,1,2560,11,8106498933
1529,181351403,399594,181750997,17,0,0,13824,17,8132301774
1530,181357102,334705,181691807,24,0,0,42496,24,164702241
1531,181386499,389901,181776400,24,0,0,4608,24,1802519312
1532,181399632,450452,181850084,35,0,0,35328,35,4806191523
1533,181409686,180055,181589741,22,0,0,1024,22,10040105162
1534,181468930,258934,181727864,37,0,0,1024,37,844776132
1535,181479612,89780,181569392,28,0,1,10240,28,4643374650
1536,181483763,412944,181896707,3,0,0,27136,3,8392539967
1537,181484297,780425,182264722,29,0,0,2048,29,633812202
1538,181485745,598030,182083775,36,0,0,8704,36,10213108568
1539,181508351,322597,181830948,6,0,0,11776,6,2110908064
1540,181510026,641528,182151554,29,0,0,3072,29,8700294104
1541,181516786,418639,181935425,8,0,0,72192,8,9579055669
1542,181517017,458809,181975826,33,0,0,48640,33,7220691904
1543,181518941,460020,181978961,37,0,0,10240,37,4937143344
1544,181535717,324653,181860370,14,0,0,19968,14,5275493600
1545,181550861,362553,181913414,1,0,0,54784,1,7461129412
1546,181558386,473690,182032076,5,0,0,15360,5,7470466795
1547,181578467,685593,182264060,31,0,0,109056,31,8549960648
1548,181596430,617901,182214331,34,0,0,45568,34,4959414029
1549,181600128,531853,182131981,18,0,0,14336,18,256326665
1550,181654142,459438,182113580,23,0,0,27648,23,8112984570
1551,181667592,277691,181945283,31,0,0,30208,31,6168021520
1552,181669907,480126,182150033,14,0,0,13312,14,2585442154
1553,181682431,11855,181694286,9,0,1,2560,9,1602719843
1554,181690620,700880,182391500,31,0,0,58880,31,7677995657
1555,181703238,372737,182075975,35,0,0,1024,35,6127171542
1556,181703752,413758,182117510,31,0,0,12800,31,6292592441
1557,181719329,228957,181948286,23,0,0,9728,23,6392724077
1558,181735692,3422,181739114,25,0,1,3584,25,5278084327
1559,181757052,642785,182399837,19,0,0,9216,19,6484331508
1560,181771865,601680,182373545,26,0,0,29184,26,2545135145
1561,181781478,727541,182509019,19,0,0,46592,19,4567942869
1562,181794508,295398,182089906,27,0,0,2560,27,1133640217
1563,181800457,469315,182269772,30,0,0,8704,30,770030177
1564,181823844,341164,182165008,1,0,0,26112,1,1118024148
1565,181841061,200105,182041166,8,0,0,5632,8,9222659214
1566,181843457,8655,181852112,19,0,1,2048,19,3406475031
1567,181849746,3032,181852778,20,0,1,1024,20,3892930726
1568,181850810,587186,182437996,25,0,0,36352,25,7686034514
1569,181855324,9458,181864782,6,0,1,11776,6,8083536390
1570,181864189,220709,182084898,26,0,0,3584,26,4075315387
1571,181868842,258756,182127598,38,0,0,15360,38,8156464766
1572,181869434,136191,182005625,5,0,0,8192,5,8283585237
1573,181876077,348105,182224182,28,0,0,32256,28,2019781926
1574,181926816,470190,182397006,26,0,0,10240,26,3878825042
1575,181926881,52095,181978976,34,0,1,40960,34,8128834581
1576,181935846,264586,182200432,27,0,0,38400,27,573225669
1577,181942309,115911,182058220,25,0,0,512,25,3387972635
1578,181960936,450514,182411450,25,0,0,7680,25,3083967357
1579,181978639,6131,181984770,37,0,1,6144,37,3227186105
1580,181982948,2168,181985116,19,0,1,512,19,671817280
1581,182006068,441631,182447699,18,0,0,6656,18,9064804320
1582,182012558,396342,182408900,10,0,0,29696,10,5065759378
1583,182035755,5434,182041189,9,0,1,12800,9,3968352232
1584,182038486,609637,182648123,0,0,0,2048,0,9204514015
1585,182041936,1994,182043930,27,0,1,2048,27,1239785620
1586,182049008,10241,182059249,9,0,1,16384,9,1963130462
1587,182049650,11545,182061195,25,0,1,3072,25,7095158963
1588,182051723,312915,182364638,27,0,0,87040,27,6212216122
1589,182073675,12995,182086670,32,0,1,25088,32,7946632306
1590,182081493,384609,182466102,9,0,0,31744,9,163837380
1591,182082691,311180,182393871,30,0,0,7680,30,6603150784
1592,182093719,19876,182113595,28,0,1,28160,28,9996653756
1593,182122249,9747,182131996,11,0,1,12288,11,10250416827
1594,182132658,634474,182767132,9,0,0,3584,9,10548706800
1595,182134429,510521,182644950,31,0,0,36352,31,2133166634
1596,182135803,273284,182409087,35,0,0,512,35,4028154727
1597,182137648,404126,182541774,5,0,0,93184,5,2516401683
1598,182147896,711567,182859463,7,0,0,18944,7,5290088268
1599,182176961,717045,182894006,1,0,0,6144,1,10332829275
1600,182178108,587917,182766025,9,0,0,9216,9,7307751470
1601,182184399,523977,182708376,7,0,0,26624,7,3140558434
1602,182200507,280772,182481279,35,0,0,7680,35,9683410204
1603,182227489,366890,182594379,29,0,0,3584,29,9459623308
1604,182228999,35076,182264075,34,0,1,9728,34,4953287538
1605,182232831,430595,182663426,16,0,0,50176,16,3344273053
1606,182246698,417085,182663783,23,0,0,512,23,1435408856
1607,182281749,1518,182283267,11,0,1,1536,11,2616069895
1608,182292417,737124,183029541,7,0,0,20992,7,9451626843
1609,182308992,1042,182310034,12,0,1,1024,12,10365616447
1610,182316472,139943,182456415,9,0,0,11776,9,3500939382
1611,182316967,446235,182763202,1,0,0,38912,1,71568783
1612,182323129,232955,182556084,35,0,0,11264,35,4991819726
1613,182342977,78619,182421596,1,0,1,24576,1,3632189391
1614,182346996,279510,182626506,5,0,0,66560,5,991186761
1615,182349823,88188,182438011,27,0,1,17920,27,8132011597
1616,182401271,264087,182665358,3,0,0,5120,3,6409283901
1617,182405656,32370,182438026,24,0,1,6656,24,8134419589
1618,182410753,27288,182438041,27,0,1,6656,27,4095143854
1619,182441233,189122,182630355,25,0,0,10752,25,1542261419
1620,182470199,177285,182647484,2,0,0,8192,2,8729618558
1621,182487436,565795,183053231,10,0,0,4096,10,2823625318
1622,182491283,172329,182663612,34,0,0,512,34,5615137939
1623,182515596,259276,182774872,21,0,0,12800,21,210993818
1624,182518982,334694,182853676,15,0,0,14336,15,10262813082
1625,182540452,292613,182833065,4,0,0,22528,4,3606872772
1626,182551959,6278,182558237,27,0,1,6656,27,4042999605
1627,182552159,8337,182560496,37,0,1,11776,37,7611885657
1628,182569746,109641,182679387,27,0,0,3072,27,2424783928
1629,182609995,20375,182630370,16,0,1,1536,16,1460266541
1630,182615563,407567,183023130,25,0,0,23552,25,505878514
1631,182618991,25982,182644973,12,0,1,16896,12,7967413846
1632,182625452,37989,182663441,32,0,1,16384,32,1982948343
1633,182626431,385905,183012336,11,0,0,38400,11,2532108390
1634,182628463,351224,182979687,39,0,0,54272,39,9935130532
1635,182678551,468236,183146787,15,0,0,3584,15,5014069112
1636,182687536,434030,183121566,26,0,0,28672,26,1912545120
1637,182703897,15270,182719167,1,0,1,17408,1,8376110005
1638,182704087,491260,183195347,35,0,0,29696,35,8268013876
1639,182706639,366444,183073083,9,0,0,40960,9,7801512678
1640,182721942,65900,182787842,11,0,0,7168,11,8192185600
1641,182725687,273047,182998734,38,0,0,62464,38,7175956330
1642,182725876,290063,183015939,7,0,0,11776,7,5384582727
1643,182727853,2870,182730723,12,0,1,8704,12,7512727598
1644,182730047,419719,183149766,14,0,0,9728,14,7513355926
1645,182781964,330851,183112815,3,0,0,21504,3,8450999225
1646,182788047,149817,182937864,16,0,0,512,16,4155011101
1647,182799348,341949,183141297,38,0,0,36864,38,2070050963
1648,182801695,304553,183106248,10,0,0,26624,10,1945311238
1649,182806131,26949,182833080,21,0,1,35328,21,2607639476
1650,182841749,303931,183145680,7,0,0,14336,7,2266571397
1651,182842019,326689,183168708,32,0,0,4608,32,7334229624
1652,182847657,229185,183076842,27,0,0,12288,27,9979431671
1653,182855276,145345,183000621,35,0,0,6144,35,5837716111
1654,182864522,12737,182877259,32,0,1,24576,32,4747616884
1655,182876979,6754,182883733,11,0,1,7168,11,5030453862
1656,182879521,341537,183221058,20,0,0,24064,20,4350716301
1657,182912906,688045,183600951,34,0,1,1091584,34,8268605509
1658,182928279,504800,183433079,32,0,0,49152,32,1240815199
1659,182934532,666434,183600966,25,0,1,10752,25,781088146
1660,182941087,658726,183599813,4,0,0,92160,4,9680127195
1661,182973238,659126,183632364,5,0,0,19968,5,8289000563
1662,182978692,458542,183437234,29,0,0,5632,29,1853883866
1663,182979229,438451,183417680,19,0,0,13312,19,5462777199
1664,182985060,659052,183644112,3,0,0,35840,3,3035684363
1665,182986315,614666,183600981,8,0,1,5120,8,516080660
1666,183020029,495959,183515988,11,0,0,2560,11,398762444
1667,183022626,671910,183694536,18,0,0,15872,18,9898977488
1668,183040879,721118,183761997,1,0,0,37888,1,5116409659
1669,183046690,725480,183772170,34,0,0,10752,34,8141917314
1670,183065671,535265,183600936,4,0,0,3584,4,2867096317
1671,183067070,302599,183369669,23,0,0,9728,23,10022563029
1672,183074708,799649,183874357,21,0,0,17408,21,4541346417
1673,183074907,393332,183468239,18,0,0,2560,18,10188179451
1674,183100438,387631,183488069,7,0,0,6656,7,4985972783
1675,183142070,460189,183602259,22,0,1,6144,22,3472598538
1676,183144293,405667,183549960,17,0,0,4096,17,4919534889
1677,183156013,446261,183602274,2,0,1,1024,2,4118574517
1678,183163967,438322,183602289,6,0,1,10752,6,1509826316
1679,183167853,434391,183602244,3,0,0,4096,3,7080605342
1680,183196856,293100,183489956,38,0,0,6144,38,6339798619
1681,183206480,579783,183786263,14,0,0,12800,14,6109982869
1682,183217173,385139,183602312,22,0,1,2048,22,5940683032
1683,183245080,399055,183644135,18,0,1,145920,18,9916850695
1684,183259419,384731,183644150,29,0,1,10240,29,10283300495
1685,183272663,459892,183732555,3,0,0,21504,3,2027647011
1686,183274923,248461,183523384,30,0,0,1024,30,10479089326
1687,183285011,429862,183714873,30,0,0,44544,30,6913767206
1688,183293191,350974,183644165,29,0,1,2048,29,4754227679
1689,183300966,524043,183825009,10,0,0,47616,10,6898172872
1690,183301143,953920,184255063,19,0,0,43008,19,1105489086
1691,183307040,126374,183433414,10,0,0,1024,10,4667935210
1692,183314333,591190,183905523,21,0,0,34304,21,7679150118
1693,183316315,225370,183541685,9,0,0,512,9,152181781
1694,183330121,1070899,184401020,17,0,0,24576,17,3361868240
1695,183330699,313481,183644180,28,0,1,6144,28,10310287495
1696,183360764,249539,183610303,27,0,0,17408,27,7158989991
1697,183367163,411106,183778269,12,0,0,19968,12,5848685681
1698,183367515,277504,183645019,14,0,1,3072,14,6681650353
1699,183377281,268302,183645583,31,0,1,10752,31,3430836682
1700,183385917,265158,183651075,31,0,1,17920,31,640928763
1701,183385926,441906,183827832,16,0,0,9216,16,5304894124
1702,183389501,263840,183653341,20,0,1,3584,20,6653369159
1703,183391645,569189,183960834,30,0,0,45056,30,2453060594
1704,183400958,381390,183782348,36,0,0,13312,36,7979565287
1705,183416361,557307,183973668,18,0,0,11264,18,5580355270
1706,183425798,228311,183654109,12,0,1,11776,12,9650410616
1707,183448733,964329,184413062,25,0,0,15872,25,8065372398
1708,183461675,198028,183659703,12,0,1,26624,12,6486392593
1709,183469352,192617,183661969,35,0,1,3584,35,3168918217
1710,183506237,362801,183869038,26,0,0,16896,26,7233135428
1711,183507674,156561,183664235,28,0,1,3584,28,1508255078
1712,183537179,127722,183664901,28,0,1,1024,28,8383672986
1713,183542315,440178,183982493,32,0,0,18944,32,3845434703
1714,183550366,396725,183947091,7,0,0,33792,7,8920033970
1715,183576174,452991,184029165,27,0,0,25600,27,1974500122
1716,183579109,473561,184052670,9,0,0,58368,9,501140324
1717,183594605,627267,184221872,36,0,0,46080,36,4090255639
1718,183613181,274838,183888019,21,0,0,18432,21,5919662476
1719,183627092,289210,183916302,6,0,0,35328,6,7508260028
1720,183636089,833339,184469428,18,0,0,59392,18,4591171802
1721,183665008,459161,184124169,24,0,0,27648,24,2679132717
1722,183673681,435135,184108816,15,0,0,7680,15,3850185880
1723,183694960,512841,184207801,16,0,0,38400,16,3459326146
1724,183711516,776935,184488451,4,0,0,15360,4,2976410106
1725,183725989,351819,184077808,34,0,0,24576,34,8536835443
1726,183734048,434031,184168079,19,0,0,66048,19,3787664690
1727,183739464,366997,184106461,9,0,0,35328,9,114657246
1728,183751691,471912,184223603,36,0,0,5632,36,8135707424
1729,183753957,565420,184319377,19,0,0,33280,19,9808543828
1730,183757088,383125,184140213,17,0,0,9728,17,5517949977
1731,183763142,566,183763708,25,0,1,512,25,9906691808
1732,183768766,192707,183961473,5,0,0,2048,5,1395271346
1733,183772887,658468,184431355,29,0,0,26624,29,1473366083
1734,183807972,739033,184547005,13,0,0,16896,13,6501609020
1735,183832052,4850,183836902,28,0,1,5120,28,1667683506
1736,183838549,1066393,184904942,5,0,0,110592,5,6323657164
1737,183838847,891985,184730832,25,0,0,53760,25,1903936316
1738,183867871,503084,184370955,28,0,0,22016,28,4731900105
1739,183879347,484885,184364232,6,0,0,40960,6,1088749457
1740,183889699,306387,184196086,24,0,0,18432,24,6088307034
1741,183905420,128712,184034132,30,0,0,512,30,10294720417
1742,183925552,482659,184408211,10,0,0,23552,10,9456329847
1743,183958062,1063551,185021613,7,0,0,33792,7,4761597308
1744,183959262,414360,184373622,38,0,0,8704,38,7927676612
1745,183960038,280904,184240942,0,0,0,9216,0,5805300638
1746,183962249,323734,184285983,9,0,0,3072,9,2506866483
1747,183963917,566,183964483,21,0,1,512,21,2882086804
1748,183965918,643121,184609039,0,0,0,61440,0,3702772164
1749,183973169,795716,184768885,8,0,0,52224,8,6281308968
1750,183984117,715796,184699913,22,0,0,48640,22,10614533535
1751,183992326,578463,184570789,22,0,0,44544,22,8942501871
1752,184001985,16096,184018081,34,0,1,31232,34,7014599866
1753,184022579,232811,184255390,1,0,0,1024,1,2539134222
1754,184052137,13520,184065657,18,0,1,25088,18,9244358766
1755,184056164,853185,184909349,12,0,0,14336,12,4021765801
1756,184078887,29944,184108831,8,0,1,40960,8,10046164181
1757,184107953,1126377,185234330,20,0,0,70144,20,1281998631
1758,184118793,678588,184797381,21,0,0,16896,21,7056372632
1759,184120789,4439,184125228,4,0,1,1024,4,10328916045
1760,184136028,1234041,185370069,34,0,0,74752,34,8186169083
1761,184137904,898700,185036604,13,0,0,49152,13,5607556426
1762,184139448,645261,184784709,5,0,0,512,5,1004057483
1763,184166297,893316,185059613,32,0,0,57856,32,1970037822
1764,184199578,100363,184299941,34,0,1,128512,34,8133421971
1765,184200929,412969,184613898,26,0,0,15872,26,4251430018
1766,184204186,386118,184590304,3,0,0,64000,3,2562351616
1767,184206738,426501,184633239,18,0,1,604672,18,8839993739
1768,184223854,1046314,185270168,34,0,0,14848,34,6849490875
1769,184224611,975753,185200364,8,0,0,67072,8,1235613869
1770,184227880,1201031,185428911,25,0,0,4608,25,7406062907
1771,184241060,837151,185078211,10,0,0,11264,10,5686268379
1772,184257563,1319690,185577253,18,0,0,55296,18,4080390338
1773,184262529,451900,184714429,37,0,0,34816,37,5196424222
1774,184264735,746567,185011302,34,0,0,19456,34,9184206451
1775,184268214,432970,184701184,36,0,0,4096,36,5855332559
1776,184270731,368307,184639038,20,0,1,27648,20,8920173195
1777,184291142,704335,184995477,27,0,0,133120,27,9334267175
1778,184294786,576437,184871223,0,0,0,44032,0,1199344120
1779,184296984,1324083,185621067,21,0,0,23040,21,4174457125
1780,184298436,1431093,185729529,12,0,0,40448,12,5005256927
1781,184338247,1000184,185338431,7,0,0,70656,7,3479629486
1782,184340215,467393,184807608,23,0,0,32256,23,5665980510
1783,184350070,1262119,185612189,27,0,0,35840,27,2251136124
1784,184356980,1180894,185537874,18,0,0,64512,18,9107290957
1785,184362764,712000,185074764,36,0,0,18432,36,191791430
1786,184366278,631866,184998144,35,0,0,8704,35,7703434542
1787,184381919,797978,185179897,23,0,0,31232,23,1352468224
1788,184386115,854056,185240171,16,0,0,7680,16,8507745634
1789,184393874,757491,185151365,6,0,0,7680,6,9419116450
1790,184395897,243807,184639704,19,0,1,1024,19,7458631952
1791,184424808,215242,184640050,20,0,1,512,20,10698135712
1792,184429719,611300,185041019,19,0,0,14336,19,9619869707
1793,184456291,184835,184641126,22,0,1,13312,22,308618445
1794,184464441,994851,185459292,38,0,0,48128,38,255712446
1795,184465513,539822,185005335,6,0,0,23552,6,10282293850
1796,184471383,653136,185124519,5,0,0,31232,5,7868726485
1797,184492757,771609,185264366,1,0,0,79360,1,4182792146
1798,184513179,128715,184641894,28,0,1,11776,28,3010522458
1799,184524478,118389,184642867,0,0,1,12800,0,9114328582
1800,184533305,109716,184643021,34,0,1,8704,34,714639091
1801,184542276,104291,184646567,19,0,1,5632,19,8951609721
1802,184549630,620728,185170358,7,0,0,21504,7,9732344398
1803,184551278,97235,184648513,2,0,1,3072,2,2380562364
1804,184552496,357062,184909558,27,0,0,512,27,10541871314
1805,184570944,275470,184846414,17,0,0,1536,17,2185204906
1806,184619236,757922,185377158,25,0,0,5120,25,9830308358
1807,184622030,643599,185265629,17,0,0,4096,17,259569581
1808,184644345,593463,185237808,33,0,0,11264,33,8383845032
1809,184648246,7230,184655476,37,0,1,7680,37,9895825710
1810,184671526,11016,184682542,20,0,1,17920,20,9343443070
1811,184673206,368764,185041970,13,0,0,3072,13,2660280576
1812,184678595,1061440,185740035,16,0,0,10752,16,2481947649
1813,184684040,780461,185464501,14,0,0,6656,14,3095904674
1814,184687059,1133063,185820122,18,0,0,11776,18,9847625481
1815,184704396,896397,185600793,2,0,0,40448,2,3498611152
1816,184723632,9186,184732818,20,0,1,2048,20,10073098203
1817,184734765,770403,185505168,18,0,0,37376,18,8526942612
1818,184750707,521816,185272523,32,0,0,7680,32,3296033050
1819,184754400,20772,184775172,14,0,1,6656,14,9127793975
1820,184762537,14901,184777438,11,0,1,3584,11,10049745094
1821,184787156,10240,184797396,11,0,1,8192,11,2967295988
1822,184791782,117582,184909364,3,0,1,148480,3,6656413369
1823,184797843,111536,184909379,20,0,1,8192,20,6211502739
1824,184807784,1430047,186237831,34,0,0,102400,34,1570452248
1825,184848190,426844,185275034,10,0,0,8192,10,3381244608
1826,184850798,298212,185149010,33,0,0,22016,33,7004768302
1827,184859381,1438376,186297757,11,0,0,18944,11,4824606040
1828,184866628,508464,185375092,2,0,0,16384,2,5099173346
1829,184873530,42562,184916092,20,0,1,7168,20,7769452720
1830,184874565,423444,185298009,38,0,0,4608,38,7184795715
1831,184930283,448310,185378593,28,0,0,4608,28,8386539112
1832,184937195,1994,184939189,28,0,1,2048,28,4161405727
1833,184940267,400074,185340341,8,0,0,6144,8,9079829745
1834,184973655,1040260,186013915,30,0,0,28160,30,9529365284
1835,184976309,83327,185059636,35,0,1,512,35,9318361612
1836,184983019,392564,185375583,10,0,0,1536,10,1986538723
1837,184995589,480070,185475659,15,0,0,13824,15,7481042909
1838,184999908,78318,185078226,35,0,1,23552,35,3406761083
1839,185005722,484989,185490711,8,0,0,15872,8,7934688053
1840,185055099,660048,185715147,4,0,0,136704,4,400969652
1841,185067576,594684,185662260,6,0,0,13824,6,947705700
1842,185082078,3422,185085500,12,0,1,3584,12,2745927235
1843,185105843,611347,185717190,9,0,0,6656,9,1811701965
1844,185127397,530636,185658033,3,0,0,61952,3,359976369
1845,185155556,926394,186081950,14,0,0,82432,14,2514657149
1846,185164064,269837,185433901,10,0,0,9728,10,6054373253
1847,185170456,63897,185234353,8,0,1,27136,8,9051743495
1848,185174667,611164,185785831,37,0,0,12800,37,6721727275
1849,185194945,541775,185736720,31,0,0,23552,31,7870026028
1850,185214134,787194,186001328,23,0,0,69632,23,5060915933
1851,185218153,120293,185338446,18,0,1,132608,18,2049298565
1852,185276895,844439,186121334,38,0,0,38912,38,775216377
1853,185285058,654488,185939546,12,0,0,27136,12,8464632280
1854,185296336,584333,185880669,38,0,0,18432,38,6669383545
1855,185300897,1329882,186630779,20,0,0,59904,20,4736401083
1856,185306010,531032,185837042,38,0,0,9728,38,7825337413
1857,185325687,537060,185862747,12,0,0,22528,12,999928355
1858,185338063,750633,186088696,10,0,0,22016,10,5791539037
1859,185349959,805296,186155255,12,0,0,56320,12,1386456517
1860,185350133,400837,185750970,26,0,0,35840,26,1223936367
1861,185356671,836543,186193214,34,0,0,4608,34,7081140540
1862,185361801,826547,186188348,7,0,0,32256,7,8911135453
1863,185362597,428397,185790994,17,0,0,16896,17,6994270017
1864,185370461,921501,186291962,11,0,0,33792,11,3470866227
1865,185378463,925237,186303700,32,0,0,19456,32,4305734660
1866,185380495,782659,186163154,31,0,0,12800,31,6331540550
1867,185383714,75601,185459315,18,0,1,121856,18,1427578685
1868,185383904,563881,185947785,22,0,0,3072,22,10384746318
1869,185394617,652138,186046755,31,0,0,5632,31,6253404809
1870,185394690,65898,185460588,6,0,1,3584,6,3865224984
1871,185409092,55424,185464516,15,0,1,3072,15,5499078011
1872,185409254,1090938,186500192,3,0,0,34816,3,1207307124
1873,185440895,27950,185468845,32,0,1,30208,32,2909274422
1874,185446322,515839,185962161,8,0,0,21504,8,2352278933
1875,185458383,472841,185931224,9,0,0,24064,9,1869769319
1876,185461869,1266570,186728439,28,0,0,51712,28,3269755353
1877,185478797,952722,186431519,4,0,0,32768,4,6307925296
1878,185482810,441051,185923861,35,0,0,26112,35,7636144934
1879,185494608,836001,186330609,5,0,0,29184,5,3368700050
1880,185503987,330068,185834055,18,0,0,6144,18,2077585083
1881,185512611,285750,185798361,13,0,0,2560,13,8342431479
1882,185533224,16475,185549699,2,0,1,19456,2,6547723582
1883,185535824,1434811,186970635,7,0,0,28160,7,9411213508
1884,185536939,884581,186421520,21,0,0,18944,21,8850828765
1885,185574678,905876,186480554,31,0,0,3072,31,5603498049
1886,185594888,540829,186135717,31,0,0,47104,31,6749417305
1887,185597791,644275,186242066,29,0,0,13824,29,8015600373
1888,185608862,712840,186321702,1,0,0,45568,1,2070422807
1889,185623773,568022,186191795,19,0,0,11264,19,7250245536
1890,185660934,392565,186053499,39,0,0,2560,39,9048761481
1891,185691397,646369,186337766,15,0,0,17408,15,9144966910
1892,185696773,556556,186253329,29,0,0,36864,29,1417390453
1893,185712876,1033541,186746417,9,0,0,56320,9,3973826795
1894,185724417,413663,186138080,28,0,0,7680,28,5118704856
1895,185726553,26996,185753549,25,0,1,2560,25,8162675691
1896,185727705,868759,186596464,20,0,0,114688,20,8063053773
1897,185739781,738433,186478214,7,0,0,60928,7,361604061
1898,185742933,805133,186548066,35,0,0,39936,35,7397340336
1899,185746695,285150,186031845,28,0,0,3584,28,10263956564
1900,185752684,3422,185756106,22,0,1,3584,22,4569773129
1901,185774346,591576,186365922,30,0,0,12288,30,8402583717
1902,185783516,488623,186272139,2,0,0,2048,2,1155625099
1903,185795019,363253,186158272,31,0,0,5120,31,39173584
1904,185800048,912604,186712652,5,0,0,49664,5,8934623704
1905,185814532,1263875,187078407,21,0,0,18944,21,6427047906
1906,185824107,271245,186095352,24,0,0,1024,24,10164461602
1907,185832364,11125,185843489,37,0,1,15872,37,1288284522
1908,185841137,4618,185845755,14,0,1,3584,14,6249574013
1909,185846177,85062,185931239,12,0,1,120320,12,5034295927
1910,185854505,176233,186030738,33,0,0,5120,33,1258322596
1911,185866963,72598,185939561,22,0,1,22528,22,9416505803
1912,185873956,221069,186095025,31,0,0,6656,31,6781890953
1913,185890422,912692,186803114,18,0,0,73216,18,4498738067
1914,185895002,194489,186089491,15,0,0,2560,15,2203020648
1915,185911582,396206,186307788,21,0,0,4096,21,8671686842
1916,185916141,23435,185939576,22,0,1,512,22,6596690527
1917,185919282,20317,185939599,37,0,1,3072,37,8847376271
1918,185923074,236165,186159239,2,0,0,3072,2,7043938763
1919,185933793,1028247,186962040,13,0,0,34816,13,3856561423
1920,185946752,209922,186156674,37,0,0,4608,37,3345505635
1921,185959931,418126,186378057,36,0,0,3072,36,5722918384
1922,185960309,478585,186438894,32,0,0,512,32,8668172946
1923,185960977,794065,186755042,32,0,0,8704,32,9721541652
1924,186001568,80397,186081965,3,0,1,125440,3,4990399600
1925,186007123,82383,186089506,31,0,1,38400,31,10217905582
1926,186080959,530713,186611672,13,0,0,15872,13,2785418669
1927,186100608,811760,186912368,18,0,0,42496,18,380068353
1928,186101889,1147970,187249859,8,0,0,50176,8,10213637519
1929,186102827,886785,186989612,23,0,0,9216,23,3463886156
1930,186113186,1202930,187316116,28,0,0,25600,28,986434574
1931,186120366,36323,186156689,23,0,1,1024,23,8221839812
1932,186143267,418230,186561497,34,0,0,44032,34,2552957820
1933,186144716,607659,186752375,6,0,0,6656,6,1168525645
1934,186145373,1205234,187350607,3,0,0,113152,3,8453959688
1935,186159527,569715,186729242,27,0,0,2560,27,4878571708
1936,186206849,396658,186603507,30,0,0,23040,30,895034114
1937,186231566,180114,186411680,4,0,0,16896,4,4380665627
1938,186239121,436080,186675201,8,0,0,1536,8,5491133747
1939,186252771,1137716,187390487,1,0,0,26624,1,3232071142
1940,186254521,386257,186640778,24,0,0,32768,24,5526674228
1941,186267961,406757,186674718,27,0,0,53248,27,9906930556
1942,186283888,23915,186307803,9,0,1,9728,9,2030869952
1943,186291035,744524,187035559,32,0,0,18944,32,689539344
1944,186322783,284023,186606806,37,0,0,10752,37,2008044646
1945,186332547,8199,186340746,16,0,1,3072,16,9650074775
1946,186334880,1336094,187670974,20,0,0,97280,20,6766650246
1947,186336236,421637,186757873,19,0,0,9216,19,6247794229
1948,186364315,1065623,187429938,37,0,0,53248,37,4808580521
1949,186368884,321811,186690695,19,0,0,18944,19,6167166110
1950,186369030,1384443,187753473,5,0,0,8192,5,6345821152
1951,186378295,4850,186383145,6,0,1,5120,6,3104849606
1952,186440468,338524,186778992,32,0,0,16384,32,781297565
1953,186469462,11107,186480569,6,0,1,1536,6,8837283165
1954,186469828,923958,187393786,4,0,0,10752,4,83353791
1955,186476870,273462,186750332,23,0,0,12800,23,2432858495
1956,186478654,1396535,187875189,22,0,0,7168,22,448420055
1957,186480802,808234,187289036,28,0,0,8704,28,6490893213
1958,186527958,467202,186995160,36,0,0,12800,36,1021668272
1959,186546963,59858,186606821,21,0,1,6144,21,168975561
1960,186591464,963521,187554985,38,0,0,12800,38,3333594353
1961,186623420,387309,187010729,29,0,0,47616,29,7334268009
1962,186635672,7610,186643282,8,0,1,2560,8,8946208671
1963,186639911,13472,186653383,9,0,1,19456,9,6268560249
1964,186652066,377698,187029764,25,0,0,37376,25,5455383820
1965,186652465,5802,186658267,27,0,1,6144,27,4034514885
1966,186653329,270577,186923906,23,0,0,512,23,7782916465
1967,186664859,12345,186677204,22,0,1,2048,22,2746522484
1968,186669637,254098,186923735,34,0,0,10240,34,5010321343
1969,186682687,304102,186986789,18,0,0,19456,18,2951178440
1970,186697845,456107,187153952,21,0,0,11776,21,866321213
1971,186700059,316457,187016516,38,0,0,18944,38,5905815893
1972,186704837,227562,186932399,17,0,0,23552,17,1995003541
1973,186735685,1262552,187998237,18,0,0,51200,18,365801713
1974,186758395,744251,187502646,4,0,0,33280,4,3950393742
1975,186763059,188358,186951417,35,0,0,22528,35,5240840282
1976,186764185,1042,186765227,35,0,1,1024,35,9256028131
1977,186764286,2254,186766540,6,0,1,2048,6,5038727539
1978,186764574,276364,187040938,23,0,0,17408,23,2923741046
1979,186780720,260553,187041273,11,0,0,1024,11,4770781793
1980,186785131,18583,186803714,11,0,1,512,11,3485614354
1981,186785993,18067,186804060,6,0,1,512,6,7783260488
1982,186795807,586530,187382337,1,0,0,80896,1,7006249530
1983,186807231,998419,187805650,19,0,0,111616,19,8339202912
1984,186811180,1994,186813174,25,0,1,2048,25,1891473849
1985,186812629,10757,186823386,2,0,1,17408,2,9741972405
1986,186819206,415350,187234556,20,0,0,55296,20,3716593417
1987,186822624,172551,186995175,18,0,1,279040,18,6967095648
1988,186824755,319859,187144614,39,0,0,12288,39,5816180690
1989,186831130,342581,187173711,21,0,0,17920,21,5266836601
1990,186867170,546529,187413699,36,0,0,16896,36,4901116525
1991,186878897,589223,187468120,22,0,0,8192,22,4108376104
1992,186882128,1187361,188069489,11,0,0,93696,11,8032924734
1993,186882776,401811,187284587,12,0,0,5632,12,1470455121
1994,186932390,1108504,188040894,8,0,0,88576,8,8598009702
1995,186932437,320578,187253015,27,0,0,2048,27,2810536490
1996,186937604,460097,187397701,21,0,0,12800,21,902201724
1997,186939882,960808,187900690,1,0,0,14848,1,6430952174
1998,187020228,337422,187357650,18,0,0,23040,18,8313938575
1999,187035383,498094,187533477,14,0,0,41472,14,9439948067
2000,187039775,212083,187251858,30,0,0,4096,30,7484311795
2001,187064227,366038,187430265,3,0,0,1024,3,4771905755
2002,187131803,1002962,188134765,12,0,0,22528,12,6729737983
2003,187151779,920712,188072491,4,0,0,2560,4,8451106025
2004,187154299,2470,187156769,7,0,1,2560,7,3207039936
2005,187159137,569664,187728801,32,0,0,34816,32,3846946987
2006,187160697,14117,187174814,28,0,1,24064,28,4695337302
2007,187173533,366735,187540268,23,0,0,14336,23,10607299764
2008,187192624,358438,187551062,35,0,0,32256,35,8455500336
2009,187201801,339418,187541219,9,0,0,3072,9,10130913901
2010,187214527,1063985,188278512,15,0,0,48640,15,6439999373
2011,187218869,646055,187864924,9,0,0,2560,9,6739203024
2012,187221320,244289,187465609,25,0,0,18944,25,5227702524
2013,187263322,1994,187265316,27,0,1,2048,27,7899942084
2014,187267282,3422,187270704,18,0,1,3584,18,3703338712
2015,187273903,15148,187289051,19,0,1,27648,19,6326969176
2016,187295950,407556,187703506,4,0,0,22016,4,8589739051
2017,187322254,60098,187382352,25,0,1,7168,25,5410390541
2018,187347497,293814,187641311,22,0,0,87040,22,3329898393
2019,187349362,330215,187679577,9,0,0,28160,9,6650259556
2020,187374849,354279,187729128,8,0,0,1024,8,2171818405
2021,187377003,24555,187401558,29,0,1,4096,29,8074919605
2022,187397602,283394,187680996,20,0,0,4608,20,1634375402
2023,187424218,538216,187962434,30,0,0,11776,30,2611829311
2024,187427436,303735,187731171,18,0,0,6656,18,5499285783
2025,187431744,470848,187902592,19,0,0,6144,19,8295286936
2026,187441580,517243,187958823,32,0,0,34304,32,2846582055
2027,187442540,2946,187445486,28,0,1,3072,28,6945389108
2028,187468380,246204,187714584,21,0,0,3584,21,2694276717
2029,187473203,452024,187925227,37,0,0,74240,37,7004239164
2030,187475701,1242674,188718375,20,0,0,78336,20,5817392778
2031,187477038,332223,187809261,2,0,0,11776,2,8129088980
2032,187493290,338441,187831731,38,0,0,2560,38,9043660560
2033,187506018,708901,188214919,39,0,0,42496,39,4184587798
2034,187512464,4420,187516884,2,0,1,11776,2,806466094
2035,187517326,360070,187877396,18,0,0,7168,18,380289798
2036,187520423,294625,187815048,25,0,0,18944,25,4408470624
2037,187521574,235229,187756803,15,0,0,4608,15,635464366
2038,187541814,276177,187817991,23,0,0,2048,23,2331111662
2039,187548196,465695,188013891,2,0,0,16384,2,3462213989
2040,187549538,289513,187839051,10,0,0,5632,10,3357358060
2041,187550435,7062,187557497,1,0,1,2560,1,3004063333
2042,187556255,260844,187817099,14,0,0,6656,14,10099353147
2043,187577712,725026,188302738,35,0,0,10752,35,4258355692
2044,187579426,403196,187982622,7,0,0,32256,7,3520650213
2045,187610084,767748,188377832,34,0,0,4096,34,70676475
2046,187616119,455569,188071688,9,0,0,7168,9,9712611161
2047,187619413,389471,188008884,28,0,0,34816,28,5211041656
2048,187646365,226601,187872966,35,0,0,11264,35,1504954260
2049,187664144,21548,187685692,11,0,1,12288,11,4202047207
2050,187687479,6278,187693757,17,0,1,6656,17,6997026590
2051,187697854,6703,187704557,29,0,1,1024,29,10124337780
2052,187703293,2570,187705863,31,0,1,2048,31,8911392897
2053,187710689,1055138,188765827,35,0,0,39424,35,5951460040
2054,187748868,223911,187972779,17,0,0,25600,17,5269017761
2055,187787465,1010761,188798226,11,0,0,4096,11,2459467247
2056,187798435,22268,187820703,1,0,1,10240,1,5578897034
2057,187819167,444510,188263677,6,0,0,41472,6,9477482617
2058,187824001,264528,188088529,0,0,0,22016,0,6761309686
2059,187846698,341917,188188615,18,0,0,1536,18,7409719553
2060,187855324,1518,187856842,8,0,1,1536,8,6121864924
2061,187870331,379244,188249575,28,0,0,95744,28,5884303122
2062,187873024,6325,187879349,11,0,1,2048,11,5718005384
2063,187885256,221518,188106774,8,0,0,1536,8,2441167973
2064,187892353,8352,187900705,10,0,1,4096,10,8819248666
2065,187918749,497668,188416417,24,0,0,6656,24,4951555316
2066,187949145,241921,188191066,14,0,0,6144,14,1565322582
2067,187962468,407537,188370005,25,0,0,54272,25,6262005944
2068,187968528,282490,188251018,25,0,0,4608,25,8669504964
2069,187968661,330786,188299447,8,0,0,19456,8,4012858840
2070,187969040,338865,188307905,8,0,0,11776,8,8989102274
2071,188003610,425489,188429099,36,0,0,5120,36,10590554840
2072,188014438,588967,188603405,4,0,0,97792,4,9350159056
2073,188019991,820146,188840137,8,0,0,38400,8,8038141090
2074,188022552,921307,188943859,16,0,0,47104,16,10283112856
2075,188036559,41345,188077904,34,0,1,13824,34,5195532030
2076,188080328,271229,188351557,30,0,0,20992,30,2765345279
2077,188085413,1047552,189132965,28,0,0,51200,28,7130395539
2078,188089877,193806,188283683,14,0,0,16896,14,1937111445
2079,188104441,552862,188657303,37,0,0,7168,37,1140205946
2080,188116259,428973,188545232,14,0,0,40448,14,3481558058
2081,188123827,570649,188694476,10,0,0,5632,10,5480628482
2082,188131429,1031365,189162794,19,0,0,9728,19,4402800343
2083,188140534,313433,188453967,6,0,0,8192,6,941854838
2084,188158527,370768,188529295,3,0,0,6144,3,6980804657
2085,188179179,617776,188796955,36,0,0,66048,36,9855382294
2086,188222830,553986,188776816,14,0,0,22016,14,9230631086
2087,188228270,444024,188672294,27,0,0,49152,27,10592634907
2088,188229525,170912,188400437,12,0,0,33280,12,2094300981
2089,188231429,622194,188853623,28,0,0,24064,28,10232832034
2090,188267379,260029,188527408,13,0,0,12288,13,6023196066
2091,188269949,142672,188412621,2,0,0,20992,2,3764770709
2092,188272512,14610,188287122,8,0,1,3584,8,1382490532
2093,188292702,220340,188513042,2,0,0,21504,2,916745209
2094,188301720,6200,188307920,20,0,1,3072,20,1842008200
2095,188330953,172917,188503870,8,0,0,36352,8,6084284735
2096,188332922,274866,188607788,3,0,0,14336,3,4477317083
2097,188333690,512562,188846252,39,0,0,19968,39,8554723989
2098,188343826,7746,188351572,6,0,1,6656,6,2749552408
2099,188372797,584993,188957790,18,0,0,45568,18,10160359392
2100,188381422,311323,188692745,9,0,0,67072,9,10034808695
2101,188388410,13253,188401663,18,0,1,25600,18,9589270155
2102,188419634,436070,188855704,29,0,0,6656,29,5936169619
2103,188434631,303978,188738609,25,0,0,10752,25,10134974329
2104,188467174,334031,188801205,27,0,0,9728,27,10413801821
2105,188475476,819816,189295292,21,0,0,55296,21,10523528634
2106,188481451,272349,188753800,5,0,0,27136,5,1810612629
2107,188486983,236243,188723226,35,0,0,15872,35,8265118608
2108,188536442,268374,188804816,5,0,0,11776,5,1652601552
2109,188538571,319876,188858447,10,0,0,8192,10,2719888691
2110,188561468,323703,188885171,2,0,0,40448,2,1627721557
2111,188584634,470355,189054989,12,0,0,6144,12,1570623358
2112,188590067,295587,188885654,1,0,0,1536,1,4763963933
2113,188615783,363776,188979559,5,0,0,31744,5,4421570736
2114,188616685,244060,188860745,1,0,0,1024,1,9991376742
2115,188619811,309681,188929492,38,0,0,72192,38,6506376489
2116,188631669,456218,189087887,3,0,0,37376,3,4507685143
2117,188638966,385933,189024899,31,0,0,48128,31,508162139
2118,188639894,329299,188969193,33,0,0,37376,33,10504022107
2119,188665673,304159,188969832,0,0,0,2048,0,4613907508
2120,188670841,381426,189052267,10,0,0,30720,10,5355533540
2121,188683402,635632,189319034,8,0,0,1536,8,9441686263
2122,188689196,414321,189103517,11,0,0,16896,11,6120037817
2123,188716558,11084,188727642,1,0,1,4608,1,8516533961
2124,188749640,645595,189395235,7,0,0,2048,7,8168963834
2125,188758087,463687,189221774,32,0,0,41984,32,3377915856
2126,188775421,647957,189423378,27,0,0,6144,27,2313190425
2127,188787684,310670,189098354,23,0,0,34304,23,6266455108
2128,188836411,17235,188853646,0,0,1,1024,0,4830450607
2129,188837881,15780,188853661,35,0,1,1024,35,2592936588
2130,188841495,44174,188885669,19,0,1,33792,19,6700868823
2131,188852412,374057,189226469,39,0,0,15360,39,10596556197
2132,188863037,520593,189383630,2,0,0,51712,2,9021696161
2133,188893804,210204,189104008,14,0,0,1536,14,7302042311
2134,188914202,65372,188979574,6,0,1,512,6,1383541203
2135,188919436,60169,188979605,27,0,1,2048,27,482236877
2136,188924931,403634,189328565,33,0,0,31232,33,9361182508
2137,188927413,248989,189176402,35,0,0,13824,35,5157553319
2138,188949003,31572,188980575,31,0,1,1024,31,690657744
2139,188962120,29258,188991378,14,0,1,18944,14,9470480758
2140,188967589,188154,189155743,19,0,0,41984,19,10462790419
2141,188993605,438216,189431821,33,0,0,26112,33,6368389877
2142,188995131,537127,189532258,6,0,0,19456,6,3481447415
2143,188996605,397991,189394596,37,0,0,15872,37,10565010188
2144,188998413,320138,189318551,37,0,0,76288,37,3927742205
2145,189003037,1518,189004555,18,0,1,1536,18,2320920124
2146,189017758,339978,189357736,8,0,0,10752,8,9248521845
2147,189086455,312695,189399150,27,0,0,12800,27,1208637863
2148,189092913,360217,189453130,5,0,0,11776,5,5955839572
2149,189093572,296157,189389729,35,0,0,19968,35,8978177823
2150,189129937,25821,189155758,6,0,1,26624,6,347986145
2151,189153175,268316,189421491,25,0,0,31232,25,5597437752
2152,189158124,469332,189627456,23,0,0,40960,23,3013947301
2153,189185488,251441,189436929,21,0,0,5632,21,7519440269
2154,189215217,15142,189230359,1,0,1,4096,1,1768885799
2155,189231454,397117,189628571,6,0,0,3584,6,8678676925
2156,189252580,362373,189614953,21,0,0,55808,21,488836501
2157,189299938,253940,189553878,22,0,0,21504,22,2428048726
2158,189299964,247347,189547311,8,0,0,36864,8,4754809223
2159,189321210,8915,189330125,0,0,1,1536,0,3136223524
2160,189351433,566,189351999,6,0,1,512,6,10251171646
2161,189375484,293360,189668844,20,0,0,10240,20,6871084401
2162,189380560,285133,189665693,25,0,0,56832,25,8655413235
2163,189402972,6754,189409726,18,0,1,7168,18,3660922624
2164,189403540,346320,189749860,24,0,0,50176,24,2469868772
2165,189409441,2470,189411911,11,0,1,2560,11,10078657267
2166,189437725,424554,189862279,33,0,0,55296,33,7080234332
2167,189437794,268807,189706601,0,0,0,17408,0,140760482
2168,189445941,2470,189448411,19,0,1,2560,19,2177521889
2169,189479832,566,189480398,31,0,1,512,31,6813921254
2170,189484041,361367,189845408,36,0,0,97792,36,7483569223
2171,189485865,2946,189488811,3,0,1,3072,3,1545588537
2172,189492481,538400,190030881,22,0,0,49664,22,5455206822
2173,189498372,374728,189873100,2,0,0,13824,2,1028572057
2174,189498610,258761,189757371,7,0,0,24576,7,5330636380
2175,189500540,1042,189501582,20,0,1,1024,20,6955889422
2176,189509198,262803,189772001,18,0,0,21504,18,2541037900
2177,189509656,562591,190072247,30,0,0,55808,30,4330444794
2178,189514978,679488,190194466,38,0,0,89088,38,3745987831
2179,189528226,364573,189892799,4,0,0,28672,4,10639686992
2180,189563473,384827,189948300,14,0,0,10752,14,5943597548
2181,189595975,500863,190096838,4,0,0,15872,4,104068087
2182,189606827,258907,189865734,30,0,0,11264,30,8257797396
2183,189611136,302074,189913210,14,0,0,512,14,9410963939
2184,189640836,467153,190107989,0,0,0,5632,0,7539027298
2185,189656654,16311,189672965,11,0,1,11264,11,3793861843
2186,189657290,549062,190206352,8,0,0,38912,8,3999626367
2187,189704565,377369,190081934,23,0,0,31744,23,5518950657
2188,189706775,238234,189945009,36,0,0,14848,36,7693862909
2189,189708566,273746,189982312,37,0,0,54784,37,4485423988
2190,189735337,160152,189895489,32,0,0,4096,32,8219122451
2191,189745909,596543,190342452,3,0,0,26112,3,5999796022
2192,189759023,135203,189894226,39,0,0,4608,39,10256891828
2193,189777157,10757,189787914,18,0,1,17408,18,8321251949
2194,189789508,336337,190125845,36,0,0,13824,36,2633448782
2195,189830011,163837,189993848,7,0,0,7680,7,9597567185
2196,189849822,23293,189873115,28,0,1,13312,28,4751961612
2197,189860428,260405,190120833,7,0,0,30208,7,7380009206
2198,189861959,226238,190088197,32,0,0,20480,32,10260122277
2199,189864125,189051,190053176,1,0,0,33792,1,9234939710
2200,189878239,655590,190533829,6,0,0,21504,6,6099858836
2201,189886386,270785,190157171,22,0,0,4608,22,4141086813
2202,189896604,136328,190032932,7,0,0,6656,7,10426625488
2203,189902144,187316,190089460,32,0,0,4096,32,10653006632
2204,189905786,232915,190138701,0,0,0,33280,0,7848630388
2205,189907376,317928,190225304,27,0,0,2048,27,7046227959
2206,189910878,486786,190397664,12,0,0,34304,12,1601650775
2207,189911676,180303,190091979,30,0,0,8192,30,6882856674
2208,189913505,439069,190352574,5,0,0,13824,5,3782668244
2209,189915440,211980,190127420,38,0,0,5120,38,9723598163
2210,189942941,272326,190215267,39,0,0,29184,39,1880463307
2211,189951239,271375,190222614,39,0,0,24064,39,10689346988
2212,189967386,257279,190224665,36,0,0,6656,36,3434706232
2213,190024748,201039,190225787,32,0,0,1536,32,6097827040
2214,190030555,7048,190037603,16,0,1,12288,16,6335165578
2215,190042230,292251,190334481,30,0,0,78848,30,781121774
2216,190065923,210925,190276848,2,0,0,24576,2,3644551301
2217,190080305,225225,190305530,10,0,0,22016,10,9472729936
2218,190086186,441060,190527246,30,0,0,70656,30,8079374414
2219,190090673,208134,190298807,7,0,0,17920,7,91071787
2220,190101258,178588,190279846,36,0,0,4096,36,6560526089
2221,190103976,4028,190108004,2,0,1,3072,2,2334037034
2222,190112539,523766,190636305,22,0,0,33280,22,6818003385
2223,190123305,15427,190138732,37,0,1,16384,37,8453588927
2224,190126088,16728,190142816,19,0,1,8192,19,8831642943
2225,190131169,248693,190379862,23,0,0,5632,23,3429025868
2226,190137447,235120,190372567,38,0,0,28672,38,149171645
2227,190142272,3898,190146170,35,0,1,4096,35,3546279581
2228,190151304,465708,190617012,35,0,0,76800,35,2292762948
2229,190167016,27465,190194481,18,0,1,5632,18,2840176872
2230,190191195,34800,190225995,27,0,1,3584,27,710393661
2231,190237477,3898,190241375,32,0,1,4096,32,5401009575
2232,190243058,1994,190245052,31,0,1,2048,31,9551656714
2233,190243605,120211,190363816,27,0,0,4096,27,9637899825
2234,190255281,311405,190566686,32,0,0,13824,32,9897174005
2235,190263464,79643,190343107,13,0,0,2048,13,8428822443
2236,190264815,279325,190544140,32,0,0,33792,32,289508049
2237,190268515,434366,190702881,29,0,0,71680,29,8937985998
2238,190273777,286171,190559948,24,0,0,32256,24,2452689947
2239,190286736,6278,190293014,35,0,1,6656,35,8505707574
2240,190292451,417948,190710399,37,0,0,15360,37,273366687
2241,190305619,72512,190378131,28,0,0,4096,28,7619223200
2242,190324715,237744,190562459,39,0,0,8192,39,9922958058
2243,190332912,260394,190593306,5,0,0,2560,5,10086626665
2244,190361654,225503,190587157,18,0,0,10752,18,8815816545
2245,190380166,203692,190583858,10,0,0,13824,10,9039359238
2246,190420859,366066,190786925,27,0,0,34816,27,8811098468
2247,190425334,11274,190436608,14,0,1,18432,14,4376069475
2248,190433660,183850,190617510,7,0,0,1536,7,6820028613
2249,190436870,278544,190715414,14,0,0,16384,14,1869515745
2250,190438808,337323,190776131,27,0,0,57856,27,5255859571
2251,190448392,205060,190653452,3,0,0,9216,3,7509152291
2252,190452068,273753,190725821,29,0,0,14848,29,530256757
2253,190453594,2946,190456540,7,0,1,3072,7,7498543320
2254,190468236,151637,190619873,35,0,0,7680,35,3827881775
2255,190478483,11274,190489757,8,0,1,18432,8,641087567
2256,190500330,312027,190812357,1,0,0,15360,1,5111019761
2257,190510347,279128,190789475,34,0,0,4096,34,9448117693
2258,190515900,377803,190893703,17,0,0,6656,17,845622383
2259,190530185,343973,190874158,5,0,0,81408,5,3391010209
2260,190532790,138120,190670910,22,0,0,512,22,9340476605
2261,190562497,143207,190705704,15,0,0,9216,15,562753820
2262,190572807,164909,190737716,14,0,0,3072,14,9273376389
2263,190581465,206731,190788196,22,0,0,4096,22,5987552958
2264,190585235,31792,190617027,11,0,1,8192,11,10431905081
2265,190598523,193826,190792349,17,0,0,4096,17,7817795179
2266,190603866,387546,190991412,5,0,0,41472,5,103730323
2267,190616479,261438,190877917,17,0,0,12288,17,9161503771
2268,190631535,260125,190891660,34,0,0,45056,34,623690244
2269,190641921,134381,190776302,6,0,0,512,6,10700123774
2270,190669165,1042,190670207,27,0,1,1024,27,526501888
2271,190705946,217776,190923722,33,0,0,5632,33,1948042534
2272,190710127,329123,191039250,4,0,0,15872,4,1049964649
2273,190713457,3016,190716473,19,0,1,1024,19,4223937655
2274,190731502,6278,190737780,29,0,1,6656,29,6438049194
2275,190732867,218913,190951780,36,0,0,24064,36,797204842
2276,190740031,171263,190911294,0,0,0,4096,0,6858253816
2277,190749817,222355,190972172,2,0,0,12288,2,10177460244
2278,190772178,192538,190964716,3,0,0,31232,3,3675612969
2279,190779171,222716,191001887,16,0,0,34304,16,8613246837
2280,190782636,282028,191064664,17,0,0,2560,17,10544637079
2281,190798811,783838,191582649,18,0,0,243712,18,4061568498
2282,190801832,587539,191389371,33,0,0,33792,33,5077482040
2283,190806526,308783,191115309,2,0,0,14848,2,2632180001
2284,190807177,468375,191275552,22,0,0,23552,22,4523660641
2285,190819191,401357,191220548,7,0,0,22016,7,6680805953
2286,190824965,1042,190826007,28,0,1,1024,28,10736877200
2287,190827387,6754,190834141,22,0,1,7168,22,7868365546
2288,190835823,377986,191213809,36,0,0,98816,36,6974939874
2289,190838004,2470,190840474,37,0,1,2560,37,6057820929
2290,190844196,447956,191292152,26,0,0,19968,26,154171632
2291,190871261,388941,191260202,31,0,0,5632,31,3995322968
2292,190891642,128923,191020565,35,0,0,5120,35,6181154013
2293,190898107,383871,191281978,32,0,0,7680,32,1847370703
2294,190905029,278641,191183670,12,0,0,67584,12,1203133074
2295,190914624,227747,191142371,39,0,0,30720,39,5875362768
2296,190916087,7650,190923737,27,0,1,7680,27,801231676
2297,190930273,5802,190936075,27,0,1,6144,27,214093734
2298,190946067,332776,191278843,21,0,0,10752,21,4869582739
2299,190946086,18645,190964731,2,0,1,6656,2,10279882700
2300,190948395,16351,190964746,16,0,1,2560,16,6300472368
2301,190960278,298193,191258471,39,0,0,41472,39,5255245993
2302,190970435,8007,190978442,36,0,1,6656,36,3681096395
2303,190982286,457595,191439881,12,0,0,36352,12,2593243139
2304,190987814,235245,191223059,34,0,0,8192,34,6053462485
2305,191017240,600172,191617412,34,0,0,14848,34,2010426600
2306,191020853,18420,191039273,14,0,1,29696,14,2146052831
2307,191023525,15763,191039288,31,0,1,11776,31,8902286056
2308,191033640,203829,191237469,34,0,0,10240,34,4239389471
2309,191034479,128584,191163063,23,0,0,4096,23,4807800908
2310,191039810,468568,191508378,7,0,0,36864,7,7115478545
2311,191054460,1042,191055502,37,0,1,1024,37,9957501580
2312,191057903,2870,191060773,25,0,1,8704,25,4093229601
2313,191058290,15826,191074116,31,0,1,26112,31,8025376696
2314,191072034,666938,191738972,9,0,0,30720,9,7614656864
2315,191074478,392996,191467474,33,0,0,32256,33,741334109
2316,191107537,321237,191428774,13,0,0,66560,13,9871471337
2317,191115311,280330,191395641,27,0,0,4096,27,8652587012
2318,191129096,177906,191307002,39,0,0,3072,39,8203494315
2319,191140188,178368,191318556,4,0,0,6656,4,7334334590
2320,191147895,174216,191322111,29,0,0,4608,29,8219397668
2321,191174662,219716,191394378,22,0,0,16384,22,8942128734
2322,191176020,416160,191592180,11,0,0,31232,11,643471069
2323,191188381,265523,191453904,35,0,0,11776,35,9564200099
2324,191189861,597126,191786987,39,0,0,14848,39,6918698076
2325,191229120,368395,191597515,23,0,0,17408,23,6663310541
2326,191238714,245426,191484140,32,0,0,2560,32,5757404903
2327,191253556,410412,191663968,24,0,0,31232,24,4487883947
2328,191259340,353525,191612865,25,0,0,48128,25,7391653225
2329,191262711,335459,191598170,37,0,0,2048,37,4563268646
2330,191268333,461264,191729597,11,0,0,34304,11,1208610936
2331,191279513,2946,191282459,16,0,1,3072,16,5609284139
2332,191288696,332475,191621171,38,0,0,12288,38,6162263693
2333,191298455,23725,191322180,13,0,1,39424,13,384306540
2334,191300668,26658,191327326,27,0,1,8192,27,3449973453
2335,191321368,320028,191641396,30,0,0,52736,30,9718396048
2336,191341206,488904,191830110,27,0,0,8192,27,6720196987
2337,191344129,6754,191350883,10,0,1,7168,10,7242869739
2338,191346836,278461,191625297,32,0,0,3072,32,3659260581
2339,191365941,258381,191624322,32,0,0,10240,32,3222130237
2340,191367961,283175,191651136,0,0,0,25088,0,8075993950
2341,191369218,418321,191787539,27,0,0,1536,27,163436130
2342,191400116,243361,191643477,39,0,0,6656,39,6779610162
2343,191405622,542470,191948092,18,0,0,6144,18,1156256110
2344,191416480,300676,191717156,25,0,0,54272,25,8703163579
2345,191421601,327415,191749016,22,0,0,20992,22,6122431070
2346,191429794,17309,191447103,27,0,1,7680,27,9432382272
2347,191493870,248735,191742605,17,0,0,9728,17,920579363
2348,191525905,213706,191739611,15,0,0,2048,15,6286008285
2349,191530380,244898,191775278,31,0,0,27136,31,6414548197
2350,191533413,328869,191862282,4,0,0,23040,4,1039739749
2351,191536083,365324,191901407,26,0,0,77824,26,8471169017
2352,191550051,91368,191641419,14,0,1,13824,14,814792109
2353,191559555,81879,191641434,0,0,1,1536,0,8709510130
2354,191575093,436365,192011458,22,0,0,16384,22,2503807595
2355,191584632,384847,191969479,13,0,0,46080,13,3526368011
2356,191587225,315445,191902670,11,0,0,4096,11,7535422215
2357,191595923,340535,191936458,12,0,0,66560,12,6694768794
2358,191617912,195436,191813348,39,0,0,14848,39,2713322481
2359,191623333,27826,191651159,27,0,1,3072,27,3150479438
2360,191638051,390460,192028511,31,0,0,24576,31,3228845773
2361,191655935,446671,192102606,30,0,0,11264,30,9122748799
2362,191666997,333259,192000256,8,0,0,1024,8,4474530070
2363,191676808,5454,191682262,16,0,1,13824,16,8153794250
2364,191678487,367209,192045696,12,0,0,2048,12,5165408130
2365,191702038,37588,191739626,35,0,1,27136,35,5759683843
2366,191708578,194107,191902685,12,0,1,272896,12,7660374187
2367,191764754,137946,191902700,18,0,1,11264,18,9531672374
2368,191768413,342220,192110633,28,0,0,5632,28,9090563553
2369,191770512,394329,192164841,1,0,0,25088,1,8040668736
2370,191783252,422012,192205264,0,0,0,110080,0,1307388593
2371,191790016,112707,191902723,2,0,1,13312,2,5180851057
2372,191800032,475792,192275824,36,0,0,24576,36,3693346514
2373,191813949,321347,192135296,5,0,0,4608,5,8423648355
2374,191819785,119028,191938813,12,0,0,7680,12,8098865824
2375,191822382,311495,192133877,7,0,0,16384,7,10121000430
2376,191853767,48971,191902738,11,0,1,14336,11,3549505202
2377,191892853,317902,192210755,7,0,0,17920,7,3009891984
2378,191901950,3253,191905203,28,0,1,2560,28,2803840441
2379,191903843,347303,192251146,39,0,0,27648,39,5265719578
2380,191913905,405942,192319847,6,0,0,24064,6,3318357720
2381,191943130,475638,192418768,35,0,0,17920,35,7375620983
2382,191943719,2470,191946189,9,0,1,2560,9,2236044969
2383,191945877,454921,192400798,17,0,0,86528,17,4764012864
2384,191955408,416968,192372376,7,0,0,61440,7,6408221183
2385,191987863,321806,192309669,13,0,0,21504,13,9195613601
2386,191989478,278843,192268321,20,0,0,56320,20,6845854553
2387,191992462,339571,192332033,14,0,0,4096,14,6259552244
2388,192032898,1518,192034416,27,0,1,1536,27,6851900289
2389,192049612,248691,192298303,36,0,0,9728,36,5853695487
2390,192062926,386073,192448999,29,0,0,26624,29,7146010475
2391,192065071,247429,192312500,8,0,0,9216,8,4611329607
2392,192084823,328470,192413293,19,0,0,40960,19,2161199338
2393,192110349,240480,192350829,10,0,0,20480,10,335622803
2394,192118562,255857,192374419,19,0,0,6656,19,10285834869
2395,192154719,181609,192336328,11,0,0,8704,11,5889525447
2396,192177904,36708,192214612,28,0,1,4096,28,2552761833
2397,192186795,379354,192566149,25,0,0,16384,25,7245869631
2398,192224240,417125,192641365,5,0,0,71680,5,3134284364
2399,192234248,265511,192499759,5,0,0,16384,5,6137781290
2400,192267749,21320,192289069,23,0,1,25600,23,10578401054
2401,192303738,156894,192460632,2,0,0,3072,2,9833134127
2402,192308346,354828,192663174,35,0,0,34304,35,5441845483
2403,192321945,1994,192323939,19,0,1,2048,19,2130465009
2404,192333805,151117,192484922,30,0,0,7680,30,1432924330
2405,192336522,4679,192341201,18,0,1,12288,18,6335446688
2406,192341774,304286,192646060,19,0,0,15360,19,10363365523
2407,192392046,108664,192500710,0,0,0,3072,0,8572342544
2408,192394865,28837,192423702,19,0,1,5120,19,1147106837
2409,192397888,311307,192709195,25,0,0,51200,25,5405750073
2410,192398269,34192,192432461,11,0,1,19968,11,2255260246
2411,192416985,258372,192675357,2,0,0,39936,2,1298260210
2412,192421103,121030,192542133,30,0,0,3072,30,62878305
2413,192427797,288597,192716394,5,0,0,23552,5,8061338572
2414,192431256,129721,192560977,8,0,0,8704,8,9410813642
2415,192437376,295577,192732953,21,0,0,28672,21,8631261599
2416,192440347,100835,192541182,29,0,0,9216,29,9950258470
2417,192445854,147919,192593773,4,0,0,11264,4,8287763513
2418,192448169,428174,192876343,23,0,0,43008,23,10259634995
2419,192458208,258365,192716573,17,0,0,512,17,7854544177
2420,192508936,2870,192511806,29,0,1,8704,29,5521981097
2421,192518895,263038,192781933,31,0,0,61952,31,10603368209
2422,192521014,297448,192818462,19,0,0,16384,19,7686127514
2423,192524587,288868,192813455,27,0,0,24576,27,22795701
2424,192530401,204276,192734677,14,0,0,5120,14,10557133017
2425,192542708,5454,192548162,27,0,1,13824,27,3655953415
2426,192551859,245974,192797833,15,0,0,13312,15,6585036617
2427,192563055,189774,192752829,17,0,0,1536,17,9076066326
2428,192563502,325062,192888564,25,0,0,27136,25,7155196786
2429,192576845,262176,192839021,2,0,0,3584,2,6238273041
2430,192583512,4162,192587674,1,0,1,11264,1,6348734073
2431,192584885,3135,192588020,9,0,1,512,9,4523735906
2432,192615082,265199,192880281,4,0,0,10752,4,1527455538
2433,192619047,64402,192683449,32,0,0,5120,32,4027501253
2434,192639524,165032,192804556,17,0,0,22016,17,4983772269
2435,192678896,4568,192683464,37,0,1,4608,37,840995183
2436,192697434,23081,192720515,11,0,1,11264,11,4869065216
2437,192718787,4442,192723229,25,0,1,9728,25,6218766213
2438,192724630,20623,192745253,12,0,1,20480,12,5203153916
2439,192765738,129025,192894763,18,0,0,4096,18,300423013
2440,192772673,11313,192783986,14,0,1,2048,14,208695450
2441,192779145,97845,192876990,10,0,0,2048,10,6856457144
2442,192780200,111655,192891855,3,0,0,10752,3,7816949940
2443,192787671,5326,192792997,20,0,1,5632,20,5663759557
2444,192814768,10933,192825701,19,0,1,7680,19,5790315885
2445,192817011,167418,192984429,15,0,0,9216,15,8332188659
2446,192821435,98999,192920434,32,0,0,512,32,555999855
2447,192822414,265928,193088342,35,0,0,54784,35,8640907125
2448,192829963,282698,193112661,12,0,0,36864,12,1201935777
2449,192866579,434297,193300876,8,0,0,49664,8,9662208975
2450,192894775,2470,192897245,18,0,1,2560,18,8916793626
2451,192906785,112186,193018971,8,0,0,12800,8,6341345681
2452,192911386,223614,193135000,24,0,0,1536,24,1981989849
2453,192917952,182385,193100337,23,0,0,14336,23,10366052875
2454,192941881,113804,193055685,14,0,0,6144,14,7734104735
2455,192954097,313568,193267665,16,0,0,11776,16,9531818233
2456,192967139,1994,192969133,14,0,1,2048,14,9070317241
2457,192981014,270061,193251075,28,0,0,18944,28,5514365825
2458,192985610,138355,193123965,39,0,0,23552,39,7012984243
2459,193010099,209800,193219899,25,0,0,100352,25,4839107725
2460,193021302,221027,193242329,12,0,0,8704,12,558748005
2461,193026602,124209,193150811,4,0,0,22016,4,418887243
2462,193033531,337100,193370631,12,0,0,15872,12,1236140296
2463,193071605,322804,193394409,22,0,0,2048,22,5853248284
2464,193075231,146579,193221810,37,0,0,6144,37,10365605895
2465,193075256,94389,193169645,1,0,0,2048,1,453378379
2466,193103486,129883,193233369,33,0,0,37888,33,6381150542
2467,193113281,315401,193428682,36,0,0,4096,36,8594629037
2468,193116226,123414,193239640,20,0,0,20480,20,10008689417
2469,193118464,225917,193344381,33,0,0,26624,33,1132058020
2470,193122159,300877,193423036,18,0,0,45056,18,1052631696
2471,193131292,5196,193136488,29,0,1,13312,29,10318302063
2472,193143770,178562,193322332,1,0,0,39424,1,8284917196
2473,193169569,133841,193303410,0,0,0,8192,0,877074595
2474,193193719,333848,193527567,9,0,0,24576,9,2760754835
2475,193195488,139976,193335464,2,0,0,1536,2,8642494394
2476,193210667,40423,193251090,31,0,1,19968,31,2364422749
2477,193216107,244747,193460854,38,0,0,4096,38,1996115366
2478,193225999,108974,193334973,18,0,0,22016,18,7606878507
2479,193230076,21037,193251113,35,0,1,2560,35,2891854615
2480,193246340,219688,193466028,0,0,0,5120,0,487626133
2481,193251377,176042,193427419,7,0,0,14336,7,2736840741
2482,193265501,2722,193268223,27,0,1,512,27,7588735668
2483,193271225,175216,193446441,39,0,0,26624,39,10248237822
2484,193284554,16337,193300891,11,0,1,2048,11,10375415776
2485,193290455,169136,193459591,33,0,0,28160,33,1671697465
2486,193300936,150044,193450980,2,0,0,14848,2,3897655499
2487,193305561,158892,193464453,2,0,0,6144,2,661960479
2488,193330644,13752,193344396,11,0,1,5120,11,2729092025
2489,193440885,113463,193554348,2,0,0,39424,2,4855661363
2490,193443628,167724,193611352,25,0,0,1024,25,745979011
2491,193485900,241434,193727334,4,0,0,24064,4,1746777360
2492,193488378,190061,193678439,28,0,0,10240,28,344660545
2493,193496294,177271,193673565,23,0,0,117248,23,4462265444
2494,193533881,141415,193675296,34,0,0,5632,34,1786271606
2495,193543888,143021,193686909,17,0,0,14848,17,780310465
2496,193545210,324568,193869778,8,0,0,6656,8,10727722966
2497,193546551,12776,193559327,31,0,1,12800,31,9804012275
2498,193564263,166362,193730625,29,0,0,10752,29,2072567837
2499,193565798,3904,193569702,28,0,1,10752,28,5072203898
2500,193568306,225401,193793707,35,0,0,71680,35,1823714263
2501,193575924,2470,193578394,11,0,1,2560,11,9142609668
2502,193592853,239816,193832669,15,0,0,78336,15,3457693518
2503,193609660,230683,193840343,31,0,0,25088,31,10653267785
2504,193632189,269112,193901301,3,0,0,13824,3,9119910643
2505,193650204,121648,193771852,5,0,0,16384,5,9457481054
2506,193667840,13736,193681576,27,0,1,9216,27,7389108174
2507,193668777,18147,193686924,34,0,1,2048,34,4069227866
2508,193683292,7063,193690355,31,0,1,3584,31,2989388343
2509,193685574,7388,193692962,14,0,1,12800,14,221077762
2510,193693054,105036,193798090,11,0,0,14336,11,8798973182
2511,193731500,262903,193994403,3,0,0,123904,3,2783185425
2512,193744197,131229,193875426,11,0,0,13824,11,4618218776
2513,193796866,157019,193953885,31,0,0,25088,31,7926225110
2514,193808281,24403,193832684,27,0,1,2048,27,3098770701
2515,193826940,174380,194001320,15,0,0,7168,15,9693380153
2516,193830458,165996,193996454,30,0,0,6656,30,3705553144
2517,193840402,158719,193999121,18,0,0,8704,18,5475879459
2518,193895831,150616,194046447,23,0,0,5120,23,7117728138
2519,193901051,220285,194121336,31,0,0,23040,31,9610687517
2520,193907855,118090,194025945,29,0,0,29696,29,222143803
2521,193921794,13512,193935306,8,0,1,26112,8,9559103770
2522,193954805,147928,194102733,38,0,0,12288,38,232397438
2523,193970357,95014,194065371,20,0,0,8704,20,5410707688
2524,194011685,193185,194204870,18,0,0,29184,18,5415354841
2525,194014923,88925,194103848,15,0,0,3584,15,474654110
2526,194020846,175109,194195955,24,0,0,55808,24,3346611900
2527,194023111,119294,194142405,7,0,0,18432,7,5743638715
2528,194025231,208153,194233384,0,0,0,11776,0,60784067
2529,194069115,109821,194178936,39,0,0,26112,39,6411087166
2530,194075218,1042,194076260,18,0,1,1024,18,171625544
2531,194075250,131671,194206921,26,0,0,6656,26,4576897282
2532,194081682,247164,194328846,19,0,0,35840,19,2715055229
2533,194101629,140154,194241783,37,0,0,10752,37,3673903081
2534,194104575,321766,194426341,36,0,0,8192,36,9814221697
2535,194110845,357421,194468266,9,0,0,89600,9,2791932081
2536,194133752,125333,194259085,32,0,0,3072,32,757209866
2537,194139244,112808,194252052,13,0,0,11776,13,4706457989
2538,194181669,178541,194360210,31,0,0,16384,31,2258135415
2539,194199644,320122,194519766,37,0,0,19968,37,6543597186
2540,194206315,367617,194573932,15,0,0,47104,15,4182868386
2541,194212999,101504,194314503,30,0,0,33280,30,9126040607
2542,194251919,103276,194355195,38,0,0,7680,38,5069300222
2543,194257003,173132,194430135,31,0,0,12288,31,8432680997
2544,194258081,165749,194423830,11,0,0,14336,11,7031052431
2545,194272849,136845,194409694,31,0,0,17408,31,3761507745
2546,194285053,76106,194361159,26,0,0,2048,26,1664341763
2547,194307338,123288,194430626,26,0,0,1536,26,6382604237
2548,194310130,211835,194521965,24,0,0,7168,24,4467743658
2549,194349293,152327,194501620,37,0,0,21504,37,488630412
2550,194353012,122609,194475621,8,0,0,24064,8,9898762459
2551,194374547,114304,194488851,3,0,0,6144,3,704734664
2552,194377633,259269,194636902,12,0,0,5632,12,7552997543
2553,194381913,1042,194382955,0,0,1,1024,0,2806101530
2554,194416544,197984,194614528,14,0,0,32256,14,5181858820
2555,194418851,7505,194426356,28,0,1,6144,28,2832608270
2556,194427103,9284,194436387,32,0,1,6144,32,6660882854
2557,194434297,114040,194548337,1,0,0,40960,1,10459337455
2558,194442076,134239,194576315,7,0,0,5632,7,4508156355
2559,194471817,228410,194700227,7,0,0,7680,7,5243071906
2560,194478866,431736,194910602,38,0,0,32768,38,4961710979
2561,194482909,2470,194485379,35,0,1,2560,35,1941132332
2562,194494077,134665,194628742,38,0,0,34304,38,9015963762
2563,194511068,283809,194794877,25,0,0,34816,25,7085879666
2564,194512787,229818,194742605,5,0,0,24576,5,6364820579
2565,194529314,182590,194711904,17,0,0,27136,17,1403165717
2566,194542639,357964,194900603,32,0,0,37888,32,6313549137
2567,194571136,283870,194855006,9,0,0,32256,9,1043611733
2568,194574157,271006,194845163,38,0,0,7168,38,10112001665
2569,194585818,112039,194697857,14,0,0,40448,14,5136721619
2570,194589842,566,194590408,35,0,1,512,35,9794142142
2571,194590525,170007,194760532,30,0,0,27136,30,9022292648
2572,194596236,2870,194599106,17,0,1,8704,17,960055715
2573,194617479,448141,195065620,10,0,0,5632,10,5423379894
2574,194624903,152730,194777633,1,0,0,11264,1,6652321276
2575,194637908,351014,194988922,14,0,0,2048,14,7213571762
2576,194651758,266511,194918269,34,0,0,25088,34,2049819870
2577,194652643,110186,194762829,10,0,0,2560,10,9746781742
2578,194659293,155702,194814995,27,0,0,24576,27,9313424704
2579,194676985,197344,194874329,11,0,0,13824,11,9133539597
2580,194679173,240695,194919868,12,0,0,5120,12,5644624917
2581,194682203,160325,194842528,16,0,0,6656,16,2267056557
2582,194682709,15163,194697872,35,0,1,5120,35,5394116225
2583,194700744,61059,194761803,25,0,0,4096,25,4648219620
2584,194701973,123714,194825687,37,0,0,13824,37,6689754002
2585,194707160,263269,194970429,18,0,0,12288,18,8192927045
2586,194716870,4374,194721244,1,0,1,4608,1,6851426846
2587,194728904,99606,194828510,30,0,0,9216,30,7841751305
2588,194741528,307287,195048815,9,0,0,23552,9,9830086659
2589,194755163,220218,194975381,39,0,0,8192,39,7072287439
2590,194762194,195241,194957435,19,0,0,8192,19,9406341899
2591,194764301,566,194764867,25,0,1,512,25,858225799
2592,194770224,95423,194865647,24,0,0,2048,24,72912933
2593,194776340,168501,194944841,7,0,0,13824,7,4234990151
2594,194783238,357640,195140878,25,0,0,29696,25,3751543938
2595,194798583,279740,195078323,24,0,0,24064,24,13731202
2596,194806634,433905,195240539,7,0,0,38912,7,2320904300
2597,194849772,116890,194966662,28,0,0,30208,28,853689507
2598,194858122,338366,195196488,14,0,0,76288,14,5812113863
2599,194862355,186943,195049298,19,0,0,1536,19,169874120
2600,194870946,425704,195296650,34,0,0,19456,34,5590989748
2601,194877757,246148,195123905,22,0,0,41472,22,9174363958
2602,194893204,27665,194920869,15,0,1,1024,15,9795997471
2603,194897006,24529,194921535,8,0,1,1024,8,2782548818
2604,194902372,351145,195253517,21,0,0,33280,21,6144102263
2605,194902914,304688,195207602,34,0,0,11776,34,10473232572
2606,194915827,6694,194922521,32,0,1,1536,32,3466155342
2607,194920638,237570,195158208,10,0,0,512,10,4219600080
2608,194937845,386527,195324372,33,0,0,14848,33,3850039546
2609,194947608,134170,195081778,12,0,0,11264,12,5296681736
2610,194955341,15111,194970452,20,0,1,2048,20,7432140284
2611,194965433,536285,195501718,28,0,0,39936,28,7876970608
2612,194987711,5971,194993682,32,0,1,14848,32,128696516
2613,195005644,212966,195218610,37,0,0,1024,37,8096950996
2614,195015346,3422,195018768,18,0,1,3584,18,1067102143
2615,195020704,222658,195243362,12,0,0,9216,12,3049406954
2616,195038064,246029,195284093,30,0,0,35840,30,10015192484
2617,195052525,151474,195203999,17,0,0,24576,17,2558520850
2618,195066084,506536,195572620,13,0,0,19456,13,4516807571
2619,195074512,133581,195208093,4,0,0,1536,4,506350567
2620,195085624,290175,195375799,14,0,0,7168,14,8243251212
2621,195085893,142767,195228660,32,0,0,25600,32,5156700126
2622,195094220,6278,195100498,20,0,1,6656,20,6593093165
2623,195100550,70582,195171132,28,0,0,8192,28,5107529836
2624,195102956,338378,195441334,12,0,0,3072,12,3879133361
2625,195124700,203181,195327881,14,0,0,10752,14,10315115537
2626,195144910,109090,195254000,24,0,0,1536,24,7334417412
2627,195146108,241414,195387522,1,0,0,38400,1,10041169460
2628,195167210,206390,195373600,7,0,0,44032,7,6819624859
2629,195180020,109587,195289607,0,0,0,12288,0,8104076438
2630,195201179,134484,195335663,17,0,0,7168,17,2661317498
2631,195204142,80449,195284591,22,0,0,1536,22,218379358
2632,195226822,299490,195526312,32,0,0,3584,32,5517056435
2633,195272174,11934,195284108,1,0,1,10752,1,8567089996
2634,195282598,241386,195523984,27,0,0,31232,27,4462883003
2635,195301767,137995,195439762,24,0,0,28160,24,3950341017
2636,195312122,1994,195314116,28,0,1,2048,28,6078271473
2637,195362565,88621,195451186,13,0,0,7168,13,225696976
2638,195383600,103646,195487246,10,0,0,512,10,4720220640
2639,195385584,63403,195448987,11,0,0,7680,11,998456629
2640,195410758,146064,195556822,5,0,0,44032,5,10278440484
2641,195429124,128025,195557149,30,0,0,1024,30,10679863284
2642,195434806,146097,195580903,33,0,0,27136,33,9759413296
2643,195442690,81621,195524311,25,0,0,1024,25,6803153343
2644,195445528,193725,195639253,37,0,0,8704,37,5657021322
2645,195447401,153992,195601393,3,0,0,25600,3,9717503980
2646,195477853,192840,195670693,29,0,0,31232,29,9867942679
2647,195478054,343907,195821961,24,0,0,12288,24,4656043823
2648,195521308,162801,195684109,34,0,0,9728,34,9478734901
2649,195522854,87644,195610498,27,0,0,11264,27,4988664406
2650,195525434,55820,195581254,34,0,0,1024,34,1558122237
2651,195527436,338869,195866305,25,0,0,512,25,5121146717
2652,195539584,1994,195541578,21,0,1,2048,21,3098201601
2653,195571009,72643,195643652,8,0,0,4096,8,7690936517
2654,195571351,246835,195818186,19,0,0,39936,19,3812119821
2655,195576410,8701,195585111,0,0,1,4096,0,212527030
2656,195587904,218099,195806003,4,0,0,37376,4,7865703404
2657,195619847,342699,195962546,28,0,0,25600,28,886232079
2658,195642365,188519,195830884,1,0,0,29184,1,7168518324
2659,195645359,95012,195740371,1,0,0,11776,1,4078652743
2660,195678535,241341,195919876,29,0,0,15872,29,9311494404
2661,195688260,106340,195794600,18,0,0,49152,18,548130156
2662,195724162,178521,195902683,33,0,0,53248,33,1856599800
2663,195727123,281545,196008668,16,0,0,19456,16,10235529220
2664,195742684,292569,196035253,38,0,0,48640,38,6433452024
2665,195777937,303140,196081077,29,0,0,29184,29,1891485680
2666,195784018,119928,195903946,1,0,0,4096,1,2377724798
2667,195785028,45871,195830899,29,0,1,4608,29,4290860123
2668,195802928,64621,195867549,25,0,0,1024,25,1989352629
2669,195828076,171202,195999278,35,0,0,30208,35,3932986246
2670,195829082,5738,195834820,21,0,1,10752,21,5810466718
2671,195833960,233850,196067810,7,0,0,18432,7,280083579
2672,195839244,75781,195915025,24,0,0,9728,24,9017607140
2673,195866366,1994,195868360,12,0,1,2048,12,8479622176
2674,195868925,225914,196094839,1,0,0,6144,1,6573743148
2675,195879192,157488,196036680,0,0,0,4608,0,4619243176
2676,195892555,70170,195962725,13,0,0,512,13,7175829078
2677,195906670,2946,195909616,38,0,1,3072,38,8914880017
2678,195908331,94394,196002725,16,0,0,11264,16,9863193971
2679,195934932,211599,196146531,39,0,0,26112,39,10301036542
2680,195952329,226768,196179097,34,0,0,49664,34,5346271016
2681,195955325,12685,195968010,20,0,1,5632,20,6739411944
2682,195968978,3645,195972623,19,0,1,10240,19,4270681320
2683,195986592,566,195987158,29,0,1,512,29,10482555205
2684,196000826,162432,196163258,8,0,0,16896,8,3891425653
2685,196015582,253595,196269177,26,0,0,34304,26,828004840
2686,196023326,229601,196252927,10,0,0,64000,10,266136780
2687,196065310,15782,196081092,9,0,1,7680,9,8168601900
2688,196066281,260416,196326697,8,0,0,31232,8,10380374961
2689,196093897,240176,196334073,25,0,0,3072,25,4762800408
2690,196099879,4374,196104253,27,0,1,4608,27,2133836325
2691,196100130,154395,196254525,37,0,0,5120,37,7412854174
2692,196112247,142605,196254852,9,0,0,1024,9,3152133335
2693,196127985,308713,196436698,37,0,0,32256,37,8027813087
2694,196148027,278828,196426855,29,0,0,26112,29,7820638934
2695,196157369,125367,196282736,32,0,0,7168,32,170640703
2696,196174352,154957,196329309,22,0,0,2560,22,3623561347
2697,196176251,178345,196354596,17,0,0,5120,17,5029825847
2698,196191741,66761,196258502,9,0,0,4608,9,1633556851
2699,196202692,566,196203258,28,0,1,512,28,203109947
2700,196221274,2470,196223744,31,0,1,2560,31,1489513641
2701,196222292,149951,196372243,31,0,0,8192,31,7115986382
2702,196227222,309432,196536654,16,0,0,17408,16,3710507622
2703,196233090,19860,196252950,0,0,1,12800,0,1520643473
2704,196235473,138501,196373974,39,0,0,5632,39,1263013893
2705,196249937,102511,196352448,17,0,0,20480,17,3238265689
2706,196262032,183276,196445308,22,0,0,28160,22,6663188023
2707,196280154,366060,196646214,36,0,0,11776,36,1768493464
2708,196290007,205314,196495321,21,0,0,43008,21,66331294
2709,196295196,94244,196389440,26,0,0,24576,26,201622723
2710,196301134,3645,196304779,14,0,1,10240,14,5755574046
2711,196305300,157014,196462314,31,0,0,22016,31,9269770860
2712,196319302,312863,196632165,27,0,0,25088,27,10657337450
2713,196329382,408744,196738126,2,0,0,30720,2,7122178457
2714,196336732,180662,196517394,17,0,0,41472,17,136635458
2715,196353572,192884,196546456,7,0,0,25088,7,2178847159
2716,196357574,266924,196624498,35,0,0,53248,35,9840026750
2717,196394859,21658,196416517,14,0,1,35328,14,4664889482
2718,196399647,259899,196659546,21,0,0,5120,21,10572219273
2719,196403761,270818,196674579,18,0,0,26112,18,2530560055
2720,196407797,28916,196436713,23,0,1,8192,23,3563685109
2721,196424672,433004,196857676,31,0,0,33792,31,2741060530
2722,196432969,162200,196595169,19,0,0,33792,19,8443547395
2723,196462159,311091,196773250,15,0,0,19968,15,5124369686
2724,196462337,542471,197004808,27,0,0,15360,27,5806907606
2725,196464592,7706,196472298,21,0,1,8192,21,7703412325
2726,196503977,102232,196606209,12,0,0,29696,12,5488772671
2727,196520703,306448,196827151,11,0,0,20480,11,1595295198
2728,196524218,162076,196686294,32,0,0,38400,32,8432202949
2729,196529438,503931,197033369,21,0,0,67584,21,9951564791
2730,196530909,388321,196919230,25,0,0,17920,25,5425417408
2731,196531360,191219,196722579,8,0,0,42496,8,6712059654
2732,196557837,219952,196777789,17,0,0,2048,17,4208494428
2733,196564081,217401,196781482,27,0,0,6656,27,7998645271
2734,196564861,14029,196578890,9,0,1,27136,9,88551637
2735,196567777,341794,196909571,14,0,0,10240,14,7195460374
2736,196576870,4420,196581290,29,0,1,11776,29,6984179217
2737,196590887,677762,197268649,27,0,0,32256,27,9671303075
2738,196595890,225006,196820896,25,0,0,18944,25,923122486
2739,196600524,261067,196861591,11,0,0,12800,11,10385207590
2740,196612135,523767,197135902,18,0,0,56320,18,5631281304
2741,196655789,324186,196979975,9,0,0,120320,9,5550861094
2742,196676772,14193,196690965,8,0,1,12288,8,8294566875
2743,196692037,3128,196695165,29,0,1,9216,29,1156907936
2744,196702434,2470,196704904,31,0,1,2560,31,6321006336
2745,196704770,17824,196722594,35,0,1,22528,35,6524997069
2746,196723268,105770,196829038,0,0,0,6144,0,10000479757
2747,196735786,621420,197357206,7,0,0,34304,7,7667064922
2748,196744177,4374,196748551,19,0,1,4608,19,8707045142
2749,196748732,300804,197049536,9,0,0,4608,9,707369715
2750,196751567,146974,196898541,20,0,0,6656,20,10351385948
2751,196766461,567861,197334322,20,0,0,34816,20,8904193156
2752,196768513,328714,197097227,16,0,0,18944,16,2760996880
2753,196771659,6145,196777804,6,0,1,4608,6,5457844566
2754,196795191,190225,196985416,1,0,0,7168,1,4019879051
2755,196803047,245070,197048117,18,0,0,35328,18,1474304235
2756,196804598,379132,197183730,24,0,0,8192,24,2600782836
2757,196810688,812444,197623132,17,0,0,20480,17,3037748702
2758,196812978,627292,197440270,22,0,0,1536,22,7386030207
2759,196821603,359608,197181211,27,0,0,64000,27,5168657293
2760,196847617,257269,197104886,15,0,0,25088,15,2095349877
2761,196884777,476120,197360897,1,0,0,1536,1,2849051818
2762,196889545,2946,196892491,27,0,1,3072,27,3333331206
2763,196893438,567870,197461308,20,0,0,60928,20,2335800263
2764,196918369,222466,197140835,37,0,0,15872,37,8866514215
2765,196923395,289110,197212505,3,0,0,28160,3,10667057410
2766,196967634,472153,197439787,36,0,0,47104,36,2023664499
2767,196982224,275622,197257846,39,0,0,5632,39,8003154633
2768,196986040,124976,197111016,31,0,0,16384,31,4729005622
2769,196992959,788852,197781811,32,0,0,144384,32,7724576445
2770,197011199,304067,197315266,32,0,0,32768,32,9315768220
2771,197018125,201507,197219632,22,0,0,5120,22,4875119696
2772,197030932,75077,197106009,31,0,0,3584,31,10464305284
2773,197042243,17801,197060044,19,0,1,16896,19,6116056458
2774,197045094,15616,197060710,1,0,1,1024,1,7842686903
2775,197053713,227083,197280796,8,0,0,26624,8,776814446
2776,197066209,359211,197425420,15,0,0,30208,15,1451647088
2777,197069713,2470,197072183,18,0,1,2560,18,6085749746
2778,197100252,192026,197292278,37,0,0,34304,37,9869326787
2779,197101758,15446,197117204,27,0,1,15360,27,9036332502
2780,197110008,7542,197117550,18,0,1,512,18,6753080689
2781,197147600,356951,197504551,39,0,0,3584,39,1464135119
2782,197153157,32299,197185456,21,0,1,52736,21,1417874896
2783,197169988,433410,197603398,30,0,0,144384,30,9864550787
2784,197186711,172249,197358960,26,0,0,2048,26,1520038444
2785,197190397,512481,197702878,18,0,0,85504,18,6409221516
2786,197190700,332646,197523346,14,0,0,7680,14,3356280219
2787,197205705,152616,197358321,19,0,0,3584,19,2686410301
2788,197233418,259018,197492436,4,0,0,16896,4,4780798234
2789,197241107,597509,197838616,22,0,0,29184,22,1033666604
2790,197249204,121016,197370220,10,0,0,3072,10,6212208216
2791,197251991,400677,197652668,27,0,0,40448,27,3378444556
2792,197260384,356493,197616877,37,0,0,44032,37,1444078261
2793,197270763,526686,197797449,17,0,0,43008,17,1470510363
2794,197273024,103359,197376383,0,0,0,3072,0,1943656821
2795,197281357,222087,197503444,10,0,0,29184,10,3247142998
2796,197296046,533655,197829701,38,0,0,34816,38,3888288205
2797,197322410,11927,197334337,37,0,1,8704,37,4375677511
2798,197343835,294048,197637883,5,0,0,5632,5,10615023595
2799,197345447,368834,197714281,19,0,0,37376,19,705726213
2800,197349976,377908,197727884,3,0,0,44544,3,3176762145
2801,197369123,365187,197734310,22,0,0,9216,22,9402857931
2802,197394178,337309,197731487,21,0,0,11776,21,1223677162
2803,197424169,360153,197784322,29,0,0,8192,29,2267049691
2804,197438491,295990,197734481,25,0,0,512,25,3378135008
2805,197442709,227067,197669776,35,0,0,43520,35,2753570663
2806,197468306,157805,197626111,24,0,0,9728,24,2131100736
2807,197526969,292109,197819078,17,0,0,8192,17,2720608976
2808,197531152,269128,197800280,15,0,0,9216,15,1856475901
2809,197536945,313425,197850370,21,0,0,38400,21,1429241963
2810,197544835,325035,197869870,33,0,0,11264,33,3209674686
2811,197545150,3898,197549048,17,0,1,4096,17,10245737364
2812,197548170,362389,197910559,28,0,0,25600,28,9521550921
2813,197549900,126821,197676721,33,0,0,11776,33,5465217694
2814,197567251,389925,197957176,20,0,0,24576,20,1226577610
2815,197577559,275517,197853076,4,0,0,8192,4,1694652882
2816,197579242,590457,198169699,37,0,0,11264,37,9456566246
2817,197584135,153669,197737804,0,0,0,10752,0,6762387532
2818,197586216,230343,197816559,37,0,0,53248,37,3256242518
2819,197592526,329124,197921650,14,0,0,36352,14,7041501414
2820,197684425,322234,198006659,28,0,0,3072,28,10637768405
2821,197685022,406477,198091499,5,0,0,14336,5,3537179832
2822,197694532,144099,197838631,34,0,1,20992,34,7892266147
2823,197716060,134505,197850565,31,0,0,512,31,10060068401
2824,197716131,450121,198166252,32,0,0,25088,32,1628027300
2825,197716277,542877,198259154,32,0,0,14336,32,10621185184
2826,197735650,198195,197933845,21,0,0,5120,21,4917433720
2827,197739683,209990,197949673,2,0,0,6656,2,1725894749
2828,197739796,399407,198139203,24,0,0,106496,24,10593914703
2829,197742745,253335,197996080,0,0,0,59392,0,9978511564
2830,197747935,288446,198036381,31,0,0,2048,31,9828443116
2831,197758811,285127,198043938,1,0,0,7680,1,508026015
2832,197759899,164418,197924317,31,0,0,8704,31,8886356498
2833,197791201,83268,197874469,39,0,1,62976,39,9337649354
2834,197801466,73464,197874930,25,0,1,10240,25,6716553029
2835,197808645,66951,197875596,19,0,1,1024,19,9022646639
2836,197830030,225945,198055975,0,0,0,1536,0,2383161969
2837,197846415,312170,198158585,29,0,0,58368,29,9259106345
2838,197857588,196119,198053707,0,0,0,9216,0,10481663059
2839,197857755,19326,197877081,29,0,1,15360,29,3757689457
2840,197878780,342485,198221265,8,0,0,41984,8,9245859817
2841,197924509,261076,198185585,10,0,0,24576,10,3505121191
2842,197926677,214101,198140778,9,0,0,5120,9,9113901714
2843,197949282,10356,197959638,9,0,1,2560,9,4286057480
2844,198006552,665,198007217,37,0,1,512,37,7113934821
2845,198017078,170394,198187472,34,0,0,6144,34,2177415243
2846,198030050,381613,198411663,21,0,0,38400,21,5214692885
2847,198047312,336820,198384132,25,0,0,76288,25,7797975735
2848,198067196,327562,198394758,36,0,0,29184,36,2759104728
2849,198071574,235140,198306714,18,0,0,21504,18,2125830018
2850,198073765,263048,198336813,8,0,0,35840,8,7934073344
2851,198077603,566,198078169,20,0,1,512,20,3323626659
2852,198087288,116964,198204252,9,0,0,41472,9,3869211493
2853,198089696,136747,198226443,33,0,0,16896,33,1323058934
2854,198099222,3128,198102350,12,0,1,9216,12,4609811153
2855,198119628,241245,198360873,26,0,0,24064,26,582241507
2856,198133979,251872,198385851,20,0,0,4096,20,6484668668
2857,198166742,288244,198454986,9,0,0,14336,9,2393727469
2858,198189000,278637,198467637,37,0,0,41472,37,10440086418
2859,198197046,150648,198347694,2,0,0,14848,2,442750335
2860,198198840,22440,198221280,19,0,1,4608,19,4718239081
2861,198200041,341067,198541108,35,0,0,15360,35,1184124579
2862,198205354,270287,198475641,15,0,0,15360,15,6715738374
2863,198225892,278564,198504456,18,0,0,9216,18,8033893350
2864,198230106,188946,198419052,20,0,0,17408,20,7963392354
2865,198242193,274602,198516795,17,0,0,40448,17,6778778633
2866,198242478,227514,198469992,5,0,0,7680,5,8567141925
2867,198243675,675265,198918940,29,0,0,1536,29,8234157586
2868,198284914,5454,198290368,11,0,1,13824,11,1299003538
2869,198289950,698200,198988150,39,0,0,46080,39,10420587287
2870,198296016,431812,198727828,12,0,0,41472,12,10569564129
2871,198316764,244965,198561729,1,0,0,32768,1,8220928128
2872,198330232,270702,198600934,24,0,0,24064,24,114953933
2873,198340651,157082,198497733,18,0,0,21504,18,5984758446
2874,198376435,241371,198617806,31,0,0,18944,31,3312138451
2875,198406399,6298,198412697,21,0,1,1024,21,10597593142
2876,198441382,110348,198551730,5,0,0,27136,5,4607197008
2877,198442877,438615,198881492,30,0,0,74240,30,3693595589
2878,198454521,183169,198637690,12,0,0,8704,12,2493844503
2879,198464930,156635,198621565,18,0,0,12288,18,9287125247
2880,198465037,10619,198475656,25,0,1,1024,25,7450160084
2881,198467436,569104,199036540,12,0,0,7168,12,6275475727
2882,198480316,234510,198714826,25,0,0,57856,25,4846865487
2883,198482211,653837,199136048,11,0,0,36352,11,234931659
2884,198489660,133028,198622688,3,0,0,3584,3,7946856763
2885,198494577,3714,198498291,32,0,1,512,32,3324541201
2886,198522738,220422,198743160,26,0,0,29184,26,7557266415
2887,198538283,700757,199239040,35,0,0,69632,35,3362737921
2888,198544128,19629,198563757,29,0,1,2048,29,7821990643
2889,198550599,17114,198567713,29,0,1,5632,29,9415790588
2890,198559321,13538,198572859,2,0,1,8192,2,7854671273
2891,198563911,14337,198578248,34,0,1,17408,34,1702553190
2892,198579735,861445,199441180,35,0,0,55296,35,2756677386
2893,198586611,262387,198848998,13,0,0,30208,13,661679486
2894,198595949,262892,198858841,5,0,0,32256,5,7980390911
2895,198609330,452092,199061422,17,0,0,6656,17,288422905
2896,198610621,448431,199059052,3,0,0,45056,3,2682192936
2897,198610843,118560,198729403,16,0,0,5120,16,7875619532
2898,198613320,189808,198803128,0,0,0,16896,0,3547653466
2899,198619859,375794,198995653,26,0,0,24576,26,8037813812
2900,198630243,84926,198715169,13,0,0,1024,13,7993977786
2901,198639952,1518,198641470,36,0,1,1536,36,9633496203
2902,198640102,2034,198642136,12,0,1,1024,12,4414075034
2903,198651959,470791,199122750,21,0,0,109568,21,10335543561
2904,198666682,250818,198917500,11,0,0,22016,11,7525410551
2905,198683412,453922,199137334,19,0,0,2560,19,612412973
2906,198685928,317463,199003391,10,0,0,9216,10,43328418
2907,198696164,363215,199059379,33,0,0,1024,33,2993485931
2908,198698003,195155,198893158,34,0,0,13824,34,8776005495
2909,198701043,473013,199174056,39,0,0,4608,39,5655562814
2910,198712243,20272,198732515,25,0,1,9216,25,1533025285
2911,198714291,28884,198743175,20,0,1,10240,20,758479075
2912,198715908,191931,198907839,14,0,1,279040,14,9611749738
2913,198740008,411116,199151124,30,0,0,36864,30,7680864714
2914,198756333,404773,199161106,22,0,0,31744,22,6678945479
2915,198784957,354896,199139853,26,0,0,8192,26,5948474645
2916,198803153,279269,199082422,36,0,0,9728,36,2601593875
2917,198808026,513118,199321144,30,0,0,21504,30,2431043837
2918,198808610,108913,198917523,27,0,1,28672,27,9720384089
2919,198825981,93456,198919437,1,0,1,18432,1,1159881522
2920,198829121,359045,199188166,35,0,0,41984,35,8777019185
2921,198831494,293455,199124949,0,0,0,7168,0,6128366271
2922,198843565,414998,199258563,32,0,0,64000,32,1094812286
2923,198850705,285834,199136539,14,0,0,1536,14,5761794198
2924,198857727,304330,199162057,14,0,0,3072,14,2813940591
2925,198893710,644627,199538337,19,0,0,3072,19,8737005082
2926,198897796,367966,199265762,14,0,0,23552,14,2119487265
2927,198912689,11032,198923721,0,0,1,15360,0,9788525965
2928,198919740,360413,199280153,7,0,0,47104,7,3962645572
2929,198943104,352594,199295698,14,0,0,5632,14,1911060195
2930,198964767,423004,199387771,4,0,0,32768,4,8213907205
2931,198995172,217331,199212503,13,0,0,7680,13,8346327158
2932,199000052,705133,199705185,3,0,0,40448,3,6228559075
2933,199025612,352160,199377772,8,0,0,41984,8,9354631880
2934,199072735,214811,199287546,29,0,0,12288,29,388078805
2935,199079518,310920,199390438,31,0,0,8704,31,5242401960
2936,199104947,192794,199297741,22,0,0,6656,22,1647203464
2937,199106956,44191,199151147,14,0,1,3072,14,8479599372
2938,199116831,208354,199325185,20,0,0,8192,20,4926831438
2939,199132401,190006,199322407,0,0,0,4096,0,553408873
2940,199133836,28244,199162080,37,0,1,2560,37,6685758852
2941,199147557,136230,199283787,27,0,0,11776,27,3396498855
2942,199151747,493153,199644900,21,0,0,90624,21,6228210184
2943,199159094,5458,199164552,34,0,1,2560,34,6021864550
2944,199170658,17523,199188181,6,0,1,8192,6,10219557849
2945,199174190,231563,199405753,20,0,0,5632,20,384865594
2946,199180934,262757,199443691,20,0,0,8192,20,1561557887
2947,199200804,2946,199203750,25,0,1,3072,25,9802895135
2948,199204747,151545,199356292,12,0,0,33792,12,4243598994
2949,199232544,560322,199792866,14,0,0,59392,14,8867128772
2950,199240022,40162,199280184,8,0,1,1024,8,9727613411
2951,199248651,52602,199301253,19,0,1,34304,19,4496541595
2952,199256246,51011,199307257,25,0,1,20480,25,1743701548
2953,199280711,256426,199537137,16,0,0,9216,16,521049098
2954,199297052,395794,199692846,4,0,0,18944,4,2189657975
2955,199303734,383325,199687059,17,0,0,138240,17,7469811394
2956,199303759,271572,199575331,15,0,0,8192,15,5748554631
2957,199305519,2404,199307923,0,0,1,1024,0,9020387524
2958,199340310,15997,199356307,20,0,1,7168,20,1408116044
2959,199355377,374836,199730213,13,0,0,35840,13,7101592422
2960,199400175,183703,199583878,39,0,0,10752,39,7514357198
2961,199417162,302116,199719278,12,0,0,24064,12,4454018813
2962,199424288,161269,199585557,29,0,0,512,29,6462196959
2963,199446539,137666,199584205,7,0,0,1024,7,1715721400
2964,199511256,239734,199750990,19,0,0,5632,19,9280986247
2965,199530744,210256,199741000,31,0,0,35328,31,9026145708
2966,199538784,167508,199706292,5,0,0,3584,5,910063728
2967,199553049,367168,199920217,24,0,0,8192,24,8571690756
2968,199564875,15579,199580454,25,0,1,30208,25,4397692213
2969,199565912,317626,199883538,16,0,0,22016,16,977285339
2970,199579432,132499,199711931,25,0,0,18432,25,456639022
2971,199613024,142920,199755944,4,0,0,9216,4,1208419011
2972,199622703,307182,199929885,3,0,0,5632,3,5990264324
2973,199627235,187021,199814256,30,0,0,27648,30,9704033814
2974,199628275,289431,199917706,9,0,0,51712,9,7159395951
2975,199687098,328616,200015714,22,0,0,40960,22,1121622840
2976,199719642,180256,199899898,17,0,0,38400,17,9823223123
2977,199731309,12629,199743938,18,0,1,3072,18,10314724134
2978,199758798,78590,199837388,1,0,0,2048,1,3253801944
2979,199776972,19308,199796280,27,0,1,3584,27,7235285649
2980,199808777,365627,200174404,10,0,0,21504,10,6934163298
2981,199828038,1518,199829556,35,0,1,1536,35,8182465542
2982,199841333,11274,199852607,33,0,1,18432,33,10690647075
2983,199867810,84260,199952070,22,0,0,12800,22,2305909164
2984,199871731,11838,199883569,20,0,1,17408,20,4965943896
2985,199877263,101433,199978696,24,0,0,13824,24,9641293435
2986,199881074,122137,200003211,1,0,0,43520,1,3940504773
2987,199914420,171676,200086096,8,0,0,6144,8,2711497566
2988,199917926,13324,199931250,29,0,1,17920,29,6105797585
2989,199921485,196089,200117574,30,0,0,58880,30,2066582846
2990,199940305,111051,200051356,20,0,0,9216,20,3268863167
2991,199977635,118500,200096135,26,0,0,7680,26,2341489883
2992,199978145,3038,199981183,19,0,1,2560,19,1003971989
2993,199986896,156936,200143832,1,0,0,16896,1,8854334377
2994,199992772,518449,200511221,32,0,0,64000,32,6415168407
2995,200016445,209899,200226344,24,0,0,8192,24,2451484131
2996,200021389,47288,200068677,32,0,0,1536,32,6621157639
2997,200037934,386744,200424678,10,0,0,9728,10,2479714779
2998,200048358,3013,200051371,18,0,1,2560,18,2880077599
2999,200065226,220577,200285803,11,0,0,6144,11,2384752669
3000,200080408,109918,200190326,33,0,0,32256,33,7305973982
3001,200083412,79275,200162687,36,0,0,2048,36,5374915539
3002,200112859,84143,200197002,25,0,0,11264,25,1397894053
3003,200137196,350867,200488063,34,0,0,148480,34,2213742584
3004,200141563,217043,200358606,38,0,0,5120,38,9283518643
3005,200189802,7215,200197017,7,0,1,4096,7,2981782329
3006,200190240,55010,200245250,34,0,0,3584,34,821861767
3007,200204180,191207,200395387,31,0,0,5632,31,6826314029
3008,200204465,3422,200207887,27,0,1,3584,27,9168979138
3009,200207825,213874,200421699,0,0,0,35840,0,7069881103
3010,200209522,147509,200357031,39,0,0,9216,39,10060597430
3011,200219109,304438,200523547,33,0,0,35840,33,3395128042
3012,200237461,188324,200425785,26,0,0,3584,26,8516103753
3013,200246030,297253,200543283,19,0,0,3072,19,439481863
3014,200246726,6754,200253480,1,0,1,7168,1,6018173321
3015,200261478,149286,200410764,26,0,0,44032,26,6865688149
3016,200271717,5326,200277043,27,0,1,5632,27,245877205
3017,200290239,142047,200432286,29,0,0,7680,29,2281966744
3018,200295658,6754,200302412,27,0,1,7168,27,5473921520
3019,200312135,179563,200491698,5,0,0,11776,5,5378643325
3020,200338821,203511,200542332,15,0,0,23552,15,4278154596
3021,200378514,148990,200527504,5,0,0,2560,5,8073783740
3022,200388725,241034,200629759,10,0,0,4096,10,2703131196
3023,200408068,141322,200549390,24,0,0,19968,24,3901502275
3024,200409993,288561,200698554,36,0,0,51712,36,7419523436
3025,200418439,116702,200535141,3,0,0,12800,3,3434825714
3026,200424260,296937,200721197,37,0,0,74240,37,4210031259
3027,200451594,348354,200799948,15,0,0,15360,15,2371826552
3028,200461328,185450,200646778,22,0,0,55808,22,4584409438
3029,200463910,263589,200727499,1,0,0,17920,1,5537611055
3030,200465920,208633,200674553,30,0,0,54784,30,86334482
3031,200485805,37781,200523586,29,0,1,11776,29,3290732846
3032,200491827,291857,200783684,2,0,0,47104,2,10229987856
3033,200502111,25408,200527519,12,0,1,3584,12,2033158220
3034,200511603,164525,200676128,20,0,0,5120,20,1927710738
3035,200511707,210317,200722024,4,0,0,2560,4,9712763029
3036,200528225,216981,200745206,8,0,0,7168,8,1863033084
3037,200529003,149948,200678951,18,0,0,9216,18,3755142885
3038,200537541,359187,200896728,11,0,0,3072,11,5499595409
3039,200547847,13843,200561690,8,0,1,20480,8,3735036327
3040,200568063,81070,200649133,30,0,0,7680,30,10312909292
3041,200586406,4679,200591085,12,0,1,12288,12,643329759
3042,200590071,480338,201070409,17,0,0,1024,17,15323889
3043,200600146,357981,200958127,5,0,0,512,5,3386475929
3044,200601689,276735,200878424,34,0,0,58368,34,5590580975
3045,200624159,223638,200847797,28,0,0,54272,28,2754786896
3046,200675321,545364,201220685,25,0,0,63488,25,3196875637
3047,200678675,271596,200950271,13,0,0,18432,13,5783598038
3048,200692820,351398,201044218,4,0,0,55296,4,1744290680
3049,200697860,115321,200813181,5,0,0,5120,5,6764185254
3050,200702983,175932,200878915,0,0,0,1536,0,7355875125
3051,200703660,254296,200957956,5,0,0,10240,5,7017332359
3052,200707352,184062,200891414,19,0,0,3072,19,7858575128
3053,200731299,1994,200733293,34,0,1,2048,34,8041794626
3054,200735795,154653,200890448,4,0,0,36864,4,2749522369
3055,200747927,6488,200754415,37,0,1,15872,37,549575905
3056,200761020,3904,200764924,18,0,1,10752,18,2033844170
3057,200765537,2946,200768483,23,0,1,3072,23,3928932941
3058,200796466,476785,201273251,30,0,0,63488,30,4245325035
3059,200796656,9128,200805784,15,0,1,6144,15,5936101388
3060,200796859,10231,200807090,37,0,1,2048,37,5591419089
3061,200808392,5802,200814194,6,0,1,6144,6,6902190419
3062,200817048,160985,200978033,13,0,0,2560,13,10024460719
3063,200828539,1994,200830533,20,0,1,2048,20,7832765371
3064,200844652,214472,201059124,2,0,0,4608,2,4939557792
3065,200847397,4315,200851712,7,0,1,4096,7,4604930781
3066,200866236,368255,201234491,30,0,0,39424,30,1003965825
3067,200867615,190074,201057689,25,0,0,44032,25,5556698582
3068,200869470,20993,200890463,34,0,1,9728,34,6402288105
3069,200894661,212090,201106751,31,0,0,13312,31,3467532749
3070,200902940,292824,201195764,28,0,0,43520,28,6884964276
3071,200920977,438205,201359182,38,0,0,70144,38,2887568131
3072,200925172,502831,201428003,31,0,0,45568,31,1276472907
3073,200942222,240267,201182489,32,0,0,54784,32,8794531838
3074,200943355,432937,201376292,33,0,0,10240,33,7198703071
3075,200946598,6793,200953391,37,0,1,9216,37,143515450
3076,200962303,172786,201135089,20,0,0,35328,20,4725831003
3077,200979869,6754,200986623,34,0,1,7168,34,2243361720
3078,200989759,465186,201454945,26,0,0,35840,26,8251710611
3079,200993987,406590,201400577,36,0,0,512,36,3498716304
3080,201010321,12049,201022370,21,0,1,19968,21,1133563013
3081,201010737,490711,201501448,12,0,0,152576,12,6172307878
3082,201029861,337448,201367309,20,0,0,26624,20,6422621711
3083,201029980,29159,201059139,20,0,1,1024,20,10111350434
3084,201031778,28218,201059996,34,0,1,2048,34,3167213529
3085,201034155,577948,201612103,36,0,0,30720,36,5673596580
3086,201034554,520463,201555017,18,0,0,3584,18,6896314847
3087,201067669,3898,201071567,29,0,1,4096,29,8471721082
3088,201069305,496967,201566272,17,0,0,36864,17,7603379788
3089,201075531,446376,201521907,14,0,0,67072,14,7618903123
3090,201083599,305502,201389101,3,0,0,8704,3,5609582876
3091,201093141,509571,201602712,1,0,0,47616,1,5417403921
3092,201094782,459120,201553902,5,0,0,104960,5,4964268429
3093,201107457,475834,201583291,20,0,0,55808,20,3002559723
3094,201148219,128635,201276854,11,0,0,11776,11,6460260163
3095,201152918,570576,201723494,18,0,0,1024,18,2102590771
3096,201156471,5802,201162273,11,0,1,6144,11,8918809056
3097,201179638,41062,201220700,27,0,1,21504,27,7118161297
3098,201186234,455585,201641819,3,0,0,64512,3,7475293727
3099,201209324,25182,201234506,31,0,1,4608,31,6356802678
3100,201212881,777523,201990404,30,0,0,49664,30,7270730526
3101,201237469,581269,201818738,30,0,0,36864,30,2784201992
3102,201242833,199815,201442648,1,0,0,10240,1,1337125133
3103,201272407,7309,201279716,36,0,1,8704,36,1475686680
3104,201319573,296001,201615574,7,0,0,11264,7,863639652
3105,201336018,314308,201650326,9,0,0,17408,9,5432912150
3106,201354314,17149,201371463,2,0,1,11264,2,10735228198
3107,201376840,211146,201587986,15,0,0,15360,15,9065151419
3108,201393294,329873,201723167,37,0,0,84480,37,4344884030
3109,201409523,178658,201588181,34,0,0,512,34,9536041483
3110,201419469,318720,201738189,28,0,0,48128,28,6045224549
3111,201426952,218040,201644992,2,0,0,10240,2,552702171
3112,201438609,177176,201615785,38,0,0,512,38,6898624222
3113,201442466,594189,202036655,32,0,0,19968,32,9373426739
3114,201443250,177109,201620359,24,0,0,12288,24,552716731
3115,201444408,299131,201743539,10,0,0,3584,10,8962053408
3116,201476724,265708,201742432,5,0,0,13824,5,1673614282
3117,201478355,427227,201905582,18,0,0,108544,18,7390808191
3118,201518807,353688,201872495,7,0,0,52736,7,5584281015
3119,201519785,122057,201641842,3,0,1,27136,3,3389392285
3120,201525691,259060,201784751,11,0,0,2048,11,6903037513
3121,201549506,356255,201905761,12,0,0,512,12,6621285555
3122,201554382,392633,201947015,17,0,0,42496,17,10444454295
3123,201556621,604852,202161473,30,0,0,65536,30,8665438550
3124,201561084,491663,202052747,14,0,0,12288,14,6668523601
3125,201565071,76786,201641857,37,0,1,1024,37,308276785
3126,201590190,506831,202097021,17,0,0,45568,17,6567595348
3127,201599705,45302,201645007,19,0,1,7168,19,10003537831
3128,201599794,322401,201922195,3,0,0,53248,3,3274350055
3129,201600317,371751,201972068,16,0,0,42496,16,6452656330
3130,201610894,387028,201997922,35,0,0,24576,35,300422705
3131,201621634,312418,201934052,18,0,0,20992,18,2502733590
3132,201637757,14572,201652329,11,0,1,2048,11,5337693349
3133,201638448,432437,202070885,38,0,0,5632,38,5435942352
3134,201691360,688645,202380005,28,0,0,34304,28,8721016234
3135,201695763,210169,201905932,7,0,0,512,7,5659259306
3136,201705714,37840,201743554,23,0,1,1536,23,6782674633
3137,201709690,33879,201743569,2,0,1,1536,2,6256957980
3138,201755386,3422,201758808,30,0,1,3584,30,1679195674
3139,201762058,505383,202267441,10,0,0,35328,10,3502497355
3140,201772364,3904,201776268,11,0,1,10752,11,8326265549
3141,201772509,466277,202238786,25,0,0,51712,25,6226206956
3142,201772695,152823,201925518,37,0,0,10752,37,5142832456
3143,201782221,519136,202301357,27,0,0,38912,27,2475997087
3144,201798118,458536,202256654,28,0,0,43520,28,9992834760
3145,201811186,21661,201832847,34,0,1,24064,34,10665193612
3146,201833074,447631,202280705,38,0,0,26112,38,9880439050
3147,201840249,592328,202432577,38,0,0,29184,38,7622735943
3148,201842804,5802,201848606,26,0,1,6144,26,8273801542
3149,201847786,642631,202490417,31,0,0,21504,31,9491367211
3150,201856071,471314,202327385,12,0,0,23040,12,9363937838
3151,201857548,384864,202242412,22,0,0,8704,22,7341259325
3152,201868491,354524,202223015,10,0,0,110592,10,8462631725
3153,201872759,589862,202462621,7,0,0,26112,7,487339415
3154,201876365,50284,201926649,31,0,1,11776,31,8362816252
3155,201897454,487745,202385199,27,0,0,16896,27,6474208067
3156,201899012,521983,202420995,32,0,0,17408,32,9945289384
3157,201904945,510731,202415676,34,0,0,36352,34,1757290724
3158,201926531,342173,202268704,30,0,0,4096,30,6011994601
3159,201937915,403964,202341879,39,0,0,12800,39,460140017
3160,201957600,14483,201972083,37,0,1,5632,37,6979831384
3161,201970079,20340,201990419,23,0,1,12800,23,6584380783
3162,202001913,241450,202243363,17,0,0,3072,17,5328748825
3163,202002546,421116,202423662,34,0,0,8704,34,1441325995
3164,202007456,2946,202010402,31,0,1,3072,31,5539706597
3165,202017700,222037,202239737,38,0,0,3072,38,10514879222
3166,202019297,568848,202588145,9,0,0,12800,9,5929366709
3167,202097742,271788,202369530,9,0,0,17920,9,7345316579
3168,202106468,165550,202272018,28,0,0,6144,28,7800768228
3169,202113809,480770,202594579,19,0,0,10752,19,2783530037
3170,202118328,356499,202474827,22,0,0,39936,22,10426128576
3171,202123390,240665,202364055,38,0,0,25088,38,2938931220
3172,202138993,1518,202140511,11,0,1,1536,11,5281859212
3173,202145008,685122,202830130,30,0,0,40448,30,979977633
3174,202172859,231711,202404570,39,0,0,55808,39,7078700919
3175,202198295,392985,202591280,28,0,0,10240,28,1139228589
3176,202220804,494091,202714895,35,0,0,13824,35,3316377668
3177,202224900,43835,202268735,21,0,1,6144,21,5284170655
3178,202254867,495281,202750148,7,0,0,22528,7,1940674957
3179,202256081,15952,202272033,6,0,1,2560,6,826870447
3180,202295583,609529,202905112,38,0,0,38400,38,8346473882
3181,202297688,6831,202304519,20,0,1,9216,20,9900671958
3182,202300946,10007,202310953,0,0,1,7168,0,6071181693
3183,202302410,240468,202542878,25,0,0,44544,25,5159717958
3184,202311039,2470,202313509,8,0,1,2560,8,4811056429
3185,202320610,339397,202660007,28,0,0,512,28,1699301322
3186,202324047,197805,202521852,35,0,0,1024,35,8053275641
3187,202355290,24730,202380020,18,0,1,6144,18,5663438507
3188,202358072,76236,202434308,8,0,0,5632,8,6363452526
3189,202368057,273749,202641806,25,0,0,64512,25,7675229052
3190,202368764,35821,202404585,22,0,1,3072,22,1341895108
3191,202421234,130768,202552002,2,0,0,3072,2,7786266602
3192,202440566,130335,202570901,17,0,0,6144,17,9395263794
3193,202452206,10438,202462644,0,0,1,4096,0,1535036548
3194,202455903,210419,202666322,18,0,0,5632,18,9174450354
3195,202463788,12616,202476404,9,0,1,1536,9,4762847183
3196,202464428,719297,203183725,3,0,0,77824,3,7127716936
3197,202468504,371328,202839832,31,0,0,10752,31,7414284888
3198,202469653,7097,202476750,0,0,1,512,0,5763932298
3199,202477913,220572,202698485,16,0,0,9728,16,951486388
3200,202479586,196650,202676236,5,0,0,6144,5,6679648101
3201,202482476,320278,202802754,22,0,0,27648,22,6745936452
3202,202483014,353527,202836541,27,0,0,20992,27,9197289655
3203,202491958,11791,202503749,33,0,1,19456,33,3367758537
3204,202496088,125081,202621169,33,0,0,14848,33,5424333387
3205,202534921,352685,202887606,18,0,0,26624,18,10414500895
3206,202537472,13196,202550668,6,0,1,8192,6,393854325
3207,202538172,249598,202787770,30,0,0,3072,30,9585784183
3208,202538612,73058,202611670,12,0,0,2048,12,9005028706
3209,202541084,305189,202846273,3,0,0,12800,3,7570236047
3210,202567230,81842,202649072,14,0,0,1536,14,5973784357
3211,202572643,276461,202849104,17,0,0,9216,17,6077234905
3212,202574054,863986,203438040,20,0,0,78848,20,7568842635
3213,202580695,372255,202952950,2,0,0,43520,2,8369711718
3214,202586594,12318,202598912,1,0,1,4608,1,7588434623
3215,202611040,320428,202931468,3,0,0,3584,3,5582843407
3216,202613897,584701,203198598,38,0,0,17920,38,3320817835
3217,202614852,760116,203374968,15,0,0,43008,15,8228451820
3218,202623508,339558,202963066,4,0,0,6144,4,6887376298
3219,202627923,214435,202842358,8,0,0,2048,8,7840938861
3220,202629539,380030,203009569,25,0,0,152576,25,6484430337
3221,202630681,14621,202645302,18,0,1,9728,18,2528900136
3222,202635129,14124,202649253,8,0,1,4608,8,3760115073
3223,202636274,205445,202841719,39,0,0,6144,39,9539986018
3224,202642633,411257,203053890,4,0,0,30720,4,1198900998
3225,202643056,8013,202651069,11,0,1,12288,11,9791642018
3226,202645951,6104,202652055,2,0,1,1536,2,3590357878
3227,202694601,509472,203204073,39,0,0,17920,39,6536064202
3228,202707079,320453,203027532,17,0,0,58880,17,9835121899
3229,202755403,553528,203308931,18,0,0,38400,18,3670137024
3230,202756137,855841,203611978,27,0,0,3072,27,3746467260
3231,202761926,443122,203205048,30,0,0,3072,30,4485437062
3232,202774473,587376,203361849,29,0,0,128000,29,6607881551
3233,202781111,368541,203149652,22,0,0,36864,22,7705854711
3234,202786599,4374,202790973,29,0,1,4608,29,7162025960
3235,202792883,276129,203069012,16,0,0,4096,16,7009359909
3236,202803102,260795,203063897,25,0,0,32768,25,2921178988
3237,202817341,371079,203188420,16,0,0,15360,16,3590176799
3238,202840472,482362,203322834,7,0,0,31744,7,7563009087
3239,202845809,896389,203742198,28,0,0,48128,28,8643335323
3240,202860381,332742,203193123,4,0,0,15360,4,5361947989
3241,202868366,729815,203598181,19,0,0,84992,19,1738516642
3242,202874467,233413,203107880,16,0,0,23552,16,4626385506
3243,202882753,8490,202891243,32,0,1,10240,32,7599573465
3244,202895734,483812,203379546,38,0,0,9728,38,6525190216
3245,202916891,302755,203219646,28,0,0,5632,28,3495188557
3246,202924816,647454,203572270,27,0,0,35328,27,7902332894
3247,202934947,721957,203656904,25,0,0,20992,25,8836971666
3248,202939869,436674,203376543,9,0,0,5120,9,9375552651
3249,202987708,482255,203469963,1,0,0,14848,1,1075690010
3250,203003614,557526,203561140,27,0,0,20480,27,10492453636
3251,203003809,308413,203312222,37,0,0,10752,37,4895733468
3252,203005114,23594,203028708,12,0,1,1024,12,10379056150
3253,203013933,841941,203855874,31,0,0,30208,31,1187793211
3254,203015216,260950,203276166,5,0,0,4608,5,10670204028
3255,203022336,105445,203127781,16,0,0,5120,16,10376347883
3256,203024739,530146,203554885,2,0,0,5632,2,5496866638
3257,203040113,566,203040679,2,0,1,512,2,8788741441
3258,203040271,512875,203553146,8,0,0,208384,8,2301919178
3259,203046976,577208,203624184,11,0,0,26112,11,8348066748
3260,203055733,554335,203610068,31,0,0,38912,31,516273151
3261,203087333,307360,203394693,25,0,0,49664,25,1711572563
3262,203105888,4871,203110759,11,0,1,8704,11,4129836341
3263,203107210,534211,203641421,34,0,0,12800,34,3770594354
3264,203109265,330358,203439623,8,0,0,5120,8,8441769689
3265,203139749,421742,203561491,18,0,0,1024,18,3711786755
3266,203149071,461956,203611027,36,0,0,3072,36,1908461804
3267,203170104,35947,203206051,12,0,1,2048,12,7936316830
3268,203187283,450207,203637490,25,0,0,43520,25,3880584933
3269,203189109,221764,203410873,0,0,0,3584,0,3687904917
3270,203201352,7850,203209202,23,0,1,11264,23,6361647668
3271,203220834,557342,203778176,20,0,0,1536,20,9596044062
3272,203229641,386572,203616213,11,0,0,13824,11,9889491654
3273,203240132,670708,203910840,14,0,0,17920,14,1386576175
3274,203258311,193423,203451734,17,0,0,36864,17,2628067103
3275,203258619,137509,203396128,33,0,0,4608,33,8901427582
3276,203279371,480785,203760156,1,0,0,5120,1,4897982137
3277,203291622,483248,203774870,39,0,0,46592,39,2452754198
3278,203333232,62927,203396159,31,0,1,512,31,7936234849
3279,203342918,707518,204050436,22,0,0,30208,22,1106107681
3280,203356613,324221,203680834,5,0,0,48128,5,6682991398
3281,203378307,399386,203777693,25,0,0,9216,25,1075725907
3282,203380978,420752,203801730,34,0,0,13824,34,8547143252
3283,203382036,284103,203666139,36,0,0,30208,36,2561630363
3284,203412074,270964,203683038,31,0,0,4608,31,6675124570
3285,203434361,291889,203726250,16,0,0,15360,16,9881065283
3286,203459581,241936,203701517,13,0,0,22016,13,8188300153
3287,203465679,5794,203471473,22,0,1,1536,22,2127212562
3288,203508827,141666,203650493,36,0,0,15872,36,325787261
3289,203542856,295090,203837946,35,0,0,12288,35,921332891
3290,203543983,183218,203727201,1,0,0,3072,1,2823300991
3291,203544609,79606,203624215,9,0,1,4608,9,7876271009
3292,203561200,231284,203792484,17,0,0,20480,17,9444934020
3293,203570687,326328,203897015,1,0,0,5632,1,6108436780
3294,203579854,124486,203704340,28,0,0,9216,28,2039311368
3295,203599870,43882,203643752,27,0,1,6656,27,4325633235
3296,203600553,120951,203721504,33,0,0,512,33,3859118559
3297,203623756,383500,204007256,30,0,0,45568,30,1977479687
3298,203643627,237849,203881476,17,0,0,12288,17,6941911382
3299,203649133,31724,203680857,8,0,1,16384,8,7901637893
3300,203651069,29803,203680872,18,0,1,11264,18,7091874906
3301,203676274,180863,203857137,7,0,0,4096,7,5356775728
3302,203736357,193761,203930118,13,0,0,12800,13,3040737466
3303,203743397,314287,204057684,16,0,0,21504,16,2449194724
3304,203745663,94170,203839833,24,0,0,6144,24,5297087421
3305,203760508,406874,204167382,38,0,0,34816,38,8849262921
3306,203775929,312948,204088877,20,0,0,17920,20,3032932165
3307,203781660,60884,203842544,24,0,0,2048,24,2123387886
3308,203793862,185269,203979131,36,0,0,31744,36,8991161187
3309,203797508,195849,203993357,15,0,0,37888,15,5675993546
3310,203808254,207486,204015740,18,0,0,1024,18,1582334198
3311,203814090,367682,204181772,14,0,0,13824,14,8263819816
3312,203846234,162753,204008987,17,0,0,5632,17,9828110974
3313,203860142,443895,204304037,33,0,0,25088,33,196108867
3314,203860316,3898,203864214,22,0,1,4096,22,1129735585
3315,203860611,121187,203981798,26,0,0,8704,26,669163435
3316,203870522,140352,204010874,3,0,0,6144,3,7824222432
3317,203873351,89989,203963340,3,0,0,2048,3,9016868231
3318,203898633,348651,204247284,4,0,0,33792,4,4517604656
3319,203903503,111910,204015413,28,0,0,14848,28,5303599351
3320,203920859,209383,204130242,32,0,0,8704,32,4970640706
3321,203935129,80954,204016083,26,0,0,1024,26,6964580564
3322,203965146,282777,204247923,18,0,0,2048,18,3070498374
3323,204006402,77000,204083402,10,0,0,7680,10,2585209731
3324,204009890,10056,204019946,33,0,1,10752,33,4415059915
3325,204019937,1995,204021932,32,0,1,2048,32,7297213292
3326,204022508,95737,204118245,15,0,0,4608,15,1870598802
3327,204029107,148438,204177545,34,0,0,33280,34,3119153247
3328,204051484,99663,204151147,26,0,0,7168,26,6248145830
3329,204055601,240777,204296378,25,0,0,44032,25,6507740024
3330,204057353,59473,204116826,8,0,0,512,8,10565215395
3331,204063021,47288,204110309,14,0,0,1536,14,6991175146
3332,204064676,128280,204192956,25,0,0,8192,25,8883001732
3333,204080419,143251,204223670,14,0,0,23552,14,3637230603
3334,204089161,176490,204265651,33,0,0,7680,33,7817626539
3335,204133110,174998,204308108,15,0,0,13312,15,9237689703
3336,204146644,246243,204392887,32,0,0,31744,32,969406752
3337,204155800,80350,204236150,18,0,0,7680,18,8812785544
3338,204161015,222177,204383192,4,0,0,75776,4,5845968999
3339,204190162,243757,204433919,26,0,0,37376,26,6771182723
3340,204197983,316079,204514062,25,0,0,30720,25,9490286358
3341,204202761,191545,204394306,33,0,0,4608,33,8289449416
3342,204204272,2946,204207218,32,0,1,3072,32,6875133612
3343,204204449,19236,204223685,27,0,1,19968,27,3924865950
3344,204207253,18279,204225532,29,0,1,24064,29,946331217
3345,204211038,128313,204339351,31,0,0,10240,31,5559686120
3346,204219582,122904,204342486,31,0,0,10240,31,8476985594
3347,204230727,319527,204550254,27,0,0,18432,27,9109249330
3348,204233149,246472,204479621,29,0,0,20992,29,9389635447
3349,204277785,128758,204406543,13,0,0,9728,13,4894599232
3350,204298474,145534,204444008,18,0,0,19968,18,4015052271
3351,204298740,236553,204535293,33,0,0,69632,33,9922256834
3352,204308813,112623,204421436,32,0,0,21504,32,2278626778
3353,204347611,395471,204743082,15,0,0,49152,15,8385330979
3354,204352429,306827,204659256,7,0,0,32256,7,3631644188
3355,204369958,182339,204552297,22,0,0,6656,22,1940441054
3356,204384688,14547,204399235,18,0,1,12800,18,3110855728
3357,204395584,213802,204609386,26,0,0,19968,26,2722484432
3358,204396261,5656,204401917,31,0,1,10240,31,9276974724
3359,204418153,196716,204614869,5,0,0,17920,5,6732012084
3360,204430757,337256,204768013,32,0,0,7680,32,2651244346
3361,204449529,3422,204452951,21,0,1,3584,21,10280588850
3362,204474364,236962,204711326,7,0,0,23040,7,6082442612
3363,204484858,130650,204615508,35,0,0,2048,35,3110202218
3364,204487061,487243,204974304,26,0,0,46080,26,7109882384
3365,204496901,131734,204628635,15,0,0,43008,15,544468068
3366,204525857,14821,204540678,22,0,1,5632,22,10069780272
3367,204526741,274673,204801414,24,0,0,69632,24,8579345336
3368,204528028,318777,204846805,31,0,0,104960,31,406935223
3369,204535018,6966,204541984,21,0,1,2048,21,10223748815
3370,204550784,192625,204743409,34,0,0,1024,34,3530941145
3371,204558347,337016,204895363,29,0,0,36352,29,5595023398
3372,204565007,206165,204771172,13,0,0,2048,13,9328763604
3373,204565889,241780,204807669,10,0,0,20480,10,2493306329
3374,204575329,278705,204854034,33,0,0,22528,33,343968107
3375,204604351,25403,204629754,21,0,1,27648,21,2054558239
3376,204617617,191159,204808776,35,0,0,3584,35,7263060732
3377,204628233,83576,204711809,12,0,0,1536,12,3815715459
3378,204635635,2946,204638581,28,0,1,3072,28,3358787509
3379,204651747,208425,204860172,7,0,0,11264,7,8621326079
3380,204659354,197355,204856709,10,0,0,8704,10,5286597337
3381,204662730,4679,204667409,25,0,1,12288,25,4458720259
3382,204667086,356540,205023626,25,0,0,2048,25,6856977469
3383,204701055,1518,204702573,9,0,1,1536,9,5998739779
3384,204722653,300311,205022964,15,0,0,23040,15,507832892
3385,204742658,342797,205085455,34,0,0,7680,34,2423445072
3386,204744273,102867,204847140,16,0,0,1024,16,660365450
3387,204744433,3128,204747561,14,0,1,9216,14,10676837828
3388,204746037,128460,204874497,20,0,0,20480,20,3129139084
3389,204749386,189780,204939166,25,0,0,1024,25,3251927933
3390,204750032,566,204750598,20,0,1,512,20,6207080201
3391,204803130,96312,204899442,17,0,0,13312,17,9307646937
3392,204805124,42031,204847155,36,0,1,22016,36,8293613910
3393,204816671,43532,204860203,8,0,1,9728,8,8483484706
3394,204822884,38765,204861649,14,0,1,1536,14,6292638645
3395,204835137,39375,204874512,27,0,1,23552,27,1417865203
3396,204885085,130844,205015929,7,0,0,41984,7,2760995533
3397,204891616,156400,205048016,10,0,0,22528,10,893715843
3398,204911431,158199,205069630,28,0,0,18944,28,3264786092
3399,204916104,174462,205090566,13,0,0,2560,13,283261092
3400,204928608,4937,204933545,21,0,1,12800,21,1122952775
3401,204942003,121840,205063843,37,0,0,17408,37,3756896078
3402,204945189,129916,205075105,19,0,0,17920,19,4374184095
3403,204956503,485179,205441682,13,0,0,32768,13,995359766
3404,204959908,231162,205191070,30,0,0,62976,30,4969559267
3405,204964909,122433,205087342,30,0,0,6144,30,3391868563
3406,204972388,108816,205081204,35,0,0,19968,35,8691109353
3407,204972904,545062,205517966,17,0,0,75776,17,4656291309
3408,204993523,29464,205022987,26,0,1,31232,26,8772685129
3409,205007419,392490,205399909,13,0,0,25088,13,939686194
3410,205028345,165860,205194205,29,0,0,10240,29,5637713637
3411,205038470,265730,205304200,21,0,0,39936,21,608905992
3412,205089042,78405,205167447,20,0,0,1536,20,6078007988
3413,205092813,564144,205656957,33,0,0,20480,33,8865563685
3414,205101099,111487,205212586,31,0,0,11776,31,9640402831
3415,205114703,298175,205412878,26,0,0,17408,26,6315833876
3416,205119809,187378,205307187,38,0,0,9728,38,2698905842
3417,205123644,7230,205130874,31,0,1,7680,31,959690789
3418,205135094,713371,205848465,18,0,0,31744,18,8127660122
3419,205137962,242723,205380685,31,0,0,50688,31,2435627195
3420,205142301,3387,205145688,21,0,1,9728,21,161457725
3421,205148097,283586,205431683,6,0,0,49664,6,109895788
3422,205152458,2870,205155328,28,0,1,8704,28,1493419304
3423,205190212,11691,205201903,35,0,1,8192,35,2953631981
3424,205195946,582169,205778115,15,0,0,38912,15,8419975231
3425,205205471,7130,205212601,21,0,1,4096,21,6256236114
3426,205209794,182317,205392111,4,0,0,3584,4,1431443576
3427,205229392,230836,205460228,34,0,0,11264,34,5739885727
3428,205233546,157450,205390996,35,0,0,33792,35,9567011198
3429,205240438,4850,205245288,14,0,1,5120,14,2936966266
3430,205248649,323540,205572189,20,0,0,32768,20,5861825172
3431,205253602,269543,205523145,9,0,0,16896,9,7176518309
3432,205269287,208337,205477624,29,0,0,27136,29,5662604036
3433,205283534,343287,205626821,39,0,0,41472,39,2437178756
3434,205294088,670498,205964586,7,0,0,16384,7,5797782089
3435,205305066,287130,205592196,11,0,0,65536,11,9497226460
3436,205329590,4850,205334440,31,0,1,5120,31,1574322261
3437,205335091,417558,205752649,33,0,0,47104,33,9058306325
3438,205361823,282736,205644559,35,0,0,28160,35,1329367881
3439,205376838,185352,205562190,33,0,0,42496,33,3557059548
3440,205396291,288579,205684870,26,0,0,13312,26,9865685897
3441,205404315,351009,205755324,31,0,0,8704,31,6614413771
3442,205427524,234908,205662432,7,0,0,17920,7,3442484747
3443,205429781,112902,205542683,34,0,0,23552,34,9610780005
3444,205441881,191663,205633544,39,0,0,22016,39,2783542492
3445,205445646,230394,205676040,6,0,0,41984,6,5394502889
3446,205508495,169455,205677950,18,0,0,6144,18,9254282088
3447,205508662,19896,205528558,19,0,1,13824,19,6433790118
3448,205531000,3128,205534128,18,0,1,9216,18,96851441
3449,205552682,146377,205699059,34,0,0,7168,34,2611520624
3450,205554879,42151,205597030,11,0,1,5120,11,9044298522
3451,205555053,146370,205701423,9,0,0,4608,9,2810775749
3452,205569133,147641,205716774,3,0,0,8192,3,2009173778
3453,205598937,91938,205690875,32,0,0,15360,32,1553907379
3454,205629652,197123,205826775,17,0,0,25600,17,5577284785
3455,205644452,139537,205783989,12,0,0,6656,12,9471231901
3456,205656393,19662,205676055,14,0,1,4096,14,4906416143
3457,205672904,143255,205816159,14,0,0,22528,14,3313229045
3458,205677476,57026,205734502,7,0,0,2560,7,9463304175
3459,205691889,218571,205910460,9,0,0,11264,9,7565773905
3460,205692284,6790,205699074,35,0,1,7168,35,5305446608
3461,205716727,182885,205899612,24,0,0,60928,24,1533335294
3462,205735485,20624,205756109,23,0,1,33280,23,3651048488
3463,205745613,269005,206014618,17,0,0,43520,17,10733849296
3464,205782482,2541,205785023,29,0,1,1024,29,8233206121
3465,205799534,278999,206078533,8,0,0,22016,8,9947456041
3466,205833414,164212,205997626,5,0,0,5632,5,5432296991
3467,205838449,135353,205973802,4,0,0,16384,4,2858869285
3468,205840878,373405,206214283,10,0,0,25600,10,10211652404
3469,205885261,19556,205904817,9,0,1,13312,9,8077662845
3470,205897332,8791,205906123,28,0,1,2048,28,10242264275
3471,205903451,272354,206175805,18,0,0,16384,18,5287199781
3472,205911123,6229,205917352,0,0,1,15360,0,147972128
3473,205917530,187652,206105182,24,0,0,15872,24,7042416118
3474,205918883,11274,205930157,32,0,1,18432,32,8055061035
3475,205960730,97182,206057912,15,0,0,22528,15,4793114307
3476,205965319,432134,206397453,28,0,0,48640,28,8738065949
3477,205984563,156731,206141294,10,0,0,33280,10,2930201652
3478,205987685,271131,206258816,28,0,0,39424,28,9638629308
3479,206018833,122632,206141465,1,0,0,512,1,4996685155
3480,206021932,88442,206110374,15,0,0,13824,15,3396707218
3481,206051101,413752,206464853,34,0,0,102400,34,4395567708
3482,206053843,8265,206062108,32,0,1,11264,32,5826581974
3483,206055017,170981,206225998,1,0,0,38400,1,3208254935
3484,206060265,179856,206240121,11,0,0,37376,11,1593310627
3485,206061611,409224,206470835,30,0,0,13312,30,5234871314
3486,206061729,265457,206327186,3,0,0,35840,3,1461646521
3487,206088557,4850,206093407,2,0,1,5120,2,7801918871
3488,206107232,274591,206381823,3,0,0,113152,3,366425809
3489,206179437,203181,206382618,6,0,0,2560,6,5572057602
3490,206188549,3387,206191936,0,0,1,9728,0,427710543
3491,206200321,266427,206466748,7,0,0,6144,7,8811738390
3492,206200534,146242,206346776,14,0,0,3584,14,4570057884
3493,206203455,22558,206226013,31,0,1,18944,31,7636293812
3494,206225368,276806,206502174,33,0,0,27136,33,5411168989
3495,206229754,202575,206432329,32,0,0,22016,32,9589866265
3496,206237060,174252,206411312,7,0,0,6656,7,2605532036
3497,206263903,3387,206267290,25,0,1,9728,25,9605508868
3498,206274567,6229,206280796,37,0,1,15360,37,592408782
3499,206277990,265261,206543251,37,0,0,52224,37,5918632963
3500,206281114,198348,206479462,0,0,0,28160,0,10680761487
3501,206326037,3135,206329172,37,0,1,2048,37,9578941835
3502,206331980,161872,206493852,0,0,0,47104,0,9406047820
3503,206334029,5802,206339831,22,0,1,6144,22,2452432173
3504,206340153,2470,206342623,25,0,1,2560,25,1703245192
3505,206346849,50643,206397492,20,0,1,50176,20,9148502848
3506,206358080,45242,206403322,23,0,1,6144,23,2698572225
3507,206367861,244338,206612199,30,0,0,12800,30,3196802776
3508,206374289,355881,206730170,5,0,0,58368,5,8128861145
3509,206396486,451689,206848175,26,0,0,23040,26,4799772074
3510,206397793,265292,206663085,8,0,0,39424,8,6890914930
3511,206420604,371569,206792173,29,0,0,37376,29,2286365952
3512,206432910,385018,206817928,26,0,0,84480,26,3112551039
3513,206433775,45710,206479485,1,0,1,512,1,1264844491
3514,206442846,375565,206818411,30,0,0,1536,30,6038419686
3515,206455391,325363,206780754,30,0,0,105472,30,9227002526
3516,206462998,30893,206493891,19,0,1,15872,19,4349842159
3517,206467993,361229,206829222,31,0,0,35328,31,8786381803
3518,206470493,364080,206834573,14,0,0,17408,14,9565973049
3519,206483252,399822,206883074,35,0,0,16384,35,3764428584
3520,206483447,19252,206502699,9,0,1,512,9,2370452624
3521,206483543,181125,206664668,16,0,0,5120,16,619818596
3522,206503787,2470,206506257,6,0,1,2560,6,9772355934
3523,206514868,5326,206520194,8,0,1,5632,8,7282439836
3524,206633129,4850,206637979,23,0,1,5120,23,35619051
3525,206638728,328711,206967439,24,0,0,75264,24,4521305410
3526,206641664,235932,206877596,37,0,0,34816,37,282556499
3527,206643980,197160,206841140,39,0,0,21504,39,3398934962
3528,206655357,537205,207192562,12,0,0,133120,12,6757500175
3529,206692854,536178,207229032,17,0,0,23040,17,7033168277
3530,206699394,148812,206848206,20,0,1,227328,20,7645214586
3531,206754588,93633,206848221,1,0,1,9728,1,7292946160
3532,206770505,314604,207085109,28,0,0,20480,28,7810024414
3533,206790064,58172,206848236,4,0,1,8704,4,5584110395
3534,206790857,254948,207045805,38,0,0,2560,38,247202669
3535,206805921,280303,207086224,38,0,0,3584,38,5351658110
3536,206813300,397567,207210867,27,0,0,28672,27,9011050298
3537,206816492,423053,207239545,34,0,0,21504,34,7089863276
3538,206818854,633769,207452623,34,0,0,10240,34,9492150828
3539,206835228,237552,207072780,0,0,0,19456,0,1795069521
3540,206836200,22765,206858965,32,0,1,17408,32,6806709186
3541,206856010,180285,207036295,33,0,0,20992,33,7907119620
3542,206856443,344870,207201313,5,0,0,28672,5,4071290823
3543,206863068,354990,207218058,37,0,0,23552,37,8654911744
3544,206897680,175747,207073427,17,0,0,2048,17,1539404422
3545,206915873,149192,207065065,25,0,0,15360,25,6817788745
3546,206925068,203003,207128071,37,0,0,14336,37,5283099489
3547,206928952,194455,207123407,35,0,0,24064,35,9226035476
3548,206945068,30111,206975179,12,0,1,8192,12,8210308324
3549,206963515,269432,207232947,18,0,0,12800,18,6617538075
3550,206964791,293654,207258445,7,0,0,26624,7,6072918256
3551,206970580,311904,207282484,36,0,0,26624,36,977592001
3552,207019165,345660,207364825,8,0,0,30720,8,890751502
3553,207026662,427076,207453738,15,0,0,3584,15,6625951915
3554,207030402,171714,207202116,24,0,0,2560,24,9971527578
3555,207032744,7466,207040210,16,0,1,4096,16,97538476
3556,207042796,244767,207287563,1,0,0,5120,1,1535205949
3557,207062275,159706,207221981,9,0,0,12800,9,4401955995
3558,207063858,2742,207066600,8,0,1,1536,8,2903240157
3559,207065725,241326,207307051,26,0,0,39936,26,4218974578
3560,207071333,190844,207262177,13,0,0,3584,13,6071177777
3561,207079078,263936,207343014,26,0,0,512,26,10051086917
3562,207099232,247720,207346952,13,0,0,2048,13,2748854371
3563,207099956,246349,207346305,39,0,0,10752,39,6778428502
3564,207101601,241242,207342843,39,0,0,22016,39,10407327550
3565,207132189,6229,207138418,6,0,1,15360,6,8134200578
3566,207133383,244421,207377804,9,0,0,42496,9,412783213
3567,207140812,275497,207416309,3,0,0,20480,3,68565278
3568,207147951,166013,207313964,38,0,0,11776,38,1282930857
3569,207150684,259370,207410054,10,0,0,23552,10,4296754814
3570,207165260,67718,207232978,18,0,1,3072,18,841529961
3571,207185529,347693,207533222,8,0,0,37376,8,5905306502
3572,207188546,240460,207429006,15,0,0,33280,15,8979878579
3573,207220521,580056,207800577,16,0,0,88576,16,1055722521
3574,207223974,17524,207241498,34,0,1,2048,34,1934221083
3575,207260138,446293,207706431,36,0,0,32768,36,10722294161
3576,207272732,237911,207510643,10,0,0,34304,10,2857227281
3577,207281428,297621,207579049,19,0,0,5632,19,4238533143
3578,207316166,418687,207734853,18,0,0,93184,18,560416187
3579,207320369,250851,207571220,0,0,0,9728,0,3245669010
3580,207342550,205716,207548266,34,0,0,1024,34,4170586323
3581,207356830,62021,207418851,27,0,0,2048,27,2687346007
3582,207360861,17468,207378329,34,0,1,512,34,8522129370
3583,207385642,415106,207800748,10,0,0,512,10,1185221037
3584,207391115,296396,207687511,37,0,0,133632,37,1778636153
3585,207392523,422758,207815281,12,0,0,22528,12,2458574622
3586,207393871,237228,207631099,18,0,0,18432,18,4115840852
3587,207405114,23907,207429021,25,0,1,2560,25,3275246337
3588,207406704,22332,207429036,7,0,1,512,7,2328914531
3589,207420292,14079,207434371,3,0,1,5632,3,822360884
3590,207421616,499631,207921247,27,0,0,76800,27,7069302033
3591,207429120,818365,208247485,20,0,0,19968,20,413742647
3592,207430889,4148,207435037,6,0,1,1024,6,4940124993
3593,207433106,148190,207581296,14,0,0,2560,14,7140102376
3594,207433120,311763,207744883,22,0,0,19456,22,3434043939
3595,207433765,191703,207625468,25,0,0,21504,25,754207695
3596,207436560,252058,207688618,9,0,0,3584,9,10142736103
3597,207438274,587196,208025470,28,0,0,54272,28,10107638442
3598,207449310,183993,207633303,16,0,0,5632,16,8718866188
3599,207449483,415588,207865071,18,0,0,11776,18,8929747377
3600,207455764,13083,207468847,27,0,1,22016,27,4173161996
3601,207457321,376836,207834157,22,0,0,18944,22,7505058819
3602,207458961,577764,208036725,29,0,0,36864,29,9994553168
3603,207479672,7706,207487378,12,0,1,8192,12,2811362233
3604,207534795,474124,208008919,26,0,0,36864,26,9357648146
3605,207545080,260059,207805139,0,0,0,14336,0,3132821626
3606,207568965,779782,208348747,34,0,0,53760,34,1124216304
3607,207584773,557654,208142427,11,0,0,5120,11,10257260931
3608,207598967,964132,208563099,32,0,0,35840,32,5771436028
3609,207601404,384380,207985784,10,0,0,45568,10,72883905
3610,207603205,920468,208523673,16,0,0,186880,16,2526839419
3611,207609826,453598,208063424,30,0,0,87552,30,7449976274
3612,207628338,570177,208198515,7,0,0,50688,7,9809494042
3613,207652960,445007,208097967,39,0,0,37888,39,1032307050
3614,207652989,793341,208446330,7,0,0,78848,7,1770280233
3615,207655994,933242,208589236,38,0,0,49664,38,4015175773
3616,207669804,36642,207706446,12,0,1,17920,12,6280966290
3617,207695235,411951,208107186,8,0,0,30208,8,1816641842
3618,207715525,567151,208282676,19,0,0,36864,19,8861176148
3619,207724691,546730,208271421,14,0,0,17920,14,5691197924
3620,207745898,915010,208660908,34,0,0,44544,34,6579880161
3621,207756167,369465,208125632,30,0,0,13312,30,2878155212
3622,207781110,34186,207815296,37,0,1,4096,37,7628368173
3623,207798653,826691,208625344,18,0,0,6144,18,6492694874
3624,207826930,237001,208063931,36,0,0,1536,36,7187403409
3625,207833116,233833,208066949,6,0,0,9216,6,4998757034
3626,207842601,340447,208183048,11,0,0,44032,11,2359887927
3627,207853436,220733,208074169,20,0,0,23040,20,6105771534
3628,207856644,4374,207861018,6,0,1,4608,6,5854595142
3629,207857696,206422,208064118,10,0,0,512,10,1122398233
3630,207879404,690270,208569674,30,0,0,21504,30,4284055133
3631,207887340,3387,207890727,11,0,1,9728,11,7980031592
3632,207888178,7025,207895203,32,0,1,5120,32,7136190717
3633,207897050,360393,208257443,36,0,0,16384,36,7059397811
3634,207913644,508647,208422291,9,0,0,35840,9,445155773
3635,207932115,176038,208108153,3,0,0,3072,3,3369832607
3636,207975809,555679,208531488,26,0,0,25600,26,5839872732
3637,207982854,635722,208618576,16,0,0,41472,16,6811394049
3638,207987106,636351,208623457,9,0,0,15872,9,3972933939
3639,207996374,292082,208288456,39,0,0,2048,39,10499751577
3640,208013496,667284,208680780,30,0,0,24064,30,4698683693
3641,208014967,363240,208378207,8,0,0,14336,8,1357777949
3642,208021866,430602,208452468,4,0,0,12288,4,8219805505
3643,208028543,258557,208287100,15,0,0,7680,15,1103659167
3644,208031947,859745,208891692,32,0,0,13312,32,191898403
3645,208035610,965869,209001479,16,0,0,26624,16,7219916329
3646,208041189,407496,208448685,27,0,0,7680,27,1786917620
3647,208051983,276116,208328099,37,0,0,3584,37,7525746552
3648,208059890,675304,208735194,39,0,0,25088,39,7963946225
3649,208074077,3982,208078059,22,0,1,4096,22,801014189
3650,208090528,23063,208113591,31,0,1,13824,31,2817147004
3651,208092157,26421,208118578,0,0,1,15360,0,2731342338
3652,208106348,177131,208283479,19,0,0,2560,19,1891032845
3653,208133012,456871,208589883,4,0,0,2048,4,1588168522
3654,208134195,620927,208755122,26,0,0,11264,26,2032099158
3655,208145126,174548,208319674,28,0,0,2560,28,6800540805
3656,208158121,2870,208160991,0,0,1,8704,0,6642142340
3657,208163733,243210,208406943,31,0,0,5632,31,5085398521
3658,208171716,30656,208202372,18,0,1,4096,18,3636546917
3659,208188882,276409,208465291,23,0,0,41984,23,9438394506
3660,208194482,130910,208325392,26,0,0,17408,26,8285153458
3661,208196741,6297,208203038,34,0,1,1024,34,5730341907
3662,208203923,345246,208549169,37,0,0,20480,37,8329983839
3663,208239640,398898,208638538,9,0,0,4096,9,4263378845
3664,208242075,224635,208466710,28,0,0,4608,28,7414944526
3665,208242646,300268,208542914,26,0,0,37376,26,9604192155
3666,208267993,19122,208287115,11,0,1,3072,11,5719828638
3667,208276887,17224,208294111,0,0,1,16896,0,5237090579
3668,208306430,6229,208312659,30,0,1,15360,30,6917421434
3669,208311283,240873,208552156,19,0,0,9728,19,8505066617
3670,208335099,295168,208630267,24,0,0,6656,24,2124838017
3671,208346864,227225,208574089,3,0,0,14336,3,8120503633
3672,208371208,771421,209142629,4,0,0,50176,4,10571073570
3673,208378962,343248,208722210,26,0,0,7680,26,4667980574
3674,208383645,211745,208595390,6,0,0,17920,6,3352794531
3675,208391001,207376,208598377,20,0,0,9728,20,4625876614
3676,208394369,211541,208605910,31,0,0,4096,31,4267332278
3677,208395387,566,208395953,23,0,1,512,23,1615505135
3678,208424125,821026,209245151,11,0,0,6144,11,10314786849
3679,208433521,171126,208604647,28,0,0,20480,28,8545108967
3680,208434966,238260,208673226,14,0,0,3072,14,7289585145
3681,208439500,92011,208531511,36,0,1,27648,36,7964874049
3682,208443858,441038,208884896,39,0,0,98304,39,9569444227
3683,208470532,270449,208740981,12,0,0,18944,12,6454167268
3684,208508418,153769,208662187,18,0,0,4096,18,5118269428
3685,208525028,219712,208744740,13,0,0,12288,13,3311014062
3686,208537304,61088,208598392,23,0,1,12288,23,2934758874
3687,208542550,63375,208605925,37,0,1,19456,37,928387655
3688,208545615,542189,209087804,39,0,0,57344,39,3934480831
3689,208553314,65277,208618591,21,0,1,7680,21,733974154
3690,208554449,64157,208618606,0,0,1,5120,0,10224741934
3691,208570712,213126,208783838,22,0,0,9728,22,6287180356
3692,208573408,236216,208809624,15,0,0,36352,15,9976591675
3693,208618187,308703,208926890,11,0,0,30208,11,10006884629
3694,208635765,200951,208836716,17,0,0,10752,17,8171016261
3695,208645729,172022,208817751,11,0,0,26624,11,6111429072
3696,208645819,133232,208779051,3,0,0,30720,3,6805386179
3697,208646837,198291,208845128,20,0,0,3072,20,2962604631
3698,208649212,418111,209067323,12,0,0,81408,12,72213473
3699,208649392,17604,208666996,11,0,1,5120,11,4920599871
3700,208667353,281068,208948421,31,0,0,19968,31,5118806528
3701,208717285,566,208717851,11,0,1,512,11,7860876665
3702,208720445,242791,208963236,1,0,0,24064,1,7333194947
3703,208741822,185395,208927217,20,0,0,1024,20,9482213709
3704,208768014,588876,209356890,5,0,0,54272,5,6644285942
3705,208770730,9355,208780085,6,0,1,1024,6,1478102115
3706,208785163,100076,208885239,22,0,0,1024,22,1278459547
3707,208845878,314907,209160785,8,0,0,24064,8,754770991
3708,208854855,237535,209092390,36,0,0,14336,36,1064798843
3709,208861123,30584,208891707,25,0,1,6144,25,4911586437
3710,208865804,173802,209039606,9,0,0,9728,9,3731857230
3711,208878452,13879,208892331,15,0,1,2048,15,9553376470
3712,208970498,253193,209223691,12,0,0,22016,12,10545172918
3713,208974775,5454,208980229,9,0,1,13824,9,5303856278
3714,208982641,1042,208983683,12,0,1,1024,12,7588558391
3715,208985676,84641,209070317,2,0,0,9728,2,5968991845
3716,208988395,254386,209242781,24,0,0,59392,24,645381401
3717,208993863,8174,209002037,27,0,1,512,27,5291169288
3718,209014410,245393,209259803,29,0,0,5120,29,394186019
3719,209015087,72904,209087991,12,0,0,512,12,8158230297
3720,209019463,158172,209177635,31,0,0,27136,31,3891369669
3721,209025697,74437,209100134,7,0,0,4096,7,10362743148
3722,209037160,30178,209067338,8,0,1,4608,8,9818418975
3723,209069455,223230,209292685,14,0,0,1024,14,8405014160
3724,209079140,164124,209243264,11,0,0,1536,11,8480855264
3725,209081975,187154,209269129,26,0,0,8704,26,6867830221
3726,209084588,80101,209164689,7,0,0,6144,7,10340103321
3727,209085467,377246,209462713,27,0,0,44032,27,8827656169
3728,209085676,14473,209100149,29,0,1,7680,29,7367952623
3729,209128734,18566,209147300,31,0,1,12288,31,3083169897
3730,209143233,7079,209150312,28,0,1,4096,28,8725656895
3731,209157445,7259,209164704,23,0,1,2560,23,4409425659
3732,209162440,198217,209360657,30,0,0,12288,30,947648972
3733,209174813,271928,209446741,3,0,0,70144,3,5015169917
3734,209175758,326898,209502656,1,0,0,20992,1,9968496643
3735,209182563,186065,209368628,34,0,0,26112,34,5183425990
3736,209185581,154297,209339878,29,0,0,18432,29,4481266258
3737,209191439,337908,209529347,17,0,0,13312,17,8049206490
3738,209205827,5326,209211153,1,0,1,5632,1,50773609
3739,209212518,236764,209449282,16,0,0,3072,16,5631918477
3740,209256447,132173,209388620,17,0,0,20480,17,6978877535
3741,209261983,1042,209263025,11,0,1,1024,11,8590609876
3742,209285339,162977,209448316,33,0,0,5120,33,10690502776
3743,209326928,352883,209679811,22,0,0,24576,22,4756205835
3744,209328828,11065,209339893,19,0,1,7168,19,1459262553
3745,209347963,254144,209602107,9,0,0,33792,9,4773017493
3746,209362861,223932,209586793,3,0,0,78336,3,6016960979
3747,209371298,164481,209535779,11,0,0,9216,11,3412775674
3748,209390166,5802,209395968,9,0,1,6144,9,4038911045
3749,209408343,87902,209496245,21,0,0,3584,21,8621660476
3750,209413030,82108,209495138,29,0,0,13824,29,4361628570
3751,209415845,32486,209448331,1,0,1,30720,1,9352561600
3752,209452850,153640,209606490,19,0,0,14336,19,10430087745
3753,209454955,214283,209669238,9,0,0,51712,9,2559621846
3754,209471426,243982,209715408,35,0,0,30720,35,10361691572
3755,209481542,108285,209589827,22,0,0,3584,22,10467855252
3756,209492391,16101,209508492,18,0,1,6144,18,7429493328
3757,209494416,136649,209631065,9,0,0,11776,9,9811183248
3758,209499441,12917,209512358,22,0,1,6144,22,9104061239
3759,209526535,191357,209717892,20,0,0,3584,20,10466241246
3760,209535350,165939,209701289,24,0,0,2048,24,7752348858
3761,209536544,4162,209540706,37,0,1,11264,37,3945439772
3762,209536688,16162,209552850,35,0,1,21504,35,834647601
3763,209575060,187873,209762933,34,0,0,12800,34,2313205680
3764,209599127,15078,209614205,14,0,1,8192,14,5609054628
3765,209604685,141508,209746193,29,0,0,13312,29,7386848445
3766,209628519,302404,209930923,32,0,0,32768,32,4946530596
3767,209655803,215517,209871320,35,0,0,20992,35,6083688102
3768,209660773,19053,209679826,19,0,1,14336,19,4070653051
3769,209683654,7230,209690884,2,0,1,7680,2,3512541997
3770,209686855,178038,209864893,36,0,0,44032,36,7122280205
3771,209693409,22014,209715423,18,0,1,22016,18,9598098862
3772,209707654,289716,209997370,12,0,0,2048,12,10677412048
3773,209725235,1994,209727229,5,0,1,2048,5,10557943046
3774,209751394,357535,210108929,17,0,0,1024,17,4493477338
3775,209769262,213874,209983136,13,0,0,12800,13,6883257482
3776,209771448,167100,209938548,1,0,0,2560,1,2707510934
3777,209777995,103745,209881740,34,0,0,7680,34,1373095549
3778,209780552,354623,210135175,10,0,0,2048,10,7752973983
3779,209802298,296506,210098804,19,0,0,48128,19,7088522829
3780,209813707,270402,210084109,27,0,0,166400,27,4373258772
3781,209816419,336231,210152650,16,0,0,10240,16,10493022390
3782,209827942,181964,210009906,8,0,0,1024,8,1046785231
3783,209828799,167924,209996723,10,0,0,44544,10,2257953737
3784,209855392,261277,210116669,22,0,0,21504,22,6550120169
3785,209856899,35521,209892420,28,0,1,34304,28,5351098510
3786,209865964,31743,209897707,35,0,1,25088,35,4430630567
3787,209876347,22026,209898373,27,0,1,11264,27,9991941798
3788,209923302,13891,209937193,29,0,1,6656,29,6464564002
3789,209936847,167440,210104287,36,0,0,17920,36,9439098462
3790,209943257,4850,209948107,0,0,1,5120,0,8425960512
3791,209946807,5802,209952609,9,0,1,6144,9,9881912523
3792,209953993,350532,210304525,30,0,0,30208,30,1341303430
3793,209957828,184218,210142046,7,0,0,15360,7,10440068907
3794,209965527,156193,210121720,26,0,0,5632,26,2894653548
3795,209971181,137381,210108562,39,0,0,13824,39,8154326793
3796,209985642,36874,210022516,30,0,1,45568,30,3250941196
3797,210023000,131381,210154381,29,0,0,5632,29,296060430
3798,210040118,283389,210323507,22,0,0,28160,22,3456773321
3799,210043094,121023,210164117,31,0,0,3584,31,839421080
3800,210066375,196913,210263288,0,0,0,23040,0,4762566148
3801,210074207,161633,210235840,28,0,0,55296,28,6984060030
3802,210078698,464883,210543581,7,0,0,54272,7,5418326113
3803,210081929,34755,210116684,23,0,1,5120,23,9386723594
3804,210083744,33838,210117582,12,0,1,6656,12,5462571315
3805,210090552,29296,210119848,6,0,1,3584,6,6108859907
3806,210092312,163941,210256253,22,0,0,16384,22,7960768324
3807,210101320,193261,210294581,37,0,0,1024,37,4317027475
3808,210104613,242515,210347128,18,0,0,40448,18,5363659554
3809,210114287,7448,210121735,14,0,1,1024,14,7227208878
3810,210120795,4354,210125149,32,0,1,3584,32,8620477655
3811,210141593,2915,210144508,29,0,1,2560,29,2333223171
3812,210142733,286504,210429237,20,0,1,467456,20,4660944924
3813,210146292,286491,210432783,0,0,1,5632,0,3016454703
3814,210149575,350438,210500013,2,0,0,8192,2,6004646825
3815,210193670,251119,210444789,1,0,0,4608,1,9223096487
3816,210203904,376559,210580463,12,0,0,17920,12,9623620202
3817,210205041,501416,210706457,11,0,0,8192,11,6676640112
3818,210208362,395213,210603575,13,0,0,33280,13,5843591570
3819,210244836,252666,210497502,13,0,0,26624,13,10381952223
3820,210267729,167320,210435049,22,0,1,3584,22,7032588933
3821,210271643,110305,210381948,8,0,0,1024,8,10192449311
3822,210288237,149398,210437635,27,0,1,4096,27,4549762119
3823,210302877,487638,210790515,34,0,0,27136,34,7512339791
3824,210321927,187767,210509694,35,0,0,6144,35,3124632079
3825,210344196,401962,210746158,13,0,0,39936,13,9062164386
3826,210360068,84736,210444804,22,0,1,24064,22,4001997543
3827,210374856,326423,210701279,25,0,0,59392,25,3203091931
3828,210394677,188149,210582826,8,0,0,7680,8,1985740584
3829,210408936,408911,210817847,18,0,0,36352,18,7838667325
3830,210409399,393369,210802768,37,0,0,26112,37,946505713
3831,210422022,654726,211076748,11,0,0,47616,11,6860565443
3832,210442407,425527,210867934,5,0,0,18944,5,6166431449
3833,210464186,318046,210782232,17,0,0,76800,17,7655606045
3834,210470427,133802,210604229,9,0,0,2048,9,7718166953
3835,210477206,501417,210978623,22,0,0,12288,22,9097083510
3836,210483651,411229,210894880,36,0,0,63488,36,5469024419
3837,210484178,353362,210837540,5,0,0,48128,5,10551242606
3838,210515603,28017,210543620,37,0,1,37888,37,8139354285
3839,210524777,446249,210971026,20,0,0,14848,20,9217357473
3840,210525076,269721,210794797,11,0,0,9728,11,7599828177
3841,210530589,19312,210549901,26,0,1,6656,26,4493228347
3842,210546387,358359,210904746,19,0,0,29184,19,5439836529
3843,210567708,550231,211117939,22,0,0,15872,22,3666333809
3844,210570976,132970,210703946,36,0,0,8704,36,2872339880
3845,210578802,5501,210584303,12,0,1,1536,12,3072741402
3846,210592934,10656,210603590,8,0,1,5632,8,4593440145
3847,210604928,402099,211007027,17,0,0,9728,17,8259133318
3848,210609612,194146,210803758,32,0,0,3072,32,907248344
3849,210625511,1042,210626553,8,0,1,1024,8,8119982609
3850,210626376,212739,210839115,26,0,0,5120,26,565782827
3851,210638553,153265,210791818,4,0,0,4096,4,7275722551
3852,210667869,150179,210818048,31,0,0,512,31,10168714995
3853,210682891,634373,211317264,1,0,0,11776,1,5670418623
3854,210695495,107312,210802807,12,0,1,146944,12,245291458
3855,210732405,403162,211135567,16,0,0,26624,16,10364156340
3856,210746544,149287,210895831,31,0,0,3072,31,10154304627
3857,210761336,56526,210817862,34,0,1,6144,34,6194951014
3858,210768854,222473,210991327,25,0,0,3072,25,10380198939
3859,210769841,395138,211164979,28,0,0,20992,28,5893943302
3860,210771571,339614,211111185,2,0,0,23552,2,9798165325
3861,210777907,177890,210955797,15,0,0,6656,15,7231814854
3862,210790944,251328,211042272,2,0,0,4608,2,3946666758
3863,210791091,26786,210817877,23,0,1,2560,23,3061013637
3864,210794265,135370,210929635,25,0,0,26624,25,8057094080
3865,210841895,193854,211035749,14,0,0,2048,14,1795669374
3866,210842686,314455,211157141,25,0,0,57344,25,3701218670
3867,210842957,626978,211469935,5,0,0,75264,5,9421643321
3868,210843042,284398,211127440,29,0,0,17920,29,7195813541
3869,210847654,256340,211103994,34,0,0,24576,34,347062759
3870,210855720,309602,211165322,15,0,0,1024,15,3540038107
3871,210857639,389427,211247066,5,0,0,11776,5,2691385457
3872,210865123,364943,211230066,19,0,0,2560,19,1988863002
3873,210866447,273191,211139638,2,0,0,13312,2,5182774079
3874,210869393,289167,211158560,3,0,0,4608,3,9618103089
3875,210870298,339489,211209787,38,0,0,13824,38,10050398614
3876,210886353,20371,210906724,8,0,1,2048,8,8275944445
3877,210895618,13640,210909258,14,0,1,10752,14,4400780631
3878,210913303,457610,211370913,38,0,0,2560,38,2774554766
3879,210933714,179358,211113072,38,0,0,6144,38,2768400371
3880,210939924,467677,211407601,3,0,0,13824,3,8460551188
3881,210951414,225959,211177373,34,0,0,2048,34,9718904366
3882,210968086,395224,211363310,2,0,0,16384,2,4825929341
3883,210982383,445201,211427584,15,0,0,65536,15,10688031077
3884,210983373,308971,211292344,1,0,0,4608,1,4629777261
3885,210986303,304622,211290925,3,0,0,18944,3,2301886900
3886,211034426,5326,211039752,35,0,1,5632,35,7340886798
3887,211053169,130661,211183830,7,0,0,2048,7,3446536703
3888,211105436,120070,211225506,8,0,0,12800,8,7524477186
3889,211109739,568889,211678628,6,0,0,28160,6,8991865679
3890,211134598,395020,211529618,37,0,0,94720,37,7897144808
3891,211137121,422322,211559443,32,0,0,2048,32,10350115255
3892,211143318,156656,211299974,7,0,0,3584,7,10252464964
3893,211159166,323740,211482906,9,0,0,42496,9,106986573
3894,211161504,373285,211534789,36,0,0,16896,36,6457059588
3895,211173384,431205,211604589,3,0,0,31232,3,4249796972
3896,211182534,10757,211193291,14,0,1,17408,14,5424635483
3897,211183894,12303,211196197,7,0,1,4608,7,10623161429
3898,211191187,92153,211283340,7,0,0,16384,7,11527605
3899,211208390,2924,211211314,28,0,1,1536,28,520217097
3900,211209415,83256,211292671,12,0,0,1024,12,5843981892
3901,211223954,324468,211548422,17,0,0,11264,17,3102439610
3902,211226160,3929,211230089,16,0,1,10752,16,9186616508
3903,211228039,580575,211808614,37,0,0,11264,37,9737485140
3904,211265554,3645,211269199,25,0,1,10240,25,8751590590
3905,211272467,378028,211650495,2,0,0,19456,2,8248124009
3906,211272657,272310,211544967,6,0,0,3072,6,6279453101
3907,211292890,207845,211500735,10,0,0,17408,10,1780505930
3908,211306858,188558,211495416,10,0,0,31744,10,1976343545
3909,211323643,3898,211327541,22,0,1,4096,22,10386058463
3910,211329675,286496,211616171,19,0,0,13312,19,8526735383
3911,211335178,213883,211549061,3,0,0,2048,3,3315172694
3912,211336474,207542,211544016,17,0,0,30208,17,5945218953
3913,211337604,148125,211485729,13,0,0,9216,13,8256111174
3914,211345608,3645,211349253,25,0,1,10240,25,9162292577
3915,211347411,228900,211576311,18,0,0,13312,18,7048591420
3916,211352159,231284,211583443,10,0,0,2560,10,7603226733
3917,211356416,36346,211392762,20,0,1,64000,20,2106570483
3918,211367912,28396,211396308,14,0,1,5632,14,1754931495
3919,211383377,411920,211795297,9,0,0,16384,9,1190046750
3920,211410554,258208,211668762,32,0,0,59904,32,2219022755
3921,211410648,29536,211440184,11,0,1,20992,11,9245201161
3922,211419711,363246,211782957,26,0,0,109056,26,6655456192
3923,211429677,182415,211612092,13,0,0,24576,13,2996854790
3924,211448132,221901,211670033,34,0,0,4096,34,6383720132
3925,211483251,334689,211817940,26,0,0,8704,26,7630160942
3926,211498246,354162,211852408,15,0,0,7680,15,8094793306
3927,211512850,551169,212064019,26,0,0,61952,26,3188670198
3928,211523852,29072,211552924,22,0,1,10752,22,1696995972
3929,211546090,351573,211897663,6,0,0,23552,6,6774608892
3930,211555568,271313,211826881,33,0,0,4096,33,7397675299
3931,211570977,7230,211578207,25,0,1,7680,25,8686072845
3932,211589403,206541,211795944,24,0,0,2048,24,899315015
3933,211590013,198466,211788479,24,0,0,1536,24,7140342676
3934,211591604,196392,211787996,38,0,0,16384,38,2816824494
3935,211601561,369538,211971099,38,0,0,6656,38,10679177067
3936,211635747,178099,211813846,35,0,0,13312,35,8218266693
3937,211637256,2470,211639726,32,0,1,2560,32,121267926
3938,211646591,37322,211683913,6,0,1,5632,6,6128036865
3939,211677509,7710,211685219,6,0,1,2048,6,158127251
3940,211683658,516101,212199759,32,0,0,27136,32,7348163392
3941,211696048,418754,212114802,20,0,0,38912,20,7421880801
3942,211701375,113890,211815265,24,0,0,4608,24,9896063384
3943,211702801,219296,211922097,2,0,0,24064,2,4938840802
3944,211707762,181875,211889637,18,0,0,13312,18,3997709826
3945,211709968,237486,211947454,19,0,0,26112,19,8410008944
3946,211734589,172875,211907464,26,0,0,22016,26,4394912083
3947,211753988,348140,212102128,18,0,0,83968,18,6947159075
3948,211757840,38119,211795959,25,0,1,5120,25,5251025552
3949,211764963,451642,212216605,36,0,0,2048,36,7713659163
3950,211766744,457520,212224264,39,0,0,25088,39,9417860973
3951,211779895,220547,212000442,6,0,0,7168,6,1646464414
3952,211781611,197814,211979425,31,0,0,12288,31,2634617858
3953,211785288,340293,212125581,3,0,0,35328,3,4398956896
3954,211792560,176496,211969056,12,0,0,36352,12,4285314984
3955,211812437,9366,211821803,26,0,1,10752,26,570642376
3956,211824712,3422,211828134,27,0,1,3584,27,2516874942
3957,211836950,6278,211843228,2,0,1,6656,2,8785360401
3958,211863617,386542,212250159,22,0,0,31232,22,4661137492
3959,211869336,513362,212382698,16,0,0,19456,16,7316318437
3960,211870065,11274,211881339,3,0,1,18432,3,4814160700
3961,211882793,287516,212170309,8,0,0,21504,8,3113883894
3962,211882957,184786,212067743,35,0,0,5120,35,10002039889
3963,211886049,409637,212295686,5,0,0,66048,5,4439923426
3964,211891335,134623,212025958,32,0,0,2560,32,8106216415
3965,211919687,209365,212129052,22,0,0,11264,22,225387498
3966,211932346,5326,211937672,32,0,1,5632,32,7228946651
3967,211949493,415757,212365250,3,0,0,32768,3,990084323
3968,211953603,368180,212321783,31,0,0,14848,31,9676969853
3969,211955123,611443,212566566,11,0,0,59904,11,5800138389
3970,211963110,9992,211973102,0,0,1,2048,0,3072757569
3971,211970220,339365,212309585,28,0,0,45568,28,867257745
3972,211972441,297545,212269986,31,0,0,65024,31,5140647056
3973,211973881,447553,212421434,30,0,0,25600,30,6221377029
3974,211990357,7230,211997587,23,0,1,7680,23,6542501375
3975,212004272,332461,212336733,11,0,0,11776,11,3430219626
3976,212017185,85738,212102923,25,0,0,2560,25,7465899293
3977,212067094,2635,212069729,0,0,1,2048,0,8559161728
3978,212089481,386243,212475724,33,0,0,45568,33,6814067378
3979,212097370,219874,212317244,12,0,0,25088,12,4747877701
3980,212098068,171941,212270009,12,0,1,193024,12,4347169284
3981,212105027,164997,212270024,26,0,1,5120,26,9964795
3982,212143332,381677,212525009,38,0,0,71680,38,1908796985
3983,212162730,107309,212270039,28,0,1,4608,28,810584595
3984,212167928,503464,212671392,37,0,0,34816,37,1693138150
3985,212171418,98636,212270054,22,0,1,1536,22,407083500
3986,212174131,362616,212536747,25,0,0,38400,25,9497157005
3987,212204619,257198,212461817,8,0,0,25600,8,226506082
3988,212223802,392254,212616056,28,0,0,29184,28,4148113604
3989,212226334,43735,212270069,18,0,1,9728,18,7455887817
3990,212235026,258043,212493069,9,0,0,4608,9,7281717517
3991,212244652,29821,212274473,35,0,1,11776,35,7674720353
3992,212269296,158399,212427695,0,0,0,9728,0,4149081567
3993,212321881,4850,212326731,1,0,1,5120,1,2635065087
3994,212327475,263723,212591198,14,0,0,15360,14,3613088655
3995,212333337,144430,212477767,37,0,0,6656,37,5627586870
3996,212338246,7230,212345476,21,0,1,7680,21,2302717820
3997,212360729,369775,212730504,28,0,0,14848,28,1515873490
3998,212363857,274608,212638465,0,0,0,30720,0,1070031150
3999,212371357,2470,212373827,18,0,1,2560,18,8744538713
4000,212380045,226723,212606768,22,0,0,47616,22,4723199554
4001,212417688,201191,212618879,3,0,0,9216,3,5136601470
4002,212422087,268665,212690752,20,0,0,3584,20,9560562447
4003,212436124,752792,213188916,12,0,0,21504,12,5115195419
4004,212457962,278038,212736000,16,0,0,7680,16,10597134244
4005,212472207,425694,212897901,38,0,0,39424,38,848955266
4006,212473673,299458,212773131,9,0,0,32256,9,2579622786
4007,212476547,286733,212763280,29,0,0,75264,29,2386069710
4008,212486904,348408,212835312,33,0,0,28672,33,3623396199
4009,212498163,3921,212502084,22,0,1,10752,22,10161479207
4010,212498168,26856,212525024,1,0,1,5120,1,7745451706
4011,212509569,340110,212849679,25,0,0,47104,25,2915597811
4012,212530576,324266,212854842,6,0,0,16896,6,5249508885
4013,212543797,2470,212546267,12,0,1,2560,12,8115517803
4014,212561934,15123,212577057,14,0,1,16896,14,3292936033
4015,212571582,622193,213193775,7,0,0,15872,7,2704525429
4016,212579899,600875,213180774,9,0,0,156160,9,7026453152
4017,212580857,357038,212937895,26,0,0,22016,26,3470299647
4018,212592700,230170,212822870,19,0,0,22528,19,4814064945
4019,212618315,442913,213061228,8,0,0,24064,8,885472084
4020,212647436,583698,213231134,31,0,0,84992,31,9105625432
4021,212655807,439726,213095533,24,0,0,40448,24,1005648495
4022,212671841,101773,212773614,3,0,0,1536,3,1062368328
4023,212674539,605491,213280030,18,0,0,38400,18,1878208022
4024,212678703,147858,212826561,8,0,0,3584,8,4804702663
4025,212679775,251058,212930833,10,0,0,22016,10,10388245742
4026,212683911,317005,213000916,28,0,0,31232,28,1225494945
4027,212684752,567933,213252685,21,0,0,70656,21,3153426757
4028,212685453,603671,213289124,33,0,0,2560,33,4709812082
4029,212694728,5802,212700530,6,0,1,6144,6,8323558324
4030,212720017,614307,213334324,10,0,0,38400,10,5796943695
4031,212730050,619093,213349143,25,0,0,9728,25,3025822064
4032,212732686,3329,212736015,18,0,1,1536,18,5963531450
4033,212734542,122031,212856573,24,0,0,5632,24,4082235578
4034,212741619,372212,213113831,38,0,0,36352,38,9483843702
4035,212782172,87332,212869504,32,0,0,13312,32,9126869702
4036,212787989,412212,213200201,36,0,0,16896,36,231432769
4037,212788125,195094,212983219,10,0,0,16384,10,6805732104
4038,212796879,11274,212808153,23,0,1,18432,23,3436286323
4039,212887114,407189,213294303,1,0,0,16896,1,4926220454
4040,212890360,212372,213102732,30,0,0,23552,30,6368070449
4041,212907630,146251,213053881,29,0,0,10240,29,9845742024
4042,212929059,8996,212938055,32,0,1,7680,32,644583415
4043,212933918,135460,213069378,27,0,0,10752,27,9149855269
4044,212935535,2943,212938478,8,0,1,512,8,6270233154
4045,212941105,534137,213475242,20,0,0,46592,20,4867835000
4046,212943755,6278,212950033,8,0,1,6656,8,6901088712
4047,212960731,307584,213268315,0,0,0,37888,0,9524215202
4048,212964399,377664,213342063,6,0,0,6656,6,9445105530
4049,212978105,204244,213182349,6,0,0,5120,6,932326676
4050,213013107,275206,213288313,36,0,0,27136,36,7241992006
4051,213037639,162889,213200528,16,0,0,1024,16,4047777902
4052,213052536,204220,213256756,6,0,0,13312,6,8623565598
4053,213054186,151037,213205223,25,0,0,15360,25,250919188
4054,213068993,126045,213195038,22,0,0,4096,22,7417211108
4055,213072544,346526,213419070,18,0,0,23552,18,1999219356
4056,213086161,486645,213572806,12,0,0,101888,12,5878992581
4057,213093552,310930,213404482,2,0,0,55808,2,3218748002
4058,213113844,184101,213297945,16,0,0,11776,16,3156593079
4059,213122889,412017,213534906,39,0,0,13312,39,6377267371
4060,213150087,278077,213428164,14,0,0,21504,14,9356962105
4061,213199599,94743,213294342,0,0,1,1536,0,1016069121
4062,213226594,373978,213600572,17,0,0,20992,17,2836270833
4063,213235416,410360,213645776,4,0,0,54784,4,10536503596
4064,213247666,492984,213740650,37,0,0,47104,37,7566628122
4065,213263350,143648,213406998,11,0,0,7168,11,9613502163
4066,213272833,46470,213319303,14,0,1,34816,14,10544169805
4067,213272834,61505,213334339,10,0,1,30208,10,2692332069
4068,213301949,217596,213519545,36,0,0,16384,36,4569404696
4069,213336186,746494,214082680,35,0,0,48128,35,4935127593
4070,213376996,4162,213381158,35,0,1,11264,35,2084586830
4071,213385514,410402,213795916,6,0,0,512,6,8846168676
4072,213388508,399436,213787944,13,0,0,38912,13,8092675887
4073,213390273,370371,213760644,29,0,0,14848,29,5180119075
4074,213394483,259600,213654083,31,0,0,27136,31,3391221470
4075,213410738,472898,213883636,28,0,0,67584,28,9873484799
4076,213424446,204623,213629069,34,0,0,45568,34,4001627420
4077,213458809,751140,214209949,35,0,0,2560,35,9151577174
4078,213461358,59072,213520430,16,0,1,77824,16,9417863726
4079,213463794,58262,213522056,6,0,1,2560,6,9643129827
4080,213479770,243938,213723708,39,0,1,362496,39,5595246106
4081,213494692,436631,213931323,16,0,0,78848,16,948366833
4082,213502106,387320,213889426,24,0,0,18944,24,3447757430
4083,213523807,268364,213792171,31,0,0,13824,31,1143192985
4084,213524015,191037,213715052,6,0,0,38400,6,8393789590
4085,213524967,319089,213844056,34,0,0,14848,34,6431806407
4086,213546282,177887,213724169,0,0,1,10240,0,6078827268
4087,213561154,769904,214331058,0,0,0,30208,0,7613793087
4088,213573397,289094,213862491,29,0,0,512,29,5977227539
4089,213598318,534063,214132381,20,0,0,20480,20,876752447
4090,213625945,322149,213948094,2,0,0,15872,2,2795797594
4091,213630877,129782,213760659,20,0,1,124928,20,8217952800
4092,213631688,418760,214050448,21,0,0,22016,21,3780670037
4093,213681948,825851,214507799,4,0,0,20480,4,3626373465
4094,213695129,67698,213762827,8,0,1,3584,8,1143164575
4095,213709555,53733,213763288,31,0,1,10240,31,1048075678
4096,213716061,711502,214427563,4,0,0,5632,4,734224444
4097,213751751,288387,214040138,36,0,0,28672,36,10319900848
4098,213762505,491634,214254139,22,0,0,35840,22,9574231613
4099,213774786,338557,214113343,25,0,0,5120,25,1512885579
4100,213784181,317603,214101784,10,0,0,29184,10,1212613447
4101,213788298,6360,213794658,8,0,1,2560,8,6801635200
4102,213796489,259809,214056298,8,0,0,512,8,4100665533
4103,213808847,302913,214111760,18,0,0,30720,18,1268725926
4104,213840384,341353,214181737,30,0,0,31232,30,3009464417
4105,213846523,734241,214580764,3,0,0,4608,3,6811225976
4106,213848092,577740,214425832,8,0,0,27136,8,4994682091
4107,213849033,205798,214054831,33,0,0,14336,33,10204467448
4108,213890766,442179,214332945,35,0,0,6144,35,437403396
4109,213905579,638327,214543906,18,0,0,10240,18,227789560
4110,213923275,285879,214209154,31,0,0,53760,31,5368062192
4111,213951175,333352,214284527,37,0,0,18432,37,8114700697
4112,213982107,296773,214278880,11,0,0,51200,11,3639140024
4113,213983628,148768,214132396,12,0,1,232960,12,7402190542
4114,213993114,456876,214449990,0,0,0,16384,0,7089322784
4115,214004922,257533,214262455,0,0,0,7680,0,2205287540
4116,214027666,410967,214438633,12,0,0,512,12,6818018096
4117,214029532,472004,214501536,34,0,0,28160,34,4748562969
4118,214080404,309875,214390279,1,0,0,14336,1,2830408467
4119,214102397,307773,214410170,5,0,0,11264,5,5079365737
4120,214124429,258023,214382452,30,0,0,1024,30,10652346279
4121,214128620,241352,214369972,37,0,0,5120,37,6915834109
4122,214167878,181102,214348980,16,0,0,28672,16,10434665637
4123,214168728,313294,214482022,39,0,0,13824,39,8714216450
4124,214188853,390492,214579345,4,0,0,21504,4,600378059
4125,214207533,9179,214216712,27,0,1,7168,27,10234291627
4126,214207665,567085,214774750,16,0,0,74752,16,9031295094
4127,214211186,299132,214510318,6,0,0,8192,6,4992919079
4128,214228076,500258,214728334,24,0,0,26112,24,2728143842
4129,214235417,1994,214237411,30,0,1,2048,30,3239199877
4130,214238070,290056,214528126,18,0,0,18944,18,7366291724
4131,214240619,142628,214383247,28,0,0,2560,28,5586170184
4132,214245142,209699,214454841,0,0,0,15872,0,4941541731
4133,214258676,123449,214382125,3,0,0,18944,3,1633477044
4134,214265917,30102,214296019,11,0,1,18944,11,3006896740
4135,214275624,365587,214641211,9,0,0,20480,9,5365879339
4136,214286349,406060,214692409,29,0,0,42496,29,284958672
4137,214297608,513098,214810706,31,0,0,9728,31,10404630851
4138,214373023,1042,214374065,23,0,1,1024,23,4684609522
4139,214403544,513328,214916872,27,0,0,31232,27,10163785471
4140,214412341,212202,214624543,29,0,0,13824,29,5526743515
4141,214415226,301222,214716448,20,0,0,78848,20,5186952956
4142,214438849,359940,214798789,9,0,0,78848,9,649104192
4143,214473176,247187,214720363,12,0,0,12800,12,4941671320
4144,214480364,145286,214625650,9,0,0,3584,9,8704525768
4145,214497110,325654,214822764,34,0,0,512,34,4908524134
4146,214503813,295771,214799584,11,0,0,2560,11,7098732656
4147,214510252,312325,214822577,22,0,0,38912,22,1351472910
4148,214514746,561904,215076650,13,0,0,9216,13,993007680
4149,214519808,317460,214837268,17,0,0,17920,17,9300487548
4150,214526983,313828,214840811,34,0,0,1024,34,6352162061
4151,214530653,409010,214939663,13,0,0,74752,13,8113371190
4152,214541188,116373,214657561,33,0,0,5120,33,664161776
4153,214548894,4850,214553744,9,0,1,5120,9,10415550383
4154,214562533,344808,214907341,31,0,0,18432,31,3975570727
4155,214564001,6229,214570230,23,0,1,15360,23,5037785196
4156,214567835,321564,214889399,27,0,0,1024,27,1621466963
4157,214581811,307261,214889072,16,0,0,26624,16,895265647
4158,214583737,448852,215032589,2,0,0,62464,2,1957205441
4159,214602583,55562,214658145,16,0,1,94720,16,5128207825
4160,214604833,384132,214988965,3,0,0,25088,3,4243566751
4161,214608588,243253,214851841,15,0,0,7680,15,3856463264
4162,214621278,319336,214940614,14,0,0,3072,14,4758773254
4163,214630887,314989,214945876,28,0,0,9728,28,8243550742
4164,214638759,168968,214807727,11,0,0,26624,11,1840740789
4165,214647284,97354,214744638,16,0,1,162816,16,3734427337
4166,214677243,323511,215000754,1,0,0,27648,1,4261037615
4167,214705676,42828,214748504,22,0,1,6144,22,2154237116
4168,214734827,562424,215297251,18,0,0,27648,18,3407755893
4169,214735164,316442,215051606,10,0,0,7680,10,8422170072
4170,214737144,205753,214942897,19,0,0,3584,19,3716454786
4171,214768676,75259,214843935,32,0,1,34816,32,3964150366
4172,214777611,164002,214941613,25,0,0,3072,25,8024824403
4173,214803185,277383,215080568,36,0,0,4096,36,10183629502
4174,214845079,366922,215212001,30,0,0,26112,30,7221132704
4175,214848359,157071,215005430,30,0,1,259072,30,8159435276
4176,214849370,198228,215047598,5,0,0,4608,5,3501398865
4177,214869267,283910,215153177,13,0,0,9216,13,8274636780
4178,214873577,349236,215222813,26,0,0,24064,26,6482948035
4179,214882070,673939,215556009,11,0,0,36864,11,10307541887
4180,214912392,95304,215007696,6,0,1,3584,6,6854249942
4181,214922339,281683,215204022,14,0,0,96256,14,845050904
4182,214943391,468972,215412363,27,0,0,70656,27,9752781417
4183,214946569,86035,215032604,16,0,1,62976,16,7342587532
4184,214979224,245632,215224856,29,0,0,6656,29,556105136
4185,214982401,473347,215455748,31,0,0,17920,31,9025547711
4186,215001521,277428,215278949,18,0,0,45568,18,10010131557
4187,215001731,30888,215032619,32,0,1,8192,32,2100356362
4188,215062324,436516,215498840,2,0,0,68608,2,9541168842
4189,215070794,515132,215585926,32,0,0,8192,32,2878561148
4190,215079758,644010,215723768,4,0,0,33280,4,2475982788
4191,215103922,568430,215672352,9,0,0,76288,9,7758032130
4192,215104129,2946,215107075,26,0,1,3072,26,5536802079
4193,215118234,694211,215812445,31,0,0,2048,31,4773428410
4194,215124403,442891,215567294,16,0,0,36864,16,5593854172
4195,215188475,657882,215846357,27,0,0,79360,27,8466132390
4196,215200434,12167,215212601,23,0,1,512,23,8094864387
4197,215201424,12285,215213709,8,0,1,1536,8,2352012697
4198,215207435,886277,216093712,27,0,0,36864,27,9618311819
4199,215213658,602702,215816360,5,0,0,12800,5,174878490
4200,215216801,769039,215985840,37,0,0,16384,37,2844209101
4201,215223788,280174,215503962,1,0,0,8704,1,211537165
4202,215238933,559130,215798063,34,0,0,60416,34,10452001623
4203,215239682,572124,215811806,22,0,0,45056,22,3825921634
4204,215259818,734054,215993872,35,0,0,26112,35,8911563229
4205,215261592,960892,216222484,4,0,0,70144,4,2799875719
4206,215271453,8572,215280025,31,0,1,1024,31,4351921040
4207,215272064,806351,216078415,17,0,0,7680,17,1815964169
4208,215276614,306763,215583377,35,0,0,52736,35,9631676164
4209,215290039,10668,215300707,34,0,1,3584,34,6781172890
4210,215292606,613258,215905864,38,0,0,195072,38,10344952104
4211,215295570,7486,215303056,35,0,1,12288,35,4338685490
4212,215303612,625612,215929224,13,0,0,5120,13,7681770457
4213,215329646,126117,215455763,13,0,1,204800,13,5316259295
4214,215336284,119494,215455778,9,0,1,10752,9,9027053776
4215,215339335,116933,215456268,27,0,1,3072,27,3699597448
4216,215353490,370769,215724259,0,0,0,1536,0,1490060838
4217,215369915,171964,215541879,12,0,1,206848,12,4869196076
4218,215376363,166822,215543185,21,0,1,2048,21,9438120277
4219,215397899,158133,215556032,1,0,1,26112,1,9557981167
4220,215403240,652090,216055330,20,0,0,4608,20,10470674295
4221,215412272,568561,215980833,37,0,0,65024,37,4573608618
4222,215431576,591024,216022600,5,0,0,11776,5,594827352
4223,215456672,99375,215556047,6,0,1,5120,6,3755771848
4224,215465269,356893,215822162,34,0,0,3584,34,2495565641
4225,215473719,109681,215583400,21,0,1,2560,21,10424984348
4226,215484007,466858,215950865,28,0,0,17920,28,5126653317
4227,215505658,679347,216185005,15,0,0,512,15,5565203661
4228,215518997,64418,215583415,35,0,1,9728,35,6773902263
4229,215524471,387360,215911831,6,0,0,19456,6,2685489869
4230,215528006,417384,215945390,3,0,0,17920,3,10372684477
4231,215528202,607702,216135904,17,0,0,15872,17,188753533
4232,215536002,403913,215939915,19,0,0,18432,19,7099048782
4233,215545994,381655,215927649,6,0,0,16384,6,720208679
4234,215552740,369894,215922634,34,0,0,35328,34,3315873354
4235,215564806,31395,215596201,20,0,1,16384,20,7885456971
4236,215576524,442450,216018974,15,0,0,45056,15,5917538591
4237,215584087,522892,216106979,18,0,0,28160,18,10703074381
4238,215588110,721261,216309371,2,0,0,13312,2,7965418926
4239,215588470,345784,215934254,34,0,0,6656,34,1219580488
4240,215592819,145302,215738121,34,0,0,1536,34,1863417614
4241,215596736,426815,216023551,9,0,0,3072,9,4505627010
4242,215606460,786965,216393425,0,0,0,33280,0,5382587964
4243,215606804,7706,215614510,15,0,1,8192,15,8497643739
4244,215614606,206449,215821055,27,0,0,15360,27,2210187818
4245,215614839,566,215615405,9,0,1,512,9,6873476068
4246,215636342,3387,215639729,9,0,1,9728,9,4190412662
4247,215653969,547128,216201097,24,0,0,14848,24,1388832390
4248,215666813,499778,216166591,17,0,0,11776,17,5870816955
4249,215679169,1042,215680211,1,0,1,1024,1,1423712927
4250,215679579,2470,215682049,31,0,1,2560,31,3538528387
4251,215693014,355542,216048556,7,0,0,4608,7,505074113
4252,215714227,217984,215932211,12,0,0,9728,12,1243023662
4253,215732634,382940,216115574,4,0,0,28160,4,1794602230
4254,215749596,184673,215934269,30,0,1,277504,30,738160447
4255,215768711,456284,216224995,31,0,0,8192,31,5687360845
4256,215783423,342578,216126001,11,0,0,1536,11,6776723431
4257,215792345,440332,216232677,37,0,0,9728,37,5984471684
4258,215813151,492141,216305292,15,0,0,45568,15,6151277084
4259,215821186,453247,216274433,35,0,0,512,35,4007559217
4260,215821652,112632,215934284,8,0,1,3072,8,9129954167
4261,215841839,144032,215985871,13,0,1,118784,13,10221480565
4262,215847047,138839,215985886,34,0,1,2560,34,9302853155
4263,215853169,438224,216291393,6,0,0,31232,6,5084066586
4264,215872596,113305,215985901,21,0,1,2048,21,4846640866
4265,215873660,120235,215993895,11,0,1,35840,11,8786191020
4266,215877353,122844,216000197,20,0,1,23040,20,7572804909
4267,215885202,511678,216396880,17,0,0,11264,17,6121817502
4268,215970653,48336,216018989,10,0,1,17408,10,2860660163
4269,215979531,540294,216519825,8,0,0,45568,8,6323381803
4270,216017209,320098,216337307,2,0,0,4096,2,6587974686
4271,216031862,2470,216034332,27,0,1,2560,27,7543597765
4272,216045290,4850,216050140,14,0,1,5120,14,4583529970
4273,216049327,329336,216378663,15,0,0,52224,15,8756246064
4274,216053090,176600,216229690,39,0,0,15360,39,1078127816
4275,216081427,384640,216466067,15,0,0,23552,15,9928529460
4276,216090100,7978,216098078,20,0,1,4608,20,10397038347
4277,216111585,296856,216408441,0,0,0,7680,0,10244317511
4278,216116193,457792,216573985,12,0,0,4608,12,5023151293
4279,216125971,511984,216637955,36,0,0,10752,36,2615825787
4280,216141661,701666,216843327,10,0,0,70656,10,2102871095
4281,216153703,552073,216705776,10,0,0,87040,10,9032724280
4282,216224841,9338,216234179,28,0,1,1536,28,6272475835
4283,216226859,662668,216889527,27,0,0,30208,27,5501941897
4284,216235710,215417,216451127,22,0,0,14848,22,5825295202
4285,216246994,192043,216439037,9,0,0,1024,9,5132445944
4286,216249854,11274,216261128,19,0,1,18432,19,8888431824
4287,216264304,220051,216484355,39,0,0,512,39,3047479839
4288,216266166,665261,216931427,3,0,0,58880,3,8754022456
4289,216276273,823562,217099835,36,0,0,37888,36,375084127
4290,216277495,319001,216596496,1,0,0,4096,1,6629426161
4291,216293821,446939,216740760,27,0,0,14336,27,3906204873
4292,216298866,426748,216725614,20,0,0,22016,20,8048812106
4293,216302612,407703,216710315,19,0,0,14848,19,1924497880
4294,216313096,3645,216316741,35,0,1,10240,35,3206679269
4295,216313642,340208,216653850,32,0,0,9728,32,7577169648
4296,216319491,270212,216589703,35,0,0,38912,35,5653482360
4297,216319973,652731,216972704,26,0,0,61440,26,1328590797
4298,216342237,447184,216789421,24,0,0,18432,24,8263940721
4299,216350841,432949,216783790,20,0,0,46592,20,4519327565
4300,216354185,257983,216612168,8,0,0,5120,8,9274686953
4301,216376864,608210,216985074,7,0,0,11264,7,1300692616
4302,216384753,15990,216400743,0,0,1,10752,0,691045824
4303,216421087,1042,216422129,32,0,1,1024,32,9319595805
4304,216433148,356600,216789748,37,0,0,1024,37,1208212380
4305,216438453,405728,216844181,10,0,0,512,10,1463290225
4306,216449958,638318,217088276,28,0,0,18944,28,7822859545
4307,216452384,529227,216981611,24,0,0,29184,24,6694793281
4308,216468246,1042,216469288,14,0,1,1024,14,4711459230
4309,216480934,1042,216481976,25,0,1,1024,25,3256970175
4310,216490168,669544,217159712,22,0,0,120320,22,8556428878
4311,216503889,118314,216622203,16,0,0,512,16,1324600603
4312,216506384,859828,217366212,32,0,0,38400,32,5742304307
4313,216524358,282051,216806409,12,0,0,4608,12,8618237962
4314,216526422,916856,217443278,27,0,0,4096,27,4943445584
4315,216540857,833794,217374651,12,0,0,27648,12,9831637016
4316,216545306,246173,216791479,5,0,0,5632,5,9966443713
4317,216562771,5326,216568097,8,0,1,5632,8,3092604035
4318,216564631,7012,216571643,1,0,1,5632,1,4331101387
4319,216580652,635235,217215887,2,0,0,42496,2,47421501
4320,216583186,1751830,218335016,22,0,0,48640,22,8205504496
4321,216587150,158515,216745665,12,0,0,4096,12,5730264604
4322,216588312,607264,217195576,1,0,0,9728,1,5377254920
4323,216600489,4850,216605339,10,0,1,5120,10,2835180786
4324,216611518,2160,216613678,25,0,1,1536,25,6910074773
4325,216626658,478964,217105622,13,0,0,18944,13,4213716173
4326,216670514,411967,217082481,26,0,0,27136,26,8528127379
4327,216697384,1300940,217998324,18,0,0,4096,18,4819916395
4328,216704508,1441536,218146044,21,0,0,92672,21,2129455419
4329,216709340,833102,217542442,18,0,0,128512,18,7317100739
4330,216724066,926242,217650308,0,0,0,122880,0,2627319965
4331,216745515,541913,217287428,20,0,0,23040,20,910776863
4332,216750432,95287,216845719,16,0,1,158720,16,4018992846
4333,216757934,521867,217279801,3,0,0,15872,3,3576896922
4334,216760123,1519731,218279854,10,0,0,66048,10,5812614703
4335,216761834,462819,217224653,18,0,0,28672,18,6039800911
4336,216769980,525746,217295726,27,0,0,27136,27,3527164127
4337,216774653,74292,216848945,1,0,1,5120,1,6487232179
4338,216806706,314302,217121008,31,0,0,9216,31,9739412724
4339,216835405,15486,216850891,34,0,1,3072,34,1324727761
4340,216849865,1375932,218225797,17,0,0,59904,17,5369245302
4341,216858667,799806,217658473,32,0,0,512,32,8837059164
4342,216863429,297896,217161325,33,0,0,5120,33,4557073064
4343,216868309,238748,217107057,12,0,0,4608,12,5875055852
4344,216909277,320235,217229512,29,0,0,15872,29,10393865691
4345,216910890,20552,216931442,5,0,1,5632,5,7234414647
4346,216935482,1625795,218561277,3,0,0,56832,3,2731779381
4347,216937288,4850,216942138,21,0,1,5120,21,3530035484
4348,216961914,211900,217173814,12,0,0,8704,12,6508173531
4349,216967167,20361,216987528,8,0,1,2560,8,1717726242
4350,216979788,184264,217164052,39,0,0,2048,39,7826189317
4351,217020499,320671,217341170,38,0,0,13824,38,326429117
4352,217029655,710159,217739814,32,0,0,26112,32,6137434459
4353,217041499,255178,217296677,27,0,0,3072,27,5405167506
4354,217054405,6278,217060683,2,0,1,6656,2,3230253451
4355,217075891,247491,217323382,20,0,0,4608,20,339471349
4356,217084569,344106,217428675,4,0,0,49664,4,4387264900
4357,217085347,27496,217112843,28,0,1,6144,28,2656289279
4358,217096991,365601,217462592,34,0,0,23040,34,9682122142
4359,217106737,6772,217113509,22,0,1,1024,22,1473723705
4360,217118188,41539,217159727,9,0,1,4608,9,9628923743
4361,217118374,41368,217159742,26,0,1,6144,26,5213176915
4362,217139824,522612,217662436,10,0,0,12800,10,934740275
4363,217150206,1566082,218716288,6,0,0,44032,6,2775965948
4364,217163430,415458,217578888,21,0,0,109056,21,2238805055
4365,217169399,4430,217173829,35,0,1,2048,35,706963390
4366,217169756,330938,217500694,33,0,0,13824,33,560289984
4367,217188282,1329076,218517358,28,0,0,8704,28,726981730
4368,217195239,2799,217198038,10,0,1,2560,10,9940296402
4369,217196625,415962,217612587,31,0,0,6656,31,1934964394
4370,217201099,14803,217215902,27,0,1,8704,27,6138661950
4371,217211596,446706,217658302,12,0,0,26112,12,1265582396
4372,217228448,715730,217944178,35,0,0,90624,35,3721034488
4373,217232882,566,217233448,23,0,1,512,23,3423224720
4374,217246659,188509,217435168,37,0,0,1536,37,3617913806
4375,217249038,447394,217696432,25,0,0,18944,25,6669283376
4376,217259629,689088,217948717,21,0,0,14848,21,9020998468
4377,217261677,919185,218180862,9,0,0,17408,9,118193049
4378,217266372,1040717,218307089,8,0,0,8192,8,1191575416
4379,217268966,18477,217287443,32,0,1,29696,32,1792355433
4380,217286267,1077061,218363328,14,0,0,25088,14,253042534
4381,217307950,653464,217961414,10,0,0,10240,10,3113560946
4382,217331662,723986,218055648,22,0,0,10752,22,4027433037
4383,217344291,751599,218095890,20,0,0,59904,20,2194016270
4384,217344846,914869,218259715,36,0,0,84992,36,7629122185
4385,217388441,275882,217664323,1,0,0,6144,1,4536253145
4386,217456410,9302,217465712,21,0,1,9216,21,1169965191
4387,217468960,447108,217916068,15,0,0,67072,15,4247408373
4388,217483679,465833,217949512,14,0,0,2560,14,1986085191
4389,217499077,4079,217503156,27,0,1,2560,27,3993042618
4390,217505196,1347503,218852699,13,0,0,60928,13,10574006570
4391,217506069,282397,217788466,0,0,0,39936,0,5603034077
4392,217528874,235459,217764333,3,0,0,14848,3,10734165962
4393,217529805,13763,217543568,15,0,1,1024,15,5795716180
4394,217534384,1525633,219060017,21,0,0,128000,21,121374810
4395,217548664,36085,217584749,14,0,1,6144,14,9783552532
4396,217553565,1372472,218926037,24,0,0,68608,24,8296454133
4397,217558769,27286,217586055,34,0,1,2048,34,681453016
4398,217575690,382573,217958263,28,0,0,28672,28,8481630460
4399,217592025,324526,217916551,35,0,0,1536,35,5027724240
4400,217604098,46233,217650331,25,0,1,23040,25,5664625534
4401,217613434,682229,218295663,3,0,0,19456,3,8943429917
4402,217624381,341744,217966125,1,0,0,15360,1,6562461219
4403,217628141,547402,218175543,6,0,0,96768,6,9084504533
4404,217637527,233860,217871387,11,0,0,2560,11,5871446701
4405,217640711,339625,217980336,28,0,0,32768,28,5152072518
4406,217650443,220149,217870592,20,0,0,17408,20,9187783130
4407,217651077,702992,218354069,31,0,0,34304,31,6002411998
4408,217670596,536622,218207218,15,0,0,3072,15,4547459395
4409,217681629,1042,217682671,34,0,1,1024,34,6892085372
4410,217682571,392087,218074658,35,0,0,13312,35,10565279976
4411,217684738,630478,218315216,5,0,0,26624,5,9654016814
4412,217715264,490971,218206235,19,0,0,61440,19,3746146751
4413,217718514,4850,217723364,14,0,1,5120,14,7397091856
4414,217745248,765988,218511236,10,0,0,83968,10,681685305
4415,217759336,5012,217764348,22,0,1,1536,22,8716096279
4416,217767504,458635,218226139,3,0,0,1024,3,7640070253
4417,217782511,223618,218006129,38,0,0,512,38,6529589518
4418,217794803,4374,217799177,20,0,1,4608,20,1391958794
4419,217806182,5196,217811378,24,0,1,13312,24,6222321113
4420,217818946,5326,217824272,22,0,1,5632,22,7216993640
4421,217830332,1042,217831374,2,0,1,1024,2,1207932051
4422,217850626,439094,218289720,8,0,0,14336,8,5256698066
4423,217871703,575535,218447238,36,0,0,27136,36,8549553022
4424,217883257,600946,218484203,0,0,0,67072,0,9332469439
4425,217887655,1042,217888697,37,0,1,1024,37,10696193234
4426,217894363,291678,218186041,33,0,0,16896,33,394557463
4427,217936737,1235762,219172499,6,0,0,32256,6,1132882996
4428,217941822,465480,218407302,16,0,0,3584,16,1119601002
4429,217956268,670035,218626303,28,0,0,47104,28,1995113272
4430,217958423,623617,218582040,4,0,0,68096,4,5889475939
4431,217967328,759996,218727324,34,0,0,20480,34,10199309434
4432,217970993,216475,218187468,0,0,0,4608,0,8780774931
4433,217972470,11787,217984257,4,0,1,10752,4,5251123572
4434,218003313,282016,218285329,13,0,0,17920,13,627931674
4435,218004884,509799,218514683,25,0,0,11264,25,5062071987
4436,218013791,585276,218599067,4,0,0,55808,4,9337462407
4437,218029858,274720,218304578,30,0,0,29184,30,5114405777
4438,218061130,276709,218337839,18,0,0,9216,18,1615280086
4439,218078769,151403,218230172,29,0,0,6144,29,10442443229
4440,218103028,1994,218105022,34,0,1,2048,34,7724425060
4441,218116601,224997,218341598,21,0,0,12288,21,8401825294
4442,218130767,1270318,219401085,7,0,0,11776,7,6693331784
4443,218144502,1384877,219529379,19,0,0,115200,19,8586733433
4444,218149471,76341,218225812,26,0,1,1536,26,2492577487
4445,218155276,485693,218640969,37,0,0,4608,37,10694854617
4446,218161921,928623,219090544,2,0,0,44544,2,8148447096
4447,218162507,438135,218600642,7,0,0,5120,7,1279917868
4448,218165467,229139,218394606,0,0,0,5632,0,4345328778
4449,218184927,426985,218611912,32,0,0,36352,32,8054360364
4450,218190623,295014,218485637,13,0,0,4608,13,1869462274
4451,218191703,348793,218540496,38,0,0,1024,38,6489446763
4452,218214765,998276,219213041,20,0,0,25088,20,2546140294
4453,218250771,66473,218317244,28,0,1,2048,28,4416305386
4454,218263824,419839,218683663,39,0,0,68608,39,9175003502
4455,218271200,82884,218354084,12,0,1,55808,12,9755405326
4456,218276857,828857,219105714,22,0,0,29696,22,8881366109
4457,218277982,479190,218757172,37,0,0,16896,37,2991367742
4458,218289296,65663,218354959,9,0,1,16384,9,1704051129
4459,218301287,768433,219069720,21,0,0,31744,21,5668113716
4460,218332295,33494,218365789,23,0,1,43520,23,2925731542
4461,218346824,253989,218600813,18,0,0,512,18,841318453
4462,218362613,1325015,219687628,6,0,0,21504,6,1243064384
4463,218413365,3422,218416787,25,0,1,3584,25,7146410317
4464,218421830,546495,218968325,14,0,0,46080,14,4529159964
4465,218431332,966150,219397482,35,0,0,25600,35,9085436797
4466,218447601,1479432,219927033,20,0,0,31232,20,10667880770
4467,218453134,31084,218484218,14,0,1,17920,14,2540231687
4468,218459811,57562,218517373,30,0,1,72704,30,7543051013
4469,218489165,148483,218637648,9,0,0,4096,9,7272741574
4470,218570871,55455,218626326,19,0,1,18432,19,1078450980
4471,218593149,1548707,220141856,3,0,0,8192,3,10483782994
4472,218597861,544095,219141956,7,0,0,2048,7,1796862820
4473,218599149,31963,218631112,25,0,1,5120,25,10131513589
4474,218612138,23480,218635618,18,0,1,7168,18,6117870973
4475,218615322,20962,218636284,35,0,1,1024,35,1196350698
4476,218618285,19378,218637663,19,0,1,512,19,5210191208
4477,218631228,7668,218638896,9,0,1,3584,9,10342834195
4478,218635406,13083,218648489,18,0,1,22016,18,8966324477
4479,218640656,623519,219264175,9,0,0,23040,9,7047013400
4480,218661841,21837,218683678,14,0,1,19968,14,7123524630
4481,218693667,304909,218998576,33,0,0,64000,33,5984309086
4482,218752628,426134,219178762,39,0,0,20480,39,293259692
4483,218774649,166388,218941037,7,0,0,4096,7,4294140211
4484,218796150,409208,219205358,34,0,0,8192,34,6800638010
4485,218801389,312054,219113443,24,0,0,14848,24,2866246630
4486,218801393,392516,219193909,18,0,0,49664,18,2530783179
4487,218838174,166829,219005003,38,0,0,20992,38,2204580246
4488,218841557,1432170,220273727,37,0,0,76800,37,3455623366
4489,218842932,444614,219287546,3,0,0,7680,3,1933265173
4490,218860287,216654,219076941,20,0,0,13824,20,859589261
4491,218861343,4850,218866193,34,0,1,5120,34,10251991014
4492,218865836,206863,219072699,37,0,0,9728,37,2100241187
4493,218867655,522012,219389667,3,0,0,71168,3,7290180026
4494,218868046,228605,219096651,35,0,0,19968,35,7157413948
4495,218872852,251214,219124066,11,0,0,34816,11,4635008977
4496,218875689,1994,218877683,31,0,1,2048,31,8116709719
4497,218893281,309566,219202847,3,0,0,25088,3,3957155001
4498,218894535,7230,218901765,21,0,1,7680,21,7654072796
4499,218894616,419554,219314170,0,0,0,3072,0,864551515
4500,218899268,208185,219107453,38,0,0,5632,38,6326402219
4501,218912139,108490,219020629,8,0,1,154112,8,5313468249
4502,218935521,1509649,220445170,18,0,0,22528,18,3217488184
4503,218973340,160983,219134323,31,0,0,1024,31,885934016
4504,218981207,91507,219072714,30,0,1,67584,30,48800035
4505,218981641,167855,219149496,18,0,0,8192,18,2628000574
4506,219003876,667833,219671709,28,0,0,2560,28,7924538003
4507,219005008,248505,219253513,2,0,0,58368,2,4659244908
4508,219012328,1557900,220570228,33,0,0,71168,33,5166038581
4509,219020464,236668,219257132,16,0,0,11776,16,5348577768
4510,219057054,138126,219195180,31,0,0,4096,31,1449372689
4511,219058528,392623,219451151,32,0,0,10752,32,7694515513
4512,219067682,380162,219447844,33,0,0,102912,33,1630980366
4513,219086760,369710,219456470,4,0,0,17408,4,5029578224
4514,219101958,440571,219542529,29,0,0,37888,29,10165349408
4515,219103474,20607,219124081,26,0,1,12800,26,46001476
4516,219150368,707874,219858242,3,0,0,27648,3,7987218475
4517,219159638,2870,219162508,26,0,1,8704,26,7098196262
4518,219162664,403003,219565667,31,0,0,6656,31,678371692
4519,219167544,1725328,220892872,37,0,0,51712,37,10593848570
4520,219168500,290973,219459473,16,0,0,9728,16,5715036888
4521,219182802,282347,219465149,32,0,0,15872,32,770711028
4522,219188827,622914,219811741,20,0,0,26112,20,9307728734
4523,219190081,402418,219592499,28,0,0,14848,28,5496889409
4524,219209918,338898,219548816,34,0,0,20480,34,912237169
4525,219236826,454561,219691387,6,0,0,12288,6,8125365615
4526,219239705,401541,219641246,37,0,0,34816,37,6725424079
4527,219245086,20616,219265702,18,0,1,1536,18,7476052707
4528,219254272,74592,219328864,30,0,1,108032,30,3135686851
4529,219255308,337986,219593294,22,0,0,2560,22,6774020600
4530,219257226,529930,219787156,6,0,0,11264,6,7911593070
4531,219262667,288504,219551171,31,0,0,7680,31,2162393809
4532,219263813,310907,219574720,5,0,0,23040,5,3157565943
4533,219265481,403382,219668863,14,0,0,27136,14,3402638979
4534,219266209,451732,219717941,36,0,0,9728,36,873124591
4535,219269189,497904,219767093,18,0,0,29184,18,3387710834
4536,219274476,256494,219530970,9,0,0,5120,9,6259765770
4537,219277444,570130,219847574,22,0,0,12800,22,1228442735
4538,219286122,681796,219967918,8,0,0,25600,8,1711063582
4539,219308009,21841,219329850,11,0,1,1536,11,3432226189
4540,219309057,27514,219336571,20,0,1,24064,20,6142017441
4541,219324298,17419,219341717,15,0,1,8192,15,7912479141
4542,219334550,267288,219601838,38,0,0,16384,38,9679435792
4543,219417716,496011,219913727,37,0,0,42496,37,9688880696
4544,219420914,519653,219940567,1,0,0,9216,1,7815167371
4545,219432723,344731,219777454,9,0,0,21504,9,3414537262
4546,219434851,1560147,220994998,2,0,0,7680,2,9500515401
4547,219435405,207112,219642517,22,0,0,4096,22,7036444071
4548,219453042,536348,219989390,16,0,0,1024,16,1805550151
4549,219459677,211229,219670906,9,0,0,6656,9,173017941
4550,219464829,5162,219469991,32,0,1,5120,32,1561822267
4551,219474368,754160,220228528,20,0,0,38912,20,5997626486
4552,219475611,4850,219480461,4,0,1,5120,4,7720367109
4553,219482740,1518,219484258,2,0,1,1536,2,9921794690
4554,219494209,303766,219797975,2,0,0,4096,2,3520564192
4555,219501675,56392,219558067,9,0,1,30208,9,4699727574
4556,219504680,634665,220139345,19,0,0,73728,19,362014285
4557,219529785,370963,219900748,17,0,0,36864,17,77528846
4558,219531105,300146,219831251,5,0,0,46080,5,3482394309
4559,219532457,259475,219791932,30,0,0,8704,30,2561631812
4560,219567142,216567,219783709,28,0,0,20480,28,4520499337
4561,219572198,10220,219582418,14,0,1,8192,14,6837548489
4562,219584387,690611,220274998,17,0,0,4096,17,9202100519
4563,219596095,403138,219999233,36,0,0,32256,36,7643272810
4564,219598298,157755,219756053,4,0,0,2048,4,4529975231
4565,219603241,1747882,221351123,20,0,0,115200,20,8156000259
4566,219624758,1606351,221231109,30,0,0,2048,30,6999279434
4567,219627048,2870,219629918,18,0,1,8704,18,7754569044
4568,219627100,290394,219917494,7,0,0,12288,7,3903301253
4569,219628434,780358,220408792,26,0,0,44032,26,2973815252
4570,219639421,666833,220306254,12,0,0,3072,12,2389895782
4571,219642351,724,219643075,31,0,1,512,31,1315085375
4572,219647824,1042,219648866,32,0,1,1024,32,8694499242
4573,219657567,449281,220106848,20,0,0,15360,20,7414217265
4574,219664639,282027,219946666,21,0,0,19968,21,3276261597
4575,219700348,2946,219703294,35,0,1,3072,35,10607675500
4576,219718715,485424,220204139,2,0,0,29184,2,3228269066
4577,219740036,357207,220097243,21,0,0,7168,21,4393252562
4578,219747074,448158,220195232,10,0,0,14848,10,1972328066
4579,219769419,1093502,220862921,39,0,0,39936,39,1867069672
4580,219770662,525516,220296178,25,0,0,13312,25,2701144080
4581,219790899,198164,219989063,38,0,0,12288,38,9134713291
4582,219800818,431641,220232459,1,0,0,12800,1,4089289747
4583,219804978,9225,219814203,6,0,1,2560,6,5024802750
4584,219819655,222063,220041718,21,0,0,15360,21,8718840858
4585,219827902,8734,219836636,34,0,1,5632,34,5682110857
4586,219828495,188929,220017424,16,0,0,17408,16,6435377659
4587,219830969,750826,220581795,22,0,0,37888,22,8455459030
4588,219842337,5326,219847663,9,0,1,5632,9,6981802338
4589,219843976,519918,220363894,13,0,0,74240,13,2356137408
4590,219845136,593155,220438291,16,0,0,96768,16,3094366321
4591,219852526,10946,219863472,10,0,1,13312,10,4950531641
4592,219855397,866794,220722191,12,0,0,73216,12,4746846964
4593,219855656,452017,220307673,3,0,0,4608,3,4424948818
4594,219871220,339494,220210714,32,0,0,21504,32,7086007599
4595,219876216,374096,220250312,2,0,0,34304,2,186357617
4596,219879830,461223,220341053,32,0,0,11264,32,10085379188
4597,219887949,589053,220477002,4,0,0,19456,4,5294325452
4598,219892167,655707,220547874,35,0,0,66560,35,1572315689
4599,219893882,491174,220385056,24,0,0,26624,24,3626834999
4600,219907007,961701,220868708,25,0,0,18944,25,8913536237
4601,219910266,19196,219929462,23,0,1,2560,23,1474978840
4602,219926003,9049,219935052,26,0,1,7680,26,288009408
4603,219926065,290592,220216657,31,0,0,19456,31,522976200
4604,219936011,86712,220022723,7,0,0,6656,7,8723718558
4605,219959383,992248,220951631,7,0,0,17408,7,3213645359
4606,219971285,206496,220177781,31,0,0,43520,31,4521249678
4607,220000712,640598,220641310,32,0,0,15872,32,5985079363
4608,220020524,298437,220318961,35,0,0,512,35,1023717066
4609,220049672,419601,220469273,36,0,0,10752,36,9513560496
4610,220052487,3387,220055874,14,0,1,9728,14,5296764532
4611,220060676,523571,220584247,24,0,0,1024,24,10723563644
4612,220099535,10241,220109776,20,0,1,16384,20,7173518235
4613,220112173,436348,220548521,22,0,0,2048,22,7342617227
4614,220165657,222066,220387723,16,0,0,8704,16,6505810684
4615,220176954,3714,220180668,21,0,1,8704,21,3305842773
4616,220182729,329233,220511962,31,0,0,58880,31,7122898438
4617,220189767,902966,221092733,24,0,0,30720,24,6334997554
4618,220195881,646787,220842668,29,0,0,39936,29,7545657069
4619,220208987,606492,220815479,30,0,0,16896,30,484544060
4620,220210748,153488,220364236,29,0,0,1024,29,5771727909
4621,220233876,1147126,221381002,37,0,0,26624,37,2879392013
4622,220249167,141379,220390546,25,0,0,9216,25,5502431399
4623,220254836,735012,220989848,10,0,0,36352,10,4147434180
4624,220270797,5260,220276057,21,0,1,1024,21,6380426836
4625,220278169,466911,220745080,17,0,0,27648,17,449781293
4626,220315625,1518,220317143,13,0,1,1536,13,5251053100
4627,220317559,6754,220324313,10,0,1,7168,10,5343447208
4628,220317671,344193,220661864,30,0,0,32768,30,10066395750
4629,220318857,45052,220363909,20,0,1,37376,20,10689710849
4630,220320866,813453,221134319,22,0,0,512,22,363733281
4631,220321600,191789,220513389,9,0,0,4608,9,10661026471
4632,220347917,17353,220365270,11,0,1,1024,11,8165857422
4633,220367195,594903,220962098,29,0,0,34304,29,3594876753
4634,220375412,216128,220591540,27,0,0,7680,27,9473039846
4635,220430676,399809,220830485,24,0,0,6144,24,3756214129
4636,220433473,395125,220828598,25,0,0,43008,25,1198280430
4637,220435220,14842,220450062,0,0,1,5120,0,4067053772
4638,220463091,13934,220477025,2,0,1,20480,2,7208902569
4639,220471734,987553,221459287,24,0,0,10240,24,3559202352
4640,220487465,163914,220651379,1,0,0,7168,1,4210905372
4641,220495141,116079,220611220,33,0,0,11776,33,3978745300
4642,220501564,12383,220513947,31,0,1,512,31,3097044599
4643,220519814,488771,221008585,30,0,0,44544,30,7440681593
4644,220529818,407836,220937654,16,0,0,17408,16,4504558829
4645,220534129,146841,220680970,7,0,0,7680,7,7711447022
4646,220545116,488854,221033970,13,0,0,18432,13,4170603637
4647,220559240,1007048,221566288,6,0,0,28672,6,6725372953
4648,220573659,501942,221075601,21,0,0,9216,21,4512484611
4649,220574489,504107,221078596,39,0,0,9728,39,7328711321
4650,220578811,493959,221072770,32,0,0,116736,32,2633955959
4651,220585049,549091,221134140,34,0,0,16384,34,5609265674
4652,220599864,880614,221480478,32,0,0,53760,32,9754714136
4653,220620101,582309,221202410,10,0,0,57344,10,4731669766
4654,220626731,183585,220810316,38,0,0,24064,38,629070814
4655,220635869,387397,221023266,21,0,0,28672,21,9372518513
4656,220642602,1204361,221846963,2,0,0,512,2,7220193297
4657,220650370,955718,221606088,36,0,0,6144,36,2025874767
4658,220658478,505664,221164142,39,0,0,52736,39,2379087538
4659,220677036,3949,220680985,37,0,1,3584,37,3461362972
4660,220678380,978304,221656684,29,0,0,17408,29,348946667
4661,220684745,217649,220902394,22,0,0,11264,22,4853200343
4662,220686971,190117,220877088,39,0,0,18944,39,7923616940
4663,220694893,1994,220696887,20,0,1,2048,20,3986190666
4664,220718397,526301,221244698,8,0,0,34816,8,5124088298
4665,220734698,433729,221168427,35,0,0,5632,35,4288026555
4666,220752796,353695,221106491,1,0,0,45056,1,8084754885
4667,220766304,4374,220770678,2,0,1,4608,2,946228868
4668,220780124,112771,220892895,12,0,1,173056,12,9784481690
4669,220785107,527415,221312522,12,0,0,51200,12,4108883121
4670,220807973,1108918,221916891,20,0,0,512,20,6444873746
4671,220815917,295111,221111028,38,0,0,1024,38,7238609446
4672,220819783,214514,221034297,38,0,0,1024,38,489944428
4673,220862416,509196,221371612,17,0,0,1024,17,6577430804
4674,220875453,22315,220897768,26,0,1,12800,26,5679981904
4675,220889292,256386,221145678,27,0,0,9728,27,10467399330
4676,220901258,4550,220905808,23,0,1,3584,23,10112879212
4677,220930127,7542,220937669,14,0,1,9216,14,7576770863
4678,220939648,22465,220962113,2,0,1,16384,2,9341015933
4679,221001558,295349,221296907,7,0,0,35328,7,4610806155
4680,221003656,312344,221316000,20,0,0,8704,20,8457839635
4681,221004280,485284,221489564,13,0,0,2560,13,3169456633
4682,221008438,362356,221370794,13,0,0,64512,13,2960330332
4683,221011503,11778,221023281,31,0,1,17408,31,4035115373
4684,221035519,960913,221996432,20,0,0,56832,20,4981361435
4685,221054016,38732,221092748,6,0,1,15360,6,6154798153
4686,221066767,520651,221587418,30,0,0,46080,30,8895396259
4687,221071174,35332,221106506,37,0,1,4608,37,9039460456
4688,221077086,319422,221396508,38,0,0,38912,38,561906443
4689,221094531,278344,221372875,28,0,0,4096,28,7513025831
4690,221104280,742512,221846792,8,0,0,13824,8,7920737312
4691,221124589,246688,221371277,25,0,0,1536,25,347301445
4692,221126376,7958,221134334,26,0,1,11776,26,4997957545
4693,221129162,184163,221313325,35,0,0,2560,35,6392580337
4694,221134760,586635,221721395,9,0,0,54272,9,7147386596
4695,221151323,233306,221384629,1,0,0,11776,1,9337617266
4696,221154969,944735,222099704,27,0,0,65536,27,524612948
4697,221156553,502509,221659062,18,0,0,2048,18,9314666006
4698,221161030,755567,221916597,20,0,0,76288,20,2725379723
4699,221164786,3656,221168442,35,0,1,3072,35,8435065647
4700,221183118,305651,221488769,33,0,0,27136,33,9511668861
4701,221232859,324678,221557537,36,0,0,89600,36,5899119809
4702,221263871,387478,221651349,10,0,0,58368,10,6742699579
4703,221295709,277654,221573363,21,0,0,23040,21,2876583896
4704,221305346,936414,222241760,12,0,0,46080,12,7522977767
4705,221308943,323325,221632268,29,0,0,4608,29,1126265329
4706,221325221,71302,221396523,2,0,1,3584,2,1418357032
4707,221359026,299389,221658415,9,0,0,5632,9,6307275191
4708,221360920,35618,221396538,32,0,1,4096,32,2316975869
4709,221392179,228120,221620299,14,0,0,46592,14,6446439078
4710,221393099,237127,221630226,20,0,0,17408,20,2356395434
4711,221393666,291211,221684877,6,0,0,9728,6,10363957662
4712,221407540,1042,221408582,22,0,1,1024,22,860931945
4713,221414046,413802,221827848,14,0,0,15872,14,9757024315
4714,221417417,376363,221793780,38,0,0,55296,38,9111229169
4715,221417438,317401,221734839,25,0,0,18432,25,1699879304
4716,221425161,6754,221431915,35,0,1,7168,35,5809074782
4717,221435938,268890,221704828,14,0,0,45056,14,3748862989
4718,221443337,150828,221594165,38,0,0,22016,38,5017487214
4719,221470854,131710,221602564,13,0,1,183296,13,4512819306
4720,221486289,116531,221602820,37,0,1,9216,37,7823417771
4721,221507000,222208,221729208,32,0,0,9728,32,57416286
4722,221508165,894252,222402417,0,0,0,74240,0,17479655
4723,221512193,108121,221620314,27,0,1,3584,27,9242167196
4724,221537081,83248,221620329,23,0,1,14336,23,10527170817
4725,221566113,477442,222043555,15,0,0,15360,15,2945655967
4726,221587351,695416,222282767,12,0,0,29696,12,6610764136
4727,221636459,432705,222069164,38,0,0,8192,38,2566828346
4728,221643294,434621,222077915,2,0,0,28672,2,772729445
4729,221653421,533694,222187115,3,0,0,38400,3,8454736979
4730,221664670,671335,222336005,7,0,0,49152,7,7965387834
4731,221670625,204163,221874788,27,0,0,35328,27,7460543366
4732,221674399,669748,222344147,0,0,0,26112,0,8772239624
4733,221675890,551815,222227705,17,0,0,79872,17,2383659414
4734,221683803,904347,222588150,6,0,0,2560,6,9490532990
4735,221697132,134987,221832119,27,0,0,3584,27,7894604787
4736,221697414,28314,221725728,21,0,1,4608,21,5489188979
4737,221708256,320102,222028358,27,0,0,26624,27,5708780024
4738,221709596,84215,221793811,13,0,1,106496,13,10513787860
4739,221718501,868854,222587355,36,0,0,34816,36,5135842144
4740,221727255,281516,222008771,0,0,0,40448,0,2112102712
4741,221731517,155955,221887472,11,0,0,2048,11,5522536853
4742,221740906,52920,221793826,21,0,1,2048,21,9229203494
4743,221743055,50786,221793841,19,0,1,13824,19,2211198110
4744,221755875,1048574,222804449,15,0,0,35840,15,1109861020
4745,221756874,657570,222414444,18,0,0,39424,18,8597849369
4746,221778877,20132,221799009,37,0,1,13312,37,9571568894
4747,221785097,675576,222460673,25,0,0,22528,25,7862563910
4748,221830621,488788,222319409,3,0,0,7680,3,9462413188
4749,221836724,329969,222166693,8,0,0,30208,8,4244394374
4750,221846877,1120,221847997,20,0,1,1024,20,10146958313
4751,221859268,566,221859834,35,0,1,512,35,1819347741
4752,221859932,476244,222336176,21,0,0,512,21,10718066060
4753,221871376,331970,222203346,33,0,0,20480,33,548382807
4754,221874873,692534,222567407,38,0,0,36864,38,450827603
4755,221883807,313260,222197067,1,0,0,32256,1,4963097909
4756,221897064,22912,221919976,6,0,1,9728,6,1423516143
4757,221948931,969540,222918471,26,0,0,30208,26,4545853530
4758,222000620,666769,222667389,9,0,0,29184,9,7420330029
4759,222002823,553321,222556144,7,0,0,59904,7,7582361368
4760,222026019,227539,222253558,13,0,1,365056,13,10000694219
4761,222026657,264214,222290871,21,0,0,2560,21,4919342132
4762,222037641,837573,222875214,24,0,0,41472,24,5317263092
4763,222041737,566411,222608148,38,0,0,65536,38,8672118467
4764,222041924,211993,222253917,23,0,1,9728,23,8769699957
4765,222043281,217049,222260330,9,0,1,22528,9,3456990689
4766,222072380,573853,222646233,34,0,0,5120,34,2342562171
4767,222102022,163454,222265476,31,0,1,8192,31,8126858499
4768,222106123,1007781,223113904,37,0,0,45568,37,8666833529
4769,222110420,192459,222302879,10,0,0,16384,10,8405091761
4770,222116969,127302,222244271,7,0,0,8192,7,296160457
4771,222177720,91302,222269022,21,0,1,5632,21,7031335382
4772,222188975,548449,222737424,21,0,0,13824,21,7940986944
4773,222190281,299970,222490251,7,0,0,28672,7,8410900328
4774,222194235,501738,222695973,18,0,0,32256,18,8223023722
4775,222196680,567137,222763817,38,0,0,3072,38,10414964002
4776,222215397,322480,222537877,4,0,0,16896,4,699683795
4777,222221142,50786,222271928,1,0,1,4608,1,6499895353
4778,222224447,345799,222570246,16,0,0,9216,16,746640346
4779,222229656,42938,222272594,27,0,1,1024,27,10635042665
4780,222237110,661363,222898473,29,0,0,29184,29,2099344745
4781,222241194,788619,223029813,20,0,0,78848,20,3287835909
4782,222256013,448726,222704739,13,0,0,7168,13,2362212686
4783,222283807,248907,222532714,29,0,0,22528,29,1013534113
4784,222284533,499704,222784237,27,0,0,32768,27,4345016916
4785,222298327,18419,222316746,35,0,1,23552,35,3091102987
4786,222299198,20226,222319424,6,0,1,2560,6,2109195072
4787,222304853,156923,222461776,1,0,0,2560,1,7022013176
4788,222319001,383539,222702540,13,0,0,21504,13,3086829069
4789,222320768,774838,223095606,8,0,0,13312,8,9525749070
4790,222344708,12566,222357274,23,0,1,20992,23,7847949342
4791,222360505,105295,222465800,16,0,0,3072,16,4856427537
4792,222373872,400366,222774238,28,0,0,22528,28,7602186185
4793,222396708,445324,222842032,0,0,0,27136,0,496092361
4794,222401481,241416,222642897,29,0,0,14336,29,10652217443
4795,222404924,10128,222415052,30,0,1,512,30,1131405594
4796,222425920,733425,223159345,4,0,0,83456,4,5538346654
4797,222428682,1994,222430676,2,0,1,2048,2,3165774179
4798,222437535,350942,222788477,25,0,0,3584,25,4600801169
4799,222444057,465195,222909252,18,0,0,35328,18,10413248995
4800,222447510,74091,222521601,23,0,1,120832,23,4422642448
4801,222470470,761939,223232409,18,0,0,14848,18,1229923981
4802,222491709,322123,222813832,16,0,0,30720,16,6599739034
4803,222493023,29756,222522779,9,0,1,13824,9,7074544186
4804,222494452,223847,222718299,30,0,0,3584,30,4746270049
4805,222496899,455601,222952500,14,0,0,45568,14,2374655037
4806,222533128,41944,222575072,39,0,1,8192,39,1982968638
4807,222543097,32539,222575636,1,0,1,10752,1,6999830544
4808,222565668,22497,222588165,19,0,1,7680,19,9775495687
4809,222573036,1018875,223591911,7,0,0,33792,7,5430685768
4810,222575039,456053,223031092,27,0,0,4096,27,5231765611
4811,222606002,655723,223261725,25,0,0,10240,25,9311535747
4812,222608220,382812,222991032,25,0,0,40960,25,5871030660
4813,222611322,551033,223162355,12,0,0,1024,12,4382149015
4814,222612743,939636,223552379,39,0,0,37888,39,1725212286
4815,222626857,4679,222631536,9,0,1,12288,9,7339243703
4816,222646575,515445,223162020,9,0,0,8704,9,880007039
4817,222654018,2870,222656888,21,0,1,8704,21,3641686476
4818,222666819,254795,222921614,35,0,0,10240,35,3303026444
4819,222672104,333670,223005774,0,0,0,18944,0,9055522837
4820,222676318,3422,222679740,28,0,1,3584,28,4231155928
4821,222680114,2470,222682584,10,0,1,2560,10,1126983345
4822,222726104,445478,223171582,18,0,0,30208,18,10621242782
4823,222740100,291943,223032043,26,0,0,3072,26,4352600001
4824,222742873,296221,223039094,18,0,0,23040,18,9111004065
4825,222763801,656953,223420754,7,0,0,13824,7,8579640631
4826,222785307,348595,223133902,22,0,0,63488,22,1041347044
4827,222796840,424293,223221133,16,0,0,1536,16,2158276473
4828,222799543,402804,223202347,10,0,0,17408,10,10589709622
4829,222842394,4937,222847331,23,0,1,12800,23,4060854433
4830,222861488,13741,222875229,14,0,1,12288,14,9011392388
4831,222903382,139818,223043200,39,0,0,1024,39,5075015617
4832,222908468,533880,223442348,38,0,0,29184,38,4375393879
4833,222910125,424908,223335033,14,0,0,18944,14,5559796327
4834,222912445,187560,223100005,10,0,0,14336,10,4815426767
4835,222928004,4374,222932378,14,0,1,4608,14,10074010437
4836,222931110,247723,223178833,35,0,0,3584,35,2821906568
4837,222981435,133108,223114543,30,0,0,2048,30,1012773361
4838,222987751,3881,222991632,26,0,1,512,26,4992980334
4839,222989985,309898,223299883,31,0,0,2560,31,9591147346
4840,223005226,33883,223039109,4,0,1,1536,4,5182209235
4841,223011382,209268,223220650,16,0,0,20992,16,5916743521
4842,223027680,362458,223390138,4,0,0,86016,4,1888365310
4843,223048278,246502,223294780,35,0,0,1024,35,10602243940
4844,223065347,507196,223572543,7,0,0,30720,7,3260992855
4845,223068033,171487,223239520,8,0,0,19456,8,10145786840
4846,223091636,190880,223282516,22,0,0,2048,22,5939070184
4847,223092491,715049,223807540,27,0,0,9728,27,10085038592
4848,223121936,638965,223760901,38,0,0,40448,38,8792008941
4849,223124186,52551,223176737,35,0,1,13312,35,6566548246
4850,223127016,50387,223177403,2,0,1,1024,2,6757627052
4851,223171338,369474,223540812,21,0,0,71680,21,7110824926
4852,223176094,96612,223272706,15,0,0,3072,15,6759788526
4853,223181562,1994,223183556,28,0,1,2048,28,5211578251
4854,223202187,511407,223713594,38,0,0,20992,38,10032497502
4855,223211755,346311,223558066,26,0,0,18432,26,3364180306
4856,223222075,246126,223468201,32,0,0,13824,32,413154067
4857,223234934,283999,223518933,36,0,0,92672,36,5184143244
4858,223244800,145837,223390637,33,0,0,1536,33,5120674711
4859,223275552,167836,223443388,38,0,0,2560,38,1957959529
4860,223290033,473714,223763747,27,0,0,1024,27,9113202276
4861,223296017,10757,223306774,16,0,1,17408,16,5093104243
4862,223311258,262422,223573680,29,0,0,3584,29,1500034361
4863,223312386,529363,223841749,8,0,0,2560,8,3924106774
4864,223328142,504841,223832983,16,0,0,83456,16,10603633544
4865,223370755,20883,223391638,1,0,1,1024,1,4974225001
4866,223371490,21888,223393378,0,0,1,2560,0,7561448912
4867,223399697,474303,223874000,18,0,0,11776,18,3405585249
4868,223403309,212129,223615438,15,0,0,2048,15,9530603751
4869,223417110,163930,223581040,20,0,0,11264,20,6634247900
4870,223423007,313842,223736849,15,0,0,33280,15,2080744038
4871,223437437,512906,223950343,36,0,0,50176,36,8421789312
4872,223452534,7706,223460240,32,0,1,8192,32,1259192207
4873,223483088,1994,223485082,19,0,1,2048,19,2951194979
4874,223499101,287930,223787031,36,0,0,35328,36,1514662802
4875,223501103,56986,223558089,2,0,1,1024,2,8282594596
4876,223503296,69262,223572558,26,0,1,23552,26,3396494363
4877,223507088,155539,223662627,0,0,0,21504,0,9586198008
4878,223518088,386020,223904108,35,0,0,45056,35,9274380399
4879,223520341,329864,223850205,21,0,0,4608,21,2362805947
4880,223521935,384060,223905995,14,0,0,6144,14,7132180604
4881,223524561,48012,223572573,10,0,1,13312,10,657454513
4882,223541769,164052,223705821,31,0,0,20992,31,5165676770
4883,223550226,163539,223713765,18,0,0,512,18,9352881106
4884,223574089,450654,224024743,28,0,0,14848,28,8476598126
4885,223608462,232492,223840954,7,0,0,26112,7,5153001246
4886,223641532,341733,223983265,18,0,0,20992,18,1961057429
4887,223719661,357198,224076859,24,0,0,24576,24,8333571189
4888,223720528,148708,223869236,14,0,0,11264,14,2200841963
4889,223726678,62117,223788795,29,0,0,1536,29,9470692835
4890,223737102,1042,223738144,27,0,1,1024,27,6137193839
4891,223744401,255883,224000284,33,0,0,55808,33,4258729375
4892,223757579,155616,223913195,17,0,0,4096,17,202932450
4893,223789788,222261,224012049,10,0,0,1024,10,2426672732
4894,223797359,318422,224115781,24,0,0,19968,24,8718243425
4895,223801060,116571,223917631,12,0,1,193536,12,2949860506
4896,223803638,356735,224160373,19,0,0,16896,19,10035160155
4897,223837754,555868,224393622,15,0,0,16384,15,10428903738
4898,223842139,77438,223919577,14,0,1,3072,14,5560531087
4899,223843378,248531,224091909,21,0,0,26624,21,9359344612
4900,223843517,76316,223919833,32,0,1,9216,32,1018507556
4901,223849998,285333,224135331,11,0,0,24064,11,3433302287
4902,223904919,291343,224196262,12,0,0,17408,12,1613573170
4903,223908698,246496,224155194,20,0,0,31232,20,2949786262
4904,223918080,135963,224054043,14,0,0,6656,14,8306647359
4905,223923181,4420,223927601,4,0,1,11776,4,4794161359
4906,223925222,354545,224279767,28,0,0,34816,28,7941314177
4907,223928621,3128,223931749,17,0,1,9216,17,5927309853
4908,223936336,199010,224135346,12,0,1,297472,12,6634535957
4909,223968661,586233,224554894,21,0,0,16896,21,3614925077
4910,224016739,275255,224291994,22,0,0,22016,22,5230587876
4911,224024345,439023,224463368,35,0,0,18944,35,7798457974
4912,224026449,214575,224241024,9,0,0,4096,9,6679548682
4913,224053529,657036,224710565,33,0,0,103936,33,4498751477
4914,224055308,184453,224239761,15,0,0,12800,15,9448808223
4915,224060826,220984,224281810,16,0,0,6656,16,1250677445
4916,224072696,499241,224571937,33,0,0,46592,33,10486904964
4917,224087365,118111,224205476,8,0,1,184320,8,1234464761
4918,224091505,322998,224414503,3,0,0,55296,3,10156763243
4919,224140138,535297,224675435,39,0,0,20992,39,8617045709
4920,224143957,65385,224209342,6,0,1,6144,6,8204753125
4921,224182789,366934,224549723,3,0,0,39424,3,3788582931
4922,224202655,7993,224210648,18,0,1,2048,18,9772692484
4923,224205209,350792,224556001,35,0,0,3584,35,5477689656
4924,224215166,565515,224780681,14,0,0,29696,14,4421587427
4925,224216218,731234,224947452,25,0,0,54272,25,123055692
4926,224242142,224384,224466526,22,0,0,10240,22,327494762
4927,224245162,423862,224669024,21,0,0,18432,21,1640081756
4928,224255599,613845,224869444,35,0,0,198144,35,2896410276
4929,224258127,509927,224768054,10,0,0,34816,10,3508420222
4930,224272513,324735,224597248,18,0,0,19968,18,936937733
4931,224275947,435725,224711672,33,0,0,3584,33,9926132498
4932,224277968,14041,224292009,18,0,1,4608,18,3546383155
4933,224281550,10474,224292024,30,0,1,1024,30,6083978346
4934,224284699,7348,224292047,32,0,1,10752,32,6913872600
4935,224286370,311361,224597731,37,0,0,1536,37,317610593
4936,224293014,144878,224437892,8,0,1,238592,8,8916515829
4937,224299606,921339,225220945,16,0,0,71680,16,5443726103
4938,224310966,642117,224953083,9,0,0,18432,9,8228436716
4939,224321772,392107,224713879,2,0,0,7168,2,2707773286
4940,224322943,115615,224438558,1,0,1,1024,1,4545940625
4941,224341663,306198,224647861,1,0,0,7680,1,7983968833
4942,224352208,86504,224438712,30,0,1,8704,30,3697457758
4943,224369397,344653,224714050,29,0,0,512,29,487639295
4944,224376767,524820,224901587,3,0,0,27136,3,7846648525
4945,224385842,600530,224986372,4,0,0,85504,4,6718900360
4946,224393261,756879,225150140,25,0,0,44032,25,10406382044
4947,224403186,648083,225051269,11,0,0,83968,11,2440310514
4948,224411957,356916,224768873,22,0,0,2560,22,880741772
4949,224412273,320749,224733022,24,0,0,10752,24,1280810784
4950,224432128,10770,224442898,9,0,1,6656,9,7639812275
4951,224454001,9382,224463383,37,0,1,6144,37,7701684038
4952,224462879,697644,225160523,21,0,0,33792,21,8870302314
4953,224473472,417756,224891228,12,0,0,36352,12,10655355259
4954,224476450,483825,224960275,9,0,0,16384,9,10135246936
4955,224477335,632794,225110129,34,0,0,5632,34,7456712808
4956,224486434,284794,224771228,7,0,0,7680,7,4576908852
4957,224501871,429030,224930901,9,0,0,44032,9,5023741473
4958,224505214,173668,224678882,25,0,0,11264,25,6021573280
4959,224538920,454799,224993719,27,0,0,24064,27,195732281
4960,224553685,568399,225122084,15,0,0,18944,15,5205038106
4961,224560584,433314,224993898,8,0,0,512,8,10293956519
4962,224570312,347158,224917470,28,0,0,21504,28,6911794849
4963,224580413,424740,225005153,21,0,0,36864,21,6479169328
4964,224580708,484760,225065468,2,0,0,1024,2,6549852582
4965,224635423,429469,225064892,21,0,0,9216,21,9985825463
4966,224645442,308764,224954206,28,0,0,3584,28,6472901955
4967,224646438,1981,224648419,0,0,1,512,0,2477327167
4968,224655632,574875,225230507,0,0,0,25088,0,5357024078
4969,224671614,50151,224721765,1,0,1,8192,1,4081897032
4970,224692058,33893,224725951,30,0,1,6656,30,8914039876
4971,224692529,395511,225088040,15,0,0,1536,15,2838400000
4972,224722671,630298,225352969,3,0,0,139776,3,3951479130
4973,224727544,60866,224788410,12,0,1,98304,12,7907694390
4974,224729598,394373,225123971,18,0,0,6144,18,8641830487
4975,224744176,383398,225127574,10,0,0,11776,10,4059853064
4976,224755569,339288,225094857,4,0,0,4096,4,2190683371
4977,224775003,636079,225411082,11,0,0,32768,11,10257882994
4978,224818269,52226,224870495,14,0,1,1024,14,4378902390
4979,224854120,16721,224870841,22,0,1,512,22,7206254758
4980,224878336,306837,225185173,27,0,0,6144,27,3312771868
4981,224882010,226388,225108398,10,0,0,9728,10,6165042096
4982,224882834,483908,225366742,17,0,0,26624,17,898324799
4983,224901865,466180,225368045,15,0,0,4096,15,4344385285
4984,224910183,539064,225449247,1,0,0,16384,1,6477228054
4985,224928908,359380,225288288,17,0,0,9216,17,3677340518
4986,224938934,21356,224960290,9,0,1,2560,9,7349848505
4987,224952184,543988,225496172,11,0,0,33280,11,3251013491
4988,224954797,5508,224960305,19,0,1,5120,19,9768599959
4989,224979439,388777,225368216,13,0,0,512,13,3157124135
4990,224988633,368251,225356884,21,0,0,12800,21,7546534975
4991,224990784,24902,225015686,2,0,1,16896,2,6436365738
4992,224994981,21883,225016864,21,0,1,13824,21,7604145359
4993,224995114,25296,225020410,32,0,1,5632,32,5179922592
4994,225020910,392995,225413905,13,0,0,9216,13,8608747675
4995,225025200,197648,225222848,31,0,0,6144,31,7292587264
4996,225027320,151227,225178547,33,0,0,512,33,6211740114
4997,225055328,217396,225272724,26,0,0,9728,26,10696005339
4998,225069379,161151,225230530,16,0,1,250880,16,2965375157
4999,225076595,153950,225230545,39,0,1,14848,39,644353947
5000,225077799,163398,225241197,16,0,1,51200,16,5631904128
5001,225101000,343240,225444240,17,0,0,7680,17,869328368
5002,225104348,267829,225372177,25,0,0,10240,25,5421270484
5003,225108141,137242,225245383,6,0,1,6656,6,3237950078
5004,225116726,130603,225247329,26,0,1,3072,26,2847429104
5005,225119358,313831,225433189,26,0,0,2560,26,6727026444
5006,225121643,390315,225511958,28,0,0,45568,28,7298130834
5007,225125034,373025,225498059,7,0,0,6144,7,581056529
5008,225159834,198781,225358615,21,0,0,5632,21,75413001
5009,225199773,229324,225429097,34,0,0,14336,34,885050112
5010,225208420,277597,225486017,12,0,0,20480,12,10229518138
5011,225219207,336844,225556051,19,0,0,1536,19,9525816491
5012,225238996,154904,225393900,36,0,0,9216,36,6189598665
5013,225243473,297695,225541168,29,0,0,15360,29,3697757119
5014,225274879,452771,225727650,0,0,0,34816,0,5997864317
5015,225277048,136872,225413920,8,0,1,216576,8,4660389098
5016,225318147,314897,225633044,38,0,0,31232,38,3307508590
5017,225330245,83690,225413935,18,0,1,4096,18,7959751344
5018,225335033,219921,225554954,19,0,0,512,19,7586213647
5019,225346176,407601,225753777,31,0,0,22528,31,5749115999
5020,225358265,479586,225837851,6,0,0,14848,6,4112419362
5021,225392871,265343,225658214,31,0,0,3584,31,9983330180
5022,225414918,295287,225710205,31,0,0,22016,31,6083703807
5023,225431912,351181,225783093,9,0,0,17920,9,3236302220
5024,225448161,255321,225703482,4,0,0,29696,4,10074532894
5025,225500084,136907,225636991,25,0,0,1024,25,10463084507
5026,225510991,338720,225849711,2,0,0,33792,2,2306936708
5027,225559771,500744,226060515,29,0,0,32768,29,6538619641
5028,225567750,407503,225975253,4,0,0,21504,4,364289064
5029,225573538,228793,225802331,13,0,0,39424,13,9954743841
5030,225588216,650757,226238973,38,0,0,34816,38,4883555963
5031,225604569,150159,225754728,39,0,0,3072,39,19862014
5032,225622717,266753,225889470,32,0,0,23040,32,2533190887
5033,225641075,169460,225810535,1,0,0,2048,1,8678331997
5034,225667632,301054,225968686,19,0,0,24576,19,5671955222
5035,225675375,566,225675941,23,0,1,512,23,2700390341
5036,225676796,224990,225901786,38,0,0,6656,38,100433437
5037,225679272,262641,225941913,0,0,0,2560,0,7344593285
5038,225686643,1994,225688637,27,0,1,2048,27,6329351258
5039,225691347,639050,226330397,7,0,0,14336,7,4078160398
5040,225701652,223486,225925138,3,0,0,7680,3,7880558080
5041,225708540,121675,225830215,25,0,0,6144,25,9175003999
5042,225712278,15403,225727681,16,0,1,29696,16,9739492201
5043,225713527,19594,225733121,10,0,1,13824,10,7658953127
5044,225713566,424514,226138080,18,0,0,26624,18,7812853621
5045,225736740,608492,226345232,1,0,0,48640,1,4806143587
5046,225756587,423298,226179885,10,0,0,30208,10,3651342606
5047,225761127,191414,225952541,37,0,0,25088,37,10727332933
5048,225766054,280301,226046355,28,0,0,2560,28,8336073034
5049,225784566,226111,226010677,33,0,0,21504,33,5269934248
5050,225813155,36571,225849726,12,0,1,62464,12,9685443318
5051,225813281,91483,225904764,10,0,0,8704,10,10472266948
5052,225814030,260531,226074561,9,0,0,18944,9,10349046610
5053,225821820,113973,225935793,17,0,0,7680,17,9733585281
5054,225833452,211679,226045131,9,0,0,10240,9,9639621122
5055,225862695,267258,226129953,7,0,0,27648,7,8927975195
5056,225888850,316990,226205840,0,0,0,7168,0,931796886
5057,225889987,308611,226198598,1,0,0,26624,1,3405214292
5058,225916061,107452,226023513,27,0,0,19456,27,5881632814
5059,225929170,6638,225935808,14,0,1,6656,14,4112185477
5060,225935431,1411,225936842,0,0,1,1024,0,9590305879
5061,225940227,267812,226208039,19,0,0,7168,19,5940758779
5062,225949188,553370,226502558,17,0,0,57344,17,2918241577
5063,225990067,359712,226349779,20,0,0,14848,20,4667780890
5064,226012006,349355,226361361,8,0,0,30208,8,5955751821
5065,226012208,4937,226017145,14,0,1,12800,14,10728006625
5066,226022287,272047,226294334,12,0,0,22016,12,9445811065
5067,226044576,15954,226060530,8,0,1,7680,8,7246051071
5068,226045132,15413,226060545,30,0,1,3072,30,2635110311
5069,226085518,4679,226090197,20,0,1,12288,20,9308771547
5070,226108307,115762,226224069,29,0,0,1024,29,7092708979
5071,226113849,413275,226527124,28,0,0,33280,28,2622168644
5072,226132610,230186,226362796,33,0,0,4608,33,8646296224
5073,226135860,315459,226451319,7,0,0,11264,7,3578962940
5074,226174999,488247,226663246,6,0,0,17920,6,2114429295
5075,226182169,169973,226352142,34,0,0,7680,34,1900087466
5076,226191295,134719,226326014,14,0,0,30208,14,4031931322
5077,226213188,2470,226215658,23,0,1,2560,23,6436666008
5078,226235330,193878,226429208,27,0,0,14336,27,1080481146
5079,226246104,133520,226379624,6,0,0,23552,6,3373221075
5080,226260362,362131,226622493,12,0,0,83968,12,4632612760
5081,226298036,246474,226544510,13,0,0,28672,13,640038499
5082,226308544,3387,226311931,37,0,1,9728,37,6916644802
5083,226323486,180989,226504475,32,0,0,6144,32,2777115139
5084,226330886,308946,226639832,13,0,0,56832,13,2595074516
5085,226340737,300382,226641119,7,0,0,4096,7,2154505313
5086,226343517,393489,226737006,6,0,0,21504,6,1634176894
5087,226355756,295441,226651197,39,0,0,24576,39,2355609615
5088,226363131,201206,226564337,19,0,0,65024,19,3576433588
5089,226366008,325017,226691025,2,0,0,8192,2,4403055873
5090,226374177,312465,226686642,1,0,0,24064,1,4881283991
5091,226396812,344761,226741573,17,0,0,13312,17,10316896186
5092,226397029,333410,226730439,16,0,0,46592,16,8611679768
5093,226413127,374006,226787133,32,0,0,16384,32,6025060156
5094,226442494,335843,226778337,11,0,0,40448,11,8075629496
5095,226452165,365646,226817811,16,0,0,25088,16,8413410136
5096,226472822,566,226473388,37,0,1,512,37,7551978811
5097,226478348,24225,226502573,34,0,1,7680,34,7103017025
5098,226479372,320001,226799373,25,0,0,38912,25,4984863424
5099,226479968,22620,226502588,30,0,1,9728,30,3802542305
5100,226503880,350435,226854315,25,0,0,21504,25,6179233539
5101,226509622,17517,226527139,23,0,1,8192,23,7332418685
5102,226510569,231331,226741900,18,0,0,1024,18,8328443176
5103,226514002,79588,226593590,9,0,0,1536,9,6035884520
5104,226525847,301237,226827084,29,0,0,4608,29,2863494728
5105,226587647,284470,226872117,24,0,0,4096,24,7132975905
5106,226599244,210908,226810152,9,0,0,35328,9,7226835218
5107,226618206,228186,226846392,14,0,0,17920,14,5690008187
5108,226622489,235585,226858074,32,0,0,12288,32,7469271149
5109,226630331,195326,226825657,22,0,0,10240,22,10372205452
5110,226637818,184704,226822522,39,0,0,15360,39,408379299
5111,226652141,284157,226936298,36,0,0,4608,36,3570611496
5112,226663617,171270,226834887,24,0,0,5632,24,418850894
5113,226665013,269531,226934544,3,0,0,16896,3,398476591
5114,226668226,232139,226900365,3,0,0,1024,3,3877202722
5115,226674393,566,226674959,20,0,1,512,20,7305550927
5116,226699514,2470,226701984,28,0,1,2560,28,2155698656
5117,226729652,205227,226934879,31,0,0,1024,31,10590917721
5118,226761407,105790,226867197,18,0,0,3072,18,4426953422
5119,226793270,121074,226914344,35,0,0,512,35,437981832
5120,226794335,36130,226830465,20,0,1,3584,20,469620463
5121,226805615,227058,227032673,35,0,0,15360,35,8670913390
5122,226832125,274378,227106503,15,0,0,29696,15,8772672356
5123,226844569,142276,226986845,11,0,0,2048,11,3604390851
5124,226854246,4862,226859108,6,0,1,1024,6,1188092294
5125,226888713,181297,227070010,3,0,0,65024,3,8811710895
5126,226892146,326311,227218457,26,0,0,35840,26,9461091138
5127,226901621,4850,226906471,14,0,1,5120,14,3819343827
5128,226901757,249435,227151192,8,0,0,34816,8,5943001640
5129,226921580,454290,227375870,38,0,0,21504,38,5980907080
5130,226931259,195721,227126980,18,0,0,54272,18,5001873358
5131,226944909,222218,227167127,32,0,0,4608,32,268348290
5132,226954783,205540,227160323,30,0,0,27648,30,2431485848
5133,226964752,15579,226980331,18,0,1,30208,18,10375237298
5134,226984949,384354,227369303,29,0,0,8192,29,5189829139
5135,226996101,131222,227127323,31,0,0,1024,31,7913940644
5136,226997884,209455,227207339,30,0,0,8192,30,2790960935
5137,227001175,150500,227151675,18,0,0,1536,18,878409133
5138,227004497,6488,227010985,9,0,1,15872,9,1780471107
5139,227014629,7706,227022335,35,0,1,8192,35,3702329005
5140,227038756,1518,227040274,25,0,1,1536,25,1982163611
5141,227044063,181576,227225639,35,0,0,12800,35,580694802
5142,227054913,347897,227402810,9,0,0,47104,9,6228857084
5143,227057622,555688,227613310,27,0,0,23552,27,1525453038
5144,227088833,566,227089399,32,0,1,512,32,487890774
5145,227095133,325164,227420297,2,0,0,8192,2,174857716
5146,227095669,308404,227404073,39,0,0,4096,39,97263958
5147,227100523,9394,227109917,35,0,1,3584,35,2630458830
5148,227108181,251608,227359789,18,0,0,32768,18,4551491872
5149,227112641,16159,227128800,24,0,1,1536,24,951063992
5150,227117601,115095,227232696,7,0,0,7680,7,4327105140
5151,227129857,6278,227136135,9,0,1,6656,9,9254556026
5152,227135174,43904,227179078,14,0,0,512,14,10121958576
5153,227168076,220367,227388443,14,0,0,35840,14,4511260085
5154,227168645,181137,227349782,32,0,0,51712,32,274709331
5155,227179197,2870,227182067,24,0,1,8704,24,155876515
5156,227187686,3645,227191331,18,0,1,10240,18,4470670310
5157,227187931,33465,227221396,16,0,1,49152,16,3461579498
5158,227188830,302782,227491612,27,0,0,78848,27,6496340701
5159,227189283,134345,227323628,33,0,0,3584,33,6990478231
5160,227196792,246704,227443496,10,0,0,25600,10,657967986
5161,227216176,241081,227457257,20,0,0,20480,20,195599999
5162,227223270,276991,227500261,12,0,0,10240,12,1443995956
5163,227270695,387616,227658311,25,0,0,4608,25,6842172391
5164,227276300,268550,227544850,13,0,0,25600,13,472384514
5165,227284047,3422,227287469,9,0,1,3584,9,4915493861
5166,227288873,208253,227497126,8,0,0,17920,8,4384107719
5167,227323400,6022,227329422,23,0,1,6144,23,2455874113
5168,227324153,272019,227596172,4,0,0,74240,4,7223606409
5169,227333325,195326,227528651,21,0,0,14848,21,5388936913
5170,227338601,314639,227653240,17,0,0,47616,17,1193768216
5171,227349118,13175,227362293,0,0,1,2560,0,3743735717
5172,227351091,320932,227672023,36,0,0,18944,36,6396784293
5173,227355971,275988,227631959,7,0,0,10752,7,4019916660
5174,227382098,705675,228087773,22,0,0,56832,22,8109041037
5175,227387399,162146,227549545,8,0,0,15360,8,6815939967
5176,227404337,292122,227696459,36,0,0,49152,36,4886366094
5177,227413725,205216,227618941,38,0,0,18432,38,5207294054
5178,227435665,807869,228243534,21,0,0,11264,21,1506340341
5179,227451221,122316,227573537,2,0,0,14848,2,9789198064
5180,227452409,424817,227877226,6,0,0,22016,6,3178353873
5181,227465049,26578,227491627,28,0,1,8704,28,9223195045
5182,227468132,294657,227762789,14,0,0,3584,14,99561448
5183,227475821,221293,227697114,1,0,0,2048,1,8312524234
5184,227478493,307548,227786041,15,0,0,54272,15,2224395155
5185,227486025,301435,227787460,26,0,0,4608,26,2278064346
5186,227496060,204607,227700667,14,0,0,4608,14,4117749835
5187,227498840,335759,227834599,12,0,0,12800,12,9076816281
5188,227507355,148084,227655439,31,0,0,7168,31,6198923607
5189,227593507,237169,227830676,36,0,0,27648,36,4204766452
5190,227599639,283531,227883170,1,0,0,12288,1,5856504543
5191,227615327,239574,227854901,12,0,0,11264,12,3894031982
5192,227657296,317425,227974721,3,0,0,45056,3,9985592434
5193,227657303,294362,227951665,15,0,0,22528,15,5886074694
5194,227659491,285287,227944778,37,0,0,48128,37,3318090673
5195,227661103,10935,227672038,1,0,1,15872,1,8523964591
5196,227682330,436166,228118496,30,0,0,19456,30,10316060249
5197,227690873,401923,228092796,36,0,0,16384,36,9481678124
5198,227700769,6229,227706998,26,0,1,15360,26,5685459421
5199,227703212,175433,227878645,38,0,0,4608,38,617912643
5200,227726668,5802,227732470,34,0,1,6144,34,4106052189
5201,227733415,81468,227814883,17,0,0,6656,17,7204779167
5202,227737547,13858,227751405,35,0,1,23552,35,690307639
5203,227766856,186852,227953708,17,0,0,6656,17,7529236278
5204,227784545,310941,228095486,27,0,0,1536,27,100688486
5205,227822299,272696,228094995,25,0,0,7168,25,276812722
5206,227828632,9621,227838253,32,0,1,10240,32,6225701938
5207,227834279,145449,227979728,13,0,0,16384,13,2609424788
5208,227838795,272105,228110900,38,0,0,4608,38,7385240396
5209,227843178,198105,228041283,29,0,0,11264,29,5854306732
5210,227847130,566,227847696,16,0,1,512,16,6476378030
5211,227866282,373781,228240063,37,0,0,5120,37,10278224451
5212,227870198,148991,228019189,9,0,0,32768,9,2461455430
5213,227885589,298082,228183671,12,0,0,4608,12,4788077429
5214,227885683,444524,228330207,37,0,0,29184,37,8595111251
5215,227899166,171276,228070442,4,0,0,64512,4,10479098082
5216,227912830,269422,228182252,20,0,0,27648,20,4704061153
5217,227933015,489946,228422961,25,0,0,50176,25,8191606070
5218,227946960,363097,228310057,27,0,0,25088,27,8756017509
5219,227974869,198384,228173253,37,0,0,13312,37,9256933932
5220,227978661,259819,228238480,17,0,0,16896,17,4114873355
5221,227988724,244593,228233317,10,0,0,26624,10,2989217427
5222,228008106,11106,228019212,6,0,1,12288,6,7914102733
5223,228010865,214293,228225158,30,0,0,91136,30,8630795231
5224,228037424,211016,228248440,11,0,0,12800,11,8874972155
5225,228067811,304387,228372198,34,0,0,39424,34,4161607399
5226,228073298,25078,228098376,0,0,1,3584,0,8987456736
5227,228094884,260317,228355201,30,0,0,31744,30,10013904283
5228,228102714,141779,228244493,30,0,0,3072,30,3201155796
5229,228182365,75917,228258282,26,0,0,512,26,8547901149
5230,228198184,352313,228550497,6,0,0,12800,6,10456407336
5231,228198583,141812,228340395,19,0,0,7168,19,5246685524
5232,228205127,43336,228248463,34,0,1,4608,34,4184037182
5233,228207664,305099,228512763,9,0,0,31232,9,10614969911
5234,228211077,213615,228424692,10,0,0,5632,10,2256774707
5235,228214491,118227,228332718,27,0,0,8192,27,10192611559
5236,228214826,33652,228248478,1,0,1,9728,1,1633627179
5237,228222179,481792,228703971,17,0,0,11264,17,7367220031
5238,228231320,197911,228429231,8,0,0,14848,8,9105540104
5239,228232943,18584,228251527,10,0,1,9216,10,3927179152
5240,228240509,157111,228397620,32,0,0,15872,32,10240232132
5241,228251580,3422,228255002,32,0,1,3584,32,4712774334
5242,228255513,235745,228491258,10,0,0,512,10,1819308033
5243,228261010,179663,228440673,30,0,0,27648,30,8650994198
5244,228289311,270476,228559787,25,0,0,20992,25,6986484985
5245,228302719,171959,228474678,10,0,0,30720,10,3279032957
5246,228307045,5023,228312068,8,0,1,2048,8,3767167401
5247,228327997,6707,228334704,26,0,1,2048,26,5050704920
5248,228346772,186592,228533364,6,0,0,25600,6,3717191568
5249,228355068,107431,228462499,21,0,0,9728,21,660920533
5250,228376984,143372,228520356,15,0,0,3072,15,6744507517
5251,228391212,426090,228817302,31,0,0,21504,31,1870995337
5252,228397817,136810,228534627,11,0,0,4096,11,4414996619
5253,228422865,203649,228626514,29,0,0,32768,29,4542637318
5254,228434004,171573,228605577,19,0,0,32256,19,1102202165
5255,228439802,291562,228731364,17,0,0,78336,17,10192196735
5256,228447071,145003,228592074,12,0,0,25600,12,3911384231
5257,228476289,261650,228737939,38,0,0,21504,38,3731300861
5258,228495857,293228,228789085,1,0,0,4096,1,6583927208
5259,228504105,173586,228677691,19,0,0,40960,19,5600978206
5260,228519748,258260,228778008,10,0,0,100352,10,7366390135
5261,228547000,285157,228832157,15,0,0,13312,15,256501708
5262,228572991,125313,228698304,17,0,0,5120,17,8173912338
5263,228575374,212448,228787822,34,0,0,22016,34,5100383018
5264,228585255,433161,229018416,39,0,0,14848,39,8286776598
5265,228587517,322291,228909808,39,0,0,53248,39,2679702002
5266,228595593,9999,228605592,26,0,1,1536,26,2484097654
5267,228597652,208756,228806408,8,0,0,43520,8,9098783137
5268,228598492,255377,228853869,0,0,0,9216,0,7758525389
5269,228609065,391688,229000753,1,0,0,34304,1,10451255707
5270,228644141,329594,228973735,13,0,0,36864,13,8034145625
5271,228658362,4937,228663299,34,0,1,12800,34,5314216072
5272,228661089,166997,228828086,36,0,0,7680,36,7488348924
5273,228668436,218673,228887109,4,0,0,22528,4,10244179304
5274,228700592,5841,228706433,10,0,1,2560,10,4972145752
5275,228708472,219776,228928248,33,0,0,56832,33,3908445950
5276,228726589,263697,228990286,39,0,0,54272,39,6901621379
5277,228729790,400055,229129845,24,0,0,3072,24,9541425107
5278,228750754,28355,228779109,6,0,1,1024,6,1209681348
5279,228752381,36727,228789108,22,0,1,11776,22,7365117863
5280,228753141,35990,228789131,10,0,1,1024,10,6489823785
5281,228774861,14285,228789146,14,0,1,1024,14,9320010118
5282,228779363,27060,228806423,32,0,1,24576,32,8071822317
5283,228783299,301960,229085259,29,0,0,34304,29,4939695513
5284,228788086,215194,229003280,24,0,0,8192,24,9696733401
5285,228810695,303509,229114204,31,0,0,37376,31,1284118779
5286,228817815,196062,229013877,22,0,0,17920,22,7150960853
5287,228819831,5326,228825157,16,0,1,5632,16,7206926557
5288,228825714,277063,229102777,36,0,0,57344,36,5094866741
5289,228827951,349418,229177369,33,0,0,11776,33,1222187004
5290,228828546,5146,228833692,34,0,1,1536,34,10165706327
5291,228850826,3058,228853884,9,0,1,1536,9,9887822400
5292,228881020,159014,229040034,17,0,0,9216,17,6944124840
5293,228897539,253034,229150573,0,0,0,25088,0,9936115479
5294,228913927,240249,229154176,33,0,0,11776,33,7873787062
5295,228938152,255920,229194072,20,0,0,39424,20,8757417573
5296,228953521,73499,229027020,2,0,0,3584,2,6758931938
5297,228960837,307355,229268192,31,0,0,20992,31,2787620901
5298,228973691,307652,229281343,19,0,0,43008,19,5081780232
5299,228981022,225881,229206903,15,0,0,17920,15,10062596283
5300,228996874,118757,229115631,35,0,0,4608,35,7124011305
5301,229043689,208070,229251759,7,0,0,18944,7,7118058945
5302,229046113,2946,229049059,31,0,1,3072,31,1725282208
5303,229064145,196209,229260354,27,0,0,28160,27,9852120166
5304,229074080,11202,229085282,23,0,1,1536,23,1651368309
5305,229075317,40329,229115646,37,0,1,6656,37,2348355497
5306,229076620,229333,229305953,12,0,0,9216,12,5850716770
5307,229086128,175653,229261781,28,0,0,4608,28,6815361693
5308,229090096,264326,229354422,33,0,0,15872,33,3504024400
5309,229090944,35960,229126904,37,0,1,18432,37,772689701
5310,229113431,301861,229415292,3,0,0,17920,3,3391961138
5311,229140716,187229,229327945,32,0,0,35328,32,6353706997
5312,229148368,184377,229332745,17,0,0,10752,17,7515290165
5313,229164487,29608,229194095,37,0,1,34816,37,2487341244
5314,229172374,300567,229472941,4,0,0,42496,4,9219819714
5315,229185486,12740,229198226,11,0,1,11264,11,8825394299
5316,229195718,11200,229206918,9,0,1,6656,9,2762404772
5317,229219107,135954,229355061,21,0,0,2048,21,7038684073
5318,229221286,274917,229496203,12,0,0,16896,12,765100965
5319,229221922,264508,229486430,24,0,0,11264,24,3927951203
5320,229227099,252991,229480090,18,0,0,19456,18,1047489622
5321,229234420,294978,229529398,4,0,0,19968,4,2664841023
5322,229239823,212832,229452655,10,0,0,7168,10,6901547353
5323,229240935,193289,229434224,12,0,0,22528,12,3896999545
5324,229249479,432721,229682200,31,0,0,65536,31,5073028551
5325,229255927,376131,229632058,27,0,0,65536,27,9286931584
5326,229257311,117419,229374730,26,0,0,4608,26,6816113965
5327,229258090,136896,229394986,16,0,0,512,16,3538117169
5328,229259510,332562,229592072,28,0,0,2560,28,4820617637
5329,229272696,274300,229546996,31,0,0,14336,31,387224794
5330,229277958,5872,229283830,20,0,1,2560,20,5894773637
5331,229299436,93306,229392742,34,0,0,13312,34,1500400088
5332,229323055,265237,229588292,3,0,0,15360,3,3841862543
5333,229340781,6229,229347010,18,0,1,15360,18,9818540475
5334,229347065,1042,229348107,2,0,1,1024,2,10076007783
5335,229348207,292610,229640817,25,0,0,28672,25,6219769599
5336,229354690,1405,229356095,22,0,1,1024,22,7110281257
5337,229388980,14253,229403233,19,0,1,16896,19,10425594882
5338,229397670,185542,229583212,8,0,0,24064,8,5519267914
5339,229399409,164571,229563980,14,0,0,6144,14,1460255144
5340,229415266,107007,229522273,19,0,0,512,19,5291455701
5341,229416240,225840,229642080,29,0,0,4096,29,9107813819
5342,229426373,7866,229434239,9,0,1,5632,9,6805815641
5343,229437047,258140,229695187,16,0,0,42496,16,940280690
5344,229437200,566,229437766,30,0,1,512,30,3827814094
5345,229456102,3422,229459524,16,0,1,3584,16,2729975204
5346,229490001,6217,229496218,25,0,1,3072,25,8511009096
5347,229515236,257850,229773086,38,0,0,28672,38,9019972972
5348,229518486,197474,229715960,30,0,0,38912,30,4323751857
5349,229560364,101853,229662217,36,0,0,32256,36,2400128084
5350,229563388,2102,229565490,22,0,1,1536,22,5170313876
5351,229564836,226483,229791319,21,0,0,23040,21,5657031754
5352,229584436,114386,229698822,15,0,0,11776,15,7131339538
5353,229599152,327994,229927146,22,0,0,52736,22,7360465056
5354,229607320,336489,229943809,14,0,0,38912,14,7730645063
5355,229613897,443629,230057526,20,0,0,65024,20,7462237331
5356,229621004,549628,230170632,1,0,0,36864,1,5199348683
5357,229637305,216618,229853923,35,0,0,7168,35,1841687882
5358,229641760,111418,229753178,3,0,0,8704,3,7218804127
5359,229656435,170842,229827277,19,0,0,18944,19,306813978
5360,229659801,309118,229968919,27,0,0,49152,27,1205903720
5361,229660101,406028,230066129,25,0,0,28160,25,7581249551
5362,229667261,484693,230151954,34,0,0,24064,34,10073815609
5363,229674427,28024,229702451,21,0,1,10240,21,8204507571
5364,229675646,272078,229947724,24,0,0,12800,24,552307512
5365,229676587,97465,229774052,21,0,0,3072,21,6115319087
5366,229686566,170180,229856746,24,0,0,9216,24,10045312499
5367,229695446,20529,229715975,6,0,1,6144,6,9752769177
5368,229707987,241819,229949806,21,0,0,4608,21,5062032167
5369,229717498,190716,229908214,9,0,0,34304,9,6024953397
5370,229729444,293826,230023270,3,0,0,21504,3,8936072978
5371,229749061,13253,229762314,16,0,1,25600,16,10557585456
5372,229754304,18797,229773101,8,0,1,3584,8,1742963883
5373,229754508,428752,230183260,6,0,0,5120,6,5620530006
5374,229764239,9828,229774067,25,0,1,8704,25,420376329
5375,229785147,163232,229948379,31,0,0,2048,31,4108694954
5376,229818813,253625,230072438,11,0,0,5120,11,2055255639
5377,229820971,6321,229827292,35,0,1,1536,35,10315391984
5378,229828773,255336,230084109,32,0,0,9216,32,6115573435
5379,229836417,233323,230069740,25,0,0,11776,25,6999422872
5380,229870005,236302,230106307,25,0,0,1536,25,4025962617
5381,229886316,232092,230118408,14,0,0,36864,14,1892988598
5382,229897210,11019,229908229,22,0,1,14848,22,4437354474
5383,229915298,228490,230143788,30,0,0,44544,30,3606254800
5384,229921421,307151,230228572,4,0,0,37888,4,6252798022
5385,229940373,136564,230076937,20,0,0,2048,20,6782140777
5386,229940655,247065,230187720,31,0,0,12288,31,1215406520
5387,229944517,156644,230101161,9,0,0,9728,9,1896615064
5388,229951619,202230,230153849,29,0,0,6144,29,9493210881
5389,229964257,9591,229973848,1,0,1,12800,1,8720389340
5390,229970586,4568,229975154,35,0,1,2048,35,9861887045
5391,229977572,119713,230097285,19,0,0,19968,19,4028588398
5392,229983117,2470,229985587,28,0,1,2560,28,23588432
5393,229987923,278505,230266428,35,0,0,11264,35,7529995984
5394,229991623,79224,230070847,15,0,0,3584,15,4311202880
5395,229997248,243359,230240607,17,0,0,39424,17,5531019987
5396,230024816,164947,230189763,39,0,0,6656,39,4105158966
5397,230046266,287884,230334150,36,0,0,512,36,8130964413
5398,230054866,89725,230144591,33,0,0,2560,33,7046312340
5399,230065900,12775,230078675,30,0,1,6656,30,6520175532
5400,230067828,16296,230084124,14,0,1,5632,14,9698541939
5401,230087101,10199,230097300,13,0,1,5120,13,2597819444
5402,230096999,77638,230174637,36,0,0,6656,36,8198182176
5403,230131683,264198,230395881,26,0,0,54784,26,10323137228
5404,230132731,234557,230367288,22,0,0,72192,22,918895232
5405,230133057,160454,230293511,29,0,0,21504,29,7004645201
5406,230146964,23683,230170647,13,0,1,7680,13,7741244092
5407,230149592,105619,230255211,21,0,0,17920,21,9562056982
5408,230166181,10736,230176917,31,0,1,6656,31,6654065363
5409,230208119,265023,230473142,26,0,0,6656,26,8871350776
5410,230220384,102113,230322497,15,0,0,4608,15,8596066375
5411,230226417,17145,230243562,29,0,1,3072,29,9491411348
5412,230236569,10539,230247108,26,0,1,5632,26,10351699613
5413,230241503,265622,230507125,35,0,0,58880,35,5120809806
5414,230275464,1994,230277458,18,0,1,2048,18,9654075831
5415,230278380,143180,230421560,19,0,0,16896,19,1975550035
5416,230285376,117863,230403239,16,0,1,196096,16,8344620065
5417,230297361,288167,230585528,27,0,0,21504,27,7964586386
5418,230307751,100634,230408385,21,0,1,8192,21,2750688517
5419,230313492,236758,230550250,0,0,0,6144,0,10707721573
5420,230318261,204743,230523004,4,0,0,8704,4,3101611698
5421,230335748,85998,230421746,37,0,0,512,37,4944363904
5422,230336913,75658,230412571,14,0,1,6656,14,734386481
5423,230346743,424180,230770923,34,0,0,14848,34,909750456
5424,230353579,264629,230618208,35,0,0,12288,35,10566332672
5425,230362944,263331,230626275,29,0,0,21504,29,1792467617
5426,230367070,190355,230557425,19,0,0,18944,19,10047731763
5427,230377597,43978,230421575,2,0,1,6144,2,8876507742
5428,230378665,195511,230574176,18,0,0,24576,18,5204169746
5429,230381803,46283,230428086,3,0,1,47616,3,2746095887
5430,230401718,191625,230593343,6,0,0,25600,6,8237438402
5431,230402676,25756,230428432,6,0,1,512,6,1890454937
5432,230403372,28606,230431978,19,0,1,5632,19,6941435965
5433,230464475,209979,230674454,25,0,0,25088,25,1414339143
5434,230496956,1187021,231683977,36,0,0,40960,36,10521300584
5435,230507565,1994,230509559,21,0,1,2048,21,7251535729
5436,230507852,200622,230708474,38,0,0,60928,38,4510355843
5437,230510231,445616,230955847,24,0,0,30208,24,9084076575
5438,230510936,226440,230737376,37,0,0,38912,37,648518250
5439,230525216,267659,230792875,34,0,0,16384,34,10154388978
5440,230525507,989656,231515163,21,0,0,20480,21,1432938881
5441,230528955,237421,230766376,36,0,0,54784,36,4500862945
5442,230531520,1994,230533514,19,0,1,2048,19,3291820846
5443,230545522,379804,230925326,39,0,0,37376,39,1923881029
5444,230548580,104362,230652942,12,0,1,166400,12,6987917970
5445,230549810,106678,230656488,23,0,1,5632,23,2750781803
5446,230550232,640165,231190397,35,0,0,31232,35,6700560957
5447,230563246,95828,230659074,34,0,1,4096,34,616237748
5448,230566331,424718,230991049,31,0,0,5120,31,483243192
5449,230568858,91804,230660662,1,0,1,15872,1,9239682612
5450,230569752,91576,230661328,2,0,1,1024,2,2131710103
5451,230585775,287601,230873376,2,0,0,15360,2,4654712207
5452,230597134,64860,230661994,27,0,1,11264,27,8133388407
5453,230597298,65362,230662660,6,0,1,1024,6,7393346238
5454,230606262,366977,230973239,30,0,0,4096,30,8515895519
5455,230607118,58448,230665566,26,0,1,4608,26,5499763743
5456,230622964,506980,231129944,25,0,0,8192,25,5706469985
5457,230625958,275541,230901499,32,0,0,7680,32,9735801868
5458,230637295,29257,230666552,18,0,1,1536,18,1823315480
5459,230659449,112113,230771562,0,0,0,2048,0,3217577703
5460,230667343,304633,230971976,22,0,0,41472,22,5235698897
5461,230667438,9520,230676958,11,0,1,2560,11,3828255430
5462,230670811,275793,230946604,29,0,0,18944,29,8424680397
5463,230677240,120541,230797781,35,0,0,512,35,9542164301
5464,230677590,187579,230865169,10,0,0,30720,10,1436323552
5465,230694830,264472,230959302,21,0,0,11264,21,3007013481
5466,230699895,1117385,231817280,6,0,0,17408,6,3531316870
5467,230706137,5766,230711903,25,0,1,9728,25,8693004989
5468,230710138,377638,231087776,0,0,0,24576,0,7914082345
5469,230714142,374749,231088891,17,0,0,3584,17,7983735377
5470,230718707,531787,231250494,25,0,0,13312,25,2660725813
5471,230728959,643907,231372866,37,0,0,50688,37,9459624389
5472,230744751,3422,230748173,12,0,1,3584,12,3630196694
5473,230756307,382731,231139038,13,0,0,23552,13,5536383783
5474,230772623,349179,231121802,8,0,0,54784,8,4938058355
5475,230775695,153546,230929241,6,0,0,12800,6,9704570752
5476,230779930,300343,231080273,38,0,0,61440,38,4818805283
5477,230781970,204198,230986168,26,0,0,37888,26,8813380256
5478,230803324,1994,230805318,25,0,1,2048,25,3569996746
5479,230804264,3898,230808162,13,0,1,4096,13,7615590125
5480,230806282,6278,230812560,35,0,1,6656,35,8098298760
5481,230814129,3645,230817774,6,0,1,10240,6,2832389216
5482,230814803,174656,230989459,26,0,0,10752,26,5038340545
5483,230833675,311462,231145137,32,0,0,19968,32,5505382163
5484,230835318,1994,230837312,2,0,1,2048,2,5828021596
5485,230839302,292537,231131839,22,0,0,6144,22,7470496958
5486,230846085,1064758,231910843,25,0,0,1024,25,4163796915
5487,230856597,306995,231163592,11,0,0,9216,11,8138294409
5488,230871299,351655,231222954,28,0,0,3584,28,7308550229
5489,230872119,255314,231127433,28,0,0,18432,28,6061478295
5490,230919786,344013,231263799,22,0,0,3072,22,8362443383
5491,230937105,22212,230959317,26,0,1,17920,26,9378017212
5492,230942299,1000288,231942587,3,0,0,20992,3,10644945585
5493,230943276,29978,230973254,12,0,1,11264,12,6488067258
5494,230945134,327064,231272198,25,0,0,11776,25,5194088109
5495,230950095,336377,231286472,27,0,0,10240,27,6620464413
5496,230960346,29128,230989474,22,0,1,5632,22,10086437700
5497,230982446,121971,231104417,15,0,0,6144,15,9839530721
5498,230982599,246758,231229357,9,0,0,1536,9,4506812968
5499,230990526,201290,231191816,38,0,0,4608,38,561556497
5500,230995469,205287,231200756,7,0,0,7168,7,5390057461
5501,230995549,479753,231475302,37,0,0,4608,37,3411836432
5502,231001161,377976,231379137,8,0,0,20480,8,2834577601
5503,231003798,402635,231406433,30,0,0,67072,30,1972609168
5504,231024758,512431,231537189,13,0,0,26624,13,10116548843
5505,231038580,7230,231045810,23,0,1,7680,23,8858683663
5506,231051541,434647,231486188,33,0,0,3072,33,8633349665
5507,231071960,457102,231529062,11,0,0,45568,11,370982057
5508,231075228,398639,231473867,10,0,0,60416,10,5766822018
5509,231082375,523132,231605507,8,0,0,53248,8,9747427595
5510,231098300,100257,231198557,0,0,0,20480,0,7040553438
5511,231122808,386100,231508908,8,0,0,53248,8,3651544035
5512,231128363,487501,231615864,1,0,0,3584,1,4994042331
5513,231150395,4374,231154769,26,0,1,4608,26,4293778702
5514,231168354,441552,231609906,11,0,0,14336,11,6321256871
5515,231175942,1994,231177936,22,0,1,2048,22,3033533466
5516,231179768,396693,231576461,27,0,0,83456,27,9053184038
5517,231189901,510587,231700488,22,0,0,44032,22,5848102670
5518,231231404,259747,231491151,35,0,0,9216,35,10642443397
5519,231239039,375718,231614757,26,0,0,15872,26,5757642466
5520,231241041,3387,231244428,2,0,1,9728,2,9087428660
5521,231249234,384483,231633717,1,0,0,18432,1,9130379118
5522,231287222,2946,231290168,21,0,1,3072,21,777822035
5523,231299133,1042,231300175,9,0,1,1024,9,2118030726
5524,231301424,323355,231624779,20,0,0,29184,20,5245655331
5525,231307582,2946,231310528,13,0,1,3072,13,4233937429
5526,231308412,280856,231589268,31,0,0,41984,31,8214317930
5527,231312741,428546,231741287,20,0,0,5120,20,2700933659
5528,231323642,4420,231328062,23,0,1,11776,23,10339876081
5529,231331065,399413,231730478,27,0,0,87040,27,10081273857
5530,231352307,296826,231649133,4,0,0,37888,4,10114073836
5531,231362893,538225,231901118,3,0,0,11264,3,10276853227
5532,231364032,19939,231383971,35,0,1,5120,35,6970911373
5533,231368912,457941,231826853,34,0,0,24064,34,5623739073
5534,231381476,356973,231738449,14,0,0,26112,14,4958219444
5535,231403835,407100,231810935,12,0,0,12288,12,5486429481
5536,231418607,119401,231538008,36,0,0,2560,36,2142513752
5537,231427299,4420,231431719,20,0,1,11776,20,4288796605
5538,231435250,304462,231739712,17,0,0,4096,17,9198066810
5539,231454791,20526,231475317,32,0,1,19968,32,6563279001
5540,231457359,178112,231635471,8,0,0,5632,8,1550760057
5541,231460477,167601,231628078,37,0,0,10752,37,8255766179
5542,231471256,439260,231910516,16,0,0,30208,16,4107060709
5543,231506744,337230,231843974,35,0,0,3072,35,1636153266
5544,231517590,279412,231797002,37,0,0,16896,37,7845008957
5545,231517933,334128,231852061,38,0,0,14336,38,5320978874
5546,231529972,367699,231897671,22,0,0,83968,22,3885072717
5547,231534811,469008,232003819,38,0,0,72704,38,6530484892
5548,231538723,165220,231703943,16,0,0,11264,16,4952162893
5549,231540716,2470,231543186,14,0,1,2560,14,5051594916
5550,231542912,388882,231931794,27,0,0,37376,27,5183524516
5551,231543506,1994,231545500,34,0,1,2048,34,2597451293
5552,231565395,270122,231835517,6,0,0,6144,6,2327494716
5553,231568660,65080,231633740,28,0,1,1536,28,7121730185
5554,231603339,153447,231756786,17,0,0,20992,17,5591522311
5555,231620361,16111,231636472,13,0,1,1024,13,4476899032
5556,231625223,387815,232013038,26,0,0,30208,26,5622546573
5557,231632444,16704,231649148,18,0,1,4608,18,611715233
5558,231640779,204128,231844907,15,0,0,1536,15,8684909556
5559,231652186,249111,231901297,28,0,0,512,28,5803674427
5560,231659324,4374,231663698,27,0,1,4608,27,5933741875
5561,231664409,284441,231948850,26,0,0,20480,26,1604451395
5562,231666733,399784,232066517,3,0,0,8192,3,3800157113
5563,231688186,177044,231865230,6,0,0,6656,6,4223156235
5564,231718395,26546,231744941,12,0,1,10240,12,7436966998
5565,231727509,226668,231954177,37,0,0,17408,37,5985214504
5566,231748500,15837,231764337,9,0,1,30720,9,2552220971
5567,231768359,291594,232059953,28,0,0,16896,28,9837409690
5568,231775819,136467,231912286,29,0,0,4608,29,4024951567
5569,231800465,280269,232080734,29,0,0,17408,29,3569231682
5570,231821902,303061,232124963,33,0,0,17408,33,6940794022
5571,231836870,5196,231842066,2,0,1,13312,2,1934248219
5572,231873623,38686,231912309,18,0,1,1024,18,8682552039
5573,231892426,26097,231918523,32,0,1,6656,32,5111268186
5574,231904597,255042,232159639,20,0,0,40448,20,4528256035
5575,231917319,390749,232308068,38,0,0,29184,38,4097193771
5576,231927622,219678,232147300,37,0,0,13824,37,5668966365
5577,231929666,271575,232201241,17,0,0,29696,17,7271937165
5578,231934967,304731,232239698,9,0,0,32768,9,3130628930
5579,231936875,76178,232013053,16,0,1,80896,16,10023397053
5580,231950919,235187,232186106,3,0,0,3072,3,3159734865
5581,231967108,142052,232109160,36,0,0,9728,36,5444695811
5582,231967596,238493,232206089,38,0,0,15360,38,3680045959
5583,232033634,287298,232320932,27,0,0,10752,27,9574791729
5584,232038826,333743,232372569,37,0,0,12800,37,5193791745
5585,232062588,151316,232213904,17,0,0,25600,17,10611022934
5586,232065562,110548,232176110,7,0,0,512,7,2875183453
5587,232076169,292485,232368654,22,0,0,12800,22,4604013664
5588,232080664,444951,232525615,30,0,0,82944,30,4562509846
5589,232095968,151312,232247280,33,0,0,2048,33,6546653855
5590,232100088,75154,232175242,30,0,0,3584,30,2085194442
5591,232117889,342745,232460634,20,0,0,42496,20,4362582978
5592,232126087,2470,232128557,23,0,1,2560,23,2152755206
5593,232137383,401063,232538446,26,0,0,41984,26,7063016951
5594,232142454,293190,232435644,38,0,0,9728,38,9369977462
5595,232163979,283692,232447671,33,0,0,39424,33,2518408723
5596,232174276,124585,232298861,11,0,0,44032,11,1289811142
5597,232200473,181380,232381853,2,0,0,6656,2,1003922655
5598,232233182,255547,232488729,21,0,0,92160,21,7228036758
5599,232235158,11311,232246469,32,0,1,7168,32,9725402606
5600,232251958,375777,232627735,11,0,0,49152,11,1155316619
5601,232261013,341223,232602236,36,0,0,9216,36,613366828
5602,232272202,369752,232641954,3,0,0,46592,3,6943253786
5603,232275812,7706,232283518,23,0,1,8192,23,1826536035
5604,232278831,272110,232550941,17,0,0,40960,17,10349033298
5605,232295911,204401,232500312,4,0,0,37888,4,9723185251
5606,232297407,261380,232558787,2,0,0,25600,2,9421378006
5607,232307786,13161,232320947,30,0,1,16896,30,3480206773
5608,232320611,252573,232573184,39,0,0,4608,39,6775645727
5609,232323285,267001,232590286,29,0,0,14336,29,4039186402
5610,232332025,400671,232732696,26,0,0,55808,26,9871709783
5611,232374761,311772,232686533,21,0,0,18432,21,3285346868
5612,232375708,339969,232715677,4,0,0,59392,4,3915869789
5613,232376682,409794,232786476,33,0,0,47616,33,6281528659
5614,232379216,625530,233004746,32,0,0,3584,32,6390795443
5615,232379816,272693,232652509,7,0,0,18432,7,7957146548
5616,232393533,347290,232740823,0,0,0,9728,0,6663332017
5617,232405640,4162,232409802,38,0,1,11264,38,7256213947
5618,232448377,102587,232550964,2,0,1,10752,2,6594137236
5619,232448876,135032,232583908,24,0,0,10240,24,6496541126
5620,232459977,220925,232680902,36,0,0,24576,36,7598685951
5621,232467187,186125,232653312,18,0,0,2560,18,985650271
5622,232473426,214534,232687960,31,0,0,4608,31,2269982839
5623,232489268,608643,233097911,29,0,0,10240,29,8545045113
5624,232489444,374015,232863459,2,0,0,15872,2,10344197946
5625,232525207,478424,233003631,32,0,0,62464,32,3126075139
5626,232535419,23893,232559312,25,0,1,512,25,6811283959
5627,232559909,172966,232732875,0,0,0,512,0,2311134633
5628,232561820,7706,232569526,37,0,1,8192,37,3043205234
5629,232596957,270277,232867234,14,0,0,12288,14,2459270523
5630,232598913,13341,232612254,0,0,1,22528,0,5552090162
5631,232610825,237464,232848289,7,0,0,23552,7,8461740178
5632,232617392,241208,232858600,10,0,0,33792,10,3151291456
5633,232623138,212479,232835617,4,0,0,13824,4,1142028970
5634,232623733,552230,233175963,34,0,0,7680,34,5361277039
5635,232640124,101494,232741618,33,0,0,2560,33,1424272636
5636,232646890,275834,232922724,6,0,0,33792,6,940251088
5637,232655092,142847,232797939,19,0,0,16384,19,1718557660
5638,232670905,421352,233092257,4,0,0,3584,4,4721713220
5639,232677576,150221,232827797,6,0,0,13312,6,5748604206
5640,232683235,402596,233085831,13,0,0,27136,13,1391176839
5641,232685345,7052,232692397,32,0,1,11776,32,10071577125
5642,232718493,179552,232898045,9,0,0,9728,9,9660463648
5643,232749551,327997,233077548,0,0,0,19456,0,10003461691
5644,232760578,258056,233018634,1,0,0,39936,1,3445486758
5645,232771609,614551,233386160,38,0,0,64512,38,6816825720
5646,232790833,280764,233071597,11,0,0,80384,11,4158749924
5647,232796562,294588,233091150,6,0,0,17408,6,4394087861
5648,232824823,10809,232835632,13,0,1,4608,13,6946282174
5649,232828692,71053,232899745,5,0,0,2560,5,4445653618
5650,232833443,172893,233006336,38,0,0,1024,38,2038232343
5651,232841569,164440,233006009,22,0,0,4096,22,1807777304
5652,232844107,250669,233094776,21,0,0,8192,21,8843048297
5653,232846641,326967,233173608,33,0,0,15872,33,309281210
5654,232869653,422251,233291904,31,0,0,38912,31,10547907748
5655,232898286,434742,233333028,18,0,0,45056,18,7136162984
5656,232910749,1518,232912267,2,0,1,1536,2,5525387331
5657,232913679,272451,233186130,0,0,0,7680,0,10159715827
5658,232923720,834748,233758468,31,0,0,52736,31,3178837108
5659,232942867,190629,233133496,0,0,0,4608,0,5900982844
5660,232958965,603798,233562763,36,0,0,117248,36,9951660772
5661,232975005,2470,232977475,34,0,1,2560,34,1534389100
5662,232987124,433402,233420526,22,0,0,70144,22,8105523528
5663,233003318,967860,233971178,1,0,0,86016,1,7478729341
5664,233004693,361796,233366489,18,0,0,23040,18,6951817623
5665,233005209,434988,233440197,2,0,0,64512,2,7485685989
5666,233007531,35366,233042897,12,0,1,43520,12,3618931868
5667,233008909,218073,233226982,24,0,0,17920,24,8854851877
5668,233010129,821379,233831508,33,0,0,58368,33,9776042940
5669,233011961,194442,233206403,32,0,0,23040,32,9686398718
5670,233017257,920507,233937764,9,0,0,2048,9,5653025240
5671,233018107,26736,233044843,0,0,1,3072,0,2549222011
5672,233041489,638294,233679783,31,0,0,138240,31,9491945547
5673,233052782,59800,233112582,9,0,1,32768,9,7071565084
5674,233081496,774557,233856053,27,0,0,58880,27,10004824533
5675,233084366,906959,233991325,27,0,0,66048,27,5136255700
5676,233092035,716155,233808190,5,0,0,2048,5,6017743232
5677,233097931,828695,233926626,38,0,0,120320,38,9782622914
5678,233098250,622006,233720256,0,0,0,73216,0,7591413966
5679,233098382,344350,233442732,27,0,0,8192,27,700843870
5680,233111236,526412,233637648,20,0,0,33280,20,4064796936
5681,233111820,451902,233563722,28,0,0,3072,28,8752492556
5682,233115707,626654,233742361,25,0,0,27136,25,5520267204
5683,233126438,604129,233730567,30,0,0,33792,30,9308099720
5684,233134821,563104,233697925,19,0,0,59392,19,5409566755
5685,233141942,3422,233145364,11,0,1,3584,11,8014229067
5686,233153224,580798,233734022,36,0,0,11264,36,2152860998
5687,233186223,585310,233771533,33,0,0,11776,33,3666477827
5688,233191462,646636,233838098,24,0,0,12800,24,10604191761
5689,233196672,1518,233198190,32,0,1,1536,32,3146529876
5690,233203679,602453,233806132,19,0,0,50176,19,9290646047
5691,233215062,642254,233857316,20,0,0,4096,20,9002406519
5692,233230577,367116,233597693,29,0,0,48640,29,3179315084
5693,233257585,510321,233767906,13,0,0,30720,13,3565922667
5694,233263603,566,233264169,32,0,1,512,32,5374897477
5695,233275894,1518,233277412,28,0,1,1536,28,5126675829
5696,233286420,157263,233443683,18,0,0,3072,18,9957033089
5697,233308746,463910,233772656,12,0,0,3584,12,7826945622
5698,233328735,616220,233944955,14,0,0,23552,14,4700083265
5699,233342744,44662,233387406,8,0,1,76800,8,1832033376
5700,233354990,35603,233390593,37,0,1,4608,37,6215853926
5701,233371589,565536,233937125,0,0,0,34304,0,8575050565
5702,233373095,682688,234055783,28,0,0,10752,28,3242207712
5703,233381604,612443,233994047,28,0,0,3584,28,1992551460
5704,233395347,781382,234176729,5,0,0,61952,5,4970193058
5705,233401560,405991,233807551,7,0,0,4608,7,1903012517
5706,233413490,420685,233834175,39,0,0,8704,39,1841421436
5707,233414567,634399,234048966,37,0,0,38912,37,5130462546
5708,233459970,1994,233461964,2,0,1,2048,2,5443799891
5709,233472439,595943,234068382,30,0,0,40960,30,2641067215
5710,233473793,300024,233773817,25,0,0,3584,25,6213636402
5711,233488574,535870,234024444,30,0,0,41984,30,7306264974
5712,233536236,550092,234086328,13,0,0,2048,13,3705474538
5713,233575394,772882,234348276,27,0,0,106496,27,7110187097
5714,233604358,4850,233609208,1,0,1,5120,1,1383397528
5715,233619514,604769,234224283,10,0,0,15360,10,5705696522
5716,233625239,233429,233858668,15,0,0,3584,15,8303852640
5717,233627099,52699,233679798,7,0,1,15360,7,2825015363
5718,233634114,124409,233758523,37,0,1,5632,37,892094261
5719,233639339,784184,234423523,9,0,0,17408,9,439219609
5720,233652569,340339,233992908,18,0,0,5120,18,8406617089
5721,233654834,117837,233772671,25,0,1,6144,25,5709890919
5722,233661425,443545,234104970,8,0,0,14848,8,8223067324
5723,233670352,445453,234115805,15,0,0,8192,15,4301383677
5724,233670776,548812,234219588,29,0,0,10752,29,9740322129
5725,233676604,678239,234354843,8,0,0,21504,8,5759423742
5726,233679273,390536,234069809,1,0,0,4608,1,588145453
5727,233681736,529413,234211149,33,0,0,2560,33,1697159272
5728,233705640,67046,233772686,6,0,1,2048,6,6703146942
5729,233710213,500133,234210346,6,0,0,36352,6,6913738647
5730,233712429,285362,233997791,37,0,0,5120,37,7238307081
5731,233718130,524954,234243084,13,0,0,5120,13,2635505139
5732,233726930,46910,233773840,7,0,1,5632,7,3696538638
5733,233735966,579808,234315774,31,0,0,79360,31,5630149076
5734,233738620,36526,233775146,32,0,1,2048,32,8420960733
5735,233740130,291376,234031506,14,0,0,5632,14,566651595
5736,233746236,616750,234362986,34,0,0,26624,34,1469542411
5737,233759899,18473,233778372,31,0,1,5120,31,10289952362
5738,233769591,9140,233778731,2,0,1,9728,2,1387118143
5739,233770742,428481,234199223,12,0,0,67072,12,8394031677
5740,233774113,7850,233781963,38,0,1,12288,38,1128926961
5741,233820502,589234,234409736,25,0,0,7680,25,5946291467
5742,233839404,561224,234400628,2,0,0,58880,2,9464724737
5743,233854767,358425,234213192,22,0,0,6656,22,10155390842
5744,233866138,7706,233873844,13,0,1,8192,13,6106675531
5745,233871642,283965,234155607,26,0,0,18432,26,2704627511
5746,233874045,1042,233875087,32,0,1,1024,32,8321859419
5747,233895651,487006,234382657,11,0,0,64512,11,3475132804
5748,233896023,561169,234457192,35,0,0,7680,35,5670622023
5749,233898051,337479,234235530,33,0,0,36864,33,4823248925
5750,233898214,280558,234178772,26,0,0,6656,26,7138798958
5751,233934527,517285,234451812,22,0,0,60928,22,6650906486
5752,233950375,53872,234004247,28,0,1,16384,28,2174833440
5753,233961568,514171,234475739,6,0,0,14336,6,5625834737
5754,233967789,39364,234007153,18,0,1,4608,18,1072556151
5755,233973562,558249,234531811,39,0,0,57856,39,8544665993
5756,233977825,614321,234592146,24,0,0,48128,24,7337844473
5757,233998382,630128,234628510,20,0,0,22528,20,4107364319
5758,234012207,13313,234025520,35,0,1,1024,35,1573201249
5759,234013550,555911,234569461,37,0,0,69632,37,8603704005
5760,234019715,387666,234407381,31,0,0,18432,31,985918039
5761,234038533,537100,234575633,17,0,0,5120,17,10488680407
5762,234051804,18020,234069824,28,0,1,25600,28,1943746169
5763,234052456,30927,234083383,37,0,1,23040,37,138642010
5764,234074425,10546,234084971,13,0,1,15872,13,226271236
5765,234076430,496026,234572456,9,0,0,9728,9,8571062585
5766,234078024,386827,234464851,27,0,0,25088,27,6641050970
5767,234078790,157223,234236013,17,0,0,1536,17,5319812672
5768,234081358,5879,234087237,27,0,1,3584,27,1974182601
5769,234098191,6802,234104993,38,0,1,7168,38,10475617045
5770,234100047,18773,234118820,31,0,1,23552,31,546643907
5771,234120774,290717,234411491,35,0,0,5632,35,7881002705
5772,234121708,310047,234431755,19,0,0,4096,19,1583347363
5773,234130764,472035,234602799,4,0,0,14848,4,4744527920
5774,234131346,6754,234138100,20,0,1,7168,20,6360266069
5775,234132545,503944,234636489,29,0,0,26112,29,7132621523
5776,234133953,414261,234548214,9,0,0,53760,9,10348645904
5777,234149733,5889,234155622,32,0,1,2560,32,4784927434
5778,234164444,442796,234607240,16,0,0,9216,16,570212276
5779,234166672,570279,234736951,35,0,0,35328,35,10336047039
5780,234170351,231384,234401735,6,0,0,3584,6,5576664231
5781,234170590,495474,234666064,12,0,0,40960,12,4841131670
5782,234185709,301299,234487008,0,0,0,6656,0,10003673639
5783,234211902,4152,234216054,32,0,1,8704,32,562134946
5784,234221857,582066,234803923,9,0,0,13824,9,6544681103
5785,234222965,243773,234466738,21,0,0,6144,21,2394287715
5786,234231950,566808,234798758,17,0,0,15360,17,8190855747
5787,234247387,207450,234454837,35,0,0,9728,35,81284234
5788,234260338,751732,235012070,29,0,0,57856,29,5457690646
5789,234269813,443849,234713662,11,0,0,26624,11,8653464968
5790,234285390,30415,234315805,0,0,1,26624,0,632346356
5791,234288276,113474,234401750,12,0,1,9216,12,879792703
5792,234294025,400879,234694904,9,0,0,18432,9,8576386614
5793,234303484,294605,234598089,14,0,0,19456,14,6219829081
5794,234307667,337437,234645104,24,0,0,11264,24,10323542585
5795,234347582,65109,234412691,8,0,1,3072,8,9804469364
5796,234353384,372461,234725845,6,0,0,39936,6,4171817936
5797,234376472,471312,234847784,27,0,0,13824,27,5225034794
5798,234378950,35367,234414317,9,0,1,2560,9,1734656029
5799,234392308,246224,234638532,39,0,0,6656,39,1146066034
5800,234394162,347706,234741868,5,0,0,2048,5,6580781304
5801,234394448,23095,234417543,38,0,1,5120,38,1634059181
5802,234400841,340360,234741201,31,0,0,10240,31,9912940287
5803,234401141,359987,234761128,5,0,0,20480,5,4516824897
5804,234401676,353197,234754873,14,0,0,10240,14,7186637964
5805,234416089,1800,234417889,34,0,1,512,34,10197605485
5806,234416288,181972,234598260,2,0,0,512,2,7804483789
5807,234426857,24978,234451835,14,0,1,7168,14,2733806486
5808,234430406,21444,234451850,30,0,1,5120,30,10052534939
5809,234433515,292657,234726172,21,0,0,1024,21,3924700531
5810,234442339,263188,234705527,11,0,0,34816,11,3856117889
5811,234481866,264481,234746347,26,0,0,8192,26,1666470009
5812,234488234,369503,234857737,31,0,0,17920,31,1719255441
5813,234498628,5196,234503824,27,0,1,13312,27,5296350354
5814,234505096,3898,234508994,34,0,1,4096,34,3776028876
5815,234514166,223892,234738058,31,0,0,3584,31,6244826563
5816,234520330,302762,234823092,21,0,0,9728,21,9529074513
5817,234542761,283177,234825938,16,0,0,6656,16,1060706674
5818,234551879,272016,234823895,8,0,0,2560,8,5788019092
5819,234557506,15951,234573457,24,0,1,1024,24,9366205742
5820,234590575,222183,234812758,28,0,0,25088,28,4210502143
5821,234601347,226478,234827825,10,0,0,6144,10,8210153734
5822,234603467,178772,234782239,34,0,0,8192,34,5056400569
5823,234606758,213355,234820113,29,0,0,24064,29,6663123324
5824,234610960,497716,235108676,31,0,0,15872,31,7912629550
5825,234618069,317153,234935222,30,0,0,24576,30,10671161371
5826,234618456,328761,234947217,35,0,0,2560,35,2224669257
5827,234622446,434181,235056627,17,0,0,6656,17,2560893040
5828,234644205,271008,234915213,3,0,0,24064,3,9035459298
5829,234656345,294022,234950367,36,0,0,1024,36,5793635550
5830,234673719,5712,234679431,10,0,1,14336,10,478106271
5831,234679734,184625,234864359,38,0,0,16384,38,6495613635
5832,234702766,378082,235080848,3,0,0,10240,3,1843163470
5833,234716425,338159,235054584,11,0,0,99328,11,10112315647
5834,234739808,6554,234746362,2,0,1,3584,2,510856910
5835,234758271,188151,234946422,11,0,0,6144,11,3454015419
5836,234773547,217692,234991239,29,0,0,11264,29,7740056220
5837,234791818,1042,234792860,10,0,1,1024,10,4661196452
5838,234802588,271909,235074497,14,0,0,27648,14,9797854349
5839,234805692,255342,235061034,24,0,0,14336,24,6702429766
5840,234812316,430331,235242647,33,0,0,32768,33,9150538568
5841,234825972,124068,234950040,39,0,0,9216,39,5513539047
5842,234841289,174712,235016001,38,0,0,12800,38,2089861832
5843,234854578,365566,235220144,24,0,0,19456,24,8352862613
5844,234884662,1042,234885704,8,0,1,1024,8,3141964855
5845,234885170,208553,235093723,12,0,0,7680,12,6582596257
5846,234905982,246704,235152686,31,0,0,11776,31,4415003875
5847,234914953,195930,235110883,32,0,0,7168,32,8863090890
5848,234916851,253307,235170158,13,0,0,33280,13,4721892187
5849,234924536,10701,234935237,4,0,1,5120,4,9353842223
5850,234925297,288904,235214201,6,0,0,30208,6,5298249398
5851,234940414,389759,235330173,37,0,0,82432,37,2449758245
5852,234949754,152720,235102474,0,0,0,28672,0,1800873460
5853,234952094,196981,235149075,25,0,0,23040,25,2771311565
5854,234988088,423978,235412066,20,0,0,48640,20,405658724
5855,235000144,221773,235221917,4,0,0,5120,4,9736999615
5856,235006391,135649,235142040,3,0,0,22016,3,8187989118
5857,235029905,251115,235281020,14,0,0,17920,14,3180516738
5858,235030317,215847,235246164,9,0,0,3584,9,3439975329
5859,235038553,557971,235596524,4,0,0,37888,4,3217540950
5860,235086668,261712,235348380,0,0,0,9216,0,5485447292
5861,235097511,207531,235305042,25,0,0,44544,25,8897990625
5862,235099404,11494,235110898,16,0,1,6656,16,6593018231
5863,235105886,355949,235461835,21,0,0,48640,21,847923566
5864,235128878,571027,235699905,8,0,0,117248,8,4941418442
5865,235139293,13918,235153211,32,0,1,512,32,156034258
5866,235152216,44522,235196738,28,0,0,512,28,8735160843
5867,235161381,413571,235574952,20,0,0,6656,20,2575501721
5868,235169686,7243,235176929,21,0,1,7168,21,2163829505
5869,235179282,11016,235190298,38,0,1,17920,38,5151365042
5870,235198931,152116,235351047,1,0,0,8704,1,7903679113
5871,235252887,475002,235727889,33,0,0,52736,33,6200430226
5872,235265585,181399,235446984,15,0,0,40448,15,3173289258
5873,235268234,268218,235536452,21,0,0,67584,21,5793387862
5874,235290320,498330,235788650,26,0,0,75264,26,1192092436
5875,235304408,506550,235810958,6,0,0,17408,6,5057978500
5876,235309843,311549,235621392,3,0,0,17920,3,4182025111
5877,235333608,181056,235514664,4,0,0,13312,4,3478902768
5878,235335103,148627,235483730,12,0,0,1536,12,7235752408
5879,235337143,2470,235339613,37,0,1,2560,37,9184099608
5880,235354396,188155,235542551,14,0,0,19968,14,10590128159
5881,235357616,1518,235359134,35,0,1,1536,35,10166695557
5882,235397162,14919,235412081,23,0,1,2560,23,9425733795
5883,235416392,247774,235664166,15,0,0,26112,15,8348348594
5884,235417614,217043,235634657,10,0,0,7168,10,9208847660
5885,235437385,30380,235467765,34,0,1,14848,34,2665599091
5886,235439924,271882,235711806,19,0,0,6656,19,895236815
5887,235448001,21710,235469711,2,0,1,3072,2,8778226585
5888,235468822,240941,235709763,11,0,0,30720,11,7517131957
5889,235489175,306674,235795849,27,0,0,23552,27,8422484222
5890,235508028,231645,235739673,27,0,0,14336,27,3769119324
5891,235560966,139422,235700388,8,0,0,1536,8,3116109180
5892,235565191,177960,235743151,34,0,0,7168,34,7452595489
5893,235566348,177910,235744258,3,0,0,3584,3,5391251379
5894,235567244,168046,235735290,38,0,0,13312,38,269875984
5895,235577234,163702,235740936,25,0,0,4096,25,8732407242
5896,235580232,288083,235868315,10,0,0,1536,10,9373464242
5897,235581099,15440,235596539,28,0,1,4608,28,6480947901
5898,235583150,148053,235731203,22,0,0,4608,22,2690322994
5899,235598256,323384,235921640,0,0,0,57344,0,2546443196
5900,235598267,345027,235943294,10,0,0,20992,10,6571729004
5901,235612463,279921,235892384,30,0,0,46592,30,9052804702
5902,235626262,177246,235803508,30,0,0,25088,30,4942850557
5903,235634508,199340,235833848,0,0,0,10752,0,917792200
5904,235635413,1042,235636455,11,0,1,1024,11,10172807334
5905,235642927,86849,235729776,21,0,0,6144,21,7138619976
5906,235710367,329212,236039579,1,0,0,46592,1,9095498219
5907,235713060,102506,235815566,7,0,0,2048,7,6738181700
5908,235713400,32345,235745745,25,0,1,5120,25,5386909180
5909,235731507,23984,235755491,21,0,1,18432,21,10726549170
5910,235742172,13985,235756157,22,0,1,1024,22,1947935694
5911,235749002,7411,235756413,32,0,1,9216,32,6467551643
5912,235752904,5455,235758359,28,0,1,3072,28,1471971066
5913,235754281,177226,235931507,28,0,0,23040,28,1422370862
5914,235759271,135780,235895051,4,0,0,8704,4,8580849623
5915,235774842,293911,236068753,33,0,0,26624,33,7580210102
5916,235794554,230814,236025368,18,0,0,57344,18,1828944190
5917,235797343,13638,235810981,7,0,1,6656,7,5560680175
5918,235807865,55977,235863842,34,0,0,3072,34,9735006568
5919,235817396,1042,235818438,7,0,1,1024,7,7404751162
5920,235831590,211452,236043042,15,0,0,11264,15,4255583018
5921,235856046,2470,235858516,22,0,1,2560,22,2422635082
5922,235859684,2470,235862154,22,0,1,2560,22,8368016012
5923,235920259,11263,235931522,25,0,1,4608,25,4146306522
5924,235955600,7706,235963306,2,0,1,8192,2,4284362079
5925,235958909,372338,236331247,21,0,0,45568,21,6952929405
5926,235960296,5712,235966008,37,0,1,14336,37,4195370619
5927,235962065,4929,235966994,3,0,1,1536,3,8438913367
5928,235968400,301544,236269944,24,0,0,4096,24,8919064734
5929,235981212,117097,236098309,19,0,0,16384,19,8535492217
5930,235996586,176177,236172763,37,0,0,32768,37,7358692458
5931,235999774,268899,236268673,5,0,0,104448,5,583887640
5932,236005891,123215,236129106,24,0,0,11264,24,1968808663
5933,236014774,31122,236045896,33,0,1,8704,33,218383771
5934,236023524,447007,236470531,14,0,0,22528,14,6396303251
5935,236033623,367164,236400787,34,0,0,68096,34,7419061852
5936,236058535,277119,236335654,13,0,0,14336,13,9476255343
5937,236062220,158148,236220368,38,0,0,38400,38,2199786001
5938,236069354,103580,236172934,12,0,0,512,12,8486116042
5939,236087969,10355,236098324,14,0,1,6144,14,7268700474
5940,236099830,340803,236440633,3,0,0,41472,3,7028311099
5941,236109160,566,236109726,31,0,1,512,31,7511196519
5942,236109481,251856,236361337,21,0,0,2048,21,3604004788
5943,236132464,400995,236533459,32,0,0,12288,32,5979754897
5944,236136296,7706,236144002,35,0,1,8192,35,4565847311
5945,236144871,1994,236146865,26,0,1,2048,26,1083184689
5946,236146962,417934,236564896,0,0,0,512,0,9917750932
5947,236173759,227675,236401434,24,0,0,2048,24,4571300982
5948,236196314,319829,236516143,33,0,0,20992,33,5873546355
5949,236206296,14087,236220383,39,0,1,7168,39,5917969436
5950,236246931,178557,236425488,4,0,0,15360,4,1081212127
5951,236268787,79936,236348723,31,0,0,2048,31,4448913894
5952,236288249,13600,236301849,3,0,1,23040,3,931245932
5953,236324482,354657,236679139,7,0,0,110080,7,6804199695
5954,236324684,240041,236564725,7,0,0,23040,7,9322461268
5955,236327135,200550,236527685,35,0,0,20480,35,6792857850
5956,236334476,292929,236627405,27,0,0,4608,27,2245995508
5957,236335608,273343,236608951,31,0,0,46080,31,9523504275
5958,236339115,141883,236480998,2,0,0,34304,2,9670027230
5959,236361821,4850,236366671,14,0,1,5120,14,7919490595
5960,236369129,414200,236783329,29,0,0,47616,29,1617507148
5961,236370354,255616,236625970,3,0,0,55808,3,5658892226
5962,236375985,510608,236886593,0,0,0,18432,0,10629504089
5963,236393735,367798,236761533,27,0,0,25600,27,8737030688
5964,236417660,7843,236425503,9,0,1,10240,9,9053124372
5965,236449289,233540,236682829,26,0,0,5120,26,4595994247
5966,236475481,244968,236720449,9,0,0,2560,9,5733255293
5967,236490790,238430,236729220,6,0,0,22016,6,2428745229
5968,236542078,96675,236638753,37,0,0,6656,37,3467023555
5969,236546989,5802,236552791,38,0,1,6144,38,9739743359
5970,236549154,180416,236729570,26,0,0,1024,26,4530994450
5971,236550639,166162,236716801,20,0,0,10752,20,2836769414
5972,236576718,3422,236580140,18,0,1,3584,18,5695806721
5973,236580802,287065,236867867,16,0,0,7168,16,3637289374
5974,236584063,112235,236696298,37,0,0,28672,37,5198678736
5975,236585437,168281,236753718,6,0,0,55808,6,8812868533
5976,236603662,25696,236629358,6,0,1,2048,6,7610044319
5977,236613502,333719,236947221,33,0,0,15360,33,4015256958
5978,236673824,155765,236829589,6,0,0,5632,6,1166318848
5979,236691063,96267,236787330,0,0,0,2560,0,6846966510
5980,236710020,155648,236865668,22,0,0,48128,22,4661885282
5981,236716404,12839,236729243,18,0,1,7680,18,4921056279
5982,236723860,157102,236880962,3,0,0,28160,3,9176744604
5983,236746806,104183,236850989,29,0,0,15360,29,2143033133
5984,236756008,186518,236942526,21,0,0,19968,21,3052387106
5985,236780657,4182,236784839,10,0,1,1536,10,5586683817
5986,236791797,113942,236905739,38,0,0,22528,38,3761091402
5987,236792656,5802,236798458,13,0,1,6144,13,5027687340
5988,236806108,168957,236975065,37,0,0,7680,37,7594572021
5989,236850811,20693,236871504,11,0,1,10240,11,1191018335
5990,236871520,15088,236886608,10,0,1,6144,10,4232625888
5991,236899607,56796,236956403,30,0,0,2560,30,1206798081
5992,236903210,111406,237014616,28,0,0,23552,28,8549234606
5993,236912065,174803,237086868,9,0,0,21504,9,9719764936
5994,236921246,69322,236990568,6,0,0,2048,6,8191863848
5995,236936321,50672,236986993,17,0,0,2560,17,2223881060
5996,236944833,125508,237070341,20,0,0,9216,20,5875376980
5997,236950038,166069,237116107,14,0,0,6144,14,2943526729
5998,236966234,85154,237051388,27,0,0,2560,27,9047369798
5999,236973303,5141,236978444,34,0,1,9728,34,5597639293
6000,236981809,161532,237143341,22,0,0,8704,22,2267026267
6001,236992138,11533,237003671,38,0,1,18944,38,319942958
6002,237009101,155187,237164288,30,0,0,6144,30,8890195038
6003,237066887,184725,237251612,19,0,0,36864,19,3567265234
6004,237067724,141168,237208892,38,0,0,32768,38,9408886236
6005,237077761,1042,237078803,1,0,1,1024,1,891522266
6006,237078473,212492,237290965,8,0,0,62464,8,4399484485
6007,237080172,180300,237260472,4,0,0,512,4,4565184050
6008,237082951,8605,237091556,35,0,1,12288,35,2280180992
6009,237086316,296921,237383237,25,0,0,20992,25,10252673366
6010,237092163,222466,237314629,34,0,0,8192,34,9519715369
6011,237092520,219590,237312110,22,0,0,57856,22,7729454344
6012,237094257,259301,237353558,24,0,0,5120,24,3881086953
6013,237097038,566,237097604,15,0,1,512,15,2207012685
6014,237097461,166549,237264010,35,0,0,1536,35,2290517189
6015,237097954,376714,237474668,8,0,0,66560,8,10393902338
6016,237130511,253997,237384508,29,0,0,4096,29,555485801
6017,237157317,212162,237369479,16,0,0,34304,16,1397248179
6018,237160748,3555,237164303,14,0,1,2048,14,5854482193
6019,237195597,338533,237534130,22,0,0,3584,22,5349668846
6020,237199563,17044,237216607,19,0,1,8192,19,9751492391
6021,237208634,10879,237219513,37,0,1,4608,37,8318449829
6022,237233108,153303,237386411,34,0,0,6144,34,2586073303
6023,237245420,131406,237376826,19,0,0,24064,19,2725130893
6024,237257934,196439,237454373,36,0,0,11776,36,181225758
6025,237273713,17810,237291523,10,0,1,512,10,2013916902
6026,237297783,178788,237476571,1,0,0,6144,1,10671879290
6027,237322537,178360,237500897,18,0,0,14336,18,3134512140
6028,237335191,3422,237338613,0,0,1,3584,0,10324375294
6029,237341932,403158,237745090,19,0,0,68608,19,5817548682
6030,237377937,379804,237757741,28,0,0,41472,28,8800443475
6031,237380950,229339,237610289,10,0,0,97792,10,6318559820
6032,237381609,291590,237673199,18,0,0,76288,18,7331853145
6033,237401730,276944,237678674,29,0,0,17920,29,5695486686
6034,237402106,295425,237697531,27,0,0,26624,27,4728056535
6035,237411504,1042,237412546,21,0,1,1024,21,4929281234
6036,237416104,347120,237763224,21,0,0,17920,21,7616750937
6037,237452680,354953,237807633,14,0,0,15360,14,10057707872
6038,237456071,24357,237480428,8,0,1,4096,8,2224069756
6039,237492971,122021,237614992,22,0,0,15360,22,7689350197
6040,237505069,320631,237825700,33,0,0,54784,33,2935907991
6041,237520151,308224,237828375,38,0,0,8704,38,8352813655
6042,237537525,7230,237544755,14,0,1,7680,14,2511136680
6043,237540074,6307,237546381,21,0,1,2560,21,10406219479
6044,237540965,161105,237702070,24,0,0,14848,24,3880450640
6045,237542758,4289,237547047,8,0,1,1024,8,10651688890
6046,237542802,8751,237551553,0,0,1,7168,0,7561350203
6047,237575702,262070,237837772,38,0,0,8704,38,6292782045
6048,237594354,84811,237679165,31,0,0,1536,31,648039968
6049,237607232,95493,237702725,19,0,0,2048,19,3874497828
6050,237610358,154909,237765267,35,0,0,6656,35,2329065948
6051,237630542,140366,237770908,13,0,0,7168,13,3383987502
6052,237659938,237061,237896999,6,0,0,9216,6,3789523959
6053,237664312,112406,237776718,31,0,0,8192,31,7100473260
6054,237666561,125382,237791943,17,0,0,3072,17,2388007189
6055,237667307,14846,237682153,7,0,1,3072,7,3357907011
6056,237692991,12163,237705154,10,0,1,2560,10,10018927626
6057,237693470,141436,237834906,29,0,0,7680,29,10641559199
6058,237732206,340650,238072856,38,0,0,34304,38,5876881492
6059,237761381,10156,237771537,34,0,1,6656,34,4767431334
6060,237786100,130256,237916356,35,0,0,41984,35,7903098523
6061,237794852,243786,238038638,21,0,0,9216,21,1936236199
6062,237810735,225072,238035807,6,0,0,96256,6,457086306
6063,237841418,203434,238044852,26,0,0,12800,26,10048752781
6064,237854021,4374,237858395,28,0,1,4608,28,155772596
6065,237877987,267200,238145187,22,0,0,12288,22,6110867323
6066,237881753,224848,238106601,16,0,0,30720,16,2999101561
6067,237886331,1042,237887373,31,0,1,1024,31,9390699178
6068,237890311,98534,237988845,10,0,0,9216,10,10331970334
6069,237902121,256602,238158723,5,0,0,20480,5,5450872633
6070,237913595,211608,238125203,15,0,0,38400,15,4124507443
6071,237916174,3145,237919319,28,0,1,3072,28,10030782995
6072,237918960,7706,237926666,12,0,1,8192,12,5029741952
6073,237937884,175596,238113480,32,0,0,22528,32,7126818077
6074,237979027,4162,237983189,14,0,1,11264,14,1724410633
6075,237980851,328707,238309558,17,0,0,52224,17,3003378253
6076,237981006,8015,237989021,13,0,1,15872,13,3677695808
6077,237996350,3387,237999737,9,0,1,9728,9,3246339184
6078,238007926,154633,238162559,22,0,0,11776,22,7499942742
6079,238029080,96918,238125998,39,0,0,2560,39,2276991415
6080,238042675,83666,238126341,39,0,0,1024,39,948791235
6081,238048511,5326,238053837,1,0,1,5632,1,2232056465
6082,238080849,94284,238175133,39,0,0,3584,39,9426014257
6083,238102043,143652,238245695,5,0,0,5120,5,7405645673
6084,238113252,386637,238499889,34,0,0,25600,34,8243147437
6085,238113350,215592,238328942,25,0,0,20480,25,8629882504
6086,238146437,250505,238396942,37,0,0,34304,37,9260481052
6087,238179722,139531,238319253,24,0,0,30720,24,2685757986
6088,238180645,6754,238187399,30,0,1,7168,30,10601948181
6089,238185909,4396,238190305,8,0,1,4608,8,10668567707
6090,238187414,242127,238429541,12,0,0,70656,12,9805941653
6091,238194810,168993,238363803,7,0,0,24576,7,2596717308
6092,238236540,54474,238291014,7,0,0,2560,7,2593841547
6093,238258824,5712,238264536,20,0,1,14336,20,6572055742
6094,238281310,167904,238449214,9,0,0,44544,9,8234715421
6095,238286456,165737,238452193,13,0,0,9728,13,10005259775
6096,238301583,18483,238320066,19,0,1,16896,19,1976402088
6097,238303124,25833,238328957,37,0,1,8192,37,8751303939
6098,238336604,153284,238489888,1,0,0,30720,1,5136537678
6099,238370993,2470,238373463,21,0,1,2560,21,9174638594
6100,238371877,1932,238373809,21,0,1,512,21,4082606262
6101,238391377,158501,238549878,16,0,0,15872,16,7779356963
6102,238403921,1042,238404963,27,0,1,1024,27,3172418154
6103,238405722,169941,238575663,14,0,0,46592,14,3906185802
6104,238426840,222512,238649352,35,0,0,14848,35,6803509492
6105,238429094,62980,238492074,33,0,0,6144,33,8764680143
6106,238442042,119410,238561452,34,0,0,20992,34,8970155696
6107,238445178,9026,238454204,11,0,1,2048,11,51005028
6108,238461814,245638,238707452,38,0,0,61952,38,6133321001
6109,238463548,151165,238614713,2,0,0,15360,2,1436182485
6110,238465940,155496,238621436,0,0,0,22016,0,3970536060
6111,238481443,145156,238626599,12,0,0,16896,12,5364632714
6112,238534029,47288,238581317,38,0,0,1536,38,10621204963
6113,238575553,94505,238670058,12,0,0,1024,12,2487948488
6114,238626471,97799,238724270,14,0,0,5120,14,8698307322
6115,238664364,3904,238668268,0,0,1,10752,0,915677329
6116,238683480,91497,238774977,10,0,0,22528,10,3616944457
6117,238770899,17170,238788069,20,0,1,22016,20,9224865398
6118,238771923,97939,238869862,3,0,0,26624,3,7433410886
6119,238781453,64054,238845507,4,0,0,10240,4,9067743732
6120,238818830,2946,238821776,0,0,1,3072,0,10147124579
6121,238836036,10499,238846535,11,0,1,16896,11,6435178085
6122,238838928,116794,238955722,13,0,0,7168,13,9840687664
6123,238840376,86224,238926600,7,0,0,14336,7,7510172154
6124,238863741,73861,238937602,21,0,0,8192,21,7626297390
6125,238901908,64537,238966445,15,0,0,10752,15,4278344626
6126,238920306,6309,238926615,20,0,1,2048,20,2005456796
6127,238930024,192836,239122860,34,0,0,5632,34,8839630454
6128,238936793,84269,239021062,27,0,0,19456,27,3890866736
6129,238937652,146183,239083835,22,0,0,17920,22,10712712289
6130,238939661,90905,239030566,21,0,0,15360,21,6324305678
6131,238944764,112547,239057311,8,0,0,4096,8,7977788183
6132,238945650,193646,239139296,5,0,0,1024,5,3361247114
6133,238948277,172852,239121129,34,0,0,20480,34,8686990330
6134,238970287,127143,239097430,37,0,0,10752,37,3524523566
6135,238971590,1994,238973584,32,0,1,2048,32,768031281
6136,238975159,3422,238978581,14,0,1,3584,14,7599872914
6137,238986366,127713,239114079,5,0,0,39936,5,764649128
6138,239002606,129456,239132062,20,0,0,13824,20,2732175561
6139,239014070,270390,239284460,16,0,0,45568,16,3461753057
6140,239032872,3422,239036294,32,0,1,3584,32,9600816921
6141,239042219,142877,239185096,5,0,0,15360,5,2784126902
6142,239044791,1994,239046785,9,0,1,2048,9,9681043714
6143,239053923,60951,239114874,2,0,0,2560,2,8948370829
6144,239056667,2630,239059297,15,0,1,2048,15,5245002682
6145,239060657,6488,239067145,9,0,1,15872,9,5741790202
6146,239063824,202734,239266558,2,0,0,2560,2,7161576607
6147,239071569,171851,239243420,10,0,0,6656,10,6494856556
6148,239119686,81850,239201536,8,0,0,1536,8,3872500305
6149,239148373,172052,239320425,14,0,0,15872,14,4773251864
6150,239160976,1994,239162970,8,0,1,2048,8,3207363372
6151,239236877,93450,239330327,9,0,0,8192,9,1225751752
6152,239284998,103307,239388305,19,0,0,15872,19,3840511432
6153,239306486,101660,239408146,8,0,0,33792,8,8980822112
6154,239311444,1518,239312962,6,0,1,1536,6,7236123289
6155,239340829,106899,239447728,12,0,0,16384,12,312342128
6156,239343110,2470,239345580,0,0,1,2560,0,10365181123
6157,239371332,43904,239415236,27,0,0,512,27,2426136815
6158,239403291,72223,239475514,19,0,0,5632,19,4768622176
6159,239404356,49403,239453759,4,0,0,1024,4,8237721543
6160,239409174,1994,239411168,1,0,1,2048,1,211159524
6161,239439141,95336,239534477,2,0,0,28160,2,7022113952
6162,239458828,58257,239517085,18,0,0,3072,18,3267827037
6163,239464674,95724,239560398,0,0,0,512,0,10157097697
6164,239464840,7706,239472546,25,0,1,8192,25,8862142766
6165,239484438,158252,239642690,38,0,0,512,38,1782511188
6166,239486027,85292,239571319,38,0,0,15360,38,4573438309
6167,239494092,207027,239701119,15,0,0,39424,15,1409216736
6168,239495646,109759,239605405,34,0,0,5120,34,2632816751
6169,239496085,5802,239501887,8,0,1,6144,8,10174672436
6170,239503322,119554,239622876,21,0,0,17920,21,6961501413
6171,239547535,1042,239548577,26,0,1,1024,26,2114035260
6172,239554051,70868,239624919,25,0,0,6656,25,3820031041
6173,239554987,2946,239557933,9,0,1,3072,9,4469107257
6174,239559626,5326,239564952,30,0,1,5632,30,5361611170
6175,239564973,162443,239727416,15,0,0,45568,15,2254142513
6176,239572145,89546,239661691,27,0,0,12288,27,7999457382
6177,239593008,115783,239708791,18,0,0,512,18,1844330873
6178,239611360,2470,239613830,30,0,1,2560,30,3287161840
6179,239613198,196394,239809592,34,0,0,15360,34,2395271519
6180,239641032,155387,239796419,12,0,0,25088,12,583370667
6181,239658647,5506,239664153,2,0,1,2560,2,1366161249
6182,239677528,2870,239680398,0,0,1,8704,0,9516830809
6183,239680491,1518,239682009,7,0,1,1536,7,5712968766
6184,239685458,15676,239701134,10,0,1,17920,10,4513385724
6185,239699935,209664,239909599,13,0,0,1024,13,5805667989
6186,239701543,279806,239981349,18,0,0,37888,18,3329550354
6187,239713174,14257,239727431,12,0,1,2048,12,815278221
6188,239726536,5261,239731797,34,0,1,4608,34,1783675784
6189,239733462,6754,239740216,13,0,1,7168,13,8325443251
6190,239733754,306365,240040119,9,0,0,17920,9,2671451170
6191,239744366,85023,239829389,2,0,0,6144,2,10652441511
6192,239770858,151067,239921925,27,0,0,9216,27,4457599011
6193,239773305,190848,239964153,34,0,0,15360,34,3333341305
6194,239789738,221336,240011074,24,0,0,14848,24,5523417531
6195,239789946,12978,239802924,10,0,1,15872,10,4565665310
6196,239796583,100123,239896706,15,0,0,15872,15,9445244397
6197,239802963,67115,239870078,1,0,0,4096,1,374186728
6198,239831094,57440,239888534,25,0,0,4608,25,4805161022
6199,239833903,97136,239931039,30,0,0,18944,30,7156328092
6200,239837205,169330,240006535,17,0,0,33792,17,48882762
6201,239865810,103350,239969160,8,0,0,16384,8,8548508100
6202,239885123,163069,240048192,38,0,0,12288,38,6211351607
6203,239902472,2946,239905418,13,0,1,3072,13,5005624133
6204,239914639,1994,239916633,6,0,1,2048,6,2929349554
6205,239957194,115721,240072915,20,0,0,9216,20,1263715040
6206,239964517,103175,240067692,14,0,0,23552,14,3759777151
6207,239985589,58844,240044433,7,0,0,9216,7,5493547349
6208,240033445,129137,240162582,6,0,0,25600,6,2239691404
6209,240033476,6658,240040134,9,0,1,3072,9,6292735229
6210,240059515,8192,240067707,9,0,1,7680,9,4304593322
6211,240084455,82845,240167300,37,0,0,15360,37,2275985240
6212,240086159,222804,240308963,7,0,0,45568,7,3880770942
6213,240094548,185251,240279799,22,0,0,81920,22,3788429280
6214,240099826,10241,240110067,26,0,1,16384,26,6070262422
6215,240115088,202312,240317400,5,0,0,16896,5,4643219676
6216,240130600,153434,240284034,9,0,0,13824,9,6228148445
6217,240131670,1518,240133188,34,0,1,1536,34,10724231730
6218,240145460,6278,240151738,34,0,1,6656,34,6607373795
6219,240152333,10264,240162597,6,0,1,9728,6,10707562628
6220,240156330,212493,240368823,9,0,0,2048,9,1248501987
6221,240164536,3322,240167858,19,0,1,512,19,7967597419
6222,240181685,102364,240284049,16,0,1,147456,16,3863364265
6223,240189181,122932,240312113,5,0,0,2048,5,3574939540
6224,240201520,109954,240311474,22,0,0,8192,22,2910592964
6225,240234820,49244,240284064,12,0,1,11264,12,708480255
6226,240262533,216636,240479169,0,0,0,31744,0,8424369092
6227,240276480,161613,240438093,5,0,0,17920,5,4572451515
6228,240279348,11487,240290835,31,0,1,7168,31,3670481072
6229,240306105,276325,240582430,31,0,0,24064,31,1319311936
6230,240330049,172562,240502611,17,0,0,11776,17,6436356268
6231,240349806,168742,240518548,13,0,0,19456,13,3396271367
6232,240352949,239872,240592821,38,0,0,6144,38,4637469432
6233,240362588,246316,240608904,21,0,0,52736,21,2682095476
6234,240366746,97592,240464338,2,0,0,29184,2,3527769092
6235,240370980,163470,240534450,25,0,0,22016,25,3481057603
6236,240381910,99618,240481528,3,0,0,512,3,6117815401
6237,240382098,227609,240609707,35,0,0,2560,35,1450912320
6238,240383544,1994,240385538,26,0,1,2048,26,2054660218
6239,240408932,205002,240613934,6,0,0,13824,6,2701257663
6240,240462441,197886,240660327,21,0,0,14848,21,5301506784
6241,240488508,3128,240491636,22,0,1,9216,22,10321986831
6242,240494081,178277,240672358,28,0,0,24576,28,7711704350
6243,240506508,3422,240509930,12,0,1,3584,12,9233875244
6244,240522938,63915,240586853,13,0,0,4608,13,8957491717
6245,240536235,172149,240708384,16,0,0,40448,16,8366111058
6246,240545805,150240,240696045,21,0,0,25088,21,8883620085
6247,240576578,97051,240673629,14,0,0,4096,14,1520674407
6248,240588380,132351,240720731,36,0,0,40448,36,8146812025
6249,240595919,180545,240776464,10,0,0,64512,10,27098364
6250,240608741,8572,240617313,1,0,1,9728,1,10346500080
6251,240632058,152734,240784792,31,0,0,2048,31,1756055113
6252,240670296,5286,240675582,13,0,1,2048,13,515027520
6253,240680259,3898,240684157,30,0,1,4096,30,386875968
6254,240695149,29703,240724852,26,0,1,11264,26,1276267652
6255,240714771,64064,240778835,33,0,0,5632,33,4198183511
6256,240720788,84944,240805732,7,0,0,2048,7,3097739023
6257,240735806,46406,240782212,10,0,0,1024,10,9833857981
6258,240737942,211360,240949302,1,0,0,1024,1,6403269522
6259,240776170,2688,240778858,25,0,1,2048,25,5107688270
6260,240777383,78641,240856024,4,0,0,11776,4,8340583510
6261,240795949,1042,240796991,6,0,1,1024,6,5054670058
6262,240798232,95130,240893362,28,0,0,7168,28,542045278
6263,240823913,4374,240828287,2,0,1,4608,2,10640712158
6264,240865531,83444,240948975,37,0,0,14336,37,9772806020
6265,240872492,64208,240936700,25,0,0,6656,25,9798494573
6266,240874711,119911,240994622,21,0,0,25088,21,7708598102
6267,240883275,103688,240986963,27,0,0,40448,27,3337785045
6268,240890112,147875,241037987,25,0,0,46592,25,1387816884
6269,240915301,171334,241086635,20,0,0,22528,20,10596110466
6270,240936665,158143,241094808,39,0,0,17920,39,8142618614
6271,240943372,5945,240949317,9,0,1,5120,9,10258991129
6272,240962042,89744,241051786,33,0,0,14848,33,3216276067
6273,240964169,139295,241103464,31,0,0,22016,31,2993759559
6274,240996133,345785,241341918,33,0,0,26112,33,1414993652
6275,241014018,214600,241228618,27,0,0,34816,27,7320423884
6276,241044087,103077,241147164,14,0,0,3072,14,1779235727
6277,241048076,8639,241056715,30,0,1,12800,30,1464269469
6278,241055805,185222,241241027,16,0,0,12800,16,9321883845
6279,241063436,153132,241216568,9,0,0,5632,9,9342165041
6280,241064455,13341,241077796,25,0,1,22528,25,6151917183
6281,241068308,162844,241231152,17,0,0,6656,17,9719789175
6282,241089476,125361,241214837,16,0,0,69120,16,4468064224
6283,241119369,202820,241322189,35,0,0,51200,35,5751323600
6284,241134175,94926,241229101,12,0,0,1536,12,4647326309
6285,241141879,76116,241217995,18,0,0,4608,18,6256169313
6286,241151344,1042,241152386,34,0,1,1024,34,7236091560
6287,241152243,253030,241405273,30,0,0,7680,30,454855455
6288,241162871,2946,241165817,12,0,1,3072,12,10669243552
6289,241191313,57440,241248753,39,0,0,4608,39,5129555812
6290,241212044,150503,241362547,3,0,0,9728,3,2339950622
6291,241219917,21125,241241042,30,0,1,6656,30,3546537513
6292,241228076,12981,241241057,18,0,1,3072,18,1655845988
6293,241253881,171773,241425654,29,0,0,16384,29,334518909
6294,241291834,104480,241396314,10,0,0,15872,10,2054272745
6295,241329397,155992,241485389,15,0,0,37888,15,3003881669
6296,241352443,79590,241432033,24,0,0,14848,24,6222553901
6297,241354676,153544,241508220,35,0,0,59392,35,7209905465
6298,241359806,151097,241510903,9,0,0,8704,9,1190796212
6299,241403347,114011,241517358,32,0,0,2560,32,9419547032
6300,241436510,4374,241440884,22,0,1,4608,22,5610563380
6301,241451719,110014,241561733,13,0,0,24064,13,7731788452
6302,241458495,84428,241542923,13,0,0,1536,13,8631854956
6303,241461033,106643,241567676,18,0,0,19456,18,1299145700
6304,241477884,92311,241570195,10,0,0,8192,10,4172291094
6305,241491855,109641,241601496,13,0,0,16384,13,4581281308
6306,241492882,151387,241644269,27,0,0,20480,27,10679930283
6307,241504707,174993,241679700,35,0,0,23552,35,6639089412
6308,241507882,7975,241515857,21,0,1,12800,21,5642469488
6309,241520428,81551,241601979,16,0,0,1536,16,1253478134
6310,241539583,4850,241544433,19,0,1,5120,19,7365078304
6311,241549181,53749,241602930,34,0,0,3072,34,5511105856
6312,241561468,90956,241652424,15,0,0,4608,15,2578186744
6313,241588890,161973,241750863,14,0,0,33280,14,3586492304
6314,241595111,145597,241740708,22,0,0,62464,22,9254661852
6315,241632113,138564,241770677,31,0,0,3072,31,3665703277
6316,241648280,159090,241807370,9,0,0,37376,9,6372391479
6317,241671611,144675,241816286,21,0,0,6144,21,1537108288
6318,241679998,218503,241898501,24,0,0,27136,24,979646275
6319,241685643,4420,241690063,32,0,1,11776,32,5827951168
6320,241703998,134881,241838879,37,0,0,29184,37,9741730146
6321,241710803,139074,241849877,21,0,0,8704,21,4826156210
6322,241745759,11584,241757343,14,0,1,15872,14,754135693
6323,241752849,5160,241758009,21,0,1,1024,21,2245211566
6324,241763571,242165,242005736,26,0,0,38912,26,7469690424
6325,241832574,106961,241939535,27,0,0,24576,27,9000063918
6326,241846401,147464,241993865,31,0,0,40448,31,4359443330
6327,241849882,10244,241860126,23,0,1,16384,23,8047524918
6328,241870474,75295,241945769,18,0,0,3584,18,1450903829
6329,241881722,149025,242030747,26,0,0,4096,26,2906266743
6330,241901152,207098,242108250,24,0,0,16896,24,2974337703
6331,241904288,351753,242256041,28,0,0,57344,28,8709341227
6332,241907791,284868,242192659,7,0,0,4608,7,4835090069
6333,241921881,181198,242103079,39,0,0,33792,39,1323545574
6334,241941903,144470,242086373,22,0,0,34304,22,52465016
6335,241941986,234887,242176873,37,0,0,55296,37,3208825132
6336,241973867,4374,241978241,38,0,1,4608,38,6838495610
6337,241985285,23932,242009217,32,0,1,3584,32,6902622841
6338,241990939,282988,242273927,3,0,0,11776,3,5458430435
6339,241994990,348695,242343685,16,0,0,8192,16,1690105446
6340,241995755,260933,242256688,13,0,0,2048,13,5542222280
6341,242018112,6278,242024390,37,0,1,6656,37,6314201606
6342,242021943,169297,242191240,32,0,0,47104,32,6410803348
6343,242049923,154456,242204379,12,0,0,8704,12,7332075217
6344,242058430,7706,242066136,37,0,1,8192,37,4553425906
6345,242058834,242687,242301521,16,0,0,60416,16,6945784192
6346,242061944,5971,242067915,19,0,1,14848,19,9062462921
6347,242066152,2749,242068901,2,0,1,1536,2,4742997775
6348,242095449,497684,242593133,26,0,0,14848,26,6010558866
6349,242101778,9452,242111230,2,0,1,3072,2,3882003411
6350,242103582,439743,242543325,28,0,0,68608,28,10233536912
6351,242105344,6746,242112090,27,0,1,8704,27,5599181552
6352,242115072,483871,242598943,30,0,0,18944,30,2273189396
6353,242121024,446824,242567848,30,0,0,80384,30,758005795
6354,242143995,6278,242150273,9,0,1,6656,9,5147973367
6355,242155347,244270,242399617,39,0,0,45568,39,7193235971
6356,242172859,258285,242431144,37,0,0,103424,37,7261426294
6357,242176736,398326,242575062,5,0,0,10752,5,2031210873
6358,242213407,232589,242445996,34,0,0,10240,34,4610766770
6359,242215506,449165,242664671,39,0,0,31744,39,10647529345
6360,242219135,286674,242505809,0,0,0,64512,0,6793884325
6361,242229856,3387,242233243,8,0,1,9728,8,9600633463
6362,242246609,266578,242513187,29,0,0,17920,29,152334343
6363,242260868,4850,242265718,24,0,1,5120,24,5905326177
6364,242274985,247421,242522406,8,0,0,30208,8,9868206143
6365,242285728,16418,242302146,8,0,1,512,8,903077140
6366,242287972,394258,242682230,18,0,0,1536,18,10214674819
6367,242288124,360939,242649063,1,0,0,7680,1,3687446457
6368,242300930,7560,242308490,2,0,1,7168,2,1016371202
6369,242325487,250089,242575576,22,0,0,1536,22,3664000198
6370,242350361,329940,242680301,29,0,0,51200,29,209702139
6371,242362504,145200,242507704,20,0,0,6144,20,363195492
6372,242362718,283990,242646708,34,0,0,51712,34,5811826548
6373,242375673,208225,242583898,29,0,0,15360,29,2972736736
6374,242393526,185653,242579179,29,0,0,11776,29,3625095174
6375,242422348,287942,242710290,2,0,0,42496,2,3485603755
6376,242428757,143014,242571771,16,0,0,12800,16,6180815469
6377,242431165,332639,242763804,1,0,0,16384,1,4804398790
6378,242457274,5326,242462600,23,0,1,5632,23,1856032291
6379,242476139,347212,242823351,12,0,0,19456,12,8879127787
6380,242486625,194627,242681252,7,0,0,3072,7,8334798746
6381,242494498,80595,242575093,6,0,1,8192,6,4739398193
6382,242507687,76234,242583921,20,0,1,1024,20,3187004140
6383,242514025,322141,242836166,19,0,0,41984,19,9423861008
6384,242528598,64550,242593148,19,0,1,5120,19,8718723749
6385,242560148,398650,242958798,28,0,0,43008,28,4873523921
6386,242568974,485506,243054480,17,0,0,33280,17,2077829597
6387,242573881,160157,242734038,15,0,0,30720,15,6610937298
6388,242576151,763897,243340048,39,0,0,55296,39,3574689218
6389,242588786,669164,243257950,22,0,0,13824,22,3590182414
6390,242651826,12860,242664686,13,0,1,4608,13,5538275168
6391,242674371,143037,242817408,8,0,0,60416,8,3712412426
6392,242712343,11274,242723617,9,0,1,18432,9,6514021678
6393,242741242,95735,242836977,33,0,0,2560,33,8824191638
6394,242747536,111869,242859405,22,0,0,1024,22,6365360048
6395,242778980,1994,242780974,7,0,1,2048,7,7634522803
6396,242789191,69887,242859078,8,0,0,3072,8,239058568
6397,242789605,212477,243002082,8,0,0,512,8,7209021843
6398,242789858,281516,243071374,37,0,0,17408,37,2591885233
6399,242797617,143601,242941218,10,0,0,60928,10,5410887151
6400,242806755,34591,242841346,14,0,1,13312,14,6356673324
6401,242821072,180839,243001911,34,0,0,12288,34,9492458881
6402,242842693,100740,242943433,15,0,0,7168,15,10722336320
6403,242866262,217873,243084135,7,0,0,4608,7,10304751412
6404,242867244,198803,243066047,0,0,0,37888,0,6280317476
6405,242874847,207869,243082716,4,0,0,12800,4,2951277901
6406,242875547,112544,242988091,0,0,0,19456,0,9927879454
6407,242918205,291546,243209751,30,0,0,10240,30,7724427805
6408,242922424,75728,242998152,35,0,0,9728,35,1844848396
6409,242923597,242839,243166436,22,0,0,61952,22,9013763798
6410,242936198,7760,242943958,19,0,1,512,19,2783642391
6411,242954194,15870,242970064,16,0,1,18432,16,4417109515
6412,242967875,173468,243141343,1,0,0,16384,1,6419967589
6413,243001822,13077,243014899,2,0,1,21504,2,1225173329
6414,243021344,163736,243185080,4,0,0,7680,4,3182575770
6415,243039872,301454,243341326,30,0,0,4096,30,1447624643
6416,243045156,26249,243071405,0,0,1,1536,0,229276249
6417,243057322,17222,243074544,9,0,1,9216,9,5151744553
6418,243058846,17848,243076694,22,0,1,2560,22,366248486
6419,243068790,378580,243447370,34,0,0,10752,34,6971943914
6420,243095296,212434,243307730,11,0,0,89088,11,6982014054
6421,243097418,346661,243444079,32,0,0,39936,32,7553907917
6422,243098846,12049,243110895,10,0,1,19968,10,6744089208
6423,243134724,297172,243431896,35,0,0,54272,35,7620870826
6424,243138765,174916,243313681,13,0,0,19456,13,5025048677
6425,243147688,240612,243388300,10,0,0,27136,10,8073152206
6426,243162282,7558,243169840,2,0,1,9728,2,3476462953
6427,243176497,348717,243525214,25,0,0,9216,25,184250876
6428,243184728,218946,243403674,39,0,0,39936,39,10014747232
6429,243241452,3128,243244580,28,0,1,9216,28,1664466076
6430,243250361,7612,243257973,18,0,1,7168,18,9103459140
6431,243257079,190782,243447861,11,0,0,1536,11,7651613448
6432,243265565,332316,243597881,33,0,0,33792,33,7106680301
6433,243281615,38854,243320469,19,0,1,7168,19,8548647701
6434,243298439,241576,243540015,29,0,0,44032,29,8307625764
6435,243303068,272846,243575914,32,0,0,19456,32,3239665615
6436,243306771,33292,243340063,13,0,1,8192,13,8934055997
6437,243318134,204242,243522376,28,0,0,41472,28,9703072923
6438,243330046,304526,243634572,33,0,0,28672,33,754886727
6439,243335973,68340,243404313,24,0,0,2048,24,3692419545
6440,243359294,203636,243562930,8,0,0,2048,8,7698026431
6441,243369249,241136,243610385,27,0,0,14336,27,9904437960
6442,243382322,219652,243601974,31,0,0,10752,31,5740726424
6443,243408593,135805,243544398,15,0,0,14336,15,2811500636
6444,243444251,124115,243568366,33,0,0,14848,33,7576789109
6445,243446408,12719,243459127,1,0,1,18432,1,6569803434
6446,243448480,162856,243611336,1,0,0,3072,1,1097066805
6447,243453919,102053,243555972,4,0,0,2048,4,7036986553
6448,243470921,5802,243476723,35,0,1,6144,35,10169523042
6449,243482509,279677,243762186,39,0,0,48128,39,10236797769
6450,243491520,229707,243721227,7,0,0,60416,7,6022578982
6451,243494541,1042,243495583,37,0,1,1024,37,6712795387
6452,243496569,165835,243662404,31,0,0,14848,31,5745524161
6453,243509049,13342,243522391,13,0,1,2560,13,5653818432
6454,243523490,2758,243526248,2,0,1,1024,2,8250821585
6455,243531244,171560,243702804,12,0,0,17920,12,4395604015
6456,243561454,87771,243649225,1,0,0,12288,1,5040054768
6457,243568919,103508,243672427,5,0,0,6656,5,285293558
6458,243570356,167205,243737561,18,0,0,14336,18,6204661219
6459,243582722,1994,243584716,26,0,1,2048,26,6186345155
6460,243590169,13506,243603675,22,0,1,6144,22,5631898026
6461,243625016,152439,243777455,24,0,0,14848,24,3407355631
6462,243629661,377181,244006842,3,0,0,2048,3,5613848650
6463,243641325,364870,244006195,5,0,0,205312,5,2841201941
6464,243653335,357297,244010632,24,0,0,9728,24,10624621201
6465,243668414,202995,243871409,22,0,0,95232,22,7882695128
6466,243679296,1042,243680338,27,0,1,1024,27,8241863164
6467,243684246,5802,243690048,8,0,1,6144,8,502319157
6468,243705831,365424,244071255,17,0,0,4096,17,4410031426
6469,243709608,337974,244047582,32,0,0,34816,32,7992734017
6470,243718996,6171,243725167,14,0,1,4096,14,6852783144
6471,243728709,164183,243892892,34,0,0,4096,34,4586925108
6472,243755083,505234,244260317,1,0,0,16384,1,8542506277
6473,243761250,130379,243891629,15,0,0,3072,15,10394411443
6474,243762084,156539,243918623,27,0,0,2048,27,5920383210
6475,243800140,207513,244007653,31,0,0,2560,31,4547623392
6476,243820921,7230,243828151,22,0,1,7680,22,8830240552
6477,243846086,261256,244107342,16,0,0,69632,16,6324470014
6478,243850139,362812,244212951,16,0,0,103936,16,7727707664
6479,243860658,373056,244233714,28,0,0,68096,28,8213229905
6480,243867502,204197,244071699,4,0,0,512,4,7145541468
6481,243891480,6858,243898338,28,0,1,13824,28,5971165647
6482,243895525,3159,243898684,28,0,1,512,28,8341967204
6483,243901581,216847,244118428,10,0,0,32768,10,5938721669
6484,243909879,139294,244049173,16,0,0,5120,16,5903016461
6485,243915239,357729,244272968,20,0,0,41472,20,3774581081
6486,243924330,91765,244016095,1,0,0,8704,1,6452450076
6487,243929701,1042,243930743,16,0,1,1024,16,978158928
6488,243950297,181841,244132138,18,0,0,1024,18,2260632981
6489,243989868,256824,244246692,35,0,0,35840,35,7416789454
6490,243992266,378863,244371129,2,0,0,23040,2,2129926548
6491,244000605,253122,244253727,39,0,0,23040,39,10711048410
6492,244007146,352214,244359360,26,0,0,71680,26,6324281131
6493,244008731,7379,244016110,21,0,1,10752,21,4682039301
6494,244010287,370805,244381092,16,0,0,22016,16,10022720327
6495,244030898,1042,244031940,1,0,1,1024,1,3958183655
6496,244040422,214880,244255302,5,0,0,5120,5,7814624647
6497,244040595,12460,244053055,9,0,1,4096,9,2258278643
6498,244043268,281734,244325002,0,0,0,6656,0,6056682873
6499,244052159,183598,244235757,15,0,0,6656,15,4364997264
6500,244079373,224915,244304288,18,0,0,5632,18,2694033882
6501,244089164,19212,244108376,19,0,1,1024,19,9965705862
6502,244107453,10990,244118443,28,0,1,14848,28,9366692573
6503,244142777,566,244143343,32,0,1,512,32,1999306273
6504,244149478,214265,244363743,35,0,0,14336,35,2871426648
6505,244152396,158792,244311188,30,0,0,3072,30,8632144347
6506,244241331,122739,244364070,22,0,0,1024,22,4693112382
6507,244246536,167638,244414174,35,0,0,9728,35,7631151750
6508,244275026,146027,244421053,16,0,0,22528,16,82358320
6509,244275303,1994,244277297,14,0,1,2048,14,2826158695
6510,244306771,180243,244487014,36,0,0,82432,36,3653709164
6511,244351267,71049,244422316,17,0,0,4096,17,1544584203
6512,244352746,267071,244619817,32,0,0,76800,32,2533484484
6513,244353069,28285,244381354,28,0,1,16384,28,8333485351
6514,244363616,59869,244423485,24,0,0,3072,24,8005522993
6515,244365368,188222,244553590,26,0,0,16384,26,9006572544
6516,244379086,379621,244758707,35,0,0,35840,35,2478779926
6517,244381153,148947,244530100,10,0,0,26112,10,7389854341
6518,244381448,295142,244676590,18,0,0,59904,18,9529135085
6519,244399743,156202,244555945,14,0,0,7680,14,2535678875
6520,244410931,223737,244634668,33,0,0,48640,33,2624229174
6521,244451544,588621,245040165,1,0,0,15360,1,3654225193
6522,244462698,29676,244492374,4,0,1,5632,4,953551740
6523,244463987,132415,244596402,21,0,0,15360,21,10008581042
6524,244483509,276001,244759510,34,0,0,2560,34,9692490297
6525,244495046,4374,244499420,20,0,1,4608,20,6856668455
6526,244495161,196670,244691831,4,0,0,23040,4,4451614664
6527,244503472,3128,244506600,14,0,1,9216,14,6925285863
6528,244503525,275792,244779317,16,0,0,1536,16,5559870261
6529,244506514,4850,244511364,30,0,1,5120,30,5893302580
6530,244509574,66680,244576254,14,0,0,9728,14,5844881881
6531,244518817,275991,244794808,22,0,0,8192,22,5111413761
6532,244530339,626317,245156656,8,0,0,28160,8,5531595294
6533,244534075,481827,245015902,26,0,0,28672,26,392142913
6534,244543261,265290,244808551,5,0,0,45056,5,3039291375
6535,244553360,318580,244871940,18,0,0,7680,18,2576110552
6536,244554186,388332,244942518,14,0,0,1024,14,2234748926
6537,244559330,75869,244635199,16,0,0,1536,16,2806503587
6538,244574885,144695,244719580,32,0,0,12288,32,7175230808
6539,244584438,1994,244586432,10,0,1,2048,10,5363264032
6540,244596118,346049,244942167,38,0,0,37888,38,5440787463
6541,244598285,38436,244636721,30,0,1,2048,30,2741455638
6542,244609440,687766,245297206,11,0,0,13312,11,3788229178
6543,244609591,468534,245078125,7,0,0,25600,7,8661535427
6544,244613396,177952,244791348,25,0,0,31744,25,193367675
6545,244617454,196951,244814405,28,0,0,15872,28,1956402733
6546,244623009,16304,244639313,23,0,1,10752,23,1480051710
6547,244623400,18707,244642107,23,0,1,3584,23,4577454021
6548,244647936,258707,244906643,21,0,0,90624,21,546740487
6549,244695655,3898,244699553,9,0,1,4096,9,6004168310
6550,244698944,640533,245339477,15,0,0,18432,15,5615605282
6551,244701855,401205,245103060,20,0,0,24064,20,4605538074
6552,244707984,222624,244930608,20,0,0,38912,20,9775652793
6553,244748426,544701,245293127,14,0,0,99328,14,4417367513
6554,244764339,3898,244768237,14,0,1,4096,14,4206218831
6555,244795966,615238,245411204,30,0,0,56832,30,8317320260
6556,244854408,241297,245095705,10,0,0,7680,10,1814041576
6557,244854993,180477,245035470,2,0,0,54272,2,2040393577
6558,244859650,143354,245003004,29,0,0,2048,29,5981236395
6559,244894410,16123,244910533,38,0,1,4096,38,4828373244
6560,244907614,351252,245258866,25,0,0,28160,25,5318260979
6561,244931516,15381,244946897,18,0,1,11776,18,6778520560
6562,244937117,228461,245165578,13,0,0,1536,13,2312831621
6563,244938337,108170,245046507,25,0,0,1536,25,5609901991
6564,244951415,89077,245040492,30,0,0,1024,30,305811108
6565,244953255,265418,245218673,18,0,0,82944,18,9669764607
6566,244958075,566,244958641,0,0,1,512,0,1877385770
6567,244972782,420527,245393309,31,0,0,33792,31,6514697242
6568,244982305,182790,245165095,16,0,0,27648,16,9509604497
6569,245008835,217824,245226659,5,0,0,16896,5,2065836119
6570,245015941,205555,245221496,17,0,0,9216,17,4368690339
6571,245038655,39485,245078140,18,0,1,51200,18,4826357672
6572,245039475,108586,245148061,39,0,0,12800,39,9177561995
6573,245043829,34326,245078155,35,0,1,1536,35,4641486162
6574,245058939,20485,245079424,10,0,1,22528,10,1405601876
6575,245093793,545292,245639085,30,0,0,83968,30,5380064884
6576,245100220,382943,245483163,10,0,0,16384,10,4966098563
6577,245101286,7117,245108403,27,0,1,5632,27,8750925633
6578,245107026,328529,245435555,1,0,0,79872,1,9711399004
6579,245108417,243806,245352223,3,0,0,16384,3,9051290854
6580,245108418,7730,245116148,12,0,1,8192,12,7738571625
6581,245110680,486342,245597022,29,0,0,1536,29,2045538797
6582,245128564,328144,245456708,10,0,0,17920,10,5615357974
6583,245131763,456321,245588084,12,0,0,144384,12,5595344231
6584,245138431,473746,245612177,17,0,0,49664,17,937848107
6585,245143930,525050,245668980,34,0,0,37888,34,8067482733
6586,245163459,433064,245596523,30,0,0,27648,30,10370587316
6587,245191393,252346,245443739,37,0,0,21504,37,422083294
6588,245228683,2870,245231553,22,0,1,8704,22,10149933089
6589,245264960,211350,245476310,26,0,0,5632,26,6103820967
6590,245278933,22205,245301138,2,0,1,4096,2,9958505395
6591,245280724,376697,245657421,34,0,0,26624,34,9990258961
6592,245288834,20928,245309762,25,0,1,18432,25,3297608381
6593,245315415,151235,245466650,20,0,0,17408,20,3730507448
6594,245327343,12566,245339909,37,0,1,20992,37,9003493136
6595,245369105,159538,245528643,24,0,0,19456,24,2884961398
6596,245374310,1994,245376304,25,0,1,2048,25,9025523241
6597,245384991,287436,245672427,17,0,0,11264,17,1235420433
6598,245387558,261728,245649286,17,0,0,11776,17,3250001613
6599,245397626,324003,245721629,11,0,0,37888,11,3276030666
6600,245404569,689016,246093585,2,0,0,300544,2,8546030510
6601,245417195,344800,245761995,10,0,0,40448,10,5028944600
6602,245427163,322477,245749640,31,0,0,57344,31,8383023082
6603,245442164,407406,245849570,18,0,0,36352,18,7884847095
6604,245443833,201850,245645683,37,0,0,21504,37,4103060325
6605,245454068,159410,245613478,35,0,0,4096,35,5741292892
6606,245477394,134806,245612200,17,0,1,176640,17,2065666487
6607,245480951,319884,245800835,5,0,0,22016,5,9659858075
6608,245508901,103314,245612215,37,0,1,1024,37,5663092959
6609,245511098,361242,245872340,15,0,0,4096,15,1527414885
6610,245552983,130501,245683484,24,0,0,1536,24,10099798048
6611,245553029,86087,245639116,10,0,1,6656,10,8911629959
6612,245568253,265003,245833256,21,0,0,13312,21,1996488499
6613,245582454,595440,246177894,34,0,0,19456,34,576175128
6614,245618809,672743,246291552,4,0,0,43520,4,5182257664
6615,245619136,870836,246489972,31,0,0,22016,31,5525146139
6616,245631670,265012,245896682,35,0,0,3584,35,715605
6617,245661871,14922,245676793,19,0,1,4608,19,3122353764
6618,245687751,285086,245972837,32,0,0,22016,32,1914079905
6619,245695192,422799,246117991,34,0,0,41472,34,3896132334
6620,245698718,261690,245960408,39,0,0,25088,39,897693521
6621,245708595,13057,245721652,27,0,1,15360,27,1524887444
6622,245713015,9172,245722187,14,0,1,512,14,1390857812
6623,245741016,240107,245981123,30,0,0,512,30,7953754473
6624,245741271,250415,245991686,21,0,0,5632,21,8727578172
6625,245788591,330983,246119574,19,0,0,5120,19,10149888886
6626,245818160,414724,246232884,25,0,0,12288,25,3926595362
6627,245839581,284399,246123980,14,0,0,10752,14,8446254714
6628,245844093,852411,246696504,32,0,0,27136,32,6876464951
6629,245861968,258713,246120681,16,0,0,3584,16,9768104349
6630,245869943,123411,245993354,18,0,0,1024,18,3846046811
6631,245872921,108023,245980944,3,0,0,12288,3,9443576189
6632,245883653,486985,246370638,5,0,0,65024,5,5922469898
6633,245884578,220762,246105340,10,0,0,38400,10,632073382
6634,245900955,233383,246134338,7,0,0,16384,7,10517592949
6635,245932012,4679,245936691,6,0,1,12288,6,2136500886
6636,245972377,333253,246305630,16,0,0,24576,16,2231058057
6637,245976570,157955,246134525,27,0,0,512,27,3123058563
6638,245979326,150005,246129331,0,0,0,17408,0,1703171786
6639,245983712,280765,246264477,25,0,0,47616,25,1467003565
6640,245987232,872636,246859868,21,0,0,15360,21,4344657440
6641,246016945,160972,246177917,39,0,1,83456,39,7666613512
6642,246023080,182152,246205232,27,0,0,6656,27,7998609999
6643,246024888,273231,246298119,17,0,0,21504,17,2934013103
6644,246026965,150967,246177932,9,0,1,1024,9,5341160352
6645,246045151,173007,246218158,8,0,0,15872,8,6425162343
6646,246055843,867523,246923366,32,0,0,20992,32,5705572879
6647,246060442,347888,246408330,9,0,0,11264,9,1403485490
6648,246083073,97899,246180972,2,0,1,7680,2,4305314568
6649,246096608,84710,246181318,23,0,1,512,23,6469946851
6650,246121534,283349,246404883,2,0,0,43520,2,1567858383
6651,246130925,278668,246409593,36,0,0,4096,36,9490071064
6652,246132396,466014,246598410,16,0,0,13824,16,133871135
6653,246140740,428054,246568794,39,0,0,52736,39,3568222681
6654,246141287,891960,247033247,34,0,0,50688,34,3412879617
6655,246143614,39330,246182944,7,0,1,2560,7,7723126964
6656,246173439,206886,246380325,30,0,0,31744,30,3720634015
6657,246176273,7337,246183610,32,0,1,1024,32,2337099988
6658,246195966,247194,246443160,17,0,0,29696,17,6302397994
6659,246209275,64912,246274187,16,0,1,109568,16,9967798225
6660,246214822,393861,246608683,33,0,0,19456,33,9656562621
6661,246220373,53968,246274341,21,0,1,8704,21,2594665894
6662,246237401,492160,246729561,39,0,0,13312,39,10104790210
6663,246237633,423903,246661536,22,0,0,38400,22,1268896993
6664,246258950,840310,247099260,27,0,0,33280,27,83642375
6665,246295680,324462,246620142,11,0,0,29696,11,9338717933
6666,246302424,9952,246312376,34,0,1,7168,34,2517287921
6667,246325695,566,246326261,10,0,1,512,10,7525283796
6668,246330209,350588,246680797,35,0,0,25600,35,6218700496
6669,246337372,346404,246683776,32,0,0,9728,32,449212961
6670,246373995,11665,246385660,11,0,1,5632,11,437458429
6671,246380061,7865,246387926,34,0,1,3584,34,804478381
6672,246389764,121616,246511380,16,0,1,196608,16,9581696112
6673,246394175,118831,246513006,2,0,1,2560,2,6098423684
6674,246419395,395384,246814779,9,0,0,48128,9,9511279716
6675,246455393,59239,246514632,8,0,1,2560,8,10133121052
6676,246464941,239965,246704906,2,0,0,15360,2,4952073439
6677,246482506,954665,247437171,27,0,0,10752,27,10425819418
6678,246496697,475254,246971951,24,0,0,15872,24,9000273713
6679,246510583,136677,246647260,24,0,0,15360,24,5653311871
6680,246538487,456767,246995254,8,0,0,12800,8,179078223
6681,246539291,231910,246771201,21,0,0,1536,21,10237797625
6682,246554720,1172240,247726960,14,0,0,49152,14,10670576870
6683,246556028,16445,246572473,13,0,1,10240,13,2651459347
6684,246558539,112457,246670996,1,0,0,10752,1,4131888300
6685,246583010,4850,246587860,11,0,1,5120,11,3786728025
6686,246602970,986247,247589217,24,0,0,65024,24,2402601202
6687,246610938,11791,246622729,8,0,1,19456,8,3283435728
6688,246620070,3965,246624035,28,0,1,2048,28,2659443221
6689,246641651,19908,246661559,26,0,1,17408,26,1158025757
6690,246651549,13908,246665457,8,0,1,10752,8,5397579650
6691,246657883,1202799,247860682,3,0,0,26624,3,9642533910
6692,246714091,1191681,247905772,24,0,0,60928,24,7350417209
6693,246740386,184399,246924785,11,0,0,4608,11,2891618512
6694,246741692,1250630,247992322,27,0,0,36352,27,7276723993
6695,246746939,5326,246752265,18,0,1,5632,18,9793861762
6696,246762688,13600,246776288,20,0,1,23040,20,6742080975
6697,246769907,7969,246777876,25,0,1,15872,25,10428460817
6698,246772112,42690,246814802,17,0,1,60416,17,4923906071
6699,246775683,39134,246814817,26,0,1,1024,26,4737053622
6700,246787393,27439,246814832,14,0,1,3072,14,8128916302
6701,246790822,184108,246974930,37,0,0,9728,37,9293232065
6702,246796938,116570,246913508,9,0,0,34304,9,9532420716
6703,246804627,13110,246817737,18,0,1,3072,18,2245653223
6704,246817705,184856,247002561,14,0,0,512,14,3408874615
6705,246840883,248222,247089105,15,0,0,10240,15,9150155753
6706,246848653,5326,246853979,9,0,1,5632,9,4080008667
6707,246882814,262783,247145597,3,0,0,25088,3,7732735247
6708,246916893,7907,246924800,1,0,1,4096,1,4375392087
6709,246922334,362894,247285228,29,0,0,80896,29,10428844549
6710,246924835,371484,247296319,0,0,0,36352,0,8630991442
6711,246924967,279273,247204240,27,0,0,43008,27,9575474880
6712,246969483,87979,247057462,4,0,0,1024,4,2760895962
6713,246969615,280792,247250407,1,0,0,10752,1,5306620111
6714,246971623,114291,247085914,27,0,0,8704,27,4752807870
6715,246974590,333148,247307738,7,0,0,37376,7,9950184086
6716,246978384,192979,247171363,30,0,0,3584,30,4053968830
6717,246987225,392779,247380004,1,0,0,3072,1,27581851
6718,247006507,312132,247318639,28,0,0,17920,28,7996523360
6719,247010563,412776,247423339,7,0,0,38912,7,5840452434
6720,247017126,453961,247471087,34,0,0,34304,34,8882675272
6721,247018149,18285,247036434,1,0,1,9216,1,9093747253
6722,247021681,16427,247038108,0,0,1,2048,0,7488090052
6723,247025501,17991,247043492,13,0,1,7168,13,6070264424
6724,247033139,11659,247044798,34,0,1,2048,34,8385033808
6725,247049059,496434,247545493,7,0,0,40448,7,237061462
6726,247054539,657430,247711969,36,0,0,85504,36,8414292751
6727,247060969,150774,247211743,35,0,0,24576,35,5141243218
6728,247083631,277251,247360882,0,0,0,25600,0,9528149488
6729,247085540,535508,247621048,5,0,0,30720,5,9356068499
6730,247097253,541872,247639125,5,0,0,56832,5,1111434552
6731,247099144,4507,247103651,1,0,1,4608,1,4114216645
6732,247099693,582846,247682539,12,0,0,35328,12,1738522130
6733,247109787,1200908,248310695,19,0,0,65536,19,990953533
6734,247122245,566,247122811,37,0,1,512,37,6036731192
6735,247147479,1082380,248229859,38,0,0,10240,38,5937566246
6736,247163356,1198403,248361759,21,0,0,2560,21,10427309355
6737,247168586,204757,247373343,16,0,0,6656,16,2735276788
6738,247179085,162804,247341889,1,0,0,22528,1,1465424605
6739,247218375,634180,247852555,26,0,0,87040,26,4441195312
6740,247254984,497489,247752473,37,0,0,20480,37,4736782666
6741,247265567,603694,247869261,27,0,0,18432,27,1777670947
6742,247289297,23751,247313048,28,0,1,5632,28,3231989457
6743,247295601,1127781,248423382,39,0,0,61952,39,7680703153
6744,247330211,603198,247933409,30,0,0,8704,30,987600734
6745,247331480,217616,247549096,16,0,0,11776,16,5842366875
6746,247332049,183967,247516016,27,0,0,9728,27,7810901763
6747,247368986,1159198,248528184,3,0,0,31744,3,6010919712
6748,247371572,5925,247377497,19,0,1,11264,19,9561486567
6749,247398184,1042,247399226,1,0,1,1024,1,5181713371
6750,247415407,9008,247424415,14,0,1,1024,14,9085811757
6751,247419312,62401,247481713,5,0,0,3072,5,7017497585
6752,247421084,1222657,248643741,7,0,0,37888,7,8649142278
6753,247425277,183357,247608634,18,0,0,27648,18,4843351463
6754,247428667,3898,247432565,7,0,1,4096,7,10519529657
6755,247432416,239344,247671760,5,0,0,52224,5,3346987177
6756,247450977,348835,247799812,2,0,0,34304,2,6943193377
6757,247453327,1211617,248664944,34,0,0,13824,34,10239267084
6758,247463727,277772,247741499,39,0,0,47616,39,3468190162
6759,247474027,272175,247746202,37,0,0,15360,37,8664991128
6760,247517276,122020,247639296,27,0,0,512,27,10199475891
6761,247519334,270011,247789345,8,0,0,13312,8,4145488479
6762,247527371,157289,247684660,27,0,0,5120,27,1989613010
6763,247548779,236495,247785274,24,0,0,31744,24,8731297212
6764,247553668,4679,247558347,28,0,1,12288,28,6346922806
6765,247572340,202980,247775320,14,0,0,11776,14,6985322654
6766,247576333,449632,248025965,38,0,0,18432,38,6954803789
6767,247617432,297403,247914835,22,0,0,29696,22,3468959568
6768,247634762,317709,247952471,36,0,0,48640,36,5904446671
6769,247657823,222376,247880199,33,0,0,3072,33,4139536048
6770,247658993,278643,247937636,33,0,0,13824,33,5652729740
6771,247696413,530288,248226701,11,0,0,56832,11,6487493198
6772,247697486,375633,248073119,6,0,1,529920,6,2348771113
6773,247714059,359726,248073785,22,0,1,1024,22,537773546
6774,247731671,260830,247992501,38,0,0,512,38,8815409357
6775,247760324,391464,248151788,34,0,0,15872,34,4425800739
6776,247767568,307523,248075091,10,0,1,2048,10,283626900
6777,247774892,320892,248095784,5,0,0,28672,5,5557712044
6778,247796655,473472,248270127,37,0,0,44032,37,9400310713
6779,247813202,566535,248379737,18,0,0,38400,18,2995220553
6780,247822652,538312,248360964,5,0,0,59392,5,8226664816
6781,247846757,148385,247995142,3,0,0,2560,3,2501976852
6782,247867408,214476,248081884,18,0,1,31232,18,1816890662
6783,247879023,205810,248084833,13,0,1,5120,13,417024732
6784,247887336,845338,248732674,30,0,0,512,30,3181277481
6785,247916845,400455,248317300,19,0,0,10240,19,3525397266
6786,247926664,155205,248081869,2,0,0,13312,2,9971707040
6787,247928600,167199,248095799,8,0,1,5632,8,2618020415
6788,247949409,341303,248290712,39,0,0,32768,39,9850506835
6789,247977095,118719,248095814,34,0,1,1024,34,5305857337
6790,247978690,335475,248314165,8,0,0,8704,8,5752882665
6791,247983536,358695,248342231,18,0,0,21504,18,82610949
6792,247993398,443159,248436557,8,0,0,4608,8,6047421451
6793,247994688,373326,248368014,29,0,0,20480,29,2285037234
6794,248034052,392317,248426369,11,0,0,9728,11,5767897253
6795,248081856,198857,248280713,27,0,0,12288,27,1477505825
6796,248089029,295435,248384464,1,0,0,15360,1,8534458276
6797,248110092,726340,248836432,33,0,0,42496,33,2679578854
6798,248117606,2870,248120476,19,0,1,8704,19,261186952
6799,248146161,5642,248151803,7,0,1,10752,7,6821684760
6800,248150778,330065,248480843,5,0,0,7680,5,5397179648
6801,248155455,156035,248311490,2,0,0,2560,2,3007615062
6802,248183259,688051,248871310,39,0,0,4608,39,7628046122
6803,248209203,17521,248226724,30,0,1,5120,30,9197809954
6804,248213187,795164,249008351,9,0,0,72192,9,8886748054
6805,248220055,174640,248394695,13,0,0,8192,13,7232640310
6806,248298430,362264,248660694,28,0,0,16384,28,4981037131
6807,248351487,32992,248384479,9,0,1,2560,9,35593853
6808,248356344,899049,249255393,22,0,0,20480,22,4744981031
6809,248356846,265790,248622636,3,0,0,64000,3,4937288655
6810,248373763,181937,248555700,2,0,0,5632,2,3202922404
6811,248408373,217398,248625771,24,0,0,10240,24,4765139884
6812,248421432,6489,248427921,13,0,1,1536,13,2552702507
6813,248424076,709806,249133882,32,0,0,37376,32,6938792753
6814,248424530,207652,248632182,34,0,0,20992,34,402565105
6815,248428038,479184,248907222,32,0,0,1536,32,8965273665
6816,248476821,10757,248487578,11,0,1,17408,11,7854602601
6817,248489820,293448,248783268,17,0,0,9216,17,9037193799
6818,248490361,160434,248650795,11,0,0,23040,11,3107134955
6819,248507200,83700,248590900,6,0,1,136192,6,9252841229
6820,248510995,81851,248592846,20,0,1,3072,20,9173487618
6821,248515288,274079,248789367,36,0,0,19968,36,2617247788
6822,248519793,755006,249274799,6,0,0,10752,6,1872692028
6823,248525441,195680,248721121,26,0,0,10752,26,10172282328
6824,248532515,244339,248776854,18,0,0,34304,18,3691384345
6825,248559432,255474,248814906,27,0,0,58368,27,1677856161
6826,248561477,389405,248950882,38,0,0,104448,38,8244940158
6827,248567125,406080,248973205,37,0,0,73216,37,4293481844
6828,248580492,405848,248986340,14,0,0,43008,14,2420628538
6829,248585118,524404,249109522,1,0,0,17920,1,6121677353
6830,248586367,7465,248593832,18,0,1,1536,18,9588262832
6831,248592523,793065,249385588,20,0,0,30208,20,10465651700
6832,248619875,40842,248660717,25,0,1,7168,25,8660851447
6833,248656018,13760,248669778,7,0,1,5120,7,5073433886
6834,248660249,220105,248880354,3,0,0,4096,3,4522109752
6835,248665363,741118,249406481,20,0,0,13312,20,10421889300
6836,248671993,5454,248677447,34,0,1,13824,34,2019591595
6837,248676481,6754,248683235,14,0,1,7168,14,7249248739
6838,248685329,4374,248689703,14,0,1,4608,14,6861625096
6839,248694066,645485,249339551,11,0,0,61952,11,4407711192
6840,248696972,369944,249066916,3,0,0,45568,3,1082989029
6841,248733161,164612,248897773,17,0,1,270336,17,3190460246
6842,248744177,535325,249279502,1,0,0,15360,1,6676615920
6843,248758390,268290,249026680,8,0,0,35840,8,2746452497
6844,248761983,249987,249011970,26,0,0,11776,26,7914551462
6845,248781131,416514,249197645,28,0,0,512,28,2995353412
6846,248786571,302562,249089133,32,0,0,8704,32,8283893604
6847,248788000,347457,249135457,20,0,0,5120,20,8443401414
6848,248792176,125776,248917952,2,0,0,2048,2,358269545
6849,248793929,234513,249028442,22,0,0,5632,22,767606138
6850,248805458,237877,249043335,17,0,0,10752,17,3272152186
6851,248818665,197080,249015745,10,0,0,12288,10,9606898885
6852,248820578,365903,249186481,0,0,0,4608,0,8772779861
6853,248841010,408128,249249138,31,0,0,32256,31,1610869577
6854,248852960,225839,249078799,14,0,0,4608,14,9715411204
6855,248862415,210140,249072555,1,0,0,18432,1,3677510303
6856,248870924,27822,248898746,29,0,1,12800,29,8063960963
6857,248879574,286785,249166359,11,0,0,41472,11,9894790495
6858,248903637,439985,249343622,31,0,0,13312,31,7744666941
6859,248917119,267943,249185062,35,0,0,44032,35,8511835400
6860,248926639,505780,249432419,29,0,0,1536,29,4923798826
6861,248943202,83501,249026703,0,0,1,8704,0,5763445010
6862,248966116,67753,249033869,20,0,1,7680,20,4547244489
6863,248990732,277855,249268587,28,0,0,11776,28,2594124935
6864,248996042,41693,249037735,5,0,1,6144,5,9683300066
6865,249052490,20088,249072578,27,0,1,5120,27,3135478585
6866,249054021,26232,249080253,14,0,1,8192,14,3422694974
6867,249056932,319437,249376369,21,0,0,15872,21,9827575488
6868,249067473,246070,249313543,20,0,0,22528,20,3342917584
6869,249083017,566,249083583,2,0,1,512,2,2311656920
6870,249089569,139267,249228836,14,0,0,4608,14,205740559
6871,249090338,19199,249109537,19,0,1,23552,19,3474208512
6872,249091409,18143,249109552,25,0,1,9728,25,4315582659
6873,249100005,301781,249401786,30,0,0,6144,30,3318513568
6874,249118087,121208,249239295,24,0,0,21504,24,2217683596
6875,249119232,182733,249301965,18,0,0,14336,18,587243681
6876,249136649,256792,249393441,28,0,0,3584,28,6823908260
6877,249145158,68762,249213920,27,0,0,1024,27,2073417229
6878,249161340,225363,249386703,34,0,0,3584,34,5316873720
6879,249170283,454526,249624809,3,0,0,77312,3,6780503726
6880,249192863,3898,249196761,30,0,1,4096,30,4611037655
6881,249193096,4011,249197107,30,0,1,512,30,6596446749
6882,249211892,134553,249346445,29,0,0,9216,29,5440326256
6883,249230119,162215,249392334,28,0,0,18432,28,1523253717
6884,249249736,265009,249514745,17,0,0,18432,17,4361798686
6885,249272720,456171,249728891,18,0,0,24576,18,7694985497
6886,249281293,400654,249681947,32,0,0,36864,32,5281030911
6887,249281355,3904,249285259,11,0,1,10752,11,6789199071
6888,249304268,502953,249807221,19,0,0,48640,19,1800577314
6889,249310057,279731,249589788,2,0,0,52224,2,6454105569
6890,249318879,316420,249635299,15,0,0,34304,15,10154302654
6891,249345948,464572,249810520,36,0,0,10752,36,1604948540
6892,249349632,559558,249909190,14,0,0,7168,14,10035162647
6893,249355923,286099,249642022,5,0,0,22016,5,1645788034
6894,249361854,147229,249509083,30,0,0,51200,30,6348396904
6895,249378356,481577,249859933,34,0,0,56832,34,3615075260
6896,249391565,3386,249394951,30,0,1,1536,30,10524843522
6897,249416285,313721,249730006,3,0,0,3584,3,5553730842
6898,249417584,476519,249894103,5,0,0,57856,5,3088661648
6899,249435317,686367,250121684,27,0,0,159744,27,7620328237
6900,249461587,3128,249464715,9,0,1,9216,9,9514255664
6901,249465633,453586,249919219,27,0,0,15360,27,638809828
6902,249471250,220539,249691789,27,0,0,11264,27,700925842
6903,249488896,550218,250039114,27,0,0,512,27,9905813988
6904,249491360,17754,249509114,35,0,1,18944,35,7813270552
6905,249492142,254973,249747115,7,0,0,10240,7,8061353107
6906,249499380,537052,250036432,1,0,0,45568,1,8214385675
6907,249528641,243212,249771853,19,0,0,35840,19,546218153
6908,249547652,615656,250163308,1,0,0,512,1,7853136682
6909,249595726,29098,249624824,28,0,1,7168,28,6392104312
6910,249599411,243191,249842602,29,0,0,7168,29,6540921670
6911,249607018,555975,250162993,35,0,0,54784,35,6750655696
6912,249637964,305009,249942973,0,0,0,55808,0,3285396306
6913,249656967,82006,249738973,10,0,0,2560,10,4797006726
6914,249668460,370483,250038943,7,0,0,8192,7,9755428843
6915,249668556,154102,249822658,11,0,0,12288,11,9862225739
6916,249669500,403497,250072997,37,0,0,7168,37,8532837298
6917,249672760,139655,249812415,35,0,0,6144,35,4029446780
6918,249694981,257211,249952192,19,0,0,30208,19,7337860795
6919,249718815,195694,249914509,9,0,0,17408,9,10154049159
6920,249724398,170968,249895366,30,0,0,4096,30,3656404482
6921,249752898,247073,249999971,4,0,0,512,4,2625573083
6922,249763539,10776,249774315,7,0,1,2560,7,3642109492
6923,249781836,124090,249905926,37,0,0,1024,37,8479176785
6924,249782678,192375,249975053,31,0,0,512,31,3441612242
6925,249794151,203392,249997543,22,0,0,57344,22,7768001415
6926,249800984,322275,250123259,24,0,0,5120,24,4520464437
6927,249813067,5326,249818393,12,0,1,5632,12,1201553890
6928,249816803,181543,249998346,7,0,0,2560,7,10122823300
6929,249829085,365645,250194730,25,0,0,24576,25,5428022313
6930,249833481,814420,250647901,19,0,0,67072,19,741636065
6931,249896725,172849,250069574,33,0,0,4096,33,9915079802
6932,249906179,8345,249914524,10,0,1,10752,10,2253678734
6933,249917832,330851,250248683,11,0,0,51200,11,3303595194
6934,249919614,482032,250401646,36,0,0,34816,36,5930513885
6935,249923750,127785,250051535,13,0,0,23552,13,834070703
6936,249925243,74262,249999505,16,0,1,124416,16,4580361453
6937,249925344,205745,250131089,2,0,0,23552,2,1138414965
6938,249932018,292655,250224673,31,0,0,12800,31,230707561
6939,249943111,242476,250185587,15,0,0,4096,15,6500562259
6940,249953136,223907,250177043,28,0,0,16384,28,9505452830
6941,249956877,167021,250123898,24,0,0,2048,24,1418927468
6942,249958089,346379,250304468,30,0,0,37888,30,10049242571
6943,249986822,16729,250003551,7,0,1,13312,7,1561802757
6944,249989582,16251,250005833,1,0,1,3584,1,364020019
6945,249995720,757092,250752812,4,0,0,20992,4,5450390996
6946,250009481,320286,250329767,24,0,0,11264,24,8228311235
6947,250010310,278312,250288622,17,0,1,455168,17,3325699328
6948,250013968,390204,250404172,38,0,0,8192,38,2379911163
6949,250036489,227401,250263890,39,0,0,31232,39,2457327483
6950,250049641,301907,250351548,31,0,0,10240,31,9227070227
6951,250061387,243096,250304483,16,0,1,57344,16,4007005058
6952,250074998,229500,250304498,33,0,1,9728,33,3222915724
6953,250076222,228876,250305098,2,0,1,11264,2,6522045019
6954,250085127,440728,250525855,12,0,0,19968,12,5482441655
6955,250091176,574661,250665837,39,0,0,35328,39,5588045178
6956,250106865,198387,250305252,8,0,1,8704,8,1535690504
6957,250110228,238185,250348413,3,0,0,29696,3,8886903094
6958,250112560,359409,250471969,23,0,0,512,23,9507416492
6959,250116185,199948,250316133,8,0,0,24576,8,4603923768
6960,250123966,683028,250806994,9,0,0,61952,9,7158373357
6961,250124903,181220,250306123,20,0,1,12288,20,1243593094
6962,250141380,174768,250316148,33,0,1,18944,33,1551362128
6963,250143806,414296,250558102,1,0,0,6656,1,3186326796
6964,250145910,747927,250893837,8,0,0,23552,8,5815560680
6965,250147551,168612,250316163,14,0,1,1024,14,7114042715
6966,250179780,447670,250627450,37,0,0,2560,37,5446763383
6967,250184761,131417,250316178,33,0,1,2560,33,7122399690
6968,250188419,224932,250413351,7,0,0,14848,7,8824982618
6969,250195517,123741,250319258,7,0,1,8192,7,9477646353
6970,250207211,367475,250574686,25,0,0,5632,25,9268794877
6971,250212519,493855,250706374,36,0,0,33280,36,827224211
6972,250212851,107995,250320846,2,0,1,15872,2,100551697
6973,250228123,705680,250933803,17,0,0,86528,17,2120355323
6974,250228503,761720,250990223,38,0,0,2560,38,801858552
6975,250234829,857860,251092689,22,0,0,38400,22,1351148794
6976,250235117,490531,250725648,38,0,0,31232,38,3248347262
6977,250238649,446200,250684849,5,0,0,16384,5,5998885268
6978,250239548,149615,250389163,17,0,1,228864,17,7641741264
6979,250243254,377302,250620556,29,0,0,50176,29,9814923333
6980,250259101,367554,250626655,25,0,0,19968,25,2359865122
6981,250262400,453709,250716109,26,0,0,8704,26,7833619812
6982,250265612,503059,250768671,36,0,0,19968,36,5837599771
6983,250270380,131281,250401661,28,0,1,3584,28,8575136116
6984,250293901,239301,250533202,8,0,0,24064,8,7982192881
6985,250305763,769720,251075483,11,0,0,23040,11,10052832492
6986,250324238,182758,250506996,33,0,0,1024,33,855161481
6987,250325030,518843,250843873,1,0,0,11776,1,671392168
6988,250341074,535757,250876831,24,0,0,46080,24,1341578072
6989,250344456,389551,250734007,37,0,0,10240,37,3196580520
6990,250350834,155835,250506669,12,0,0,10240,12,8707941601
6991,250367699,391952,250759651,38,0,0,8704,38,7858861475
6992,250386117,263063,250649180,12,0,0,4096,12,10000073280
6993,250406654,1042,250407696,32,0,1,1024,32,10618338964
6994,250414919,1994,250416913,34,0,1,2048,34,4850097511
6995,250418139,566,250418705,7,0,1,512,7,6679317457
6996,250426500,430016,250856516,19,0,0,12800,19,5734158883
6997,250441937,687712,251129649,19,0,0,59392,19,1081645100
6998,250448154,330660,250778814,35,0,0,4608,35,5836152768
6999,250454565,3422,250457987,9,0,1,3584,9,8588882432
7000,250477504,429920,250907424,9,0,0,44544,9,4632456299
7001,250522916,17099,250540015,18,0,1,7168,18,4291796942
7002,250530541,568894,251099435,1,0,0,19456,1,726289208
7003,250531955,641109,251173064,39,0,0,82944,39,10491379851
7004,250533176,13285,250546461,37,0,1,17920,37,4472001716
7005,250546355,2946,250549301,24,0,1,3072,24,6631476726
7006,250589177,468795,251057972,14,0,0,15872,14,6058178618
7007,250592574,11274,250603848,3,0,1,18432,3,8185601544
7008,250594785,605540,251200325,5,0,0,36352,5,4264122687
7009,250603884,572338,251176222,35,0,0,10240,35,10336061204
7010,250624320,30145,250654465,21,0,1,5632,21,9816013729
7011,250638562,46310,250684872,34,0,1,55808,34,5060894171
7012,250682151,1082035,251764186,11,0,0,20992,11,2674141329
7013,250696179,11672,250707851,27,0,1,1536,27,6199395674
7014,250697944,10253,250708197,25,0,1,512,25,8391810468
7015,250705031,406492,251111523,2,0,0,28160,2,10359385062
7016,250706599,2904,250709503,10,0,1,2048,10,8580034993
7017,250706771,1119492,251826263,21,0,0,17920,21,1592928130
7018,250714456,736451,251450907,9,0,0,62464,9,6147491393
7019,250718046,11985,250730031,2,0,1,4608,2,1281518038
7020,250720717,852901,251573618,31,0,0,65536,31,4446823778
7021,250742724,207391,250950115,15,0,0,26624,15,6531800189
7022,250742843,219537,250962380,27,0,0,5120,27,7006332719
7023,250746774,306347,251053121,32,0,0,47616,32,9536197986
7024,250747396,897842,251645238,19,0,0,8704,19,8655295376
7025,250751537,4280,250755817,38,0,1,3072,38,519174888
7026,250752187,307383,251059570,9,0,0,5120,9,8613149402
7027,250773216,442558,251215774,9,0,0,12800,9,641327430
7028,250780434,300532,251080966,22,0,0,17920,22,7127905190
7029,250803480,415475,251218955,15,0,0,5632,15,2824173944
7030,250811740,323868,251135608,13,0,0,19456,13,1595635039
7031,250813600,4374,250817974,9,0,1,4608,9,7001297244
7032,250815121,508828,251323949,39,0,0,45568,39,3926367455
7033,250820816,56038,250876854,6,0,1,93184,6,7971453966
7034,250849361,28508,250877869,27,0,1,3584,27,9344629581
7035,250865190,192805,251057995,39,0,1,277504,39,10641171572
7036,250880797,323755,251204552,30,0,0,13824,30,9541519113
7037,250880845,212647,251093492,13,0,0,2560,13,8394959267
7038,250910859,518516,251429375,25,0,0,16384,25,3613570937
7039,250926010,571735,251497745,24,0,0,12800,24,10113439824
7040,250927323,1040899,251968222,37,0,0,23040,37,5800408485
7041,250938524,363316,251301840,3,0,0,1536,3,6826315012
7042,250943612,115989,251059601,13,0,1,6656,13,1481729880
7043,250988952,243346,251232298,31,0,0,8192,31,9274173015
7044,250998643,398237,251396880,13,0,0,27648,13,8916583852
7045,251003425,216021,251219446,0,0,0,1536,0,2514899259
7046,251020932,388728,251409660,20,0,0,24576,20,7071421183
7047,251038338,418059,251456397,20,0,0,7168,20,2160042357
7048,251039414,172320,251211734,8,0,0,2048,8,494083578
7049,251048402,224355,251272757,27,0,0,10752,27,10266879166
7050,251049210,252131,251301341,8,0,0,43008,8,4143958685
7051,251050622,297273,251347895,12,0,0,2048,12,6158660334
7052,251069878,29580,251099458,33,0,1,1024,33,1996513646
7053,251071830,39708,251111538,27,0,1,4608,27,4225540199
7054,251115284,551757,251667041,4,0,0,28672,4,8574856788
7055,251128490,425145,251553635,33,0,0,15360,33,9042828827
7056,251132421,625346,251757767,30,0,0,43008,30,10028164959
7057,251134469,332255,251466724,27,0,0,33792,27,4541967892
7058,251141647,31432,251173079,9,0,1,6656,9,6049291880
7059,251152055,359263,251511318,29,0,0,17920,29,4576978808
7060,251178964,463591,251642555,19,0,0,45056,19,295278595
7061,251181710,1994,251183704,0,0,1,2048,0,3827763648
7062,251199949,336520,251536469,27,0,0,30720,27,6409176799
7063,251201564,252634,251454198,10,0,0,10752,10,519935731
7064,251210745,576251,251786996,35,0,0,4608,35,1422827130
7065,251217863,837977,252055840,19,0,0,85504,19,5153858955
7066,251232286,282471,251514757,31,0,0,3584,31,3098761769
7067,251273103,11016,251284119,39,0,1,17920,39,6915503659
7068,251291156,234353,251525509,39,0,0,3584,39,8540410400
7069,251294731,711973,252006704,38,0,0,39936,38,8400103620
7070,251298306,691794,251990100,27,0,0,6144,27,5195617933
7071,251301809,309457,251611266,0,0,0,8192,0,6817203092
7072,251312902,13509,251326411,7,0,1,2560,7,8308463020
7073,251345678,7230,251352908,30,0,1,7680,30,3912007219
7074,251349227,3937,251353164,22,0,1,9216,22,8956095033
7075,251377211,2470,251379681,21,0,1,2560,21,4821064504
7076,251377822,3088,251380910,22,0,1,8704,22,3188727772
7077,251379573,311623,251691196,36,0,0,15872,36,2105942795
7078,251380064,745793,252125857,7,0,0,31744,7,2525786509
7079,251400445,540265,251940710,24,0,0,26112,24,37735669
7080,251402527,283818,251686345,7,0,0,16896,7,76606217
7081,251408848,166033,251574881,13,0,0,4096,13,6584169316
7082,251446522,534839,251981361,2,0,0,24064,2,7644563404
7083,251446525,711179,252157704,3,0,0,104448,3,8335967078
7084,251467027,7230,251474257,22,0,1,7680,22,5324487915
7085,251481855,211988,251693843,35,0,0,4608,35,772074598
7086,251501761,293671,251795432,35,0,0,4608,35,5585697336
7087,251516122,187405,251703527,34,0,0,6144,34,9446649174
7088,251560923,600080,252161003,33,0,0,10752,33,8116205818
7089,251576250,271868,251848118,20,0,0,71680,20,9652492706
7090,251584496,4374,251588870,10,0,1,4608,10,9705515287
7091,251595631,313987,251909618,22,0,0,2048,22,10416080671
7092,251624825,605701,252230526,33,0,0,18944,33,1311175676
7093,251626422,436773,252063195,15,0,0,24064,15,800843951
7094,251634346,56873,251691219,4,0,1,75264,4,4935836574
7095,251637775,578122,252215897,34,0,0,46080,34,344242106
7096,251666287,203491,251869778,29,0,0,1536,29,3919769674
7097,251682485,305728,251988213,14,0,0,11264,14,1652967897
7098,251701144,260043,251961187,28,0,0,36864,28,8584865111
7099,251731858,216995,251948853,12,0,0,3072,12,8033364944
7100,251732131,341547,252073678,12,0,0,34304,12,4795417448
7101,251735332,5712,251741044,31,0,1,14336,31,1677367998
7102,251735530,594087,252329617,25,0,0,4096,25,5907233287
7103,251748548,177009,251925557,19,0,0,25088,19,3814530977
7104,251772186,238745,252010931,18,0,0,13824,18,3917388776
7105,251815367,154892,251970259,29,0,0,6144,29,8386567803
7106,251859091,305695,252164786,33,0,0,12288,33,876386739
7107,251898418,439801,252338219,16,0,0,17920,16,3027200139
7108,251903679,416584,252320263,12,0,0,23040,12,3562541406
7109,251910088,580316,252490404,35,0,0,57344,35,7392427758
7110,251916284,157409,252073693,39,0,1,247808,39,2828072493
7111,251920800,466447,252387247,28,0,0,44032,28,8053148824
7112,251923689,373208,252296897,24,0,0,24576,24,586509705
7113,251926095,650115,252576210,10,0,0,70656,10,3145652384
7114,251934714,423295,252358009,3,0,0,39936,3,4463222327
7115,251986367,89150,252075517,14,0,1,29696,14,8653721180
7116,252005867,354809,252360676,4,0,0,8704,4,1745317726
7117,252017515,498542,252516057,16,0,0,512,16,644212654
7118,252044980,34403,252079383,0,0,1,6144,0,7409626678
7119,252053827,451108,252504935,13,0,0,47616,13,9747867407
7120,252092237,429459,252521696,13,0,0,18432,13,2671815984
7121,252094192,520196,252614388,22,0,0,23552,22,4368645725
7122,252118008,603733,252721741,39,0,0,36352,39,8179125326
7123,252120272,270453,252390725,7,0,0,1536,7,3463228293
7124,252131421,282482,252413903,4,0,0,9216,4,10165319586
7125,252133961,553774,252687735,30,0,0,83456,30,7997295154
7126,252138027,298525,252436552,3,0,0,1536,3,599549744
7127,252150521,666982,252817503,8,0,0,5120,8,9921030163
7128,252157975,232251,252390226,3,0,0,9728,3,9216473044
7129,252158974,356904,252515878,14,0,0,35840,14,6139785238
7130,252159626,447571,252607197,20,0,0,47104,20,6832954762
7131,252162692,1024850,253187542,24,0,0,22016,24,1921198235
7132,252164541,226199,252390740,39,0,1,348160,39,9075413272
7133,252254269,405652,252659921,35,0,0,7168,35,7474747941
7134,252258902,480638,252739540,32,0,0,58368,32,4092640750
7135,252274826,520037,252794863,32,0,0,9216,32,5434202674
7136,252307790,273964,252581754,1,0,0,8192,1,3336492558
7137,252312777,427128,252739905,33,0,0,1024,33,9704175713
7138,252313146,87865,252401011,4,0,1,69120,4,8399055117
7139,252323456,82061,252405517,19,0,1,7168,19,7143659517
7140,252343891,413189,252757080,38,0,0,56320,38,2789207019
7141,252353299,56724,252410023,28,0,1,7168,28,4858991080
7142,252374198,566137,252940335,11,0,0,4608,11,7671603963
7143,252374624,663213,253037837,17,0,0,33792,17,7596897508
7144,252412759,5510,252418269,2,0,1,4608,2,5482645872
7145,252445697,1518,252447215,12,0,1,1536,12,946829450
7146,252450129,3898,252454027,18,0,1,4096,18,9026938865
7147,252451009,8164,252459173,11,0,1,8192,11,5533145402
7148,252456386,378753,252835139,13,0,0,27648,13,8611098223
7149,252466299,449928,252916227,20,0,0,19968,20,9233684506
7150,252479878,521121,253000999,0,0,0,33792,0,8494046904
7151,252483070,38657,252521727,25,0,1,2048,25,935667925
7152,252499211,283580,252782791,24,0,0,2560,24,2822174214
7153,252507445,15310,252522755,10,0,1,1024,10,9468212822
7154,252512965,195730,252708695,17,0,1,306688,17,3817381838
7155,252529522,210041,252739563,1,0,1,26112,1,7880943008
7156,252539808,566127,253105935,38,0,0,40448,38,6028102954
7157,252544539,237457,252781996,3,0,0,1024,3,5884808558
7158,252544850,468020,253012870,5,0,0,38912,5,5102032975
7159,252547452,421569,252969021,1,0,0,35840,1,10083568938
7160,252553970,459235,253013205,24,0,0,1024,24,3978151035
7161,252554415,516012,253070427,39,0,0,20992,39,9213384153
7162,252565430,594715,253160145,2,0,0,30720,2,314416168
7163,252573483,276655,252850138,2,0,0,47104,2,7576691820
7164,252575217,164361,252739578,0,0,1,8704,0,7346747347
7165,252594504,193287,252787791,6,0,1,237056,6,2413619159
7166,252624729,365578,252990307,30,0,0,8192,30,8302237501
7167,252650416,138361,252788777,11,0,1,1536,11,8569483615
7168,252656624,132499,252789123,28,0,1,512,28,3806002285
7169,252663615,305577,252969192,22,0,0,512,22,10605714844
7170,252673960,117749,252791709,38,0,1,4096,38,4500191904
7171,252680760,346766,253027526,17,0,0,5632,17,1271994850
7172,252683836,299069,252982905,15,0,0,15872,15,4701349643
7173,252688410,531666,253220076,16,0,0,9216,16,7958334039
7174,252698281,221861,252920142,1,0,0,12800,1,9923306877
7175,252705780,673345,253379125,39,0,0,7168,39,6188692052
7176,252712946,625321,253338267,12,0,0,8192,12,263256141
7177,252733594,61284,252794878,18,0,1,14336,18,10214775971
7178,252734639,482614,253217253,9,0,0,56832,9,2157046515
7179,252773257,116394,252889651,8,0,0,4096,8,1780189671
7180,252778294,818164,253596458,7,0,0,76288,7,4211415393
7181,252782041,12852,252794893,18,0,1,8704,18,8714127271
7182,252785933,293655,253079588,13,0,0,29184,13,414348215
7183,252795570,315372,253110942,31,0,0,16384,31,2345710732
7184,252798886,444161,253243047,19,0,0,16384,19,2087659938
7185,252809876,566,252810442,1,0,1,512,1,1968827082
7186,252813136,4382,252817518,11,0,1,10240,11,6412032394
7187,252826587,1044945,253871532,26,0,0,61440,26,8738991195
7188,252828562,21591,252850153,15,0,1,8192,15,6425097825
7189,252834776,74117,252908893,6,0,1,115200,6,10586800129
7190,252867362,439948,253307310,24,0,0,26112,24,6261321179
7191,252867530,605494,253473024,39,0,0,37888,39,4665762489
7192,252869137,585761,253454898,32,0,0,34304,32,7278418624
7193,252871391,38488,252909879,9,0,1,1536,9,4880512669
7194,252872008,634424,253506432,12,0,0,10752,12,5481192675
7195,252873485,769804,253643289,8,0,0,153600,8,6945895185
7196,252913659,744309,253657968,5,0,0,48128,5,685556675
7197,252922479,258340,253180819,35,0,0,12800,35,10040632918
7198,252933316,392589,253325905,33,0,0,24064,33,9970857296
7199,252947493,317529,253265022,5,0,0,3584,5,32209285
7200,252948949,776132,253725081,30,0,0,71168,30,3461052667
7201,252952479,4374,252956853,12,0,1,4608,12,7948666405
7202,252974404,2470,252976874,8,0,1,2560,8,636991910
7203,252981395,354361,253335756,28,0,0,32256,28,1599279636
7204,252984738,397366,253382104,9,0,0,9728,9,4600932235
7205,252999924,354287,253354211,9,0,0,12288,9,288208663
7206,253002683,166066,253168749,37,0,0,512,37,5861716948
7207,253006395,8821,253015216,9,0,1,2048,9,4483248715
7208,253017431,322731,253340162,2,0,0,6144,2,7038322852
7209,253024805,274534,253299339,31,0,0,17408,31,7717874874
7210,253028382,21255,253049637,28,0,1,19456,28,352002654
7211,253032126,698796,253730922,26,0,0,512,26,1537384431
7212,253048548,326797,253375345,36,0,0,19968,36,9451777624
7213,253073763,487698,253561461,27,0,0,24064,27,10364321711
7214,253079458,653409,253732867,3,0,0,512,3,5653351059
7215,253083357,873425,253956782,28,0,0,34816,28,1333837889
7216,253085214,34108,253119322,6,0,1,56320,6,8560168692
7217,253092188,727491,253819679,13,0,0,25600,13,8412884389
7218,253129145,443875,253573020,29,0,0,37888,29,5946599225
7219,253156532,7520,253164052,25,0,1,4096,25,9128242344
7220,253157708,7598,253165306,0,0,1,10752,0,4368949135
7221,253167668,2470,253170138,37,0,1,2560,37,6812331215
7222,253171523,681266,253852789,36,0,0,91136,36,5393146199
7223,253183419,290120,253473539,10,0,0,1536,10,3608033011
7224,253183736,370378,253554114,9,0,0,50176,9,3514342133
7225,253185906,5840,253191746,33,0,1,11264,33,6354154240
7226,253195100,823763,254018863,20,0,0,35840,20,956153158
7227,253210281,543595,253753876,12,0,0,64000,12,6087933049
7228,253215915,447638,253663553,16,0,0,13824,16,2362390504
7229,253229352,564794,253794146,35,0,0,15872,35,5147163472
7230,253230343,825489,254055832,9,0,0,26624,9,9506414148
7231,253233127,228338,253461465,36,0,0,21504,36,5534669880
7232,253253178,711385,253964563,22,0,0,18944,22,633063263
7233,253256798,4374,253261172,12,0,1,4608,12,3304014554
7234,253280609,5454,253286063,0,0,1,13824,0,10311030457
7235,253287974,401306,253689280,3,0,0,13312,3,3213496769
7236,253308283,350020,253658303,33,0,0,1024,33,8714451766
7237,253319162,340124,253659286,32,0,0,3072,32,9092689291
7238,253330752,13298,253344050,34,0,1,10752,34,7067069020
7239,253336380,236819,253573199,30,0,0,512,30,4556281398
7240,253340138,533928,253874066,0,0,0,5120,0,5485344694
7241,253350662,786309,254136971,7,0,0,31232,7,5689365128
7242,253357238,467768,253825006,32,0,0,17408,32,3073271171
7243,253360129,742189,254102318,30,0,0,24064,30,6483922648
7244,253371436,633964,254005400,2,0,0,11776,2,8672176209
7245,253371565,500926,253872491,16,0,0,3072,16,1508475070
7246,253378579,352148,253730727,13,0,0,6656,13,227455780
7247,253404303,812559,254216862,26,0,0,4608,26,6047069793
7248,253419575,2870,253422445,1,0,1,8704,1,9169237131
7249,253420417,308267,253728684,31,0,0,11776,31,6338969757
7250,253421557,2262,253423819,7,0,1,1536,7,8208419477
7251,253431472,50741,253482213,4,0,1,81920,4,10465303533
7252,253437094,58578,253495672,32,0,1,36352,32,8241077590
7253,253438371,946165,254384536,32,0,0,67584,32,5228795618
7254,253438507,609198,254047705,37,0,0,53760,37,7651803259
7255,253460636,38262,253498898,12,0,1,5120,12,10198849798
7256,253479290,23154,253502444,25,0,1,5632,25,711273499
7257,253483699,688032,254171731,37,0,0,61440,37,7856966692
7258,253536537,827392,254363929,19,0,0,53248,19,10383379536
7259,253552230,542496,254094726,15,0,0,17408,15,4757597088
7260,253579713,415426,253995139,14,0,0,2048,14,903972844
7261,253580728,702959,254283687,12,0,0,4608,12,8323386736
7262,253599072,66977,253666049,19,0,1,7168,19,5595972058
7263,253618789,583366,254202155,31,0,0,15360,31,7004361023
7264,253622894,43501,253666395,13,0,1,512,13,7426847797
7265,253627068,42873,253669941,33,0,1,5632,33,4622656849
7266,253628602,307890,253936492,4,0,0,23552,4,8463991012
7267,253631127,42680,253673807,34,0,1,6144,34,5379265157
7268,253644919,832400,254477319,26,0,0,57344,26,140396914
7269,253667069,9004,253676073,21,0,1,3584,21,10706904190
7270,253681234,379145,254060379,27,0,0,14848,27,8228915828
7271,253700230,497230,254197460,34,0,0,47616,34,9206971028
7272,253702089,526644,254228733,2,0,0,38912,2,2755347643
7273,253709482,691955,254401437,26,0,0,6144,26,3314595460
7274,253712980,860598,254573578,1,0,0,3584,1,6072020088
7275,253728118,25773,253753891,11,0,1,6656,11,7821413187
7276,253730796,891669,254622465,7,0,0,6656,7,2720561819
7277,253733583,393857,254127440,20,0,0,19456,20,885781218
7278,253768348,513912,254282260,27,0,0,39424,27,7071112453
7279,253775699,543508,254319207,1,0,0,34816,1,5834049125
7280,253780005,610630,254390635,31,0,0,19968,31,3529643707
7281,253798661,339269,254137930,37,0,0,3072,37,6224578221
7282,253809840,587674,254397514,20,0,0,22528,20,5010953860
7283,253812433,389901,254202334,38,0,0,512,38,7800264167
7284,253824136,51432,253875568,32,0,1,1536,32,3378844410
7285,253835542,614657,254450199,31,0,0,38912,31,5903012206
7286,253851943,351654,254203597,7,0,0,4096,7,125950738
7287,253852838,290099,254142937,17,0,0,16384,17,4310900460
7288,253855592,20962,253876554,26,0,1,1536,26,2565180212
7289,253866791,348637,254215428,19,0,0,25088,19,3091096843
7290,253936545,411145,254347690,30,0,0,31232,30,1979172418
7291,253937511,566,253938077,14,0,1,512,14,1776163056
7292,253972467,3387,253975854,2,0,1,9728,2,9961997216
7293,253988402,3128,253991530,30,0,1,9216,30,8571278226
7294,254006710,12168,254018878,16,0,1,4096,16,5862174130
7295,254041468,22540,254064008,28,0,1,10240,28,1527887504
7296,254045550,492495,254538045,22,0,0,28672,22,4007355726
7297,254069810,159094,254228904,24,0,0,512,24,629782230
7298,254074608,259987,254334595,31,0,0,512,31,8531358387
7299,254097732,17573,254115305,38,0,1,25088,38,4843615494
7300,254126285,286418,254412703,34,0,0,23040,34,8173102813
7301,254148085,23661,254171746,26,0,1,14848,26,1921815766
7302,254192239,289339,254481578,33,0,0,13824,33,9980360504
7303,254207468,7975,254215443,7,0,1,8704,7,9622998442
7304,254261153,154217,254415370,14,0,0,8704,14,2016651554
7305,254272241,279851,254552092,17,0,1,439296,17,9245632397
7306,254295037,575399,254870436,10,0,0,31232,10,6945671732
7307,254310132,396456,254706588,13,0,0,15872,13,789916055
7308,254310230,242848,254553078,28,0,1,1536,28,9354904570
7309,254318985,236359,254555344,34,0,1,3584,34,317166214
7310,254322278,624945,254947223,11,0,0,45568,11,5302826802
7311,254324691,260515,254585206,36,0,0,8704,36,7953034192
7312,254343167,213803,254556970,0,0,1,2560,0,2324765154
7313,254347017,637682,254984699,11,0,0,3072,11,1278057496
7314,254364295,254678,254618973,8,0,0,15360,8,5564636790
7315,254376408,182828,254559236,26,0,1,3584,26,406747383
7316,254398617,319218,254717835,38,0,0,36864,38,5173705231
7317,254399078,461016,254860094,28,0,0,37888,28,3242181248
7318,254418514,123342,254541856,17,0,0,8704,17,1496358374
7319,254432242,163796,254596038,6,0,1,118784,6,10422450216
7320,254434833,519893,254954726,28,0,0,24576,28,8829483129
7321,254456553,140561,254597114,32,0,1,13312,32,5765044939
7322,254461073,265996,254727069,11,0,0,30208,11,7862792630
7323,254463064,134204,254597268,20,0,1,8704,20,7129121289
7324,254481047,205906,254686953,33,0,0,2048,33,6840827796
7325,254506955,308701,254815656,37,0,0,3584,37,3673016490
7326,254509206,532271,255041477,38,0,0,7168,38,2154459685
7327,254517769,324281,254842050,14,0,0,34304,14,7456583160
7328,254518362,376212,254894574,0,0,0,65536,0,6142592769
7329,254526790,134416,254661206,13,0,0,512,13,7688906762
7330,254532664,242928,254775592,8,0,0,512,8,8597004016
7331,254536273,549235,255085508,3,0,0,79872,3,5001736397
7332,254538968,577065,255116033,32,0,0,38912,32,1689926935
7333,254541173,363617,254904790,3,0,0,30208,3,9699063744
7334,254559677,348888,254908565,30,0,0,12288,30,4882728504
7335,254562070,366998,254929068,2,0,0,11264,2,1184124428
7336,254571007,215002,254786009,14,0,0,1536,14,7533653318
7337,254571526,386655,254958181,26,0,0,11264,26,2670580751
7338,254601179,535133,255136312,36,0,0,30208,36,8589269365
7339,254607214,15266,254622480,32,0,1,22528,32,504358462
7340,254617293,186517,254803810,29,0,0,16384,29,5333262332
7341,254639877,516915,255156792,15,0,0,33280,15,3299340259
7342,254642235,561591,255203826,26,0,0,28672,26,9194866471
7343,254648363,212526,254860889,24,0,0,2560,24,1138748627
7344,254659477,742236,255401713,37,0,0,5632,37,8145708896
7345,254674178,365092,255039270,5,0,0,5120,5,5276298198
7346,254678119,563540,255241659,10,0,0,34304,10,5416074116
7347,254693424,1994,254695418,8,0,1,2048,8,3681819504
7348,254693476,24374,254717850,18,0,1,20992,18,4102273611
7349,254714323,269417,254983740,37,0,0,22528,37,2414639201
7350,254717099,11981,254729080,28,0,1,2048,28,5792269502
7351,254730589,662368,255392957,29,0,0,5632,29,4471205711
7352,254751716,336459,255088175,34,0,0,8704,34,4537436388
7353,254758180,629975,255388155,39,0,0,44032,39,6253655853
7354,254768209,358884,255127093,31,0,0,29184,31,1853019555
7355,254775499,154894,254930393,39,0,0,1024,39,6264236257
7356,254784579,276578,255061157,35,0,0,30208,35,4934969894
7357,254805579,385286,255190865,17,0,0,4096,17,7665777886
7358,254809933,227754,255037687,12,0,0,34304,12,1756642936
7359,254821575,345528,255167103,2,0,0,33792,2,8372641868
7360,254826727,343207,255169934,8,0,0,9216,8,2850107108
7361,254854952,471841,255326793,17,0,0,23552,17,1990051201
7362,254858060,372767,255230827,2,0,0,18432,2,6642031235
7363,254868588,320999,255189587,3,0,0,27136,3,373254732
7364,254901075,552260,255453335,37,0,0,1024,37,4771879511
7365,254902008,413359,255315367,38,0,0,27136,38,9940435696
7366,254907378,2697,254910075,1,0,1,1536,1,6316962146
7367,254911881,799214,255711095,29,0,0,88576,29,5432625643
7368,254914583,504244,255418827,25,0,0,33792,25,10162083461
7369,254916706,289319,255206025,30,0,0,7168,30,7676900926
7370,254943985,444497,255388482,20,0,0,1024,20,3085599917
7371,254961532,283211,255244743,39,0,0,4096,39,7064307076
7372,254965053,629480,255594533,5,0,0,100352,5,4931443177
7373,254982412,451753,255434165,11,0,0,14848,11,9285156664
7374,254984296,316015,255300311,5,0,0,31744,5,9763271118
7375,254985423,13253,254998676,25,0,1,25600,25,3623893077
7376,254990780,10482,255001262,20,0,1,4096,20,2365200699
7377,255001547,318055,255319602,21,0,0,13824,21,6568238406
7378,255002777,282079,255284856,29,0,0,6144,29,3323279906
7379,255005792,436344,255442136,17,0,0,26112,17,8518522875
7380,255012116,7230,255019346,32,0,1,7680,32,6469110560
7381,255012616,525185,255537801,16,0,0,40448,16,9391447873
7382,255013696,13400,255027096,16,0,1,20992,16,3711226226
7383,255027147,824517,255851664,7,0,0,9216,7,7857764223
7384,255027756,18100,255045856,2,0,1,11776,2,875208775
7385,255031135,389423,255420558,30,0,0,5632,30,3710111916
7386,255038742,7780,255046522,3,0,1,1024,3,10727896014
7387,255046989,4374,255051363,28,0,1,4608,28,458997508
7388,255104111,11937,255116048,13,0,1,11776,13,10264681594
7389,255111470,24857,255136327,23,0,1,3584,23,3151717714
7390,255138511,5971,255144482,30,0,1,14848,30,9782599953
7391,255145405,331154,255476559,29,0,0,61952,29,10625730384
7392,255149384,485177,255634561,0,0,0,58368,0,4730083615
7393,255176029,13573,255189602,13,0,1,6144,13,812967564
7394,255235393,11133,255246526,13,0,1,5120,13,2269135896
7395,255235783,667432,255903215,28,0,0,43008,28,8500615212
7396,255241691,279650,255521341,1,0,0,4096,1,705806357
7397,255260489,1518,255262007,14,0,1,1536,14,7136189970
7398,255279394,3387,255282781,36,0,1,9728,36,4881568320
7399,255282471,627155,255909626,4,0,0,20992,4,5594697251
7400,255287374,329372,255616746,36,0,0,28672,36,4499886295
7401,255309862,291550,255601412,12,0,0,22528,12,5179169030
7402,255315738,452000,255767738,28,0,0,10240,28,2632846592
7403,255315767,15434,255331201,14,0,1,4608,14,4801698421
7404,255326109,13655,255339764,38,0,1,18944,38,9235483067
7405,255341063,137107,255478170,20,0,0,4608,20,1335402424
7406,255371594,236385,255607979,17,0,0,21504,17,2339054510
7407,255403866,436209,255840075,21,0,0,10752,21,8198154062
7408,255431837,204010,255635847,19,0,0,4096,19,5799096086
7409,255443690,271632,255715322,14,0,0,13824,14,823662449
7410,255448497,5802,255454299,20,0,1,6144,20,5155368379
7411,255484610,312010,255796620,10,0,0,18432,10,2972310112
7412,255522445,1518,255523963,34,0,1,1536,34,2489997885
7413,255532961,117238,255650199,19,0,0,21504,19,7536469181
7414,255534637,4699,255539336,9,0,1,1536,9,6468719854
7415,255549594,293148,255842742,38,0,0,8704,38,2996819208
7416,255580509,54075,255634584,25,0,1,5120,25,2538842161
7417,255594738,254103,255848841,34,0,0,19968,34,510524357
7418,255611590,262372,255873962,35,0,0,13824,35,4338274796
7419,255617837,23320,255641157,22,0,1,5632,22,3980601193
7420,255628890,188592,255817482,17,0,0,5120,17,7734942074
7421,255641793,357812,255999605,20,0,0,75776,20,1661998191
7422,255645225,99372,255744597,17,0,0,3584,17,9095327009
7423,255657073,319413,255976486,25,0,0,24576,25,7952493138
7424,255662878,173906,255836784,8,0,0,35328,8,6969054659
7425,255675996,2470,255678466,22,0,1,2560,22,1114786126
7426,255677331,1801,255679132,23,0,1,1024,23,340796802
7427,255719097,244788,255963885,34,0,0,9216,34,5118826768
7428,255736281,206420,255942701,14,0,0,8192,14,5113244582
7429,255742677,147419,255890096,15,0,0,6656,15,9356269080
7430,255749175,18578,255767753,11,0,1,30720,11,9661487914
7431,255753063,159542,255912605,32,0,0,9728,32,199670464
7432,255769214,1042,255770256,8,0,1,1024,8,694684775
7433,255800707,566,255801273,8,0,1,512,8,637326768
7434,255849717,14676,255864393,35,0,1,24576,35,2773035073
7435,255873215,279269,256152484,0,0,0,1024,0,4866946517
7436,255907989,16141,255924130,27,0,1,18944,27,2300812640
7437,255913847,120797,256034644,17,0,0,9728,17,7303115576
7438,255914141,109314,256023455,14,0,0,25088,14,3508578498
7439,255917403,82225,255999628,4,0,1,111104,4,1395016030
7440,255921277,257713,256178990,5,0,0,17408,5,4657281668
7441,255931641,218857,256150498,30,0,0,76288,30,10015630705
7442,255941209,58434,255999643,28,0,1,10752,28,10623649677
7443,255974085,228059,256202144,36,0,0,1536,36,8162032785
7444,255974999,134274,256109273,21,0,0,8192,21,5511847920
7445,255982950,304555,256287505,12,0,0,21504,12,10004863624
7446,256003632,423811,256427443,9,0,0,15872,9,7825256835
7447,256005363,411814,256417177,26,0,0,51200,26,2034004738
7448,256012614,333312,256345926,33,0,0,48640,33,7298348356
7449,256023699,10960,256034659,10,0,1,17408,10,324449776
7450,256031589,299494,256331083,4,0,0,38400,4,9239909597
7451,256037631,154448,256192079,28,0,0,7680,28,4681852683
7452,256038850,911032,256949882,26,0,0,9728,26,8203309449
7453,256044820,814120,256858940,14,0,0,14848,14,6432706702
7454,256048019,11016,256059035,30,0,1,17920,30,9188244225
7455,256055496,327900,256383396,5,0,0,24064,5,7849089356
7456,256057783,328904,256386687,24,0,0,10752,24,6089736325
7457,256075937,660405,256736342,20,0,0,16896,20,8528849291
7458,256077527,7706,256085233,8,0,1,8192,8,3803458185
7459,256079185,491384,256570569,30,0,0,65024,30,2348252794
7460,256086129,262160,256348289,22,0,0,7680,22,563514919
7461,256115709,5454,256121163,26,0,1,13824,26,1035825231
7462,256116825,311574,256428399,4,0,1,503808,4,1887062824
7463,256123825,498191,256622016,2,0,0,48640,2,8669085124
7464,256124057,469498,256593555,17,0,0,18432,17,3850750638
7465,256153555,657403,256810958,25,0,0,79360,25,5028911795
7466,256156677,274308,256430985,16,0,1,4096,16,6281247263
7467,256167891,473596,256641487,7,0,0,7680,7,1166149121
7468,256184914,808037,256992951,2,0,0,50176,2,7704556488
7469,256206818,616727,256823545,16,0,0,9216,16,8294393331
7470,256238725,368433,256607158,10,0,0,44544,10,5295935578
7471,256255056,182035,256437091,22,0,1,20992,22,130106431
7472,256258231,292487,256550718,20,0,0,93184,20,351479882
7473,256287334,151383,256438717,1,0,1,2560,1,729950289
7474,256290303,814383,257104686,38,0,0,101376,38,4542392789
7475,256291936,335555,256627491,30,0,0,17920,30,2994550349
7476,256297241,580226,256877467,27,0,0,5120,27,3146306776
7477,256302358,285542,256587900,2,0,0,56832,2,840343753
7478,256303845,396996,256700841,21,0,0,8192,21,9298303010
7479,256324931,788818,257113749,21,0,0,29696,21,8330314977
7480,256336050,103333,256439383,27,0,1,1024,27,4673413575
7481,256354092,862815,257216907,21,0,0,73216,21,8410135440
7482,256361832,81097,256442929,21,0,1,5632,21,378034990
7483,256411388,34767,256446155,33,0,1,5120,33,3064599473
7484,256413016,564632,256977648,12,0,0,8192,12,119502467
7485,256417725,334368,256752093,19,0,0,30208,19,3383109614
7486,256422863,450425,256873288,20,0,0,4096,20,3706868517
7487,256442146,878783,257320929,28,0,0,40448,28,8701712290
7488,256443447,24412,256467859,6,0,1,44032,6,6350538967
7489,256451378,1190390,257641768,33,0,0,5120,33,1008671920
7490,256474088,2470,256476558,0,0,1,2560,0,4932822866
7491,256479567,1994,256481561,26,0,1,2048,26,7652880926
7492,256483107,657675,257140782,38,0,0,47104,38,75820333
7493,256507949,204148,256712097,20,0,0,3072,20,2848475200
7494,256527101,80080,256607181,25,0,1,8704,25,8581384196
7495,256530281,623043,257153324,28,0,0,31744,28,18080394
7496,256534734,440403,256975137,5,0,0,32768,5,6042640259
7497,256555715,293595,256849310,26,0,0,4608,26,8419334058
7498,256562368,840984,257403352,28,0,0,41472,28,10242779329
7499,256566547,388677,256955224,16,0,0,3584,16,5591759147
7500,256581671,693676,257275347,14,0,0,2560,14,9027095234
7501,256588897,342311,256931208,21,0,0,14848,21,10449562720
7502,256650960,575322,257226282,32,0,0,30720,32,7323699356
7503,256672921,501680,257174601,14,0,0,33280,14,5398343541
7504,256675058,6229,256681287,19,0,1,15360,19,5676113814
7505,256696430,5326,256701756,0,0,1,5632,0,3744666728
7506,256714880,736556,257451436,39,0,0,14848,39,4827747091
7507,256715199,249939,256965138,14,0,0,4096,14,9902543215
7508,256735162,391253,257126415,35,0,0,22016,35,2503933719
7509,256735414,427129,257162543,1,0,0,30208,1,7397764017
7510,256743047,504611,257247658,33,0,0,15872,33,3699716524
7511,256759356,360336,257119692,34,0,0,19456,34,2648778840
7512,256780179,30794,256810973,8,0,1,20992,8,9948871602
7513,256793706,687307,257481013,20,0,0,5120,20,9370006665
7514,256796520,347093,257143613,1,0,0,9216,1,3000371540
7515,256812644,921449,257734093,8,0,0,109056,8,4278586982
7516,256814247,3387,256817634,22,0,1,9728,22,7753104770
7517,256816395,117185,256933580,39,0,1,193024,39,1713412783
7518,256817309,182161,256999470,37,0,0,1536,37,1418829583
7519,256837663,97543,256935206,18,0,1,2560,18,9103534720
7520,256842424,151018,256993442,2,0,0,1536,2,811097785
7521,256845835,190391,257036226,21,0,0,11264,21,4539289091
7522,256858105,80647,256938752,23,0,1,5632,23,9121094163
7523,256861792,468364,257330156,31,0,0,30208,31,10338386585
7524,256873851,320413,257194264,9,0,0,3072,9,6021217718
7525,256882767,59851,256942618,13,0,1,6144,13,10029270908
7526,256899975,728191,257628166,0,0,0,39936,0,9476529145
7527,256910755,253683,257164438,39,0,0,6144,39,1413369173
7528,256910994,278174,257189168,8,0,0,14336,8,2141761084
7529,256912656,32548,256945204,0,0,1,4096,0,4914430468
7530,256914657,30701,256945358,12,0,1,8704,12,9006020462
7531,256943131,3213,256946344,8,0,1,1536,8,2474164937
7532,256983244,380562,257363806,10,0,0,6656,10,4626709428
7533,256992273,868443,257860716,21,0,0,84480,21,8898882701
7534,257013777,391946,257405723,37,0,0,7680,37,447695984
7535,257014255,220342,257234597,27,0,0,27136,27,2692041510
7536,257031225,711807,257743032,12,0,0,29184,12,5506648547
7537,257045829,5326,257051155,2,0,1,5632,2,5087517327
7538,257055522,587361,257642883,1,0,0,3584,1,8151858622
7539,257059782,192429,257252211,37,0,0,2560,37,191443430
7540,257070931,296322,257367253,16,0,0,11264,16,4178448910
7541,257093850,692624,257786474,1,0,0,39936,1,8189085068
7542,257106367,373034,257479401,2,0,0,2560,2,1300123502
7543,257109106,451757,257560863,2,0,0,6656,2,5822656855
7544,257117121,882878,257999999,26,0,0,36864,26,10295644580
7545,257142295,816931,257959226,3,0,0,14848,3,6449685689
7546,257157180,22706,257179886,24,0,1,5632,24,4329748850
7547,257180371,259775,257440146,32,0,0,54784,32,4243970105
7548,257210074,276409,257486483,22,0,0,1536,22,7315120643
7549,257216274,720717,257936991,25,0,0,20992,25,3366833650
7550,257220111,614850,257834961,25,0,0,38912,25,5843188201
7551,257222688,26155,257248843,13,0,1,27648,13,5035228616
7552,257229786,21218,257251004,20,0,1,9728,20,2420472
7553,257231926,993313,258225239,34,0,0,2560,34,6065473742
7554,257233200,379529,257612729,5,0,0,56832,5,8291413670
7555,257240960,1044271,258285231,9,0,0,22016,9,42981789
7556,257242427,802071,258044498,13,0,0,26624,13,3914448372
7557,257248380,81791,257330171,4,0,1,103936,4,10581485222
7558,257281949,520544,257802493,17,0,0,26112,17,5829189131
7559,257285156,458515,257743671,7,0,0,2048,7,8340691807
7560,257296272,692480,257988752,4,0,0,43520,4,3809676491
7561,257298541,1037423,258335964,20,0,0,80896,20,10292289024
7562,257310584,823225,258133809,26,0,0,10752,26,4126780166
7563,257326901,370022,257696923,14,0,0,4608,14,8328470937
7564,257333294,180500,257513794,8,0,0,7680,8,9504820900
7565,257351262,899655,258250917,11,0,0,16384,11,4936547287
7566,257359763,951538,258311301,16,0,0,5632,16,7220234454
7567,257368238,635996,258004234,33,0,0,13824,33,8456672272
7568,257369863,744265,258114128,19,0,0,62464,19,4630109701
7569,257372568,497850,257870418,7,0,0,6656,7,6369779185
7570,257380242,550338,257930580,16,0,0,20992,16,3469737104
7571,257392833,292012,257684845,26,0,0,56832,26,3442307895
7572,257401039,239154,257640193,2,0,0,39424,2,1109174339
7573,257407248,1056743,258463991,29,0,0,38400,29,7328520335
7574,257410431,457944,257868375,25,0,0,25088,25,2430125413
7575,257410979,969520,258380499,14,0,0,14848,14,4640052161
7576,257437127,1015149,258452276,37,0,0,30720,37,1031850214
7577,257463545,5802,257469347,12,0,1,6144,12,3134301018
7578,257464563,329959,257794522,39,0,0,25600,39,6690770473
7579,257469223,337965,257807188,13,0,0,15360,13,4396877192
7580,257486754,399131,257885885,2,0,0,50688,2,2647231303
7581,257510788,553041,258063829,39,0,0,19456,39,5959682469
7582,257526145,635994,258162139,10,0,0,13312,10,2626909601
7583,257541318,1148246,258689564,7,0,0,207360,7,5601288580
7584,257541416,1042,257542458,1,0,1,1024,1,1237754100
7585,257541966,147278,257689244,3,0,0,14336,3,3447292972
7586,257547893,542108,258090001,31,0,0,51200,31,2023209558
7587,257590141,385328,257975469,13,0,0,44544,13,6836823297
7588,257593816,313085,257906901,38,0,0,17920,38,9987009256
7589,257601049,14618,257615667,23,0,1,3072,23,3942195543
7590,257625434,505061,258130495,9,0,0,45568,9,543427424
7591,257655651,253708,257909359,2,0,0,512,2,708356461
7592,257656792,414922,258071714,27,0,0,12288,27,3941288227
7593,257665285,566,257665851,22,0,1,512,22,5082481312
7594,257673098,251071,257924169,30,0,0,12288,30,7784742953
7595,257674264,1109480,258783744,7,0,0,65024,7,4802470530
7596,257683203,72512,257755715,39,0,1,112640,39,2545873326
7597,257683482,432244,258115726,29,0,0,5120,29,10193287261
7598,257691492,497960,258189452,0,0,0,42496,0,3783141100
7599,257703469,56112,257759581,27,0,1,6144,27,377099011
7600,257710562,580613,258291175,31,0,0,1024,31,7814823584
7601,257729107,472512,258201619,31,0,0,512,31,4393021945
7602,257734988,762979,258497967,38,0,0,25088,38,4191069077
7603,257806267,448673,258254940,0,0,0,1024,0,846240226
7604,257837332,53191,257890523,11,0,1,12288,11,5502337141
7605,257873228,351216,258224444,4,0,0,41472,4,2186929765
7606,257902114,562984,258465098,16,0,0,3584,16,2749502220
7607,257906400,293948,258200348,12,0,0,7680,12,4689619216
7608,257913093,490192,258403285,1,0,0,512,1,77361911
7609,257927947,617785,258545732,38,0,0,9728,38,1150646304
7610,257931614,539742,258471356,8,0,0,9216,8,10243079836
7611,257947177,666086,258613263,0,0,0,12288,0,9130543123
7612,257948975,422207,258371182,29,0,0,35840,29,8852111088
7613,257958720,401527,258360247,15,0,0,56320,15,9600529742
7614,257960478,313590,258274068,4,0,0,18432,4,9408648897
7615,257967501,967141,258934642,1,0,0,5120,1,1272950945
7616,257982333,1000689,258983022,17,0,0,60416,17,1085184262
7617,258014828,562146,258576974,35,0,0,50688,35,7710561543
7618,258023560,6754,258030314,7,0,1,7168,7,914450419
7619,258029892,14621,258044513,35,0,1,17408,35,8887209293
7620,258076773,513283,258590056,3,0,0,1536,3,9148518772
7621,258085457,28694,258114151,10,0,1,17408,10,6418261690
7622,258097927,32583,258130510,12,0,1,7168,12,5277109642
7623,258112091,871898,258983989,26,0,0,3072,26,5786230426
7624,258113085,372357,258485442,37,0,0,11776,37,474286427
7625,258123635,417719,258541354,28,0,0,47104,28,4855571706
7626,258135417,452303,258587720,39,0,0,9216,39,10070585579
7627,258173891,915428,259089319,35,0,0,35840,35,5692887825
7628,258201111,264470,258465581,34,0,0,1536,34,9700288236
7629,258202627,269992,258472619,20,0,0,4096,20,7490640105
7630,258226045,810301,259036346,38,0,0,5120,38,6362465212
7631,258227032,475907,258702939,25,0,0,24064,25,9245055707
7632,258233241,6278,258239519,33,0,1,6656,33,10270898941
7633,258234979,922974,259157953,2,0,0,23040,2,2548969940
7634,258235204,5941,258241145,20,0,1,2560,20,7444931087
7635,258253992,509894,258763886,8,0,0,31744,8,1267039212
7636,258254070,169525,258423595,22,0,0,15360,22,218795644
7637,258274715,475097,258749812,19,0,0,54784,19,10373684510
7638,258294121,11274,258305395,37,0,1,18432,37,7657840440
7639,258296432,205726,258502158,17,0,0,6144,17,5085178944
7640,258321587,373989,258695576,31,0,0,19456,31,6682620143
7641,258323790,478736,258802526,1,0,0,26624,1,7067397551
7642,258338070,566,258338636,2,0,1,512,2,5051175951
7643,258364669,8516,258373185,13,0,1,2048,13,1852546155
7644,258370808,9714,258380522,34,0,1,15872,34,7665672402
7645,258376846,173743,258550589,29,0,0,14336,29,7335538064
7646,258378696,5726,258384422,28,0,1,4096,28,1029505046
7647,258388258,406125,258794383,5,0,0,34816,5,3057395303
7648,258403291,5198,258408489,20,0,1,13312,20,4113862959
7649,258421637,435110,258856747,5,0,0,2048,5,22959767
7650,258430458,46729,258477187,39,0,1,80896,39,7488197501
7651,258461190,501210,258962400,25,0,0,84480,25,6321277637
7652,258462701,351463,258814164,17,0,0,12800,17,644717689
7653,258465168,13325,258478493,10,0,1,2048,10,2708855569
7654,258468144,264902,258733046,27,0,0,43008,27,9945794137
7655,258473489,5670,258479159,34,0,1,11264,34,9407893455
7656,258490584,365524,258856108,7,0,0,8192,7,1020470130
7657,258535853,60110,258595963,4,0,1,89600,4,2599229572
7658,258543598,265690,258809288,17,0,0,13312,17,5721047479
7659,258545587,51349,258596936,33,0,1,12800,33,1807740585
7660,258565609,712026,259277635,12,0,0,21504,12,7449327585
7661,258571033,438945,259009978,13,0,0,52224,13,7499007226
7662,258576736,228473,258805209,38,0,0,8704,38,9421923836
7663,258577065,45383,258622448,6,0,1,67072,6,3396556851
7664,258580258,406554,258986812,35,0,0,9216,35,8951453722
7665,258580574,300738,258881312,0,0,0,7680,0,2166244349
7666,258586085,39909,258625994,8,0,1,5632,8,6799824872
7667,258588558,101021,258689579,22,0,1,3072,22,7586946017
7668,258611152,78442,258689594,37,0,1,9216,37,7827466924
7669,258614460,75149,258689609,23,0,1,11776,23,3991830809
7670,258637606,607923,259245529,10,0,0,20480,10,307964271
7671,258642083,369524,259011607,8,0,0,5120,8,2162209129
7672,258657253,489054,259146307,22,0,0,28672,22,1862381921
7673,258666242,327777,258994019,3,0,0,23552,3,557178450
7674,258682343,282256,258964599,2,0,0,7168,2,10419121728
7675,258687009,19837,258706846,2,0,1,4096,2,1700182048
7676,258695437,474946,259170383,22,0,0,40448,22,1123057746
7677,258719409,315354,259034763,2,0,0,34816,2,1533371938
7678,258732102,17733,258749835,7,0,1,3072,7,3683811521
7679,258735108,28809,258763917,27,0,1,16896,27,37045580
7680,258744080,594003,259338083,13,0,0,25600,13,10722046642
7681,258747290,367269,259114559,14,0,0,48128,14,7000615057
7682,258751376,272726,259024102,7,0,0,40960,7,3184085923
7683,258753045,342217,259095262,1,0,0,19456,1,7298753250
7684,258763304,385096,259148400,7,0,0,2048,7,9347975643
7685,258767129,42206,258809335,19,0,1,5632,19,6341501777
7686,258770336,674893,259445229,29,0,0,24576,29,3851440820
7687,258779181,43319,258822500,9,0,1,25600,9,9189386218
7688,258783132,271662,259054794,16,0,0,28672,16,4355814340
7689,258793384,32342,258825726,28,0,1,5120,28,1892781778
7690,258800241,26791,258827032,36,0,1,2048,36,1813108698
7691,258806760,339898,259146658,7,0,0,1024,7,5333149797
7692,258814581,317216,259131797,17,0,0,15872,17,6317206820
7693,258824139,503899,259328038,30,0,0,165376,30,6172465841
7694,258826841,229372,259056213,20,0,0,4608,20,10650879423
7695,258870581,5196,258875777,10,0,1,13312,10,8038866293
7696,258878403,300578,259178981,0,0,0,12288,0,8180096823
7697,258888614,616813,259505427,16,0,0,14336,16,9514184142
7698,258896110,454521,259350631,10,0,0,18944,10,3895854283
7699,258903475,426793,259330268,28,0,0,1536,28,1202650470
7700,258948429,61580,259010009,2,0,1,5120,2,2736748028
7701,258950720,254363,259205083,20,0,0,10240,20,511092230
7702,258964904,45120,259010024,34,0,1,8704,34,9146186159
7703,258971181,455605,259426786,28,0,0,6656,28,5426393078
7704,258978760,45365,259024125,18,0,1,6144,18,6083516991
7705,258979086,45054,259024140,34,0,1,2048,34,7817741548
7706,259007733,333797,259341530,16,0,0,11264,16,10081815616
7707,259015572,156386,259171958,38,0,0,5120,38,9758969125
7708,259021336,150637,259171973,6,0,1,213504,6,8034531356
7709,259031932,141914,259173846,28,0,1,26112,28,8800903171
7710,259032728,297041,259329769,7,0,0,5632,7,4079581823
7711,259046785,128239,259175024,8,0,1,13824,8,8672354587
7712,259047344,131652,259178996,16,0,1,3584,16,9428730703
7713,259065922,278922,259344844,30,0,0,6144,30,5324890498
7714,259079238,442121,259521359,4,0,0,18432,4,10197719686
7715,259084795,266179,259350974,38,0,0,1024,38,10093938952
7716,259085858,323322,259409180,36,0,0,73728,36,6477596159
7717,259087027,91984,259179011,34,0,1,1536,34,6338970303
7718,259087065,299636,259386701,11,0,0,36352,11,4260384363
7719,259089955,94427,259184382,39,0,1,29184,39,5305878134
7720,259100081,363007,259463088,10,0,0,37888,10,7343431260
7721,259102257,362414,259464671,4,0,0,5120,4,6972785659
7722,259119075,70696,259189771,12,0,1,25600,12,3924157897
7723,259133667,356840,259490507,38,0,0,23040,38,2279433579
7724,259133769,317760,259451529,21,0,0,18944,21,9615845379
7725,259135785,370443,259506228,12,0,0,2560,12,10339812441
7726,259169310,21127,259190437,0,0,1,11264,0,2175887739
7727,259182561,10782,259193343,1,0,1,4608,1,3119176206
7728,259189662,221873,259411535,33,0,0,7680,33,4299839166
7729,259213707,4374,259218081,1,0,1,4608,1,907311213
7730,259220829,5802,259226631,11,0,1,6144,11,5962045058
7731,259228277,270271,259498548,14,0,0,14848,14,2188805679
7732,259232822,1042,259233864,12,0,1,1024,12,7980121034
7733,259237049,105900,259342949,29,0,0,4608,29,5287411171
7734,259252513,382932,259635445,2,0,0,49664,2,9997159501
7735,259260207,566,259260773,0,0,1,512,0,916915967
7736,259266941,437790,259704731,2,0,0,8192,2,8125163884
7737,259267581,345978,259613559,19,0,0,58368,19,3963813330
7738,259288117,283637,259571754,26,0,0,14848,26,1280042589
7739,259291868,290341,259582209,1,0,0,3072,1,5923124420
7740,259318290,38127,259356417,10,0,1,6144,10,6871608320
7741,259330973,143913,259474886,17,0,1,198144,17,5621620848
7742,259374490,105888,259480378,32,0,1,26112,32,8919158414
7743,259377583,105381,259482964,25,0,1,4096,25,7104595889
7744,259379827,110695,259490522,11,0,1,7680,11,5032787314
7745,259393801,271448,259665249,1,0,0,35328,1,1751647411
7746,259407463,314870,259722333,20,0,0,56320,20,1326071768
7747,259412072,176086,259588158,22,0,0,7168,22,1095930619
7748,259421374,262520,259683894,27,0,0,20992,27,204688297
7749,259422739,67957,259490696,16,0,1,4608,16,325562970
7750,259430696,343339,259774035,35,0,0,13312,35,332931410
7751,259430789,431304,259862093,35,0,0,25088,35,1181574092
7752,259455780,398638,259854418,24,0,0,37888,24,8666740985
7753,259461346,158944,259620290,9,0,0,22016,9,8012776234
7754,259461926,321640,259783566,4,0,0,31232,4,4676418957
7755,259473256,19706,259492962,24,0,1,3584,24,2680433616
7756,259473831,248985,259722816,4,0,0,1536,4,7129691797
7757,259524965,1518,259526483,38,0,1,1536,38,9015194603
7758,259535135,292613,259827748,33,0,0,27136,33,683311252
7759,259539325,206094,259745419,33,0,0,4608,33,5324320731
7760,259559060,227703,259786763,20,0,0,1024,20,8147533808
7761,259587503,370616,259958119,19,0,0,27136,19,523386633
7762,259601834,376587,259978421,2,0,0,26624,2,9808054955
7763,259607542,485228,260092770,22,0,0,15360,22,7833607083
7764,259621778,24717,259646495,33,0,1,17920,33,5674663766
7765,259622631,24850,259647481,13,0,1,1536,13,8815649806
7766,259625933,25734,259651667,27,0,1,6656,27,377685512
7767,259646904,275677,259922581,21,0,0,23552,21,4662730494
7768,259662709,252681,259915390,15,0,0,6144,15,2240403119
7769,259691090,4679,259695769,1,0,1,12288,1,1271454567
7770,259696571,335387,260031958,33,0,0,9216,33,1826138341
7771,259701103,319014,260020117,2,0,0,25088,2,3532094353
7772,259730556,79589,259810145,9,0,0,1024,9,5617288420
7773,259734199,428082,260162281,4,0,0,14336,4,95832247
7774,259760546,292084,260052630,36,0,0,8192,36,3129551886
7775,259763871,430596,260194467,25,0,0,5632,25,9468214777
7776,259806500,196711,260003211,9,0,0,15360,9,7264635992
7777,259822958,7252,259830210,31,0,1,2560,31,8452534221
7778,259842746,207373,260050119,21,0,0,27648,21,6832004392
7779,259846397,299738,260146135,19,0,0,17920,19,2342741472
7780,259848184,219135,260067319,5,0,0,1024,5,4266009337
7781,259875858,365725,260241583,10,0,0,105472,10,2826087178
7782,259879417,277574,260156991,27,0,0,20480,27,10214887503
7783,259892105,131303,260023408,22,0,0,10752,22,2518420100
7784,259908114,354559,260262673,31,0,0,19968,31,5398981349
7785,259909650,257326,260166976,5,0,0,15360,5,3658502438
7786,259925285,331289,260256574,31,0,0,49152,31,6338687817
7787,259929584,251870,260181454,0,0,0,22016,0,3644236973
7788,259931251,7230,259938481,0,0,1,7680,0,8255947234
7789,259931424,379716,260311140,15,0,0,33280,15,1190864080
7790,259934181,631137,260565318,2,0,1,1025536,2,1900955269
7791,259936637,453410,260390047,9,0,0,17920,9,8999041324
7792,259969440,675319,260644759,17,0,0,18432,17,3231894878
7793,259979104,587085,260566189,23,0,1,12288,23,4185935866
7794,259981080,379291,260360371,14,0,0,11264,14,2411732418
7795,259982226,557054,260539280,3,0,0,10240,3,5274580807
7796,259995040,548435,260543475,30,0,0,1536,30,3823946420
7797,260000376,566159,260566535,7,0,1,512,7,9290470953
7798,260002176,569505,260571681,28,0,1,8192,28,6936750403
7799,260005627,574497,260580124,30,0,0,20992,30,9981114092
7800,260022775,766695,260789470,0,0,0,29184,0,7482579459
7801,260028535,1062837,261091372,32,0,0,7168,32,10007646479
7802,260040168,532281,260572449,8,0,1,11776,8,79521236
7803,260040891,1143628,261184519,14,0,0,5632,14,6620522312
7804,260077191,502948,260580139,36,0,1,2560,36,7668891529
7805,260118026,462128,260580154,13,0,1,5632,13,1304170212
7806,260132014,950412,261082426,25,0,0,110592,25,8905124112
7807,260155267,568296,260723563,25,0,0,56320,25,7589454085
7808,260162887,393656,260556543,32,0,0,4096,32,4883593398
7809,260164194,590421,260754615,29,0,0,6656,29,10142816616
7810,260170496,782309,260952805,34,0,0,67072,34,8870262265
7811,260173077,427200,260600277,11,0,0,12288,11,4309998770
7812,260189342,663008,260852350,7,0,0,74240,7,69939136
7813,260217789,453097,260670886,30,0,1,299008,30,6377946877
7814,260218864,454608,260673472,8,0,1,4096,8,8361056015
7815,260231148,858025,261089173,39,0,0,22016,39,6074058002
7816,260254369,384735,260639104,25,0,0,53248,25,6606320067
7817,260256782,551274,260808056,38,0,0,6144,38,2188186282
7818,260267379,477340,260744719,39,0,0,14848,39,5315827285
7819,260286218,387600,260673818,25,0,1,512,25,8051244990
7820,260304339,424060,260728399,22,0,0,6656,22,3187707980
7821,260317827,685787,261003614,39,0,0,63488,39,1747593020
7822,260320578,611768,260932346,24,0,0,70144,24,2133207649
7823,260349464,325980,260675444,0,0,1,2560,0,5432795625
7824,260355321,524654,260879975,36,0,0,7680,36,3730582065
7825,260358224,318526,260676750,4,0,1,2048,4,9890448545
7826,260359968,597696,260957664,34,0,0,15872,34,5651958021
7827,260389298,468854,260858152,30,0,0,18944,30,493267062
7828,260409328,268088,260677416,16,0,1,1024,16,4989131484
7829,260424038,879281,261303319,5,0,0,20992,5,10183027960
7830,260429503,251139,260680642,4,0,1,5120,4,2905227713
7831,260453918,229950,260683868,33,0,1,5120,33,1756531407
7832,260454724,682052,261136776,13,0,0,31232,13,3393193236
7833,260475465,873819,261349284,17,0,0,63488,17,446170899
7834,260485266,198948,260684214,25,0,1,512,25,872112357
7835,260516251,520920,261037171,25,0,0,512,25,2818749043
7836,260520862,510710,261031572,31,0,0,15872,31,3720183829
7837,260547447,218997,260766444,19,0,0,4096,19,1932615412
7838,260565408,601359,261166767,25,0,0,41472,25,9593438656
7839,260569871,117249,260687120,34,0,1,4608,34,5445451824
7840,260581749,1068402,261650151,24,0,0,43008,24,4217975015
7841,260588214,530656,261118870,36,0,0,28160,36,5353923687
7842,260595839,262492,260858331,31,0,0,512,31,7245404630
7843,260598443,192134,260790577,26,0,0,3584,26,3321526879
7844,260605033,260377,260865410,12,0,0,11776,12,6124473245
7845,260622801,66905,260689706,32,0,1,4096,32,9301828001
7846,260624057,71960,260696017,13,0,1,30208,13,10161183042
7847,260629005,667101,261296106,32,0,0,20992,32,2163661918
7848,260634353,65850,260700203,13,0,1,6656,13,4264794793
7849,260646161,58868,260705029,16,0,1,7680,16,27840419
7850,260655479,601433,261256912,13,0,0,76800,13,10498857763
7851,260660923,314737,260975660,3,0,0,29696,3,6407592872
7852,260717783,495934,261213717,13,0,0,23040,13,5793990563
7853,260718547,9867,260728414,16,0,1,8704,16,6149595803
7854,260721435,464035,261185470,17,0,0,3072,17,8582752648
7855,260721796,6641,260728437,19,0,1,2048,19,805704791
7856,260724092,565603,261289695,19,0,0,8704,19,9219475883
7857,260751134,518646,261269780,17,0,0,512,17,8788448641
7858,260763549,442273,261205822,20,0,0,9216,20,233908543
7859,260792934,581266,261374200,7,0,0,15872,7,2603263847
7860,260795268,1319964,262115232,21,0,0,28160,21,7358074362
7861,260797005,634967,261431972,32,0,0,31744,32,7850528827
7862,260805549,556027,261361576,5,0,0,9728,5,10704971401
7863,260814940,6754,260821694,23,0,1,7168,23,4887466031
7864,260818104,448510,261266614,5,0,0,31232,5,2913709815
7865,260818300,364488,261182788,12,0,0,25088,12,2596957571
7866,260826194,1223193,262049387,37,0,0,80384,37,6646601269
7867,260828464,23901,260852365,0,0,1,4608,0,5630274933
7868,260837978,27447,260865425,23,0,1,5632,23,2688192325
7869,260867776,1043520,261911296,9,0,0,54784,9,2671029190
7870,260883716,7706,260891422,32,0,1,8192,32,6460547680
7871,260895799,905566,261801365,25,0,0,15360,25,6058160383
7872,260903077,1282605,262185682,25,0,0,7168,25,5250507057
7873,260923864,612400,261536264,22,0,0,34816,22,6586854202
7874,260936002,22212,260958214,25,0,1,512,25,4181129499
7875,260950228,403774,261354002,36,0,0,15360,36,6036152
7876,260958393,2870,260961263,5,0,1,8704,5,2778990360
7877,260960207,6213,260966420,6,0,1,5632,6,5350425393
7878,260968867,731023,261699890,31,0,0,19456,31,7420457095
7879,260977015,461688,261438703,0,0,0,22016,0,8384787710
7880,260977240,573753,261550993,35,0,0,33280,35,6074686079
7881,260977564,279519,261257083,32,0,0,512,32,6883479609
7882,260978985,290624,261269609,32,0,0,9728,32,10716572064
7883,260997198,688208,261685406,17,0,0,59392,17,5762473514
7884,261013600,1215163,262228763,28,0,0,1024,28,8633536301
7885,261025727,261301,261287028,32,0,0,20480,32,3130104610
7886,261036419,458822,261495241,16,0,0,1536,16,3782870935
7887,261061237,705889,261767126,33,0,0,26624,33,5914731697
7888,261067040,355245,261422285,10,0,0,18432,10,645506768
7889,261069843,237563,261307406,21,0,0,1024,21,7874218411
7890,261112457,576552,261689009,15,0,0,11776,15,6094455982
7891,261129824,8028,261137852,27,0,1,1024,27,3239989993
7892,261135830,526036,261661866,33,0,0,38400,33,1184722799
7893,261136502,956072,262092574,20,0,0,9728,20,1120207228
7894,261138427,12566,261150993,25,0,1,20992,25,838651228
7895,261139415,452386,261591801,37,0,0,4608,37,7570869746
7896,261145328,7291,261152619,11,0,1,2560,11,2912178287
7897,261145621,7664,261153285,33,0,1,11264,33,512798110
7898,261155941,1192900,262348841,37,0,0,51200,37,5092893905
7899,261171504,693323,261864827,12,0,0,46080,12,118660539
7900,261193671,566,261194237,10,0,1,512,10,2412387054
7901,261216638,939278,262155916,33,0,0,14848,33,10624428657
7902,261244399,30044,261274443,1,0,1,12288,1,2133116347
7903,261245911,1268632,262514543,37,0,0,4096,37,6041211432
7904,261260943,514622,261775565,32,0,0,27648,32,53222965
7905,261277713,652004,261929717,22,0,0,20992,22,10432065277
7906,261300358,615789,261916147,29,0,0,15872,29,6298045857
7907,261307678,667494,261975172,5,0,0,13824,5,5252199600
7908,261325808,23491,261349299,33,0,1,5632,33,6063835194
7909,261344096,22860,261366956,1,0,1,25088,1,9703782865
7910,261382412,487688,261870100,34,0,0,15360,34,10331397928
7911,261384847,626220,262011067,19,0,0,117760,19,4195254611
7912,261396904,817340,262214244,38,0,0,80384,38,7001366244
7913,261423332,280629,261703961,35,0,0,13312,35,9864137046
7914,261460050,289682,261749732,26,0,0,12288,26,984552281
7915,261463749,3387,261467136,20,0,1,9728,20,5017740176
7916,261473457,1042,261474499,24,0,1,1024,24,2011877904
7917,261479502,3128,261482630,13,0,1,9216,13,8463649025
7918,261487712,3387,261491099,36,0,1,9728,36,1052138927
7919,261502480,1125613,262628093,19,0,0,37888,19,4704648432
7920,261558131,464526,262022657,10,0,0,30208,10,10531856743
7921,261568019,882859,262450878,3,0,0,11776,3,8937835252
7922,261573308,360218,261933526,27,0,0,5632,27,476114464
7923,261609718,5971,261615689,23,0,1,14848,23,4847871678
7924,261616547,208471,261825018,30,0,1,342528,30,8543122025
7925,261620713,205688,261826401,38,0,1,14848,38,4267850128
7926,261624752,547929,262172681,7,0,0,25088,7,7475944289
7927,261633128,432663,262065791,34,0,0,3072,34,2231581051
7928,261655147,172240,261827387,13,0,1,1536,13,5754072230
7929,261656652,172041,261828693,25,0,1,2048,25,9144861963
7930,261659035,804246,262463281,27,0,0,19968,27,4690757484
7931,261661974,168204,261830178,26,0,1,15360,26,7214764013
7932,261691039,432261,262123300,33,0,0,3584,33,7539521419
7933,261696624,587814,262284438,3,0,0,7168,3,7613155090
7934,261702051,880042,262582093,27,0,0,14848,27,5507091701
7935,261705339,319517,262024856,34,0,0,7168,34,3516941991
7936,261706488,124676,261831164,9,0,1,1536,9,4118903219
7937,261710319,303119,262013438,19,0,0,7680,19,1524215942
7938,261710498,684633,262395131,37,0,0,10752,37,6175378279
7939,261722772,113218,261835990,26,0,1,7680,26,5706400610
7940,261735247,371382,262106629,32,0,0,46080,32,2134658797
7941,261799257,473277,262272534,4,0,0,23552,4,7156377857
7942,261800087,423199,262223286,2,0,0,3072,2,10043149307
7943,261808963,33236,261842199,7,0,1,21504,7,8656140426
7944,261829726,13549,261843275,13,0,1,13312,13,2364392097
7945,261831933,350903,262182836,14,0,0,33280,14,1648819620
7946,261835138,9110,261844248,23,0,1,12800,23,8210467584
7947,261835788,234596,262070384,24,0,0,6144,24,9322807114
7948,261838207,7347,261845554,25,0,1,2048,25,7903705006
7949,261844192,2028,261846220,19,0,1,1024,19,3809533368
7950,261850205,14637,261864842,9,0,1,5120,9,7123256766
7951,261855158,261025,262116183,15,0,0,3072,15,5792362608
7952,261858349,678445,262536794,8,0,0,51712,8,10115567910
7953,261873189,179333,262052522,26,0,0,10240,26,6410503521
7954,261879895,13341,261893236,16,0,1,22528,16,3593912
7955,261915980,3546,261919526,19,0,1,9728,19,4529940364
7956,261935829,489866,262425695,8,0,0,10240,8,7116969056
7957,261943443,293061,262236504,25,0,0,21504,25,6462195339
7958,261945955,237520,262183475,33,0,0,2048,33,2298819173
7959,261965701,956642,262922343,6,0,0,81408,6,5690705118
7960,261973560,699440,262673000,28,0,0,72192,28,2211241698
7961,261982184,70377,262052561,9,0,1,23040,9,2807067852
7962,262009103,458405,262467508,26,0,0,13824,26,6082055987
7963,262009185,217154,262226339,29,0,0,8192,29,8831444535
7964,262024379,849831,262874210,25,0,0,26112,25,8412889907
7965,262034031,28799,262062830,1,0,1,16384,1,9673240126
7966,262034406,1134813,263169219,35,0,0,8192,35,1555145490
7967,262039657,324934,262364591,33,0,0,16384,33,2638247030
7968,262083255,244999,262328254,20,0,0,5632,20,1967517089
7969,262095512,45559,262141071,18,0,1,45056,18,7487592081
7970,262110298,410725,262521023,22,0,0,10240,22,7167508236
7971,262129530,726071,262855601,7,0,0,1536,7,6098636055
7972,262132669,518320,262650989,24,0,0,20480,24,3178067864
7973,262133045,630957,262764002,19,0,0,50688,19,3182168812
7974,262143745,366964,262510709,36,0,0,47616,36,1653379709
7975,262144774,270466,262415240,39,0,0,6144,39,8634991963
7976,262147521,323324,262470845,0,0,0,1024,0,9977065324
7977,262151488,642355,262793843,17,0,0,66560,17,2505346333
7978,262156827,420719,262577546,19,0,0,29184,19,988500141
7979,262162986,481190,262644176,30,0,0,52736,30,2186842372
7980,262171299,313618,262484917,5,0,0,15360,5,6376232302
7981,262186228,749133,262935361,11,0,0,39424,11,10228501009
7982,262215729,463400,262679129,8,0,0,3072,8,8239740593
7983,262234790,831075,263065865,10,0,0,73728,10,7845254284
7984,262244499,2946,262247445,0,0,1,3072,0,4647733311
7985,262248631,606487,262855118,34,0,0,94208,34,8969582119
7986,262262205,168497,262430702,14,0,0,16384,14,9120095478
7987,262264730,684062,262948792,21,0,0,44032,21,6785730304
7988,262268805,331586,262600391,11,0,0,6656,11,9353296724
7989,262284494,3898,262288392,13,0,1,4096,13,9971553702
7990,262302253,495004,262797257,11,0,0,1024,11,5711875881
7991,262308040,512572,262820612,28,0,0,8192,28,8055186048
7992,262309423,556816,262866239,5,0,0,19456,5,1491578972
7993,262325906,534390,262860296,15,0,0,15360,15,6396394546
7994,262350113,804359,263154472,0,0,0,34816,0,10344188645
7995,262351505,4850,262356355,37,0,1,5120,37,3408347205
7996,262360999,16409,262377408,2,0,1,21504,2,4107576921
7997,262371065,307113,262678178,5,0,0,8704,5,1110135668
7998,262373166,703828,263076994,36,0,0,29184,36,7407049416
7999,262391145,4009,262395154,18,0,1,10240,18,3759185737
8000,262393940,649401,263043341,24,0,0,55296,24,10544639221
8001,262410777,582653,262993430,39,0,0,18432,39,7697247685
8002,262412962,7230,262420192,12,0,1,7680,12,4920623955
8003,262415862,410537,262826399,22,0,0,18944,22,2728279857
8004,262416396,723404,263139800,4,0,0,32768,4,3504839844
8005,262442516,897765,263340281,36,0,0,96768,36,7162781050
8006,262444776,511090,262955866,17,0,0,11776,17,6432502076
8007,262454576,641549,263096125,31,0,0,3072,31,492596807
8008,262467765,543239,263011004,38,0,0,5632,38,5841574824
8009,262476293,421223,262897516,29,0,0,25600,29,432716223
8010,262487460,402209,262889669,33,0,0,50688,33,1950863517
8011,262507881,167630,262675511,26,0,0,8192,26,8651452600
8012,262523442,606359,263129801,29,0,0,4096,29,4741590137
8013,262527757,779018,263306775,26,0,0,25088,26,7228007091
8014,262528708,423555,262952263,37,0,0,11264,37,8555332892
8015,262556239,538912,263095151,10,0,0,34816,10,7526129072
8016,262572385,512127,263084512,17,0,0,512,17,1364137395
8017,262591819,331515,262923334,15,0,0,3072,15,958714081
8018,262593813,366756,262960569,34,0,0,15360,34,3103255660
8019,262595223,1994,262597217,21,0,1,2048,21,1466635958
8020,262600451,566257,263166708,2,0,0,5120,2,5153551414
8021,262608546,1994,262610540,2,0,1,2048,2,1814813490
8022,262619280,808737,263428017,27,0,0,28672,27,9410396860
8023,262644610,348835,262993445,6,0,1,565248,6,406329119
8024,262668726,415615,263084341,17,0,0,24064,17,3967702721
8025,262674605,446890,263121495,5,0,0,15872,5,972229016
8026,262679889,1123978,263803867,3,0,0,48640,3,4329386167
8027,262682795,419892,263102687,8,0,0,18944,8,2022752774
8028,262696725,413933,263110658,15,0,0,26112,15,8300978012
8029,262708152,882174,263590326,22,0,0,7680,22,3162718836
8030,262744148,687487,263431635,14,0,0,1024,14,7153421013
8031,262760720,525258,263285978,37,0,0,14336,37,3643669360
8032,262770168,297919,263068087,21,0,0,7168,21,6770512844
8033,262771098,674535,263445633,26,0,0,19968,26,10712171337
8034,262775782,226008,263001790,33,0,1,40960,33,4140806127
8035,262798098,715183,263513281,38,0,0,9728,38,8897056098
8036,262803606,703389,263506995,29,0,0,59904,29,3351053264
8037,262807739,215863,263023602,17,0,1,71680,17,2814921718
8038,262818220,699756,263517976,3,0,0,15360,3,6149988698
8039,262822883,220473,263043356,11,0,1,6144,11,1731927543
8040,262837067,595215,263432282,34,0,0,2048,34,7957426727
8041,262856801,186570,263043371,28,0,1,1024,28,7916325283
8042,262865953,644333,263510286,33,0,0,10752,33,1206458284
8043,262874079,169307,263043386,4,0,1,12288,4,9361122207
8044,262880383,1044005,263924388,9,0,0,77824,9,9590087005
8045,262884520,818213,263702733,36,0,0,53760,36,3650807837
8046,262931946,309056,263241002,27,0,0,27136,27,2250743304
8047,262935014,1290449,264225463,10,0,0,23040,10,3894321727
8048,262943835,783454,263727289,2,0,0,76800,2,6149525614
8049,262968069,430143,263398212,26,0,0,17408,26,4725397499
8050,262969538,461770,263431308,29,0,0,10752,29,8234780280
8051,262978345,692508,263670853,39,0,0,56832,39,5345744151
8052,263015848,926043,263941891,21,0,0,57344,21,9832532669
8053,263016429,49451,263065880,2,0,1,9728,2,4226301095
8054,263025022,609099,263634121,5,0,0,52224,5,9962838223
8055,263029515,65659,263095174,33,0,1,6144,33,502855438
8056,263069782,1276779,264346561,17,0,0,39424,17,6033573925
8057,263082013,497028,263579041,33,0,0,14848,33,170971744
8058,263094791,848683,263943474,9,0,0,5120,9,9256823584
8059,263106491,842201,263948692,17,0,0,10752,17,9305799270
8060,263117782,225174,263342956,39,0,0,8704,39,522714959
8061,263132641,441861,263574502,32,0,0,55808,32,6270159721
8062,263134088,423395,263557483,16,0,0,28672,16,2801125085
8063,263136437,836138,263972575,7,0,0,78336,7,740276815
8064,263147950,600942,263748892,20,0,0,47104,20,3127849397
8065,263149796,6211,263156007,25,0,1,1536,25,6959926095
8066,263163085,11274,263174359,8,0,1,18432,8,2225593792
8067,263164208,589239,263753447,38,0,0,14848,38,10159852385
8068,263165479,17286,263182765,16,0,1,26112,16,2004974354
8069,263166600,469720,263636320,8,0,0,7168,8,4544246215
8070,263180034,403294,263583328,14,0,0,6144,14,9161534702
8071,263215832,6488,263222320,7,0,1,15872,7,1867664877
8072,263221595,1081241,264302836,33,0,0,11264,33,9348179665
8073,263229929,855000,264084929,31,0,0,50688,31,8301581551
8074,263245705,592044,263837749,21,0,0,27648,21,3733597715
8075,263264909,315559,263580468,18,0,0,4608,18,5810895813
8076,263283773,4191,263287964,23,0,1,2048,23,7914653280
8077,263294351,473151,263767502,36,0,0,46080,36,9305633260
8078,263312292,37928,263350220,26,0,1,7680,26,5484006832
8079,263313724,1171983,264485707,3,0,0,53248,3,5265957713
8080,263337335,307946,263645281,9,0,0,8192,9,494638598
8081,263340218,341255,263681473,24,0,0,2048,24,4223900272
8082,263347769,1256098,264603867,8,0,0,47104,8,7234887771
8083,263425935,643527,264069462,38,0,0,53760,38,5219294258
8084,263456126,1215171,264671297,31,0,0,1024,31,6085350492
8085,263462789,325666,263788455,33,0,0,10752,33,10126253871
8086,263465173,834216,264299389,25,0,0,95232,25,5223812697
8087,263481606,1518,263483124,24,0,1,1536,24,5047712583
8088,263492657,630941,264123598,8,0,0,12800,8,4357158972
8089,263504319,352078,263856397,28,0,0,8192,28,3411976959
8090,263508151,505186,264013337,28,0,0,10240,28,2269859855
8091,263523065,422312,263945377,27,0,0,6144,27,9697923749
8092,263526864,464043,263990907,11,0,0,3072,11,2501907247
8093,263529900,1027452,264557352,14,0,0,83456,14,4924335773
8094,263534851,1343388,264878239,25,0,0,79360,25,1957488872
8095,263536738,439136,263975874,12,0,0,10752,12,2866783892
8096,263550541,30452,263580993,1,0,1,512,1,7879761288
8097,263614742,540338,264155080,26,0,0,4096,26,5516992565
8098,263634171,231857,263866028,32,0,0,6656,32,906244260
8099,263643121,472040,264115161,8,0,0,4608,8,8685833801
8100,263660982,469027,264130009,17,0,0,20992,17,4011152955
8101,263661565,348629,264010194,1,0,0,25600,1,2063167827
8102,263698855,542870,264241725,19,0,0,50688,19,458604615
8103,263700679,700910,264401589,37,0,0,46592,37,9613723261
8104,263735664,490594,264226258,38,0,0,2560,38,3470755698
8105,263736979,376763,264113742,27,0,0,29696,27,9085426850
8106,263765590,452838,264218428,5,0,0,50688,5,7564127741
8107,263766110,2451,263768561,19,0,1,1024,19,6348376188
8108,263821314,3904,263825218,15,0,1,10752,15,3800660812
8109,263824053,615330,264439383,20,0,0,8192,20,357070546
8110,263826064,850552,264676616,6,0,0,17408,6,8462477690
8111,263858593,454242,264312835,35,0,0,32768,35,1313542284
8112,263866053,511830,264377883,25,0,0,28160,25,5973429866
8113,263880520,540420,264420940,8,0,0,11776,8,6219440732
8114,263892802,355086,264247888,24,0,0,5632,24,9487718983
8115,263902107,1106398,265008505,8,0,0,118272,8,1077378332
8116,263902354,350244,264252598,0,0,0,15360,0,7416558050
8117,263903298,276780,264180078,7,0,0,5632,7,9862917007
8118,263907119,552275,264459394,39,0,0,13312,39,2447640104
8119,263910645,70384,263981029,37,0,1,13312,37,208875915
8120,263920402,61933,263982335,10,0,1,2048,10,74484795
8121,263926094,56587,263982681,13,0,1,512,13,2891062771
8122,263932512,391582,264324094,29,0,0,2560,29,4210100307
8123,263939134,650366,264589500,9,0,0,27648,9,3545886455
8124,263952378,397965,264350343,9,0,0,5632,9,5487505731
8125,263972542,11572,263984114,21,0,1,9728,21,9246394550
8126,263995510,490680,264486190,25,0,0,1536,25,4593466429
8127,264000234,817599,264817833,2,0,0,42496,2,2073737585
8128,264006681,415990,264422671,6,0,0,5632,6,8211510367
8129,264025582,472043,264497625,39,0,0,6656,39,6166327731
8130,264043299,405453,264448752,34,0,0,22016,34,644147606
8131,264053801,35937,264089738,4,0,1,5120,4,9348382297
8132,264070379,121064,264191443,6,0,1,174080,6,1370871538
8133,264071598,709495,264781093,15,0,0,38912,15,9820050671
8134,264074259,274345,264348604,37,0,0,6656,37,600219361
8135,264077851,115538,264193389,37,0,1,3072,37,6477626603
8136,264125470,496194,264621664,24,0,0,38400,24,152113839
8137,264153671,606613,264760284,0,0,0,67072,0,6864927477
8138,264164637,30698,264195335,33,0,1,3072,33,2798071812
8139,264165687,505283,264670970,13,0,0,17408,13,3823369167
8140,264168464,478102,264646566,6,0,0,13312,6,292552886
8141,264218609,29294,264247903,32,0,1,5120,32,7206523798
8142,264226014,431495,264657509,16,0,0,35840,16,10625219789
8143,264229134,23479,264252613,2,0,1,1536,2,3425612746
8144,264239461,186293,264425754,26,0,0,512,26,1048560662
8145,264258848,383138,264641986,13,0,0,8192,13,7596102871
8146,264262158,264219,264526377,33,0,0,3584,33,739432922
8147,264294942,628843,264923785,21,0,0,1536,21,9542608990
8148,264305210,377154,264682364,32,0,0,16384,32,1078555123
8149,264332566,680478,265013044,29,0,0,14848,29,9868241271
8150,264338654,430560,264769214,1,0,0,1024,1,4430909637
8151,264343469,714986,265058455,11,0,0,18944,11,5791553082
8152,264385915,15697,264401612,7,0,1,4608,7,5697316517
8153,264388731,380156,264768887,17,0,0,28160,17,9448811930
8154,264431459,234192,264665651,39,0,0,26624,39,7675184480
8155,264435493,270558,264706051,25,0,0,26112,25,9156873011
8156,264440837,10499,264451336,36,0,1,16896,36,4147533730
8157,264448456,396156,264844612,0,0,0,24576,0,8040490646
8158,264449426,341291,264790717,17,0,0,25600,17,9347886909
8159,264488386,251439,264739825,38,0,0,14848,38,667876910
8160,264524728,186326,264711054,16,0,0,8192,16,10317064368
8161,264529998,251422,264781420,7,0,0,1024,7,7562483873
8162,264592323,320896,264913219,9,0,0,18432,9,384789282
8163,264605748,324517,264930265,32,0,0,12288,32,2272100240
8164,264606240,542398,265148638,14,0,0,121344,14,1517256018
8165,264621227,393578,265014805,15,0,0,5632,15,5377749305
8166,264625823,2470,264628293,9,0,1,2560,9,9321280665
8167,264631211,615495,265246706,38,0,0,37888,38,5168086628
8168,264634195,213716,264847911,21,0,0,10752,21,3187533855
8169,264641269,16255,264657524,39,0,1,11264,39,1846262616
8170,264644332,521550,265165882,11,0,0,512,11,6803100968
8171,264670292,495411,265165703,10,0,0,38400,10,3482010191
8172,264678707,175337,264854044,39,0,0,5120,39,2897163733
8173,264678727,4696,264683423,8,0,1,1024,8,7641467193
8174,264702122,346787,265048909,12,0,0,24064,12,3310401814
8175,264705434,2152,264707586,25,0,1,1536,25,5079085998
8176,264719043,350035,265069078,26,0,0,34816,26,6374550690
8177,264721550,196052,264917602,16,0,0,14336,16,9180347819
8178,264733858,573760,265307618,10,0,0,121856,10,2203938184
8179,264735438,283906,265019344,12,0,0,14848,12,2464345177
8180,264744793,407292,265152085,25,0,0,11264,25,4220192050
8181,264755053,350274,265105327,31,0,0,61440,31,9685445201
8182,264767014,386966,265153980,28,0,0,6144,28,3382440113
8183,264821063,543021,265364084,36,0,0,69120,36,5410511417
8184,264837450,14324,264851774,11,0,1,10752,11,1208703117
8185,264848496,263139,265111635,36,0,0,3072,36,644892492
8186,264864551,569463,265434014,20,0,0,5120,20,639325563
8187,264866872,243782,265110654,15,0,0,17408,15,5234683590
8188,264887227,328329,265215556,19,0,0,512,19,8060081680
8189,264917048,13232,264930280,20,0,1,17408,20,8200950245
8190,264930120,400757,265330877,20,0,0,8704,20,10115212684
8191,264933318,1994,264935312,18,0,1,2048,18,6034004797
8192,264934608,78451,265013059,6,0,1,78848,6,8149881309
8193,264937649,384703,265322352,30,0,0,44544,30,6583009483
8194,264954778,58296,265013074,16,0,1,1536,16,2240217387
8195,264963856,956444,265920300,34,0,0,108032,34,4042051137
8196,264971893,432505,265404398,20,0,0,1024,20,1571676835
8197,265010708,355747,265366455,17,0,0,7680,17,5802633361
8198,265034191,5802,265039993,33,0,1,6144,33,2954328104
8199,265050590,18503,265069093,11,0,1,12800,11,28111912
8200,265058656,21278,265079934,0,0,1,17408,0,5927813634
8201,265060016,50653,265110669,30,0,1,34304,30,10031445448
8202,265062449,265761,265328210,28,0,0,15360,28,8130109337
8203,265062659,246074,265308733,1,0,0,3584,1,4648318768
8204,265067695,995942,266063637,30,0,0,11264,30,8470989926
8205,265077057,361496,265438553,22,0,0,14848,22,6167716590
8206,265084390,26294,265110684,9,0,1,2560,9,7617672352
8207,265084835,453117,265537952,24,0,0,118272,24,1008638502
8208,265086826,343564,265430390,1,0,0,18432,1,750162791
8209,265102596,762629,265865225,22,0,0,6656,22,9774720437
8210,265105276,757906,265863182,16,0,0,108544,16,1240311464
8211,265133696,465822,265599518,12,0,0,9216,12,4063566917
8212,265139736,251030,265390766,32,0,0,19456,32,10342121283
8213,265157390,177510,265334900,14,0,0,6144,14,4019628367
8214,265177826,231974,265409800,5,0,0,2560,5,5300520735
8215,265184707,1042,265185749,26,0,1,1024,26,6098853145
8216,265188191,2870,265191061,9,0,1,8704,9,661546021
8217,265196007,446891,265642898,21,0,0,53248,21,2113232970
8218,265214056,461273,265675329,22,0,0,6656,22,10731143439
8219,265259790,935361,266195151,30,0,0,43520,30,9492432981
8220,265271817,50558,265322375,0,0,1,11264,0,832009508
8221,265290072,40820,265330892,23,0,1,6144,23,1699932315
8222,265298209,246950,265545159,7,0,0,23552,7,9357826004
8223,265302249,392453,265694702,24,0,0,1024,24,7995066384
8224,265317012,549031,265866043,33,0,0,1024,33,7905006753
8225,265318505,150435,265468940,17,0,0,43008,17,8603333537
8226,265330476,4447,265334923,20,0,1,3584,20,3632318412
8227,265333681,339511,265673192,28,0,0,7168,28,5027030277
8228,265346469,700373,266046842,38,0,0,15872,38,1753979724
8229,265347163,142442,265489605,6,0,1,199680,6,7403497249
8230,265357600,134271,265491871,21,0,1,3584,21,52198430
8231,265381914,111263,265493177,28,0,1,2048,28,9085544773
8232,265384611,709133,266093744,0,0,0,72704,0,5456594916
8233,265385129,613892,265999021,24,0,0,8192,24,9485404595
8234,265385910,952912,266338822,31,0,0,22016,31,5634548307
8235,265390267,711967,266102234,3,0,0,8704,3,1586939163
8236,265392688,577654,265970342,2,0,0,66048,2,9510614338
8237,265399381,535481,265934862,31,0,0,15872,31,6242909233
8238,265402548,573441,265975989,1,0,0,18432,1,4659705301
8239,265412508,312627,265725135,15,0,0,7680,15,1859180070
8240,265419761,355281,265775042,35,0,0,18432,35,7982301271
8241,265429503,500500,265930003,31,0,0,31744,31,2967853541
8242,265429720,64942,265494662,0,0,1,15360,0,5891994076
8243,265438104,448158,265886262,35,0,0,65536,35,3596029710
8244,265439480,498517,265937997,8,0,0,10240,8,10667694838
8245,265445416,53432,265498848,26,0,1,6656,26,3187124421
8246,265450481,49033,265499514,37,0,1,1024,37,9793232217
8247,265460197,530798,265990995,27,0,0,49152,27,9404196361
8248,265469228,274320,265743548,35,0,0,2560,35,6878434289
8249,265469649,559495,266029144,13,0,0,98816,13,2741904266
8250,265471110,570873,266041983,3,0,0,41984,3,8329906396
8251,265474182,267225,265741407,33,0,0,5632,33,6303427102
8252,265493979,1011314,266505293,6,0,0,80384,6,2660378669
8253,265500888,447576,265948464,35,0,0,34304,35,5202121550
8254,265507912,243316,265751228,34,0,0,2560,34,8874798555
8255,265519489,35870,265555359,2,0,1,16384,2,5558679906
8256,265541509,324199,265865708,11,0,0,1536,11,8016098969
8257,265542785,573105,266115890,20,0,0,38400,20,9831655858
8258,265543226,14079,265557305,1,0,1,3072,1,4892056953
8259,265550759,9452,265560211,21,0,1,4608,21,9010755222
8260,265556375,7062,265563437,37,0,1,5120,37,9272085092
8261,265560749,610160,266170909,27,0,0,37376,27,10685928247
8262,265575804,599652,266175456,38,0,0,14848,38,5610017560
8263,265609170,1518,265610688,16,0,1,1536,16,3757186068
8264,265615117,2470,265617587,25,0,1,2560,25,5173812300
8265,265623114,327089,265950203,11,0,0,5632,11,607614349
8266,265636804,250565,265887369,7,0,0,3584,7,134134717
8267,265644771,536636,266181407,1,0,0,19456,1,1171001824
8268,265651126,876404,266527530,31,0,0,19456,31,8587718731
8269,265694517,5503,265700020,32,0,1,5632,32,2560445535
8270,265717614,657893,266375507,8,0,0,15360,8,7754562789
8271,265747115,3128,265750243,16,0,1,9216,16,5898616195
8272,265763175,863120,266626295,39,0,0,32768,39,10632636772
8273,265780220,1042,265781262,25,0,1,1024,25,1897265854
8274,265785690,5326,265791016,19,0,1,5632,19,4457573231
8275,265816435,306349,266122784,2,0,0,22528,2,1226104231
8276,265828943,167551,265996494,1,0,0,17920,1,7975580603
8277,265852141,825518,266677659,33,0,0,18944,33,613325288
8278,265884015,570997,266455012,36,0,0,64000,36,9238093312
8279,265891663,401737,266293400,10,0,0,32768,10,6027959632
8280,265902180,73824,265976004,39,0,1,5120,39,9821656910
8281,265938405,198109,266136514,36,0,0,18944,36,7942745541
8282,265943226,469668,266412894,8,0,0,9728,8,9951061819
8283,265956722,812795,266769517,33,0,0,1536,33,1019548145
8284,265960972,263377,266224349,17,0,0,19456,17,1344956363
8285,265971709,75148,266046857,11,0,1,1536,11,7544097956
8286,265976377,70495,266046872,28,0,1,512,28,6032153415
8287,265976677,412214,266388891,1,0,0,16384,1,1169728132
8288,266011841,268599,266280440,14,0,0,21504,14,7088614432
8289,266014087,392930,266407017,27,0,0,59392,27,10571376574
8290,266024739,258662,266283401,39,0,0,1536,39,8208065611
8291,266035147,13728,266048875,12,0,1,2048,12,4404675435
8292,266037954,498545,266536499,0,0,0,19968,0,5460278308
8293,266051233,6754,266057987,4,0,1,7168,4,5001294115
8294,266051743,11909,266063652,4,0,1,7680,4,3093643309
8295,266071387,458997,266530384,36,0,0,7680,36,8162383492
8296,266082444,663849,266746293,4,0,0,40960,4,1591367686
8297,266094264,206542,266300806,8,0,0,7680,8,4648708609
8298,266098449,566,266099015,8,0,1,512,8,3834452150
8299,266100023,486912,266586935,8,0,0,24576,8,6906272075
8300,266102379,13526,266115905,31,0,1,11776,31,5170775654
8301,266123032,13770,266136802,18,0,1,26624,18,5234737536
8302,266123064,23908,266146972,2,0,1,16896,2,9584062698
8303,266135039,386540,266521579,26,0,0,4096,26,8870429968
8304,266143812,376480,266520292,30,0,0,49152,30,6855884466
8305,266144027,3611,266147638,8,0,1,1024,8,3886958155
8306,266145570,3374,266148944,11,0,1,2048,11,7284219718
8307,266152528,605167,266757695,37,0,0,11264,37,7429983048
8308,266160104,109110,266269214,15,0,0,5120,15,6079912071
8309,266165823,29343,266195166,24,0,1,3584,24,7386529923
8310,266198858,409796,266608654,38,0,0,32768,38,5902002412
8311,266208773,560261,266769034,11,0,0,22528,11,2824016918
8312,266222990,462952,266685942,33,0,0,27136,33,9509720822
8313,266223694,570690,266794384,15,0,0,37888,15,2151290496
8314,266226074,526755,266752829,25,0,0,18432,25,2495949909
8315,266229948,659931,266889879,25,0,0,88576,25,7802499262
8316,266243237,804452,267047689,29,0,0,122368,29,6396221470
8317,266264468,583432,266847900,39,0,0,49152,39,6438245994
8318,266303475,603244,266906719,12,0,0,19456,12,5400081482
8319,266316699,2470,266319169,33,0,1,2560,33,6603337972
8320,266321260,206761,266528021,6,0,0,1536,6,9664715066
8321,266324392,944607,267268999,14,0,0,31232,14,3012446630
8322,266325695,13142,266338837,37,0,1,15872,37,3514038128
8323,266326218,361931,266688149,31,0,0,7168,31,3712670856
8324,266329890,424358,266754248,38,0,0,4608,38,7970792459
8325,266350545,370525,266721070,24,0,0,35328,24,8323297166
8326,266363921,498955,266862876,2,0,0,32768,2,252809331
8327,266368393,710907,267079300,9,0,0,512,9,7229806837
8328,266379068,9838,266388906,12,0,1,5120,12,9691260758
8329,266383854,594202,266978056,7,0,0,87040,7,1862094512
8330,266387019,20598,266407617,11,0,1,512,11,6870084760
8331,266391369,21540,266412909,20,0,1,5120,20,1746336337
8332,266401200,658539,267059739,13,0,0,31744,13,2388237266
8333,266429817,157289,266587106,10,0,0,512,10,9918193752
8334,266430222,640764,267070986,32,0,0,36864,32,7395444642
8335,266435106,19921,266455027,31,0,1,5120,31,8946677694
8336,266474955,882279,267357234,11,0,0,33280,11,3333488868
8337,266481901,432933,266914834,37,0,0,3584,37,6920407456
8338,266489127,47411,266536538,32,0,1,3584,32,2122085462
8339,266492326,518064,267010390,8,0,0,83968,8,9757124178
8340,266496916,641941,267138857,31,0,0,30208,31,5493971438
8341,266504442,720994,267225436,4,0,0,9216,4,1791426005
8342,266514745,24659,266539404,28,0,1,3072,28,3585890601
8343,266523623,21502,266545125,9,0,1,8192,9,9817769681
8344,266523737,210061,266733798,22,0,0,19968,22,8631417139
8345,266528291,423222,266951513,1,0,0,56832,1,1006968819
8346,266542102,667368,267209470,29,0,0,78848,29,2428242557
8347,266557308,665297,267222605,3,0,0,43008,3,7252253964
8348,266560240,824122,267384362,12,0,0,14336,12,4063534751
8349,266560614,588257,267148871,7,0,0,27136,7,3706606050
8350,266584740,494381,267079121,14,0,0,26624,14,927275294
8351,266586640,463412,267050052,13,0,0,7680,13,8235140188
8352,266607809,6033,266613842,25,0,1,13312,25,3127347919
8353,266642979,341363,266984342,15,0,0,11264,15,158396832
8354,266645260,11016,266656276,0,0,1,17920,0,8851486266
8355,266659834,808006,267467840,7,0,0,55296,7,374530166
8356,266675646,23478,266699124,13,0,1,17920,13,4973302693
8357,266687646,659433,267347079,6,0,0,6656,6,2227930384
8358,266737604,181447,266919051,31,0,0,11264,31,7854233027
8359,266766217,374371,267140588,30,0,0,5632,30,8634942836
8360,266778709,347298,267126007,10,0,0,9216,10,3480465474
8361,266790375,552930,267343305,22,0,0,82944,22,10725868190
8362,266790424,190471,266980895,11,0,0,9216,11,3952409561
8363,266796051,2470,266798521,33,0,1,2560,33,7315062238
8364,266796627,359279,267155906,35,0,0,23040,35,4234644249
8365,266802566,87336,266889902,38,0,1,124928,38,6391753527
8366,266833974,329971,267163945,33,0,0,1536,33,6795849
8367,266840750,270332,267111082,8,0,0,10240,8,376516524
8368,266847674,983120,267830794,29,0,0,57344,29,2226871708
8369,266850737,39188,266889925,25,0,1,23040,25,7535440044
8370,266874431,32303,266906734,24,0,1,18432,24,8181633668
8371,266881994,24755,266906749,24,0,1,8704,24,9040696558
8372,266898308,611394,267509702,17,0,0,34816,17,4786266563
8373,266920233,437188,267357421,39,0,0,512,39,9240765962
8374,266934412,1101091,268035503,9,0,0,7680,9,5819330199
8375,266943571,1151386,268094957,27,0,0,35328,27,2645945784
8376,266956628,274127,267230755,1,0,0,17408,1,4136382871
8377,267009327,692533,267701860,9,0,0,11264,9,386445515
8378,267040671,39655,267080326,9,0,1,1024,9,8071787126
8379,267062783,436288,267499071,15,0,0,102400,15,8571130403
8380,267068275,450490,267518765,37,0,0,29696,37,5424093471
8381,267080949,478952,267559901,35,0,0,12288,35,2537621197
8382,267088581,180745,267269326,33,0,0,1024,33,2147916872
8383,267090492,148168,267238660,24,0,0,7680,24,4380087112
8384,267092791,1147462,268240253,8,0,0,51200,8,8041201758
8385,267093852,3898,267097750,28,0,1,4096,28,9152788722
8386,267094394,1067061,268161455,5,0,0,25600,5,1040558242
8387,267100494,244542,267345036,3,0,0,5632,3,6339211365
8388,267102697,1994,267104691,21,0,1,2048,21,10220330439
8389,267116775,305918,267422693,26,0,0,17920,26,1655345633
8390,267148729,373639,267522368,12,0,0,11776,12,5728075730
8391,267165367,566,267165933,23,0,1,512,23,9583173785
8392,267167745,443678,267611423,24,0,0,18944,24,4447805164
8393,267173222,3898,267177120,27,0,1,4096,27,9473508826
8394,267187424,43346,267230770,7,0,1,6144,7,4980614710
8395,267188171,463418,267651589,26,0,0,40448,26,5433610370
8396,267238241,377586,267615827,1,0,0,8192,1,5021511634
8397,267246881,276914,267523795,17,0,0,4608,17,5086488334
8398,267288145,552875,267841020,9,0,0,3072,9,6566550555
8399,267299750,4374,267304124,23,0,1,4608,23,8986944553
8400,267303911,438718,267742629,0,0,0,15360,0,1181286793
8401,267311692,291455,267603147,21,0,0,25600,21,6459448153
8402,267329948,41032,267370980,31,0,1,23040,31,2485451647
8403,267338323,290106,267628429,19,0,0,34816,19,10385113595
8404,267389165,268976,267658141,0,0,0,16384,0,5292972071
8405,267393385,15062,267408447,33,0,1,29184,33,5711580366
8406,267419052,7020,267426072,32,0,1,9728,32,562373873
8407,267430168,222224,267652392,27,0,0,2560,27,4441729647
8408,267447730,220614,267668344,19,0,0,1024,19,735910386
8409,267451492,388553,267840045,10,0,0,30208,10,4092143085
8410,267451551,301545,267753096,39,0,0,34304,39,1285018129
8411,267468904,448348,267917252,24,0,0,111104,24,6348371195
8412,267479084,48857,267527941,23,0,1,11264,23,6882367770
8413,267518140,327746,267845886,30,0,0,6144,30,3518719529
8414,267541079,387770,267928849,9,0,0,19456,9,8058746307
8415,267554036,255377,267809413,12,0,0,32256,12,6271909535
8416,267558858,321400,267880258,29,0,0,58368,29,7167973505
8417,267597766,13672,267611438,7,0,1,13824,7,4002759332
8418,267625096,218903,267843999,32,0,0,9728,32,4317926846
8419,267633350,226471,267859821,28,0,0,9216,28,8240704575
8420,267633968,1518,267635486,39,0,1,1536,39,7059312138
8421,267635027,742214,268377241,26,0,0,51712,26,6347520830
8422,267640834,472577,268113411,5,0,0,34304,5,696680759
8423,267669904,247995,267917899,0,0,0,2048,0,6625032272
8424,267682171,240735,267922906,33,0,0,16384,33,6417732217
8425,267690754,14029,267704783,31,0,1,27136,31,670158759
8426,267697814,232462,267930276,33,0,0,4608,33,7883789850
8427,267699272,437836,268137108,28,0,0,5120,28,1582905559
8428,267701260,600654,268301914,20,0,0,28672,20,9109208251
8429,267722548,341616,268064164,20,0,0,31744,20,13304620
8430,267723314,238395,267961709,26,0,0,15872,26,999294378
8431,267769102,374577,268143679,29,0,0,13312,29,1877297006
8432,267794910,275992,268070902,21,0,0,14336,21,10299022333
8433,267796707,317671,268114378,31,0,0,3072,31,9150668587
8434,267804109,220980,268025089,22,0,0,14848,22,882806014
8435,267805088,435812,268240900,27,0,0,2048,27,2062093898
8436,267813096,253423,268066519,22,0,0,7680,22,7046913148
8437,267814558,305957,268120515,10,0,0,19968,10,5710273020
8438,267816959,28942,267845901,28,0,1,512,28,4241053578
8439,267821584,24332,267845916,2,0,1,2560,2,5431966742
8440,267824305,674232,268498537,4,0,0,22528,4,2358352922
8441,267827025,297576,268124601,36,0,0,13312,36,9243071375
8442,267889192,375614,268264806,11,0,0,9728,11,2316752075
8443,267898156,382147,268280303,15,0,0,47616,15,5699659269
8444,267935193,167743,268102936,32,0,0,26112,32,5165004914
8445,267976853,384609,268361462,39,0,0,20992,39,4085294289
8446,267979388,541510,268520898,33,0,0,14336,33,1364906170
8447,268000691,557432,268558123,25,0,0,14848,25,2940656718
8448,268007316,1518,268008834,12,0,1,1536,12,1161470433
8449,268010020,621433,268631453,2,0,0,50688,2,3540327228
8450,268010646,318620,268329266,19,0,0,35328,19,6456649523
8451,268015578,476072,268491650,24,0,0,100352,24,5146548162
8452,268023958,312210,268336168,30,0,0,15872,30,2618607255
8453,268024770,5662,268030432,12,0,1,5632,12,9321131991
8454,268029800,230697,268260497,33,0,0,11776,33,9693483432
8455,268030135,84266,268114401,38,0,1,123392,38,4795199054
8456,268055204,276105,268331309,5,0,0,6656,5,8104858988
8457,268073097,41319,268114416,24,0,1,2560,24,8065696529
8458,268085770,34760,268120530,11,0,1,11776,11,5747692713
8459,268085989,38708,268124697,21,0,1,8192,21,7386968608
8460,268090903,650900,268741803,8,0,0,97792,8,4748905364
8461,268128708,1994,268130702,37,0,1,2048,37,7133317614
8462,268137732,203443,268341175,31,0,0,16384,31,9710867953
8463,268147238,274520,268421758,13,0,0,4096,13,6546501486
8464,268157677,487798,268645475,7,0,0,11264,7,9020242086
8465,268174656,3387,268178043,19,0,1,9728,19,17581870
8466,268218321,331512,268549833,12,0,0,52224,12,6899077896
8467,268235875,8406,268244281,10,0,1,3584,10,4398103046
8468,268245236,271271,268516507,30,0,0,32256,30,4022087796
8469,268257391,266962,268524353,10,0,0,11264,10,7824391667
8470,268274217,232447,268506664,13,0,0,26624,13,2249325218
8471,268276140,10151,268286291,12,0,1,14848,12,1339967556
8472,268287446,3898,268291344,4,0,1,4096,4,6982773217
8473,268300552,311687,268612239,17,0,0,48640,17,2214233040
8474,268301608,223236,268524844,20,0,0,1536,20,5499136153
8475,268309515,402469,268711984,21,0,0,41472,21,1853401839
8476,268322021,315449,268637470,38,0,0,15872,38,7872979692
8477,268335745,8368,268344113,27,0,1,3072,27,2461537804
8478,268345620,31652,268377272,33,0,1,36864,33,1235873754
8479,268348800,32298,268381098,1,0,1,4096,1,4905979774
8480,268365240,186168,268551408,9,0,0,5120,9,10211651343
8481,268378381,4343,268382724,4,0,1,2560,4,10495433334
8482,268394219,305106,268699325,19,0,0,55808,19,1952851007
8483,268404852,175020,268579872,39,0,0,10240,39,671867852
8484,268413843,30491,268444334,6,0,1,49152,6,2274801795
8485,268423134,22071,268445205,33,0,1,12288,33,4230333916
8486,268443697,427168,268870865,28,0,0,1536,28,3701069232
8487,268449306,505830,268955136,33,0,0,22016,33,970441862
8488,268449784,1518,268451302,23,0,1,1536,23,3189254229
8489,268466128,646281,269112409,29,0,0,133632,29,6760765979
8490,268489164,415537,268904701,37,0,0,9216,37,4407551017
8491,268511191,18963,268530154,7,0,1,5632,7,5672344556
8492,268514446,288403,268802849,5,0,0,9216,5,6327835138
8493,268519298,468485,268987783,33,0,0,63488,33,6881792682
8494,268553281,575702,269128983,35,0,0,8192,35,2154168119
8495,268553943,347935,268901878,31,0,0,24064,31,7081584576
8496,268555079,15110,268570189,0,0,1,19968,0,4732811660
8497,268566933,591120,269158053,20,0,0,12800,20,9099065903
8498,268573098,226265,268799363,4,0,0,25088,4,1286478984
8499,268579876,4166,268584042,39,0,1,11264,39,8608338580
8500,268590505,336069,268926574,30,0,0,49664,30,4834288776
8501,268596567,358748,268955315,25,0,0,512,25,1223869484
8502,268604484,352404,268956888,25,0,0,2560,25,5267153833
8503,268618135,19655,268637790,32,0,1,6656,32,5318721562
8504,268620655,39364,268660019,38,0,1,48128,38,1939725747
8505,268620879,533235,269154114,9,0,0,82432,9,9560549001
8506,268622828,129682,268752510,32,0,0,6144,32,6009505391
8507,268654777,10068,268664845,20,0,1,7680,20,9001440968
8508,268657784,569067,269226851,30,0,0,9728,30,8161660319
8509,268670812,195642,268866454,29,0,0,13824,29,10397356889
8510,268678571,600114,269278685,20,0,0,16384,20,4255886767
8511,268679761,501875,269181636,20,0,0,27136,20,1799838855
8512,268682284,59534,268741818,20,0,1,1536,20,8600127140
8513,268697316,503563,269200879,20,0,0,25088,20,1970742020
8514,268702308,51385,268753693,24,0,1,19456,24,1486806054
8515,268708072,463132,269171204,35,0,0,43008,35,7754263764
8516,268716780,409684,269126464,33,0,0,46080,33,8804026743
8517,268718865,689286,269408151,28,0,0,44032,28,6429095530
8518,268737629,536049,269273678,39,0,0,70144,39,9711257350
8519,268749188,209161,268958349,36,0,0,2560,36,5051260037
8520,268752016,471848,269223864,4,0,0,55808,4,7134722349
8521,268776054,1518,268777572,5,0,1,1536,5,5901803909
8522,268812414,393784,269206198,10,0,0,17408,10,9635008218
8523,268834542,372295,269206837,9,0,0,2048,9,5290039778
8524,268843765,4374,268848139,27,0,1,4608,27,6702695277
8525,268846453,4679,268851132,8,0,1,12288,8,2382550097
8526,268868179,523194,269391373,29,0,0,84480,29,5739189262
8527,268879023,410769,269289792,11,0,0,36352,11,8790899205
8528,268887864,506488,269394352,6,0,0,9728,6,4646751139
8529,268888439,474185,269362624,22,0,0,44032,22,3123509586
8530,268915911,16409,268932320,24,0,1,14336,24,429603221
8531,268924409,9217,268933626,18,0,1,2048,18,4162478061
8532,268925357,580733,269506090,20,0,0,22528,20,7521782046
8533,268935852,309283,269245135,39,0,0,24576,39,1894878907
8534,268949821,444702,269394523,39,0,0,512,39,1452025384
8535,268956846,30952,268987798,33,0,1,39424,33,5989491363
8536,269012504,10757,269023261,13,0,1,17408,13,9504501072
8537,269015621,438812,269454433,8,0,0,6144,8,6361424502
8538,269040877,400161,269441038,15,0,0,17920,15,2316374238
8539,269055522,235377,269290899,20,0,0,3584,20,6754664962
8540,269057493,308125,269365618,39,0,0,7168,39,4386786611
8541,269067144,417469,269484613,11,0,0,2560,11,8850842524
8542,269070865,506877,269577742,29,0,0,31744,29,8227969973
8543,269078309,725115,269803424,27,0,0,97280,27,339617117
8544,269085953,85274,269171227,27,0,1,512,27,5748437039
8545,269101894,261525,269363419,25,0,0,2560,25,2925141594
8546,269102181,514700,269616881,30,0,0,18944,30,948912353
8547,269120070,290748,269410818,6,0,0,8704,6,3267729038
8548,269142749,467412,269610161,21,0,0,27136,21,1716460530
8549,269147515,322647,269470162,12,0,0,7680,12,1987733386
8550,269158296,493900,269652196,31,0,0,16896,31,1352707523
8551,269171616,1042,269172658,26,0,1,1024,26,5842165504
8552,269201119,251427,269452546,36,0,0,3072,36,7004036128
8553,269202236,312777,269515013,22,0,0,29184,22,10043067760
8554,269202651,539680,269742331,15,0,0,8192,15,1840231329
8555,269212054,22537,269234591,2,0,1,8192,2,3524138813
8556,269214054,282586,269496640,0,0,0,7680,0,4596314344
8557,269245568,333437,269579005,26,0,0,4096,26,2557881149
8558,269249044,697724,269946768,33,0,0,6656,33,5757642719
8559,269262139,511630,269773769,30,0,0,82944,30,9390173103
8560,269269752,536830,269806582,10,0,0,6144,10,3343860938
8561,269315015,806318,270121333,10,0,0,46592,10,1753347569
8562,269315904,707335,270023239,13,0,0,33280,13,8769994159
8563,269336480,504937,269841417,28,0,0,114176,28,5408270189
8564,269342564,92991,269435555,8,0,0,9728,8,3410195484
8565,269387034,567393,269954427,14,0,0,25088,14,8064074678
8566,269387530,332994,269720524,26,0,0,10240,26,647580095
8567,269410385,566993,269977378,9,0,0,49664,9,5381004350
8568,269433912,419305,269853217,7,0,0,14336,7,5426389141
8569,269439560,459410,269898970,2,0,0,146432,2,1955410646
8570,269448214,400604,269848818,12,0,0,14848,12,9973646733
8571,269449749,181489,269631238,20,0,0,14848,20,1285787795
8572,269452764,401560,269854324,17,0,0,3584,17,8438454150
8573,269473273,463904,269937177,9,0,0,5632,9,10136611631
8574,269476074,258436,269734510,10,0,0,26112,10,5117046123
8575,269488412,250489,269738901,30,0,0,14336,30,3558541316
8576,269498257,566052,270064309,10,0,0,58368,10,8244121412
8577,269501517,342746,269844263,12,0,0,8704,12,9980994261
8578,269501672,238024,269739696,15,0,0,2560,15,3016886621
8579,269511502,192167,269703669,22,0,0,5120,22,2623696754
8580,269524084,3898,269527982,24,0,1,4096,24,2956896889
8581,269545747,258940,269804687,17,0,0,4096,17,148337827
8582,269581402,62416,269643818,30,0,1,101376,30,6852091869
8583,269590650,371149,269961799,3,0,0,20480,3,9997688186
8584,269612212,32272,269644484,9,0,1,1024,9,4625989822
8585,269624428,580552,270204980,12,0,0,33792,12,1026167666
8586,269631650,13180,269644830,6,0,1,512,6,6459628473
8587,269643447,273658,269917105,9,0,0,59392,9,3698508112
8588,269647166,330859,269978025,26,0,0,2048,26,7412793805
8589,269660897,1042,269661939,21,0,1,1024,21,6820566021
8590,269681441,411946,270093387,20,0,0,10752,20,5316652703
8591,269684889,2870,269687759,16,0,1,8704,16,1946810116
8592,269705991,135605,269841596,12,0,0,512,12,5718883413
8593,269720238,5474,269725712,4,0,1,13312,4,9160332335
8594,269723556,221169,269944725,32,0,0,10240,32,8281569592
8595,269726904,212316,269939220,33,0,0,6656,33,9044753054
8596,269761544,251527,270013071,4,0,0,1536,4,128164415
8597,269768763,548597,270317360,0,0,0,20992,0,4648209245
8598,269773029,81310,269854339,27,0,1,3584,27,8817077792
8599,269773341,387628,270160969,4,0,0,15360,4,2228835793
8600,269780618,309462,270090080,35,0,0,84480,35,3283679148
8601,269813578,169063,269982641,7,0,0,13312,7,8509604592
8602,269815242,408785,270224027,20,0,0,62464,20,6149252901
8603,269823221,360222,270183443,5,0,0,33792,5,4144118794
8604,269830153,665834,270495987,22,0,0,105984,22,1419154160
8605,269858516,61494,269920010,2,0,1,3072,2,2322516925
8606,269885521,37158,269922679,28,0,1,12288,28,2540722779
8607,269887650,255089,270142739,17,0,0,1024,17,10123935233
8608,269902915,454040,270356955,1,0,0,62976,1,4721226851
8609,269915714,10487,269926201,0,0,1,4608,0,3849344914
8610,269916859,11568,269928427,38,0,1,13312,38,3437149146
8611,269928553,33269,269961822,2,0,1,53760,2,9264767450
8612,269957518,291757,270249275,19,0,0,2048,19,8998559425
8613,269966992,16343,269983335,19,0,1,5632,19,9719473128
8614,269975545,335404,270310949,14,0,0,28160,14,8701049036
8615,269994387,326435,270320822,37,0,0,11264,37,3046352977
8616,270038985,567082,270606067,36,0,0,38400,36,572685163
8617,270039855,232484,270272339,36,0,0,7168,36,4158340547
8618,270051774,485137,270536911,20,0,0,39936,20,2474356704
8619,270059120,330511,270389631,34,0,0,52736,34,607786083
8620,270072473,318273,270390746,14,0,0,3584,14,4688168901
8621,270074760,443593,270518353,5,0,0,44032,5,7533927236
8622,270079222,248239,270327461,9,0,0,11776,9,3237266134
8623,270090005,372412,270462417,24,0,0,73728,24,2488550825
8624,270095650,767811,270863461,10,0,0,16384,10,2114373746
8625,270099911,295968,270395879,28,0,0,2048,28,3942551507
8626,270114499,461117,270575616,39,0,0,36352,39,4911923361
8627,270115783,6150,270121933,10,0,1,512,10,9134180972
8628,270119605,2674,270122279,24,0,1,512,24,9139486011
8629,270125402,439099,270564501,34,0,0,12800,34,4270330002
8630,270126730,682954,270809684,3,0,0,33792,3,2274705460
8631,270133570,204174,270337744,21,0,0,13312,21,3712614697
8632,270150355,649010,270799365,28,0,0,57856,28,9365002011
8633,270169441,294239,270463680,3,0,0,4096,3,9847310021
8634,270178840,251465,270430305,1,0,0,9216,1,7483559982
8635,270202156,24976,270227132,16,0,1,3072,16,9747180431
8636,270204621,42675,270247296,21,0,1,36352,21,6021373014
8637,270208309,40981,270249290,7,0,1,3072,7,4850897724
8638,270213587,153386,270366973,26,0,0,1024,26,3898479107
8639,270215036,372723,270587759,9,0,0,2560,9,1774477640
8640,270215282,345304,270560586,15,0,0,65536,15,3559165477
8641,270219599,31589,270251188,26,0,1,3072,26,6118866034
8642,270220534,720591,270941125,4,0,0,7680,4,1595682646
8643,270229589,511374,270740963,35,0,0,34304,35,3285989810
8644,270234513,18301,270252814,13,0,1,2560,13,913374568
8645,270257142,7230,270264372,0,0,1,7680,0,1597539668
8646,270264372,148462,270412834,6,0,0,1536,6,10282939733
8647,270285406,408718,270694124,19,0,0,3072,19,6775664214
8648,270286235,31140,270317375,12,0,1,33792,12,6938414381
8649,270328161,364988,270693149,27,0,0,65024,27,9655158994
8650,270336431,201431,270537862,36,0,0,3072,36,10712771862
8651,270359306,6754,270366060,16,0,1,7168,16,1048230272
8652,270362044,735664,271097708,0,0,0,49664,0,4473289056
8653,270367124,3898,270371022,18,0,1,4096,18,4637674624
8654,270369008,273905,270642913,20,0,0,27136,20,5489515418
8655,270371457,153271,270524728,21,0,0,9728,21,3291511274
8656,270386096,379713,270765809,25,0,0,18944,25,1174031866
8657,270401451,215320,270616771,32,0,0,28160,32,1399234642
8658,270408856,307484,270716340,19,0,0,15872,19,2524199517
8659,270418818,4374,270423192,23,0,1,4608,23,3558377002
8660,270424657,237906,270662563,37,0,0,3584,37,3541873197
8661,270430316,578606,271008922,8,0,0,59392,8,7441271353
8662,270470116,746782,271216898,21,0,0,41472,21,8034816850
8663,270473588,399003,270872591,1,0,0,3072,1,7695621718
8664,270489382,235241,270724623,30,0,0,27136,30,7692788415
8665,270509038,9873,270518911,16,0,1,512,16,5105796766
8666,270551313,26757,270578070,18,0,1,2560,18,9807874551
8667,270554430,117882,270672312,20,0,0,16384,20,4291537836
8668,270560095,328096,270888191,19,0,0,36352,19,896876984
8669,270564325,383063,270947388,22,0,0,20480,22,2419989531
8670,270571532,406776,270978308,25,0,0,19456,25,7553631348
8671,270576903,272440,270849343,21,0,0,26624,21,2145789716
8672,270590861,646859,271237720,33,0,0,18432,33,1570718068
8673,270593804,344913,270938717,5,0,0,76288,5,197343154
8674,270599345,170064,270769409,22,0,0,512,22,5883605074
8675,270628615,698575,271327190,15,0,0,93696,15,5365006692
8676,270648682,360427,271009109,8,0,0,512,8,1675883208
8677,270654340,1518,270655858,4,0,1,1536,4,2227451183
8678,270663028,9299,270672327,32,0,1,7168,32,3818129452
8679,270677418,20613,270698031,16,0,1,4096,16,9514347637
8680,270678048,23849,270701897,14,0,1,6144,14,8429085191
8681,270682082,21441,270703523,7,0,1,2560,7,8886149018
8682,270690918,13885,270704803,19,0,1,14336,19,7572523389
8683,270692080,13191,270705271,13,0,1,8704,13,4876867028
8684,270694525,296278,270990803,9,0,0,23040,9,8422078646
8685,270695801,777492,271473293,6,0,0,137216,6,5733651785
8686,270721070,8888,270729958,24,0,1,5632,24,6886119245
8687,270721653,320147,271041800,24,0,0,17408,24,546648384
8688,270728453,416572,271145025,21,0,0,22528,21,217682588
8689,270775997,632830,271408827,22,0,0,56320,22,4211773605
8690,270783171,330024,271113195,26,0,0,6144,26,838008642
8691,270788316,21968,270810284,24,0,1,512,24,10552011149
8692,270789224,222256,271011480,21,0,0,7680,21,5753414174
8693,270793522,277826,271071348,37,0,0,15872,37,1420758191
8694,270822232,368340,271190572,22,0,0,4608,22,793763633
8695,270832424,106308,270938732,6,0,1,143872,6,5496729041
8696,270837020,594442,271431462,3,0,0,24576,3,5020326794
8697,270843297,417289,271260586,7,0,0,17408,7,9987330573
8698,270850487,88268,270938755,38,0,1,9728,38,22391602
8699,270850557,284861,271135418,30,0,0,31744,30,7323867107
8700,270861692,249008,271110700,2,0,0,12800,2,8529117185
8701,270862872,75898,270938770,34,0,1,1024,34,10202454370
8702,270877915,285957,271163872,28,0,0,3584,28,10357628159
8703,270918651,31849,270950500,20,0,1,9216,20,8937353358
8704,270920726,464817,271385543,24,0,0,12288,24,5302384342
8705,270936529,588683,271525212,38,0,0,28672,38,2413012566
8706,270968025,397478,271365503,30,0,0,16384,30,6757701548
8707,270977428,261414,271238842,12,0,0,3584,12,5579864671
8708,270982135,1518,270983653,18,0,1,1536,18,8617488259
8709,270986514,25495,271012009,31,0,1,9216,31,4524114544
8710,270995652,892323,271887975,30,0,0,6656,30,2968484282
8711,270998974,346483,271345457,11,0,0,53248,11,1161183176
8712,271001402,12873,271014275,28,0,1,2560,28,2022636586
8713,271006260,368867,271375127,4,0,0,18432,4,9935328215
8714,271023965,638122,271662087,13,0,0,99328,13,8621522947
8715,271034529,785702,271820231,22,0,0,109568,22,4005339690
8716,271043928,376793,271420721,12,0,0,25088,12,2463991159
8717,271048902,566,271049468,10,0,1,512,10,1860429094
8718,271050975,505966,271556941,5,0,0,43520,5,9342825138
8719,271091416,10224,271101640,7,0,1,4096,7,5825188276
8720,271093903,8083,271101986,39,0,1,512,39,10668907106
8721,271096843,271483,271368326,2,0,0,9216,2,4396450996
8722,271104175,430732,271534907,39,0,0,31744,39,9210968066
8723,271121960,57113,271179073,30,0,1,97792,30,3104239187
8724,271128755,352977,271481732,37,0,0,27648,37,6558767282
8725,271211036,276647,271487683,4,0,0,19456,4,7396788521
8726,271217488,787655,272005143,8,0,0,99840,8,7254642404
8727,271222296,15439,271237735,26,0,1,16384,26,6950344779
8728,271224233,14624,271238857,2,0,1,6144,2,7649073559
8729,271242800,300866,271543666,25,0,0,28672,25,8194748376
8730,271246166,540650,271786816,2,0,0,31744,2,3935204579
8731,271252791,133711,271386502,34,0,0,3072,34,1506133800
8732,271253180,825967,272079147,37,0,0,11776,37,8178279601
8733,271289136,1137951,272427087,9,0,0,102912,9,1637543979
8734,271316481,456718,271773199,28,0,0,29696,28,8456137353
8735,271322069,922623,272244692,24,0,0,40960,24,273415821
8736,271323785,405144,271728929,13,0,0,5120,13,9912379902
8737,271359068,315709,271674777,34,0,0,40448,34,135220982
8738,271368593,549781,271918374,4,0,0,23552,4,3661518853
8739,271373156,566933,271940089,26,0,0,64000,26,2380058457
8740,271376571,708265,272084836,2,0,0,13312,2,2285797139
8741,271384302,392812,271777114,12,0,0,12800,12,4049850727
8742,271384996,844174,272229170,32,0,0,163328,32,431728247
8743,271394760,513532,271908292,2,0,0,15872,2,3590343985
8744,271405547,549548,271955095,38,0,0,49152,38,9515768306
8745,271413445,335546,271748991,38,0,0,5120,38,5241235260
8746,271414007,248415,271662422,0,0,0,1024,0,2150604438
8747,271426969,581090,272008059,3,0,0,1024,3,5638416576
8748,271439722,54174,271493896,26,0,1,15360,26,5235754804
8749,271458474,516234,271974708,34,0,0,15360,34,9968821696
8750,271511287,496415,272007702,38,0,0,8192,38,10114625838
8751,271523165,33791,271556956,18,0,1,12288,18,1351599613
8752,271556557,324674,271881231,30,0,0,9728,30,8961511342
8753,271564027,1042,271565069,7,0,1,1024,7,862842598
8754,271565047,402977,271968024,6,0,0,24064,6,8006357513
8755,271590318,654553,272244871,25,0,0,512,25,1259736798
8756,271606560,860725,272467285,33,0,0,29696,33,390844085
8757,271613927,432375,272046302,3,0,0,20992,3,1888583002
8758,271633049,927084,272560133,21,0,0,73728,21,131305140
8759,271645803,739372,272385175,26,0,0,67072,26,9254316539
8760,271646480,421783,272068263,9,0,0,3072,9,9080251715
8761,271666110,648094,272314204,11,0,0,44032,11,2310818515
8762,271667157,494895,272162052,38,0,0,58368,38,2076429979
8763,271673509,6247,271679756,9,0,1,12800,9,332490861
8764,271676524,919459,272595983,26,0,0,18432,26,3787293645
8765,271689122,7706,271696828,17,0,1,8192,17,10066394114
8766,271689854,838617,272528471,8,0,0,43008,8,10226055583
8767,271691422,437063,272128485,22,0,0,11264,22,9772025257
8768,271734498,444885,272179383,22,0,0,56832,22,4826370348
8769,271737740,310761,272048501,15,0,0,7168,15,2036445382
8770,271763888,13241,271777129,38,0,1,10752,38,1749211007
8771,271772590,167514,271940104,2,0,1,165888,2,6731738349
8772,271778891,176235,271955126,1,0,1,34816,1,4793253218
8773,271794486,654673,272449159,14,0,0,20480,14,2128520996
8774,271799769,564939,272364708,19,0,0,76288,19,6141737548
8775,271822398,409791,272232189,24,0,0,9728,24,425263461
8776,271860955,94202,271955157,10,0,1,55296,10,1232191617
8777,271924976,768609,272693585,35,0,0,20480,35,3063597993
8778,271929800,370965,272300765,3,0,0,61440,3,4787747655
8779,271940721,66996,272007717,17,0,1,66560,17,9290683868
8780,271942724,65008,272007732,6,0,1,512,6,1314914263
8781,271962441,49951,272012392,18,0,1,4608,18,287854622
8782,271972361,40287,272012648,1,0,1,9216,1,5425261471
8783,271972479,693823,272666302,6,0,0,6144,6,18843557
8784,271972737,43138,272015875,37,0,1,10240,37,8044931299
8785,271981204,790400,272771604,39,0,0,6656,39,4807587030
8786,271984709,336731,272321440,19,0,0,11264,19,1764046817
8787,272015992,12308,272028300,0,0,1,20480,0,1843173474
8788,272041881,786389,272828270,27,0,0,30208,27,622651028
8789,272064366,200656,272265022,21,0,0,8704,21,3944371670
8790,272071593,386629,272458222,3,0,0,29696,3,6357522071
8791,272081260,399784,272481044,20,0,0,45056,20,2228403697
8792,272091317,180869,272272186,30,0,0,14848,30,4657833514
8793,272091480,351424,272442904,8,0,0,19456,8,9253688129
8794,272137354,377983,272515337,30,0,0,47104,30,7207386351
8795,272155368,89534,272244902,12,0,1,15360,12,78057624
8796,272170291,579093,272749384,0,0,0,5632,0,9687142062
8797,272173575,318263,272491838,26,0,0,2048,26,1898601740
8798,272180951,64921,272245872,1,0,1,1024,1,55290264
8799,272185201,584352,272769553,24,0,0,11264,24,10274223527
8800,272213447,223498,272436945,35,0,0,32256,35,693076063
8801,272219222,31407,272250629,38,0,1,13824,38,7113087120
8802,272229577,301873,272531450,0,0,0,9728,0,2744407095
8803,272252244,7230,272259474,10,0,1,7680,10,2791268563
8804,272262321,536368,272798689,34,0,0,88576,34,3878755600
8805,272286216,204983,272491199,3,0,0,33280,3,4572492699
8806,272319234,5144,272324378,31,0,1,3072,31,7572691873
8807,272324593,1042,272325635,19,0,1,1024,19,7551898948
8808,272356733,233619,272590352,9,0,0,27648,9,3653318488
8809,272361426,28645,272390071,7,0,1,12800,7,8364485614
8810,272366771,397136,272763907,32,0,0,47616,32,8101740841
8811,272386896,259970,272646866,39,0,0,41984,39,4158335215
8812,272392782,34320,272427102,20,0,1,4608,20,9862712539
8813,272404276,488511,272892787,33,0,0,19968,33,4200057489
8814,272411826,160420,272572246,9,0,0,5120,9,9435010391
8815,272451448,276422,272727870,21,0,0,33792,21,9127520700
8816,272456098,208317,272664415,24,0,0,8704,24,7798648957
8817,272493648,361001,272854649,9,0,0,86528,9,6755236359
8818,272497744,17608,272515352,14,0,1,4096,14,8418746763
8819,272516446,302605,272819051,37,0,0,17408,37,3637363953
8820,272524521,9416,272533937,20,0,1,2560,20,1692692545
8821,272544134,221972,272766106,5,0,0,7168,5,148308533
8822,272555781,337489,272893270,38,0,0,1536,38,10145090182
8823,272600142,339089,272939231,26,0,0,70144,26,4579421300
8824,272621037,361418,272982455,0,0,0,50688,0,6745570936
8825,272627156,325866,272953022,38,0,0,45056,38,5116986377
8826,272638245,42116,272680361,30,0,1,58368,30,6310730513
8827,272674723,8864,272683587,31,0,1,5120,31,8482334585
8828,272684274,9326,272693600,37,0,1,9216,37,3668201351
8829,272685257,394949,273080206,10,0,0,19456,10,2270272385
8830,272723631,4797,272728428,19,0,1,512,19,2876339095
8831,272735427,220122,272955549,38,0,0,8192,38,2763262540
8832,272764669,295173,273059842,0,0,0,33280,0,9493172374
8833,272778119,177650,272955769,17,0,1,259072,17,9065828011
8834,272792865,166450,272959315,7,0,1,5632,7,2262569907
8835,272813386,354865,273168251,14,0,0,23040,14,10034320051
8836,272814765,523364,273338129,11,0,0,55808,11,8754958739
8837,272826116,316887,273143003,11,0,0,37888,11,3082498299
8838,272840096,125325,272965421,10,0,1,20992,10,553753862
8839,272845075,152527,272997602,30,0,1,104960,30,4203934608
8840,272861548,513332,273374880,26,0,0,22528,26,3123579941
8841,272868178,452924,273321102,15,0,0,53760,15,3506512167
8842,272892465,110424,273002889,21,0,1,16896,21,6726923625
8843,272893030,113725,273006755,20,0,1,6144,20,8286599337
8844,272894188,381015,273275203,11,0,0,81408,11,5030989909
8845,272898709,110632,273009341,8,0,1,4096,8,941360976
8846,272912659,447340,273359999,12,0,0,41984,12,8249249296
8847,272917788,444574,273362362,30,0,0,7680,30,4883543452
8848,272922543,591732,273514275,27,0,0,9216,27,1557723791
8849,272923063,87264,273010327,30,0,1,1536,30,756761989
8850,272944867,555930,273500797,28,0,0,69632,28,1565657982
8851,272948841,207998,273156839,37,0,0,7680,37,8840627498
8852,272951059,62174,273013233,26,0,1,4608,26,6772546304
8853,272954916,225131,273180047,15,0,0,6656,15,4050940046
8854,272982427,32112,273014539,7,0,1,2048,7,8612599
8855,273000734,81203,273081937,31,0,0,5632,31,4470311710
8856,273004402,14643,273019045,9,0,1,7168,9,691669407
8857,273010465,357536,273368001,17,0,0,18432,17,7561097608
8858,273013765,5626,273019391,37,0,1,512,37,4891510294
8859,273019093,158903,273177996,38,0,0,11264,38,2729386336
8860,273020686,4850,273025536,28,0,1,5120,28,6885920693
8861,273049733,367562,273417295,24,0,0,23552,24,9416530103
8862,273052963,294229,273347192,10,0,0,29696,10,5147539321
8863,273105187,406265,273511452,3,0,0,34816,3,970094950
8864,273115787,259600,273375387,7,0,0,1536,7,9449867235
8865,273167190,292209,273459399,29,0,0,31232,29,39521047
8866,273175848,5200,273181048,24,0,1,1024,24,4391194531
8867,273192072,422162,273614234,11,0,0,36352,11,7013937918
8868,273196504,470926,273667430,34,0,0,18432,34,3987505450
8869,273199196,260406,273459602,27,0,0,512,27,207900252
8870,273205621,415648,273621269,2,0,0,23040,2,6079249460
8871,273214651,610963,273825614,30,0,0,15872,30,2880212712
8872,273218897,12049,273230946,8,0,1,19968,8,2896707624
8873,273240529,135349,273375878,14,0,0,1536,14,4294781692
8874,273262014,475125,273737139,26,0,0,68608,26,660837196
8875,273277545,325598,273603143,8,0,0,60928,8,9727731468
8876,273281951,1042,273282993,12,0,1,1024,12,9900452875
8877,273296687,458865,273755552,28,0,0,34304,28,3479830527
8878,273308453,380648,273689101,32,0,0,20992,32,4003713501
8879,273319852,356174,273676026,2,0,0,6144,2,6688152162
8880,273334170,46665,273380835,23,0,1,14848,23,2140487368
8881,273356367,556361,273912728,24,0,0,28672,24,5202498062
8882,273362646,283756,273646402,4,0,0,29184,4,5867788273
8883,273369448,481931,273851379,9,0,0,12800,9,807435190
8884,273374789,7568,273382357,7,0,1,8704,7,5894953574
8885,273382386,594123,273976509,3,0,0,16896,3,9796144842
8886,273427470,44920,273472390,6,0,1,77312,6,3787330430
8887,273442993,445438,273888431,3,0,0,32256,3,7709004172
8888,273449358,414734,273864092,21,0,0,25088,21,6054087886
8889,273450045,245615,273695660,38,0,0,4096,38,3900045101
8890,273451103,327494,273778597,0,0,0,24064,0,8342697596
8891,273464332,279867,273744199,17,0,0,512,17,4958883492
8892,273480050,521791,274001841,15,0,0,14336,15,4920583299
8893,273493070,583007,274076077,28,0,0,1536,28,7259705881
8894,273497859,281065,273778924,11,0,0,1024,11,8713371444
8895,273499174,396760,273895934,20,0,0,24576,20,10116049106
8896,273539127,13341,273552468,26,0,1,22528,26,3523487208
8897,273545910,308141,273854051,8,0,0,5120,8,2219783821
8898,273560043,515551,274075594,37,0,0,16384,37,2361056954
8899,273567672,187895,273755567,33,0,1,306176,33,9799844518
8900,273567993,392825,273960818,36,0,0,24064,36,4372692268
8901,273568251,191427,273759678,39,0,1,18432,39,3121373939
8902,273578714,426673,274005387,33,0,0,9728,33,5204827090
8903,273627152,177643,273804795,26,0,0,22016,26,4959117232
8904,273644131,411092,274055223,2,0,0,57344,2,1972060906
8905,273652133,248652,273900785,30,0,0,15872,30,991040999
8906,273678916,83028,273761944,27,0,1,3584,27,8382761584
8907,273692259,305199,273997458,14,0,0,58368,14,476170551
8908,273696248,374331,274070579,36,0,0,14848,36,5597944423
8909,273717530,262114,273979644,17,0,0,10240,17,5966805527
8910,273736404,68414,273804818,6,0,1,102400,6,9252133862
8911,273745646,337260,274082906,2,0,0,4096,2,1907011113
8912,273768861,296376,274065237,10,0,0,12288,10,391595008
8913,273787952,731002,274518954,12,0,0,32256,12,2972998265
8914,273789177,15656,273804833,28,0,1,14336,28,9245687640
8915,273798739,8050,273806789,31,0,1,2048,31,33907677
8916,273815558,245920,274061478,10,0,0,20480,10,5768826913
8917,273824664,297424,274122088,26,0,0,14336,26,7757808813
8918,273827746,204857,274032603,35,0,0,9216,35,10006131813
8919,273837548,388416,274225964,28,0,0,74240,28,7396747038
8920,273848003,406848,274254851,27,0,0,39424,27,7669542321
8921,273870778,406887,274277665,5,0,0,24576,5,782732617
8922,273873107,397047,274270154,32,0,0,50176,32,3671679635
8923,273891112,391732,274282844,14,0,0,16896,14,10075481814
8924,273893044,9293,273902337,37,0,1,1536,37,7027808065
8925,273896360,212132,274108492,7,0,0,30208,7,6936369801
8926,273911045,154987,274066032,21,0,0,2560,21,3560518184
8927,273920181,2470,273922651,27,0,1,2560,27,8950795867
8928,273942669,475452,274418121,38,0,0,64000,38,5728061738
8929,273947460,723646,274671106,38,0,0,51200,38,2617858875
8930,273947533,3422,273950955,21,0,1,3584,21,8385758893
8931,273954150,444440,274398590,27,0,0,88576,27,1220646427
8932,273958469,341695,274300164,26,0,0,2048,26,10591956298
8933,273962715,4374,273967089,28,0,1,4608,28,6321409434
8934,273964903,152421,274117324,10,0,0,2048,10,2262297435
8935,273970089,9570,273979659,4,0,1,10752,4,6098659645
8936,273994692,19983,274014675,37,0,1,21504,37,3773475424
8937,273995855,371604,274367459,33,0,0,28672,33,4641939664
8938,274018701,5454,274024155,31,0,1,13824,31,4123897220
8939,274050046,680538,274730584,21,0,0,18432,21,5828546698
8940,274067183,610818,274678001,36,0,0,22528,36,7916225562
8941,274082108,14560,274096668,33,0,1,26624,33,1746405702
8942,274087461,9873,274097334,33,0,1,1024,33,2926613388
8943,274091715,203636,274295351,4,0,0,25600,4,9069558009
8944,274130266,174271,274304537,4,0,0,3072,4,5795074679
8945,274137713,1994,274139707,11,0,1,2048,11,212640254
8946,274138150,724166,274862316,3,0,0,56832,3,3967599239
8947,274148311,498185,274646496,39,0,0,36352,39,9851295113
8948,274180660,398237,274578897,29,0,0,3584,29,3346501952
8949,274204712,581196,274785908,31,0,0,5632,31,9136346495
8950,274208086,242333,274450419,2,0,0,9728,2,8671766778
8951,274208214,22046,274230260,21,0,1,11264,21,1334198096
8952,274210200,317181,274527381,22,0,0,4096,22,6206942971
8953,274210951,246734,274457685,8,0,0,11264,8,10133503109
8954,274213764,756053,274969817,37,0,0,48640,37,4462426945
8955,274224174,7392,274231566,0,0,1,2048,0,894289637
8956,274252193,618333,274870526,9,0,0,13312,9,1402948214
8957,274258854,745796,275004650,11,0,0,26624,11,6376518036
8958,274267756,50126,274317882,6,0,1,61440,6,8374702469
8959,274274911,46837,274321748,8,0,1,6144,8,8050457007
8960,274290444,269453,274559897,11,0,0,1536,11,9711396542
8961,274310497,369258,274679755,38,0,0,3584,38,5654858423
8962,274311789,531163,274842952,36,0,0,22016,36,5274696545
8963,274312949,293170,274606119,14,0,0,49664,14,10559823031
8964,274313211,468923,274782134,37,0,0,92672,37,2533282746
8965,274323906,992131,275316037,4,0,0,56832,4,3875477380
8966,274330410,1994,274332404,28,0,1,2048,28,96785275
8967,274335244,820222,275155466,7,0,0,6144,7,8195014268
8968,274345806,1070893,275416699,13,0,0,28160,13,2710461295
8969,274379179,43275,274422454,21,0,1,4608,21,2164659563
8970,274381843,41803,274423646,20,0,1,11264,20,3802543031
8971,274409573,582567,274992140,10,0,0,73216,10,4892929634
8972,274415006,387550,274802556,6,0,0,22016,6,8113524882
8973,274425635,583569,275009204,9,0,0,12800,9,9097980334
8974,274434203,378141,274812344,34,0,0,9216,34,5385448786
8975,274450823,6885,274457708,27,0,1,15360,27,9423206479
8976,274452345,544178,274996523,28,0,0,14336,28,1436018551
8977,274477752,431270,274909022,26,0,0,48128,26,6684259888
8978,274506272,12697,274518969,31,0,1,4608,31,5060927703
8979,274508649,169999,274678648,38,0,0,2048,38,8767020000
8980,274519021,267994,274787015,35,0,0,3584,35,5585741092
8981,274558065,226112,274784177,24,0,0,6656,24,1191702582
8982,274559800,445489,275005289,37,0,0,2048,37,1531746679
8983,274565724,486133,275051857,5,0,0,8704,5,4852044164
8984,274583223,359610,274942833,32,0,0,512,32,911235440
8985,274588285,2470,274590755,7,0,1,2560,7,714900670
8986,274597064,154855,274751919,0,0,0,18432,0,1678634762
8987,274597682,11841,274609523,35,0,1,9728,35,8957296653
8988,274616764,586335,275203099,31,0,0,55296,31,603183937
8989,274623780,442950,275066730,6,0,0,5632,6,5679104864
8990,274651050,212529,274863579,38,0,0,4096,38,6654028143
8991,274659477,417464,275076941,13,0,0,6656,13,251871665
8992,274661183,32098,274693281,11,0,1,29696,11,8293653932
8993,274675097,237528,274912625,21,0,0,11776,21,9386714610
8994,274690591,6876,274697467,19,0,1,6656,19,10363566785
8995,274703825,160876,274864701,9,0,0,3584,9,10174828055
8996,274709076,3422,274712498,10,0,1,3584,10,6659386878
8997,274718325,148130,274866455,39,0,0,5120,39,2397812446
8998,274719879,4420,274724299,4,0,1,11776,4,751706734
8999,274727586,4984,274732570,7,0,1,2048,7,5988732341
9000,274734667,130205,274864872,34,0,0,512,34,1349241407
9001,274789607,160162,274949769,34,0,0,10240,34,5395353577
9002,274803094,560027,275363121,10,0,0,43008,10,2854285448
9003,274805918,587809,275393727,5,0,0,11264,5,8623442865
9004,274839748,23846,274863594,32,0,1,8704,32,9586555621
9005,274854940,75824,274930764,2,0,0,7168,2,7587526479
9006,274887193,266386,275153579,3,0,0,95744,3,7986414764
9007,274896217,347056,275243273,26,0,0,86528,26,6744215642
9008,274906986,357770,275264756,35,0,0,25600,35,366815180
9009,274909744,245737,275155481,17,0,1,377344,17,8332959317
9010,274917169,242086,275159255,2,0,1,46592,2,1765359911
9011,274930454,279414,275209868,2,0,1,177664,2,948123204
9012,274942401,733662,275676063,37,0,0,6656,37,4366971274
9013,274956180,259333,275215513,3,0,0,9216,3,6020690841
9014,274964223,581582,275545805,14,0,0,18944,14,4156426628
9015,274989011,254277,275243288,10,0,1,39936,10,8655354513
9016,274994784,298749,275293533,2,0,1,229376,2,6472407121
9017,274999568,159672,275159240,28,0,0,12288,28,8118633542
9018,275005678,290121,275295799,23,0,1,3584,23,3575410601
9019,275014591,255640,275270231,31,0,0,17920,31,8186177910
9020,275023828,321407,275345235,38,0,0,5120,38,7404031723
9021,275095282,201823,275297105,26,0,1,2048,26,4190884221
9022,275126098,237350,275363448,36,0,0,1024,36,6367458105
9023,275202709,94742,275297451,38,0,1,512,38,216056437
9024,275233916,218930,275452846,5,0,0,39424,5,4173283043
9025,275240132,284532,275524664,20,0,0,1536,20,7878713161
9026,275249721,267133,275516854,3,0,0,10240,3,5431709241
9027,275253646,345724,275599370,1,0,0,38912,1,7029602821
9028,275258143,181881,275440024,17,0,0,11264,17,7419902751
9029,275267744,226319,275494063,19,0,0,14848,19,3333970249
9030,275268151,172668,275440819,30,0,0,2560,30,4573989704
9031,275285207,265621,275550828,32,0,0,16384,32,10521968466
9032,275295523,410842,275706365,3,0,0,14336,3,3114063226
9033,275298310,317820,275616130,22,0,0,6144,22,6290123311
9034,275327500,3645,275331145,0,0,1,10240,0,9737186153
9035,275331047,331570,275662617,13,0,0,8192,13,6199902698
9036,275374925,163883,275538808,15,0,0,512,15,2689781542
9037,275377155,401549,275778704,0,0,0,15872,0,5811171686
9038,275394397,364099,275758496,38,0,0,96256,38,4051869478
9039,275416886,5971,275422857,8,0,1,14848,8,4260313919
9040,275459902,255393,275715295,26,0,0,12288,26,1449002167
9041,275460447,305895,275766342,2,0,0,512,2,1909733783
9042,275463865,94177,275558042,14,0,0,4096,14,5116653639
9043,275497422,4374,275501796,38,0,1,4608,38,6886525183
9044,275497890,184466,275682356,5,0,0,7680,5,3341112382
9045,275501440,172580,275674020,28,0,0,37376,28,5166403629
9046,275506703,203109,275709812,15,0,0,11264,15,8656811506
9047,275507747,258416,275766163,20,0,0,25088,20,1367967699
9048,275510451,705298,276215749,31,0,0,59392,31,2599404694
9049,275511369,5500,275516869,19,0,1,4608,19,5224671071
9050,275516465,169502,275685967,22,0,0,3072,22,9263985854
9051,275541195,387893,275929088,30,0,0,60928,30,6708633124
9052,275543939,262973,275806912,34,0,0,35840,34,8780162485
9053,275545616,228229,275773845,6,0,0,24576,6,910300569
9054,275574020,418860,275992880,1,0,0,10240,1,4537473460
9055,275593971,370991,275964962,12,0,0,8704,12,5220288812
9056,275601825,499513,276101338,15,0,0,102400,15,9080510534
9057,275602413,191788,275794201,24,0,0,8704,24,2288793685
9058,275615626,3918,275619544,16,0,1,3584,16,5202837900
9059,275623885,154842,275778727,17,0,1,249344,17,3525832779
9060,275625486,190171,275815657,29,0,0,1024,29,2367423033
9061,275654911,125679,275780590,19,0,1,4608,19,5924033586
9062,275661908,274847,275936755,13,0,0,25088,13,1562358197
9063,275662158,118688,275780846,26,0,1,9216,26,10522668580
9064,275677999,104153,275782152,24,0,1,2048,24,7336805464
9065,275684546,255196,275939742,4,0,0,9728,4,1880699176
9066,275711896,442089,276153985,23,0,0,23040,23,9277768390
9067,275718283,464451,276182734,10,0,0,47616,10,5054647793
9068,275719741,394550,276114291,31,0,0,22016,31,10270819149
9069,275723829,62189,275786018,10,0,1,6144,10,1339495333
9070,275725650,61354,275787004,32,0,1,1536,32,5168728826
9071,275739035,256570,275995605,11,0,0,6656,11,4975385713
9072,275743426,577918,276321344,3,0,0,13824,3,4503289734
9073,275765654,22336,275787990,33,0,1,1536,33,681529564
9074,275779151,15065,275794216,0,0,1,19968,0,6484946591
9075,275784094,384102,276168196,11,0,0,46592,11,5370829652
9076,275795439,11504,275806943,20,0,1,2048,20,2737622893
9077,275797047,671419,276468466,22,0,0,512,22,4914215840
9078,275797308,457736,276255044,7,0,0,34816,7,10374842326
9079,275809545,321762,276131307,28,0,0,512,28,32559002
9080,275840586,539560,276380146,26,0,0,15872,26,2418543059
9081,275844033,221208,276065241,3,0,0,17920,3,6819285528
9082,275858313,243991,276102304,4,0,0,3072,4,6319523858
9083,275860535,7706,275868241,26,0,1,8192,26,429466784
9084,275872533,320350,276192883,30,0,0,21504,30,2691012136
9085,275873791,229324,276103115,7,0,0,2560,7,563509298
9086,275886344,498512,276384856,11,0,0,14848,11,6459044028
9087,275905980,311892,276217872,36,0,0,4096,36,6388975484
9088,275910024,404418,276314442,27,0,0,51200,27,7165847077
9089,275910768,325497,276236265,33,0,0,17408,33,2731674652
9090,275925525,542770,276468295,36,0,0,11264,36,2270221369
9091,275958612,426415,276385027,10,0,0,512,10,4709055354
9092,275962753,258254,276221007,33,0,0,10240,33,7084019799
9093,275963514,361121,276324635,11,0,0,10752,11,10347862627
9094,276012348,265503,276277851,5,0,0,2048,5,6019991413
9095,276034882,566,276035448,10,0,1,512,10,7842457692
9096,276034959,209356,276244315,30,0,0,1536,30,533793109
9097,276038685,375202,276413887,30,0,0,51712,30,2897641551
9098,276063237,38116,276101353,9,0,1,7168,9,3270438435
9099,276076584,270047,276346631,33,0,0,35840,33,10510896066
9100,276078537,557623,276636160,30,0,0,24576,30,2755968065
9101,276090327,208500,276298827,39,0,0,19968,39,8679475216
9102,276097350,347068,276444418,25,0,0,45056,25,9186682073
9103,276103700,276617,276380317,35,0,0,512,35,7369181636
9104,276103934,469417,276573351,22,0,0,87040,22,1350901902
9105,276104291,10015,276114306,32,0,1,6144,32,879861198
9106,276105064,270231,276375295,15,0,0,10752,15,2636775999
9107,276114391,1042,276115433,12,0,1,1024,12,1016006298
9108,276130865,1042,276131907,0,0,1,1024,0,7663048567
9109,276141723,26488,276168211,13,0,1,16896,13,5026563285
9110,276167284,149825,276317109,6,0,0,8704,6,29022728
9111,276172889,242242,276415131,31,0,0,3584,31,2246196069
9112,276174153,654967,276829120,0,0,0,50688,0,8378993456
9113,276177089,19741,276196830,37,0,1,27136,37,5937978594
9114,276188509,27255,276215764,24,0,1,7680,24,4480069769
9115,276205167,312692,276517859,35,0,0,1024,35,3880537235
9116,276225659,3387,276229046,20,0,1,9728,20,4669212028
9117,276236179,257494,276493673,15,0,0,6656,15,7017686380
9118,276274353,306033,276580386,15,0,0,23040,15,8255082029
9119,276308861,87265,276396126,2,0,1,115712,2,10215602668
9120,276315914,130004,276445918,0,0,0,4608,0,2908553927
9121,276322904,301935,276624839,10,0,0,8192,10,5879289893
9122,276328973,390373,276719346,32,0,0,10752,32,3013619063
9123,276351924,257022,276608946,32,0,0,22016,32,6107913889
9124,276358416,55486,276413902,8,0,1,4096,8,6328161923
9125,276364867,171117,276535984,36,0,0,11264,36,8805604376
9126,276366710,301154,276667864,37,0,0,14336,37,5929766295
9127,276406879,463833,276870712,34,0,0,6144,34,3994578042
9128,276411598,317064,276728662,24,0,0,512,24,1604857405
9129,276417735,2946,276420681,31,0,1,3072,31,7980656156
9130,276424937,368639,276793576,2,0,0,46080,2,8238467624
9131,276442910,240441,276683351,14,0,0,38912,14,6320369420
9132,276447998,1518,276449516,33,0,1,1536,33,5490493629
9133,276460196,2870,276463066,31,0,1,8704,31,2361483238
9134,276472053,180717,276652770,2,0,0,6144,2,5602272113
9135,276500167,356928,276857095,36,0,0,29696,36,1494795675
9136,276518567,255300,276773867,2,0,0,32256,2,1029051781
9137,276532544,162796,276695340,29,0,0,3584,29,8618121589
9138,276557542,305808,276863350,21,0,0,20480,21,9106058990
9139,276557654,359036,276916690,33,0,0,14336,33,7820091189
9140,276576908,309887,276886795,1,0,0,52736,1,4193910335
9141,276580918,399323,276980241,12,0,0,71168,12,576893808
9142,276607322,280861,276888183,0,0,0,2048,0,3361012879
9143,276633687,267297,276900984,22,0,0,15872,22,5107608814
9144,276667018,201807,276868825,35,0,0,17920,35,1282976104
9145,276699651,359054,277058705,17,0,1,585728,17,4258238516
9146,276700795,582202,277282997,7,0,0,76800,7,8571039125
9147,276702438,459829,277162267,10,0,0,8704,10,44969478
9148,276720447,338924,277059371,13,0,1,1024,13,1274125977
9149,276733426,331744,277065170,24,0,1,19456,24,9027978094
9150,276778956,697840,277476796,35,0,0,14848,35,53080461
9151,276789198,243422,277032620,0,0,0,3584,0,3869375078
9152,276793125,752382,277545507,37,0,0,6656,37,9210538417
9153,276794009,271622,277065631,2,0,1,10240,2,10549175965
9154,276799554,300811,277100365,22,0,0,25088,22,3178294684
9155,276814571,256757,277071328,33,0,1,18944,33,3608385800
9156,276821668,234355,277056023,22,0,0,8192,22,2855634780
9157,276826061,244773,277070834,24,0,0,4096,24,2630098703
9158,276845287,257607,277102894,6,0,1,101888,6,10305021420
9159,276854947,248818,277103765,21,0,1,12288,21,9017095436
9160,276858623,588225,277446848,32,0,0,43520,32,4297339394
9161,276860676,347128,277207804,4,0,0,37888,4,4905794747
9162,276867558,236553,277104111,0,0,1,512,0,5568359629
9163,276869023,444131,277313154,21,0,0,40960,21,10325886467
9164,276873618,351350,277224968,20,0,0,45056,20,9387075631
9165,276880032,173480,277053512,12,0,0,18944,12,9834056725
9166,276904536,638928,277543464,6,0,0,32256,6,9347943431
9167,276912436,200589,277113025,39,0,0,6144,39,6214075819
9168,276925169,180248,277105417,19,0,1,2048,19,6122232547
9169,276928363,177208,277105571,28,0,1,8704,28,1458918574
9170,276941398,658064,277599462,20,0,0,14848,20,3828941068
9171,276945726,160101,277105827,7,0,1,9216,7,5912439041
9172,276946885,744208,277691093,24,0,0,124928,24,8170401051
9173,276953383,154070,277107453,10,0,1,2560,10,7395006204
9174,276963165,144852,277108017,18,0,1,10752,18,2035734557
9175,276980074,303406,277283480,29,0,0,1536,29,3481995166
9176,276987233,589376,277576609,2,0,0,83968,2,9754296442
9177,276997705,435868,277433573,28,0,0,41472,28,217215056
9178,276999237,952432,277951669,10,0,0,48128,10,6793157378
9179,277005260,219895,277225155,31,0,0,512,31,7862910452
9180,277017810,95230,277113040,31,0,1,5632,31,4589618303
9181,277044769,341453,277386222,21,0,0,16384,21,4280365301
9182,277065845,396040,277461885,5,0,0,12800,5,6215068881
9183,277066476,778378,277844854,32,0,0,109568,32,9402135607
9184,277080381,35048,277115429,10,0,1,6144,10,124771255
9185,277082664,374191,277456855,36,0,0,32768,36,1257870190
9186,277091770,25605,277117375,25,0,1,3072,25,3939032702
9187,277096826,21010,277117836,2,0,1,10240,2,6549814366
9188,277118065,10499,277128564,2,0,1,16896,2,9963218760
9189,277154289,761611,277915900,8,0,0,6656,8,2857978100
9190,277159224,4850,277164074,11,0,1,5120,11,715073868
9191,277163726,2946,277166672,21,0,1,3072,21,8473312527
9192,277171185,423714,277594899,39,0,0,17920,39,9195381578
9193,277192935,265035,277457970,29,0,0,3584,29,8565382957
9194,277200367,877124,278077491,33,0,0,98304,33,903761953
9195,277219366,64137,277283503,6,0,1,91136,6,3506597798
9196,277219959,369457,277589416,37,0,0,41984,37,1600221724
9197,277222322,61716,277284038,39,0,1,8192,39,1916478369
9198,277256426,606243,277862669,32,0,0,58368,32,7504364492
9199,277265251,430693,277695944,2,0,0,15872,2,54762320
9200,277283221,496354,277779575,5,0,0,20992,5,4050904988
9201,277291145,237841,277528986,26,0,0,4608,26,7964964331
9202,277308463,292433,277600896,5,0,0,2560,5,7766115546
9203,277323510,613480,277936990,5,0,0,43520,5,3625240986
9204,277366503,680998,278047501,8,0,0,33280,8,3962775637
9205,277378416,545299,277923715,34,0,0,25600,34,169595298
9206,277379774,638780,278018554,28,0,0,1024,28,6485475180
9207,277399530,707149,278106679,7,0,0,24576,7,2434867087
9208,277429654,707460,278137114,10,0,0,99840,10,10506009039
9209,277444472,511112,277955584,32,0,0,12800,32,404383315
9210,277468119,728788,278196907,10,0,0,7680,10,6419483477
9211,277470484,628692,278099176,35,0,0,22528,35,4068681318
9212,277482672,10757,277493429,8,0,1,17408,8,7559169158
9213,277495014,512170,278007184,4,0,0,40448,4,3749658386
9214,277495056,699496,278194552,5,0,0,109568,5,7944384875
9215,277501299,760406,278261705,8,0,0,41984,8,3075210702
9216,277573393,632733,278206126,38,0,0,30208,38,7244736492
9217,277577093,29132,277606225,39,0,1,7168,39,4575673446
9218,277579783,32629,277612412,19,0,1,17408,19,9714068336
9219,277580051,148831,277728882,11,0,0,3072,11,10382893794
9220,277584239,409893,277994132,39,0,0,5632,39,9869958340
9221,277594861,442485,278037346,34,0,0,12288,34,4956961872
9222,277596401,640252,278236653,14,0,0,47616,14,2987565916
9223,277633218,729740,278362958,22,0,0,89600,22,3091499231
9224,277637246,448576,278085822,19,0,0,27136,19,9536954729
9225,277674966,27290,277702256,37,0,1,6656,37,6824525022
9226,277684651,827285,278511936,10,0,0,30208,10,1528490234
9227,277686850,648793,278335643,8,0,0,46592,8,7474534368
9228,277701705,3898,277705603,10,0,1,4096,10,1299499058
9229,277726430,483314,278209744,9,0,0,10752,9,8524864905
9230,277729707,751848,278481555,30,0,0,20992,30,7735537501
9231,277735308,243561,277978869,33,0,0,20480,33,642193791
9232,277749821,1042,277750863,4,0,1,1024,4,8617073632
9233,277766177,440276,278206453,8,0,0,1024,8,8046742134
9234,277776052,6902,277782954,39,0,1,9728,39,6746947251
9235,277788099,652395,278440494,19,0,0,33792,19,4099573521
9236,277807641,682906,278490547,37,0,0,29184,37,2232591499
9237,277817303,65691,277882994,37,0,1,32768,37,10671959841
9238,277821409,476689,278298098,14,0,0,44544,14,681982769
9239,277846739,517120,278363859,27,0,0,2560,27,5927868556
9240,277861055,748618,278609673,0,0,0,42496,0,7837203080
9241,277872766,15374,277888140,9,0,1,8192,9,3695637527
9242,277874009,601135,278475144,19,0,0,4096,19,5040449331
9243,277891033,562866,278453899,10,0,0,9728,10,6734442884
9244,277961796,456234,278418030,37,0,0,25600,37,3355836692
9245,278007182,270432,278277614,36,0,0,14336,36,2810231969
9246,278022056,25460,278047516,6,0,1,24064,6,471655403
9247,278037532,540898,278578430,25,0,0,4096,25,3407419766
9248,278040448,665159,278705607,29,0,0,53760,29,9791156024
9249,278040507,453799,278494306,27,0,0,12288,27,4912598341
9250,278052803,624000,278676803,7,0,0,8704,7,1394119261
9251,278054404,308569,278362973,17,0,1,393728,17,8317390542
9252,278063956,299032,278362988,13,0,1,7680,13,5878754444
9253,278064283,565879,278630162,5,0,0,39936,5,2666200506
9254,278075298,322644,278397942,2,0,0,24064,2,443984933
9255,278113176,662900,278776076,29,0,0,31744,29,1036959806
9256,278129789,339043,278468832,11,0,0,33792,11,10231651299
9257,278135813,400288,278536101,6,0,0,9728,6,780102284
9258,278145510,387612,278533122,17,0,0,11776,17,6622279200
9259,278159718,203285,278363003,23,0,1,512,23,2456436997
9260,278187654,175364,278363018,38,0,1,6656,38,10017634062
9261,278206939,365387,278572326,38,0,0,19456,38,2003106358
9262,278252741,110300,278363041,4,0,1,2560,4,7034825567
9263,278254468,561449,278815917,4,0,0,51712,4,9290065742
9264,278259503,181326,278440829,8,0,0,1024,8,8027784666
9265,278280828,274086,278554914,34,0,0,7680,34,6812392234
9266,278286172,76884,278363056,2,0,1,1024,2,557632889
9267,278297560,84795,278382355,30,0,1,133120,30,2788217984
9268,278320835,511812,278832647,14,0,0,13824,14,7375540561
9269,278354561,328113,278682674,21,0,0,11264,21,5117887215
9270,278358294,258414,278616708,25,0,0,23040,25,8140677088
9271,278372506,245465,278617971,15,0,0,4096,15,8571518398
9272,278379467,7394,278386861,7,0,1,7168,7,9642395618
9273,278390351,7606,278397957,0,0,1,14336,0,8554883237
9274,278432912,359355,278792267,32,0,0,9728,32,7206229662
9275,278460159,285002,278745161,20,0,0,27648,20,3907467664
9276,278494478,384438,278878916,26,0,0,7168,26,4898392581
9277,278502972,16679,278519651,31,0,1,8192,31,3516131757
9278,278511695,407028,278918723,20,0,0,4096,20,963298210
9279,278542550,35895,278578445,17,0,1,60928,17,3820429122
9280,278552074,506291,279058365,0,0,0,23040,0,4894711309
9281,278554539,211842,278766381,15,0,0,15360,15,9319263033
9282,278567395,11256,278578651,32,0,1,2048,32,1357185078
9283,278604324,345620,278949944,14,0,0,32256,14,7165256811
9284,278615061,509043,279124104,14,0,0,4096,14,5521071958
9285,278623381,278975,278902356,5,0,0,10240,5,1750514782
9286,278624126,7137,278631263,13,0,1,1024,13,1392018697
9287,278628897,371753,279000650,25,0,0,17408,25,10353123586
9288,278631033,193479,278824512,8,0,0,28160,8,7404357983
9289,278633872,264403,278898275,37,0,0,63488,37,9822824185
9290,278680513,5540,278686053,2,0,1,9728,2,10549027650
9291,278690738,214441,278905179,38,0,0,9216,38,9839739211
9292,278718593,294396,279012989,38,0,0,40448,38,5515139879
9293,278724769,207934,278932703,13,0,0,4608,13,1358259368
9294,278728946,397294,279126240,21,0,0,1024,21,7360310849
9295,278737133,456936,279194069,4,0,0,134144,4,1271680480
9296,278746140,448576,279194716,4,0,0,2048,4,8439562042
9297,278762503,25581,278788084,31,0,1,19968,31,6938176401
9298,278780136,251412,279031548,9,0,0,4096,9,4502931254
9299,278784584,252595,279037179,8,0,0,18432,8,3941058529
9300,278785718,6564,278792282,32,0,1,11264,32,6446938120
9301,278785850,282424,279068274,1,0,0,17920,1,7906598013
9302,278814590,255883,279070473,25,0,0,7168,25,5872563399
9303,278863499,485944,279349443,14,0,0,48640,14,4465099331
9304,278882986,318321,279201307,39,0,0,21504,39,3085016703
9305,278890616,574587,279465203,20,0,0,14336,20,9171373159
9306,278891522,228601,279120123,4,0,0,17920,4,8142618356
9307,278897333,477162,279374495,20,0,0,512,20,1195627339
9308,278904147,5703,278909850,9,0,1,12288,9,609241721
9309,278915886,418706,279334592,30,0,0,12288,30,4967381582
9310,278921553,11165,278932718,39,0,1,17920,39,488257893
9311,278924286,292644,279216930,14,0,0,29696,14,4572605853
9312,278960795,13083,278973878,33,0,1,22016,33,2939071727
9313,278985454,345379,279330833,1,0,0,132096,1,7466969140
9314,279006152,10251,279016403,38,0,1,3584,38,1972196268
9315,279014116,5193,279019309,18,0,1,4608,18,9102564054
9316,279037884,5802,279043686,18,0,1,6144,18,6984541091
9317,279041882,6278,279048160,37,0,1,6656,37,2829529003
9318,279059499,513066,279572565,9,0,0,19456,9,1523047301
9319,279069993,311924,279381917,8,0,0,16896,8,1757589411
9320,279078436,5712,279084148,13,0,1,14336,13,3758482304
9321,279107244,5971,279113215,1,0,1,14848,1,5569346311
9322,279118326,322944,279441270,36,0,0,7168,36,4567505496
9323,279121600,252686,279374286,24,0,0,81408,24,10733590150
9324,279124829,327307,279452136,11,0,0,3072,11,7860331946
9325,279135296,467463,279602759,29,0,0,17920,29,2407355323
9326,279137393,306619,279444012,6,0,0,6656,6,10044120742
9327,279141579,4374,279145953,7,0,1,4608,7,9613229361
9328,279143340,7119,279150459,38,0,1,7168,38,10600445912
9329,279153285,356790,279510075,32,0,0,31744,32,1522576299
9330,279161266,277113,279438379,36,0,0,1024,36,3650060819
9331,279165382,376476,279541858,34,0,0,15872,34,3725156874
9332,279169954,32855,279202809,7,0,1,1536,7,718742984
9333,279182486,378747,279561233,15,0,0,48128,15,10280528893
9334,279196743,6732,279203475,9,0,1,1024,9,5613095208
9335,279203535,13410,279216945,12,0,1,7680,12,4916426562
9336,279219081,361642,279580723,21,0,0,26624,21,6423020234
9337,279227863,518928,279746791,35,0,0,19968,35,8319649650
9338,279244522,240697,279485219,6,0,0,26624,6,504366911
9339,279271414,132782,279404196,4,0,0,1024,4,2639211497
9340,279272559,7706,279280265,9,0,1,8192,9,7134672946
9341,279304291,70010,279374301,4,0,1,2560,4,5050321083
9342,279304378,69938,279374316,13,0,1,14848,13,3420865153
9343,279318730,225335,279544065,32,0,0,7168,32,1276207147
9344,279357078,238133,279595211,1,0,0,13312,1,4023326628
9345,279373202,482034,279855236,4,0,0,59904,4,4982579476
9346,279391403,283261,279674664,29,0,0,25600,29,10199753061
9347,279397958,13770,279411728,11,0,1,26624,11,7113890293
9348,279409039,234310,279643349,31,0,0,18944,31,1727976883
9349,279413693,2946,279416639,12,0,1,3072,12,8283494310
9350,279428901,328036,279756937,24,0,0,10240,24,2805919273
9351,279431307,356247,279787554,21,0,0,82432,21,3176263892
9352,279435315,5970,279441285,11,0,1,13312,11,5763699677
9353,279456171,9047,279465218,26,0,1,7168,26,6599360490
9354,279474540,10710,279485250,15,0,1,7168,15,7341791289
9355,279477606,243455,279721061,1,0,0,34816,1,6929976419
9356,279481016,174153,279655169,38,0,0,17408,38,9409620916
9357,279496330,420950,279917280,11,0,0,28160,11,9202062181
9358,279498205,399239,279897444,27,0,0,24064,27,9453704521
9359,279498694,11420,279510114,12,0,1,16896,12,8425486595
9360,279500248,13767,279514015,39,0,1,4096,39,9205949475
9361,279501295,13457,279514752,13,0,1,9728,13,662777112
9362,279503487,353168,279856655,11,0,0,4608,11,521069687
9363,279511432,6074,279517506,11,0,1,9216,11,10388835480
9364,279536730,7358,279544088,9,0,1,6656,9,565852055
9365,279538852,5738,279544590,9,0,1,512,9,8549829199
9366,279554869,167611,279722480,12,0,0,4608,12,6600791815
9367,279555955,16625,279572580,32,0,1,6656,32,3998631530
9368,279556770,23984,279580754,16,0,1,17920,16,9074592931
9369,279564413,22071,279586484,12,0,1,6144,12,388304091
9370,279565839,235146,279800985,17,0,0,44032,17,6733339840
9371,279573253,14217,279587470,28,0,1,1536,28,2745063671
9372,279592344,472231,280064575,36,0,0,77312,36,8319718982
9373,279603717,739387,280343104,10,0,0,46592,10,6212937785
9374,279608349,412089,280020438,2,0,0,73728,2,3164041698
9375,279615747,253678,279869425,37,0,0,39424,37,3378228742
9376,279629075,3128,279632203,37,0,1,9216,37,3381086026
9377,279642795,306904,279949699,35,0,0,11264,35,5056697208
9378,279649829,12529,279662358,32,0,1,7680,32,2565441617
9379,279661235,213205,279874440,20,0,0,16384,20,8587791056
9380,279664111,431513,280095624,3,0,0,16896,3,2599421508
9381,279694762,301317,279996079,30,0,0,3072,30,2403941923
9382,279701632,1042,279702674,9,0,1,1024,9,7404697900
9383,279710021,12474,279722495,11,0,1,6656,11,983412165
9384,279717532,11226,279728758,16,0,1,15360,16,413328116
9385,279721270,88239,279809509,9,0,0,4096,9,3025417260
9386,279722072,235953,279958025,17,0,0,24576,17,8056104119
9387,279739579,7227,279746806,26,0,1,4096,26,3928477694
9388,279754884,314090,280068974,10,0,0,14336,10,1140962102
9389,279806812,215373,280022185,3,0,0,5632,3,6107915196
9390,279821316,12737,279834053,20,0,1,24576,20,5232208682
9391,279848828,574330,280423158,31,0,0,105472,31,4691827137
9392,279859571,293172,280152743,36,0,0,25088,36,2207508187
9393,279883974,421776,280305750,31,0,0,63488,31,7793070935
9394,279891946,496425,280388371,31,0,0,8192,31,8847248499
9395,279894162,434715,280328877,13,0,0,75776,13,8351066055
9396,279923310,363081,280286391,5,0,0,49664,5,3453785513
9397,279932401,552431,280484832,0,0,0,49664,0,8633857257
9398,279936842,7706,279944548,1,0,1,8192,1,4847355274
9399,279937465,7749,279945214,2,0,1,1024,2,9783924143
9400,279941309,520447,280461756,19,0,0,9216,19,9973485801
9401,279955987,395446,280351433,37,0,0,24064,37,10122269349
9402,279966717,469746,280436463,39,0,0,2048,39,1922217065
9403,280002148,242764,280244912,14,0,0,1536,14,1904994145
9404,280013606,257638,280271244,7,0,0,46592,7,4729494773
9405,280041229,519587,280560816,3,0,0,137728,3,10172555947
9406,280041847,188361,280230208,6,0,0,7680,6,5159996816
9407,280047831,581277,280629108,7,0,0,23552,7,3486876508
9408,280057859,443825,280501684,33,0,0,46592,33,4506503371
9409,280069132,4850,280073982,18,0,1,5120,18,8597948161
9410,280074431,361393,280435824,33,0,0,14848,33,8077780952
9411,280085595,14804,280100399,2,0,1,28672,2,1159753956
9412,280094681,249390,280344071,29,0,0,3072,29,8775032074
9413,280113405,338379,280451784,14,0,0,11776,14,1159163974
9414,280114452,446715,280561167,34,0,0,1024,34,1620212559
9415,280119803,630230,280750033,9,0,0,10240,9,9296706157
9416,280120480,240799,280361279,35,0,0,13824,35,4822973581
9417,280156352,358295,280514647,30,0,0,42496,30,10160916539
9418,280197992,4850,280202842,20,0,1,5120,20,5585236045
9419,280203619,7706,280211325,7,0,1,8192,7,1935677511
9420,280209180,507181,280716361,27,0,0,27648,27,1642765934
9421,280223772,215225,280438997,24,0,0,8192,24,6782775080
9422,280236726,385191,280621917,27,0,0,17408,27,2845589575
9423,280246908,448177,280695085,0,0,0,23552,0,7629351810
9424,280256692,473235,280729927,14,0,0,10752,14,9994246544
9425,280279092,368298,280647390,3,0,0,36352,3,8041706938
9426,280279478,64608,280344086,9,0,1,512,9,7962645989
9427,280287398,361411,280648809,6,0,0,4608,6,9987386471
9428,280304296,261098,280565394,32,0,0,13824,32,2863204888
9429,280309890,45922,280355812,35,0,1,11776,35,5428551826
9430,280311103,325196,280636299,26,0,0,23552,26,5873239173
9431,280347229,18558,280365787,11,0,1,17408,11,9156216401
9432,280349249,575459,280924708,14,0,0,25600,14,5089340619
9433,280358138,12155,280370293,8,0,1,7168,8,7048091472
9434,280372004,438461,280810465,10,0,0,27136,10,9134991283
9435,280390809,317113,280707922,14,0,0,19968,14,9101079518
9436,280401913,514980,280916893,8,0,0,5632,8,3363949510
9437,280412445,259773,280672218,33,0,0,37376,33,2362848858
9438,280427611,8867,280436478,10,0,1,6144,10,663110282
9439,280434536,152401,280586937,33,0,0,10240,33,7787452091
9440,280445832,255991,280701823,13,0,0,17408,13,4721548042
9441,280449296,538086,280987382,7,0,0,59904,7,8076672709
9442,280451714,209101,280660815,33,0,0,34816,33,4768439232
9443,280459634,189666,280649300,29,0,0,1536,29,496983368
9444,280461772,7723,280469495,26,0,1,8192,26,6047018868
9445,280463776,267951,280731727,1,0,0,1536,1,2584911497
9446,280507219,407912,280915131,31,0,0,98816,31,1466758247
9447,280523435,262670,280786105,19,0,0,7680,19,2504007413
9448,280546534,291378,280837912,35,0,0,8192,35,3124896013
9449,280547016,404894,280951910,33,0,0,2560,33,8715778878
9450,280565729,14804,280580533,23,0,1,28672,23,6452214967
9451,280576376,120128,280696504,33,0,0,4608,33,8494968633
9452,280606155,2470,280608625,27,0,1,2560,27,899439717
9453,280634961,376663,281011624,16,0,0,36864,16,1620849928
9454,280643821,187648,280831469,21,0,0,13824,21,3007029567
9455,280655561,17708,280673269,3,0,1,1024,3,9226910202
9456,280656167,272768,280928935,13,0,0,13824,13,5495810307
9457,280718558,295125,281013683,4,0,0,6656,4,7411597682
9458,280730481,373270,281103751,10,0,0,41472,10,10204125256
9459,280740903,192585,280933488,31,0,0,6656,31,3020744327
9460,280773996,261623,281035619,30,0,0,37376,30,5289004065
9461,280785580,431704,281217284,7,0,0,29696,7,7915753689
9462,280803417,257357,281060774,29,0,0,6144,29,4761926628
9463,280806893,193452,281000345,5,0,0,42496,5,4660707115
9464,280820274,257358,281077632,10,0,0,11264,10,10020384926
9465,280841850,279308,281121158,4,0,0,43008,4,534468296
9466,280864846,177590,281042436,33,0,0,6656,33,2539571872
9467,280870032,336396,281206428,8,0,0,13312,8,2527679900
9468,280884763,30383,280915146,0,0,1,1536,0,7995592518
9469,280886531,259759,281146290,26,0,0,23040,26,3940556936
9470,280893739,130477,281024216,36,0,0,13312,36,3386024920
9471,280934143,239671,281173814,10,0,0,27136,10,5472542311
9472,280955141,403478,281358619,12,0,0,39424,12,10130868305
9473,280962261,3645,280965906,8,0,1,10240,8,10718343549
9474,280983880,359088,281342968,5,0,0,44032,5,6769597569
9475,280984604,32781,281017385,16,0,1,6144,16,2458854938
9476,280988487,300832,281289319,18,0,0,15872,18,4641378724
9477,280989459,197732,281187191,19,0,0,23552,19,10176474343
9478,281005062,273866,281278928,29,0,0,15872,29,9800644698
9479,281043704,566,281044270,9,0,1,512,9,8941351983
9480,281060151,239962,281300113,31,0,0,22528,31,7860883218
9481,281066222,431532,281497754,22,0,0,33280,22,6446373480
9482,281082408,143369,281225777,24,0,0,23040,24,8415523856
9483,281082624,23895,281106519,6,0,1,43008,6,15096827
9484,281086090,21040,281107130,8,0,1,9728,8,5578583705
9485,281133395,5802,281139197,31,0,1,6144,31,1401104311
9486,281136606,262845,281399451,35,0,0,28160,35,4430990516
9487,281138670,426599,281565269,21,0,0,59392,21,8230812811
9488,281159673,411071,281570744,20,0,0,17920,20,2553048369
9489,281166488,142285,281308773,38,0,0,24064,38,1963180236
9490,281185255,254942,281440197,13,0,0,29696,13,4698565618
9491,281230320,271977,281502297,26,0,0,6656,26,2735927535
9492,281231177,295750,281526927,17,0,0,10752,17,7869660106
9493,281232131,1042,281233173,37,0,1,1024,37,7794179541
9494,281247260,112014,281359274,1,0,0,2048,1,10125313636
9495,281250930,255764,281506694,30,0,0,7168,30,4031281843
9496,281263606,1042,281264648,32,0,1,1024,32,6440287984
9497,281264456,361047,281625503,6,0,0,47104,6,2496111130
9498,281274691,358625,281633316,28,0,0,6656,28,5766736497
9499,281323216,19767,281342983,13,0,1,17920,13,5295433613
9500,281347974,321627,281669601,4,0,0,15360,4,7514835574
9501,281352511,244152,281596663,21,0,0,84992,21,8934029984
9502,281361526,349958,281711484,12,0,0,101888,12,1768361506
9503,281363890,5326,281369216,28,0,1,5632,28,2424904333
9504,281370472,3898,281374370,19,0,1,4096,19,3894678603
9505,281372748,467345,281840093,28,0,0,30720,28,2847749619
9506,281373394,226412,281599806,20,0,0,10240,20,8638837577
9507,281387472,213620,281601092,21,0,0,4096,21,1964007517
9508,281393936,326564,281720500,27,0,0,7168,27,5615674962
9509,281406973,331149,281738122,14,0,0,20992,14,958812934
9510,281417284,3898,281421182,24,0,1,4096,24,2460187336
9511,281426855,1994,281428849,8,0,1,2048,8,6932257980
9512,281432019,167810,281599829,17,0,1,227328,17,5446029417
9513,281434792,176344,281611136,29,0,0,32768,29,10582317658
9514,281442582,651070,282093652,15,0,0,24064,15,6871523646
9515,281442877,158230,281601107,20,0,1,6656,20,5609753400
9516,281443243,617845,282061088,8,0,0,47616,8,8613669850
9517,281460971,641588,282102559,21,0,0,29184,21,139510237
9518,281461941,329138,281791079,27,0,0,2048,27,7972112651
9519,281462946,346551,281809497,13,0,0,1536,13,3059711412
9520,281508479,92643,281601122,21,0,1,4096,21,6324042868
9521,281513226,438193,281951419,22,0,0,39424,22,661584708
9522,281514457,486771,282001228,7,0,0,41472,7,3335783852
9523,281536730,223183,281759913,38,0,0,7680,38,7731282614
9524,281536980,319299,281856279,32,0,0,12800,32,6515360686
9525,281537616,477299,282014915,36,0,0,20480,36,6312998114
9526,281538562,62575,281601137,17,0,1,6656,17,463933235
9527,281541561,300546,281842107,9,0,0,4096,9,6442700228
9528,281550012,528749,282078761,34,0,0,40448,34,5680773752
9529,281554995,407048,281962043,0,0,0,21504,0,9333051659
9530,281576596,61949,281638545,33,0,1,22016,33,1384217888
9531,281605795,37576,281643371,1,0,1,7680,1,650101104
9532,281618111,26246,281644357,4,0,1,1536,4,10615524112
9533,281625355,441067,282066422,1,0,0,7680,1,5157740570
9534,281629461,19082,281648543,28,0,1,6656,28,7228024694
9535,281652125,196108,281848233,6,0,1,318464,6,1393939138
9536,281662983,401084,282064067,3,0,0,9728,3,5816062738
9537,281672589,437237,282109826,9,0,0,512,9,8055845107
9538,281678040,635157,282313197,26,0,0,148992,26,1846460422
9539,281684863,1013339,282698202,15,0,0,3072,15,7877770215
9540,281700055,150764,281850819,4,0,1,4096,4,483362150
9541,281704649,173936,281878585,3,0,0,8192,3,2020259649
9542,281722831,360121,282082952,2,0,0,9216,2,1143526632
9543,281726252,320313,282046565,38,0,0,55808,38,5386292404
9544,281747056,469696,282216752,8,0,0,29184,8,6722577687
9545,281754109,566591,282320700,2,0,0,24576,2,9908362257
9546,281791162,611890,282403052,12,0,0,11776,12,5247044315
9547,281817024,734546,282551570,24,0,0,34304,24,3914699200
9548,281825305,310083,282135388,8,0,0,14848,8,203772479
9549,281832167,333516,282165683,3,0,0,30208,3,6617505447
9550,281867730,497398,282365128,15,0,0,32256,15,9846779408
9551,281872229,335616,282207845,7,0,0,12288,7,6501592662
9552,281901587,472634,282374221,34,0,0,13824,34,6370756491
9553,281903723,294659,282198382,12,0,0,4608,12,7806786228
9554,281920163,5326,281925489,21,0,1,5632,21,10173016127
9555,281949716,379743,282329459,26,0,0,28672,26,3890803518
9556,281988913,427924,282416837,0,0,0,38400,0,534292464
9557,282014891,794119,282809010,11,0,0,67072,11,391521429
9558,282015777,339484,282355261,32,0,0,66560,32,965798550
9559,282020955,3898,282024853,1,0,1,4096,1,9987580008
9560,282021510,347065,282368575,31,0,0,11264,31,5024636967
9561,282023724,222322,282246046,32,0,0,14848,32,5365803679
9562,282062392,460566,282522958,33,0,0,30720,33,9380304590
9563,282078343,256623,282334966,19,0,0,17920,19,1062805079
9564,282078637,552083,282630720,15,0,0,73728,15,851743431
9565,282106520,282230,282388750,31,0,0,7680,31,4445449087
9566,282107175,82792,282189967,30,0,0,7168,30,3293176457
9567,282111869,522298,282634167,4,0,0,11264,4,7248193262
9568,282126666,430691,282557357,19,0,0,18944,19,267040472
9569,282133096,130533,282263629,20,0,0,3584,20,7823681160
9570,282136742,6488,282143230,33,0,1,15872,33,4837423336
9571,282152872,12826,282165698,9,0,1,8192,9,9391945604
9572,282182391,814205,282996596,19,0,0,38400,19,4502130379
9573,282213935,325871,282539806,30,0,0,20480,30,6854247184
9574,282219248,503301,282722549,22,0,0,10752,22,4421796360
9575,282227697,269417,282497114,15,0,0,16896,15,4864757199
9576,282240521,429980,282670501,19,0,0,8192,19,7250495021
9577,282258951,111043,282369994,36,0,0,4608,36,6252333923
9578,282286304,170996,282457300,20,0,0,9728,20,7554709636
9579,282300048,74188,282374236,28,0,1,21504,28,10349368152
9580,282317590,56661,282374251,17,0,1,4096,17,5428024044
9581,282317750,240558,282558308,38,0,0,3072,38,9502367965
9582,282320224,512076,282832300,39,0,0,71680,39,8134976851
9583,282324820,415373,282740193,12,0,0,23552,12,8285023795
9584,282373396,289964,282663360,29,0,0,90112,29,7167533855
9585,282394050,196358,282590408,3,0,0,44544,3,5355964754
9586,282406245,14975,282421220,23,0,1,4608,23,4544627039
9587,282409653,360462,282770115,10,0,0,9728,10,2910229366
9588,282420890,599011,283019901,19,0,0,59904,19,7653682684
9589,282476886,5326,282482212,21,0,1,5632,21,6741270781
9590,282489369,349857,282839226,20,0,0,22528,20,4957285451
9591,282502234,363221,282865455,11,0,0,28672,11,7519447111
9592,282508282,302147,282810429,22,0,0,4608,22,10312583452
9593,282513411,157417,282670828,9,0,0,1024,9,9535060480
9594,282528670,566,282529236,4,0,1,512,4,4556673926
9595,282531392,316686,282848078,1,0,0,17920,1,2391614234
9596,282534113,376831,282910944,3,0,0,47616,3,8979289820
9597,282557023,424826,282981849,31,0,0,35840,31,9725140546
9598,282575110,15321,282590431,24,0,1,16896,24,10207859911
9599,282581011,15191,282596202,32,0,1,6144,32,10146404726
9600,282598700,574597,283173297,21,0,0,1536,21,1265426283
9601,282599873,290560,282890433,3,0,0,45568,3,9416320813
9602,282625290,231383,282856673,0,0,0,28160,0,7241105597
9603,282626411,120349,282746760,28,0,0,21504,28,8513863315
9604,282629497,456882,283086379,26,0,0,13312,26,8468871199
9605,282644594,804429,283449023,24,0,0,78336,24,2292839131
9606,282648035,552842,283200877,19,0,0,19968,19,9902161183
9607,282662808,414830,283077638,34,0,0,51200,34,2154355123
9608,282679518,302814,282982332,26,0,0,1536,26,9192550447
9609,282680194,4374,282684568,1,0,1,4608,1,9582956674
9610,282714586,65392,282779978,37,0,0,6144,37,10349763483
9611,282730373,195419,282925792,30,0,0,2560,30,10544162893
9612,282771348,252312,283023660,13,0,0,12288,13,9425364990
9613,282782017,50306,282832323,8,0,1,48640,8,4488081294
9614,282783066,511593,283294659,37,0,0,12288,37,2019921428
9615,282799472,39809,282839281,20,0,1,12800,20,2085363803
9616,282807035,32766,282839801,37,0,1,512,37,1678695065
9617,282822666,19195,282841861,32,0,1,2560,32,8505331249
9618,282822899,206392,283029291,27,0,0,18432,27,7487831705
9619,282828217,89583,282917800,5,0,0,1536,5,42823246
9620,282831910,24786,282856696,2,0,1,8192,2,9480308296
9621,282834443,284463,283118906,39,0,0,40448,39,2484325731
9622,282838179,548121,283386300,9,0,0,22528,9,5673665790
9623,282845878,274915,283120793,34,0,0,6144,34,9681658953
9624,282848546,298002,283146548,16,0,0,84480,16,10455797562
9625,282860327,288607,283148934,28,0,0,2560,28,4316767132
9626,282860663,7279,282867942,12,0,1,2560,12,3820873682
9627,282871075,4374,282875449,26,0,1,4608,26,9869181239
9628,282888360,412912,283301272,38,0,0,15360,38,1014244816
9629,282899965,17266,282917231,11,0,1,6656,11,2428178848
9630,282903716,370087,283273803,8,0,0,103424,8,10022789052
9631,282919837,362257,283282094,30,0,0,27136,30,313554941
9632,282941653,277634,283219287,27,0,0,16896,27,7002302157
9633,282960619,499662,283460281,4,0,0,32256,4,10688034307
9634,282964289,183850,283148139,9,0,0,5120,9,6365301691
9635,282976870,310707,283287577,19,0,0,17920,19,3712263457
9636,282998699,243059,283241758,4,0,0,9216,4,2467817362
9637,283009128,281756,283290884,32,0,0,10752,32,3300523076
9638,283024285,214650,283238935,35,0,0,44032,35,7343804293
9639,283035246,146377,283181623,24,0,0,7168,24,5806244803
9640,283051745,598677,283650422,20,0,0,20992,20,3163196710
9641,283084163,2774,283086937,28,0,1,512,28,9829951147
9642,283094769,6278,283101047,17,0,1,6656,17,2877435419
9643,283103982,228148,283332130,38,0,0,10240,38,10670016100
9644,283124723,437991,283562714,29,0,0,20480,29,6489487625
9645,283134443,194014,283328457,15,0,0,3584,15,2472151617
9646,283149208,221766,283370974,28,0,0,1024,28,5257074406
9647,283152490,378288,283530778,32,0,0,40448,32,4689604078
9648,283162951,2870,283165821,12,0,1,8704,12,1886939099
9649,283171211,173074,283344285,11,0,0,5120,11,4394236997
9650,283185952,239188,283425140,22,0,0,26624,22,5356678331
9651,283202989,280641,283483630,5,0,0,48128,5,6445998751
9652,283205671,7706,283213377,23,0,1,8192,23,3450723368
9653,283221139,3898,283225037,23,0,1,4096,23,3629170324
9654,283251308,44385,283295693,27,0,1,5120,27,4017654426
9655,283260654,257785,283518439,1,0,0,52736,1,8086769013
9656,283264932,402981,283667913,14,0,0,38912,14,7742501404
9657,283271686,342348,283614034,30,0,0,1536,30,1807759841
9658,283278013,30488,283308501,37,0,1,23552,37,8334508975
9659,283290688,284183,283574871,4,0,0,22016,4,2006431749
9660,283298735,285994,283584729,24,0,0,29696,24,8276040049
9661,283322195,1518,283323713,1,0,1,1536,1,9571700703
9662,283324295,251371,283575666,36,0,0,2560,36,6955981298
9663,283324353,411996,283736349,10,0,0,48640,10,6671655147
9664,283327930,283835,283611765,36,0,0,20992,36,10421519837
9665,283335017,160299,283495316,0,0,0,1536,0,8775868580
9666,283341597,328827,283670424,27,0,0,8192,27,8189827921
9667,283347956,677059,284025015,17,0,0,12288,17,1079881495
9668,283359471,172882,283532353,37,0,0,5120,37,7849867601
9669,283366267,4850,283371117,24,0,1,5120,24,9231542527
9670,283368631,3472,283372103,27,0,1,1536,27,3025039986
9671,283377182,216745,283593927,2,0,0,21504,2,4397327538
9672,283378243,8072,283386315,12,0,1,3584,12,5530607295
9673,283401985,408410,283810395,13,0,0,43520,13,9768300321
9674,283413501,3128,283416629,2,0,1,9216,2,7246260361
9675,283423569,501066,283924635,26,0,0,53248,26,2490575555
9676,283479143,214773,283693916,28,0,0,57344,28,2564856930
9677,283481854,266686,283748540,18,0,0,39936,18,8571904053
9678,283497627,268153,283765780,19,0,0,32256,19,3730779500
9679,283548714,4850,283553564,20,0,1,5120,20,9775727036
9680,283582200,517812,284100012,37,0,0,55296,37,951121660
9681,283608872,223658,283832530,34,0,0,43520,34,825553284
9682,283615948,197917,283813865,14,0,0,8192,14,1106866488
9683,283625809,252735,283878544,34,0,0,22016,34,10502455688
9684,283629307,154359,283783666,20,0,0,11776,20,4412519638
9685,283676950,248324,283925274,36,0,0,2048,36,5038998354
9686,283681704,322821,284004525,10,0,0,82432,10,10402752157
9687,283692535,7701,283700236,39,0,1,6656,39,7632586956
9688,283721661,89693,283811354,32,0,0,3072,32,1874189913
9689,283734888,310274,284045162,30,0,0,66048,30,8204735858
9690,283746745,19058,283765803,1,0,1,8192,1,7991894591
9691,283747536,390265,284137801,29,0,0,22528,29,3090707088
9692,283756173,13761,283769934,28,0,1,11264,28,7329923516
9693,283773857,180164,283954021,36,0,0,33280,36,1353478063
9694,283778470,242770,284021240,27,0,0,54784,27,1007887657
9695,283800209,252004,284052213,39,0,0,23040,39,8034335218
9696,283811040,6721,283817761,28,0,1,10752,28,9382008628
9697,283858847,96749,283955596,26,0,0,5120,26,6427282528
9698,283880488,4374,283884862,13,0,1,4608,13,9456061485
9699,283898984,175570,284074554,24,0,0,49152,24,1778953834
9700,283939459,1518,283940977,33,0,1,1536,33,9454971553
9701,283945597,155382,284100979,3,0,0,3072,3,10395605499
9702,283947824,135325,284083149,5,0,0,28160,5,9999921723
9703,283948183,282419,284230602,5,0,0,37376,5,7592070387
9704,283979388,166984,284146372,12,0,0,17408,12,523390263
9705,283992650,59602,284052252,19,0,1,7168,19,5558548405
9706,284000479,203145,284203624,29,0,0,8704,29,615636239
9707,284006543,303461,284310004,15,0,0,78336,15,9285327255
9708,284026200,145835,284172035,15,0,0,32768,15,3838048
9709,284028750,164620,284193370,11,0,0,9216,11,1290887109
9710,284033800,185399,284219199,30,0,0,23040,30,8945011611
9711,284039997,172159,284212156,9,0,0,23552,9,2418579059
9712,284079440,231203,284310643,29,0,0,2048,29,6395398861
9713,284086583,166631,284253214,17,0,0,29184,17,8967134415
9714,284092026,327522,284419548,14,0,0,3584,14,803783324
9715,284130655,287786,284418441,26,0,0,9216,26,8166535578
9716,284139549,6846,284146395,33,0,1,14336,33,3357520026
9717,284142899,116573,284259472,19,0,0,13312,19,5281109807
9718,284151887,426920,284578807,1,0,0,23552,1,4286767269
9719,284174045,241541,284415586,7,0,0,107008,7,5946312266
9720,284185762,316410,284502172,28,0,0,57344,28,4490515352
9721,284185841,600272,284786113,21,0,0,55296,21,325407132
9722,284194829,254489,284449318,21,0,0,5120,21,10184006890
9723,284195821,676266,284872087,24,0,0,38912,24,608888208
9724,284205135,653233,284858368,26,0,0,27136,26,7421692577
9725,284213930,349598,284563528,4,0,0,15872,4,2850080218
9726,284221353,576848,284798201,19,0,0,4608,19,2683100840
9727,284247719,306084,284553803,33,0,0,17920,33,2734252340
9728,284255516,19802,284275318,8,0,1,30720,8,3718254781
9729,284255800,54858,284310658,2,0,1,41472,2,7333196113
9730,284267942,280370,284548312,25,0,0,64512,25,8062160607
9731,284285724,763958,285049682,14,0,0,45056,14,5776719196
9732,284301379,661863,284963242,14,0,0,12288,14,6863245965
9733,284322628,4374,284327002,2,0,1,4608,2,6855833704
9734,284331012,658309,284989321,33,0,0,39424,33,4029798355
9735,284340546,229237,284569783,39,0,0,20480,39,3241028992
9736,284342666,12566,284355232,23,0,1,20992,23,6122455027
9737,284350835,8583,284359418,38,0,1,6656,38,7705314172
9738,284353265,172691,284525956,36,0,0,46592,36,2432348420
9739,284360444,118616,284479060,20,0,0,3584,20,8787450159
9740,284375201,419039,284794240,20,0,0,26624,20,10561882509
9741,284390885,254142,284645027,24,0,0,1536,24,4232370697
9742,284392739,251580,284644319,18,0,0,14336,18,2314963992
9743,284395868,35172,284431040,24,0,1,18944,24,8900714239
9744,284402602,316911,284719513,6,0,0,3072,6,163564483
9745,284421761,81518,284503279,39,0,0,3584,39,7644057278
9746,284429285,642866,285072151,14,0,0,7680,14,4253118402
9747,284442785,241217,284684002,28,0,0,22528,28,6260588597
9748,284452511,747917,285200428,24,0,0,61440,24,9792830319
9749,284455628,671684,285127312,35,0,0,58880,35,3248350306
9750,284465945,643412,285109357,19,0,0,7680,19,6308661976
9751,284483319,433381,284916700,39,0,0,52224,39,1807891556
9752,284519120,98445,284617565,34,0,0,1024,34,10562161221
9753,284523090,101605,284624695,1,0,0,512,1,10339090262
9754,284530021,271027,284801048,20,0,0,9216,20,8099483666
9755,284537657,212905,284750562,30,0,0,17920,30,4908460551
9756,284546525,10140,284556665,17,0,1,8704,17,867168392
9757,284573911,155535,284729446,5,0,0,23552,5,3626994609
9758,284577249,474476,285051725,22,0,0,6656,22,2365101461
9759,284577957,561808,285139765,14,0,0,6656,14,3351727835
9760,284584204,410139,284994343,15,0,0,7168,15,8879995055
9761,284602763,336773,284939536,29,0,0,41472,29,7611107421
9762,284606884,189087,284795971,3,0,0,5632,3,7953681683
9763,284607550,238229,284845779,9,0,0,17920,9,6746165708
9764,284627084,138745,284765829,13,0,0,8704,13,5879949549
9765,284673059,1518,284674577,10,0,1,1536,10,5529360846
9766,284683157,343687,285026844,5,0,0,20992,5,4461718888
9767,284698294,98480,284796774,24,0,0,2560,24,6821156165
9768,284750400,720,284751120,1,0,1,512,1,10210698826
9769,284769017,110261,284879278,28,0,0,23552,28,6335608889
9770,284782332,26119,284808451,32,0,1,16384,32,9381187475
9771,284786099,234334,285020433,18,0,0,75264,18,7597187303
9772,284789214,429146,285218360,17,0,0,28672,17,2828860604
9773,284795422,179722,284975144,8,0,0,9216,8,7160961153
9774,284801836,195642,284997478,30,0,0,10240,30,880506121
9775,284809042,438424,285247466,13,0,0,4096,13,5505845674
9776,284827734,144571,284972305,38,0,0,29696,38,2927777217
9777,284845359,190580,285035939,37,0,0,4608,37,2581164171
9778,284853181,138963,284992144,22,0,0,9216,22,1579315028
9779,284888011,192891,285080902,17,0,0,28672,17,274031152
9780,284903292,17298,284920590,16,0,1,4096,16,8519899687
9781,284938407,239256,285177663,26,0,0,44032,26,560257232
9782,284946713,153688,285100401,18,0,0,18432,18,683139802
9783,284961582,95165,285056747,32,0,0,12800,32,8554551270
9784,284962001,90831,285052832,12,0,0,3584,12,4305922934
9785,284992332,113339,285105671,20,0,0,10240,20,1559284801
9786,285011029,215978,285227007,3,0,0,19456,3,3241149406
9787,285018567,160203,285178770,2,0,0,3584,2,3503746888
9788,285021501,158859,285180360,15,0,0,2560,15,3744875241
9789,285051984,149083,285201067,8,0,0,2048,8,4846650443
9790,285052995,175743,285228738,1,0,0,5632,1,463570123
9791,285068181,88370,285156551,27,0,0,3584,27,6540037205
9792,285098785,80780,285179565,5,0,0,2560,5,5632263426
9793,285102474,273482,285375956,7,0,0,37888,7,10250527358
9794,285115019,151018,285266037,37,0,0,15360,37,6289666545
9795,285124303,121900,285246203,34,0,0,28672,34,3918969445
9796,285136892,161985,285298877,18,0,0,18944,18,7365962863
9797,285139431,206988,285346419,6,0,1,338944,6,656399392
9798,285142178,207147,285349325,38,0,1,4608,38,8040681574
9799,285155965,344117,285500082,25,0,0,61952,25,280012190
9800,285160575,484015,285644590,13,0,0,7680,13,2768762125
9801,285167699,462727,285630426,24,0,0,33792,24,8550099335
9802,285170926,136809,285307735,24,0,0,5120,24,6206518383
9803,285174884,211963,285386847,33,0,0,16384,33,3204598235
9804,285176434,178485,285354919,8,0,1,18432,8,5590510734
9805,285183539,319210,285502749,21,0,0,8704,21,8563551222
9806,285197949,331335,285529284,1,0,0,25600,1,5061178289
9807,285216322,228119,285444441,37,0,0,7680,37,161045745
9808,285229157,345370,285574527,21,0,0,22016,21,2993630235
9809,285248685,231516,285480201,1,0,0,34304,1,9056684266
9810,285263037,323517,285586554,37,0,0,39424,37,4414980063
9811,285316000,282852,285598852,26,0,0,512,26,8512660581
9812,285324245,31135,285355380,10,0,1,10240,10,8873373435
9813,285332451,23275,285355726,4,0,1,512,4,7392503642
9814,285335363,25752,285361115,21,0,1,25600,21,1283121158
9815,285336024,39947,285375971,1,0,1,16896,1,3024450532
9816,285340778,212698,285553476,3,0,0,9216,3,7350064041
9817,285368300,245779,285614079,8,0,0,5120,8,9357866872
9818,285369149,185287,285554436,34,0,0,3072,34,10236093051
9819,285386214,404157,285790371,39,0,0,34304,39,6788193715
9820,285389195,323054,285712249,24,0,0,15872,24,5832563694
9821,285403949,234577,285638526,35,0,0,25088,35,5230972088
9822,285431635,322674,285754309,12,0,0,10240,12,5510791090
9823,285445302,387078,285832380,9,0,0,1024,9,8519028125
9824,285455642,3422,285459064,38,0,1,3584,38,476212976
9825,285462656,299141,285761797,11,0,0,19456,11,8124996971
9826,285494806,10405,285505211,23,0,1,2560,23,6379610853
9827,285539600,240304,285779904,33,0,0,9728,33,6430460319
9828,285567397,161945,285729342,6,0,0,11264,6,6942243500
9829,285587745,69338,285657083,30,0,0,1024,30,9491319608
9830,285594185,5196,285599381,20,0,1,13312,20,3536063898
9831,285600243,231810,285832053,12,0,0,15360,12,2096297677
9832,285616815,73533,285690348,12,0,0,8192,12,6982682238
9833,285617766,12675,285630441,18,0,1,4608,18,3100703384
9834,285631866,30289,285662155,34,0,1,42496,34,8352762814
9835,285649967,324958,285974925,22,0,0,7680,22,2640378090
9836,285651290,11211,285662501,26,0,1,512,26,7334100596
9837,285651523,175835,285827358,37,0,0,33280,37,4213333572
9838,285662558,246095,285908653,3,0,0,55808,3,7084824783
9839,285678098,388705,286066803,0,0,0,71168,0,3712676468
9840,285699427,313118,286012545,10,0,0,43520,10,2045273621
9841,285729628,3662,285733290,10,0,1,10240,10,5138551966
9842,285729629,4007,285733636,39,0,1,512,39,4162700727
9843,285733268,144209,285877477,8,0,0,24064,8,2533146032
9844,285738945,144958,285883903,37,0,0,20992,37,10414999930
9845,285758501,107239,285865740,24,0,0,22016,24,8480532261
9846,285766105,261343,286027448,8,0,0,2560,8,7310456535
9847,285834979,254684,286089663,30,0,0,19968,30,2710069740
9848,285837890,3422,285841312,9,0,1,3584,9,663430873
9849,285852580,15062,285867642,31,0,1,29184,31,1012565797
9850,285854756,22736,285877492,16,0,1,4096,16,7510809837
9851,285884812,322237,286207049,14,0,0,29184,14,703006398
9852,285893663,15565,285909228,37,0,1,512,37,2216762525
9853,285901760,334315,286236075,33,0,0,62976,33,7465465961
9854,285910034,228402,286138436,4,0,0,6656,4,10150772275
9855,285914061,159309,286073370,33,0,0,21504,33,4291854963
9856,285933730,236548,286170278,30,0,0,9216,30,2851671645
9857,285934971,369101,286304072,39,0,0,69120,39,5760747555
9858,285949128,124421,286073549,30,0,0,512,30,8318598227
9859,285951922,1042,285952964,27,0,1,1024,27,5439585933
9860,285957739,125809,286083548,3,0,0,32768,3,262685707
9861,285962067,247493,286209560,1,0,0,8192,1,2981177563
9862,285990273,145140,286135413,31,0,0,26112,31,10119712554
9863,285998644,357683,286356327,33,0,0,77312,33,5411016026
9864,285999159,490098,286489257,25,0,0,18432,25,9300268926
9865,285999461,328552,286328013,7,0,0,40960,7,6179395313
9866,286000973,363325,286364298,12,0,0,26112,12,1675548635
9867,286009111,142040,286151151,36,0,0,1024,36,5056475449
9868,286027336,4008,286031344,9,0,1,10752,9,2132033452
9869,286033991,501145,286535136,14,0,0,150528,14,5210762120
9870,286040196,566,286040762,23,0,1,512,23,8831818103
9871,286058533,31153,286089686,33,0,1,1536,33,6598588145
9872,286066869,26175,286093044,24,0,1,3584,24,3036185190
9873,286093280,320514,286413794,21,0,0,39936,21,4449176153
9874,286116459,280110,286396569,0,0,0,17408,0,6913919291
9875,286129075,256388,286385463,9,0,0,1536,9,1355394104
9876,286130222,140419,286270641,5,0,0,24064,5,9563789390
9877,286138063,3493,286141556,8,0,1,9216,8,1488238765
9878,286139333,317404,286456737,4,0,0,27648,4,6176978947
9879,286146854,496628,286643482,21,0,0,37888,21,4157096886
9880,286159697,261142,286420839,10,0,0,11776,10,780115590
9881,286179402,408320,286587722,2,0,0,17408,2,6005748455
9882,286197083,174681,286371764,36,0,0,11776,36,9593982460
9883,286206197,7259,286213456,19,0,1,10752,19,7575852786
9884,286211841,389468,286601309,0,0,0,44544,0,9109503362
9885,286211894,419234,286631128,22,0,0,97792,22,8056844108
9886,286212594,3728,286216322,23,0,1,9728,23,2748540551
9887,286220290,170960,286391250,5,0,0,18944,5,10279216144
9888,286294058,364349,286658407,0,0,0,44544,0,4087627649
9889,286298253,11638,286309891,23,0,1,6144,23,6561550002
9890,286311439,397480,286708919,3,0,0,26624,3,8418517978
9891,286402983,17871,286420854,12,0,1,12288,12,8327992956
9892,286428798,106377,286535175,6,0,1,153088,6,4923458771
9893,286438241,404940,286843181,6,0,0,88064,6,4427191663
9894,286442486,189437,286631923,39,0,0,2560,39,6023447843
9895,286458145,124258,286582403,39,0,0,4608,39,6140307270
9896,286475564,192841,286668405,29,0,0,14336,29,7781724516
9897,286479332,99375,286578707,15,0,0,2560,15,4858896938
9898,286481174,54016,286535190,27,0,1,7680,27,9212690305
9899,286508329,265303,286773632,13,0,0,18944,13,1166845652
9900,286510907,480568,286991475,7,0,0,2560,7,10656941186
9901,286514458,210071,286724529,20,0,0,27136,20,2794706285
9902,286535697,157034,286692731,10,0,0,31744,10,10478554619
9903,286537836,315048,286852884,30,0,0,31744,30,5444597337
9904,286542128,169934,286712062,27,0,0,10240,27,9573279991
9905,286553906,213939,286767845,3,0,0,25088,3,1977352729
9906,286571332,1042,286572374,8,0,1,1024,8,7597065674
9907,286572463,283736,286856199,30,0,0,10752,30,6777112364
9908,286592246,280437,286872683,2,0,0,17408,2,865705196
9909,286660186,8234,286668420,10,0,1,4608,10,158607266
9910,286689082,258487,286947569,11,0,0,30720,11,5375145243
9911,286691719,4674,286696393,20,0,1,10240,20,6487304153
9912,286693650,270363,286964013,29,0,0,49664,29,2389727863
9913,286707576,401307,287108883,25,0,0,32768,25,4450224459
9914,286710083,105690,286815773,7,0,0,26112,7,3671920640
9915,286726287,323722,287050009,20,0,0,89088,20,7673977165
9916,286731318,484293,287215611,22,0,0,60416,22,6573642830
9917,286737603,556812,287294415,17,0,0,6656,17,2229601400
9918,286740140,566,286740706,20,0,1,512,20,1469731641
9919,286756159,385319,287141478,7,0,0,18432,7,4047050024
9920,286759954,297410,287057364,21,0,0,24064,21,3211212008
9921,286774194,228345,287002539,14,0,0,3584,14,6539927445
9922,286776702,149887,286926589,34,0,0,6656,34,5697104485
9923,286820311,36889,286857200,13,0,1,1024,13,136141917
9924,286822751,248988,287071739,34,0,0,47104,34,6980959121
9925,286831681,41025,286872706,28,0,1,23040,28,5066017514
9926,286834813,400801,287235614,33,0,0,18944,33,7248609981
9927,286840552,320774,287161326,39,0,0,17408,39,3340011356
9928,286851425,131302,286982727,22,0,0,4096,22,9646668434
9929,286855136,621506,287476642,18,0,0,124416,18,4692144152
9930,286858136,330532,287188668,38,0,0,35840,38,6671750360
9931,286859583,637711,287497294,19,0,0,40960,19,1117317966
9932,286864006,106262,286970268,11,0,0,20480,11,1437276160
9933,286864879,7842,286872721,19,0,1,1024,19,5686320289
9934,286865361,8626,286873987,7,0,1,5120,7,3012767322
9935,286865413,145378,287010791,28,0,0,10240,28,6679047225
9936,286868288,7265,286875553,16,0,1,8704,16,4839050882
9937,286880697,7706,286888403,26,0,1,8192,26,10430535045
9938,286884379,307276,287191655,28,0,0,9728,28,2578650997
9939,286896380,271636,287168016,0,0,0,3584,0,3093454911
9940,286900482,469473,287369955,36,0,0,40448,36,2827503242
9941,286920716,235291,287156007,25,0,0,26112,25,1126987898
9942,286943034,253866,287196900,14,0,0,2048,14,607189233
9943,286962683,14824,286977507,4,0,1,7680,4,10234615969
9944,286962801,16332,286979133,37,0,1,2560,37,1394738665
9945,286973098,319266,287292364,33,0,0,19456,33,5793793895
9946,286977338,214644,287191982,8,0,0,1024,8,3230071901
9947,287005658,554521,287560179,17,0,0,31232,17,3363414149
9948,287012460,6278,287018738,11,0,1,6656,11,3878749175
9949,287028080,300166,287328246,6,0,0,18944,6,9556688364
9950,287035963,263927,287299890,4,0,0,17920,4,8571102465
9951,287076350,5326,287081676,38,0,1,5632,38,2651638
9952,287088350,5326,287093676,37,0,1,5632,37,2546133639
9953,287089990,8832,287098822,2,0,1,8192,2,13929971
9954,287097217,189204,287286421,7,0,0,62976,7,8804124659
9955,287114414,320580,287434994,11,0,0,3584,11,8959101655
9956,287119429,260213,287379642,32,0,0,31744,32,7807390575
9957,287141771,277388,287419159,1,0,0,29696,1,1143233590
9958,287161258,177717,287338975,2,0,0,27648,2,4790485028
9959,287164267,2470,287166737,31,0,1,2560,31,6662267672
9960,287170428,566,287170994,31,0,1,512,31,9321846311
9961,287170532,211488,287382020,14,0,0,7680,14,8528032754
9962,287175341,303196,287478537,26,0,0,6144,26,4221317726
9963,287179039,541983,287721022,30,0,0,11776,30,5599939455
9964,287198784,158463,287357247,34,0,0,9728,34,2227920106
9965,287205140,458393,287663533,30,0,0,6656,30,1064772447
9966,287222970,256066,287479036,0,0,0,1536,0,8627173595
9967,287259632,601601,287861233,13,0,0,28160,13,10465257780
9968,287271713,32059,287303772,37,0,1,4096,37,4597677112
9969,287291619,259029,287550648,13,0,0,32768,13,2075044834
9970,287296374,404047,287700421,20,0,0,11776,20,3921017184
9971,287296853,243773,287540626,36,0,0,29696,36,10298941709
9972,287304868,309144,287614012,30,0,0,29696,30,2606463616
9973,287306313,339332,287645645,15,0,0,12800,15,7377736343
9974,287316006,325724,287641730,34,0,0,29696,34,1978618815
9975,287316998,1994,287318992,0,0,1,2048,0,4470824880
9976,287324380,485082,287809462,21,0,0,22016,21,8298829935
9977,287327392,236078,287563470,27,0,0,10752,27,6544001903
9978,287331174,687907,288019081,27,0,0,34816,27,5737541208
9979,287353749,67773,287421522,19,0,0,7680,19,7481963312
9980,287355689,23968,287379657,19,0,1,21504,19,6314820284
9981,287372093,521675,287893768,3,0,0,58368,3,8132215067
9982,287382601,208426,287591027,20,0,0,24064,20,6507248139
9983,287385474,538333,287923807,32,0,0,512,32,8823983224
9984,287388669,440479,287829148,17,0,0,9728,17,2210772090
9985,287395490,396626,287792116,37,0,0,32256,37,2982818653
9986,287413768,13565,287427333,24,0,1,6144,24,10096367665
9987,287416789,553663,287970452,30,0,0,14336,30,8948103026
9988,287417218,487173,287904391,24,0,0,34816,24,2449406765
9989,287435464,367275,287802739,26,0,0,34816,26,4427500815
9990,287442940,425796,287868736,15,0,0,24576,15,2992805151
9991,287465475,442987,287908462,35,0,0,13312,35,2505802756
9992,287474475,637679,288112154,38,0,0,90112,38,3779451921
9993,287481767,673607,288155374,38,0,0,6656,38,2080284789
9994,287483165,343004,287826169,27,0,0,54784,27,9755621361
9995,287513296,566,287513862,24,0,1,512,24,4163565957
9996,287513621,4850,287518471,4,0,1,5120,4,1879769804
9997,287522540,524706,288047246,10,0,0,38400,10,441330017
9998,287526886,13755,287540641,13,0,1,13312,13,10537786364
9999,287535847,198562,287734409,5,0,0,25088,5,598128063
