RequestID,ArrivalTime,DelayTime,FinishTime,InitiatorID,TargetID,IOType,Size,VolumeID,Offset
0,0,13364,13364,0,0,1,22016,5,859860941
1,1,83759,83760,5,0,0,5120,8,6145295860
2,2,57446,57448,3,0,0,4096,12,4302795047
3,3,113935,113938,6,0,0,22016,5,4237502209
4,4,90147,90151,2,0,0,9728,15,9371252305
5,5,261319,261324,7,0,0,20992,8,2616591739
6,6,131479,131485,8,0,0,20480,13,1655771292
7,7,82170,82177,1,0,0,19968,14,4119310220
8,8,149393,149401,9,0,0,8704,19,5585761691
9,9,19359,19368,4,0,1,20480,4,7967281500
10,1470,329996,331466,5,0,0,10752,8,7370532512
11,2350,131952,134302,7,0,0,8192,8,9703292455
12,4360,488553,492913,8,0,0,90112,13,8566522680
13,13210,7784,20994,3,0,1,2560,12,2679415760
14,14679,6571,21250,1,0,1,9216,14,969496498
15,29760,87418,117178,9,0,0,5120,19,6497026275
16,34710,212305,247015,1,0,0,3072,14,896342690
17,45870,484034,529904,1,0,0,14848,14,10580137929
18,46520,542694,589214,5,0,0,11776,8,10493117377
19,49531,2470,52001,5,0,1,2560,8,3163540853
20,59220,276702,335922,0,0,0,2560,5,10054773643
21,62180,380382,442562,5,0,0,67072,8,503637687
22,63200,181624,244824,1,0,0,28160,14,4564158180
23,63530,206857,270387,5,0,0,29696,8,5131257377
24,64630,963980,1028610,0,0,0,3072,5,6486346849
25,70560,139456,210016,6,0,0,11264,5,6632822250
26,72130,935377,1007507,3,0,0,31744,12,3590700020
27,76051,379356,455407,0,0,0,41984,5,1217137405
28,78880,479984,558864,5,0,0,6144,8,5160298012
29,80040,437888,517928,7,0,0,19456,8,1104199558
30,89191,7706,96897,7,0,1,7168,8,9561198811
31,92411,6432,98843,7,0,1,3072,8,1868319044
32,94760,588844,683604,8,0,0,35840,13,10679948102
33,95130,414672,509802,5,0,0,21504,8,2759518553
34,111140,13073,124213,3,0,1,16384,12,8303072383
35,113770,28402,142172,2,0,1,38400,15,5678862237
36,113850,602513,716363,7,0,0,58880,8,563941747
37,115240,27598,142838,2,0,1,1024,15,6276916410
38,118990,434048,553038,4,0,0,10752,4,4136547592
39,133300,140764,274064,7,0,0,9216,8,6430879697
40,135990,13434,149424,4,0,1,7680,4,4077425941
41,142710,638412,781122,8,0,0,5120,13,471505032
42,143910,780882,924792,6,0,0,15360,5,1869489905
43,144480,5770,150250,6,0,1,4096,5,3465426278
44,146870,266645,413515,1,0,0,2048,14,8852017654
45,147830,603421,751251,7,0,0,5120,8,5745223289
46,151320,146954,298274,1,0,0,7680,14,334210729
47,155020,986408,1141428,9,0,0,6656,19,1079051015
48,156380,189258,345638,8,0,0,1024,13,4866253525
49,157960,340896,498856,5,0,0,19456,8,3563096340
50,167530,380276,547806,9,0,0,35328,19,6154373966
51,171421,901341,1072762,0,0,0,6656,5,9773639069
52,177751,1699802,1877553,0,0,0,180736,5,4756569348
53,178090,763778,941868,4,0,0,52224,4,5662325610
54,178550,1699330,1877880,0,0,0,1024,5,4247107035
55,189080,4850,193930,0,0,1,5120,5,2955048349
56,200000,673602,873602,9,0,0,1536,19,2689104548
57,210040,1084519,1294559,7,0,0,28672,8,1525314032
58,211340,3898,215238,3,0,1,4096,12,3747864976
59,218440,590692,809132,6,0,0,14336,5,4725873861
60,219120,530532,749652,1,0,0,43008,14,3351921029
61,219540,280735,500275,9,0,0,4608,19,5942505280
62,226900,1028962,1255862,6,0,0,27136,5,4077194283
63,227940,1749882,1977822,3,0,0,55296,12,1484955497
64,229450,82666,312116,2,0,1,134144,15,3578901429
65,230770,635362,866132,6,0,0,2560,5,1959875283
66,233070,81632,314702,6,0,1,4096,5,7234210024
67,233530,1074254,1307784,7,0,0,5120,8,9791744942
68,241930,456470,698400,6,0,0,27136,5,8175446876
69,243690,75518,319208,3,0,1,7168,12,3757723606
70,249440,307521,556961,1,0,0,12800,14,6269335455
71,249631,881300,1130931,0,0,0,18944,5,9505766195
72,251060,1922586,2173646,7,0,0,10240,8,6215869608
73,253100,1773922,2027022,5,0,0,6144,8,9660076473
74,267030,924426,1191456,9,0,0,8704,19,2926088348
75,267230,991065,1258295,3,0,0,6656,12,9965340143
76,273500,352060,625560,2,0,0,6656,15,5135844965
77,277620,384684,662304,5,0,0,15360,8,2582829322
78,284480,1797750,2082230,2,0,0,31744,15,832839645
79,290151,929271,1219422,0,0,0,31232,5,5392594168
80,290200,2726308,3016508,6,0,0,46080,5,2775113454
81,292270,29204,321474,6,0,1,3584,5,7294890644
82,297950,1036302,1334252,1,0,0,31232,14,4367463419
83,302330,215769,518099,6,0,0,512,5,3023543816
84,305680,1587237,1892917,5,0,0,32768,8,4998524171
85,307160,862086,1169246,1,0,0,41984,14,2228974853
86,309200,2241936,2551136,2,0,0,5120,15,2788395200
87,311040,1110032,1421072,6,0,0,68608,5,10506998712
88,319120,1768429,2087549,2,0,0,17408,15,10007541403
89,322510,709306,1031816,6,0,0,4608,5,3111655558
90,329880,1064810,1394690,3,0,0,5632,12,10619986724
91,330231,537444,867675,0,0,0,512,5,9778790632
92,332471,1356852,1689323,0,0,0,15872,5,3507041414
93,334000,487003,821003,3,0,0,38912,12,6779422444
94,346270,5971,352241,4,0,1,14848,4,10139729459
95,347950,94635,442585,2,0,1,120832,15,7056851933
96,349170,1323974,1673144,0,0,0,56832,5,3716819182
97,349820,1343984,1693804,8,0,0,4608,13,4934746775
98,352810,1002130,1354940,1,0,0,17920,14,1462775069
99,358210,378315,736525,4,0,0,28160,4,3570281972
100,365240,958120,1323360,5,0,0,13312,8,6072798208
101,368730,1512925,1881655,5,0,0,12288,8,6001480935
102,368870,1676402,2045272,7,0,0,8192,8,1352103735
103,377710,1003192,1380902,7,0,0,47104,8,6912893743
104,378890,337652,716542,3,0,0,512,12,7955789241
105,380010,62590,442600,6,0,1,8704,5,1308183169
106,383500,614320,997820,6,0,0,14848,5,8266707516
107,386410,337028,723438,7,0,0,8192,8,4417371968
108,387690,2119338,2507028,4,0,0,116736,4,1584069340
109,392730,2273152,2665882,6,0,0,41984,5,5317157334
110,396900,384401,781301,6,0,0,512,5,3927004037
111,398700,1500552,1899252,9,0,0,20480,19,2185826276
112,400359,55071,455430,8,0,1,3584,13,10021954851
113,407440,1874840,2282280,0,0,0,26624,5,975334139
114,410150,2686534,3096684,4,0,0,26624,4,9414614543
115,411720,1350664,1762384,1,0,0,8704,14,10202590280
116,413560,119580,533140,2,0,0,3584,15,3852073513
117,415040,870768,1285808,1,0,0,9216,14,2589368972
118,424050,1125524,1549574,9,0,0,15360,19,5350859273
119,426260,2466378,2892638,5,0,0,29696,8,3097200653
120,427840,711545,1139385,0,0,0,4608,5,6219704154
121,428440,517710,946150,8,0,0,1024,13,5743915762
122,429440,1071278,1500718,5,0,0,3584,8,881952095
123,432160,692984,1125144,7,0,0,76800,8,1584387321
124,434220,575018,1009238,7,0,0,5632,8,516872101
125,434910,1549947,1984857,9,0,0,23040,19,5031137982
126,439321,21549,460870,2,0,1,13312,15,7928402340
127,441910,649682,1091592,5,0,0,1536,8,4624527155
128,450140,2201952,2652092,4,0,0,115712,4,8576285294
129,451780,1018480,1470260,5,0,0,15872,8,3099877528
130,453530,149358,602888,9,0,1,231936,19,9131683191
131,461860,1222612,1684472,0,0,0,14336,5,3145422674
132,467740,2508008,2975748,7,0,0,9216,8,6928411557
133,471350,1028253,1499603,6,0,0,96256,5,3417959752
134,473360,1409558,1882918,1,0,0,4096,14,5225043160
135,480770,1158718,1639488,3,0,0,10240,12,5726199949
136,483750,2550940,3034690,2,0,0,26624,15,7935034002
137,483801,119433,603234,7,0,1,512,8,10025025942
138,486100,1936780,2422880,4,0,0,19968,4,6755149208
139,486560,900597,1387157,4,0,0,20480,4,2988233180
140,486800,1335646,1822446,7,0,0,18432,8,1431236480
141,491570,2732413,3223983,5,0,0,84480,8,8682401524
142,494760,2356276,2851036,6,0,0,56320,5,6326925692
143,495420,642546,1137966,7,0,0,23040,8,741702242
144,500640,1852532,2353172,0,0,0,40448,5,121478821
145,507141,96759,603900,7,0,1,1024,8,10079780342
146,521030,329668,850698,5,0,0,10240,8,3877523008
147,522270,983294,1505564,8,0,0,10752,13,7336043176
148,530871,75615,606486,7,0,1,4096,8,2622557796
149,543600,1597769,2141369,0,0,0,7680,5,2820286876
150,546870,1074392,1621262,7,0,0,4608,8,848488042
151,547130,426552,973682,0,0,0,1536,5,3879654104
152,547150,2867330,3414480,7,0,0,36864,8,7002068451
153,548310,844649,1392959,5,0,0,1536,8,2469746228
154,549790,1589224,2139014,6,0,0,81920,5,4914437751
155,551610,471830,1023440,9,0,0,8192,19,9568905799
156,551700,2510149,3061849,4,0,0,89088,4,8167933051
157,554820,1912274,2467094,9,0,0,7680,19,8413202116
158,557060,2239091,2796151,3,0,0,10240,12,2880433484
159,560030,2157953,2717983,0,0,0,7168,5,5310319028
160,561250,1024078,1585328,4,0,0,13824,4,8706011752
161,563550,2869696,3433246,5,0,0,11776,8,45042183
162,567400,1107163,1674563,0,0,0,4608,5,7902387296
163,568710,1768377,2337087,7,0,0,6144,8,10357512170
164,578620,1234412,1813032,4,0,0,23040,4,9761712781
165,580320,2134825,2715145,4,0,0,13824,4,9789995466
166,582849,23983,606832,8,0,1,512,13,7145721061
167,584350,2442165,3026515,4,0,0,32768,4,7668841435
168,586831,24187,611018,7,0,1,6656,8,10633662021
169,600830,344985,945815,4,0,0,12800,4,408202874
170,601260,951632,1552892,7,0,0,8192,8,10451097446
171,604770,366020,970790,6,0,0,7168,5,5730309830
172,604850,787626,1392476,9,0,0,17408,19,1000546136
173,606810,1646550,2253360,4,0,0,17408,4,4154333244
174,607579,5705,613284,8,0,1,3584,13,3487684402
175,615850,3898,619748,4,0,1,4096,4,3945787547
176,622171,12308,634479,2,0,1,20480,15,1182670619
177,622670,16315,638985,3,0,1,7168,12,7553450110
178,624840,15131,639971,6,0,1,1536,5,7879684654
179,634270,1455790,2090060,7,0,0,8192,8,2889438519
180,638600,1383091,2021691,3,0,0,74240,12,8928189382
181,652820,1073916,1726736,0,0,0,5120,5,9039120592
182,653030,1994,655024,0,0,1,2048,5,2494715911
183,654260,2043041,2697301,0,0,0,102912,5,3203815820
184,659890,2509044,3168934,6,0,0,4096,5,7454317414
185,665360,2199879,2865239,7,0,0,10240,8,4393020034
186,667410,1485638,2153048,8,0,0,20992,13,2504039770
187,671480,2033792,2705272,3,0,0,26112,12,10555545489
188,673190,2483768,3156958,8,0,0,5120,13,7613784943
189,678730,1624714,2303444,3,0,0,36864,12,4857181078
190,679550,3285802,3965352,4,0,0,52224,4,2777201876
191,688090,933936,1622026,0,0,0,2048,5,249622147
192,691560,2686037,3377597,2,0,0,7680,15,6604288878
193,696870,26583,723453,0,0,1,5632,5,4962712014
194,697420,1770469,2467889,4,0,0,2560,4,10368033450
195,698530,2577034,3275564,6,0,0,16896,5,5179012093
196,699440,727464,1426904,2,0,0,2048,15,1658239042
197,702860,1238980,1941840,9,0,0,4608,19,2508698694
198,703030,4110962,4813992,5,0,0,25600,8,2961727094
199,706410,1901625,2608035,7,0,0,78336,8,4899045255
200,707970,2007814,2715784,8,0,0,2048,13,1270427113
201,711410,2006744,2718154,6,0,0,512,5,3415360709
202,719180,3030930,3750110,8,0,0,109568,13,4488333196
203,720250,2714659,3434909,9,0,0,1536,19,687888607
204,729820,2415668,3145488,9,0,0,29696,19,2525699699
205,733990,2970499,3704489,2,0,0,27648,15,5993295079
206,734910,1600266,2335176,0,0,0,38912,5,10475987969
207,736930,16324,753254,4,0,1,2048,4,9477919179
208,743110,1967808,2710918,7,0,0,11264,8,2810651000
209,744340,2518415,3262755,7,0,0,65024,8,10256036507
210,750460,4163467,4913927,0,0,0,92160,5,10421906287
211,752750,3533946,4286696,3,0,0,35328,12,9307668929
212,753370,4850,758220,3,0,1,5120,12,9977234011
213,757610,2860924,3618534,0,0,0,86016,5,1496350655
214,761150,3099190,3860340,6,0,0,111616,5,3339630645
215,765850,983014,1748864,3,0,0,7168,12,8179429572
216,768181,13858,782039,2,0,1,23552,15,10449603098
217,771451,16182,787633,7,0,1,18432,8,6520533236
218,775480,2210233,2985713,2,0,0,3072,15,5703181999
219,776240,2598994,3375234,6,0,0,12288,5,8609790191
220,776680,2559188,3335868,9,0,0,10752,19,7891240233
221,781850,1217206,1999056,0,0,0,11264,5,2527894438
222,784490,1032301,1816791,8,0,0,12288,13,5030508654
223,786900,3306888,4093788,3,0,0,25088,12,5685756058
224,791660,2514288,3305948,3,0,0,10752,12,5978356744
225,796580,1776676,2573256,0,0,0,18432,5,1693666276
226,799180,2893384,3692564,3,0,0,181760,12,7033204157
227,807090,939428,1746518,1,0,0,5120,14,10067572583
228,808320,836508,1644828,9,0,0,2560,19,5132028064
229,808730,1605626,2414356,2,0,0,24576,15,2442748044
230,810290,2148978,2959268,0,0,0,24576,5,4097777406
231,814290,1453601,2267891,5,0,0,47616,8,9057918014
232,819300,4766,824066,0,0,1,3072,5,9158123670
233,825220,1787822,2613042,5,0,0,16384,8,1975775804
234,830430,2281540,3111970,0,0,0,27136,5,5324672188
235,831040,2878308,3709348,4,0,0,15872,4,4125485961
236,833070,20882,853952,4,0,1,33792,4,6281000919
237,837720,1185242,2022962,7,0,0,4096,8,122444072
238,837870,2392540,3230410,4,0,0,20992,4,824263956
239,839330,2682949,3522279,5,0,0,9216,8,3909143557
240,843430,2922973,3766403,9,0,0,35328,19,5129525510
241,846510,2272900,3119410,7,0,0,512,8,9719482516
242,848210,2328112,3176322,0,0,0,2560,5,5669980557
243,854271,114245,968516,7,0,1,188928,8,1218757538
244,858130,3064628,3922758,2,0,0,45056,15,5036671921
245,861300,2505924,3367224,5,0,0,8192,8,2254504835
246,869310,2115436,2984746,0,0,0,24576,5,7139186276
247,876500,3461215,4337715,3,0,0,1024,12,3936058046
248,884000,2926768,3810768,4,0,0,16384,4,1735621144
249,887890,2463532,3351422,8,0,0,44032,13,9766193278
250,889009,81796,970805,8,0,1,11264,13,4503648110
251,896210,2174725,3070935,2,0,0,27648,15,7508824848
252,907770,63050,970820,6,0,1,9216,5,378396195
253,912430,1618160,2530590,5,0,0,512,8,6208928272
254,928630,2157812,3086442,2,0,0,50688,15,5318750549
255,929410,2639760,3569170,5,0,0,56320,8,153640780
256,931530,2994096,3925626,8,0,0,7168,13,4949169449
257,934030,2430675,3364705,3,0,0,43520,12,8264788851
258,942050,3182866,4124916,0,0,0,41984,5,4689687548
259,947880,2748162,3696042,3,0,0,7680,12,9176942820
260,948321,27223,975544,7,0,1,20992,8,8174586622
261,951440,24668,976108,0,0,1,10752,5,5164736826
262,951630,948441,1900071,7,0,0,2560,8,9249897941
263,956760,23214,979974,4,0,1,6144,4,8576663983
264,957620,4527993,5485613,6,0,0,56320,5,8624972146
265,965331,228462,1193793,2,0,1,374784,15,9190730920
266,965810,2276253,3242063,8,0,0,20992,13,3460079632
267,968650,3454881,4423531,3,0,0,26112,12,3055512019
268,974150,3331156,4305306,4,0,0,51200,4,3350489372
269,976470,3511941,4488411,8,0,0,54784,13,134077532
270,982180,2501353,3483533,2,0,0,4608,15,7752669559
271,986800,3368878,4355678,2,0,0,58880,15,10466489356
272,987380,2898613,3885993,8,0,0,8192,13,6689128759
273,994100,2986320,3980420,1,0,0,7168,14,1578385156
274,995740,2385491,3381231,7,0,0,1024,8,4133587585
275,999360,3378200,4377560,7,0,0,20992,8,7194338006
276,1008060,187359,1195419,6,0,1,2560,5,2358674434
277,1013810,183555,1197365,4,0,1,3072,4,4742606955
278,1015010,4000318,5015328,1,0,0,3584,14,6896310438
279,1015230,2501543,3516773,9,0,0,98816,19,7686289604
280,1016350,3635324,4651674,7,0,0,61440,8,2482928186
281,1016480,2881735,3898215,5,0,0,30720,8,9656222887
282,1016760,3151224,4167984,5,0,0,22016,8,6816301550
283,1022280,3420976,4443256,7,0,0,34304,8,7011945658
284,1024060,3517547,4541607,7,0,0,2048,8,5193041627
285,1027240,2519982,3547222,3,0,0,12800,12,871090184
286,1050380,147331,1197711,3,0,1,512,12,9534919377
287,1058250,145465,1203715,0,0,1,20480,5,6612280142
288,1060250,2913884,3974134,2,0,0,26624,15,5052349559
289,1069210,1792894,2862104,5,0,0,20480,8,4411267591
290,1071210,3640550,4711760,8,0,0,22528,13,9675607853
291,1073470,1728944,2802414,4,0,0,20480,4,4633736962
292,1076331,218243,1294574,7,0,1,266240,8,2521930132
293,1081000,1434694,2515694,0,0,0,12288,5,7386812292
294,1087140,3474036,4561176,9,0,0,33792,19,5259256082
295,1092210,202379,1294589,3,0,1,512,12,1146248637
296,1092670,3409104,4501774,0,0,0,25600,5,872898507
297,1097580,2716200,3813780,4,0,0,9216,4,3844864804
298,1108850,5182904,6291754,8,0,0,36864,13,4435225520
299,1112590,3817474,4930064,8,0,0,17408,13,9207697844
300,1116560,222906,1339466,9,0,1,168960,19,7018918790
301,1116850,1610738,2727588,4,0,0,3584,4,8009273244
302,1137020,1154723,2291743,5,0,0,3584,8,3568795888
303,1139790,3424857,4564647,2,0,0,11264,15,4491980009
304,1141730,198082,1339812,6,0,1,512,5,4510292542
305,1160691,180747,1341438,5,0,1,2560,8,2544817145
306,1166590,3020588,4187178,2,0,0,17920,15,9080260274
307,1168001,176343,1344344,7,0,1,4608,8,8959179109
308,1168620,177670,1346290,9,0,1,3072,19,8186052469
309,1175831,219098,1394929,7,0,1,147456,8,10478367679
310,1177340,2850304,4027644,6,0,0,2560,5,6402081084
311,1177390,220334,1397724,6,0,1,24576,5,1390803390
312,1185101,11775572,12960673,2,0,1,144896,15,145732268
313,1185280,2296826,3482106,3,0,0,5632,12,7656641583
314,1186170,3224925,4411095,7,0,0,5120,8,3461955527
315,1187320,2603951,3791271,1,0,0,23040,14,4083281690
316,1194400,2669418,3863818,2,0,0,1024,15,6567692533
317,1194550,3566372,4760922,1,0,0,11264,14,9783164911
318,1204020,4302946,5506966,2,0,0,48128,15,10405245749
319,1206031,13965135,15171166,7,0,1,222720,8,1944144496
320,1208480,2079766,3288246,8,0,0,3072,13,7693761182
321,1212680,13969140,15181820,4,0,1,6144,4,7553154858
322,1214900,687114,1902014,5,0,0,6144,8,2797550895
323,1222020,2531233,3753253,3,0,0,10240,12,7582771846
324,1237420,13944423,15181843,3,0,1,3584,12,6431854244
325,1241080,13940786,15181866,9,0,1,2560,19,1304981177
326,1243170,2349133,3592303,5,0,0,29696,8,7517198150
327,1246080,1986733,3232813,5,0,0,7680,8,1603461803
328,1257170,3966943,5224113,8,0,0,33792,13,8275621571
329,1263060,3826660,5089720,7,0,0,126976,8,4242936222
330,1263740,3658946,4922686,9,0,0,28672,19,8404129743
331,1275970,1377081,2653051,8,0,0,3072,13,8050297692
332,1280780,3056600,4337380,7,0,0,24576,8,7548287880
333,1289080,3635657,4924737,7,0,0,6656,8,7746988416
334,1291020,2597804,3888824,2,0,0,9216,15,6965870383
335,1293461,13888428,15181889,5,0,1,1536,8,4973852711
336,1295080,3640935,4936015,9,0,0,19456,19,5135437075
337,1314470,3571354,4885824,4,0,0,41984,4,1818649329
338,1323350,3911908,5235258,7,0,0,3072,8,405005244
339,1325360,2046107,3371467,8,0,0,13824,13,496619164
340,1327810,2427806,3755616,7,0,0,7680,8,927158959
341,1329630,3538474,4868104,3,0,0,9216,12,7917051853
342,1337570,3666449,5004019,3,0,0,12288,12,642748393
343,1348350,2957759,4306109,9,0,0,2560,19,147690617
344,1354070,4005453,5359523,8,0,0,24576,13,1921222897
345,1362060,1786267,3148327,3,0,0,9216,12,7148080248
346,1368970,2400768,3769738,5,0,0,1536,8,9737067387
347,1372420,3492853,4865273,1,0,0,51712,14,4675795606
348,1383430,3616822,5000252,3,0,0,26112,12,9167584981
349,1387590,4672796,6060386,0,0,0,41984,5,5507779412
350,1388410,4858138,6246548,0,0,0,60928,5,1988338285
351,1390740,2388016,3778756,0,0,0,7680,5,5385174459
352,1395500,2180042,3575542,0,0,0,6656,5,1252714379
353,1398290,4382430,5780720,5,0,0,6144,8,3652799370
354,1398460,3551227,4949687,5,0,0,8192,8,7914084313
355,1401330,3231601,4632931,0,0,0,36864,5,10327404461
356,1406020,2113428,3519448,5,0,0,8704,8,9840937632
357,1406040,13820495,15226535,8,0,1,8192,13,3017270129
358,1406120,3937882,5344002,2,0,0,52736,15,1353655068
359,1406760,13819798,15226558,9,0,1,3584,19,885142987
360,1408010,2722172,4130182,2,0,0,1024,15,2399718817
361,1411110,3099579,4510689,9,0,0,29184,19,8747491828
362,1420250,2443233,3863483,9,0,0,10240,19,5816176970
363,1421370,2993500,4414870,7,0,0,512,8,4248597170
364,1421720,13804861,15226581,4,0,1,14336,4,9581395895
365,1422480,2446914,3869394,2,0,0,4096,15,8919452975
366,1423571,14135800,15559371,2,0,1,27648,15,5441115389
367,1425520,14244636,15670156,8,0,1,2048,13,2398466967
368,1439550,2187587,3627137,2,0,0,28160,15,10287730944
369,1447990,3499170,4947160,5,0,0,8704,8,178566842
370,1451580,1060355,2511935,7,0,0,15872,8,783693172
371,1455200,2834483,4289683,2,0,0,9728,15,1712362033
372,1458550,2481812,3940362,2,0,0,5120,15,10088514605
373,1470270,5314040,6784310,5,0,0,32256,8,2850876047
374,1476790,2968968,4445758,1,0,0,1024,14,4356477274
375,1479820,14190359,15670179,9,0,1,2048,19,1982591761
376,1485860,1984800,3470660,3,0,0,8192,12,4996549961
377,1488840,3856433,5345273,5,0,0,4096,8,5054954695
378,1500200,14170002,15670202,9,0,1,19456,19,9340945483
379,1508941,16105494,17614435,7,0,1,329216,8,6451816367
380,1518580,3440490,4959070,9,0,0,30720,19,5283324583
381,1520660,16139681,17660341,6,0,1,30208,5,7417646427
382,1525130,4502596,6027726,8,0,0,37888,13,8679488063
383,1532030,3198072,4730102,1,0,0,11776,14,3636845898
384,1533970,2449749,3983719,9,0,0,10752,19,7507811381
385,1534220,2453422,3987642,8,0,0,12800,13,1070122039
386,1536890,4033253,5570143,0,0,0,53760,5,4276217360
387,1549630,2333844,3883474,3,0,0,10240,12,10625640858
388,1556740,4283368,5840108,3,0,0,60416,12,2869755870
389,1559780,3608730,5168510,5,0,0,20992,8,1722139432
390,1562900,3720919,5283819,2,0,0,11264,15,2965636601
391,1563160,3182378,4745538,2,0,0,6144,15,8960711163
392,1565890,3055786,4621676,8,0,0,39424,13,1851192366
393,1571970,3742279,5314249,5,0,0,4096,8,1166680882
394,1575350,2685945,4261295,0,0,0,1024,5,3858279149
395,1590350,3369523,4959873,1,0,0,2560,14,6926915414
396,1592140,2101539,3693679,0,0,0,3584,5,2650910350
397,1595440,2592073,4187513,5,0,0,1024,8,8721211109
398,1597550,1018355,2615905,0,0,0,9216,5,9416137158
399,1603150,16070208,17673358,0,0,1,8192,5,5735854087
400,1606460,4294320,5900780,1,0,0,8192,14,5615563047
401,1607970,4086596,5694566,2,0,0,17408,15,5053231305
402,1610440,16066205,17676645,9,0,1,5632,19,7147712654
403,1610843,4170056,5780899,8,0,0,512,13,9855617686
404,1611200,2820310,4431510,3,0,0,26112,12,6560401712
405,1618291,16120264,17738555,2,0,1,23552,15,4817362826
406,1618381,16219538,17837919,7,0,1,9216,8,9825552485
407,1625790,2920052,4545842,1,0,0,13824,14,4290283148
408,1629410,16347501,17976911,6,0,1,19968,5,7891220043
409,1630690,5966035,7596725,9,0,0,39936,19,6578361444
410,1632090,1160902,2792992,5,0,0,27136,8,9040943522
411,1632620,3494187,5126807,1,0,0,16896,14,849255449
412,1637081,16339853,17976934,7,0,1,8192,8,3411990623
413,1642900,16347028,17989928,6,0,1,1024,5,2943438133
414,1645060,2254738,3899798,2,0,0,5120,15,8967978248
415,1651950,1931282,3583232,5,0,0,24576,8,1178590412
416,1653890,5276976,6930866,9,0,0,73728,19,9730371182
417,1661770,2326215,3987985,3,0,0,1024,12,7415781671
418,1667011,17142365,18809376,2,0,1,223744,15,9698406454
419,1668000,3560660,5228660,0,0,0,14848,5,5353632996
420,1668880,17178521,18847401,9,0,1,17408,19,7273472618
421,1671450,3637129,5308579,0,0,0,6144,5,1641876538
422,1694830,3964529,5659359,3,0,0,94720,12,121931899
423,1694840,2992947,4687787,0,0,0,16384,5,10564002882
424,1699150,4166253,5865403,3,0,0,82944,12,6207725378
425,1700490,3832573,5533063,3,0,0,36352,12,7746633712
426,1702610,1031802,2734412,0,0,0,512,5,2676552479
427,1711600,4057062,5768662,2,0,0,13312,15,466200342
428,1714440,17224579,18939019,4,0,1,26624,4,7997170522
429,1715300,17223742,18939042,0,0,1,1024,5,3085383018
430,1717250,2684342,4401592,0,0,0,2560,5,6158645907
431,1720991,17327357,19048348,2,0,1,30208,15,4403657045
432,1726640,17324934,19051574,9,0,1,5120,19,823712546
433,1727150,17510707,19237857,3,0,1,14336,12,5422589711
434,1739350,2869584,4608934,3,0,0,9728,12,6313459965
435,1741360,3973821,5715181,5,0,0,67584,8,7321277131
436,1742970,5412927,7155897,9,0,0,47616,19,2306327387
437,1743310,17602966,19346276,6,0,1,8704,5,9672881463
438,1744180,2221819,3965999,4,0,0,2048,4,3199613000
439,1746380,17623373,19369753,0,0,1,1536,5,8781537221
440,1747740,2230473,3978213,7,0,0,13312,8,4889076179
441,1750250,4200683,5950933,4,0,0,155648,4,8429623041
442,1751790,4600909,6352699,1,0,0,47616,14,3499069915
443,1763280,5098222,6861502,1,0,0,28672,14,4026698909
444,1764650,17861194,19625844,0,0,1,19968,5,1505651334
445,1769630,3361576,5131206,2,0,0,14336,15,9880236597
446,1787580,2704910,4492490,8,0,0,13312,13,5625142040
447,1787740,17858359,19646099,8,0,1,12288,13,5895185393
448,1791940,3299831,5091771,0,0,0,6656,5,2349836657
449,1802150,905321,2707471,8,0,0,7168,13,4752443583
450,1807400,932040,2739440,7,0,0,1024,8,10166387271
451,1810400,2379828,4190228,9,0,0,3584,19,9032068681
452,1810850,2411820,4222670,9,0,0,29696,19,6709695581
453,1812360,2738497,4550857,7,0,0,16384,8,8988561976
454,1812370,2877967,4690337,0,0,0,4096,5,2616532779
455,1814430,4222531,6036961,1,0,0,30208,14,10172860382
456,1827191,17818931,19646122,7,0,1,10752,8,8974779991
457,1829680,2298847,4128527,5,0,0,11776,8,3632668040
458,1844460,4721024,6565484,3,0,0,33792,12,4480079539
459,1844470,4126017,5970487,3,0,0,12800,12,8843432146
460,1850311,17986500,19836811,2,0,1,30720,15,2858535192
461,1852650,3766195,5618845,5,0,0,15872,8,8051782176
462,1857220,4629563,6486783,1,0,0,60416,14,7522796977
463,1857550,18098081,19955631,9,0,1,3072,19,8037362921
464,1860390,1375254,3235644,0,0,0,9216,5,4312114540
465,1862040,3075870,4937910,1,0,0,6144,14,6800243905
466,1864260,5263480,7127740,1,0,0,51712,14,2851116989
467,1865330,2935834,4801164,3,0,0,36352,12,10110262971
468,1873030,4937110,6810140,6,0,0,10752,5,8732261048
469,1873600,3516404,5390004,1,0,0,31232,14,6244127623
470,1882901,18072753,19955654,5,0,1,512,8,7733518616
471,1883370,2225550,4108920,5,0,0,7168,8,4197537088
472,1884090,2428126,4312216,4,0,0,19968,4,9716148710
473,1885370,1312858,3198228,8,0,0,41472,13,2443421297
474,1887610,4376144,6263754,8,0,0,5120,13,2772150148
475,1901220,623898,2525118,1,0,0,12800,14,2599102017
476,1903720,2161741,4065461,4,0,0,45568,4,1508574176
477,1917260,1171241,3088501,7,0,0,6656,8,6003211018
478,1924650,5376526,7301176,9,0,0,8704,19,9350617804
479,1925170,3819875,5745045,6,0,0,12800,5,9672983695
480,1925270,5870242,7795512,7,0,0,54784,8,8245716331
481,1930970,4773900,6704870,8,0,0,39424,13,10201519018
482,1940870,3179495,5120365,3,0,0,82432,12,5733490630
483,1942010,2441680,4383690,0,0,0,16384,5,10073985544
484,1949460,2741680,4691140,1,0,0,2560,14,8784849574
485,1953270,18002407,19955677,0,0,1,10240,5,7468415519
486,1955061,18004680,19959741,5,0,1,2560,8,1158347756
487,1955440,3835739,5791179,5,0,0,3072,8,8827930351
488,1969210,4198537,6167747,4,0,0,31744,4,4863359449
489,1971740,3324001,5295741,4,0,0,15360,4,8030061816
490,1972970,3809832,5782802,8,0,0,6144,13,8222966850
491,1973400,3266717,5240117,3,0,0,15872,12,9680445563
492,1973430,4978877,6952307,9,0,0,5120,19,9677189145
493,1976640,3144996,5121636,4,0,0,4096,4,3934773009
494,1984971,17977036,19962007,7,0,1,3584,8,917788446
495,2000800,6292811,8293611,3,0,0,67072,12,9981318735
496,2007930,4942794,6950724,6,0,0,34816,5,3158075815
497,2011740,4819146,6830886,8,0,0,20992,13,10103442690
498,2013670,2669102,4682772,9,0,0,88576,19,3714061874
499,2016071,17947242,19963313,5,0,1,2048,8,8208037735
500,2016441,18593113,20609554,2,0,1,280064,15,3971036790
501,2027890,18587014,20614904,9,0,1,2560,19,8881334652
502,2037470,5589698,7627168,4,0,0,14848,4,9769353435
503,2038730,4429622,6468352,5,0,0,20480,8,3851773309
504,2039040,18575887,20614927,4,0,1,1536,4,10564762498
505,2047070,4176719,6223789,6,0,0,13824,5,4077652206
506,2047200,4518775,6565975,4,0,0,1536,4,1626429457
507,2052281,18562669,20614950,7,0,1,512,8,6861062912
508,2054290,4103762,6158052,4,0,0,92160,4,8888896499
509,2055270,18559703,20614973,4,0,1,1536,4,4484085521
510,2059910,1813312,3873222,0,0,0,1536,5,5476133663
511,2067030,6005328,8072358,5,0,0,6144,8,6591043751
512,2072860,3326527,5399387,1,0,0,30720,14,9921466639
513,2079490,4316380,6395870,8,0,0,8704,13,3562990796
514,2085440,2958258,5043698,4,0,0,34816,4,1036647718
515,2087170,18547808,20634978,8,0,1,29696,13,2458150561
516,2090890,5075669,7166559,0,0,0,23040,5,6690890702
517,2093840,3197198,5291038,4,0,0,12288,4,1159632471
518,2098241,18568957,20667198,7,0,1,5120,8,1846769716
519,2098580,4238085,6336665,5,0,0,13824,8,480717876
520,2101499,18565722,20667221,8,0,1,3072,13,7203072787
521,2102930,4257904,6360834,0,0,0,26624,5,8814736097
522,2104640,5281809,7386449,6,0,0,13312,5,5150921836
523,2111440,3927728,6039168,3,0,0,7168,12,7391778187
524,2111620,4643940,6755560,5,0,0,23552,8,1625804845
525,2118310,5087294,7205604,3,0,0,79872,12,4194711639
526,2118400,3115899,5234299,4,0,0,18432,4,8371244587
527,2119510,4774889,6894399,3,0,0,11776,12,9178361931
528,2124101,18543143,20667244,5,0,1,8704,8,509181089
529,2126370,3087424,5213794,0,0,0,77312,5,9207123342
530,2128330,3055336,5183666,1,0,0,3584,14,1440760962
531,2132550,2962676,5095226,7,0,0,11264,8,6250740552
532,2135030,18653029,20788059,3,0,1,13312,12,9607250627
533,2135660,3830904,5966564,5,0,0,51200,8,7153787129
534,2142450,5315002,7457452,8,0,0,1024,13,3302876115
535,2145580,1638648,3784228,6,0,0,13312,5,8049385116
536,2147000,2570047,4717047,6,0,0,8192,5,2151992545
537,2147430,3165540,5312970,6,0,0,14336,5,2879225637
538,2148170,5468812,7616982,3,0,0,52736,12,7779559779
539,2150440,4591011,6741451,6,0,0,105472,5,42537060
540,2150520,3285300,5435820,3,0,0,16384,12,5443833510
541,2151470,18637307,20788777,6,0,1,19456,5,7930572874
542,2153160,4396788,6549948,5,0,0,54272,8,555920449
543,2163991,3304439,5468430,0,0,0,17920,5,86495748
544,2174251,6488461,8662712,0,0,0,88064,5,9719414333
545,2175190,2296506,4471696,6,0,0,15872,5,663805291
546,2175290,4260905,6436195,4,0,0,34304,4,212130479
547,2199790,18613669,20813459,6,0,1,20992,5,5758860710
548,2203230,3143782,5347012,9,0,0,5632,19,9392040047
549,2206710,759856,2966566,5,0,0,1024,8,979814745
550,2209350,3221447,5430797,6,0,0,62976,5,3827879302
551,2218940,18613053,20831993,9,0,1,7680,19,5982402508
552,2220510,2912242,5132752,9,0,0,1024,19,5646451652
553,2221900,3215659,5437559,7,0,0,5632,8,6841897183
554,2230040,2753748,4983788,8,0,0,40960,13,7961401557
555,2237080,825408,3062488,0,0,0,2048,5,2149391946
556,2238800,6837364,9076164,4,0,0,35840,4,7074134199
557,2249520,3076998,5326518,3,0,0,25600,12,213680390
558,2256060,18575956,20832016,3,0,1,1536,12,3726806738
559,2259190,4015070,6274260,0,0,0,25088,5,9416824635
560,2261720,2338736,4600456,5,0,0,33792,8,7657544591
561,2280130,3158700,5438830,1,0,0,4096,14,1496644866
562,2283610,18548429,20832039,9,0,1,512,19,1547458321
563,2291940,4241449,6533389,5,0,0,66560,8,84652129
564,2293010,4262155,6555165,2,0,0,1024,15,3228256691
565,2296740,2096714,4393454,6,0,0,1024,5,5184859099
566,2305060,1746494,4051554,4,0,0,19968,4,2506427964
567,2309710,4367571,6677281,5,0,0,89600,8,2542299082
568,2314420,836114,3150534,6,0,0,7168,5,1987601716
569,2316450,2943892,5260342,8,0,0,1536,13,7209804089
570,2321020,18511042,20832062,3,0,1,3072,12,1769962292
571,2321840,6604330,8926170,1,0,0,58880,14,3714048623
572,2324080,4059732,6383812,3,0,0,38400,12,10535192600
573,2326560,2516832,4843392,3,0,0,36352,12,3293630532
574,2329230,18541466,20870696,3,0,1,6656,12,4206898657
575,2332550,5029650,7362200,8,0,0,25600,13,8298727022
576,2342280,3919891,6262171,2,0,0,51200,15,9329818512
577,2343280,3119667,5462947,4,0,0,24576,4,4880747859
578,2356050,6051677,8407727,2,0,0,44032,15,2955190176
579,2356741,5534596,7891337,0,0,0,64000,5,6173753230
580,2358600,4415859,6774459,6,0,0,61952,5,7722067450
581,2358610,4967087,7325697,5,0,0,2560,8,1553629983
582,2370090,2039422,4409512,1,0,0,9216,14,4147213655
583,2370130,3521868,5891998,5,0,0,13312,8,1670267458
584,2371940,4737435,7109375,8,0,0,48640,13,3877091643
585,2373970,1342733,3716703,0,0,0,24064,5,2283541069
586,2381100,4121104,6502204,8,0,0,15360,13,1897849611
587,2381810,3634349,6016159,2,0,0,29184,15,573621701
588,2389470,18481428,20870898,0,0,1,1536,5,7978728207
589,2390180,2854958,5245138,8,0,0,2048,13,8487223586
590,2401150,18481712,20882862,0,0,1,6656,5,5995290130
591,2406680,4384090,6790770,2,0,0,15360,15,1088677640
592,2411030,5071717,7482747,1,0,0,13824,14,6837673939
593,2415651,18788155,21203806,2,0,1,72704,15,66518555
594,2418740,4549369,6968109,4,0,0,15360,4,4828968581
595,2421370,18810500,21231870,8,0,1,7168,13,2115889570
596,2432020,3145033,5577053,6,0,0,20992,5,8697530619
597,2437130,2869554,5306684,1,0,0,35840,14,789952395
598,2437220,18794906,21232126,6,0,1,9216,5,8604998067
599,2438571,942325,3380896,0,0,0,10752,5,1030655304
600,2438970,2344935,4783905,6,0,0,9728,5,10059755740
601,2451800,1071594,3523394,0,0,0,3584,5,9483109024
602,2453020,485447,2938467,0,0,0,6144,5,7903817452
603,2453230,4929140,7382370,9,0,0,59904,19,182090414
604,2456170,4452209,6908379,3,0,0,34304,12,9600701164
605,2464630,3907459,6372089,6,0,0,36864,5,4385641228
606,2471840,18850978,21322818,3,0,1,17920,12,9115344538
607,2474061,3834452,6308513,0,0,0,37376,5,5429200929
608,2480690,3797048,6277738,1,0,0,2560,14,181693237
609,2485390,6312581,8797971,4,0,0,10240,4,2035285934
610,2490530,4789521,7280051,8,0,0,6656,13,6624349010
611,2492390,4574466,7066856,9,0,0,39936,19,9628795666
612,2499480,2688724,5188204,6,0,0,1536,5,3604862925
613,2510840,3230282,5741122,3,0,0,3584,12,7973713169
614,2511490,4521037,7032527,0,0,0,1536,5,6085744098
615,2518040,6847824,9365864,4,0,0,55808,4,2119048794
616,2529750,3249075,5778825,5,0,0,33280,8,1497906487
617,2538400,18830966,21369366,4,0,1,11776,4,2629937033
618,2542150,3431488,5973638,8,0,0,10240,13,10201745469
619,2544240,3542512,6086752,6,0,0,6144,5,1633039667
620,2545680,18835731,21381411,0,0,1,26112,5,5981240743
621,2550800,5945980,8496780,4,0,0,26112,4,5071817847
622,2555810,4710950,7266760,1,0,0,7168,14,5381187852
623,2556890,7094858,9651748,5,0,0,6656,8,3192171160
624,2557800,3424920,5982720,4,0,0,10752,4,559495664
625,2559500,2268934,4828434,9,0,0,43008,19,1765990711
626,2563760,3196731,5760491,9,0,0,13824,19,2780568628
627,2564470,3545604,6110074,6,0,0,41984,5,6371492139
628,2571081,18865830,21436911,7,0,1,10240,8,3301171896
629,2571490,3837763,6409253,9,0,0,10752,19,9167007779
630,2576270,1802405,4378675,8,0,0,3584,13,4288033663
631,2576670,4880447,7457117,9,0,0,57344,19,1810803703
632,2587000,4096232,6683232,1,0,0,19456,14,6423963974
633,2589300,4944669,7533969,8,0,0,16384,13,1527188212
634,2590740,18846194,21436934,4,0,1,3072,4,3618140885
635,2594500,1409258,4003758,4,0,0,5120,4,4162172281
636,2600890,3614950,6215840,6,0,0,51712,5,10301187539
637,2609770,4075201,6684971,6,0,0,5632,5,2785930544
638,2615990,3107014,5723004,5,0,0,25600,8,1153153462
639,2618200,18835027,21453227,3,0,1,4608,12,10646972392
640,2629880,3258039,5887919,6,0,0,14848,5,7053879268
641,2635221,19507640,22142861,2,0,1,287744,15,4289387920
642,2641810,6394376,9036186,8,0,0,23552,13,3123462105
643,2647690,6283339,8931029,2,0,0,15872,15,2115325859
644,2651200,3168256,5819456,4,0,0,12800,4,6386864318
645,2653570,3249916,5903486,3,0,0,3072,12,5830240234
646,2666730,4623538,7290268,3,0,0,8704,12,6308905720
647,2667670,3501036,6168706,5,0,0,3072,8,6255227120
648,2676510,3973448,6649958,8,0,0,55808,13,4994969471
649,2689260,7107405,9796665,2,0,0,34304,15,2609180271
650,2695960,1959801,4655761,1,0,0,13312,14,3437725301
651,2704010,6258429,8962439,9,0,0,61440,19,7413528857
652,2704230,3846521,6550751,4,0,0,2560,4,9657318305
653,2723131,19429854,22152985,2,0,1,3584,15,5651466142
654,2724250,3848152,6572402,3,0,0,20992,12,7462872852
655,2724520,4493275,7217795,2,0,0,39936,15,1313114524
656,2729981,19485749,22215730,5,0,1,512,8,3554155101
657,2735880,4656520,7392400,6,0,0,19456,5,4270719515
658,2754060,6033194,8787254,0,0,0,7168,5,6554971527
659,2754750,3993276,6748026,4,0,0,21504,4,4456895483
660,2757820,4640391,7398211,2,0,0,18944,15,10082402104
661,2765770,19449983,22215753,0,0,1,2560,5,7842461715
662,2766660,6262327,9028987,9,0,0,68608,19,466881093
663,2769090,3344576,6113666,5,0,0,5120,8,5369958571
664,2776260,6678630,9454890,9,0,0,15872,19,3220000707
665,2782050,5023512,7805562,5,0,0,29696,8,10667134999
666,2784880,3113381,5898261,9,0,0,20480,19,1690666428
667,2785960,5407955,8193915,4,0,0,79360,4,1923660999
668,2785980,1115245,3901225,8,0,0,4608,13,10094774844
669,2794450,6709578,9504028,4,0,0,23552,4,5930903419
670,2797090,6821665,9618755,4,0,0,39424,4,8780868208
671,2798080,2146405,4944485,4,0,0,21504,4,3946701452
672,2800870,1888196,4689066,1,0,0,4096,14,8420683581
673,2808730,4350786,7159516,8,0,0,11776,13,7716646825
674,2809800,5711869,8521669,4,0,0,9728,4,10114026363
675,2809970,3251375,6061345,1,0,0,3072,14,6503991932
676,2821260,5100098,7921358,3,0,0,17920,12,8709682922
677,2836330,19422375,22258705,4,0,1,35840,4,131245821
678,2838720,6104976,8943696,9,0,0,41472,19,10297910777
679,2840830,19491793,22332623,4,0,1,9216,4,7697113365
680,2853381,19479498,22332879,7,0,1,9216,8,7492352089
681,2859580,6970695,9830275,6,0,0,72192,5,3763744616
682,2868061,19505575,22373636,7,0,1,23552,8,2554220383
683,2872720,4150164,7022884,1,0,0,30208,14,8105102742
684,2876990,4234592,7111582,6,0,0,7168,5,1768533098
685,2891820,5462412,8354232,2,0,0,61440,15,739179077
686,2901170,3916453,6817623,9,0,0,16896,19,2414327642
687,2904630,3710976,6615606,1,0,0,20480,14,7257868931
688,2906460,19471114,22377574,0,0,1,2560,5,3356745770
689,2916000,5519252,8435252,0,0,0,35328,5,763545806
690,2916860,4324225,7241085,1,0,0,52736,14,1089226250
691,2920450,2319846,5240296,4,0,0,512,4,53273696
692,2922961,19455527,22378488,5,0,1,5120,8,1041291765
693,2928580,4799417,7727997,8,0,0,54784,13,277757401
694,2929010,7092552,10021562,9,0,0,15872,19,10058088114
695,2930260,4758416,7688676,6,0,0,5120,5,369474590
696,2932630,3468754,6401384,9,0,0,4608,19,6689328132
697,2935980,5480194,8416174,8,0,0,27648,13,56148727
698,2936010,5145762,8081772,3,0,0,13312,12,563302388
699,2941230,4235182,7176412,1,0,0,2560,14,9622389857
700,2943420,5310568,8253988,5,0,0,4608,8,1692215544
701,2943600,6779811,9723411,4,0,0,23552,4,2711795576
702,2947990,4847857,7795847,3,0,0,1024,12,3975640908
703,2952520,5088207,8040727,4,0,0,18432,4,2106604507
704,2957410,5707665,8665075,0,0,0,7680,5,4923516113
705,2963501,19588259,22551760,7,0,1,8192,8,6674715953
706,2972461,19587613,22560074,5,0,1,8192,8,4691256084
707,2977310,4931522,7908832,5,0,0,57344,8,8496697110
708,2978260,3961833,6940093,3,0,0,30208,12,9425046436
709,2988400,4968418,7956818,4,0,0,38912,4,4911556047
710,3000280,5059552,8059832,1,0,0,53248,14,9987248137
711,3002570,19557527,22560097,0,0,1,512,5,4785110901
712,3006730,4660375,7667105,9,0,0,13312,19,5627373127
713,3007940,19564870,22572810,3,0,1,30208,12,843407570
714,3009790,19580171,22589961,0,0,1,12288,5,10044103436
715,3013700,4402802,7416502,0,0,0,28672,5,1742651372
716,3017660,4743619,7761279,8,0,0,50688,13,5202081008
717,3021010,4117829,7138839,6,0,0,36352,5,611475608
718,3023060,5241645,8264705,2,0,0,6656,15,8000990776
719,3025300,19564684,22589984,3,0,1,7680,12,2347647319
720,3027340,3972142,6999482,8,0,0,26112,13,917644532
721,3030480,4456034,7486514,2,0,0,12288,15,8932021499
722,3031460,5967061,8998521,2,0,0,69632,15,5249935470
723,3036930,5399601,8436531,0,0,0,4096,5,5618814479
724,3051510,19541484,22592994,4,0,1,2560,4,1802149522
725,3055170,19589713,22644883,3,0,1,20992,12,8654546118
726,3055800,6049934,9105734,6,0,0,9728,5,1429375223
727,3062750,3835154,6897904,2,0,0,8192,15,7313909433
728,3064120,3916519,6980639,8,0,0,7680,13,8981211635
729,3072390,3940324,7012714,3,0,0,1536,12,3709383863
730,3088710,7017378,10106088,9,0,0,80896,19,768160424
731,3089250,19568706,22657956,4,0,1,512,4,1814035052
732,3094930,19564332,22659262,2,0,1,2048,15,8256689637
733,3104031,19559954,22663985,2,0,1,3072,15,6928705722
734,3108380,3297574,6405954,0,0,0,12800,5,4121728994
735,3111030,19554364,22665394,4,0,1,6656,4,1686695738
736,3112331,19613612,22725943,2,0,1,11264,15,3244515180
737,3121330,4126080,7247410,2,0,0,5120,15,10554635981
738,3133860,6044510,9178370,6,0,0,68608,5,784583181
739,3135970,5690240,8826210,2,0,0,12288,15,2683779017
740,3136610,1296171,4432781,0,0,0,4096,5,4404162376
741,3138330,4932133,8070463,8,0,0,34816,13,987707419
742,3143010,4541278,7684288,8,0,0,56320,13,7572865582
743,3149680,4328832,7478512,1,0,0,44544,14,2672214464
744,3157450,2507548,5664998,7,0,0,18432,8,6951132085
745,3160460,3352626,6513086,3,0,0,19968,12,4627738064
746,3164680,5082055,8246735,8,0,0,41472,13,6489289471
747,3164730,4408312,7573042,4,0,0,20480,4,8747597916
748,3168851,19673095,22841946,2,0,1,24576,15,9075437154
749,3175050,5249415,8424465,1,0,0,27136,14,1350036251
750,3185210,6264821,9450031,2,0,0,56832,15,5102068762
751,3190650,4915334,8105984,2,0,0,1536,15,9665292327
752,3191210,4470576,7661786,5,0,0,59392,8,5774368050
753,3197840,19676912,22874752,3,0,1,10752,12,7967722309
754,3199240,5249201,8448441,3,0,0,35840,12,7603553077
755,3201890,5856213,9058103,9,0,0,28672,19,8073802301
756,3204110,4041717,7245827,3,0,0,7680,12,4136940186
757,3205419,19669356,22874775,8,0,1,1024,13,8903711781
758,3206230,2205348,5411578,0,0,0,39936,5,10230232629
759,3212260,5643214,8855474,3,0,0,15872,12,1617928190
760,3218340,5576488,8794828,5,0,0,12800,8,3648866309
761,3222790,6065513,9288303,2,0,0,67584,15,6325466569
762,3225181,19649617,22874798,7,0,1,2048,8,674765598
763,3225350,4279886,7505236,8,0,0,11264,13,9065565697
764,3230160,5495151,8725311,6,0,0,40448,5,4452328457
765,3230560,4480722,7711282,0,0,0,36352,5,6884049797
766,3236910,6226458,9463368,8,0,0,18944,13,2288869262
767,3240590,19793354,23033944,3,0,1,22016,12,10065800964
768,3246700,6770003,10016703,1,0,0,95744,14,2489157507
769,3247291,19809223,23056514,7,0,1,7168,8,2616083918
770,3247560,4908818,8156378,1,0,0,31232,14,8735974876
771,3250490,1481218,4731708,3,0,0,1024,12,8670751855
772,3253320,7018162,10271482,6,0,0,32768,5,3235442291
773,3254580,5596035,8850615,2,0,0,20480,15,2836540300
774,3263690,5343865,8607555,8,0,0,7168,13,7541262069
775,3267370,19851624,23118994,4,0,1,18944,4,117451433
776,3268139,19850886,23119025,1,0,1,24576,14,396487811
777,3272010,3979167,7251177,3,0,0,12288,12,5191209732
778,3273320,4472484,7745804,8,0,0,58368,13,538996822
779,3278880,4046014,7324894,8,0,0,15360,13,5868142312
780,3285640,19842053,23127693,0,0,1,5120,5,10311822791
781,3290130,4141892,7432022,9,0,0,27136,19,9482600071
782,3298549,19844263,23142812,1,0,1,19456,14,1914048422
783,3301280,19886172,23187452,9,0,1,512,19,3194314443
784,3302721,19887637,23190358,2,0,1,4608,15,7465995548
785,3305081,19888183,23193264,5,0,1,4608,8,1303110554
786,3319960,4366450,7686410,7,0,0,5120,8,5316774333
787,3322431,19875339,23197770,5,0,1,7168,8,6124659199
788,3329000,2538454,5867454,1,0,0,6656,14,6785476319
789,3330490,6912219,10242709,2,0,0,44544,15,9285658303
790,3331170,4008520,7339690,8,0,0,44032,13,4736738652
791,3340040,3214790,6554830,0,0,0,13312,5,8237010884
792,3340670,5481773,8822443,8,0,0,71168,13,1851661767
793,3340681,19886603,23227284,5,0,1,12288,8,5891219007
794,3342789,19887401,23230190,8,0,1,4608,13,6794442728
795,3343860,1460135,4803995,2,0,0,9216,15,5380463009
796,3344530,3880464,7224994,1,0,0,23552,14,8338925769
797,3354640,4679590,8034230,2,0,0,4096,15,3781054498
798,3355080,6453152,9808232,7,0,0,37888,8,2567742315
799,3359291,19950300,23309591,7,0,1,9728,8,250112485
800,3368120,19969475,23337595,9,0,1,17920,19,6549596838
801,3368570,6128259,9496829,0,0,0,25600,5,4725495987
802,3373359,19971458,23344817,1,0,1,11264,14,441165069
803,3387930,4757798,8145728,4,0,0,26112,4,3540493358
804,3389910,2512609,5902519,0,0,0,5632,5,9556449428
805,3392010,19952830,23344840,9,0,1,7680,19,7987683702
806,3410140,5108542,8518682,5,0,0,8192,8,3738605573
807,3416190,6917773,10333963,4,0,0,17920,4,6122036411
808,3417210,3724148,7141358,7,0,0,8192,8,6917615194
809,3422410,4518627,7941037,2,0,0,64512,15,5332540064
810,3423760,5306566,8730326,5,0,0,16384,8,1192688151
811,3425389,19948120,23373509,8,0,1,1536,13,5429287024
812,3427860,7053914,10481774,6,0,0,7168,5,8248903056
813,3429010,2327246,5756256,1,0,0,25088,14,8892019029
814,3433280,2607159,6040439,2,0,0,4096,15,6771043257
815,3435320,5857062,9292382,7,0,0,13312,8,649927215
816,3436050,7500083,10936133,8,0,0,2560,13,9853216186
817,3436610,5643009,9079619,9,0,0,11264,19,8286958089
818,3436950,5571110,9008060,8,0,0,31232,13,9842811851
819,3437580,6294145,9731725,2,0,0,8704,15,3616980888
820,3449270,7372552,10821822,8,0,0,2560,13,10473703093
821,3449770,5747077,9196847,7,0,0,13824,8,1481510442
822,3450300,7310188,10760488,0,0,0,47616,5,3848056447
823,3454990,5877793,9332783,1,0,0,38912,14,4203999977
824,3457360,1274013,4731373,4,0,0,4096,4,6589218535
825,3465690,4902940,8368630,9,0,0,40448,19,6064033942
826,3471470,5649237,9120707,8,0,0,2560,13,2586819840
827,3477739,19895793,23373532,1,0,1,2560,14,3202014638
828,3479460,19894095,23373555,2,0,1,3584,15,2095823379
829,3484040,2086594,5570634,3,0,0,1536,12,3922464496
830,3486330,3222954,6709284,5,0,0,13824,8,2265708459
831,3486680,4292117,7778797,2,0,0,51712,15,10620818885
832,3489450,5925061,9414511,4,0,0,26624,4,7845409782
833,3489880,5942812,9432692,2,0,0,25600,15,7388661257
834,3493740,19879838,23373578,9,0,1,5632,19,7729544465
835,3497390,2779545,6276935,8,0,0,8704,13,9845519265
836,3498410,6998230,10496640,2,0,0,9216,15,1274286803
837,3501930,7588420,11090350,8,0,0,9216,13,4139092883
838,3505880,5238780,8744660,5,0,0,6144,8,4290112808
839,3511960,3755915,7267875,4,0,0,3584,4,3816053605
840,3512620,3951118,7463738,9,0,0,15872,19,1284807584
841,3519221,19912756,23431977,5,0,1,26624,8,7359363492
842,3524130,5725164,9249294,8,0,0,13824,13,9466011135
843,3524380,6776285,10300665,1,0,0,75776,14,8997837352
844,3527030,4746122,8273152,2,0,0,27648,15,10713682384
845,3528670,20206062,23734732,3,0,1,38912,12,7055869876
846,3533980,7641743,11175723,8,0,0,27648,13,3182226077
847,3540030,20372646,23912676,9,0,1,57344,19,6012917252
848,3541600,4536085,8077685,8,0,0,17408,13,4174587491
849,3543529,20438340,23981869,1,0,1,4096,14,10437958713
850,3552200,4541690,8093890,1,0,0,18432,14,883156428
851,3552860,5830410,9383270,4,0,0,40960,4,5381430722
852,3555061,20426831,23981892,7,0,1,2560,8,4119889446
853,3555350,4645296,8200646,8,0,0,22016,13,7947828219
854,3557410,20430144,23987554,2,0,1,1024,15,8599705471
855,3564330,21284305,24848635,9,0,1,330752,19,9777395295
856,3564760,7156316,10721076,1,0,0,105472,14,4138495151
857,3568610,4303204,7871814,7,0,0,25600,8,7235133059
858,3568960,7235868,10804828,7,0,0,35840,8,2616035194
859,3569880,21279101,24848981,0,0,1,512,5,10067146015
860,3571780,1714995,5286775,0,0,0,8192,5,3571989581
861,3572620,7331707,10904327,4,0,0,44544,4,3267889053
862,3579339,21383591,24962930,1,0,1,19456,14,10670445751
863,3583230,6378402,9961632,4,0,0,27136,4,2296822773
864,3588410,2823674,6412084,0,0,0,9216,5,10298252795
865,3590650,2802545,6393195,8,0,0,30720,13,8854308153
866,3598970,2667623,6266593,9,0,0,9216,19,4239863496
867,3601650,21364826,24966476,8,0,1,5632,13,6900206140
868,3602220,4060057,7662277,5,0,0,1536,8,1608801207
869,3604420,4925818,8530238,4,0,0,14336,4,4075248954
870,3604590,4500248,8104838,1,0,0,13312,14,8690424087
871,3605450,6911805,10517255,1,0,0,67584,14,951838310
872,3605491,3654445,7259936,0,0,0,28672,5,3066896458
873,3608720,5880278,9488998,4,0,0,51712,4,6247771056
874,3610660,3352746,6963406,6,0,0,36352,5,2793851997
875,3611960,6747672,10359632,4,0,0,8704,4,1058544399
876,3615210,21356092,24971302,9,0,1,7680,19,20393608
877,3616120,21394265,25010385,9,0,1,23040,19,4201381137
878,3616810,5928589,9545399,5,0,0,135680,8,3500228761
879,3622320,21388088,25010408,0,0,1,2048,5,10714690694
880,3628800,6014938,9643738,1,0,0,81920,14,1536350323
881,3631740,7216983,10848723,4,0,0,9216,4,4513668281
882,3650450,21957606,25608056,3,0,1,345088,12,7515060518
883,3663230,21982477,25645707,8,0,1,9216,13,4151379600
884,3665390,4568686,8234076,5,0,0,76800,8,4745157155
885,3666430,4586123,8252553,7,0,0,17920,8,2002925739
886,3673360,7289581,10962941,9,0,0,15872,19,10028131221
887,3681830,3672547,7354377,5,0,0,48128,8,125213981
888,3687130,1981011,5668141,4,0,0,10240,4,44601708
889,3687930,1096395,4784325,6,0,0,1024,5,5774328296
890,3688930,21956800,25645730,4,0,1,512,4,2043564994
891,3689410,6026467,9715877,2,0,0,26624,15,656564202
892,3709780,21942704,25652484,4,0,1,8192,4,2117279347
893,3716800,6217775,9934575,1,0,0,24064,14,1824422095
894,3716850,6307566,10024416,7,0,0,5120,8,6462802307
895,3716900,21951854,25668754,8,0,1,7168,13,4654183275
896,3719201,21958647,25677848,5,0,1,3584,8,7297839846
897,3722191,21955680,25677871,5,0,1,2048,8,4243896051
898,3729871,21948023,25677894,5,0,1,6656,8,1504182020
899,3730371,21966243,25696614,7,0,1,3584,8,10399199813
900,3738260,4631329,8369589,0,0,0,3072,5,9134173993
901,3744330,5315847,9060177,0,0,0,1024,5,8822449976
902,3747110,7814289,11561399,9,0,0,40960,19,3652393588
903,3750930,5093422,8844352,7,0,0,17408,8,8480370721
904,3751290,7923285,11674575,4,0,0,87552,4,5870324556
905,3751970,21944699,25696669,4,0,1,4096,4,805330513
906,3754880,22282083,26036963,3,0,1,292864,12,7274814530
907,3755400,6197941,9953341,7,0,0,31232,8,10734893838
908,3755409,22284780,26040189,8,0,1,5120,13,1309177931
909,3759941,4807511,8567452,0,0,0,35328,5,1161078622
910,3759990,22283745,26043735,2,0,1,5632,15,4631373230
911,3766370,3996648,7763018,6,0,0,5632,5,2686788026
912,3766870,4721029,8487899,2,0,0,2048,15,2848406878
913,3768410,6833809,10602219,8,0,0,168448,13,1074728582
914,3773131,4559059,8332190,0,0,0,69120,5,10480449597
915,3777670,4480709,8258379,7,0,0,14336,8,1708765327
916,3779210,1813469,5592679,6,0,0,11776,5,8585578817
917,3780540,7335338,11115878,4,0,0,5632,4,4672050300
918,3786510,6282123,10068633,1,0,0,47616,14,3686463139
919,3809211,4204293,8013504,0,0,0,512,5,10191217061
920,3810930,4150279,7961209,6,0,0,14336,5,4017987561
921,3815439,22230242,26045681,8,0,1,3072,13,2839565772
922,3829910,3534185,7364095,2,0,0,6144,15,9385044277
923,3831620,4636692,8468312,7,0,0,35840,8,1750899549
924,3835370,3749164,7584534,8,0,0,11776,13,6515300293
925,3842810,5277094,9119904,8,0,0,28160,13,7616888964
926,3849850,4836630,8686480,8,0,0,65536,13,7563571212
927,3855710,6167123,10022833,6,0,0,4096,5,1464187109
928,3859790,2540167,6399957,4,0,0,13312,4,7417385575
929,3863000,22279430,26142430,3,0,1,48640,12,6943508501
930,3864040,2841009,6705049,8,0,0,512,13,4462179681
931,3865760,6262704,10128464,9,0,0,23552,19,9891313109
932,3867711,6877911,10745622,0,0,0,61440,5,9023319757
933,3873450,4136200,8009650,9,0,0,4096,19,9881839810
934,3875170,4371900,8247070,8,0,0,1024,13,6054228670
935,3876829,22265947,26142776,1,0,1,512,14,4124917408
936,3878250,5162639,9040889,6,0,0,15360,5,3722896691
937,3888300,4777578,8665878,7,0,0,2560,8,3678929116
938,3896630,5470505,9367135,8,0,0,4096,13,3380082343
939,3906070,6204877,10110947,7,0,0,15872,8,589105392
940,3906380,4844868,8751248,7,0,0,2560,8,8160042798
941,3908840,7093286,11002126,5,0,0,47616,8,7318404523
942,3921509,22221613,26143122,8,0,1,512,13,2249083379
943,3922910,7416289,11339199,2,0,0,2048,15,8477116094
944,3929810,3332877,7262687,8,0,0,5120,13,3371300947
945,3932960,3471537,7404497,7,0,0,12288,8,7473883792
946,3934531,5640421,9574952,0,0,0,47616,5,9513974218
947,3937230,4689854,8627084,5,0,0,25088,8,7565913818
948,3949440,5243172,9192612,6,0,0,28160,5,7674408114
949,3950660,7094982,11045642,3,0,0,61440,12,10248653804
950,3951930,4787470,8739400,4,0,0,2048,4,6115036531
951,3953700,7858233,11811933,7,0,0,23040,8,3195816614
952,3959900,5914124,9874024,5,0,0,53760,8,4428507644
953,3963310,6265804,10229114,1,0,0,90624,14,4498819539
954,3964730,7273023,11237753,1,0,0,62976,14,6571348251
955,3973250,22223762,26197012,3,0,1,45568,12,731357030
956,3977431,22242896,26220327,5,0,1,1536,8,9155075690
957,3979001,22241349,26220350,7,0,1,1536,8,4426895182
958,3980080,4376203,8356283,4,0,0,6656,4,6444612507
959,3983780,4034826,8018606,5,0,0,13312,8,2923293232
960,3988600,5797574,9786174,5,0,0,62464,8,4096930049
961,3988960,22231413,26220373,9,0,1,2560,19,3728895859
962,4002920,2745441,6748361,6,0,0,1024,5,2420043495
963,4007430,5845488,9852918,2,0,0,74240,15,10299075147
964,4012431,22208950,26221381,2,0,1,5632,15,6495746727
965,4014830,4195823,8210653,9,0,0,32768,19,1630976084
966,4016400,6058504,10074904,6,0,0,20480,5,1720089572
967,4019540,22202507,26222047,6,0,1,1024,5,1228310344
968,4023000,2379031,6402031,5,0,0,2048,8,2787709026
969,4023491,22233405,26256896,5,0,1,6144,8,9640555959
970,4025680,2964240,6989920,5,0,0,12800,8,1728837476
971,4028189,22245498,26273687,8,0,1,27136,13,4961711502
972,4034539,22306347,26340886,8,0,1,4096,13,3212746396
973,4043270,4292219,8335489,7,0,0,10752,8,9461756810
974,4056249,22305919,26362168,1,0,1,22528,14,3021778256
975,4056600,22307785,26364385,0,0,1,1536,5,8038715988
976,4063400,7183588,11246988,7,0,0,30208,8,2478709710
977,4063530,22301521,26365051,4,0,1,1024,4,6376464781
978,4070430,22298807,26369237,0,0,1,6656,5,10356652887
979,4071280,7269190,11340470,8,0,0,4096,13,4016234621
980,4072760,3843115,7915875,4,0,0,23040,4,2028379271
981,4077560,3226994,7304554,2,0,0,3584,15,1075926394
982,4083980,22324630,26408610,2,0,1,19456,15,3322552309
983,4085600,5811916,9897516,6,0,0,60416,5,6254483054
984,4087401,6050569,10137970,0,0,0,8192,5,4310928690
985,4088960,5640090,9729050,8,0,0,18432,13,1283511203
986,4090401,22356488,26446889,7,0,1,7168,8,10646652832
987,4091599,22392554,26484153,1,0,1,30208,14,1251497840
988,4093320,2077458,6170778,5,0,0,1024,8,5038487915
989,4097430,4741595,8839025,6,0,0,41984,5,1391191905
990,4099150,6246380,10345530,8,0,0,37888,13,8678510015
991,4102410,22444386,26546796,3,0,1,49152,12,2081713941
992,4104481,5104120,9208601,0,0,0,26624,5,9750138134
993,4106511,6270821,10377332,0,0,0,16384,5,4434169315
994,4113990,7842103,11956093,2,0,0,512,15,834988813
995,4119581,7382164,11501745,0,0,0,18944,5,3443459956
996,4125141,6281228,10406369,0,0,0,38400,5,3001708949
997,4127180,4585784,8712964,8,0,0,46592,13,10013245958
998,4129550,4179411,8308961,7,0,0,10752,8,8127045451
999,4132950,2658155,6791105,7,0,0,1024,8,7131121885
1000,4139660,22407159,26546819,0,0,1,4608,5,9504170816
1001,4140830,8004032,12144862,9,0,0,16896,19,360938262
1002,4148670,22426509,26575179,0,0,1,5120,5,905758306
1003,4150200,4545088,8695288,2,0,0,10240,15,2865154252
1004,4150420,3308459,7458879,9,0,0,4608,19,1175518835
1005,4150560,22427525,26578085,9,0,1,4608,19,4710046682
1006,4153320,5773289,9926609,5,0,0,22528,8,1726689219
1007,4155431,6010819,10166250,0,0,0,30208,5,5234375049
1008,4158030,2849439,7007469,6,0,0,26112,5,8588129827
1009,4161310,7284129,11445439,2,0,0,26112,15,5787521186
1010,4166710,4129451,8296161,6,0,0,4608,5,2995980135
1011,4171140,6138284,10309424,6,0,0,28672,5,6313067932
1012,4179520,22404272,26583792,6,0,1,2048,5,685784987
1013,4182490,22413056,26595546,6,0,1,7168,5,10658240243
1014,4189361,4284590,8473951,0,0,0,18432,5,9332641057
1015,4190820,4426990,8617810,9,0,0,22528,19,1485725811
1016,4191689,22437295,26628984,8,0,1,13824,13,870786632
1017,4193070,5548396,9741466,9,0,0,22528,19,8647151171
1018,4194301,22434706,26629007,5,0,1,1024,8,3173838464
1019,4195110,6283007,10478117,5,0,0,107520,8,1594309756
1020,4211630,22417400,26629030,3,0,1,1024,12,1191332297
1021,4215220,22421968,26637188,6,0,1,2560,5,10224699655
1022,4216380,7421427,11637807,9,0,0,5632,19,5817081978
1023,4219350,4554652,8774002,1,0,0,3584,14,895225967
1024,4221459,22454403,26675862,1,0,1,7680,14,10285647552
1025,4224160,22451725,26675885,3,0,1,9216,12,6150121067
1026,4225900,2360952,6586852,6,0,0,4608,5,2728116000
1027,4229310,4873437,9102747,2,0,0,19968,15,3300841810
1028,4231170,3012286,7243456,5,0,0,7680,8,9387516391
1029,4236671,6407228,10643899,0,0,0,13824,5,4045250500
1030,4236761,22475964,26712725,5,0,1,3584,8,1891836213
1031,4239320,22473428,26712748,6,0,1,3584,5,95533951
1032,4261170,7258196,11519366,6,0,0,35328,5,978224822
1033,4270001,22442770,26712771,7,0,1,6144,8,4860807814
1034,4273520,4962468,9235988,8,0,0,37888,13,6744579733
1035,4273810,22605212,26879022,2,0,1,9216,15,5404247537
1036,4273989,22605056,26879045,8,0,1,8192,13,734020579
1037,4274420,22604916,26879336,4,0,1,1536,4,7933942954
1038,4278181,5709327,9987508,0,0,0,29696,5,7608503584
1039,4285210,7517222,11802432,5,0,0,512,8,4306387101
1040,4286310,4690972,8977282,6,0,0,48640,5,9766118647
1041,4289190,4315355,8604545,8,0,0,40960,13,3535685705
1042,4291120,6348209,10639329,9,0,0,29696,19,4667907774
1043,4291350,6202459,10493809,4,0,0,39424,4,4268268565
1044,4291730,6018653,10310383,4,0,0,3072,4,1003344857
1045,4298690,8082687,12381377,5,0,0,35328,8,3108489153
1046,4298770,4761072,9059842,1,0,0,5632,14,5965633340
1047,4299070,6084681,10383751,7,0,0,20992,8,893994548
1048,4300270,6510197,10810467,7,0,0,18432,8,10231240173
1049,4304830,22577092,26881922,3,0,1,4096,12,4117387148
1050,4306190,6333474,10639664,4,0,0,1024,4,5158504160
1051,4307100,5747002,10054102,1,0,0,1024,14,7250789705
1052,4310980,5423599,9734579,6,0,0,3072,5,8935157717
1053,4311470,5272085,9583555,7,0,0,28160,8,9288199441
1054,4314000,3497752,7811752,2,0,0,16384,15,9640883786
1055,4317300,7568247,11885547,9,0,0,19968,19,5154849893
1056,4326730,7765529,12092259,6,0,0,2048,5,414479791
1057,4330000,5931475,10261475,5,0,0,23040,8,9482701626
1058,4330780,22701586,27032366,3,0,1,11776,12,10596101734
1059,4330830,6592754,10923584,7,0,0,1536,8,5951506678
1060,4335040,6344432,10679472,7,0,0,21504,8,2694033167
1061,4344100,7822157,12166257,6,0,0,70144,5,4002021378
1062,4348381,6866706,11215087,0,0,0,24576,5,9608149491
1063,4350870,4043418,8394288,4,0,0,17408,4,5931564411
1064,4365690,8101796,12467486,7,0,0,7680,8,6266266113
1065,4369100,5398019,9767119,5,0,0,81920,8,8483179343
1066,4370830,7867763,12238593,3,0,0,17408,12,2552165042
1067,4373460,5276237,9649697,5,0,0,19456,8,10378213400
1068,4373629,22669963,27043592,1,0,1,26624,14,511595293
1069,4373980,8190962,12564942,9,0,0,49152,19,8042213145
1070,4376241,4834902,9211143,0,0,0,1024,5,9572926732
1071,4377000,6607804,10984804,1,0,0,71680,14,4586227702
1072,4380700,6232774,10613474,9,0,0,36864,19,1640685449
1073,4382470,22701601,27084071,0,0,1,3584,5,10966326
1074,4382930,4862129,9245059,4,0,0,29696,4,3095969095
1075,4385910,4798099,9184009,4,0,0,18432,4,3379135759
1076,4388430,4812028,9200458,2,0,0,11776,15,4790034045
1077,4390760,6262701,10653461,5,0,0,12800,8,9329777231
1078,4393010,6560049,10953059,4,0,0,22528,4,4370532327
1079,4397870,22826344,27224214,0,0,1,24576,5,7715764273
1080,4406211,4658053,9064264,0,0,0,5120,5,9218338910
1081,4416310,2575193,6991503,4,0,0,5120,4,7676051884
1082,4424910,5032663,9457573,3,0,0,8704,12,571131492
1083,4428580,2972150,7400730,9,0,0,8192,19,4079298725
1084,4429950,5311851,9741801,4,0,0,1024,4,10200557726
1085,4430160,6428313,10858473,9,0,0,10240,19,3638022616
1086,4431220,6358243,10789463,4,0,0,30720,4,5128107473
1087,4443760,6541535,10985295,2,0,0,1536,15,7865128255
1088,4449190,6698103,11147293,7,0,0,19968,8,2023090121
1089,4449921,22774316,27224237,7,0,1,10240,8,147006850
1090,4462390,6904247,11366637,9,0,0,24576,19,6539074758
1091,4463590,22760670,27224260,3,0,1,512,12,2045254614
1092,4467110,5452612,9919722,2,0,0,13312,15,373743895
1093,4467920,3154701,7622621,8,0,0,18432,13,2671547020
1094,4467930,5585837,10053767,3,0,0,96256,12,837824718
1095,4468600,6955827,11424427,6,0,0,103936,5,3705775640
1096,4468911,5234440,9703351,0,0,0,28672,5,1754299687
1097,4471390,22752893,27224283,4,0,1,7168,4,2832943687
1098,4474940,7118129,11593069,9,0,0,512,19,10174460889
1099,4484370,22740895,27225265,2,0,1,6656,15,2519621062
1100,4487200,6640033,11127233,1,0,0,6144,14,2621481676
1101,4490380,8028101,12518481,4,0,0,107008,4,5569439629
1102,4496440,5186242,9682682,1,0,0,99840,14,5268933282
1103,4499990,22736799,27236789,9,0,1,8192,19,1364370760
1104,4503090,6363050,10866140,4,0,0,25088,4,292260877
1105,4504130,5409562,9913692,4,0,0,39424,4,1551079682
1106,4509571,22810051,27319622,5,0,1,16384,8,2914530735
1107,4510900,8170319,12681219,8,0,0,2048,13,7426324663
1108,4512470,4873319,9385789,1,0,0,8192,14,9386237034
1109,4514230,7855869,12370099,5,0,0,49152,8,5718292403
1110,4516560,7216653,11733213,5,0,0,9728,8,5949161644
1111,4529201,6689341,11218542,0,0,0,11264,5,8774256157
1112,4530011,7954210,12484221,0,0,0,3072,5,792594064
1113,4545369,22788807,27334176,1,0,1,3072,14,7058511168
1114,4556030,7014760,11570790,2,0,0,30720,15,8071461340
1115,4568820,22769302,27338122,0,0,1,3584,5,4825691038
1116,4569620,6504437,11074057,3,0,0,93184,12,9248352362
1117,4574930,8107248,12682178,9,0,0,3072,19,1935293210
1118,4576390,8231692,12808082,2,0,0,26624,15,8442135945
1119,4587780,6750772,11338552,7,0,0,43520,8,9809763697
1120,4589380,5268241,9857621,7,0,0,15360,8,537582426
1121,4593049,22745096,27338145,8,0,1,4096,13,160526817
1122,4593940,22782034,27375974,2,0,1,512,15,4325730398
1123,4599401,6832872,11432273,0,0,0,9728,5,10528618162
1124,4599730,7504205,12103935,7,0,0,23040,8,3120058860
1125,4599920,4506773,9106693,7,0,0,3072,8,2141095358
1126,4605950,4995279,9601229,1,0,0,10752,14,1526437475
1127,4606129,22769868,27375997,8,0,1,2560,13,2359629777
1128,4610450,4949971,9560421,6,0,0,23552,5,8993975398
1129,4617929,22794241,27412170,1,0,1,5120,14,9862044505
1130,4619600,6724325,11343925,9,0,0,11264,19,5850665002
1131,4622080,6223812,10845892,6,0,0,39936,5,4849854132
1132,4622250,22826478,27448728,0,0,1,4608,5,9526898969
1133,4622640,6491499,11114139,8,0,0,65536,13,3741941928
1134,4627040,22822354,27449394,6,0,1,11264,5,1505192435
1135,4638320,22812060,27450380,3,0,1,1536,12,7604330135
1136,4658790,4814429,9473219,4,0,0,32256,4,8127648608
1137,4661450,6132435,10793885,9,0,0,9216,19,3284872410
1138,4668110,4234866,8902976,3,0,0,12800,12,1255073943
1139,4686050,6906840,11592890,5,0,0,3072,8,3679856342
1140,4694320,6743124,11437444,2,0,0,16896,15,2164460338
1141,4695590,22773821,27469411,4,0,1,5632,4,2590935407
1142,4696579,22784526,27481105,8,0,1,7680,13,9476549944
1143,4698210,6681281,11379491,2,0,0,9728,15,4210092262
1144,4698280,4351056,9049336,8,0,0,27648,13,686958564
1145,4698520,22791384,27489904,4,0,1,5632,4,1215946706
1146,4698839,22791691,27490530,8,0,1,11264,13,314908968
1147,4704640,22828737,27533377,3,0,1,7680,12,7476632840
1148,4709930,8203528,12913458,5,0,0,24576,8,3174874739
1149,4715220,22818180,27533400,0,0,1,1024,5,2100558445
1150,4719580,22815756,27535336,4,0,1,6144,4,8586489645
1151,4723320,5587242,10310562,2,0,0,512,15,6204283580
1152,4728010,5750442,10478452,7,0,0,1024,8,8908567812
1153,4728840,22807482,27536322,4,0,1,1536,4,4391248675
1154,4732460,4865470,9597930,3,0,0,47104,12,7290937031
1155,4738790,7700797,12439587,9,0,0,48640,19,4697944810
1156,4742980,6140522,10883502,5,0,0,45568,8,9107741480
1157,4744030,22793918,27537948,2,0,1,2560,15,6341445584
1158,4757320,5186482,9943802,9,0,0,30208,19,494696765
1159,4761241,5604199,10365440,0,0,0,2560,5,4889574677
1160,4765740,6010885,10776625,6,0,0,14336,5,5261472653
1161,4767090,5998101,10765191,5,0,0,15360,8,9867341610
1162,4769671,7186243,11955914,0,0,0,41984,5,1416282773
1163,4771270,3523464,8294734,1,0,0,3584,14,9692206657
1164,4777821,22818226,27596047,5,0,1,7680,8,4108029519
1165,4778350,22892892,27671242,3,0,1,1536,12,409875246
1166,4783150,8214275,12997425,9,0,0,15872,19,4643825550
1167,4798140,6547368,11345508,9,0,0,5120,19,3635043208
1168,4798870,4895722,9694592,3,0,0,15360,12,2730414414
1169,4805940,4910272,9716212,9,0,0,1024,19,8644386423
1170,4806410,6968087,11774497,2,0,0,19968,15,6051023039
1171,4813500,6485180,11298680,6,0,0,99328,5,9254335416
1172,4815409,22891800,27707209,1,0,1,9216,14,5024901502
1173,4822910,4495465,9318375,8,0,0,25600,13,10730486373
1174,4831130,4473570,9304700,6,0,0,16384,5,4718714511
1175,4846460,5809052,10655512,9,0,0,6656,19,3431709378
1176,4850420,22856812,27707232,6,0,1,1536,5,8648792337
1177,4861710,7903887,12765597,8,0,0,189952,13,1207085421
1178,4867360,7487740,12355100,8,0,0,113664,13,8740780400
1179,4867680,5781858,10649538,2,0,0,18432,15,5249952520
1180,4867840,5460640,10328480,7,0,0,7168,8,5296066898
1181,4869560,6058883,10928443,8,0,0,15872,13,3057979287
1182,4869620,6248153,11117773,3,0,0,6144,12,1724182493
1183,4873900,6047610,10921510,7,0,0,56320,8,6697608084
1184,4882500,8230225,13112725,9,0,0,15872,19,6833731737
1185,4891620,5734871,10626491,5,0,0,8192,8,7250845709
1186,4895100,4838520,9733620,7,0,0,6144,8,155981836
1187,4895280,3542210,8437490,1,0,0,3072,14,5864876136
1188,4899600,7949500,12849100,5,0,0,15360,8,6342709630
1189,4907730,22799525,27707255,0,0,1,9728,5,10351099031
1190,4909731,4832405,9742136,0,0,0,1024,5,10318760164
1191,4915410,5161553,10076963,5,0,0,6656,8,7038394399
1192,4917500,7915744,12833244,6,0,0,24064,5,846462688
1193,4923800,22884965,27808765,0,0,1,8704,5,4412612286
1194,4927950,5955887,10883837,1,0,0,1024,14,9577047295
1195,4931921,23303760,28235681,7,0,1,4608,8,6980451966
1196,4935970,5746333,10682303,8,0,0,9216,13,10531700446
1197,4940580,23299515,28240095,9,0,1,12800,19,10019075897
1198,4942860,4934619,9877479,7,0,0,11264,8,2244328824
1199,4945760,5203351,10149111,3,0,0,28160,12,3011056239
1200,4947070,6593847,11540917,6,0,0,70656,5,3044507862
1201,4947130,3658218,8605348,5,0,0,2560,8,6878660240
1202,4966200,23360897,28327097,3,0,1,7168,12,9888449793
1203,4971040,4582182,9553222,2,0,0,25600,15,84794691
1204,4973770,4632942,9606712,7,0,0,17920,8,169052327
1205,4974790,23352653,28327443,9,0,1,512,19,8718591405
1206,4974811,7715369,12690180,0,0,0,18944,5,1840095201
1207,4979000,5347273,10326273,9,0,0,5632,19,6368389602
1208,4983110,4918547,9901657,6,0,0,3072,5,5393732140
1209,4989110,7891891,12881001,9,0,0,24576,19,6816821722
1210,4995060,5259372,10254432,9,0,0,38400,19,9730099527
1211,4996080,4883005,9879085,7,0,0,1024,8,1570805365
1212,4999150,7459671,12458821,5,0,0,55808,8,10238137996
1213,5001330,5525472,10526802,6,0,0,31232,5,8832234297
1214,5001350,23327719,28329069,3,0,1,2560,12,6283953249
1215,5006540,6637210,11643750,2,0,0,14336,15,8704844791
1216,5015481,9002930,14018411,0,0,0,87040,5,5358002190
1217,5016151,23313584,28329735,5,0,1,1024,8,259115459
1218,5018690,5392070,10410760,3,0,0,14336,12,7480000638
1219,5032560,5407722,10440282,1,0,0,3584,14,157354920
1220,5035440,8639640,13675080,1,0,0,69632,14,5071111252
1221,5044800,6087627,11132427,2,0,0,8704,15,2127702521
1222,5045740,7573346,12619086,3,0,0,65536,12,2686320874
1223,5046920,4853770,9900690,1,0,0,5632,14,3595999466
1224,5048060,23284901,28332961,6,0,1,5120,5,2082986911
1225,5048950,5697007,10745957,7,0,0,1024,8,921666312
1226,5051660,7496141,12547801,9,0,0,41984,19,8782443984
1227,5052769,23285338,28338107,8,0,1,8192,13,5135855652
1228,5053340,23296859,28350199,4,0,1,6144,4,9836060766
1229,5058170,5599861,10658031,2,0,0,8192,15,2326927666
1230,5060780,6190006,11250786,9,0,0,7168,19,5298434215
1231,5063940,23300189,28364129,6,0,1,2560,5,4518736724
1232,5065120,5565138,10630258,9,0,0,12288,19,5006559559
1233,5066239,23297921,28364160,8,0,1,4608,13,9427139174
1234,5077100,9080049,14157149,6,0,0,87552,5,3691807595
1235,5084910,5850420,10935330,9,0,0,22528,19,6252290056
1236,5086580,7757809,12844389,2,0,0,9728,15,6111679253
1237,5095310,6599435,11694745,5,0,0,7680,8,1925681831
1238,5096241,5454452,10550693,0,0,0,78336,5,10239957242
1239,5098140,8243782,13341922,1,0,0,37376,14,7501096416
1240,5104261,23280524,28384785,5,0,1,20480,8,4940863092
1241,5109840,7021814,12131654,6,0,0,20480,5,3220184912
1242,5111900,5660334,10772234,7,0,0,23040,8,1762464552
1243,5112050,23404807,28516857,2,0,1,17408,15,5651338484
1244,5112120,4595622,9707742,4,0,0,14336,4,7435131967
1245,5114510,5612369,10726879,1,0,0,18944,14,1761129850
1246,5115760,5557137,10672897,1,0,0,28672,14,3699477629
1247,5123101,6253403,11376504,0,0,0,32256,5,9001495816
1248,5123380,4566501,9689881,4,0,0,23552,4,8914512226
1249,5123781,23419099,28542880,7,0,1,4096,8,8279690327
1250,5137750,4514489,9652239,6,0,0,1536,5,8035763059
1251,5138620,7780321,12918941,6,0,0,17920,5,10698387709
1252,5143280,9072858,14216138,8,0,0,37888,13,4808298563
1253,5149270,7676619,12825889,6,0,0,58368,5,10591749495
1254,5154681,6203174,11357855,0,0,0,40448,5,1455792320
1255,5155420,7101742,12257162,5,0,0,35328,8,8025573015
1256,5156950,8041904,13198854,9,0,0,36352,19,4069510649
1257,5161750,7711740,12873490,2,0,0,35840,15,407970465
1258,5169580,7736367,12905947,3,0,0,55296,12,7996564970
1259,5173200,7300237,12473437,9,0,0,19456,19,5005937832
1260,5177970,5905782,11083752,3,0,0,31744,12,8101496598
1261,5181890,5843078,11024968,1,0,0,2560,14,475698805
1262,5186160,7461716,12647876,9,0,0,69120,19,6931764558
1263,5188541,7479170,12667711,0,0,0,65024,5,848315526
1264,5191270,4224044,9415314,7,0,0,2560,8,8764311362
1265,5193590,4017218,9210808,6,0,0,7168,5,2598847300
1266,5204740,7177908,12382648,9,0,0,4096,19,4044438697
1267,5207601,8158093,13365694,0,0,0,29696,5,7296903892
1268,5211891,23331012,28542903,5,0,1,5120,8,5505873701
1269,5212420,5621281,10833701,2,0,0,38912,15,8716786777
1270,5220260,8265392,13485652,1,0,0,5632,14,6684493337
1271,5221960,7547248,12769208,3,0,0,11776,12,776494616
1272,5224830,6803354,12028184,3,0,0,65536,12,8777058025
1273,5227620,8324776,13552396,9,0,0,71680,19,1517711297
1274,5231870,5658854,10890724,3,0,0,22528,12,106172303
1275,5232549,23481246,28713795,1,0,1,13312,14,211993992
1276,5237050,5448396,10685446,8,0,0,10240,13,10587334837
1277,5243100,6471168,11714268,4,0,0,64000,4,10354119754
1278,5243331,5611975,10855306,0,0,0,21504,5,3509966443
1279,5244590,5378891,10623481,1,0,0,32768,14,9530315912
1280,5249200,7145069,12394269,4,0,0,9728,4,2535730012
1281,5256110,5701972,10958082,7,0,0,16384,8,7216161445
1282,5272719,23443959,28716678,8,0,1,6656,13,2285686610
1283,5277940,5540716,10818656,2,0,0,6656,15,6867169942
1284,5279260,5885990,11165250,1,0,0,17920,14,8294248402
1285,5285010,5131485,10416495,1,0,0,6144,14,7580047493
1286,5286790,6035781,11322571,3,0,0,78336,12,3780555979
1287,5289280,23514185,28803465,3,0,1,7680,12,10286965113
1288,5289460,4609483,9898943,8,0,0,4608,13,2861865566
1289,5292510,7677427,12969937,8,0,0,2048,13,3414515518
1290,5293730,7907978,13201708,1,0,0,3584,14,2325467639
1291,5296141,23509270,28805411,7,0,1,3072,8,494736409
1292,5298290,6060836,11359126,6,0,0,4096,5,8647276449
1293,5302610,4576140,9878750,4,0,0,4096,4,6786101348
1294,5316190,5771329,11087519,7,0,0,12288,8,9172068718
1295,5316490,5689114,11005604,6,0,0,1536,5,3458860393
1296,5318320,5806371,11124691,4,0,0,3072,4,572226462
1297,5323170,5802168,11125338,6,0,0,2048,5,8972074069
1298,5323620,7762027,13085647,3,0,0,37888,12,5006079016
1299,5327091,7860664,13187755,0,0,0,45056,5,4818832227
1300,5327330,5483636,10810966,2,0,0,1536,15,8833380164
1301,5341880,8282682,13624562,4,0,0,4608,4,150574103
1302,5342520,8276224,13618744,4,0,0,55296,4,6523085215
1303,5349640,5780112,11129752,3,0,0,8192,12,1951776883
1304,5351400,5973066,11324466,8,0,0,6144,13,10706962708
1305,5353410,6448843,11802253,2,0,0,10240,15,795885281
1306,5361170,23456335,28817505,2,0,1,8704,15,3437131471
1307,5362720,7344978,12707698,2,0,0,17408,15,5622279294
1308,5366519,23451009,28817528,8,0,1,1024,13,6575361242
1309,5378810,5245162,10623972,2,0,0,1536,15,2089579969
1310,5381930,9063501,14445431,8,0,0,24576,13,6508953986
1311,5388000,5792094,11180094,6,0,0,6144,5,2160907723
1312,5392680,23494928,28887608,6,0,1,3584,5,9320063739
1313,5397980,5382100,10780080,3,0,0,11264,12,5442451332
1314,5400290,5469305,10869595,7,0,0,11264,8,2881121363
1315,5400300,5150572,10550872,6,0,0,512,5,574434444
1316,5406919,23520642,28927561,1,0,1,8192,14,10276225653
1317,5426270,23519335,28945605,4,0,1,5632,4,1838964454
1318,5436330,7975335,13411665,6,0,0,52736,5,3745232342
1319,5441710,8240748,13682458,3,0,0,9728,12,5169677350
1320,5444501,6175465,11619966,0,0,0,52224,5,5425404689
1321,5444579,23604728,29049307,8,0,1,16384,13,10201742874
1322,5453590,23610191,29063781,6,0,1,2048,5,2711723451
1323,5464601,5860668,11325269,0,0,0,2560,5,6734336879
1324,5465170,23600529,29065699,9,0,1,4608,19,7514737472
1325,5467030,8288055,13755085,5,0,0,26112,8,7048748512
1326,5472020,7097781,12569801,7,0,0,15872,8,5204717563
1327,5472340,7787413,13259753,8,0,0,17408,13,1393900938
1328,5476380,8319162,13795542,4,0,0,18432,4,2536563454
1329,5481270,5309776,10791046,3,0,0,5120,12,9096852807
1330,5483600,5205301,10688901,5,0,0,11264,8,8223080782
1331,5486200,9229357,14715557,8,0,0,40448,13,2668073837
1332,5486530,8154997,13641527,2,0,0,11776,15,3992356785
1333,5486580,5177558,10664138,2,0,0,19968,15,4996105859
1334,5487380,23593550,29080930,4,0,1,6656,4,3532373287
1335,5494691,23589785,29084476,5,0,1,5632,8,6349101381
1336,5494841,5884985,11379826,0,0,0,1024,5,5077365223
1337,5498580,6538706,12037286,1,0,0,22528,14,5839944587
1338,5508240,5585908,11094148,9,0,0,2048,19,5277449542
1339,5514050,23572372,29086422,4,0,1,3072,4,204914787
1340,5533570,6046342,11579912,8,0,0,1024,13,7674115019
1341,5540930,23557415,29098345,0,0,1,5120,5,7501074416
1342,5555070,8213321,13768391,5,0,0,42496,8,4320416454
1343,5560100,23538268,29098368,3,0,1,1024,12,7274703511
1344,5564520,8022435,13586955,5,0,0,52224,8,8357510354
1345,5566851,8252763,13819614,0,0,0,24576,5,8017244951
1346,5567060,5825676,11392736,9,0,0,29184,19,7434063768
1347,5567270,5814919,11382189,8,0,0,7680,13,10656377182
1348,5568730,8413346,13982076,4,0,0,7168,4,4033741072
1349,5568750,5567015,11135765,6,0,0,1024,5,1837163911
1350,5573710,5550014,11123724,9,0,0,19456,19,501472088
1351,5574480,6187632,11762112,2,0,0,9216,15,504083413
1352,5588060,7463994,13052054,1,0,0,91648,14,5938101454
1353,5589241,8280332,13869573,0,0,0,29696,5,2911035239
1354,5594670,5954226,11548896,7,0,0,26112,8,2870282571
1355,5596910,23501481,29098391,0,0,1,5120,5,7255570817
1356,5597880,9393525,14991405,2,0,0,37376,15,480986770
1357,5601660,23496754,29098414,6,0,1,10752,5,2579937662
1358,5603130,5213475,10816605,9,0,0,18432,19,8958519636
1359,5613300,8158242,13771542,6,0,0,10240,5,2053404948
1360,5613380,8781829,14395209,5,0,0,120832,8,7541117343
1361,5617080,5812206,11429286,8,0,0,15872,13,3030544544
1362,5619320,23515573,29134893,6,0,1,1024,5,7500055048
1363,5619910,23523050,29142960,4,0,1,22528,4,8343629150
1364,5621861,23523045,29144906,5,0,1,3072,8,2919971904
1365,5622380,6307603,11929983,8,0,0,29696,13,10695607132
1366,5624850,5967081,11591931,3,0,0,16384,12,1264559468
1367,5630590,8874454,14505044,3,0,0,9216,12,8701002494
1368,5636560,5456933,11093493,5,0,0,10240,8,2053070387
1369,5639240,5181779,10821019,5,0,0,7680,8,7274628288
1370,5646320,5358793,11005113,7,0,0,9728,8,2004361337
1371,5651981,8295708,13947689,0,0,0,30208,5,697596594
1372,5657191,4822376,10479567,0,0,0,3584,5,8643149997
1373,5660310,5285838,10946148,2,0,0,32768,15,4808020795
1374,5660550,8441297,14101847,5,0,0,10752,8,10272958379
1375,5664430,24064311,29728741,3,0,1,36864,12,5742722891
1376,5670040,6083446,11753486,7,0,0,13312,8,10055447048
1377,5680099,24086783,29766882,8,0,1,6144,13,6627260768
1378,5685700,5774081,11459781,5,0,0,12288,8,6831624324
1379,5687390,7288912,12976302,1,0,0,13824,14,10019603284
1380,5690170,6127292,11817462,7,0,0,6144,8,5303036026
1381,5691610,7370185,13061795,3,0,0,11264,12,2742837065
1382,5697300,5551271,11248571,5,0,0,5120,8,1176014309
1383,5713881,24318908,30032789,7,0,1,26624,8,1449908568
1384,5714290,8236465,13950755,6,0,0,5632,5,8923121897
1385,5740510,7143166,12883676,3,0,0,8704,12,4514895085
1386,5747720,8141059,13888779,5,0,0,37376,8,2654709224
1387,5748060,5969819,11717879,2,0,0,11776,15,8386013272
1388,5752560,7311153,13063713,4,0,0,5120,4,8554446553
1389,5757350,5972876,11730226,2,0,0,40448,15,4721179987
1390,5760321,8114735,13875056,0,0,0,17920,5,6825181937
1391,5762981,6091065,11854046,0,0,0,35328,5,757755821
1392,5765450,9333961,15099411,6,0,0,16384,5,5405381727
1393,5768350,6357041,12125391,3,0,0,12800,12,3740572117
1394,5772660,24269266,30041926,6,0,1,12800,5,8073428927
1395,5775930,8125820,13901750,3,0,0,42496,12,93639224
1396,5777080,6016514,11793594,4,0,0,51200,4,370117690
1397,5781780,7597148,13378928,2,0,0,6656,15,8831847106
1398,5781920,24361034,30142954,3,0,1,7168,12,7502076045
1399,5784550,6586040,12370590,6,0,0,1536,5,10357653271
1400,5795550,24347427,30142977,3,0,1,5632,12,2808599055
1401,5801320,8826729,14628049,9,0,0,14336,19,4738840811
1402,5804150,8236004,14040154,3,0,0,29696,12,6087632619
1403,5809150,5446807,11255957,6,0,0,16896,5,3942786151
1404,5811839,24485904,30297743,8,0,1,29696,13,1713521096
1405,5816570,8371224,14187794,6,0,0,20992,5,2881088988
1406,5822820,8403233,14226053,4,0,0,24064,4,2213359536
1407,5823170,6771567,12594737,5,0,0,13312,8,9376950696
1408,5828141,8343851,14171992,0,0,0,48640,5,623183635
1409,5836220,6194171,12030391,2,0,0,7168,15,5989072319
1410,5849419,24448785,30298204,8,0,1,10240,13,10024548492
1411,5850460,8123582,13974042,7,0,0,7168,8,7058026785
1412,5850580,7386520,13237100,6,0,0,27648,5,8498734620
1413,5851450,5840932,11692382,5,0,0,58368,8,10029178406
1414,5855741,6182660,12038401,0,0,0,3584,5,5095751202
1415,5860090,5063003,10923093,2,0,0,5120,15,10706835619
1416,5866790,5268632,11135422,8,0,0,9728,13,3033411148
1417,5869150,5778692,11647842,1,0,0,2560,14,5516792337
1418,5870000,8548195,14418195,9,0,0,69120,19,841220654
1419,5872110,8524994,14397104,9,0,0,6144,19,2665244917
1420,5882001,8628838,14510839,0,0,0,18944,5,10002092312
1421,5889890,5371578,11261468,6,0,0,6144,5,489664562
1422,5892630,5905729,11798359,4,0,0,8704,4,2455213660
1423,5894070,9393503,15287573,1,0,0,12800,14,2255419283
1424,5895330,24408059,30303389,6,0,1,16384,5,2457265853
1425,5900140,24412266,30312406,4,0,1,6144,4,6988872648
1426,5918890,6138479,12057369,7,0,0,4608,8,6413342377
1427,5919280,24495684,30414964,2,0,1,17920,15,2253211720
1428,5919380,6157651,12077031,7,0,0,26112,8,8509935466
1429,5921640,5837641,11759281,2,0,0,18944,15,9701336434
1430,5926020,6368979,12294999,3,0,0,13312,12,8181030798
1431,5930350,5960511,11890861,6,0,0,8704,5,8374939984
1432,5936221,8900720,14836941,0,0,0,49664,5,5568538891
1433,5939170,5855851,11795021,6,0,0,4608,5,10720792092
1434,5941990,6110552,12052542,1,0,0,31744,14,6913524270
1435,5945780,6013765,11959545,2,0,0,4608,15,5889885840
1436,5947450,8410920,14358370,2,0,0,98816,15,10429433153
1437,5947529,24467781,30415310,1,0,1,512,14,5775948714
1438,5948640,7266998,13215638,5,0,0,41984,8,2532333973
1439,5950091,24469725,30419816,7,0,1,7168,8,5695770639
1440,5951520,8119078,14070598,9,0,0,15360,19,10425952005
1441,5955371,9289485,15244856,0,0,0,59904,5,1183079191
1442,5957081,6096420,12053501,0,0,0,3072,5,5517646428
1443,5961351,6901196,12862547,0,0,0,44032,5,8838412718
1444,5975580,6160621,12136201,2,0,0,14848,15,9107247961
1445,5977410,6294948,12272358,9,0,0,3584,19,3900460552
1446,5978330,7675511,13653841,7,0,0,35328,8,9100224206
1447,5983091,8537333,14520424,0,0,0,15360,5,7418543536
1448,5990810,9095314,15086124,5,0,0,7168,8,5488462108
1449,5992100,24437697,30429797,2,0,1,512,15,4826046390
1450,5994460,24437404,30431864,6,0,1,5120,5,9495570046
1451,5998410,9501994,15500404,9,0,0,4608,19,1852442257
1452,6003280,5808988,11812268,1,0,0,1024,14,2854490800
1453,6006150,24425970,30432120,4,0,1,9216,4,3159721736
1454,6014299,24448288,30462587,1,0,1,2048,14,2942734788
1455,6018160,7681995,13700155,6,0,0,9728,5,8983007962
1456,6020080,7208573,13228653,5,0,0,18944,8,6630736316
1457,6022120,5842547,11864667,9,0,0,22016,19,8688895327
1458,6023310,6646452,12669762,4,0,0,6656,4,3091458578
1459,6028160,6229805,12257965,9,0,0,2560,19,8485935135
1460,6032180,9568676,15600856,8,0,0,56320,13,6020910378
1461,6038570,6640731,12679301,3,0,0,31232,12,979516664
1462,6047600,6543058,12590658,8,0,0,13824,13,8149679187
1463,6049670,8624959,14674629,1,0,0,75264,14,1667628033
1464,6050660,24438866,30489526,6,0,1,8704,5,9598446578
1465,6052940,6117396,12170336,4,0,0,13312,4,10570621103
1466,6054670,5575037,11629707,5,0,0,14336,8,8752361849
1467,6062071,24427478,30489549,5,0,1,2048,8,9749181017
1468,6065940,24423632,30489572,9,0,1,8192,19,10625838594
1469,6066240,24470989,30537229,6,0,1,12288,5,2881972715
1470,6066640,24491539,30558179,0,0,1,8704,5,320512574
1471,6071711,24486491,30558202,7,0,1,3072,8,2465853889
1472,6074420,6762435,12836855,5,0,0,11776,8,3579927028
1473,6077950,8409537,14487487,9,0,0,60928,19,1970143448
1474,6079190,6342103,12421293,2,0,0,7680,15,7963191115
1475,6082290,6380306,12462596,7,0,0,12288,8,10561885558
1476,6099780,6130376,12230156,5,0,0,12800,8,1648296758
1477,6101190,6433149,12534339,7,0,0,11776,8,6000384482
1478,6113611,6081026,12194637,0,0,0,2048,5,6330352193
1479,6115710,7255311,13371021,9,0,0,17408,19,1869024680
1480,6116900,24554227,30671127,4,0,1,46080,4,3567988421
1481,6124590,6395474,12520064,9,0,0,5120,19,1668703331
1482,6127580,24551480,30679060,3,0,1,11264,12,10378303381
1483,6127700,5861196,11988896,3,0,0,4608,12,7544835633
1484,6127751,24651696,30779447,7,0,1,23040,8,6110072852
1485,6133741,6921456,13055197,0,0,0,10240,5,1931093493
1486,6137570,7492631,13630201,6,0,0,18432,5,6142510215
1487,6138481,5329254,11467735,0,0,0,4608,5,3790891252
1488,6138520,24641223,30779743,2,0,1,1024,15,1106006817
1489,6150460,9207182,15357642,5,0,0,7680,8,166479631
1490,6161630,5846563,12008193,9,0,0,28160,19,3299293795
1491,6164110,8487564,14651674,8,0,0,25600,13,8241166526
1492,6166710,6986102,13152812,8,0,0,20992,13,9957161830
1493,6166830,6458230,12625060,6,0,0,6144,5,85313583
1494,6171210,6615204,12786414,5,0,0,27136,8,4347359743
1495,6173051,24609278,30782329,7,0,1,4096,8,10585047665
1496,6181180,5634387,11815567,1,0,0,10752,14,4445883237
1497,6185000,6772645,12957645,6,0,0,45056,5,3265386606
1498,6188980,24619550,30808530,9,0,1,6656,19,7504632214
1499,6191120,24733548,30924668,6,0,1,20992,5,10715574913
1500,6192550,7029803,13222353,3,0,0,18432,12,9573606858
1501,6194351,8524193,14718544,0,0,0,9728,5,6025497329
1502,6199400,6862730,13062130,8,0,0,1024,13,1270496149
1503,6199470,8637650,14837120,8,0,0,512,13,3757170969
1504,6214820,24714730,30929550,4,0,1,17408,4,10369707008
1505,6215330,6102061,12317391,2,0,0,512,15,5181185608
1506,6215700,24831327,31047027,4,0,1,48128,4,6275620202
1507,6218439,24833094,31051533,1,0,1,7168,14,10630159256
1508,6221380,6305747,12527127,7,0,0,1024,8,2335169857
1509,6231560,8796418,15027978,1,0,0,58368,14,5233274344
1510,6232591,6390574,12623165,0,0,0,13312,5,185761931
1511,6233800,6287847,12521647,4,0,0,5120,4,1129353817
1512,6234280,6988564,13222844,5,0,0,1536,8,547148048
1513,6239440,6552925,12792365,3,0,0,19456,12,8899709010
1514,6242050,7455118,13697168,1,0,0,15872,14,1539001043
1515,6242580,8395632,14638212,6,0,0,33280,5,2284781485
1516,6244820,7038448,13283268,6,0,0,39936,5,138688590
1517,6245050,24970606,31215656,4,0,1,20992,4,102524329
1518,6245430,6532693,12778123,4,0,0,29184,4,9880685371
1519,6246641,25010028,31256669,7,0,1,3584,8,10437412173
1520,6247410,7444899,13692309,1,0,0,32256,14,1125484902
1521,6250070,6215045,12465115,8,0,0,8192,13,4396714782
1522,6254900,8473807,14728707,5,0,0,33280,8,8571446439
1523,6256250,7074097,13330347,7,0,0,13824,8,7674312925
1524,6256561,9142085,15398646,0,0,0,71680,5,4627443216
1525,6266820,8419925,14686745,9,0,0,4096,19,9831572137
1526,6267740,6311288,12579028,9,0,0,30208,19,8642820002
1527,6271170,7195518,13466688,3,0,0,29696,12,222936660
1528,6273840,25407881,31681721,4,0,1,168448,4,6943479405
1529,6285481,25397866,31683347,5,0,1,2560,8,1005182643
1530,6285670,25483750,31769420,2,0,1,23552,15,1446265175
1531,6286860,6513087,12799947,8,0,0,23040,13,9644340360
1532,6290220,6648893,12939113,8,0,0,6656,13,5688797780
1533,6292170,7748639,14040809,2,0,0,2048,15,8928672452
1534,6296830,6544572,12841402,1,0,0,14848,14,4415323479
1535,6299100,6901493,13200593,8,0,0,5632,13,5259370041
1536,6300491,7560011,13860502,0,0,0,62464,5,9959462279
1537,6303041,25512733,31815774,5,0,1,19456,8,4744711735
1538,6317170,25509719,31826889,0,0,1,5120,5,9321318942
1539,6321960,6792192,13114152,4,0,0,4608,4,3698980547
1540,6322740,8742927,15065667,5,0,0,65024,8,5130056402
1541,6323910,6074343,12398253,3,0,0,7680,12,10181791791
1542,6327700,6780166,13107866,6,0,0,40960,5,10204275025
1543,6331160,8462163,14793323,6,0,0,25088,5,310406781
1544,6338340,7113585,13451925,5,0,0,23552,8,7681846490
1545,6346470,8757800,15104270,9,0,0,15872,19,2379598054
1546,6347390,8619758,14967148,3,0,0,86528,12,3631821256
1547,6348050,7459417,13807467,9,0,0,19968,19,3972717273
1548,6357640,7418293,13775933,6,0,0,14336,5,117728342
1549,6358859,25477748,31836607,1,0,1,4096,14,2309344957
1550,6364130,7594695,13958825,5,0,0,17920,8,1474317905
1551,6364200,7258935,13623135,9,0,0,14336,19,8507811294
1552,6365230,7225648,13590878,6,0,0,12800,5,9955144812
1553,6366160,7067089,13433249,5,0,0,10752,8,7732221771
1554,6368250,6929156,13297406,2,0,0,25600,15,3676673175
1555,6370360,6164626,12534986,6,0,0,2048,5,7439435840
1556,6385340,6299045,12684385,5,0,0,7168,8,5502659377
1557,6393750,8547011,14940761,7,0,0,79360,8,160248407
1558,6395040,8073860,14468900,5,0,0,45568,8,9902445102
1559,6395970,7318880,13714850,9,0,0,48128,19,5871212286
1560,6397580,8878600,15276180,1,0,0,48640,14,8609919986
1561,6404260,9348051,15752311,2,0,0,9216,15,6277265166
1562,6411560,7267911,13679471,5,0,0,14336,8,8286215655
1563,6413990,9256143,15670133,4,0,0,61952,4,3523194038
1564,6414731,6643609,13058340,0,0,0,10240,5,4895115621
1565,6421521,9309786,15731307,0,0,0,151552,5,3871094409
1566,6423720,25412910,31836630,0,0,1,10752,5,86798311
1567,6424850,25817327,32242177,4,0,1,196608,4,6970537531
1568,6427850,25814350,32242200,0,0,1,1024,5,3472624490
1569,6428360,6504273,12932633,3,0,0,512,12,2835268705
1570,6428910,8002412,14431322,9,0,0,43008,19,10217346728
1571,6429630,25826188,32255818,9,0,1,2048,19,3494425077
1572,6431211,25824630,32255841,2,0,1,9216,15,9098906338
1573,6436990,25846095,32283085,4,0,1,11776,4,10051488021
1574,6444421,25855635,32300056,2,0,1,20480,15,4713599302
1575,6449460,25850942,32300402,0,0,1,512,5,5273972962
1576,6461131,8054099,14515230,0,0,0,14336,5,5561331697
1577,6477550,7546032,14023582,3,0,0,16896,12,9568611923
1578,6480510,7266596,13747106,8,0,0,28160,13,9193029182
1579,6480710,6221661,12702371,1,0,0,39936,14,1286244704
1580,6481060,7315909,13796969,5,0,0,4608,8,9594508547
1581,6483671,25818357,32302028,2,0,1,2560,15,6857415205
1582,6488260,5953534,12441794,1,0,0,7168,14,1729899685
1583,6498820,7936113,14434933,6,0,0,11776,5,3162396607
1584,6500390,6763130,13263520,9,0,0,12288,19,4577366785
1585,6500721,25929370,32430091,5,0,1,39936,8,3742196347
1586,6501260,8979112,15480372,3,0,0,66560,12,2504684500
1587,6502059,25934650,32436709,8,0,1,7680,13,9072774063
1588,6509530,7415306,13924836,4,0,0,51200,4,896426245
1589,6510210,6282662,12792872,5,0,0,1536,8,8921173371
1590,6512590,6167982,12680572,2,0,0,4096,15,6229828523
1591,6515590,7812649,14328239,6,0,0,108544,5,3683763315
1592,6525900,7315547,13841447,6,0,0,32768,5,6788591249
1593,6533240,7026979,13560219,6,0,0,25600,5,8101267394
1594,6535280,9266699,15801979,2,0,0,16896,15,3899732883
1595,6536690,7371531,13908221,7,0,0,3072,8,2108906819
1596,6539951,25897424,32437375,2,0,1,1024,15,5291789290
1597,6540730,8040442,14581172,6,0,0,32768,5,9318569661
1598,6547110,26046004,32593114,6,0,1,12288,5,9656294575
1599,6547570,7976933,14524503,8,0,0,13312,13,6115089860
1600,6548640,6973443,13522083,6,0,0,8704,5,3219727924
1601,6550590,7515305,14065895,5,0,0,26112,8,9611572338
1602,6552479,26040658,32593137,8,0,1,1536,13,4933586549
1603,6553701,26039459,32593160,7,0,1,12288,8,6393367960
1604,6559281,9019533,15578814,0,0,0,55808,5,6536723977
1605,6560051,26037211,32597262,7,0,1,3584,8,5872895898
1606,6564030,9384585,15948615,6,0,0,19968,5,5610960003
1607,6566980,26043276,32610256,0,0,1,17408,5,4078934670
1608,6567489,26206739,32774228,1,0,1,36352,14,5392029310
1609,6567830,7613545,14181375,2,0,0,30720,15,6141123398
1610,6568010,9438228,16006238,8,0,0,1024,13,5783963163
1611,6570640,6603364,13174004,4,0,0,19968,4,8472527758
1612,6578210,6001153,12579363,2,0,0,1024,15,5343411076
1613,6579170,7625401,14204571,3,0,0,14848,12,3744583315
1614,6583870,26264990,32848860,2,0,1,6144,15,6069917248
1615,6586350,8449147,15035497,7,0,0,24576,8,10353117966
1616,6589701,26319398,32909099,7,0,1,18944,8,1072976176
1617,6593109,26339055,32932164,8,0,1,32256,13,3823002515
1618,6595240,26361315,32956555,2,0,1,4096,15,8155317332
1619,6596790,9332389,15929179,7,0,0,46080,8,4562261482
1620,6600380,7486993,14087373,7,0,0,512,8,8206412857
1621,6601770,7519560,14121330,2,0,0,19456,15,3089854996
1622,6608661,8467949,15076610,0,0,0,35840,5,5212637081
1623,6612410,8641369,15253779,8,0,0,29184,13,1532683750
1624,6612890,8226125,14839015,4,0,0,6144,4,6073069852
1625,6615600,8008058,14623658,1,0,0,130048,14,1052023912
1626,6615880,8523361,15139241,4,0,0,39424,4,7452316889
1627,6616401,7873145,14489546,0,0,0,6656,5,4329615756
1628,6617691,26342730,32960421,5,0,1,6144,8,6734605875
1629,6625560,27786427,34411987,4,0,1,517120,4,9005733875
1630,6626190,9123290,15749480,5,0,0,37888,8,10582884302
1631,6641411,27770599,34412010,7,0,1,5120,8,5941245183
1632,6641880,7796040,14437920,8,0,0,9728,13,8279300841
1633,6644250,27768486,34412736,6,0,1,14336,5,7298442996
1634,6649820,27795379,34445199,3,0,1,3072,12,4206656870
1635,6650010,9355893,16005903,8,0,0,57856,13,4202239242
1636,6650120,6352320,13002440,7,0,0,16384,8,2882384513
1637,6650470,8246689,14897159,8,0,0,10240,13,7359165303
1638,6654470,9570180,16224650,7,0,0,6656,8,699003923
1639,6657620,9744907,16402527,6,0,0,80896,5,9764008956
1640,6673620,6451721,13125341,4,0,0,5632,4,4613449570
1641,6678340,7521676,14200016,2,0,0,36352,15,2819231265
1642,6678600,8538302,15216902,2,0,0,27648,15,527721717
1643,6680739,27778758,34459497,8,0,1,20480,13,9843893811
1644,6681770,7271348,13953118,9,0,0,7680,19,9725465902
1645,6686891,27773632,34460523,5,0,1,512,8,9419582059
1646,6689270,9386296,16075566,9,0,0,28160,19,9476877010
1647,6689351,27774398,34463749,5,0,1,5120,8,8317549411
1648,6693010,8805967,15498977,6,0,0,10752,5,10106665454
1649,6693660,7131369,13825029,9,0,0,10752,19,2189380825
1650,6706529,27779369,34485898,1,0,1,1536,14,4524266583
1651,6709290,10053940,16763230,6,0,0,43520,5,9371190278
1652,6715430,9184196,15899626,4,0,0,21504,4,3338922909
1653,6716340,6767573,13483913,2,0,0,14848,15,5005387436
1654,6717570,7083790,13801360,1,0,0,14336,14,4418296149
1655,6719040,28658237,35377277,4,0,1,441344,4,10062025474
1656,6719340,9113382,15832722,6,0,0,9728,5,3716515847
1657,6722470,6480353,13202823,1,0,0,3584,14,7817389008
1658,6722480,6875909,13598389,7,0,0,24576,8,3053767791
1659,6724100,28654163,35378263,6,0,1,1536,5,1210425258
1660,6727200,9239401,15966601,6,0,0,41472,5,7743060320
1661,6733930,8447867,15181797,6,0,0,34816,5,5323220635
1662,6747781,28631788,35379569,5,0,1,2048,8,1934463567
1663,6749911,7752294,14502205,0,0,0,41472,5,5084981122
1664,6752270,8984996,15737266,5,0,0,19456,8,7132693702
1665,6754260,6712607,13466867,4,0,0,512,4,540133209
1666,6758750,8054799,14813549,8,0,0,39424,13,6508718705
1667,6765930,8391024,15156954,4,0,0,13312,4,2050984725
1668,6766010,7501101,14267111,9,0,0,26624,19,9183232885
1669,6766940,8278892,15045832,6,0,0,33792,5,7173941069
1670,6768170,28616225,35384395,9,0,1,7680,19,10520188436
1671,6771120,8490209,15261329,8,0,0,13312,13,4993101867
1672,6774110,7680883,14454993,1,0,0,512,14,9985830436
1673,6777510,7155617,13933127,9,0,0,27136,19,9322007483
1674,6780570,7803433,14584003,2,0,0,9216,15,9180171682
1675,6789940,8516173,15306113,7,0,0,5120,8,8166062328
1676,6790060,7975051,14765111,6,0,0,3072,5,8811863472
1677,6796030,8833763,15629793,1,0,0,80384,14,7637021581
1678,6797300,9425299,16222599,9,0,0,79872,19,7463561668
1679,6800280,8208308,15008588,6,0,0,56320,5,5627306853
1680,6810760,28578141,35388901,3,0,1,7168,12,2677172129
1681,6815660,7915410,14731070,8,0,0,7680,13,10137457979
1682,6827401,6628291,13455692,0,0,0,12288,5,3772275871
1683,6827460,7707095,14534555,7,0,0,2048,8,4788168076
1684,6830260,7107593,13937853,6,0,0,9216,5,10000596570
1685,6836440,7977444,14813884,2,0,0,1024,15,4583136203
1686,6842930,6912490,13755420,4,0,0,1024,4,4195928486
1687,6843050,8807693,15650743,4,0,0,64000,4,1219568794
1688,6846000,28547407,35393407,6,0,1,7168,5,5557990436
1689,6846240,8324903,15171143,6,0,0,19968,5,3968798845
1690,6850700,7884316,14735016,1,0,0,12288,14,2622240290
1691,6851990,10058791,16910781,2,0,0,25088,15,1295506386
1692,6852240,9206744,16058984,1,0,0,512,14,4904975533
1693,6853011,28550751,35403762,5,0,1,23552,8,6969391261
1694,6862110,8560317,15422427,7,0,0,44544,8,9335742535
1695,6868570,6908946,13777516,5,0,0,5120,8,4298996829
1696,6878270,8752950,15631220,1,0,0,4608,14,924590809
1697,6897190,7924596,14821786,7,0,0,23040,8,1532074274
1698,6901660,9296580,16198240,2,0,0,149504,15,9976609094
1699,6904920,8988131,15893051,2,0,0,83456,15,7226639549
1700,6911050,8207509,15118559,2,0,0,8704,15,5295234180
1701,6922750,6708566,13631316,6,0,0,3584,5,10157556796
1702,6923870,7719981,14643851,5,0,0,18432,8,1067733958
1703,6924200,9646269,16570469,6,0,0,20480,5,9436418723
1704,6926880,9398696,16325576,9,0,0,36864,19,4269652071
1705,6929019,28474847,35403866,1,0,1,11776,14,3612269368
1706,6932830,9156729,16089559,6,0,0,19456,5,3497506662
1707,6933210,8144367,15077577,8,0,0,3072,13,857783264
1708,6944070,8370887,15314957,4,0,0,22016,4,5813109085
1709,6945980,8637693,15583673,9,0,0,15872,19,7641669891
1710,6947270,9731942,16679212,2,0,0,52224,15,5894600771
1711,6947490,8025921,14973411,8,0,0,20480,13,6372149265
1712,6954530,10032388,16986918,9,0,0,76288,19,9810601860
1713,6958980,8155623,15114603,3,0,0,7168,12,5425140297
1714,6959190,9768861,16728051,2,0,0,8192,15,2974256018
1715,6960290,10364939,17325229,7,0,0,56320,8,3695830268
1716,6963090,9497302,16460392,6,0,0,125440,5,6126433370
1717,6976950,28488376,35465326,4,0,1,66048,4,4234012604
1718,6980520,7833855,14814375,6,0,0,1536,5,6754626220
1719,6987320,9600222,16587542,7,0,0,32768,8,3134739125
1720,6991470,7524251,14515721,8,0,0,1536,13,6941271658
1721,6992260,8102136,15094396,1,0,0,18432,14,2490404681
1722,7002460,8938933,15941393,1,0,0,20480,14,1830539829
1723,7006850,8003321,15010171,4,0,0,5120,4,3352701793
1724,7009461,8595318,15604779,0,0,0,12800,5,7219094679
1725,7014680,8670404,15685084,9,0,0,34304,19,825538537
1726,7015170,7015913,14031083,6,0,0,20480,5,5000842931
1727,7021180,28457036,35478216,9,0,1,13312,19,4666450870
1728,7031340,28470746,35502086,3,0,1,5632,12,7156779806
1729,7033550,8453397,15486947,2,0,0,21504,15,9430481975
1730,7038440,8165780,15204220,4,0,0,73216,4,7333046495
1731,7040550,8827050,15867600,8,0,0,64000,13,1628312434
1732,7047580,8887550,15935130,1,0,0,19456,14,7186283318
1733,7058050,28446622,35504672,0,0,1,4096,5,7988995222
1734,7078730,28428559,35507289,3,0,1,3072,12,6401911961
1735,7078781,28432343,35511124,7,0,1,7168,8,2436517262
1736,7080590,6867746,13948336,6,0,0,2048,5,7495010429
1737,7085440,8820605,15906045,7,0,0,20992,8,1543791763
1738,7086170,8670632,15756802,2,0,0,9728,15,3331192028
1739,7088231,28423239,35511470,7,0,1,512,8,1646840371
1740,7090150,6844872,13935022,5,0,0,6144,8,6110103087
1741,7093130,28420952,35514082,6,0,1,4096,5,2814966361
1742,7108340,8932589,16040929,6,0,0,7168,5,3127331218
1743,7110650,7344164,14454814,4,0,0,30720,4,2010759766
1744,7111110,10309860,17420970,8,0,0,74752,13,9392330695
1745,7114970,8004796,15119766,3,0,0,512,12,6222070017
1746,7117450,9191833,16309283,1,0,0,10240,14,3410555860
1747,7122100,8913114,16035214,7,0,0,13824,8,8597088215
1748,7125250,8549351,15674601,1,0,0,14336,14,3571012876
1749,7128650,8522584,15651234,9,0,0,1536,19,8111629733
1750,7131801,8094663,15226464,0,0,0,8192,5,2149037893
1751,7132360,7056549,14188909,9,0,0,3584,19,6043003023
1752,7134490,9243366,16377856,4,0,0,15872,4,158913490
1753,7138830,8918647,16057477,4,0,0,10240,4,154975303
1754,7143211,28373137,35516348,5,0,1,3584,8,10314555385
1755,7143830,9122720,16266550,4,0,0,46080,4,9110393886
1756,7144770,8965069,16109839,7,0,0,20480,8,4499873425
1757,7147500,8665445,15812945,2,0,0,23552,15,3678282206
1758,7149430,9568537,16717967,4,0,0,89088,4,7083881561
1759,7158900,9789889,16948789,5,0,0,79360,8,5184049194
1760,7162280,8094954,15257234,5,0,0,11264,8,8815722811
1761,7170871,8124670,15295541,0,0,0,8704,5,10045502320
1762,7171940,8036515,15208455,5,0,0,13824,8,4186445571
1763,7172560,8633186,15805746,1,0,0,12288,14,5758966997
1764,7178280,28339694,35517974,4,0,1,2560,4,3500526517
1765,7179190,28341050,35520240,6,0,1,3584,5,9428035241
1766,7179251,28343575,35522826,7,0,1,4096,8,957960373
1767,7179280,8229552,15408832,7,0,0,11264,8,4646534781
1768,7179930,10375395,17555325,8,0,0,146432,13,9132328861
1769,7182100,8243782,15425882,2,0,0,11264,15,7974971727
1770,7186390,9155684,16342074,7,0,0,48640,8,1276319467
1771,7189941,28335950,35525891,2,0,1,9216,15,5785613186
1772,7193580,28360211,35553791,4,0,1,4096,4,9908481662
1773,7197281,9031292,16228573,0,0,0,12800,5,8666685121
1774,7198741,9093235,16291976,0,0,0,19968,5,10465093476
1775,7198850,7781136,14979986,2,0,0,21504,15,5475161790
1776,7199720,9344027,16543747,2,0,0,67584,15,1795811231
1777,7201890,8786362,15988252,6,0,0,26624,5,8429329259
1778,7208700,9043787,16252487,9,0,0,67072,19,7044594616
1779,7221550,8920784,16142334,3,0,0,27136,12,726026777
1780,7227750,9245457,16473207,8,0,0,41984,13,3326752056
1781,7228380,28332930,35561310,9,0,1,16896,19,739303154
1782,7229470,28359023,35588493,0,0,1,17408,5,9412467665
1783,7240470,7545077,14785547,2,0,0,13312,15,9723258209
1784,7240960,28408125,35649085,2,0,1,14848,15,1253922028
1785,7246670,10721459,17968129,3,0,0,24576,12,7998861311
1786,7249490,28401916,35651406,6,0,1,2560,5,1929086383
1787,7253410,28530506,35783916,0,0,1,39424,5,9955078050
1788,7270621,8740663,16011284,0,0,0,512,5,8315162
1789,7273630,28510309,35783939,6,0,1,2560,5,2133372502
1790,7275140,9332829,16607969,5,0,0,26624,8,4227855792
1791,7286460,9027861,16314321,7,0,0,5120,8,9055944855
1792,7290170,7441079,14731249,1,0,0,512,14,1126771022
1793,7296210,9751262,17047472,6,0,0,54784,5,6807217573
1794,7296480,9901405,17197885,5,0,0,18944,8,1058212298
1795,7298060,10430465,17728525,6,0,0,34816,5,1211065813
1796,7301540,8968020,16269560,5,0,0,4608,8,291924542
1797,7308440,8994216,16302656,4,0,0,4608,4,5858351494
1798,7325500,8489340,15814840,5,0,0,6144,8,2610902694
1799,7329600,28544320,35873920,0,0,1,20480,5,2163962956
1800,7334311,28539632,35873943,2,0,1,6144,15,6238301195
1801,7344760,9067173,16411933,9,0,0,14848,19,10534097870
1802,7347180,9829993,17177173,5,0,0,14848,8,2991191493
1803,7348090,10143027,17491117,6,0,0,71680,5,3499377322
1804,7355080,28543595,35898675,0,0,1,2560,5,8286813754
1805,7355420,7806081,15161501,7,0,0,14848,8,7044072354
1806,7359641,8555475,15915116,0,0,0,29696,5,2934951743
1807,7364590,9199616,16564206,3,0,0,67072,12,5619068668
1808,7367140,9114202,16481342,4,0,0,26624,4,7968151551
1809,7368700,9038686,16407386,6,0,0,15872,5,1716304753
1810,7372771,9794372,17167143,0,0,0,25088,5,6723042697
1811,7375390,28524271,35899661,3,0,1,1536,12,415571045
1812,7376600,8420208,15796808,6,0,0,33792,5,1528800388
1813,7376620,7847325,15223945,2,0,0,23040,15,2650968495
1814,7381360,9512972,16894332,2,0,0,167424,15,2084221293
1815,7382060,9823589,17205649,1,0,0,4096,14,5262265312
1816,7383470,9729965,17113435,5,0,0,65536,8,7476096994
1817,7390890,28511037,35901927,4,0,1,3584,4,1946739962
1818,7393340,8586777,15980117,5,0,0,26624,8,10655007295
1819,7397450,28504823,35902273,6,0,1,512,5,8237667181
1820,7398020,9282931,16680951,4,0,0,5632,4,9139058661
1821,7399200,10771673,18170873,3,0,0,42496,12,6949287695
1822,7400590,8337323,15737913,2,0,0,2048,15,10566324945
1823,7400810,8541698,15942508,4,0,0,3584,4,5622468680
1824,7403760,10656812,18060572,3,0,0,15872,12,2221239534
1825,7412660,9337287,16749947,5,0,0,10240,8,6922278344
1826,7414390,8596715,16011105,9,0,0,15872,19,2531424064
1827,7419590,9967217,17386807,6,0,0,43008,5,3638967749
1828,7421201,10193211,17614412,0,0,0,75776,5,5803540129
1829,7421301,28494086,35915387,7,0,1,18944,8,8322510375
1830,7424770,9225349,16650119,5,0,0,47104,8,781454023
1831,7430090,8847917,16278007,7,0,0,27648,8,2731058746
1832,7441260,10411905,17853165,7,0,0,29184,8,8531592395
1833,7442140,9193604,16635744,6,0,0,76800,5,715933703
1834,7443610,9079522,16523132,5,0,0,35328,8,841060168
1835,7445080,9990848,17435928,6,0,0,17408,5,8503454915
1836,7452660,10405052,17857712,6,0,0,14848,5,2492943100
1837,7456620,8512360,15968980,9,0,0,7680,19,8230533576
1838,7460669,28487807,35948476,1,0,1,14848,14,8595661656
1839,7461430,7943947,15405377,4,0,0,22016,4,7338366573
1840,7464130,8767898,16232028,2,0,0,11264,15,10625867103
1841,7470510,28596617,36067127,0,0,1,9728,5,6067453034
1842,7471390,28635576,36106966,6,0,1,19456,5,9730701277
1843,7480780,28626647,36107427,3,0,1,10240,12,6320232739
1844,7483850,10811191,18295041,3,0,0,34304,12,5435693008
1845,7485820,7941489,15427309,9,0,0,4608,19,3105021006
1846,7487030,28774797,36261827,4,0,1,3072,4,8962651959
1847,7488760,9174509,16663269,5,0,0,2560,8,10057867951
1848,7496650,10460357,17957007,3,0,0,56320,12,5619626893
1849,7496910,28821753,36318663,4,0,1,1024,4,3885816846
1850,7497521,9228003,16725524,0,0,0,14336,5,2915214334
1851,7498151,8994741,16492892,0,0,0,6656,5,5838987407
1852,7502720,8810018,16312738,3,0,0,11264,12,9349354593
1853,7515680,29635002,37150682,6,0,1,275968,5,1476025721
1854,7516061,9396927,16912988,0,0,0,7168,5,1427049156
1855,7517510,29674837,37192347,2,0,1,6656,15,997461698
1856,7520510,29672351,37192861,9,0,1,6144,19,4230117049
1857,7521039,29671845,37192884,1,0,1,512,14,2073784296
1858,7521771,9168944,16690715,0,0,0,1536,5,5397265466
1859,7533441,9813541,17346982,0,0,0,11776,5,8217794839
1860,7541931,29652071,37194002,5,0,1,3072,8,1273569433
1861,7542730,7958789,15501519,4,0,0,3584,4,4291467217
1862,7543490,9027470,16570960,5,0,0,1536,8,8436714684
1863,7549880,9112586,16662466,3,0,0,40448,12,948999753
1864,7551860,8541154,16093014,3,0,0,11264,12,13964901
1865,7563630,9244428,16808058,6,0,0,10752,5,1397488392
1866,7568240,29640880,37209120,6,0,1,12800,5,7432817231
1867,7568520,29640623,37209143,9,0,1,1024,19,1244105268
1868,7569190,8574259,16143449,5,0,0,3584,8,9571106003
1869,7574501,29634665,37209166,7,0,1,2048,8,6352845621
1870,7575360,29633837,37209197,4,0,1,8192,4,6105579179
1871,7581790,8266287,15848077,7,0,0,15872,8,7829131811
1872,7586660,10325546,17912206,3,0,0,1024,12,10324680155
1873,7595060,29617018,37212078,3,0,1,4608,12,9679749995
1874,7601270,8004008,15605278,7,0,0,1536,8,7547466968
1875,7604720,8972815,16577535,4,0,0,21504,4,10283351072
1876,7613429,29598803,37212232,1,0,1,8704,14,1754497436
1877,7615510,10757469,18372979,4,0,0,3584,4,3956448737
1878,7621170,10654762,18275932,4,0,0,130048,4,514547753
1879,7623141,29590357,37213498,5,0,1,9216,8,8121701522
1880,7632790,10422923,18055713,6,0,0,36352,5,2374632873
1881,7648930,9072203,16721133,2,0,0,8704,15,7316955297
1882,7651570,9929332,17580902,2,0,0,17408,15,5123047187
1883,7653060,8458362,16111422,9,0,0,5120,19,5662570934
1884,7653370,9783369,17436739,5,0,0,2560,8,3347740177
1885,7658460,9087403,16745863,0,0,0,16384,5,1336330071
1886,7661860,9998458,17660318,7,0,0,50176,8,5109857042
1887,7662310,9429916,17092226,5,0,0,14336,8,7589058003
1888,7665750,29550014,37215764,2,0,1,3584,15,5374569584
1889,7677680,9144398,16822078,3,0,0,19456,12,9737507100
1890,7678069,29564434,37242503,1,0,1,12288,14,7311920053
1891,7681880,10712829,18394709,3,0,0,69120,12,1190499284
1892,7695519,29547855,37243374,1,0,1,12288,14,10564190736
1893,7702160,9196875,16899035,5,0,0,15360,8,8828518817
1894,7702350,9302222,17004572,9,0,0,29696,19,5877298050
1895,7708490,9417627,17126117,4,0,0,16384,4,6849716712
1896,7709670,9193444,16903114,5,0,0,13312,8,7756490226
1897,7711171,29543130,37254301,7,0,1,3584,8,5794590139
1898,7712010,9086846,16798856,3,0,0,55808,12,4118742383
1899,7712200,8329844,16042044,2,0,0,3584,15,4007217444
1900,7716970,10951476,18668446,4,0,0,93696,4,7769502602
1901,7717940,8236002,15953942,6,0,0,17408,5,1224901463
1902,7719241,29544777,37264018,2,0,1,22528,15,2260091756
1903,7735291,8951923,16687214,0,0,0,20480,5,6216088168
1904,7736340,11017674,18754014,6,0,0,3584,5,9105006841
1905,7741350,29524753,37266103,3,0,1,1536,12,7910046475
1906,7742120,9345715,17087835,5,0,0,62976,8,4047092099
1907,7743480,29545524,37289004,9,0,1,2560,19,3315103826
1908,7746870,29542800,37289670,4,0,1,1024,4,9114834266
1909,7758601,29531735,37290336,5,0,1,1024,8,1506046224
1910,7763699,29528609,37292308,1,0,1,3072,14,2332181276
1911,7764880,9301202,17066082,9,0,0,47616,19,6086382435
1912,7765150,10972182,18737332,7,0,0,1024,8,4222051051
1913,7770490,8826770,16597260,5,0,0,29696,8,8421133636
1914,7774790,9144773,16919563,4,0,0,21504,4,1856133652
1915,7777130,9349174,17126304,5,0,0,512,8,137243049
1916,7777630,29515344,37292974,0,0,1,1024,5,3356444430
1917,7783540,9389086,17172626,2,0,0,17920,15,4065229275
1918,7786000,9163600,16949600,9,0,0,2560,19,2945700635
1919,7790070,8488748,16278818,7,0,0,2560,8,10007811179
1920,7790980,9446489,17237469,6,0,0,12800,5,5978601636
1921,7803400,11039310,18842710,5,0,0,5632,8,532927733
1922,7807200,11208059,19015259,3,0,0,55296,12,1994046618
1923,7812210,8607230,16419440,5,0,0,2048,8,10729041515
1924,7812990,8455143,16268133,5,0,0,5120,8,6226513984
1925,7813880,9254253,17068133,3,0,0,6656,12,4717208145
1926,7815920,8772269,16588189,1,0,0,2048,14,8897189706
1927,7823830,9482633,17306463,9,0,0,11264,19,7933052318
1928,7825480,9017817,16843297,2,0,0,26112,15,6043910812
1929,7826470,9294632,17121102,3,0,0,25088,12,8170028126
1930,7835430,9459196,17294626,3,0,0,87040,12,1533919942
1931,7837380,10802495,18639875,5,0,0,89600,8,1957418875
1932,7854120,29442400,37296520,3,0,1,5632,12,4261016549
1933,7855390,29442718,37298108,3,0,1,15872,12,5062487547
1934,7860190,9483181,17343371,2,0,0,33280,15,10119799114
1935,7862080,9849208,17711288,7,0,0,27648,8,1638788298
1936,7863680,9325140,17188820,4,0,0,20480,4,8598345831
1937,7863810,10113078,17976888,7,0,0,28672,8,988217844
1938,7866500,8823724,16690224,6,0,0,512,5,8873366569
1939,7868610,29525591,37394201,6,0,1,40960,5,3686104383
1940,7872660,9796908,17669568,9,0,0,30208,19,5762761379
1941,7873080,8611249,16484329,5,0,0,9728,8,7199792476
1942,7875541,29553384,37428925,2,0,1,7168,15,8101524015
1943,7883870,29545078,37428948,9,0,1,4608,19,4863634418
1944,7886460,9852072,17738532,6,0,0,32768,5,10550972170
1945,7891000,9375500,17266500,5,0,0,27648,8,4849600752
1946,7894040,29655776,37549816,9,0,1,5632,19,10590785301
1947,7904450,29650404,37554854,9,0,1,8192,19,8429227666
1948,7911270,8778775,16690045,6,0,0,9216,5,276268972
1949,7914210,29670303,37584513,9,0,1,18432,19,6342247453
1950,7914650,8826198,16740848,3,0,0,36352,12,1513468231
1951,7915310,10285875,18201185,4,0,0,20992,4,9363520772
1952,7915980,9286764,17202744,4,0,0,15872,4,7189394561
1953,7916880,9670716,17587596,2,0,0,13312,15,3047813915
1954,7917079,29667690,37584769,8,0,1,9216,13,6917447966
1955,7934840,10569351,18504191,7,0,0,9216,8,6758652147
1956,7943640,9560760,17504400,3,0,0,43520,12,8535806495
1957,7945870,9477486,17423356,5,0,0,5120,8,126620313
1958,7946440,9846382,17792822,3,0,0,3584,12,9977145552
1959,7959901,8964677,16924578,0,0,0,16384,5,707179440
1960,7962570,10713277,18675847,3,0,0,14336,12,7548026057
1961,7962860,9477646,17440506,7,0,0,12288,8,2587599251
1962,7968869,29618947,37587816,8,0,1,14336,13,4835535190
1963,7972000,9932025,17904025,0,0,0,7680,5,6694075660
1964,7973800,9294283,17268083,5,0,0,5120,8,9433281356
1965,7975030,30521174,38496204,6,0,1,284160,5,4592275454
1966,7975720,8859598,16835318,5,0,0,28160,8,9005378133
1967,7983890,9591685,17575575,6,0,0,13312,5,365837705
1968,7985830,8830297,16816127,0,0,0,5632,5,9739594175
1969,8000770,9566012,17566782,6,0,0,19968,5,6048142902
1970,8002280,10275235,18277515,9,0,0,5120,19,7172998101
1971,8007601,10146763,18154364,0,0,0,7168,5,3861183925
1972,8009680,9982775,17992455,2,0,0,8192,15,10465627603
1973,8010000,9817465,17827465,6,0,0,15360,5,1123129125
1974,8017580,9135972,17153552,9,0,0,512,19,4649525641
1975,8018370,10875662,18894032,6,0,0,10752,5,8121854411
1976,8024270,8694188,16718458,4,0,0,1536,4,9079349705
1977,8026390,9306818,17333208,6,0,0,26112,5,6710132257
1978,8035690,30460537,38496227,0,0,1,1536,5,965194785
1979,8040071,30482579,38522650,5,0,1,12800,8,2301543269
1980,8042661,9256044,17298705,0,0,0,13312,5,3910557022
1981,8044311,30501045,38545356,5,0,1,9728,8,4588543428
1982,8046610,9514065,17560675,3,0,0,10752,12,1713706402
1983,8046789,30506881,38553670,1,0,1,5632,14,8596753356
1984,8048121,9259925,17308046,0,0,0,5120,5,10544675994
1985,8052060,9621275,17673335,2,0,0,12288,15,3597753994
1986,8052371,9505005,17557376,0,0,0,6656,5,2726521241
1987,8053910,8941591,16995501,3,0,0,6656,12,7067645011
1988,8055281,30539650,38594931,5,0,1,5120,8,2970630703
1989,8058410,10694489,18752899,5,0,0,5120,8,6736483098
1990,8063510,30536708,38600218,3,0,1,16896,12,4339148181
1991,8071720,9119933,17191653,7,0,0,3584,8,3878005156
1992,8073059,30553304,38626363,8,0,1,27648,13,3409461849
1993,8074041,8977510,17051551,0,0,0,13312,5,10599182170
1994,8083210,30596724,38679934,4,0,1,13824,4,10245592789
1995,8085220,9814859,17900079,2,0,0,66560,15,9452822856
1996,8087100,9343501,17430601,2,0,0,10240,15,6449459862
1997,8088710,10582746,18671456,0,0,0,9216,5,4720506631
1998,8101571,9888334,17989905,0,0,0,42496,5,9041442142
1999,8108110,9536897,17645007,5,0,0,79872,8,7812390221
2000,8108920,8845696,16954616,3,0,0,10240,12,7438143879
2001,8111490,9456898,17568388,3,0,0,4096,12,5571804339
2002,8111779,30568178,38679957,8,0,1,2048,13,2623422844
2003,8118050,8950574,17068624,5,0,0,1536,8,4033064790
2004,8123370,30556610,38679980,0,0,1,10752,5,6136295719
2005,8125140,11201849,19326989,5,0,0,59904,8,6515427246
2006,8129390,10210892,18340282,9,0,0,1024,19,7355021275
2007,8130721,30553272,38683993,5,0,1,6656,8,167045999
2008,8134430,9293028,17427458,7,0,0,1536,8,7455004408
2009,8137770,30551659,38689429,3,0,1,12288,12,3612769450
2010,8138879,30595882,38734761,1,0,1,1024,14,2229074311
2011,8140980,11021543,19162523,3,0,0,10240,12,6419952638
2012,8143210,30592537,38735747,3,0,1,1536,12,10290936558
2013,8167200,30572093,38739293,4,0,1,5632,4,1593130005
2014,8168930,9045031,17213961,9,0,0,512,19,6630623583
2015,8176030,9591987,17768017,7,0,0,12800,8,4692429884
2016,8184590,11075757,19260347,2,0,0,60928,15,10168757961
2017,8187851,9166651,17354502,0,0,0,17920,5,79075096
2018,8191450,9641498,17832948,6,0,0,17920,5,1090173031
2019,8200240,30542416,38742656,9,0,1,2048,19,7953321664
2020,8203201,30545873,38749074,2,0,1,6144,15,5207928549
2021,8205581,11219106,19424687,0,0,0,152576,5,8153543956
2022,8206400,10589130,18795530,3,0,0,28672,12,7133826761
2023,8206620,9496221,17702841,9,0,0,56832,19,6290452900
2024,8206760,9705111,17911871,7,0,0,6144,8,7095597782
2025,8207370,9303316,17510686,3,0,0,11264,12,8696697406
2026,8221620,9688356,17909976,3,0,0,19456,12,2018170750
2027,8225551,9714137,17939688,0,0,0,20992,5,9919830827
2028,8228340,30546800,38775140,3,0,1,1536,12,8396510285
2029,8230941,30544660,38775601,7,0,1,10240,8,4301821103
2030,8237670,9129482,17367152,7,0,0,6656,8,1029734334
2031,8241450,9638318,17879768,3,0,0,53248,12,9769220397
2032,8241480,11200881,19442361,3,0,0,3072,12,6253726940
2033,8242910,9993375,18236285,7,0,0,70656,8,7651098896
2034,8243381,9946313,18189694,0,0,0,18944,5,6273560260
2035,8246560,9673355,17919915,2,0,0,9728,15,6256308620
2036,8247510,9259721,17507231,3,0,0,9216,12,8065689187
2037,8250580,30577558,38828138,4,0,1,21504,4,6937318619
2038,8275641,30570218,38845859,7,0,1,9728,8,1049559228
2039,8277489,30641354,38918843,1,0,1,11776,14,6127023882
2040,8289490,9132283,17421773,7,0,0,2560,8,1495677675
2041,8292950,9448124,17741074,2,0,0,8192,15,5087970439
2042,8296700,10998345,19295045,4,0,0,17408,4,7678267339
2043,8299530,10000237,18299767,4,0,0,14848,4,8423710225
2044,8305611,9261506,17567117,0,0,0,1024,5,4437610046
2045,8314820,9112147,17426967,2,0,0,11776,15,4017085000
2046,8316040,10193803,18509843,2,0,0,2560,15,10673863402
2047,8336060,9662730,17998790,1,0,0,9216,14,1254989186
2048,8338061,30628173,38966234,7,0,1,18944,8,4028679498
2049,8338630,9379264,17717894,2,0,0,18432,15,5750513006
2050,8340900,31817288,40158188,6,0,1,712704,5,3736205142
2051,8350850,9657295,18008145,5,0,0,15872,8,6697978281
2052,8356130,9790081,18146211,4,0,0,69632,4,184573541
2053,8358420,9936800,18295220,4,0,0,512,4,7021118857
2054,8359050,10012814,18371864,4,0,0,33280,4,5343823
2055,8359230,11398765,19757995,7,0,0,12800,8,1311867339
2056,8360300,10437749,18798049,9,0,0,8192,19,7626145740
2057,8363110,9474310,17837420,7,0,0,7680,8,5604522182
2058,8363230,11220223,19583453,3,0,0,67584,12,2305681897
2059,8381690,10227719,18609409,5,0,0,48128,8,2676680309
2060,8383890,10524228,18908118,1,0,0,38912,14,3304093071
2061,8390630,9432124,17822754,5,0,0,24576,8,10157398150
2062,8390850,10331109,18721959,2,0,0,48640,15,2346443373
2063,8392210,9423033,17815243,1,0,0,18944,14,6039249213
2064,8394230,10439386,18833616,1,0,0,34304,14,3318733179
2065,8404370,10520307,18924677,7,0,0,54272,8,7125555900
2066,8405060,11095557,19500617,7,0,0,14336,8,10152952566
2067,8410200,31781131,40191331,4,0,1,1536,4,3937434041
2068,8412530,9735911,18148441,2,0,0,3072,15,7881165382
2069,8418070,10573375,18991445,7,0,0,24576,8,7994984403
2070,8421000,9337334,17758334,7,0,0,8704,8,9043622785
2071,8425120,9683728,18108848,6,0,0,51712,5,3894774314
2072,8425650,9286597,17712247,4,0,0,3072,4,3755122106
2073,8427701,31802223,40229924,7,0,1,24576,8,969440430
2074,8433610,32054284,40487894,6,0,1,211456,5,6997880930
2075,8442651,32048149,40490800,2,0,1,4608,15,10100203324
2076,8447960,10513023,18960983,1,0,0,43520,14,4212442533
2077,8454480,10282517,18736997,1,0,0,10240,14,5648381411
2078,8458600,11185737,19644337,5,0,0,17408,8,10434471615
2079,8459520,9501098,17960618,5,0,0,11776,8,6701139565
2080,8461581,32048546,40510127,5,0,1,6656,8,7355313682
2081,8465021,11371759,19836780,0,0,0,56832,5,2992437762
2082,8468431,9611687,18080118,0,0,0,22016,5,3754264610
2083,8472639,32055488,40528127,1,0,1,14848,14,10732004676
2084,8477070,10457489,18934559,7,0,0,30208,8,8991112582
2085,8479560,11339881,19819441,2,0,0,72192,15,10164369135
2086,8483740,10321539,18805279,5,0,0,4096,8,3618454222
2087,8487750,11418040,19905790,9,0,0,13312,19,709781786
2088,8493251,10948151,19441402,0,0,0,54784,5,10300343693
2089,8506110,9707786,18213896,6,0,0,1024,5,6281359237
2090,8512940,10618395,19131335,5,0,0,8704,8,7509475078
2091,8520661,10063650,18584311,0,0,0,7168,5,5560982306
2092,8520990,9550045,18071035,6,0,0,15872,5,8103342112
2093,8522350,10231999,18754349,5,0,0,1024,8,7485458704
2094,8527100,10180016,18707116,3,0,0,14848,12,4964613125
2095,8529350,10739779,19269129,5,0,0,9216,8,4318010880
2096,8531470,9616012,18147482,2,0,0,4096,15,4749895953
2097,8534500,10306471,18840971,6,0,0,24064,5,7065495696
2098,8534980,31993170,40528150,0,0,1,3584,5,5726561506
2099,8541690,9359972,17901662,5,0,0,5120,8,2958636012
2100,8543050,9667618,18210668,7,0,0,512,8,8490207128
2101,8547720,9753162,18300882,3,0,0,3584,12,188446858
2102,8552860,31999774,40552634,9,0,1,13312,19,2871822571
2103,8554290,9652037,18206327,1,0,0,9216,14,232378079
2104,8557270,9920037,18477307,6,0,0,1024,5,5929239328
2105,8571670,31999389,40571059,4,0,1,512,4,830699123
2106,8572070,11300141,19872211,5,0,0,17408,8,1862728178
2107,8572560,10118910,18691470,3,0,0,51200,12,4721877138
2108,8575560,11486225,20061785,4,0,0,75264,4,7721486284
2109,8578270,32183112,40761382,6,0,1,178176,5,6795017193
2110,8580300,10785242,19365542,1,0,0,7680,14,1283784710
2111,8582559,32184008,40766567,1,0,1,16384,14,2612331097
2112,8585161,10259444,18844605,0,0,0,6144,5,10014688921
2113,8586070,10391895,18977965,2,0,0,512,15,3743357624
2114,8590510,9694056,18284566,1,0,0,23040,14,9964118792
2115,8593860,9913082,18506942,9,0,0,6656,19,6082640779
2116,8596910,10136944,18733854,3,0,0,38912,12,1965937995
2117,8602290,10342235,18944525,1,0,0,17920,14,8214688257
2118,8603240,11840286,20443526,9,0,0,76288,19,8162504874
2119,8606380,11883232,20489612,9,0,0,4608,19,2284713492
2120,8607620,9935243,18542863,5,0,0,12288,8,8582365966
2121,8609520,10939848,19549368,9,0,0,98304,19,2393868457
2122,8613270,10653028,19266298,4,0,0,19456,4,3608145575
2123,8619320,9873457,18492777,7,0,0,24064,8,1021559680
2124,8619390,10264144,18883534,7,0,0,61952,8,4005184668
2125,8620011,9813559,18433570,0,0,0,3072,5,6920903541
2126,8622560,10231157,18853717,7,0,0,15872,8,6797774887
2127,8634370,11039058,19673428,9,0,0,512,19,10223735053
2128,8636770,10857747,19494517,6,0,0,17920,5,1592919352
2129,8639750,10111566,18751316,7,0,0,17408,8,5910945597
2130,8641290,11973591,20614881,4,0,0,17408,4,2590600671
2131,8641481,32185563,40827044,7,0,1,7680,8,2574301310
2132,8649891,32177176,40827067,2,0,1,512,15,534649241
2133,8651090,9812765,18463855,1,0,0,47616,14,3510790164
2134,8652570,10286426,18938996,5,0,0,4608,8,3973062286
2135,8652590,12148633,20801223,6,0,0,12800,5,9831828716
2136,8653580,32277270,40930850,6,0,1,114688,5,10339656686
2137,8664790,32276803,40941593,3,0,1,4608,12,5886174049
2138,8664930,9811333,18476263,2,0,0,7680,15,8633190430
2139,8672720,9503287,18176007,5,0,0,9216,8,732071527
2140,8681350,9726414,18407764,6,0,0,4608,5,1435770824
2141,8684840,10017729,18702569,1,0,0,36352,14,7986422390
2142,8686069,32255985,40942054,8,0,1,10240,13,2845000538
2143,8690090,11233755,19923845,5,0,0,7680,8,2007583443
2144,8691890,10390052,19081942,9,0,0,5120,19,8679630463
2145,8691900,10545287,19237187,5,0,0,25600,8,7898146152
2146,8695079,32249241,40944320,8,0,1,3584,13,4616087558
2147,8695200,10866390,19561590,6,0,0,19456,5,8829771919
2148,8695560,10754312,19449872,5,0,0,24576,8,8964789371
2149,8704320,9964305,18668625,7,0,0,512,8,9791308915
2150,8711761,32249879,40961640,5,0,1,5120,8,9210289509
2151,8717300,10362214,19079514,1,0,0,15872,14,7532917041
2152,8744950,9770838,18515788,1,0,0,4608,14,5132831085
2153,8746641,32218545,40965186,7,0,1,5632,8,1834583663
2154,8748070,10481294,19229364,9,0,0,78336,19,5052141627
2155,8749510,10146729,18896239,0,0,0,7168,5,1050990927
2156,8751800,9993066,18744866,7,0,0,19456,8,10221167599
2157,8759090,9767006,18526096,6,0,0,8192,5,886731862
2158,8768830,10035170,18804000,0,0,0,19456,5,17578583
2159,8777800,11388709,20166509,5,0,0,123904,8,5853354838
2160,8779840,10893393,19673233,6,0,0,8192,5,5790864060
2161,8790560,11463599,20254159,6,0,0,41472,5,8077887990
2162,8790670,9821882,18612552,3,0,0,10240,12,899713074
2163,8804130,9982641,18786771,1,0,0,4608,14,7993959164
2164,8816170,9929811,18745981,1,0,0,3584,14,5974636087
2165,8816629,32153063,40969692,8,0,1,7168,13,9800708574
2166,8817210,11084501,19901711,4,0,0,45056,4,3767243992
2167,8821030,9964314,18785344,9,0,0,28160,19,3374589284
2168,8829920,10341835,19171755,9,0,0,7680,19,3198618225
2169,8832199,32139759,40971958,8,0,1,3584,13,9178413247
2170,8837490,11164037,20001527,6,0,0,20480,5,6024293134
2171,8838611,11354628,20193239,0,0,0,70656,5,3926955261
2172,8842570,9896345,18738915,2,0,0,5120,15,3772133441
2173,8857710,10079859,18937569,6,0,0,1536,5,3327797420
2174,8863820,10112061,18975881,7,0,0,13824,8,2275469329
2175,8870770,10162851,19033621,6,0,0,9216,5,3443218724
2176,8871650,10213903,19085553,7,0,0,11776,8,2672970078
2177,8887960,10037364,18925324,2,0,0,2048,15,8884854366
2178,8888131,10048947,18937078,0,0,0,8192,5,6159501172
2179,8906010,9984723,18890733,5,0,0,23552,8,2489052212
2180,8907820,10731182,19639002,1,0,0,22016,14,3432334527
2181,8916730,10450551,19367281,3,0,0,5632,12,6589856932
2182,8917520,10157135,19074655,2,0,0,9216,15,8268895141
2183,8920680,10533271,19453951,7,0,0,13312,8,8288478605
2184,8926960,10670868,19597828,4,0,0,47104,4,559778522
2185,8930570,32041849,40972419,2,0,1,10240,15,7970778320
2186,8931579,32042466,40974045,1,0,1,2560,14,5549921356
2187,8932790,10586603,19519393,1,0,0,49152,14,7733141811
2188,8936260,11149306,20085566,2,0,0,12800,15,4798293211
2189,8945430,11275327,20220757,0,0,0,15872,5,5662383318
2190,8953379,32035265,40988644,1,0,1,15872,14,1367504754
2191,8966960,11358712,20325672,3,0,0,1536,12,5345323548
2192,8969270,10724573,19693843,4,0,0,19968,4,9425161943
2193,8970240,10214426,19184666,0,0,0,16896,5,10123416906
2194,8975990,10694724,19670714,7,0,0,34304,8,8508866421
2195,8976190,10392214,19368404,5,0,0,3584,8,4646310418
2196,8976831,10487500,19464331,0,0,0,24576,5,487192205
2197,8980550,10707186,19687736,9,0,0,31744,19,3552362593
2198,8982910,10963388,19946298,1,0,0,14336,14,5361589896
2199,8983320,10254514,19237834,5,0,0,2048,8,8724189217
2200,8983480,10662596,19646076,1,0,0,5632,14,7242496961
2201,8984570,10220903,19205473,1,0,0,24064,14,217643940
2202,8986629,32002988,40989617,1,0,1,12800,14,808308291
2203,8989670,10670569,19660239,7,0,0,26624,8,4209375560
2204,8991170,12056134,21047304,1,0,0,37888,14,6466968297
2205,8992650,10639613,19632263,6,0,0,20992,5,4106112082
2206,8992790,10000812,18993602,4,0,0,2048,4,7078832715
2207,9003910,10359269,19363179,5,0,0,33792,8,2333648951
2208,9004540,10861565,19866105,7,0,0,11776,8,1288304141
2209,9004580,10551059,19555639,7,0,0,20480,8,5217814586
2210,9010600,10910882,19921482,7,0,0,2560,8,7927889900
2211,9013110,31993208,41006318,9,0,1,3072,19,6638585756
2212,9019610,11508947,20528557,2,0,0,1024,15,10070326253
2213,9020030,10971147,19991177,4,0,0,25088,4,2291394659
2214,9024980,31994160,41019140,3,0,1,7168,12,3291351026
2215,9028700,11435776,20464476,2,0,0,60416,15,569273077
2216,9036420,10826066,19862486,3,0,0,80384,12,3050461248
2217,9037210,11287971,20325181,7,0,0,46592,8,1656607408
2218,9038190,11897607,20935797,7,0,0,77312,8,8186223814
2219,9042460,12054638,21097098,5,0,0,46592,8,8400105693
2220,9047820,10891412,19939232,6,0,0,28672,5,7491661460
2221,9057000,10617075,19674075,3,0,0,2048,12,9308172241
2222,9061530,11682435,20743965,5,0,0,93184,8,10406687982
2223,9062990,10562831,19625821,6,0,0,49664,5,8395630213
2224,9066480,10585616,19652096,2,0,0,13824,15,7031465330
2225,9077880,31941283,41019163,9,0,1,1024,19,2775725295
2226,9078920,11136978,20215898,2,0,0,74240,15,4932221512
2227,9079900,10948486,20028386,1,0,0,2560,14,4061197744
2228,9081810,11315803,20397613,2,0,0,32256,15,9070352887
2229,9082040,11259492,20341532,2,0,0,3584,15,3921198493
2230,9091370,10826299,19917669,4,0,0,38912,4,1412429818
2231,9099850,12085635,21185485,9,0,0,92672,19,9628030121
2232,9107330,10871165,19978495,9,0,0,43008,19,10129356549
2233,9108490,31910696,41019186,4,0,1,1536,4,4461422932
2234,9109181,10538680,19647861,0,0,0,5632,5,5938772944
2235,9109260,12187756,21297016,7,0,0,20480,8,4495206905
2236,9111090,10355905,19466995,1,0,0,3072,14,4853843594
2237,9118900,11430794,20549694,2,0,0,16896,15,9397696687
2238,9123260,11259258,20382518,1,0,0,37376,14,8710810582
2239,9126010,10791838,19917848,5,0,0,512,8,4737850385
2240,9127641,10483025,19610666,0,0,0,20992,5,4717777803
2241,9133210,10471037,19604247,9,0,0,20992,19,7421722726
2242,9139750,31879459,41019209,4,0,1,9216,4,7509556264
2243,9142480,11184463,20326943,5,0,0,4096,8,4192530913
2244,9145690,12200409,21346099,5,0,0,8704,8,5489356548
2245,9148360,10835150,19983510,5,0,0,16384,8,2902556672
2246,9148790,10929866,20078656,9,0,0,55296,19,3272076089
2247,9155040,10765639,19920679,9,0,0,9216,19,5412594823
2248,9155260,10730413,19885673,1,0,0,35840,14,8254119970
2249,9159260,11012428,20171688,9,0,0,16896,19,10614752008
2250,9159310,10795183,19954493,9,0,0,24576,19,2888297367
2251,9163291,31886990,41050281,5,0,1,24576,8,2120313333
2252,9163511,31889702,41053213,5,0,1,4608,8,3033142587
2253,9165810,12156985,21322795,3,0,0,17920,12,1482606598
2254,9168460,10773447,19941907,5,0,0,8704,8,494122073
2255,9187680,31866199,41053879,9,0,1,11264,19,2787655581
2256,9188309,31890757,41079066,8,0,1,31232,13,7734016724
2257,9189210,11173965,20363175,2,0,0,60928,15,7951496550
2258,9192510,10586474,19778984,9,0,0,34304,19,2269252250
2259,9199240,10675490,19874730,9,0,0,8192,19,6796461232
2260,9212700,11668384,20881084,2,0,0,25088,15,7736881595
2261,9213260,11012356,20225616,7,0,0,15872,8,10105935941
2262,9213660,31875091,41088751,9,0,1,4096,19,8586402680
2263,9216450,31878202,41094652,0,0,1,19968,5,10421650931
2264,9218420,10799757,20018177,9,0,0,11776,19,3087317377
2265,9228140,31887992,41116132,9,0,1,4096,19,10706863747
2266,9230000,11404955,20634955,9,0,0,16384,19,6809886186
2267,9236679,31882359,41119038,1,0,1,4608,14,9811464195
2268,9240821,31880483,41121304,5,0,1,3584,8,9646928837
2269,9249110,11621765,20870875,7,0,0,512,8,2326676939
2270,9249260,10485294,19734554,6,0,0,1024,5,1540161636
2271,9255680,11573771,20829451,4,0,0,34304,4,6548863852
2272,9262500,11944605,21207105,1,0,0,10752,14,6248045465
2273,9266679,31857211,41123890,8,0,1,4096,13,6068217924
2274,9270330,31853906,41124236,9,0,1,512,19,7604725725
2275,9275070,11695291,20970361,3,0,0,6656,12,1041343654
2276,9280700,10848034,20128734,2,0,0,12800,15,3741489222
2277,9284120,12152760,21436880,7,0,0,27648,8,284675085
2278,9303319,31821583,41124902,8,0,1,11264,13,9075855160
2279,9310700,10577024,19887724,1,0,0,6656,14,1214583153
2280,9312050,11259574,20571624,6,0,0,2048,5,3404398512
2281,9316040,10765603,20081643,4,0,0,9728,4,5754901432
2282,9334880,12195755,21530635,5,0,0,7168,8,389585949
2283,9335120,31790448,41125568,0,0,1,11264,5,6554397035
2284,9336820,11140451,20477271,6,0,0,8192,5,3425150907
2285,9337540,31788694,41126234,0,0,1,1024,5,8972179922
2286,9340210,11058518,20398728,2,0,0,3584,15,10036823636
2287,9344020,12539246,21883266,2,0,0,47616,15,3253638671
2288,9346940,12334553,21681493,5,0,0,37376,8,6025347815
2289,9349490,10645766,19995256,7,0,0,13312,8,4811910755
2290,9351360,11315815,20667175,9,0,0,41472,19,5334342045
2291,9352970,11157641,20510611,7,0,0,15360,8,1581624813
2292,9354280,10601328,19955608,6,0,0,3584,5,8522719644
2293,9359530,12350626,21710156,3,0,0,12800,12,8894232822
2294,9367240,11439909,20807149,5,0,0,10752,8,926240743
2295,9386260,10849519,20235779,9,0,0,33280,19,8592577915
2296,9386300,31773086,41159386,3,0,1,12288,12,6650884052
2297,9389070,31770339,41159409,9,0,1,2048,19,3061763102
2298,9392280,31776064,41168344,4,0,1,10240,4,5760579308
2299,9394870,11808913,21203783,9,0,0,29696,19,1272068017
2300,9395680,11212245,20607925,2,0,0,90112,15,2898223791
2301,9398400,12564214,21962614,9,0,0,33280,19,7599447836
2302,9413140,11057443,20470583,4,0,0,19968,4,4252341565
2303,9415640,10839790,20255430,2,0,0,4096,15,3896097885
2304,9417110,31834074,41251184,6,0,1,101888,5,8146284628
2305,9427140,31920764,41347904,6,0,1,30208,5,6863187384
2306,9430700,31925636,41356336,9,0,1,8704,19,6166795899
2307,9431330,31928872,41360202,6,0,1,6144,5,1883670791
2308,9440639,31930691,41371330,1,0,1,10240,14,9254350068
2309,9443170,12490055,21933225,6,0,0,40448,5,8162306294
2310,9444270,11429147,20873417,9,0,0,8192,19,5282218159
2311,9449740,11313627,20763367,4,0,0,49664,4,848587184
2312,9450330,11105627,20555957,4,0,0,20480,4,8927867733
2313,9452971,11156560,20609531,0,0,0,1024,5,10062756413
2314,9458791,31923024,41381815,2,0,1,11264,15,2691568454
2315,9460981,31975322,41436303,5,0,1,4096,8,129099757
2316,9466450,10979595,20446045,5,0,0,8192,8,7121542017
2317,9472130,12635794,22107924,9,0,0,41984,19,3818205446
2318,9474271,32017302,41491573,5,0,1,19456,8,7366229353
2319,9479750,11910157,21389907,6,0,0,15872,5,4528332247
2320,9491560,11645557,21137117,6,0,0,57344,5,9155347000
2321,9492940,11448993,20941933,0,0,0,12288,5,3096616939
2322,9495262,11971599,21466861,1,0,0,5120,14,10240930205
2323,9499680,10803423,20303103,6,0,0,25088,5,1981874274
2324,9499911,31991685,41491596,5,0,1,1024,8,9778146044
2325,9500280,11108916,20609196,2,0,0,4096,15,4511976270
2326,9501300,32005630,41506930,4,0,1,16896,4,927934489
2327,9505291,32049706,41554997,5,0,1,3072,8,4206205824
2328,9514930,32040090,41555020,9,0,1,15360,19,7447846409
2329,9515800,32039243,41555043,4,0,1,2048,4,2747470938
2330,9515960,10989948,20505908,1,0,0,7680,14,791219734
2331,9522489,32037904,41560393,8,0,1,3584,13,6864451110
2332,9530170,10943876,20474046,1,0,0,11264,14,4612992961
2333,9538400,10845389,20383789,2,0,0,4096,15,8872049189
2334,9566249,31994167,41560416,8,0,1,3072,13,9174826514
2335,9571240,31992810,41564050,9,0,1,3072,19,8092733373
2336,9571290,32024267,41595557,3,0,1,3584,12,3484782100
2337,9601881,10960339,20562220,0,0,0,20480,5,6321091248
2338,9602740,12179566,21782306,8,0,0,23040,13,10694230413
2339,9605960,12430608,22036568,1,0,0,11776,14,812528903
2340,9611660,31988403,41600063,4,0,1,7168,4,1637567850
2341,9618081,11004067,20622148,0,0,0,18432,5,8623190812
2342,9626030,12144542,21770572,4,0,0,49664,4,8506574740
2343,9630439,31971250,41601689,1,0,1,2560,14,5470733135
2344,9636940,11482682,21119622,6,0,0,68096,5,3636781049
2345,9659820,11793384,21453204,1,0,0,48640,14,5025338763
2346,9661201,11209472,20870673,0,0,0,35328,5,7734172306
2347,9668980,11639447,21308427,4,0,0,37376,4,172787380
2348,9669681,31934594,41604275,5,0,1,4096,8,5211101538
2349,9674420,12224625,21899045,2,0,0,51712,15,7384826724
2350,9678230,12414984,22093214,2,0,0,12800,15,1015884951
2351,9683010,11457562,21140572,6,0,0,11264,5,8452859485
2352,9684470,12574212,22258682,2,0,0,15872,15,7237779173
2353,9685901,12467061,22152962,0,0,0,29696,5,7283491814
2354,9688120,31919061,41607181,6,0,1,4608,5,1283892913
2355,9698850,10939895,20638745,7,0,0,12288,8,4386503228
2356,9705080,12833016,22538096,1,0,0,151040,14,9475989316
2357,9707900,11574352,21282252,4,0,0,46592,4,8024497924
2358,9707989,31903058,41611047,1,0,1,6144,14,5308528242
2359,9708800,11581953,21290753,7,0,0,20480,8,9237213934
2360,9709411,11173412,20882823,0,0,0,5632,5,1056997930
2361,9710020,11121950,20831970,9,0,0,8192,19,2435766003
2362,9710760,11201458,20912218,1,0,0,4096,14,4346977928
2363,9716690,11237291,20953981,2,0,0,18432,15,4101508498
2364,9723891,11701399,21425290,0,0,0,14848,5,728249992
2365,9733600,11744726,21478326,1,0,0,3584,14,9564896943
2366,9735860,11167786,20903646,4,0,0,14848,4,10546443559
2367,9747800,11717470,21465270,6,0,0,39424,5,586045995
2368,9762050,12106685,21868735,9,0,0,22016,19,8853127868
2369,9773311,11912417,21685728,0,0,0,13824,5,7859116466
2370,9774600,12475440,22250040,1,0,0,4096,14,4681884328
2371,9775350,11508025,21283375,7,0,0,3584,8,2265685886
2372,9779200,11710802,21490002,1,0,0,11264,14,3814568840
2373,9785740,10991376,20777116,5,0,0,512,8,1810097750
2374,9788401,31823312,41611713,2,0,1,11264,15,8894086847
2375,9793060,11042274,20835334,6,0,0,1024,5,6577185936
2376,9794731,31845873,41640604,2,0,1,7680,15,10248704273
2377,9795300,11863545,21658845,1,0,0,88576,14,2184613776
2378,9798330,31842297,41640627,0,0,1,2048,5,259679923
2379,9802900,11086131,20889031,9,0,0,6144,19,9371360482
2380,9805340,11814658,21619998,9,0,0,7168,19,1881869947
2381,9807830,12204174,22012004,1,0,0,47104,14,3346029824
2382,9809060,11226677,21035737,7,0,0,59904,8,2914937420
2383,9809450,11664142,21473592,4,0,0,22016,4,7264453173
2384,9810110,10992540,20802650,2,0,0,4608,15,2504966863
2385,9811380,11609363,21420743,6,0,0,30208,5,3515081821
2386,9814610,13022423,22837033,9,0,0,140288,19,4773679476
2387,9815120,11267759,21082879,1,0,0,16896,14,4303813012
2388,9824650,11490981,21315631,4,0,0,12288,4,6922672810
2389,9828290,11439743,21268033,1,0,0,89088,14,8526813587
2390,9831821,11606540,21438361,0,0,0,4608,5,7714231984
2391,9832210,31808464,41640674,9,0,1,1024,19,8528247816
2392,9834530,12477232,22311762,4,0,0,17920,4,10513265175
2393,9835800,11358912,21194712,3,0,0,30208,12,7941206059
2394,9840830,11529807,21370637,1,0,0,4096,14,6676907833
2395,9846350,11516249,21362599,4,0,0,22528,4,6894003161
2396,9848240,31794380,41642620,2,0,1,3072,15,9331015326
2397,9849350,11519993,21369343,2,0,0,19456,15,9143737819
2398,9855129,31812498,41667627,1,0,1,18432,14,3077970681
2399,9857930,11889144,21747074,4,0,0,2560,4,1631895185
2400,9861940,31821609,41683549,3,0,1,2048,12,7065275811
2401,9862680,11999324,21862004,4,0,0,61952,4,10462745338
2402,9879140,12041738,21920878,9,0,0,5120,19,4745525365
2403,9879290,31805232,41684522,4,0,1,12800,4,5196476781
2404,9880890,31823022,41703912,3,0,1,4096,12,3112725845
2405,9887550,11589653,21477203,2,0,0,11776,15,3376820058
2406,9888070,31828062,41716132,0,0,1,4096,5,4352465855
2407,9888250,13068765,22957015,4,0,0,44032,4,8841365452
2408,9892020,31825406,41717426,4,0,1,16896,4,2166977726
2409,9898100,12011763,21909863,6,0,0,4096,5,3077582836
2410,9899079,31845745,41744824,8,0,1,13824,13,10608646832
2411,9899640,12096271,21995911,2,0,0,2560,15,3114916700
2412,9901060,11383430,21284490,9,0,0,3584,19,2237657213
2413,9901361,31869012,41770373,2,0,1,14336,15,2084335175
2414,9902860,13216111,23118971,4,0,0,20992,4,10286679270
2415,9903340,13087473,22990813,6,0,0,3584,5,9790139390
2416,9905400,12115980,22021380,5,0,0,18432,8,10119590840
2417,9905590,31867369,41772959,3,0,1,4096,12,10421035338
2418,9906500,11616114,21522614,5,0,0,14848,8,8620064671
2419,9906560,31942202,41848762,0,0,1,9728,5,644473135
2420,9907521,11588996,21496517,0,0,0,512,5,10347482197
2421,9908200,31940818,41849018,9,0,1,9216,19,4285010076
2422,9914670,12433472,22348142,7,0,0,20480,8,6784447387
2423,9918200,11510233,21428433,1,0,0,10240,14,7197767724
2424,9925850,12376194,22302044,1,0,0,74240,14,9510654987
2425,9945460,12006991,21952451,6,0,0,13824,5,1098001453
2426,9945781,11680012,21625793,0,0,0,18944,5,2481938100
2427,9951740,12608311,22560051,1,0,0,27136,14,2721554910
2428,9965480,11737142,21702622,2,0,0,33280,15,4740996416
2429,9966300,12249407,22215707,7,0,0,41472,8,4934366359
2430,9971260,32051545,42022805,0,0,1,30208,5,9468319287
2431,9974239,32181092,42155331,1,0,1,512,14,10238243519
2432,9976360,11716099,21692459,5,0,0,22016,8,6823891583
2433,9982691,11603336,21586027,0,0,0,27648,5,7078146293
2434,10010690,12688125,22698815,1,0,0,74240,14,8583087298
2435,10014780,11824558,21839338,3,0,0,75264,12,6573701646
2436,10018690,12109591,22128281,2,0,0,13312,15,9819902
2437,10021680,11784068,21805748,7,0,0,3072,8,1323425204
2438,10026630,12556351,22582981,2,0,0,33280,15,1574464657
2439,10033390,12956308,22989698,2,0,0,19968,15,7319823227
2440,10041310,11760742,21802052,5,0,0,512,8,10365663245
2441,10041620,12046437,22088057,7,0,0,44032,8,8803563560
2442,10044150,32114407,42158557,9,0,1,5120,19,5893605699
2443,10049830,11862864,21912694,1,0,0,9216,14,7550049195
2444,10049910,11930043,21979953,7,0,0,56832,8,2083502164
2445,10053900,11438945,21492845,7,0,0,3584,8,1109871954
2446,10055730,11650503,21706233,8,0,0,11776,13,7668646192
2447,10063259,32099484,42162743,1,0,1,6656,14,899474990
2448,10065310,11777795,21843105,9,0,0,12288,19,4415833902
2449,10066471,32195758,42262229,5,0,1,13824,8,7967543113
2450,10072880,32192713,42265593,0,0,1,3072,5,7708505096
2451,10077110,12272147,22349257,5,0,0,3584,8,8233364066
2452,10080510,12122538,22203048,8,0,0,115200,13,3471639215
2453,10084531,12703293,22787824,0,0,0,115712,5,6263378457
2454,10084660,13027892,23112552,6,0,0,7680,5,7833634740
2455,10088880,12280154,22369034,5,0,0,5632,8,7390216702
2456,10089530,11819054,21908584,8,0,0,31232,13,4017043727
2457,10095741,32174678,42270419,5,0,1,7680,8,9843671051
2458,10102590,12129753,22232343,8,0,0,36864,13,5405627768
2459,10117320,12002951,22120271,2,0,0,40448,15,8834602830
2460,10120390,13170286,23290676,4,0,0,105984,4,1690191723
2461,10125090,32192961,42318051,4,0,1,3584,4,4102965659
2462,10126920,12179359,22306279,7,0,0,13824,8,4701676790
2463,10127280,12259331,22386611,5,0,0,11776,8,1112104751
2464,10127410,32200185,42327595,0,0,1,23040,5,8693308891
2465,10131940,12467704,22599644,1,0,0,10752,14,5539671226
2466,10134851,12185941,22320792,0,0,0,20480,5,5339030908
2467,10139930,32188580,42328510,4,0,1,2048,4,10051465378
2468,10143250,12429529,22572779,1,0,0,34816,14,8999399169
2469,10145140,12194592,22339732,4,0,0,13824,4,4633384152
2470,10161210,11933899,22095109,6,0,0,6144,5,4568963711
2471,10161270,11833838,21995108,8,0,0,49664,13,4670083954
2472,10184490,12036590,22221080,8,0,0,17408,13,9079393617
2473,10197090,12253741,22450831,8,0,0,17920,13,4396011063
2474,10199000,32188404,42387404,4,0,1,20992,4,2050672150
2475,10203180,12471788,22674968,7,0,0,8704,8,7752024466
2476,10209941,32243731,42453672,2,0,1,7168,15,6592396701
2477,10210091,12720670,22930761,0,0,0,61952,5,3763708412
2478,10214950,12038873,22253823,7,0,0,12288,8,815852877
2479,10216180,13089674,23305854,1,0,0,47616,14,8214097804
2480,10229910,12332238,22562148,5,0,0,6656,8,847950568
2481,10247381,12338470,22585851,0,0,0,2560,5,9938169469
2482,10250040,11917028,22167068,5,0,0,32256,8,168615296
2483,10257420,12283195,22540615,1,0,0,8192,14,101156150
2484,10262110,12405212,22667322,1,0,0,6144,14,6597457978
2485,10266930,32269201,42536131,6,0,1,8192,5,1110350076
2486,10268031,32268356,42536387,5,0,1,9216,8,8072318749
2487,10270130,32272355,42542485,3,0,1,4096,12,5421364812
2488,10274380,12210117,22484497,1,0,0,16384,14,4202258998
2489,10284640,12465475,22750115,2,0,0,33280,15,167096643
2490,10288030,32254478,42542508,9,0,1,11776,19,5956625170
2491,10292210,12297728,22589938,1,0,0,13312,14,4107043020
2492,10294180,13079306,23373486,7,0,0,49152,8,9806615516
2493,10304240,11944529,22248769,8,0,0,50688,13,4544496622
2494,10311760,13189520,23501280,2,0,0,8704,15,1729440731
2495,10319120,32355124,42674244,0,0,1,19456,5,8534852577
2496,10326990,12294537,22621527,8,0,0,17408,13,3587901567
2497,10327840,11905462,22233302,4,0,0,3072,4,1094660720
2498,10339620,12202422,22542042,1,0,0,4608,14,10514249379
2499,10341500,12539896,22881396,2,0,0,13312,15,10484858803
2500,10346980,12447286,22794266,2,0,0,8704,15,3476993204
2501,10352390,12522339,22874729,4,0,0,107520,4,6021431688
2502,10367811,12242805,22610616,0,0,0,7680,5,7073555255
2503,10372970,12295623,22668593,6,0,0,4096,5,7587062473
2504,10375561,12734620,23110181,0,0,0,53248,5,10352012839
2505,10377720,12174017,22551737,7,0,0,31744,8,8195672537
2506,10382590,32294240,42676830,9,0,1,4096,19,6549115283
2507,10387210,12631001,23018211,1,0,0,9728,14,3076484360
2508,10388280,12588122,22976402,8,0,0,1536,13,116539052
2509,10390080,12776078,23166158,2,0,0,32256,15,9964189367
2510,10392001,32295465,42687466,2,0,1,7680,15,5243424666
2511,10393540,12700394,23093934,1,0,0,43520,14,10227729514
2512,10398160,12809578,23207738,7,0,0,22528,8,8536725675
2513,10398530,11979021,22377551,6,0,0,12288,5,1107510839
2514,10401640,32285849,42687489,2,0,1,5120,15,1189826957
2515,10404650,12488157,22892807,6,0,0,37376,5,777451081
2516,10406241,32281271,42687512,2,0,1,3072,15,5247655519
2517,10418590,12166442,22585032,5,0,0,6656,8,3484170885
2518,10434280,12158691,22592971,2,0,0,9728,15,3153225397
2519,10441970,12396958,22838928,5,0,0,6144,8,345739202
2520,10443430,12550526,22993956,7,0,0,10240,8,9542744344
2521,10447180,12625804,23072984,7,0,0,19968,8,6451746204
2522,10450170,11952686,22402856,8,0,0,4608,13,2213531406
2523,10450200,12613300,23063500,2,0,0,8192,15,5618310522
2524,10453389,32246816,42700205,1,0,1,2048,14,10631703171
2525,10456970,12334621,22791591,8,0,0,12288,13,2608308854
2526,10457970,32252419,42710389,2,0,1,3584,15,7988194960
2527,10467850,12196782,22664632,8,0,0,2048,13,5506314162
2528,10472190,12191772,22663962,2,0,0,10240,15,5531427360
2529,10479100,32231312,42710412,3,0,1,512,12,5367293045
2530,10480940,12513507,22994447,5,0,0,1536,8,406284179
2531,10489290,12848282,23337572,6,0,0,89600,5,2852733249
2532,10493290,12587361,23080651,4,0,0,25088,4,893938375
2533,10497500,12793823,23291323,6,0,0,2048,5,1292549813
2534,10507739,32210207,42717946,8,0,1,6656,13,6846788133
2535,10511189,32326356,42837545,1,0,1,6144,14,6659055219
2536,10520950,12476862,22997812,0,0,0,1536,5,5742425734
2537,10523720,12882246,23405966,4,0,0,25600,4,2863288755
2538,10523990,12387872,22911862,1,0,0,62464,14,5423675257
2539,10529460,12651439,23180899,8,0,0,26112,13,3918760018
2540,10532270,32306101,42838371,2,0,1,7680,15,7169278860
2541,10532960,12344357,22877317,6,0,0,8192,5,3711724215
2542,10537010,13178621,23715631,4,0,0,45056,4,629522330
2543,10537071,12807723,23344794,0,0,0,23552,5,314759089
2544,10546540,32330385,42876925,6,0,1,11776,5,2069304368
2545,10548180,32474300,43022480,3,0,1,14848,12,6285162985
2546,10549650,12860083,23409733,2,0,0,12288,15,10636522495
2547,10550790,32501430,43052220,0,0,1,24576,5,7457564013
2548,10551340,13182722,23734062,5,0,0,60416,8,4957258988
2549,10555110,32589298,43144408,6,0,1,4096,5,416401847
2550,10557070,12959146,23516216,1,0,0,43520,14,7779115944
2551,10561071,12608854,23169925,0,0,0,12288,5,7191376150
2552,10574730,13009236,23583966,2,0,0,55296,15,2824869865
2553,10576860,12552728,23129588,1,0,0,6144,14,4729389054
2554,10582460,12474031,23056491,8,0,0,49664,13,9748154787
2555,10583010,32561421,43144431,2,0,1,512,15,5195700730
2556,10583029,32561425,43144454,8,0,1,1024,13,7891969928
2557,10586280,32558197,43144477,2,0,1,1536,15,8536652279
2558,10596410,12245505,22841915,7,0,0,9728,8,208605740
2559,10597810,32546690,43144500,9,0,1,1536,19,7978101096
2560,10600820,12874404,23475224,6,0,0,14848,5,1561361028
2561,10617040,13221820,23838860,5,0,0,58368,8,7736911385
2562,10619620,12316320,22935940,4,0,0,16896,4,10008386366
2563,10620530,12594675,23215205,4,0,0,8704,4,7160358901
2564,10626530,12313721,22940251,6,0,0,2048,5,7896353634
2565,10627800,13106909,23734709,1,0,0,2048,14,6568247384
2566,10634290,13347221,23981511,1,0,0,1024,14,285545237
2567,10635100,13022830,23657930,2,0,0,23552,15,8917640364
2568,10637901,12381737,23019638,0,0,0,4608,5,2469353128
2569,10640590,12487080,23127670,4,0,0,26112,4,4321003364
2570,10646130,32530934,43177064,6,0,1,9728,5,111721006
2571,10651131,13159469,23810600,0,0,0,73728,5,7603885780
2572,10656059,32893954,43550013,1,0,1,8192,14,6129259663
2573,10657970,13041235,23699205,2,0,0,48128,15,4939855152
2574,10658540,33019189,43677729,2,0,1,10240,15,9500530955
2575,10661490,12721471,23382961,1,0,0,30720,14,355526695
2576,10661501,33021720,43683221,5,0,1,17920,8,8519055534
2577,10668000,12917089,23585089,6,0,0,3584,5,7243948641
2578,10668540,12886374,23554914,6,0,0,33280,5,1546929209
2579,10670420,12574903,23245323,2,0,0,20992,15,9779239314
2580,10673360,13168331,23841691,8,0,0,9216,13,9494183918
2581,10675140,13479010,24154150,2,0,0,68608,15,10406838384
2582,10690240,13275001,23965241,4,0,0,53248,4,5932199269
2583,10699171,13082809,23781980,0,0,0,49152,5,7238806352
2584,10699210,13348972,24048182,6,0,0,6656,5,95339479
2585,10700591,13383411,24084002,0,0,0,2560,5,6368244219
2586,10701870,33050150,43752020,9,0,1,3584,19,3532137821
2587,10702020,13516248,24218268,4,0,0,53760,4,4893260987
2588,10704830,33056168,43760998,3,0,1,3072,12,6356070018
2589,10708690,12548026,23256716,2,0,0,10752,15,2485352101
2590,10708719,33052740,43761459,8,0,1,10240,13,10133775928
2591,10708870,33134476,43843346,0,0,1,1536,5,8338203872
2592,10712240,12470554,23182794,6,0,0,6144,5,8346979243
2593,10717040,12455872,23172912,3,0,0,9728,12,8784684648
2594,10723290,13696789,24420079,5,0,0,10240,8,5470621068
2595,10733350,13421915,24155265,2,0,0,3584,15,10239982833
2596,10733460,13125636,23859096,1,0,0,10752,14,5682272089
2597,10740330,12892146,23632476,8,0,0,24576,13,2557774132
2598,10745869,33102623,43848492,1,0,1,8192,14,491157413
2599,10755011,12812084,23567095,0,0,0,29184,5,3427107277
2600,10758580,33090898,43849478,0,0,1,1536,5,8808085998
2601,10760780,12772336,23533116,4,0,0,16896,4,3629434918
2602,10765620,13280511,24046131,1,0,0,43520,14,5791532601
2603,10770161,12996820,23766981,0,0,0,19456,5,2867557699
2604,10775890,12612414,23388304,5,0,0,17408,8,468697500
2605,10776110,33076274,43852384,2,0,1,4608,15,8202418286
2606,10784240,13137846,23922086,7,0,0,1024,8,7175744438
2607,10787800,33215105,44002905,6,0,1,30208,5,9563917161
2608,10794949,33397435,44192384,1,0,1,85504,14,4049369490
2609,10796540,13184636,23981176,0,0,0,52224,5,6896054558
2610,10797780,13092626,23890406,7,0,0,58368,8,4824326238
2611,10798540,13270519,24069059,8,0,0,48128,13,5901332465
2612,10798850,13475389,24274239,5,0,0,68608,8,2180188213
2613,10816720,13690601,24507321,5,0,0,37376,8,3130026109
2614,10818130,13457076,24275206,6,0,0,3072,5,4229067188
2615,10822370,33436026,44258396,4,0,1,22016,4,8178746349
2616,10832850,33428452,44261302,0,0,1,4608,5,10510872133
2617,10851490,33433700,44285190,3,0,1,11264,12,5940614937
2618,10857680,13324928,24182608,7,0,0,38912,8,695716958
2619,10864730,33421126,44285856,9,0,1,1024,19,6874818826
2620,10868740,13080254,23948994,0,0,0,77824,5,3687984705
2621,10870230,13525756,24395986,6,0,0,82944,5,8963614579
2622,10873770,12946548,23820318,6,0,0,18432,5,10225513760
2623,10876050,12944759,23820809,2,0,0,1536,15,1829289703
2624,10886760,33401362,44288122,0,0,1,3584,5,9348632705
2625,10893330,13517655,24410985,6,0,0,49152,5,10350813174
2626,10896150,13103283,23999433,7,0,0,38912,8,893816415
2627,10902920,13078926,23981846,1,0,0,1024,14,10466486331
2628,10903089,33661325,44564414,1,0,1,108032,14,1945546999
2629,10908600,13685171,24593771,5,0,0,78336,8,2503715033
2630,10911760,12790120,23701880,8,0,0,8704,13,4613623992
2631,10912390,13574597,24486987,0,0,0,41472,5,5221786134
2632,10927230,13633659,24560889,4,0,0,13824,4,4601833955
2633,10928380,12751324,23679704,7,0,0,8192,8,5401330578
2634,10928720,13623387,24552107,3,0,0,37376,12,7073445412
2635,10928890,13796941,24725831,2,0,0,73216,15,2091003905
2636,10929470,13844757,24774227,5,0,0,3072,8,10514988196
2637,10945170,13296076,24241246,3,0,0,66048,12,3140380032
2638,10948050,12957161,23905211,2,0,0,22528,15,2218288806
2639,10950210,13853102,24803312,1,0,0,55808,14,5469553014
2640,10958250,33624116,44582366,2,0,1,16384,15,2473108474
2641,10958260,13074588,24032848,5,0,0,109568,8,7726066747
2642,10966130,12848549,23814679,8,0,0,13312,13,8598346084
2643,10971550,33646840,44618390,9,0,1,2560,19,6732913337
2644,10973109,33647227,44620336,8,0,1,3072,13,1303831480
2645,10977820,12578053,23555873,3,0,0,3072,12,8490046710
2646,10986250,13203089,24189339,8,0,0,22016,13,9649586678
2647,10986810,33646200,44633010,9,0,1,15872,19,85157102
2648,10989620,13259917,24249537,2,0,0,27136,15,5689377278
2649,10993170,13787008,24780178,6,0,0,19456,5,6175204187
2650,10997470,13453555,24451025,0,0,0,9216,5,374483813
2651,10998080,13277633,24275713,8,0,0,1536,13,7247642440
2652,11001930,33774429,44776359,3,0,1,26624,12,5890896103
2653,11021220,33880081,44901301,6,0,1,4096,5,9783423917
2654,11023930,13168864,24192794,6,0,0,11264,5,9592324228
2655,11024420,13228892,24253312,8,0,0,12288,13,2894635913
2656,11028740,13308754,24337494,5,0,0,2048,8,9819119643
2657,11029119,33880343,44909462,1,0,1,8192,14,7124212373
2658,11045910,33863575,44909485,3,0,1,3072,12,6349415418
2659,11055530,33890685,44946215,0,0,1,18944,5,10362059492
2660,11055930,33890308,44946238,3,0,1,6656,12,2138486427
2661,11057790,13112939,24170729,1,0,0,37888,14,1222442243
2662,11064330,33892083,44956413,3,0,1,16384,12,6295131388
2663,11070230,12917301,23987531,2,0,0,18432,15,2759579386
2664,11077350,13549595,24626945,1,0,0,9216,14,7690373938
2665,11079000,13387349,24466349,1,0,0,36864,14,10612246205
2666,11082160,34062565,45144725,0,0,1,52224,5,2169999614
2667,11082270,13237947,24320217,0,0,0,34304,5,1457143066
2668,11084500,13117365,24201865,2,0,0,29696,15,1513863623
2669,11092540,13796234,24888774,8,0,0,62976,13,7742753431
2670,11105790,13821281,24927071,6,0,0,84992,5,3034070279
2671,11105880,13450774,24556654,5,0,0,14848,8,6386497291
2672,11107110,12962908,24070018,7,0,0,3072,8,8693273191
2673,11114270,34030916,45145186,3,0,1,10240,12,1829123372
2674,11125450,13835436,24960886,0,0,0,15360,5,1164343167
2675,11127060,34050786,45177846,8,0,1,8192,13,9425202457
2676,11128670,13949507,25078177,6,0,0,39424,5,4008246714
2677,11131910,13285026,24416936,5,0,0,19456,8,3273263527
2678,11135020,13086079,24221099,4,0,0,9216,4,589478083
2679,11135250,13568250,24703500,7,0,0,13824,8,1653198619
2680,11147760,13459184,24606944,0,0,0,31744,5,8632696501
2681,11152560,34029805,45182365,9,0,1,8192,19,2188407991
2682,11152610,34650606,45803216,0,0,1,76800,5,7130254068
2683,11153140,13211341,24364481,0,0,0,8192,5,3680659364
2684,11155640,13517649,24673289,6,0,0,37376,5,3493452359
2685,11160810,14302150,25462960,5,0,0,19968,8,6090542755
2686,11161050,13612218,24773268,8,0,0,103424,13,3815466751
2687,11171750,13302578,24474328,3,0,0,26112,12,2584056743
2688,11174570,12929418,24103988,7,0,0,5632,8,6025611746
2689,11182380,35086424,46268804,0,0,1,192000,5,1116266383
2690,11189820,13118171,24307991,3,0,0,18432,12,601007659
2691,11194570,13301340,24495910,5,0,0,29184,8,4951353101
2692,11195840,13399982,24595822,7,0,0,6656,8,10611592922
2693,11201400,13802208,25003608,3,0,0,15360,12,7009280878
2694,11201630,13584655,24786285,3,0,0,19968,12,4291121963
2695,11214300,13617077,24831377,3,0,0,11776,12,6074688604
2696,11219610,13784957,25004567,4,0,0,3072,4,5425532539
2697,11229710,13879158,25108868,3,0,0,13312,12,5818688902
2698,11230320,35038509,46268829,4,0,1,6144,4,9626503679
2699,11233040,13594726,24827766,5,0,0,24064,8,4218314904
2700,11238820,13947644,25186464,5,0,0,25600,8,6272741095
2701,11240720,13279416,24520136,8,0,0,41984,13,6800223529
2702,11246080,13415798,24661878,2,0,0,9728,15,1500700111
2703,11247070,14398590,25645660,8,0,0,28672,13,2428077235
2704,11249840,13644261,24894101,5,0,0,17408,8,2144262691
2705,11252610,13746295,24998905,0,0,0,44032,5,2645823394
2706,11253680,13343569,24597249,1,0,0,4608,14,2676835954
2707,11259460,14348573,25608033,2,0,0,23040,15,19618764
2708,11266210,35037976,46304186,0,0,1,10752,5,10737293869
2709,11269770,35047106,46316876,6,0,1,4096,5,3782251787
2710,11272120,35089736,46361856,3,0,1,14848,12,684849422
2711,11273790,35102348,46376138,4,0,1,2560,4,3055460763
2712,11276910,13827879,25104789,0,0,0,16896,5,5022056603
2713,11276970,13759360,25036330,7,0,0,512,8,5298657084
2714,11281280,13619864,24901144,6,0,0,23040,5,8347970007
2715,11287720,14847504,26135224,5,0,0,36352,8,9773160308
2716,11288180,13445318,24733498,8,0,0,25088,13,6367864721
2717,11292910,13382586,24675496,9,0,0,7168,19,3533112841
2718,11293129,35304250,46597379,1,0,1,145920,14,3261522319
2719,11299490,13790098,25089588,6,0,0,37376,5,5435935312
2720,11302780,14014107,25316887,3,0,0,60928,12,1186483800
2721,11307230,13862067,25169297,5,0,0,89088,8,5050249809
2722,11313840,14615344,25929184,9,0,0,40960,19,2130723015
2723,11321730,14018938,25340668,9,0,0,69632,19,7506500476
2724,11325860,14096540,25422400,9,0,0,17920,19,3364352903
2725,11333231,35274788,46608019,5,0,1,18944,8,1517447480
2726,11333560,13676802,25010362,6,0,0,18944,5,8233547221
2727,11333710,13776608,25110318,8,0,0,3584,13,7312071724
2728,11337200,35371920,46709120,3,0,1,4096,12,2523041119
2729,11341560,35369148,46710708,6,0,1,15872,5,10695759513
2730,11350280,13968502,25318782,6,0,0,6144,5,943521077
2731,11358320,14053073,25411393,3,0,0,29696,12,10538812788
2732,11363180,13810999,25174179,7,0,0,2560,8,7405554713
2733,11366781,35346513,46713294,5,0,1,4096,8,10090470756
2734,11374971,35341488,46716459,5,0,1,13312,8,6255538909
2735,11377000,13793903,25170903,7,0,0,3072,8,5947125963
2736,11384330,13428599,24812929,6,0,0,1536,5,6491670791
2737,11388010,13781934,25169944,8,0,0,2048,13,2422649591
2738,11388850,13546528,24935378,1,0,0,27136,14,2094958868
2739,11389640,13719563,25109203,3,0,0,1024,12,9119027368
2740,11397650,13838097,25235747,6,0,0,36864,5,5236153682
2741,11405770,13614877,25020647,8,0,0,5632,13,10153575286
2742,11407320,14106287,25513607,9,0,0,54272,19,9945526316
2743,11408890,14156843,25565733,2,0,0,21504,15,8254013146
2744,11412770,13652400,25065170,5,0,0,28672,8,6616682994
2745,11414980,13850321,25265301,3,0,0,44032,12,4805289913
2746,11423850,13675768,25099618,6,0,0,5632,5,9639743737
2747,11429950,14790354,26220304,3,0,0,22016,12,1824834451
2748,11437580,14027119,25464699,9,0,0,5632,19,1788815244
2749,11442860,13959462,25402322,7,0,0,11776,8,8697106145
2750,11445250,14191651,25636901,5,0,0,69632,8,1229509171
2751,11457310,14222011,25679321,2,0,0,4608,15,6964094866
2752,11463880,13633999,25097879,7,0,0,27136,8,6887725861
2753,11464230,13714411,25178641,9,0,0,1536,19,5755119271
2754,11464749,35273950,46738699,1,0,1,16384,14,1077932716
2755,11465500,35330643,46796143,6,0,1,15360,5,10515643185
2756,11465731,35435555,46901286,5,0,1,19968,8,1746850570
2757,11466680,14115612,25582292,0,0,0,54272,5,9264870728
2758,11477680,14465411,25943091,8,0,0,45568,13,6490273686
2759,11481020,14050538,25531558,6,0,0,52736,5,5351225599
2760,11483070,14398204,25881274,5,0,0,45056,8,1376396664
2761,11487530,14209061,25696591,6,0,0,55296,5,2486389404
2762,11489400,14179331,25668731,8,0,0,53248,13,5394156270
2763,11491790,14298089,25789879,6,0,0,51712,5,3674771144
2764,11495780,13705674,25201454,9,0,0,32256,19,8403957122
2765,11503200,14174625,25677825,9,0,0,29696,19,1278448472
2766,11505380,14381377,25886757,9,0,0,17920,19,7691954580
2767,11513380,14385256,25898636,9,0,0,38912,19,3786012176
2768,11520410,14561125,26081535,2,0,0,106496,15,8477279560
2769,11521300,14841827,26363127,2,0,0,3072,15,4584720824
2770,11522230,14601895,26124125,0,0,0,52224,5,8742892425
2771,11533110,13705761,25238871,9,0,0,3072,19,186467918
2772,11536960,13978409,25515369,3,0,0,4096,12,1595211777
2773,11539890,14112571,25652461,8,0,0,22016,13,2004772648
2774,11542870,14684633,26227503,8,0,0,3584,13,3952441088
2775,11544750,14303048,25847798,1,0,0,20992,14,8578461147
2776,11549100,13770329,25319429,1,0,0,2048,14,10314464066
2777,11551650,14925545,26477195,9,0,0,10240,19,3184078042
2778,11566820,14441047,26007867,6,0,0,33792,5,5974719624
2779,11573320,14424228,25997548,1,0,0,37376,14,9116966264
2780,11575690,35325619,46901309,3,0,1,1024,12,9972783445
2781,11576850,13911156,25488006,0,0,0,19456,5,2375179308
2782,11579100,35322232,46901332,2,0,1,5120,15,6376638076
2783,11580200,35321155,46901355,0,0,1,5632,5,7848126174
2784,11586220,13801309,25387529,1,0,0,1536,14,3244784491
2785,11586860,13927238,25514098,6,0,0,1536,5,3811226464
2786,11599990,13882065,25482055,1,0,0,14336,14,60356139
2787,11601239,35402660,47003899,1,0,1,64512,14,8658537780
2788,11606090,14149038,25755128,5,0,0,6656,8,10471578406
2789,11606930,14415698,26022628,7,0,0,13824,8,9407209128
2790,11609590,35396071,47005661,3,0,1,7168,12,2684593641
2791,11629030,35634467,47263497,0,0,1,130048,5,8416302045
2792,11630080,13912671,25542751,3,0,0,512,12,960217955
2793,11638460,14998705,26637165,9,0,0,26624,19,9692620757
2794,11647189,35616331,47263520,8,0,1,3584,13,5865814420
2795,11652880,14442585,26095465,1,0,0,38912,14,10707881387
2796,11654600,14376172,26030772,3,0,0,3584,12,6318623468
2797,11663500,14666033,26329533,2,0,0,70144,15,9239262687
2798,11663990,35642811,47306801,3,0,1,20480,12,2873592675
2799,11668500,14772259,26440759,8,0,0,40448,13,8996285278
2800,11671420,14412166,26083586,8,0,0,6656,13,8103626885
2801,11676409,35746831,47423240,1,0,1,59392,14,710510607
2802,11677240,14670374,26347614,8,0,0,6656,13,2039583455
2803,11677720,14627036,26304756,3,0,0,13312,12,5009457119
2804,11678220,36191352,47869572,0,0,1,344576,5,1715062497
2805,11687079,36422132,48109211,1,0,1,114688,14,8434596048
2806,11687360,14859413,26546773,8,0,0,39424,13,1321438056
2807,11698880,36419113,48117993,2,0,1,2048,15,6772296827
2808,11701720,14927241,26628961,0,0,0,24064,5,4740395787
2809,11703670,14564809,26268479,5,0,0,21504,8,1203828990
2810,11706030,36443529,48149559,4,0,1,7680,4,10284124623
2811,11706960,14680024,26386984,6,0,0,19456,5,8184259307
2812,11708410,14237824,25946234,5,0,0,10240,8,2057622815
2813,11710170,14253887,25964057,2,0,0,4608,15,2286072458
2814,11729349,36759873,48489222,1,0,1,326656,14,2906830797
2815,11729710,14938481,26668191,9,0,0,35840,19,1176355703
2816,11733649,36767902,48501551,8,0,1,2048,13,3962131511
2817,11740380,14449779,26190159,8,0,0,1024,13,6405277581
2818,11740930,14448894,26189824,8,0,0,73216,13,8238892707
2819,11751370,14273777,26025147,5,0,0,8192,8,3829685230
2820,11753071,36798589,48551660,5,0,1,23040,8,141133306
2821,11755240,15033723,26788963,2,0,0,9216,15,10099552434
2822,11759890,14686976,26446866,6,0,0,19968,5,2553545087
2823,11760440,36811234,48571674,2,0,1,13824,15,2916728906
2824,11767180,14966871,26734051,1,0,0,55296,14,183813377
2825,11773110,14708039,26481149,2,0,0,8192,15,5865826292
2826,11775920,36795777,48571697,4,0,1,3072,4,9389231489
2827,11777730,14841937,26619667,8,0,0,50688,13,10203292566
2828,11779110,14583035,26362145,0,0,0,47616,5,9375928927
2829,11780840,14627747,26408587,7,0,0,25600,8,1007677053
2830,11785160,36798122,48583282,3,0,1,2560,12,6593631941
2831,11786250,14724961,26511211,3,0,0,24064,12,3691471204
2832,11789380,36812794,48602174,3,0,1,18944,12,8096501126
2833,11791960,15123849,26915809,6,0,0,62976,5,2094465079
2834,11796050,14541970,26338020,3,0,0,1024,12,4422669408
2835,11803780,14869270,26673050,3,0,0,15872,12,1598682737
2836,11819820,14442084,26261904,9,0,0,13824,19,1542844403
2837,11836350,36822786,48659136,2,0,1,9216,15,7631811295
2838,11847269,36811890,48659159,8,0,1,6144,13,2793868099
2839,11852900,36938055,48790955,0,0,1,109056,5,6113234642
2840,11857860,15038738,26896598,1,0,0,41984,14,7730131247
2841,11862730,14467294,26330024,3,0,0,1536,12,6169236288
2842,11864840,15178729,27043569,7,0,0,36352,8,7987130780
2843,11865350,14391523,26256873,9,0,0,3072,19,1078398986
2844,11867980,14606072,26474052,0,0,0,37376,5,5253658293
2845,11873060,15271214,27144274,7,0,0,8704,8,6987556867
2846,11874830,36932123,48806953,2,0,1,1024,15,9722679207
2847,11876010,14781238,26657248,5,0,0,32256,8,8902898458
2848,11881340,14763515,26644855,7,0,0,25088,8,3149546733
2849,11883529,36924665,48808194,8,0,1,6656,13,10047164197
2850,11883910,14527296,26411206,6,0,0,2048,5,10345948183
2851,11891220,14821482,26712702,7,0,0,58880,8,5507341800
2852,11892120,14703395,26595515,7,0,0,38400,8,4864226969
2853,11895300,36915800,48811100,4,0,1,4608,4,6233650347
2854,11906320,14572302,26478622,9,0,0,4608,19,5484051858
2855,11906330,14677439,26583769,7,0,0,16896,8,10579385621
2856,11912890,36898569,48811459,9,0,1,9728,19,2632536802
2857,11921680,15039640,26961320,0,0,0,10240,5,2603187386
2858,11925430,14769309,26694739,7,0,0,9728,8,3763074712
2859,11925491,36896847,48822338,5,0,1,4608,8,5813267784
2860,11928140,15409959,27338099,6,0,0,12800,5,5554699382
2861,11944450,36877911,48822361,3,0,1,10240,12,2303777720
2862,11944650,15004144,26948794,1,0,0,4096,14,4988709594
2863,11949750,15277434,27227184,6,0,0,6144,5,7483427259
2864,11950990,14724849,26675839,9,0,0,8192,19,445105321
2865,11951810,14420149,26371959,5,0,0,2560,8,9345727050
2866,11953270,14969894,26923164,3,0,0,24064,12,3265314081
2867,11961319,36861335,48822654,8,0,1,11776,13,5906800259
2868,11968600,14677526,26646126,1,0,0,4096,14,4713896666
2869,11970360,14977163,26947523,7,0,0,79872,8,6682761951
2870,11972820,15361333,27334153,8,0,0,47616,13,9119528577
2871,11973850,14824815,26798665,5,0,0,12800,8,3135884348
2872,11974170,14790571,26764741,1,0,0,17408,14,2076399419
2873,11974600,14622373,26596973,2,0,0,4608,15,361976846
2874,11980040,15395911,27375951,1,0,0,5120,14,4908827830
2875,11982170,15274550,27256720,3,0,0,3584,12,10462207513
2876,11986040,15503841,27489881,2,0,0,2048,15,1242573044
2877,11989200,36834222,48823422,4,0,1,11776,4,2083876097
2878,11991960,15382408,27374368,5,0,0,118784,8,3247937552
2879,11992000,14695154,26687154,6,0,0,32256,5,6719710295
2880,11994850,15570142,27564992,8,0,0,18432,13,8432330541
2881,11995570,36844591,48840161,6,0,1,14848,5,9370152910
2882,12002400,14558233,26560633,4,0,0,8704,4,3702733944
2883,12009390,14509692,26519082,3,0,0,2560,12,2414703336
2884,12010220,15192539,27202759,0,0,0,50176,5,8856154928
2885,12011070,14867929,26878999,9,0,0,38400,19,4641897500
2886,12011860,14635537,26647397,0,0,0,4096,5,8890981581
2887,12013380,15068759,27082139,9,0,0,20480,19,7938823390
2888,12016130,14671359,26687489,1,0,0,1024,14,9645271189
2889,12017760,15463322,27481082,6,0,0,24576,5,2847795105
2890,12024680,36858723,48883403,2,0,1,1024,15,8263210222
2891,12026460,36856966,48883426,6,0,1,9216,5,4170593473
2892,12034490,36853194,48887684,4,0,1,6656,4,1011459021
2893,12036190,15182674,27218864,6,0,0,36864,5,527905274
2894,12037330,15199436,27236766,0,0,0,8704,5,10545676321
2895,12038120,14989095,27027215,7,0,0,1536,8,9207167983
2896,12042880,14933016,26975896,1,0,0,24064,14,7704291558
2897,12046490,14911687,26958177,1,0,0,30720,14,10459974311
2898,12046910,14976903,27023813,7,0,0,27136,8,8711436661
2899,12047350,15186741,27234091,2,0,0,6656,15,5740887446
2900,12051110,15268489,27319599,0,0,0,74240,5,1538706429
2901,12051970,15173272,27225242,1,0,0,3072,14,2145465578
2902,12056340,36866550,48922890,2,0,1,22528,15,10342483646
2903,12058250,15070308,27128558,5,0,0,13824,8,8569873439
2904,12058740,15362787,27421527,2,0,0,5120,15,1731684459
2905,12060480,14964760,27025240,8,0,0,4608,13,5318605486
2906,12062580,14759241,26821821,2,0,0,13312,15,4068207453
2907,12063319,37194316,49257635,1,0,1,122368,14,4342936122
2908,12064580,37450745,49515325,0,0,1,149504,5,8157730307
2909,12064700,15767286,27831986,9,0,0,3072,19,478261790
2910,12078420,15338164,27416584,5,0,0,8192,8,3458065688
2911,12080940,15565776,27646716,1,0,0,116736,14,9786482639
2912,12086940,15325207,27412147,1,0,0,19456,14,88517379
2913,12089620,15670123,27759743,5,0,0,108032,8,4319863502
2914,12091340,15344293,27435633,8,0,0,6144,13,2167420791
2915,12094390,15506360,27600750,7,0,0,15360,8,394628331
2916,12095430,15670443,27765873,6,0,0,11776,5,1995197095
2917,12097760,15308436,27406196,1,0,0,74752,14,2068710090
2918,12106570,14859765,26966335,5,0,0,16384,8,10090617520
2919,12111780,15696962,27808742,0,0,0,29184,5,5146791969
2920,12113100,37404491,49517591,2,0,1,3584,15,8675699075
2921,12116610,15742667,27859277,9,0,0,35328,19,10641858002
2922,12121880,15474144,27596024,7,0,0,34304,8,5164121165
2923,12123180,15654622,27777802,3,0,0,14336,12,4217160182
2924,12123280,15599656,27722936,9,0,0,45568,19,10384516098
2925,12128671,37393426,49522097,5,0,1,7168,8,9516981915
2926,12128920,15074798,27203718,8,0,0,3072,13,1087504279
2927,12131620,15048044,27179664,3,0,0,33280,12,6235105433
2928,12134250,15247074,27381324,9,0,0,17408,19,1854607243
2929,12135320,15767558,27902878,6,0,0,45056,5,6485206344
2930,12137450,15935969,28073419,8,0,0,5120,13,7414511653
2931,12140670,15911696,28052366,8,0,0,43520,13,6492908986
2932,12148180,15385174,27533354,2,0,0,34816,15,9860690830
2933,12149410,37412685,49562095,3,0,1,512,12,6662428912
2934,12156580,37405538,49562118,6,0,1,15872,5,8176915976
2935,12160800,37401341,49562141,3,0,1,3584,12,4721085459
2936,12162320,15484887,27647207,6,0,0,1536,5,4693161433
2937,12173550,15524401,27697951,7,0,0,43008,8,8851149697
2938,12180330,15403958,27584288,1,0,0,14336,14,5900241320
2939,12182800,15822635,28005435,7,0,0,34816,8,9959286440
2940,12189730,15495094,27684824,7,0,0,11776,8,6433553953
2941,12192400,15031791,27224191,2,0,0,17408,15,8098697956
2942,12194830,15724729,27919559,8,0,0,10240,13,5755853531
2943,12197520,15457222,27654742,1,0,0,24576,14,1220906023
2944,12198490,15821811,28020301,8,0,0,12288,13,4881271566
2945,12200350,37453839,49654189,0,0,1,62976,5,10409243548
2946,12217050,15925364,28142414,6,0,0,12288,5,5609790235
2947,12217610,15602622,27820232,8,0,0,35328,13,9520506766
2948,12219730,15650334,27870064,2,0,0,35328,15,1218295762
2949,12227180,15382362,27609542,1,0,0,20480,14,887577023
2950,12237270,15757534,27994804,2,0,0,62464,15,5969305882
2951,12240670,15842935,28083605,0,0,0,30720,5,7321189029
2952,12244720,37421770,49666490,4,0,1,7680,4,8029285097
2953,12247400,15035300,27282700,2,0,0,8192,15,7123265804
2954,12249439,37948932,50198371,1,0,1,408576,14,8893631330
2955,12251100,15979208,28230308,7,0,0,96256,8,8321305204
2956,12260260,15153805,27414065,9,0,0,6144,19,1413899878
2957,12266050,15838171,28104221,7,0,0,10240,8,664883671
2958,12270200,15746334,28016534,5,0,0,36352,8,9761275593
2959,12272690,15338435,27611125,7,0,0,5120,8,4166974413
2960,12275089,37960810,50235899,1,0,1,46080,14,6649121959
2961,12277900,15243873,27521773,6,0,0,19456,5,9474346452
2962,12283540,15605587,27889127,8,0,0,6144,13,4756584677
2963,12284140,15423046,27707186,2,0,0,30208,15,2660492655
2964,12284349,38104811,50389160,1,0,1,225792,14,2074238194
2965,12300070,38089113,50389183,6,0,1,2048,5,9510480909
2966,12307640,38081566,50389206,9,0,1,512,19,5998833732
2967,12307680,15523339,27831019,0,0,0,35328,5,7015847745
2968,12308560,15355396,27663956,0,0,0,13312,5,9251618365
2969,12312370,38076859,50389229,4,0,1,1536,4,10295236204
2970,12313600,15185640,27499240,8,0,0,9728,13,2265246825
2971,12316070,15821462,28137532,0,0,0,57344,5,4459267611
2972,12327970,16188856,28516826,8,0,0,89600,13,2430245274
2973,12332930,15897713,28230643,8,0,0,1024,13,8187908025
2974,12342080,38056395,50398475,0,0,1,15360,5,5675885070
2975,12350049,38147898,50497947,1,0,1,76800,14,7754763776
2976,12357020,15591782,27948802,3,0,0,11776,12,8485546437
2977,12363870,15932046,28295916,0,0,0,41984,5,4217135052
2978,12372500,15935482,28307982,8,0,0,30208,13,2989709495
2979,12373710,38124260,50497970,4,0,1,9728,4,9071100609
2980,12373770,15818602,28192372,6,0,0,23040,5,6084389165
2981,12374290,15661634,28035924,3,0,0,51200,12,4943413264
2982,12383060,15981046,28364106,0,0,0,45568,5,381833601
2983,12386070,16058384,28444454,0,0,0,41984,5,1097237820
2984,12390970,16017070,28408040,2,0,0,4608,15,4716567713
2985,12399300,15362962,27762262,6,0,0,8192,5,5608169741
2986,12399590,16081051,28480641,7,0,0,11264,8,914488787
2987,12404350,16483235,28887585,6,0,0,44544,5,835521833
2988,12411930,15828142,28240072,2,0,0,14336,15,758608475
2989,12418650,15694264,28112914,6,0,0,20480,5,5573733462
2990,12420360,15906517,28326877,5,0,0,6144,8,4702595488
2991,12428340,15710307,28138647,2,0,0,3584,15,639611736
2992,12428620,38102843,50531463,0,0,1,18432,5,2716644611
2993,12429460,16031088,28460548,2,0,0,9216,15,5775632015
2994,12431400,16019785,28451185,8,0,0,22016,13,2928577267
2995,12435120,15757587,28192707,0,0,0,1024,5,10540884031
2996,12435811,38097918,50533729,5,0,1,3584,8,3255099059
2997,12444830,15812976,28257806,3,0,0,24064,12,9329757815
2998,12457910,16579932,29037842,2,0,0,23040,15,4389027811
2999,12457920,16222220,28680140,3,0,0,512,12,8935174439
3000,12468620,15603216,28071836,8,0,0,28672,13,7417194621
3001,12474570,15808531,28283101,7,0,0,82944,8,9657150485
3002,12483300,38051505,50534805,9,0,1,13312,19,493330019
3003,12484390,16229382,28713772,6,0,0,81408,5,6693061838
3004,12493890,16338847,28832737,1,0,0,38912,14,5740581844
3005,12495261,38040530,50535791,5,0,1,1536,8,293646817
3006,12497330,15576892,28074222,2,0,0,2560,15,5643828375
3007,12501360,15870654,28372014,0,0,0,3584,5,1266455050
3008,12504630,16593692,29098322,3,0,0,28672,12,6291791879
3009,12505060,16079403,28584463,6,0,0,3072,5,5794916318
3010,12507490,16809334,29316824,1,0,0,43008,14,4712071091
3011,12510790,15797371,28308161,5,0,0,512,8,9164042586
3012,12512809,38249264,50762073,1,0,1,167424,14,1216833188
3013,12514840,15720818,28235658,7,0,0,16384,8,4436015656
3014,12519160,38258015,50777175,2,0,1,24064,15,9510391502
3015,12529829,38248524,50778353,1,0,1,13824,14,9640725011
3016,12533920,16283562,28817482,5,0,0,24064,8,9981569926
3017,12534900,38287996,50822896,6,0,1,4096,5,241461706
3018,12540660,15513453,28054113,9,0,0,5632,19,3705775566
3019,12546260,16463739,29009999,3,0,0,108032,12,460299125
3020,12559880,16073769,28633649,0,0,0,71168,5,5301801394
3021,12566450,15923053,28489503,6,0,0,15872,5,3039547299
3022,12567580,15471503,28039083,5,0,0,10240,8,9622765982
3023,12568240,15769782,28338022,0,0,0,512,5,9559785546
3024,12568580,38254339,50822919,3,0,1,512,12,6142136304
3025,12575200,16602495,29177695,4,0,0,16384,4,9377886477
3026,12582300,15742682,28324982,6,0,0,30208,5,10155352049
3027,12587700,16584980,29172680,3,0,0,86528,12,68440924
3028,12591900,15706855,28298755,6,0,0,9216,5,10402941025
3029,12592720,15242057,27834777,5,0,0,6656,8,9599167837
3030,12603180,15980324,28583504,5,0,0,43520,8,8412259870
3031,12604320,16592765,29197085,5,0,0,29696,8,4557967305
3032,12606810,16064957,28671767,8,0,0,44544,13,3694777600
3033,12610820,16661413,29272233,8,0,0,13824,13,6858215450
3034,12619290,16156295,28775585,0,0,0,1024,5,2875859721
3035,12622830,15902989,28525819,0,0,0,18432,5,1784540762
3036,12625160,15725016,28350176,1,0,0,28672,14,3502977458
3037,12630099,38192843,50822942,8,0,1,1024,13,1539961309
3038,12631290,16137395,28768685,8,0,0,3584,13,765002747
3039,12633100,16140678,28773778,2,0,0,6656,15,4521366687
3040,12634490,15736401,28370891,3,0,0,22016,12,3285145705
3041,12640190,38182775,50822965,3,0,1,5632,12,6022694956
3042,12640741,38182247,50822988,5,0,1,1536,8,1382459728
3043,12646770,15965172,28611942,7,0,0,90112,8,7957153143
3044,12647850,38175161,50823011,3,0,1,3584,12,3200688933
3045,12652440,16250518,28902958,0,0,0,20992,5,2845071556
3046,12655200,16290382,28945582,8,0,0,17408,13,9721383427
3047,12658530,15794816,28453346,7,0,0,5632,8,9178007334
3048,12659650,16352244,29011894,0,0,0,6144,5,9377100213
3049,12660150,38162884,50823034,9,0,1,9216,19,8924845331
3050,12660910,38164510,50825420,2,0,1,3072,15,9839696747
3051,12686060,38139383,50825443,6,0,1,7680,5,8005944782
3052,12692010,38133456,50825466,2,0,1,5120,15,8938364058
3053,12696120,16678804,29374924,5,0,0,23552,8,7908833541
3054,12699400,16366276,29065676,1,0,0,6144,14,6925057204
3055,12700600,16601608,29302208,7,0,0,98304,8,6048381141
3056,12700620,38124869,50825489,0,0,1,9728,5,7028547202
3057,12702060,16194471,28896531,3,0,0,29184,12,6195676522
3058,12702690,16171300,28873990,7,0,0,44032,8,621012975
3059,12704950,16700380,29405330,0,0,0,9728,5,6385156324
3060,12709730,15827395,28537125,8,0,0,9728,13,5938908064
3061,12710150,16477864,29188014,9,0,0,33792,19,7063423308
3062,12710620,38119674,50830294,4,0,1,33280,4,1173460047
3063,12719860,15807854,28527714,2,0,0,6144,15,9261322212
3064,12725240,16303620,29028860,7,0,0,28672,8,9177870378
3065,12729420,16524650,29254070,1,0,0,9728,14,805229477
3066,12729640,16799416,29529056,8,0,0,23040,13,3179338429
3067,12734920,16370100,29105020,9,0,0,3584,19,3998030895
3068,12744130,16388082,29132212,1,0,0,512,14,6657542407
3069,12748010,16106434,28854444,7,0,0,71168,8,8655802049
3070,12749590,16729828,29479418,1,0,0,39936,14,6812847376
3071,12759690,38071156,50830846,0,0,1,512,5,4569165491
3072,12761819,38069386,50831205,1,0,1,9728,14,7816600221
3073,12764670,38073999,50838669,4,0,1,17920,4,8013546424
3074,12766150,16337747,29103897,2,0,0,17920,15,7695850917
3075,12766500,16624003,29390503,2,0,0,5120,15,5484751371
3076,12770330,16907688,29678018,7,0,0,70656,8,4401037182
3077,12771440,38111196,50882636,6,0,1,1536,5,2326388341
3078,12773407,16615513,29388920,1,0,0,32768,14,5980662186
3079,12774310,16747703,29522013,6,0,0,4096,5,7153938218
3080,12786380,16339289,29125669,5,0,0,16384,8,2725552065
3081,12800620,16653053,29453673,6,0,0,10752,5,8195216355
3082,12800760,16637278,29438038,6,0,0,54272,5,9451775939
3083,12806960,16532686,29339646,6,0,0,69120,5,1408078041
3084,12811930,16902000,29713930,5,0,0,45056,8,348857298
3085,12817900,16910818,29728718,9,0,0,40448,19,4607147445
3086,12822540,38060119,50882659,3,0,1,1024,12,7441965265
3087,12825380,38057302,50882682,2,0,1,8192,15,9427897702
3088,12833160,15709697,28542857,1,0,0,10752,14,23446279
3089,12836090,16104165,28940255,0,0,0,40448,5,3422002051
3090,12844910,38037795,50882705,0,0,1,5632,5,2104831331
3091,12849140,17076804,29925944,6,0,0,84480,5,2138355441
3092,12851280,17023898,29875178,1,0,0,86528,14,8863396153
3093,12857310,15776994,28634304,1,0,0,2048,14,9445435498
3094,12858160,38024576,50882736,9,0,1,20992,19,6038497113
3095,12859270,15895054,28754324,0,0,0,32256,5,9615779634
3096,12863800,16344228,29208028,8,0,0,35840,13,9104421183
3097,12863810,16603082,29466892,5,0,0,41984,8,1315686712
3098,12868850,16144783,29013633,9,0,0,5632,19,4539308247
3099,12873490,15987061,28860551,7,0,0,19968,8,4896738647
3100,12873740,16184402,29058142,8,0,0,512,13,8796260104
3101,12875740,38007019,50882759,4,0,1,1536,4,5010938326
3102,12882580,16385418,29267998,9,0,0,26624,19,3553030146
3103,12885060,16556121,29441181,8,0,0,10240,13,259790662
3104,12889820,16673784,29563604,3,0,0,59392,12,8748421946
3105,12891210,16955218,29846428,2,0,0,82432,15,4293551167
3106,12894316,16226338,29120654,6,0,0,41472,5,8533860152
3107,12901960,16685446,29587406,2,0,0,6144,15,8030441931
3108,12903770,16176128,29079898,6,0,0,8192,5,2112573046
3109,12904899,37986437,50891336,8,0,1,26112,13,10272552115
3110,12906730,16674654,29581384,8,0,0,13312,13,1576743672
3111,12921710,16834510,29756220,6,0,0,90112,5,284376825
3112,12922580,37999979,50922559,6,0,1,26112,5,7843258155
3113,12924910,17077055,30001965,9,0,0,5120,19,4652197084
3114,12926509,37996073,50922582,8,0,1,11776,13,1301069338
3115,12927439,38001429,50928868,8,0,1,3584,13,3099624504
3116,12931740,16480168,29411908,8,0,0,4608,13,10430494852
3117,12931830,16588912,29520742,8,0,0,27136,13,1280149482
3118,12937170,16884111,29821281,7,0,0,17920,8,5212270974
3119,12939260,38016618,50955878,9,0,1,7168,19,9376700414
3120,12939710,16269277,29208987,7,0,0,3072,8,9159092811
3121,12944360,17334428,30278788,6,0,0,52224,5,325013194
3122,12947790,16655551,29603341,3,0,0,52224,12,3878229496
3123,12950250,38014868,50965118,9,0,1,30208,19,2967197440
3124,12955630,16723503,29679133,9,0,0,3584,19,5158552800
3125,12959340,16582486,29541826,4,0,0,22528,4,1311781733
3126,12961050,16916179,29877229,1,0,0,6656,14,3666034432
3127,12963060,16915908,29878968,8,0,0,5632,13,2652086241
3128,12968850,16157934,29126784,5,0,0,3584,8,6381801312
3129,12977920,16820254,29798174,3,0,0,20480,12,1304755151
3130,12988529,37986344,50974873,8,0,1,7168,13,8686366382
3131,12998860,16572099,29570959,1,0,0,24064,14,4028247678
3132,13024520,16039238,29063758,9,0,0,5632,19,5577125489
3133,13024540,16478154,29502694,7,0,0,30208,8,9296785963
3134,13025309,37949735,50975044,8,0,1,2048,13,280491323
3135,13026749,37998504,51025253,1,0,1,3584,14,5119257914
3136,13027490,37998327,51025817,2,0,1,10752,15,3008252167
3137,13028820,16329592,29358412,9,0,0,26624,19,4279260029
3138,13029430,16009839,29039269,8,0,0,4608,13,4095756990
3139,13044150,17042013,30086163,3,0,0,25600,12,8026915270
3140,13047910,16402464,29450374,8,0,0,23040,13,679555309
3141,13048220,16561869,29610089,1,0,0,17408,14,65674862
3142,13050050,16554406,29604456,3,0,0,3584,12,3440074000
3143,13050930,37976193,51027123,6,0,1,2048,5,769978003
3144,13052520,37985428,51037948,3,0,1,7680,12,1041487539
3145,13054074,16712785,29766859,3,0,0,34816,12,4893629119
3146,13063049,37976525,51039574,1,0,1,2560,14,1019219129
3147,13068930,16275107,29344037,8,0,0,14336,13,9148243346
3148,13069130,16857461,29926591,7,0,0,2048,8,10016878202
3149,13069550,16702994,29772544,2,0,0,6144,15,7398994575
3150,13075070,16392157,29467227,1,0,0,1024,14,796840590
3151,13075620,17577779,30653399,2,0,0,39424,15,7755053147
3152,13077880,16917152,29995032,9,0,0,51200,19,3295252245
3153,13079670,16576037,29655707,8,0,0,9728,13,3692632924
3154,13080470,16408488,29488958,9,0,0,2048,19,4508489398
3155,13091830,17126854,30218684,7,0,0,100864,8,7486442528
3156,13099100,37941140,51040240,3,0,1,1024,12,9652176901
3157,13099350,16386339,29485689,8,0,0,20480,13,9195491965
3158,13105590,37934996,51040586,4,0,1,512,4,2521081095
3159,13105830,16588630,29694460,3,0,0,7168,12,5838935673
3160,13106060,17469477,30575537,8,0,0,16896,13,1419768171
3161,13111630,16887013,29998643,0,0,0,11776,5,209991990
3162,13116550,16202013,29318563,9,0,0,5632,19,7537530829
3163,13126789,37918623,51045412,8,0,1,7680,13,1675544863
3164,13127000,17286200,30413200,2,0,0,16384,15,8881448631
3165,13131270,16660641,29791911,8,0,0,63488,13,9260905244
3166,13135420,17422736,30558156,1,0,0,68608,14,1177679450
3167,13136530,16885278,30021808,5,0,0,65024,8,3256922334
3168,13150450,16943536,30093986,5,0,0,25600,8,3401700437
3169,13152850,16775480,29928330,2,0,0,5632,15,2344676217
3170,13154250,16661548,29815798,3,0,0,31232,12,2561755494
3171,13155130,17028088,30183218,8,0,0,22016,13,1757737871
3172,13164290,16836092,30000382,3,0,0,5632,12,5221307430
3173,13166270,16444622,29610892,9,0,0,2560,19,5956793077
3174,13170240,16710311,29880551,5,0,0,5120,8,6966573578
3175,13172710,37873163,51045873,2,0,1,10240,15,4325099588
3176,13178640,16800769,29979409,5,0,0,49664,8,9078638711
3177,13180729,37866965,51047694,1,0,1,512,14,4207327246
3178,13189820,16998109,30187929,0,0,0,15360,5,4144695660
3179,13197710,16572939,29770649,7,0,0,12288,8,7597289421
3180,13203170,37851144,51054314,9,0,1,5120,19,1094432589
3181,13205070,17024424,30229494,2,0,0,34304,15,7478828573
3182,13215330,17507402,30722732,7,0,0,36864,8,5319281504
3183,13224720,37832945,51057665,2,0,1,5120,15,6640209363
3184,13227930,17442675,30670605,5,0,0,55808,8,4512200867
3185,13230640,16825033,30055673,9,0,0,7680,19,6093292338
3186,13233710,37825776,51059486,2,0,1,3072,15,5864257921
3187,13251580,16843521,30095101,6,0,0,3584,5,6650641124
3188,13253170,37810435,51063605,9,0,1,8704,19,1468798922
3189,13253300,16889631,30142931,1,0,0,35840,14,1760251418
3190,13258370,16985553,30243923,6,0,0,20480,5,7779112668
3191,13262721,37802830,51065551,5,0,1,3072,8,5831765848
3192,13263109,37804708,51067817,1,0,1,3584,14,6792596587
3193,13268300,38193216,51461516,9,0,1,14848,19,4379561359
3194,13278900,16743727,30022627,9,0,0,2560,19,5748310469
3195,13279610,16865937,30145547,7,0,0,4096,8,5674874414
3196,13287700,38176517,51464217,3,0,1,5632,12,5729876877
3197,13294310,17514197,30808507,5,0,0,22016,8,937177462
3198,13296490,38169673,51466163,4,0,1,3072,4,10355673348
3199,13296570,17015813,30312383,9,0,0,9216,19,3683003190
3200,13299990,16830564,30130554,9,0,0,22016,19,6753296905
3201,13303350,17065215,30368565,1,0,0,3072,14,10408550172
3202,13305020,16543771,29848791,9,0,0,7680,19,8230349017
3203,13305480,17040862,30346342,6,0,0,53248,5,2641041069
3204,13308040,17850068,31158108,2,0,0,12288,15,9782374854
3205,13321930,16642324,29964254,0,0,0,23552,5,9632176298
3206,13322930,17962390,31285320,5,0,0,91648,8,326847969
3207,13323570,17305736,30629306,7,0,0,32768,8,6300524179
3208,13326570,16555572,29882142,6,0,0,5120,5,3282768380
3209,13327040,16780840,30107880,1,0,0,20992,14,3055262090
3210,13327190,38273333,51600523,2,0,1,29696,15,8023474384
3211,13327730,17411249,30738979,2,0,0,53248,15,3028879322
3212,13331750,16820650,30152400,0,0,0,15872,5,3113914017
3213,13333380,17463381,30796761,1,0,0,26112,14,8908395227
3214,13336740,17984241,31320981,6,0,0,2560,5,118470122
3215,13337219,38263650,51600869,1,0,1,512,14,8359162393
3216,13350970,16690933,30041903,5,0,0,22528,8,10650017637
3217,13353490,16883203,30236693,0,0,0,23552,5,6719066935
3218,13355510,17499001,30854511,0,0,0,17920,5,5858660513
3219,13362181,38244803,51606984,5,0,1,7680,8,1069550773
3220,13366200,17122968,30489168,6,0,0,33280,5,3192216971
3221,13368800,17510913,30879713,2,0,0,15872,15,1628605807
3222,13385560,17621472,31007032,7,0,0,28160,8,8483815943
3223,13386480,16923072,30309552,0,0,0,11776,5,3223720321
3224,13389560,17245431,30634991,6,0,0,9216,5,4009404827
3225,13390970,17533675,30924645,2,0,0,30208,15,9003441858
3226,13400300,18031288,31431588,5,0,0,19968,8,9468295627
3227,13402140,38206150,51608290,4,0,1,2048,4,4590190975
3228,13403170,16854512,30257682,0,0,0,29184,5,1184987747
3229,13412070,16806949,30219019,7,0,0,1024,8,2052492152
3230,13412300,16850553,30262853,7,0,0,16896,8,5184606706
3231,13412460,16703075,30115535,1,0,0,5632,14,2927802438
3232,13413001,38195750,51608751,5,0,1,10240,8,5171203162
3233,13417490,16758997,30176487,0,0,0,12288,5,2361486815
3234,13420080,16963054,30383134,3,0,0,37888,12,5455464932
3235,13421610,38243327,51664937,9,0,1,7680,19,3783054656
3236,13422380,16815280,30237660,5,0,0,3072,8,5765808070
3237,13423620,17412159,30835779,6,0,0,3584,5,5027833245
3238,13429110,17539208,30968318,6,0,0,43008,5,4796786488
3239,13435010,16810303,30245313,0,0,0,4096,5,9561945112
3240,13436250,18226085,31662335,6,0,0,50176,5,10595417796
3241,13436760,38246077,51682837,0,0,1,9728,5,4246119459
3242,13437210,38369893,51807103,8,0,1,2560,13,3064076763
3243,13437811,38390710,51828521,5,0,1,5632,8,419875502
3244,13441850,17331690,30773540,3,0,0,26112,12,8342059392
3245,13450380,17086826,30537206,1,0,0,19968,14,7883056052
3246,13459600,17649754,31109354,8,0,0,34816,13,7857357883
3247,13463430,17751159,31214589,1,0,0,19968,14,4793717580
3248,13466010,16963764,30429774,9,0,0,27136,19,2903970123
3249,13467770,17021733,30489503,0,0,0,1024,5,7642960067
3250,13473310,17158047,30631357,8,0,0,6656,13,1421306019
3251,13476670,17155490,30632160,6,0,0,2560,5,1774927377
3252,13477470,16925694,30403164,8,0,0,26624,13,5309869156
3253,13480460,16992428,30472888,0,0,0,8704,5,6678324963
3254,13482700,18239282,31721982,1,0,0,8704,14,5996421356
3255,13483850,38344694,51828544,4,0,1,3584,4,6541554661
3256,13483890,17806445,31290335,6,0,0,16384,5,4792413223
3257,13486380,17020440,30506820,9,0,0,6144,19,8932946174
3258,13488610,16965581,30454191,1,0,0,10752,14,6915110685
3259,13495060,17102296,30597356,0,0,0,65024,5,3362762033
3260,13495510,17158068,30653578,7,0,0,512,8,186704508
3261,13508101,38320466,51828567,5,0,1,1024,8,105506417
3262,13513690,38353414,51867104,0,0,1,10752,5,9159716487
3263,13514550,17493293,31007843,1,0,0,2560,14,9456685724
3264,13514720,17087027,30601747,5,0,0,14336,8,2157703176
3265,13516410,38350717,51867127,4,0,1,4608,4,4733883223
3266,13528520,17541615,31070135,5,0,0,11264,8,8861832445
3267,13529870,17488515,31018385,2,0,0,31744,15,3469697013
3268,13535980,17462449,30998429,1,0,0,89600,14,5777424993
3269,13536060,17069610,30605670,1,0,0,12800,14,1673278494
3270,13537110,18442452,31979562,0,0,0,73728,5,8590305671
3271,13538190,38368689,51906879,3,0,1,9728,12,3093375447
3272,13538880,17262896,30801776,7,0,0,16384,8,1310776736
3273,13540930,17549757,31090687,3,0,0,15360,12,10079416254
3274,13558080,18268786,31826866,7,0,0,26624,8,3992062707
3275,13560780,17218644,30779424,5,0,0,16384,8,8996527881
3276,13561810,38382774,51944584,2,0,1,5120,15,9214166417
3277,13562210,18720852,32283062,2,0,0,54272,15,5018283979
3278,13569240,38375367,51944607,6,0,1,7680,5,7916745924
3279,13570130,17047178,30617308,4,0,0,1536,4,6707347442
3280,13575970,18587623,32163593,3,0,0,36352,12,1413119438
3281,13576850,17298004,30874854,8,0,0,51200,13,7003336359
3282,13583420,38496256,52079676,3,0,1,2048,12,2272847203
3283,13588710,18937596,32526306,3,0,0,28672,12,7520267474
3284,13591410,17079694,30671104,0,0,0,1536,5,5250009559
3285,13595150,38484549,52079699,6,0,1,5632,5,8389717770
3286,13600280,17154144,30754424,4,0,0,14848,4,754280027
3287,13610180,18790300,32400480,1,0,0,95744,14,6794476689
3288,13613420,17844104,31457524,1,0,0,39936,14,9759812515
3289,13619920,17896584,31516504,8,0,0,38400,13,6333931607
3290,13620140,17260844,30880984,8,0,0,4096,13,8606953362
3291,13620380,38460513,52080893,6,0,1,5120,5,3906513456
3292,13620669,38518415,52139084,1,0,1,6656,14,8005442621
3293,13623440,17754097,31377537,6,0,0,50176,5,3637534124
3294,13631070,17850230,31481300,5,0,0,9216,8,6268751786
3295,13638310,17905721,31544031,6,0,0,40960,5,3977451931
3296,13642160,18968073,32610233,6,0,0,42496,5,8411582861
3297,13643260,17442724,31085984,5,0,0,40960,8,8781634414
3298,13643320,17418593,31061913,2,0,0,21504,15,9760701295
3299,13646080,19425212,33071292,8,0,0,45056,13,9119530449
3300,13649820,19109823,32759643,1,0,0,77312,14,4922068890
3301,13667470,17897831,31565301,5,0,0,40448,8,6055310360
3302,13670100,17089464,30759564,1,0,0,12800,14,173757510
3303,13673340,38483262,52156602,8,0,1,6144,13,3115120499
3304,13678960,17467714,31146674,0,0,0,37376,5,6490336955
3305,13679410,17060060,30739470,4,0,0,1536,4,10706555776
3306,13686140,18058235,31744375,9,0,0,25600,19,2516143711
3307,13687720,17604978,31292698,9,0,0,7680,19,10039359423
3308,13689830,18462664,32152494,7,0,0,24064,8,8723035653
3309,13699360,17869872,31569232,1,0,0,12800,14,9772884910
3310,13706700,38462428,52169128,9,0,1,3072,19,9831492388
3311,13707720,17363062,31070782,8,0,0,2048,13,10721467678
3312,13710330,17449673,31160003,2,0,0,6144,15,7726392817
3313,13710680,17767789,31478469,5,0,0,53760,8,4074408056
3314,13712540,18285796,31998336,0,0,0,41472,5,1156744730
3315,13714280,38484783,52199063,2,0,1,4608,15,1124071685
3316,13728091,38470995,52199086,7,0,1,512,8,6212578880
3317,13731930,17079431,30811361,3,0,0,9216,12,8959887442
3318,13733290,17586888,31320178,1,0,0,8704,14,5634058677
3319,13736720,17355394,31092114,8,0,0,4608,13,1905638369
3320,13739300,17292855,31032155,7,0,0,2560,8,857304076
3321,13743860,17855730,31599590,3,0,0,12288,12,8834195617
3322,13761530,17834293,31595823,4,0,0,14336,4,3063101380
3323,13765500,17909829,31675329,6,0,0,35328,5,3611896466
3324,13765990,17388351,31154341,0,0,0,25088,5,6936117572
3325,13779380,17575058,31354438,9,0,0,10240,19,8800512929
3326,13783160,18019424,31802584,1,0,0,12288,14,6726780999
3327,13785360,17841633,31626993,4,0,0,4608,4,5537450695
3328,13792780,38406329,52199109,2,0,1,3072,15,4373643657
3329,13794430,17510646,31305076,5,0,0,20480,8,6415223530
3330,13797650,17755304,31552954,0,0,0,29184,5,1003477223
3331,13799790,17721105,31520895,8,0,0,14336,13,16204414
3332,13801030,18319038,32120068,0,0,0,40448,5,9500985908
3333,13806170,17942752,31748922,2,0,0,14848,15,3646447262
3334,13809020,38395283,52204303,4,0,1,4608,4,3906637310
3335,13810120,17357862,31167982,0,0,0,26112,5,3968615510
3336,13812790,17887091,31699881,3,0,0,22016,12,8488044197
3337,13818590,18470458,32289048,7,0,0,17408,8,8005842428
3338,13819810,38384516,52204326,2,0,1,4096,15,3190151460
3339,13823630,17955797,31779427,9,0,0,32768,19,7876453395
3340,13835750,17933631,31769381,9,0,0,67072,19,2818393277
3341,13843460,17593888,31437348,1,0,0,3584,14,4254693618
3342,13847780,17645993,31493773,6,0,0,15872,5,9231238118
3343,13853530,17453129,31306659,8,0,0,5120,13,1242913923
3344,13855040,19335796,33190836,4,0,0,6656,4,4844425201
3345,13857010,18240196,32097206,4,0,0,37888,4,8976791880
3346,13857290,38347713,52205003,6,0,1,14848,5,3809885478
3347,13858040,17440765,31298805,0,0,0,19968,5,4125456972
3348,13863731,38342552,52206283,5,0,1,14336,8,7977421127
3349,13872260,38392578,52264838,9,0,1,2560,19,10422757976
3350,13876980,38389164,52266144,3,0,1,2048,12,1334615947
3351,13877490,17581461,31458951,1,0,0,4608,14,2233770834
3352,13877670,19412009,33289679,7,0,0,25600,8,3399501550
3353,13881629,38439244,52320873,8,0,1,27136,13,3304616211
3354,13883300,17953284,31836584,1,0,0,31744,14,349826313
3355,13885310,38439455,52324765,4,0,1,6144,4,6255698452
3356,13886920,38438204,52325124,2,0,1,9728,15,9904505635
3357,13892450,17518906,31411356,5,0,0,10752,8,3842868038
3358,13895550,18090119,31985669,8,0,0,19968,13,7072308247
3359,13896830,17750194,31647024,3,0,0,51200,12,355479601
3360,13898600,18875597,32774197,9,0,0,42496,19,208534016
3361,13899390,17765152,31664542,1,0,0,7168,14,8517795993
3362,13907630,19522987,33430617,2,0,0,34304,15,344282547
3363,13910260,38541315,52451575,9,0,1,1024,19,166550189
3364,13910880,19459047,33369927,8,0,0,37888,13,752895465
3365,13920050,17757174,31677224,8,0,0,6144,13,8512012053
3366,13924440,17607080,31531520,2,0,0,21504,15,5555369236
3367,13927870,17880041,31807911,6,0,0,17408,5,6119095215
3368,13928980,38577336,52506316,6,0,1,26112,5,9694502112
3369,13930860,18291927,32222787,2,0,0,77312,15,4827163384
3370,13932870,18322925,32255795,6,0,0,44544,5,6916949986
3371,13934030,18167434,32101464,4,0,0,7680,4,4997073703
3372,13936740,38601536,52538276,3,0,1,11776,12,6610162646
3373,13947200,17840674,31787874,7,0,0,27648,8,4469637483
3374,13957960,18303528,32261488,2,0,0,18432,15,7586738282
3375,13958990,38579309,52538299,6,0,1,8704,5,5126775229
3376,13965940,17652411,31618351,5,0,0,10240,8,822561788
3377,13967500,18095387,32062887,9,0,0,10240,19,4511105231
3378,13973260,17825557,31798817,6,0,0,35840,5,965595238
3379,13975530,38565451,52540981,0,0,1,512,5,2679193891
3380,13978060,18427435,32405495,2,0,0,16384,15,10024595060
3381,13979050,38626853,52605903,6,0,1,24576,5,7739773829
3382,13983000,19502198,33485198,8,0,0,8704,13,4139601915
3383,13987120,17826438,31813558,6,0,0,18432,5,1594337047
3384,13989220,38742299,52731519,6,0,1,19968,5,6293324843
3385,13992730,18012493,32005223,0,0,0,22528,5,3276247477
3386,13993420,18059826,32053246,3,0,0,13824,12,8791677733
3387,13999250,38762804,52762054,6,0,1,11264,5,271354298
3388,14004429,38863027,52867456,8,0,1,33792,13,5942812663
3389,14004520,38913324,52917844,0,0,1,512,5,467778803
3390,14007380,18579760,32587140,9,0,0,156672,19,2539440452
3391,14013940,17832222,31846162,2,0,0,22016,15,10638879011
3392,14015861,38902006,52917867,5,0,1,10752,8,3665973209
3393,14023940,18218214,32242154,2,0,0,63488,15,6854479272
3394,14025810,18603368,32629178,9,0,0,11776,19,2115804802
3395,14032580,18144744,32177324,9,0,0,22016,19,5338351226
3396,14033519,38884371,52917890,8,0,1,1536,13,8735430270
3397,14038680,17800313,31838993,0,0,0,7680,5,10047939680
3398,14049470,18414080,32463550,6,0,0,26112,5,67918204
3399,14057340,19516053,33573393,6,0,0,80896,5,9160272209
3400,14057820,38860520,52918340,9,0,1,2048,19,7467478974
3401,14059010,18026629,32085639,1,0,0,14336,14,8271023054
3402,14059270,18844323,32903593,5,0,0,16896,8,5067410298
3403,14060980,18800432,32861412,0,0,0,31232,5,3952634362
3404,14070430,18978921,33049351,0,0,0,15360,5,10420965137
3405,14070750,18621893,32692643,9,0,0,7680,19,752638223
3406,14072671,38857586,52930257,5,0,1,5120,8,4311026913
3407,14073300,38938350,53011650,2,0,1,2048,15,8209725050
3408,14079810,18563135,32642945,1,0,0,45056,14,3033240075
3409,14082570,18081982,32164552,3,0,0,3072,12,930542353
3410,14085180,19082406,33167586,2,0,0,78848,15,7853349744
3411,14092590,18935454,33028044,9,0,0,11264,19,8310233367
3412,14093340,38993539,53086879,3,0,1,29184,12,3261399233
3413,14093850,18241426,32335276,6,0,0,28672,5,2794656774
3414,14097320,18169183,32266503,1,0,0,16384,14,1955955646
3415,14106040,19532819,33638859,9,0,0,57344,19,8779553164
3416,14107909,39004061,53111970,8,0,1,15872,13,8022371661
3417,14113980,18300141,32414121,1,0,0,2048,14,3097859287
3418,14115730,17983371,32099101,6,0,0,6144,5,7236399778
3419,14116310,18724614,32840924,7,0,0,11776,8,5281617975
3420,14120330,18747547,32867877,9,0,0,512,19,4082123822
3421,14120870,39144862,53265732,0,0,1,24064,5,8843017359
3422,14123910,17929671,32053581,6,0,0,1024,5,8686492711
3423,14128130,18525336,32653466,2,0,0,5632,15,661435692
3424,14128770,39199847,53328617,6,0,1,32768,5,5567133070
3425,14131490,18298578,32430068,8,0,0,2560,13,1571683379
3426,14138590,19691235,33829825,7,0,0,60416,8,6036212881
3427,14141300,18272174,32413474,3,0,0,26112,12,10360385812
3428,14141690,18357298,32498988,0,0,0,28672,5,5009709542
3429,14144050,18333461,32477511,2,0,0,4096,15,681975767
3430,14147480,18588576,32736056,3,0,0,26112,12,9716234192
3431,14149050,19804939,33953989,1,0,0,19968,14,2803845869
3432,14152040,18445199,32597239,1,0,0,13312,14,2490747789
3433,14155320,18437771,32593091,1,0,0,19456,14,9764568117
3434,14169850,18479826,32649676,0,0,0,22016,5,6835863355
3435,14170640,18481087,32651727,1,0,0,6656,14,8526973688
3436,14179010,18549067,32728077,5,0,0,24576,8,1826024516
3437,14185580,18512390,32697970,6,0,0,17408,5,1726027404
3438,14186430,18287127,32473557,7,0,0,32768,8,3650902992
3439,14191690,18237575,32429265,6,0,0,16896,5,10570694461
3440,14192820,18605343,32798163,6,0,0,26624,5,7620512615
3441,14196010,18615650,32811660,6,0,0,34304,5,4290244098
3442,14196820,18799583,32996403,6,0,0,68096,5,846532248
3443,14198060,39130580,53328640,0,0,1,2560,5,4176791094
3444,14199390,18936147,33135537,6,0,0,120320,5,730267194
3445,14206920,18269312,32476232,2,0,0,8704,15,8448081122
3446,14215800,18693276,32909076,1,0,0,17920,14,5782314750
3447,14223840,18401727,32625567,2,0,0,50176,15,9679505482
3448,14225200,18536026,32761226,6,0,0,5120,5,5283331938
3449,14231950,18458330,32690280,2,0,0,24064,15,3163387340
3450,14232070,39137826,53369896,0,0,1,17920,5,2634829134
3451,14240940,18438223,32679163,7,0,0,7680,8,8652115262
3452,14244150,18284207,32528357,5,0,0,6656,8,6377356655
3453,14245440,18622258,32867698,3,0,0,7680,12,65618894
3454,14246490,18582665,32829155,8,0,0,57344,13,268128881
3455,14249779,39259034,53508813,8,0,1,1536,13,9390386005
3456,14264320,18737277,33001597,6,0,0,11264,5,10238166212
3457,14271860,18764584,33036444,5,0,0,16896,8,8904175931
3458,14272880,19008976,33281856,6,0,0,75776,5,4287263402
3459,14277210,18664316,32941526,0,0,0,20992,5,454860971
3460,14277630,19123909,33401539,2,0,0,26624,15,1315430654
3461,14279290,18652851,32932141,5,0,0,9728,8,10168772156
3462,14280480,19112745,33393225,1,0,0,7168,14,7390246598
3463,14281200,19112204,33393404,5,0,0,512,8,4697254790
3464,14283320,39253428,53536748,4,0,1,7680,4,9953736042
3465,14284170,18581165,32865335,1,0,0,12800,14,5345907536
3466,14284670,39258109,53542779,0,0,1,6144,5,1487512915
3467,14287630,19781978,34069608,8,0,0,43008,13,10103899884
3468,14292820,18543066,32835886,6,0,0,22016,5,9063166108
3469,14294929,39247873,53542802,1,0,1,15360,14,2332311196
3470,14297000,18889398,33186398,4,0,0,1536,4,453814840
3471,14297030,18540283,32837313,4,0,0,4608,4,7599071881
3472,14302310,18742338,33044648,2,0,0,25600,15,268745900
3473,14312400,18869116,33181516,7,0,0,1536,8,6104182201
3474,14318120,39319601,53637721,0,0,1,6656,5,5240125243
3475,14319050,19339199,33658249,7,0,0,19968,8,7474141295
3476,14319910,39318021,53637931,6,0,1,23040,5,6267103637
3477,14327070,18811298,33138368,9,0,0,9216,19,4735246831
3478,14327340,18593311,32920651,3,0,0,22016,12,10408335433
3479,14329140,19205028,33534168,0,0,0,51200,5,8216981824
3480,14336750,18849157,33185907,5,0,0,14336,8,5846248690
3481,14339370,19051640,33391010,3,0,0,69120,12,175629407
3482,14339530,18658612,32998142,6,0,0,5632,5,10520032550
3483,14341460,18802079,33143539,3,0,0,16896,12,2804788189
3484,14341620,19674279,34015899,8,0,0,23040,13,7707988085
3485,14353560,19298582,33652142,3,0,0,43520,12,10189149296
3486,14356570,19229482,33586052,9,0,0,41472,19,5535404464
3487,14357490,39280464,53637954,3,0,1,8192,12,5300015157
3488,14370260,19336505,33706765,9,0,0,14336,19,10586643044
3489,14372230,39265747,53637977,2,0,1,3584,15,3758358746
3490,14378980,39259020,53638000,9,0,1,10752,19,7688480411
3491,14385151,39276147,53661298,7,0,1,15872,8,3512812881
3492,14385830,19720780,34106610,4,0,0,2560,4,8881172960
3493,14390189,39271775,53661964,1,0,1,1024,14,5096111442
3494,14398310,19063337,33461647,4,0,0,8192,4,7964955139
3495,14398680,19102921,33501601,5,0,0,53760,8,3079455049
3496,14409680,39255190,53664870,3,0,1,4608,12,9317169513
3497,14414380,18766645,33181025,5,0,0,44032,8,1069982564
3498,14414710,19134012,33548722,6,0,0,39424,5,3267178845
3499,14415990,18668240,33084230,3,0,0,8192,12,7839225029
3500,14422820,18930630,33353450,5,0,0,39424,8,4760410152
3501,14425380,18901793,33327173,3,0,0,8704,12,629120762
3502,14425920,19260608,33686528,1,0,0,19456,14,962972836
3503,14432780,19452624,33885404,3,0,0,28672,12,1987497340
3504,14436150,18882865,33319015,5,0,0,46080,8,4048764016
3505,14442890,19416030,33858920,0,0,0,512,5,2585265581
3506,14455770,19080917,33536687,5,0,0,8192,8,6194428751
3507,14458220,18752956,33211176,8,0,0,5120,13,8559637513
3508,14458990,19281461,33740451,2,0,0,2560,15,1589946539
3509,14467480,18857018,33324498,8,0,0,17920,13,9485186338
3510,14468450,19270170,33738620,5,0,0,23040,8,3403375793
3511,14469400,18775877,33245277,1,0,0,5120,14,8682442956
3512,14472940,18967894,33440834,4,0,0,23040,4,8809259699
3513,14474490,18966835,33441325,0,0,0,1536,5,991308926
3514,14475280,19333037,33808317,5,0,0,512,8,7534552772
3515,14479620,19529236,34008856,7,0,0,8704,8,9538571616
3516,14483350,18962522,33445872,2,0,0,14848,15,6305952822
3517,14484530,18842822,33327352,5,0,0,512,8,10350597230
3518,14484890,19136474,33621364,6,0,0,74240,5,5699633388
3519,14486740,19234548,33721288,1,0,0,11776,14,2638805491
3520,14487770,19907945,34395715,4,0,0,4608,4,5054112655
3521,14489040,19797176,34286216,4,0,0,7680,4,3830816492
3522,14499810,19528459,34028269,6,0,0,38912,5,1957550232
3523,14501780,19446102,33947882,8,0,0,22016,13,6438116009
3524,14502620,39177826,53680446,0,0,1,2048,5,2535020878
3525,14504120,18900266,33404386,2,0,0,9216,15,3215954810
3526,14509840,19727294,34237134,1,0,0,16896,14,7887494273
3527,14510760,19179992,33690752,4,0,0,3072,4,119298486
3528,14512260,19002698,33514958,4,0,0,7680,4,1409078048
3529,14512290,19687975,34200265,6,0,0,40448,5,10525947625
3530,14515570,19071285,33586855,7,0,0,2560,8,6454324170
3531,14515580,19557951,34073531,1,0,0,12800,14,6335163483
3532,14519880,19071998,33591878,7,0,0,16384,8,6020314135
3533,14519890,39161542,53681432,3,0,1,1536,12,3101512083
3534,14519940,19159975,33679915,6,0,0,28160,5,3719831427
3535,14528010,19256780,33784790,2,0,0,1536,15,3369452337
3536,14528300,39156358,53684658,6,0,1,5120,5,9935504512
3537,14529480,19411671,33941151,6,0,0,72704,5,4705971226
3538,14531060,39179876,53710936,8,0,1,9728,13,6400426081
3539,14532940,19473241,34006181,9,0,0,41472,19,6654166692
3540,14535090,19196458,33731548,4,0,0,5120,4,2372795159
3541,14538350,19670830,34209180,0,0,0,29184,5,8339586203
3542,14546710,19836220,34382930,7,0,0,87040,8,3721617105
3543,14547730,19311011,33858741,5,0,0,30208,8,876196413
3544,14553960,39196958,53750918,6,0,1,512,5,10173042230
3545,14561960,18939820,33501780,0,0,0,512,5,4548771583
3546,14576940,39174324,53751264,4,0,1,512,4,1691831601
3547,14579230,39275955,53855185,0,0,1,12288,5,3806679247
3548,14579940,20058418,34638358,6,0,0,27648,5,2592967305
3549,14581000,20118363,34699363,8,0,0,3584,13,10276644492
3550,14597650,19382121,33979771,0,0,0,49152,5,6274533901
3551,14598230,19180706,33778936,4,0,0,54784,4,5652785417
3552,14598510,19265425,33863935,3,0,0,16384,12,9177816033
3553,14599350,39288675,53888025,4,0,1,19456,4,9883189820
3554,14600470,19207668,33808138,6,0,0,18432,5,9938060303
3555,14604240,20220074,34824314,5,0,0,33280,8,6333638753
3556,14611170,19288663,33899833,7,0,0,9728,8,7491022590
3557,14613190,19423089,34036279,6,0,0,17408,5,9152035474
3558,14616040,39272344,53888384,4,0,1,9728,4,9771473792
3559,14617830,19484272,34102102,2,0,0,7680,15,3060194989
3560,14622910,19789054,34411964,1,0,0,14848,14,3025762033
3561,14622970,19370552,33993522,9,0,0,45056,19,2744280892
3562,14626340,39273263,53899603,6,0,1,3584,5,5779212349
3563,14626360,39296563,53922923,6,0,1,11264,5,900202891
3564,14627530,19476258,34103788,9,0,0,512,19,2340281554
3565,14641770,19247713,33889483,8,0,0,13312,13,963238123
3566,14643570,19684552,34328122,5,0,0,41472,8,9911760991
3567,14646050,39280099,53926149,2,0,1,5120,15,9130669058
3568,14647660,20360009,35007669,7,0,0,81920,8,9558783350
3569,14654930,39271565,53926495,4,0,1,512,4,4548306027
3570,14656620,20621580,35278200,8,0,0,39424,13,6664220818
3571,14663660,20508709,35172369,8,0,0,31744,13,10615959192
3572,14668780,19142614,33811394,4,0,0,8192,4,9713658667
3573,14669070,39258411,53927481,2,0,1,1536,15,791185611
3574,14670320,39351711,54022031,4,0,1,35328,4,1291341572
3575,14674500,19341890,34016390,5,0,0,1536,8,848987765
3576,14675490,19355462,34030952,1,0,0,8704,14,7790162548
3577,14683920,19710265,34394185,8,0,0,36864,13,620277340
3578,14687550,19359119,34046669,0,0,0,10240,5,10152406141
3579,14692910,19388405,34081315,1,0,0,3584,14,8071859036
3580,14694930,39349072,54044002,6,0,1,2048,5,9105491214
3581,14698140,19704640,34402780,5,0,0,3072,8,10130349469
3582,14700670,19613240,34313910,0,0,0,11776,5,9116225400
3583,14704240,19827925,34532165,9,0,0,20992,19,4121657006
3584,14705240,19443596,34148836,8,0,0,8704,13,3773851817
3585,14710220,19346261,34056481,6,0,0,22528,5,9716288735
3586,14711050,19511124,34222174,2,0,0,19968,15,1257702600
3587,14711850,19393957,34105807,7,0,0,4608,8,2695755595
3588,14712701,39379521,54092222,5,0,1,10240,8,9110990226
3589,14716710,19728466,34445176,0,0,0,36352,5,2514643806
3590,14717320,19461549,34178869,5,0,0,2560,8,10229699373
3591,14717520,19555362,34272882,3,0,0,14848,12,8589038407
3592,14722050,19494017,34216067,1,0,0,22528,14,7577313546
3593,14722610,19757771,34480381,7,0,0,4096,8,1196760978
3594,14728940,19570860,34299800,7,0,0,3072,8,10362279102
3595,14729420,19559471,34288891,0,0,0,8704,5,7501238936
3596,14743570,39403318,54146888,4,0,1,19456,4,8429730807
3597,14744480,19481305,34225785,8,0,0,11776,13,8943067702
3598,14747680,19677399,34425079,2,0,0,10240,15,1631234685
3599,14750310,19677132,34427442,8,0,0,7680,13,4068913060
3600,14750850,19718335,34469185,4,0,0,7680,4,4886576267
3601,14758390,19509945,34268335,5,0,0,43008,8,897072362
3602,14788390,19992068,34780458,3,0,0,4608,12,1447832733
3603,14793640,19684851,34478491,7,0,0,15360,8,7341915481
3604,14797480,19532225,34329705,4,0,0,5120,4,2742252337
3605,14804360,19825551,34629911,8,0,0,37376,13,2179568122
3606,14809870,19676005,34485875,6,0,0,16384,5,1552083388
3607,14814750,19516268,34331018,0,0,0,3584,5,10349392065
3608,14825940,19944777,34770717,4,0,0,27136,4,4124041181
3609,14826090,19749517,34575607,7,0,0,28160,8,7685485136
3610,14831430,19451246,34282676,8,0,0,1024,13,5108057096
3611,14834420,19896543,34730963,3,0,0,13824,12,5026610948
3612,14836130,19720875,34557005,7,0,0,11776,8,6837887412
3613,14841220,19710283,34551503,0,0,0,16896,5,3593910553
3614,14844650,20007680,34852330,6,0,0,47616,5,2006899382
3615,14844830,19861402,34706232,8,0,0,10240,13,3932961696
3616,14850700,20044785,34895485,4,0,0,50176,4,6623703009
3617,14853020,19951258,34804278,1,0,0,13312,14,5218827437
3618,14863100,39285525,54148625,3,0,1,3072,12,5185528813
3619,14865550,20196202,35061752,8,0,0,122368,13,7784142576
3620,14867939,39282069,54150008,1,0,1,14848,14,5137862746
3621,14869430,19694462,34563892,9,0,0,22528,19,7113975540
3622,14869660,20010514,34880174,1,0,0,55296,14,516617012
3623,14876480,20453637,35330117,6,0,0,19968,5,4361156958
3624,14883580,19654377,34537957,0,0,0,12800,5,9214643030
3625,14896050,20333775,35229825,3,0,0,33792,12,2902762570
3626,14898120,20505619,35403739,0,0,0,25088,5,4131079532
3627,14903991,19752358,34656349,0,0,0,9728,5,10676478845
3628,14904060,19601905,34505965,0,0,0,3584,5,6375026028
3629,14904339,39318310,54222649,1,0,1,2048,14,2057852912
3630,14906080,20544657,35450737,9,0,0,16896,19,2803306609
3631,14912500,39673922,54586422,4,0,1,30720,4,8803469555
3632,14913530,19861266,34774796,3,0,0,13312,12,6042266453
3633,14915390,19922409,34837799,4,0,0,21504,4,8992489225
3634,14917750,39668695,54586445,3,0,1,8704,12,3415244483
3635,14918570,19773520,34692090,4,0,0,15872,4,10569192456
3636,14922650,39775580,54698230,2,0,1,16896,15,9203529145
3637,14930420,20083980,35014400,2,0,0,22016,15,7065849037
3638,14940860,20566406,35507266,6,0,0,2560,5,4895170938
3639,14944720,20194527,35139247,0,0,0,28160,5,5218586940
3640,14947960,19739271,34687231,2,0,0,4096,15,948031616
3641,14948540,39830741,54779281,6,0,1,16384,5,10506065078
3642,14949060,20601934,35550994,2,0,0,25088,15,2662796954
3643,14960130,39822785,54782915,0,0,1,11264,5,1058939223
3644,14961180,20056987,35018167,5,0,0,12288,8,6698928151
3645,14963520,19941660,34905180,2,0,0,31744,15,1204295318
3646,14967480,19988934,34956414,3,0,0,22016,12,6550359011
3647,14969440,19809591,34779031,7,0,0,13824,8,3427729567
3648,14976800,19849565,34826365,7,0,0,6656,8,7465290556
3649,14981110,19927837,34908947,7,0,0,12288,8,7923913406
3650,14988980,20096249,35085229,5,0,0,40448,8,5749524239
3651,14993070,20099982,35093052,2,0,0,25600,15,475404762
3652,14993961,19861668,34855629,0,0,0,10752,5,1516605364
3653,15001020,20142306,35143326,8,0,0,13312,13,2227613094
3654,15002330,39867323,54869653,0,0,1,3072,5,7399733169
3655,15008250,39863789,54872039,9,0,1,6144,19,9439517455
3656,15010220,20352200,35362420,5,0,0,32256,8,2751884827
3657,15015410,19781761,34797171,7,0,0,5632,8,7214795017
3658,15021730,20558190,35579920,2,0,0,28160,15,7774294603
3659,15025471,19805753,34831224,0,0,0,15872,5,6662193496
3660,15029900,20122706,35152606,4,0,0,12800,4,263338448
3661,15030430,19952256,34982686,5,0,0,8192,8,2527665115
3662,15030850,19993595,35024445,7,0,0,12288,8,8466216580
3663,15036430,19905417,34941847,4,0,0,1536,4,3717558614
3664,15037740,19920881,34958621,2,0,0,7168,15,8704738528
3665,15039600,19893118,34932718,1,0,0,9216,14,4074377694
3666,15044640,20696883,35741523,9,0,0,134144,19,8846105949
3667,15046821,20022294,35069115,0,0,0,24064,5,5870393893
3668,15047750,20199470,35247220,8,0,0,17920,13,5680194748
3669,15049720,20023162,35072882,4,0,0,12288,4,707947323
3670,15059290,20044884,35104174,5,0,0,26624,8,3858594153
3671,15062440,20580326,35642766,1,0,0,20480,14,5952539011
3672,15071400,20134589,35205989,9,0,0,6144,19,6700073976
3673,15075400,20190765,35266165,8,0,0,39424,13,4191700041
3674,15075900,39798057,54873957,3,0,1,5632,12,1011844179
3675,15081580,39795410,54876990,4,0,1,3584,4,1179199595
3676,15082840,20039688,35122528,4,0,0,26112,4,2864897484
3677,15083660,20012379,35096039,9,0,0,9728,19,5691840097
3678,15092590,39784914,54877504,0,0,1,5632,5,7679357954
3679,15093970,20269409,35363379,8,0,0,3072,13,8059044331
3680,15097480,39800404,54897884,4,0,1,14336,4,1446074409
3681,15104180,20112720,35216900,5,0,0,4608,8,7705286558
3682,15112431,20084678,35197109,0,0,0,12288,5,8703009803
3683,15114350,20139780,35254130,2,0,0,1536,15,623493261
3684,15116820,20743705,35860525,2,0,0,43008,15,3351917146
3685,15118740,20233677,35352417,9,0,0,3072,19,5091193259
3686,15119440,20186466,35305906,3,0,0,12800,12,2599680708
3687,15132020,20059187,35191207,8,0,0,37376,13,2813762900
3688,15137280,39760627,54897907,4,0,1,512,4,3813335054
3689,15147450,20743516,35890966,4,0,0,8192,4,1557845908
3690,15153100,20100539,35253639,9,0,0,20992,19,3244804369
3691,15154300,20197158,35351458,1,0,0,31232,14,7579891139
3692,15158900,20589986,35748886,3,0,0,24064,12,6728271453
3693,15159550,20850013,36009563,5,0,0,25600,8,689619795
3694,15164680,20896339,36061019,9,0,0,58368,19,6874595366
3695,15166040,20222396,35388436,2,0,0,11776,15,9707287079
3696,15167200,20310993,35478193,3,0,0,23040,12,3563056882
3697,15179510,20456993,35636503,7,0,0,3072,8,6048318649
3698,15183250,20223594,35406844,1,0,0,2048,14,6699103952
3699,15186960,20414593,35601553,2,0,0,25600,15,7544225233
3700,15190700,20265988,35456688,3,0,0,19456,12,5778854454
3701,15191000,20592893,35783893,1,0,0,47104,14,9033280187
3702,15192000,20594375,35786375,9,0,0,6144,19,517893004
3703,15193560,20397424,35590984,8,0,0,7680,13,6877569961
3704,15194020,20791033,35985053,8,0,0,47104,13,4805026645
3705,15197230,20436327,35633557,4,0,0,56832,4,2497127122
3706,15202920,20634385,35837305,3,0,0,57856,12,3675694476
3707,15202930,20454501,35657431,4,0,0,11264,4,2304093140
3708,15204580,20288667,35493247,5,0,0,11264,8,740815813
3709,15207830,20492798,35700628,3,0,0,11264,12,5874112190
3710,15211370,20636028,35847398,9,0,0,23040,19,6425997558
3711,15224280,21355071,36579351,6,0,0,26624,5,5533710189
3712,15233610,39664320,54897930,3,0,1,7168,12,1226796095
3713,15238360,21440827,36679187,1,0,0,62976,14,2195315216
3714,15246600,39682016,54928616,9,0,1,12800,19,10561741959
3715,15255100,20396283,35651383,2,0,0,7168,15,9071930554
3716,15256381,39692325,54948706,5,0,1,8704,8,8693843906
3717,15270871,20404291,35675162,0,0,0,19456,5,3586275388
3718,15277220,20596677,35873897,1,0,0,39424,14,3148431847
3719,15279440,20417733,35697173,8,0,0,36352,13,8156740134
3720,15284141,20350688,35634829,0,0,0,512,5,6512756472
3721,15288300,39715813,55004113,6,0,1,7680,5,4342339317
3722,15289010,21538989,36827999,5,0,0,9728,8,8511489414
3723,15289980,21281236,36571216,2,0,0,69120,15,883647405
3724,15292120,20633308,35925428,3,0,0,15872,12,5280836632
3725,15294319,39709817,55004136,1,0,1,9216,14,8471356872
3726,15295380,20716546,36011926,6,0,0,7680,5,6944877241
3727,15299230,20380947,35680177,5,0,0,16384,8,969675616
3728,15300790,20632952,35933742,7,0,0,14336,8,8247253461
3729,15300830,20587617,35888447,7,0,0,26624,8,5201723971
3730,15310170,20762959,36073129,3,0,0,18944,12,3867447476
3731,15310620,39754718,55065338,9,0,1,512,19,10329696463
3732,15312769,39752592,55065361,8,0,1,8704,13,2415482434
3733,15316190,21701349,37017539,2,0,0,59904,15,10492531336
3734,15317750,39817641,55135391,2,0,1,20992,15,10368816503
3735,15325180,21088977,36414157,8,0,0,29696,13,4916057558
3736,15325881,39809533,55135414,5,0,1,512,8,6222534660
3737,15329110,20710816,36039926,6,0,0,22528,5,4791504900
3738,15331300,21057488,36388788,1,0,0,14336,14,2994661536
3739,15348660,39786777,55135437,0,0,1,8192,5,6082585345
3740,15349700,20959295,36308995,8,0,0,48640,13,8283700137
3741,15353250,20576101,35929351,2,0,0,12800,15,8124534914
3742,15361820,20712112,36073932,3,0,0,2560,12,1869023052
3743,15371860,39791842,55163702,9,0,1,4096,19,4392516649
3744,15375604,20756844,36132448,4,0,0,22528,4,4150017390
3745,15378850,20845261,36224111,3,0,0,59392,12,7789544208
3746,15385659,39808350,55194009,8,0,1,10752,13,1145934842
3747,15394061,20788002,36182063,0,0,0,59392,5,535023802
3748,15398050,22143471,37541521,8,0,0,28160,13,5151564694
3749,15400549,39801306,55201855,1,0,1,1536,14,10087746189
3750,15409750,39792128,55201878,2,0,1,7168,15,10015204634
3751,15421060,21722318,37143378,9,0,0,16896,19,2913566354
3752,15421510,20739176,36160686,9,0,0,27136,19,7997850382
3753,15421690,20937025,36358715,6,0,0,17920,5,5353597523
3754,15421709,39878406,55300115,8,0,1,16384,13,1727585321
3755,15423000,39877138,55300138,6,0,1,2048,5,4148224059
3756,15423790,20662378,36086168,4,0,0,16896,4,7518200601
3757,15424860,20805982,36230842,9,0,0,22016,19,8976488998
3758,15432971,20808369,36241340,0,0,0,14336,5,605708553
3759,15442660,20803718,36246378,2,0,0,4096,15,7856466231
3760,15446960,39853201,55300161,3,0,1,2560,12,542617955
3761,15450280,20697650,36147930,6,0,0,25600,5,7486631477
3762,15455850,20813874,36269724,6,0,0,15872,5,2207918147
3763,15456760,39843424,55300184,6,0,1,5120,5,6340573998
3764,15459370,20495503,35954873,8,0,0,1536,13,3609214824
3765,15463930,20555935,36019865,7,0,0,2048,8,8108097322
3766,15464200,21222654,36686854,4,0,0,25088,4,6700859054
3767,15465410,22238985,37704395,9,0,0,17920,19,1891104590
3768,15467580,20867100,36334680,8,0,0,12288,13,7519362373
3769,15468159,39843779,55311938,1,0,1,3072,14,10117997532
3770,15482751,20665826,36148577,0,0,0,2048,5,5943900704
3771,15484189,39835127,55319316,8,0,1,3072,13,7194079163
3772,15485760,21113894,36599654,3,0,0,66560,12,1107524370
3773,15489570,20884968,36374538,8,0,0,36352,13,7470173562
3774,15489840,39829499,55319339,6,0,1,2048,5,149386447
3775,15490741,20910202,36400943,0,0,0,15360,5,7080565851
3776,15493210,39922948,55416158,0,0,1,15872,5,7111790937
3777,15496420,20919920,36416340,5,0,0,1024,8,2845012108
3778,15500310,20705682,36205992,4,0,0,33792,4,2721658496
3779,15501500,40061101,55562601,9,0,1,11776,19,2777750609
3780,15507910,21104145,36612055,3,0,0,11264,12,6886499416
3781,15509330,20735777,36245107,1,0,0,12288,14,2590310281
3782,15521430,40041194,55562624,0,0,1,13312,5,5525308833
3783,15523230,21136703,36659933,9,0,0,30208,19,2467553849
3784,15524390,20736143,36260533,9,0,0,32768,19,3815035569
3785,15524739,40196940,55721679,1,0,1,24576,14,8653266942
3786,15533800,40189185,55722985,9,0,1,2048,19,1078980415
3787,15535001,20726803,36261804,0,0,0,4096,5,8115679484
3788,15536330,20551265,36087595,3,0,0,4608,12,4002991235
3789,15538770,20698179,36236949,7,0,0,19968,8,3758112479
3790,15541580,21067020,36608600,4,0,0,17408,4,3444083633
3791,15542100,21061165,36603265,6,0,0,11776,5,7980246194
3792,15556310,40168941,55725251,6,0,1,3584,5,1190999050
3793,15562940,40166177,55729117,9,0,1,6144,19,2829722988
3794,15569481,20814908,36384389,0,0,0,32256,5,8896638224
3795,15570791,40187651,55758442,5,0,1,7680,8,5209953499
3796,15575071,20742251,36317322,0,0,0,19968,5,495776908
3797,15583540,20966593,36550133,6,0,0,115712,5,3549522289
3798,15588890,40169575,55758465,3,0,1,3584,12,10276620499
3799,15598110,20879855,36477965,6,0,0,42496,5,4998683708
3800,15603460,22138205,37741665,9,0,0,39424,19,7029663303
3801,15605060,21009537,36614597,5,0,0,2048,8,10312892558
3802,15614370,21027821,36642191,6,0,0,2048,5,1376655485
3803,15616959,40300825,55917784,1,0,1,23552,14,7933290548
3804,15620869,40298005,55918874,1,0,1,4096,14,10290028294
3805,15622450,40297090,55919540,2,0,1,1024,15,4490300434
3806,15622581,20769664,36392245,0,0,0,8192,5,4854209726
3807,15629160,21124831,36753991,9,0,0,22528,19,10303284637
3808,15629600,21160308,36789908,4,0,0,71168,4,5187333288
3809,15631380,20866253,36497633,9,0,0,11264,19,7694991674
3810,15640920,21052041,36692961,5,0,0,19968,8,7728797155
3811,15642750,21079787,36722537,7,0,0,21504,8,3257969673
3812,15648420,22189277,37837697,7,0,0,129536,8,7245339988
3813,15649780,21077115,36726895,6,0,0,9216,5,5326795189
3814,15654200,21143367,36797567,4,0,0,5632,4,10345207184
3815,15658110,21315959,36974069,4,0,0,7680,4,8661281341
3816,15663470,21217446,36880916,1,0,0,7168,14,9167186127
3817,15663480,21042787,36706267,9,0,0,26624,19,7528995020
3818,15668160,20945790,36613950,3,0,0,6144,12,4968456880
3819,15670260,21027872,36698132,8,0,0,16896,13,1339684929
3820,15672729,40314957,55987686,8,0,1,13824,13,9911315749
3821,15674650,40335798,56010448,3,0,1,15360,12,685834318
3822,15676670,40565542,56242212,2,0,1,512,15,8175635161
3823,15678110,40565367,56243477,0,0,1,3584,5,6995673025
3824,15681460,21162766,36844226,5,0,0,18944,8,9861830088
3825,15682570,40565733,56248303,9,0,1,7680,19,7014697056
3826,15683870,21371288,37055158,7,0,0,123392,8,4268589680
3827,15698170,20917074,36615244,3,0,0,2048,12,8854062502
3828,15703080,21364924,37068004,3,0,0,31744,12,3788526914
3829,15706710,20914727,36621437,1,0,0,9728,14,7589565286
3830,15707120,21008842,36715962,1,0,0,31744,14,2902847025
3831,15707190,21147260,36854450,4,0,0,5632,4,5552192781
3832,15707890,40541079,56248969,6,0,1,1024,5,2733822181
3833,15728970,21107804,36836774,1,0,0,3072,14,10618041094
3834,15734290,21339041,37073331,3,0,0,17408,12,4855368498
3835,15734430,21170477,36904907,6,0,0,38912,5,7275727880
3836,15735490,21178956,36914446,9,0,0,31232,19,729495425
3837,15736230,21076502,36812732,7,0,0,25088,8,6159836803
3838,15745040,40512261,56257301,6,0,1,11264,5,7131399639
3839,15750730,21179850,36930580,9,0,0,4608,19,2899904362
3840,15756979,40500345,56257324,8,0,1,9216,13,7097336456
3841,15758770,21320269,37079039,3,0,0,13312,12,9754079553
3842,15758840,21376371,37135211,9,0,0,36352,19,287591994
3843,15766400,22237299,38003699,9,0,0,113664,19,5997411796
3844,15767300,40536727,56304027,3,0,1,4096,12,9817712285
3845,15768190,21094729,36862919,4,0,0,27136,4,9791700002
3846,15771821,21027251,36799072,0,0,0,512,5,8838856418
3847,15774550,22128158,37902708,8,0,0,45568,13,442457913
3848,15775440,21476801,37252241,1,0,0,26112,14,9163460149
3849,15777280,21281029,37058309,5,0,0,10240,8,7890620183
3850,15780330,21177956,36958286,4,0,0,23040,4,8300607427
3851,15784390,21445132,37229522,3,0,0,12288,12,887294722
3852,15785630,21422500,37208130,5,0,0,40960,8,7246974144
3853,15787370,21364360,37151730,1,0,0,2048,14,2675698120
3854,15788480,40522501,56310981,0,0,1,5632,5,9094033992
3855,15790380,40521062,56311442,3,0,1,10240,12,10146122236
3856,15801701,21391137,37192838,0,0,0,1536,5,4448094268
3857,15815140,21520465,37335605,3,0,0,14336,12,5143276586
3858,15815940,21364006,37179946,7,0,0,45568,8,8749177922
3859,15821680,21607222,37428902,1,0,0,30208,14,6304065812
3860,15824220,21364173,37188393,5,0,0,27648,8,2698235123
3861,15835560,21356756,37192316,7,0,0,12800,8,1560036852
3862,15842530,21366567,37209097,7,0,0,3072,8,7251713824
3863,15865300,22367678,38232978,8,0,0,4608,13,1351349053
3864,15867440,22327179,38194619,8,0,0,32256,13,2066182230
3865,15878420,21352373,37230793,5,0,0,4096,8,9669408209
3866,15887001,22251308,38138309,0,0,0,19968,5,9823697735
3867,15894330,21392345,37286675,7,0,0,36352,8,4203874842
3868,15895340,21370740,37266080,7,0,0,5120,8,7006905872
3869,15904041,40448953,56352994,5,0,1,12288,8,544942538
3870,15906289,40449724,56356013,8,0,1,5632,13,1440960962
3871,15915160,21969718,37884878,3,0,0,41472,12,4701910800
3872,15920750,21610251,37531001,4,0,0,3072,4,2803531055
3873,15927350,21486998,37414348,7,0,0,66048,8,3854056600
3874,15927581,21492094,37419675,0,0,0,17408,5,1071390295
3875,15931340,21421407,37352747,5,0,0,19456,8,4689377859
3876,15933291,21616502,37549793,0,0,0,9216,5,2292328105
3877,15938230,21747033,37685263,3,0,0,32768,12,9851578516
3878,15943490,21771009,37714499,8,0,0,2048,13,8666035483
3879,15947120,40654232,56601352,9,0,1,11776,19,5516812584
3880,15947780,21747677,37695457,9,0,0,4096,19,4630561319
3881,15954639,40687250,56641889,1,0,1,23552,14,10732706999
3882,15963490,21430688,37394178,3,0,0,34304,12,8986351302
3883,15965600,40676312,56641912,4,0,1,512,4,1658646094
3884,15966000,21728186,37694186,7,0,0,18432,8,8370808231
3885,15967680,21698618,37666298,7,0,0,32768,8,2544127420
3886,15970380,21794412,37764792,3,0,0,21504,12,7789494201
3887,15973471,21660544,37634015,0,0,0,82944,5,8190002082
3888,15987360,21465479,37452839,8,0,0,14848,13,1411083296
3889,15987700,40654235,56641935,9,0,1,8704,19,202654083
3890,15995560,22328132,38323692,5,0,0,49152,8,3521140770
3891,15998160,21729419,37727579,4,0,0,1536,4,6631712625
3892,16001609,40643773,56645382,1,0,1,3072,14,5196218468
3893,16011740,40635948,56647688,2,0,1,2048,15,233666155
3894,16012080,40638194,56650274,4,0,1,4096,4,180900838
3895,16025620,21534595,37560215,5,0,0,2048,8,1251616302
3896,16034580,21604529,37639109,8,0,0,9728,13,7115638902
3897,16046320,21824940,37871260,8,0,0,110080,13,10375834301
3898,16060130,21546689,37606819,7,0,0,24576,8,3598799234
3899,16063679,40690387,56754066,1,0,1,9216,14,7250019343
3900,16074370,22370655,38445025,3,0,0,20480,12,2022699051
3901,16082750,21552692,37635442,7,0,0,4608,8,3310880692
3902,16090970,40666873,56757843,4,0,1,16896,4,1589570199
3903,16092470,22665084,38757554,8,0,0,2048,13,10675401790
3904,16105071,21606357,37711428,0,0,0,7680,5,8842449852
3905,16105310,21831435,37936745,8,0,0,4096,13,5547920241
3906,16107661,40728020,56835681,5,0,1,6656,8,5054639687
3907,16115120,21570790,37685910,3,0,0,2048,12,2336064092
3908,16117801,21793042,37910843,0,0,0,26624,5,759865215
3909,16118280,22406887,38525167,8,0,0,5120,13,8357486402
3910,16125120,21310604,37435724,4,0,0,5120,4,2873355020
3911,16125991,21923889,38049880,0,0,0,66048,5,5019003617
3912,16129510,40717570,56847080,6,0,1,512,5,9012841626
3913,16136630,21531875,37668505,8,0,0,7168,13,10347080551
3914,16137950,21792641,37930591,3,0,0,18944,12,10490538685
3915,16144270,21777539,37921809,8,0,0,34816,13,9115406851
3916,16155090,22458511,38613601,6,0,0,22016,5,5972992332
3917,16156250,21588402,37744652,7,0,0,9728,8,7071059738
3918,16156780,21856660,38013440,5,0,0,11776,8,2070303166
3919,16159700,21712519,37872219,1,0,0,3072,14,5468409832
3920,16160180,40703116,56863296,2,0,1,16896,15,1992329709
3921,16161239,40702080,56863319,8,0,1,1024,13,7356743526
3922,16164651,21534261,37698912,0,0,0,11264,5,2889526205
3923,16165280,21854423,38019703,7,0,0,20480,8,2288261882
3924,16177270,21470087,37647357,6,0,0,8192,5,6002641379
3925,16178290,21710511,37888801,7,0,0,12800,8,3848655215
3926,16178490,21746306,37924796,4,0,0,9728,4,8589494245
3927,16180760,40682582,56863342,6,0,1,2048,5,121667007
3928,16180950,21572919,37753869,5,0,0,7680,8,4596667893
3929,16181720,40682770,56864490,3,0,1,8192,12,963823654
3930,16182710,21845128,38027838,4,0,0,26624,4,3326497687
3931,16184130,21823024,38007154,8,0,0,11264,13,3392915662
3932,16187629,40745449,56933078,1,0,1,9216,14,6436786163
3933,16188910,21913358,38102268,8,0,0,24064,13,6185052269
3934,16189400,22636797,38826197,7,0,0,39936,8,5218592091
3935,16189941,40743160,56933101,5,0,1,12800,8,2438599195
3936,16198680,22234904,38433584,3,0,0,112128,12,5675824672
3937,16205150,22023064,38228214,4,0,0,48128,4,9948625238
3938,16206460,21803369,38009829,6,0,0,8704,5,9562843813
3939,16207220,21992258,38199478,7,0,0,15872,8,1269958801
3940,16207710,21703468,37911178,1,0,0,1024,14,8515742738
3941,16210511,21969386,38179897,0,0,0,12800,5,2006356822
3942,16214311,21946797,38161108,0,0,0,74752,5,2723351287
3943,16223420,21709846,37933266,8,0,0,8704,13,9504055024
3944,16224250,21946709,38170959,4,0,0,32256,4,10674429840
3945,16226931,22172466,38399397,0,0,0,50176,5,5361576858
3946,16231750,21797983,38029733,4,0,0,6144,4,7139026427
3947,16231960,40765336,56997296,0,0,1,1536,5,2273406184
3948,16232879,40765083,56997962,1,0,1,1024,14,7081452512
3949,16238060,21969420,38207480,5,0,0,24576,8,7479977381
3950,16238960,40789298,57028258,9,0,1,6656,19,5774690899
3951,16244700,22009500,38254200,8,0,0,50176,13,8416178771
3952,16246060,40794724,57040784,2,0,1,4608,15,7090321775
3953,16254830,22004028,38258858,6,0,0,14848,5,8963062452
3954,16255301,22007667,38262968,0,0,0,7680,5,9839899224
3955,16258190,21941779,38199969,4,0,0,1536,4,782075957
3956,16265540,22592198,38857738,8,0,0,38912,13,8544157431
3957,16269760,21906214,38175974,1,0,0,16384,14,7264570349
3958,16273620,22222561,38496181,5,0,0,38400,8,9133950596
3959,16276110,22403801,38679911,6,0,0,40960,5,6415951391
3960,16280350,22178564,38458914,6,0,0,31744,5,2618353780
3961,16283270,21946059,38229329,3,0,0,3584,12,1361247393
3962,16283450,21946058,38229508,6,0,0,512,5,1226647968
3963,16286680,22150702,38437382,4,0,0,1536,4,180478170
3964,16287930,41307498,57595428,2,0,1,199168,15,2426363899
3965,16292650,21778802,38071452,5,0,0,3584,8,7039040359
3966,16293150,22520856,38814006,8,0,0,114688,13,3577831231
3967,16293160,22041891,38335051,7,0,0,18944,8,2100338668
3968,16295580,22742606,39038186,8,0,0,11264,13,4492533904
3969,16298600,21910954,38209554,4,0,0,5632,4,2541964855
3970,16305111,21963245,38268356,0,0,0,17408,5,2119444447
3971,16305890,22239443,38545333,4,0,0,38400,4,5463137662
3972,16314790,21893025,38207815,3,0,0,1024,12,6966447098
3973,16319100,41276351,57595451,2,0,1,6656,15,3045510286
3974,16329470,21963468,38292938,6,0,0,10752,5,3575261858
3975,16340840,21919757,38260597,4,0,0,5632,4,1770054096
3976,16346830,22124431,38471261,7,0,0,26624,8,4474287907
3977,16349040,22762385,39111425,2,0,0,7168,15,6592086457
3978,16352390,22242332,38594722,6,0,0,17408,5,9668842921
3979,16354550,22288318,38642868,6,0,0,512,5,7275350413
3980,16370160,22457955,38828115,7,0,0,4608,8,4816697720
3981,16372270,22376042,38748312,4,0,0,1536,4,3958194559
3982,16376540,22399606,38776146,3,0,0,1024,12,4114654853
3983,16397230,22560948,38958178,1,0,0,129024,14,1586510538
3984,16399710,21939468,38339178,2,0,0,3072,15,8636249161
3985,16406040,22122270,38528310,1,0,0,10240,14,6868831150
3986,16407610,22029273,38436883,2,0,0,10752,15,6771455149
3987,16420970,22246438,38667408,1,0,0,43008,14,8463638886
3988,16424400,22327946,38752346,6,0,0,5120,5,3928380252
3989,16430210,22152467,38582677,2,0,0,11264,15,3689597763
3990,16435121,21948965,38384086,0,0,0,26112,5,4705398230
3991,16445610,22400202,38845812,6,0,0,12288,5,2189428072
3992,16453680,22465140,38918820,1,0,0,30720,14,9738875802
3993,16459760,41202222,57661982,6,0,1,2048,5,2877888418
3994,16464580,22124815,38589395,5,0,0,20992,8,7041293794
3995,16472980,41189025,57662005,6,0,1,512,5,2314302617
3996,16481280,22072367,38553647,2,0,0,27136,15,7251526636
3997,16483461,22425797,38909258,0,0,0,31232,5,1878074592
3998,16486370,22537863,39024233,2,0,0,40960,15,83771743
3999,16486521,22371708,38858229,0,0,0,1536,5,5175114665
4000,16487001,22519706,39006707,0,0,0,75264,5,2128645105
4001,16493030,22468322,38961352,7,0,0,7168,8,10113995890
4002,16496650,41165378,57662028,0,0,1,2048,5,8743119507
4003,16502440,22550308,39052748,8,0,0,10240,13,7101685048
4004,16504030,41174268,57678298,3,0,1,6144,12,829056117
4005,16505490,22602145,39107635,3,0,0,18944,12,4755432367
4006,16510320,22389399,38899719,5,0,0,35328,8,3397380472
4007,16512431,22329614,38842045,0,0,0,45568,5,4890202316
4008,16517120,22661255,39178375,6,0,0,14336,5,7567563930
4009,16517810,41695145,58212955,9,0,1,24576,19,3052612058
4010,16519670,22163305,38682975,8,0,0,9728,13,1003141155
4011,16520930,22183475,38704405,8,0,0,10240,13,5462954693
4012,16529570,22454182,38983752,6,0,0,48128,5,7272949450
4013,16530370,22516792,39047162,8,0,0,7680,13,4441503191
4014,16532161,41751262,58283423,5,0,1,14336,8,10573012329
4015,16538930,22562910,39101840,8,0,0,30208,13,8964303639
4016,16546700,22419511,38966211,5,0,0,15872,8,2306643909
4017,16546880,22362557,38909437,8,0,0,512,13,10196892791
4018,16548720,41751033,58299753,2,0,1,16896,15,4464772679
4019,16550940,41761263,58312203,0,0,1,4608,5,4660275304
4020,16554650,22520208,39074858,2,0,0,31744,15,7652042327
4021,16557420,22824147,39381567,3,0,0,41984,12,6329007406
4022,16560630,22683121,39243751,2,0,0,67584,15,1827396205
4023,16562870,22448860,39011730,4,0,0,16384,4,8037390489
4024,16581670,41730556,58312226,2,0,1,9216,15,219878560
4025,16586371,22278408,38864779,0,0,0,15360,5,3731269944
4026,16602610,22224078,38826688,6,0,0,1536,5,6901475175
4027,16622859,41689655,58312514,1,0,1,2048,14,8932441661
4028,16634200,22762953,39397153,1,0,0,50688,14,3043550060
4029,16643460,41734248,58377708,4,0,1,8192,4,3821184657
4030,16645850,22323215,38969065,7,0,0,9216,8,774301447
4031,16647781,41732313,58380094,5,0,1,4096,8,1309551355
4032,16650111,22432177,39082288,0,0,0,16896,5,8593200151
4033,16661300,22491601,39152901,6,0,0,34816,5,10033952939
4034,16664329,41715788,58380117,8,0,1,9216,13,10335796683
4035,16664950,41715190,58380140,4,0,1,1536,4,9596104668
4036,16676770,22357961,39034731,4,0,0,28672,4,9948381168
4037,16688200,22429134,39117334,1,0,0,14848,14,2010945301
4038,16694760,22264377,38959137,3,0,0,3072,12,2958895621
4039,16695489,41748548,58444037,1,0,1,6144,14,9879310908
4040,16699080,22326892,39025972,3,0,0,5632,12,8670842060
4041,16706690,41737706,58444396,6,0,1,9728,5,4414844662
4042,16712000,22570311,39282311,1,0,0,20992,14,8912624234
4043,16712150,41762343,58474493,2,0,1,6656,15,6862615100
4044,16712340,41862548,58574888,6,0,1,2560,5,7522088704
4045,16716240,22392978,39109218,5,0,0,5120,8,922362766
4046,16719020,22469105,39188125,5,0,0,16896,8,7100032210
4047,16738461,41866695,58605156,5,0,1,7680,8,322833278
4048,16742680,22386808,39129488,1,0,0,13312,14,7997666654
4049,16742830,41973051,58715881,4,0,1,4096,4,5846746300
4050,16749280,41966624,58715904,4,0,1,2560,4,6134420310
4051,16753290,22668525,39421815,6,0,0,36864,5,2855950287
4052,16756300,22601009,39357309,4,0,0,12800,4,10672882633
4053,16760180,22325917,39086097,5,0,0,6656,8,658823149
4054,16772240,22448349,39220589,2,0,0,1024,15,3683734918
4055,16779260,22403694,39182954,6,0,0,6144,5,4040171566
4056,16781540,22337065,39118605,5,0,0,4096,8,4183878050
4057,16787790,22662387,39450177,3,0,0,24064,12,4697014330
4058,16791450,22256047,39047497,9,0,0,1024,19,6324017203
4059,16799540,23131392,39930932,2,0,0,14848,15,1901578457
4060,16801060,22459824,39260884,5,0,0,26112,8,3518827548
4061,16804410,41911517,58715927,2,0,1,512,15,726061548
4062,16814470,22783881,39598351,3,0,0,19968,12,33093941
4063,16814990,22641918,39456908,3,0,0,22016,12,942141190
4064,16821070,22761768,39582838,3,0,0,50688,12,30351767
4065,16833590,22757695,39591285,6,0,0,27648,5,7588684149
4066,16833700,22515705,39349405,2,0,0,55296,15,8166537635
4067,16834550,22411252,39245802,7,0,0,6656,8,7387046757
4068,16834980,23478468,40313448,6,0,0,37888,5,2936051178
4069,16835640,41880310,58715950,6,0,1,3584,5,3890832384
4070,16836480,22848058,39684538,3,0,0,10240,12,5954714763
4071,16837130,41878843,58715973,9,0,1,3584,19,5770703959
4072,16839710,22429465,39269175,7,0,0,27136,8,3399168197
4073,16839720,22482399,39322119,2,0,0,8192,15,1847308363
4074,16844940,22555668,39400608,4,0,0,11264,4,10050409747
4075,16858520,22751615,39610135,5,0,0,19968,8,3590119416
4076,16861600,22911203,39772803,9,0,0,1536,19,7491407322
4077,16865969,41919146,58785115,1,0,1,20480,14,3571147707
4078,16867520,22682200,39549720,2,0,0,124416,15,10290551949
4079,16869580,22797284,39666864,9,0,0,32768,19,6548464500
4080,16870540,22530247,39400787,6,0,0,512,5,10721660623
4081,16872521,22694850,39567371,0,0,0,57856,5,7430455539
4082,16872560,22831184,39703744,3,0,0,57856,12,8435969884
4083,16876329,41943034,58819363,8,0,1,15360,13,9505261505
4084,16878850,22801578,39680428,2,0,0,7680,15,4784596654
4085,16882530,41943065,58825595,3,0,1,9728,12,5707358661
4086,16883020,22798375,39681395,4,0,0,3072,4,6378810522
4087,16883050,22737434,39620484,4,0,0,1536,4,3994962791
4088,16886700,22550341,39437041,6,0,0,40448,5,4887927147
4089,16894640,22749968,39644608,5,0,0,25088,8,7664521580
4090,16899090,22909571,39808661,6,0,0,512,5,6548304535
4091,16903450,22865556,39769006,1,0,0,13824,14,8114685798
4092,16906130,22823299,39729429,2,0,0,14336,15,8990975267
4093,16908290,22683954,39592244,1,0,0,3072,14,4034870154
4094,16920820,22814620,39735440,5,0,0,15360,8,5255125674
4095,16922120,41907879,58829999,4,0,1,11264,4,6861058814
4096,16930440,22813603,39744043,5,0,0,28160,8,295906749
4097,16933410,42109366,59042776,2,0,1,27136,15,6759162155
4098,16933810,22680248,39614058,4,0,0,12800,4,6115819072
4099,16945120,22802009,39747129,1,0,0,4096,14,2381591254
4100,16951370,22831380,39782750,1,0,0,8192,14,2605112750
4101,16951580,42112949,59064529,2,0,1,512,15,8255060937
4102,16962650,22881871,39844521,4,0,0,39424,4,8878988678
4103,16964030,22670243,39634273,3,0,0,17408,12,10499076316
4104,16964720,22705287,39670007,2,0,0,10240,15,9796895497
4105,16973120,42116758,59089878,0,0,1,14848,5,725703633
4106,16974410,22703655,39678065,6,0,0,22528,5,4401918272
4107,16984870,22740168,39725038,5,0,0,5632,8,9387650193
4108,16990690,22867108,39857798,5,0,0,13312,8,3697308877
4109,16991510,23016694,40008204,4,0,0,9728,4,659014996
4110,16997230,22810987,39808217,3,0,0,4096,12,5846553485
4111,17003240,22798627,39801867,2,0,0,20480,15,1721129439
4112,17010210,22899375,39909585,7,0,0,13312,8,9185002469
4113,17018920,22813566,39832486,6,0,0,33792,5,6623977932
4114,17023110,42066791,59089901,0,0,1,1536,5,10719664614
4115,17028200,22872915,39901115,9,0,0,55808,19,7718078004
4116,17033419,42056505,59089924,1,0,1,11776,14,9105487475
4117,17038330,23018406,40056736,9,0,0,13824,19,8779242888
4118,17042180,22868988,39911168,2,0,0,5120,15,6341664843
4119,17055380,42034567,59089947,9,0,1,1024,19,1253091373
4120,17055430,22880361,39935791,6,0,0,15872,5,2061753957
4121,17061771,22864614,39926385,0,0,0,11776,5,8191761572
4122,17062740,23331775,40394515,4,0,0,16384,4,10340203967
4123,17064940,42025245,59090185,4,0,1,512,4,7145781871
4124,17066660,22838846,39905506,5,0,0,14336,8,9766414099
4125,17067080,42190021,59257101,4,0,1,27136,4,4822246225
4126,17069890,22913759,39983649,3,0,0,38400,12,4915592347
4127,17079410,23042208,40121618,9,0,0,69120,19,1376151513
4128,17082061,42182123,59264184,5,0,1,7680,8,1446117559
4129,17085550,42275886,59361436,6,0,1,9728,5,10321753200
4130,17087390,23440714,40528104,9,0,0,39424,19,4386923207
4131,17089009,42328694,59417703,1,0,1,21504,14,3310270910
4132,17092070,23058055,40150125,7,0,0,28160,8,2760631994
4133,17099680,22977772,40077452,4,0,0,8704,4,7377977086
4134,17106870,22913624,40020494,2,0,0,5632,15,63350249
4135,17107540,23030169,40137709,2,0,0,52736,15,9404817243
4136,17114931,42318074,59433005,5,0,1,5120,8,7361373810
4137,17117780,22866672,39984452,2,0,0,2560,15,3535193063
4138,17118261,23020563,40138824,0,0,0,3584,5,5203177971
4139,17118420,42405998,59524418,9,0,1,8192,19,8149681394
4140,17120340,42404101,59524441,4,0,1,2048,4,4509243750
4141,17128800,23010827,40139627,5,0,0,2560,8,2942111498
4142,17129780,23092877,40222657,9,0,0,7168,19,1945460319
4143,17133260,42391204,59524464,9,0,1,14848,19,10707043256
4144,17157740,22983782,40141522,1,0,0,6144,14,5047416165
4145,17158061,23033247,40191308,0,0,0,16384,5,10124189774
4146,17158480,23043028,40201508,7,0,0,32768,8,6236117802
4147,17160400,23088304,40248704,7,0,0,38400,8,46874757
4148,17166971,23019322,40186293,0,0,0,34816,5,6682492135
4149,17170900,23041078,40211978,9,0,0,6144,19,4897901514
4150,17177550,23198208,40375758,3,0,0,19456,12,4850728407
4151,17191431,22971946,40163377,0,0,0,7680,5,1496253332
4152,17193840,42337534,59531374,6,0,1,18944,5,3491633385
4153,17201470,42453856,59655326,9,0,1,26112,19,1536027632
4154,17206420,23183080,40389500,2,0,0,44544,15,3096432417
4155,17220580,23075877,40296457,9,0,0,7680,19,9090669825
4156,17220770,23266999,40487769,7,0,0,45568,8,6977957594
4157,17235370,42419979,59655349,0,0,1,512,5,2921119907
4158,17237261,23085708,40322969,0,0,0,9728,5,8094758461
4159,17251099,42404273,59655372,8,0,1,1536,13,2194414736
4160,17255240,23149126,40404366,8,0,0,27648,13,6310345908
4161,17263360,23348317,40611677,3,0,0,22528,12,1403004634
4162,17269190,23164045,40433235,7,0,0,18432,8,43730094
4163,17269330,23158266,40427596,1,0,0,20992,14,1221974896
4164,17271090,23422669,40693759,6,0,0,16384,5,6150817273
4165,17271121,42384274,59655395,5,0,1,512,8,3428453137
4166,17271420,23399361,40670781,4,0,0,20480,4,2182885848
4167,17282500,23544521,40827021,1,0,0,15360,14,10554014699
4168,17288170,23050258,40338428,5,0,0,28160,8,1541750798
4169,17297120,23114106,40411226,9,0,0,18944,19,8679644214
4170,17303190,23385554,40688744,1,0,0,58880,14,2386677499
4171,17305290,23299500,40604790,1,0,0,60416,14,7697941317
4172,17306420,23732394,41038814,2,0,0,43520,15,7599519226
4173,17307410,23482081,40789491,1,0,0,12800,14,8075491814
4174,17309819,42345599,59655418,1,0,1,16384,14,4595231796
4175,17316520,23406360,40722880,3,0,0,26624,12,173860395
4176,17325930,23937788,41263718,2,0,0,12800,15,6811258344
4177,17330760,42351337,59682097,9,0,1,2560,19,5664672520
4178,17335700,23486618,40822318,6,0,0,70144,5,8354494622
4179,17339360,23820003,41159363,5,0,0,58880,8,3562992669
4180,17344430,23656374,41000804,4,0,0,35840,4,6684946123
4181,17350260,23301468,40651728,5,0,0,6656,8,2461322092
4182,17350720,23626175,40976895,1,0,0,7680,14,2571469930
4183,17355380,23372827,40728207,8,0,0,17408,13,4039186829
4184,17358961,42324007,59682968,5,0,1,12288,8,313908191
4185,17360860,23424708,40785568,2,0,0,13824,15,7732530533
4186,17364840,23641455,41006295,8,0,0,17920,13,9278323957
4187,17373489,42337775,59711264,1,0,1,6656,14,4130610277
4188,17376830,42396960,59773790,3,0,1,9216,12,8942614353
4189,17387840,23386955,40774795,1,0,0,18432,14,5806920493
4190,17389340,23486750,40876090,4,0,0,8704,4,1085408503
4191,17389820,23858739,41248559,1,0,0,1536,14,7650308617
4192,17401870,42371943,59773813,3,0,1,5120,12,5763623056
4193,17402231,23915589,41317820,0,0,0,45056,5,3052579376
4194,17402260,23640945,41043205,4,0,0,14336,4,3557271662
4195,17404730,23658419,41063149,2,0,0,17920,15,5145707679
4196,17405520,23673523,41079043,6,0,0,28160,5,1010215040
4197,17408010,23995126,41403136,7,0,0,17920,8,4982379187
4198,17408300,24146674,41554974,5,0,0,111616,8,9851958170
4199,17415330,23603787,41019117,1,0,0,29184,14,5560973359
4200,17420150,23743025,41163175,3,0,0,4608,12,66100613
4201,17422710,42351126,59773836,9,0,1,1024,19,7431352340
4202,17430220,23908529,41338749,9,0,0,32768,19,6820102558
4203,17432350,23991427,41423777,7,0,0,35840,8,5917801292
4204,17435270,23911647,41346917,3,0,0,5632,12,6551924242
4205,17446040,23858029,41304069,6,0,0,34816,5,1859764206
4206,17455800,23884064,41339864,2,0,0,3584,15,2319886564
4207,17459400,24181181,41640581,2,0,0,52736,15,9275782277
4208,17462161,23755917,41218078,0,0,0,3072,5,9417089568
4209,17463070,24021905,41484975,6,0,0,53248,5,4694966443
4210,17464299,42309560,59773859,8,0,1,6656,13,6876024054
4211,17479690,23883774,41363464,7,0,0,8704,8,1393210291
4212,17481501,24905880,42387381,0,0,0,2560,5,7491989439
4213,17483929,42289953,59773882,1,0,1,1536,14,6644947634
4214,17484270,42289635,59773905,6,0,1,10240,5,9796384003
4215,17490940,24000610,41491550,4,0,0,21504,4,10395186038
4216,17492720,24174884,41667604,2,0,0,28160,15,2014599509
4217,17494740,24012167,41506907,3,0,0,50176,12,5121167334
4218,17497290,42309311,59806601,4,0,1,1024,4,2996097994
4219,17508920,24055107,41564027,2,0,0,11776,15,8224975639
4220,17515480,42375991,59891471,4,0,1,20992,4,1576433897
4221,17520471,42371154,59891625,5,0,1,8704,8,2463926312
4222,17525500,23992864,41518364,5,0,0,14848,8,1507328979
4223,17526950,23879641,41406591,6,0,0,11264,5,9096862326
4224,17528910,23764528,41293438,6,0,0,25600,5,5707803750
4225,17530890,23865099,41395989,4,0,0,6656,4,9466418345
4226,17541960,23894320,41436280,8,0,0,40960,13,7784860427
4227,17557661,23956156,41513817,0,0,0,22528,5,2148175129
4228,17564189,42408247,59972436,1,0,1,21504,14,5447105384
4229,17565990,23778265,41344255,1,0,0,14336,14,4836270421
4230,17578040,42396798,59974838,6,0,1,14336,5,8154373519
4231,17585320,24073681,41659001,8,0,0,37376,13,3597056903
4232,17586289,42388895,59975184,8,0,1,512,13,1914327367
4233,17586550,24129559,41716109,6,0,0,27648,5,32587823
4234,17589430,23735158,41324588,3,0,0,14848,12,6137424885
4235,17595190,23973423,41568613,6,0,0,14848,5,6942871612
4236,17595371,23983920,41579291,0,0,0,13824,5,5769613244
4237,17597580,23921627,41519207,6,0,0,2560,5,1263716590
4238,17599050,23961320,41560370,6,0,0,17408,5,1451461428
4239,17600540,23985170,41585710,1,0,0,20992,14,918720452
4240,17602980,42436268,60039248,9,0,1,17920,19,503025038
4241,17603630,23783627,41387257,4,0,0,2560,4,293538956
4242,17604091,24140710,41744801,0,0,0,9216,5,9688924847
4243,17609830,24107573,41717403,6,0,0,4096,5,5076759827
4244,17615180,42503578,60118758,9,0,1,5120,19,3467528130
4245,17616331,42556225,60172556,5,0,1,7680,8,3040861333
4246,17621530,24743740,42365270,4,0,0,9216,4,3928887283
4247,17622570,24211176,41833746,3,0,0,7168,12,184625942
4248,17632650,42629298,60261948,9,0,1,14848,19,5028631885
4249,17633630,24286738,41920368,4,0,0,60928,4,8054244324
4250,17635210,24840105,42475315,5,0,0,40448,8,4851892948
4251,17636740,24175838,41812578,1,0,0,10752,14,4455875136
4252,17638620,24482695,42121315,1,0,0,19968,14,9582486255
4253,17645540,42793914,60439454,4,0,1,55296,4,3947742940
4254,17646430,24300672,41947102,1,0,0,17408,14,6586256389
4255,17647220,24791430,42438650,6,0,0,102400,5,8745533066
4256,17656360,24598876,42255236,7,0,0,24064,8,9608710866
4257,17658409,42781068,60439477,8,0,1,10752,13,2803367306
4258,17659530,23803761,41463291,6,0,0,4608,5,1302028464
4259,17661150,44791265,62452415,4,0,1,581120,4,10411442199
4260,17661520,44826627,62488147,9,0,1,2560,19,9531790481
4261,17666919,44822854,62489773,8,0,1,2560,13,8956517058
4262,17670970,24364829,42035799,5,0,0,13824,8,10067823336
4263,17673030,24817627,42490657,8,0,0,40960,13,5142893602
4264,17676560,24024891,41701451,7,0,0,9216,8,3832336039
4265,17678250,24855270,42533520,7,0,0,5632,8,6041573312
4266,17687690,24818519,42506209,8,0,0,512,13,136477038
4267,17694560,24806580,42501140,2,0,0,34304,15,7169244577
4268,17694900,24671485,42366385,3,0,0,3584,12,9888852254
4269,17697470,24447300,42144770,4,0,0,14848,4,8722474461
4270,17712370,44777749,62490119,0,0,1,512,5,8266982184
4271,17714320,24763834,42478154,2,0,0,9216,15,1850694070
4272,17714781,24068138,41782919,0,0,0,18944,5,149519477
4273,17721119,44802172,62523291,1,0,1,13312,14,3310928659
4274,17732070,24290704,42022774,9,0,0,33792,19,6511174400
4275,17737550,25053479,42791029,9,0,0,71168,19,5307156029
4276,17738330,24933431,42671761,1,0,0,10240,14,9874736325
4277,17747610,44795476,62543086,4,0,1,18432,4,10556504397
4278,17748050,24293700,42041750,9,0,0,19456,19,3298450323
4279,17749850,24236139,41985989,5,0,0,13824,8,2580069479
4280,17750790,24259302,42010092,1,0,0,58880,14,5675801937
4281,17751200,24280364,42031564,1,0,0,28672,14,5018304275
4282,17756860,24746183,42503043,7,0,0,6144,8,977814099
4283,17758770,24393992,42152762,7,0,0,15872,8,2096048069
4284,17775110,24445694,42220804,9,0,0,25088,19,4671994657
4285,17794960,24452921,42247881,1,0,0,38400,14,7090396886
4286,17800310,24314336,42114646,4,0,0,17920,4,8753749640
4287,17802210,24841657,42643867,2,0,0,6656,15,3404776253
4288,17803440,45078891,62882331,4,0,1,171008,4,946034585
4289,17819041,45063956,62882997,5,0,1,1024,8,3286866860
4290,17829280,24633688,42462968,9,0,0,13824,19,3694642152
4291,17829530,24624477,42454007,1,0,0,1024,14,443169526
4292,17838210,24811608,42649818,9,0,0,19456,19,2493275733
4293,17846831,45153866,63000697,5,0,1,32256,8,3008078598
4294,17850940,24409646,42260586,8,0,0,6144,13,865552472
4295,17858761,24119999,41978760,0,0,0,3072,5,9065717777
4296,17861390,24441237,42302627,9,0,0,71680,19,1773947178
4297,17863630,24642400,42506030,5,0,0,9728,8,3840722860
4298,17866720,24145735,42012455,4,0,0,7680,4,2531843151
4299,17874830,24113522,41988352,8,0,0,7680,13,679008424
4300,17876550,24858306,42734856,9,0,0,11776,19,8496061089
4301,17876920,24862849,42739769,5,0,0,8192,8,4628075745
4302,17883681,24834242,42717923,0,0,0,24576,5,7499299146
4303,17887310,24720033,42607343,5,0,0,28160,8,8129955445
4304,17887680,24690722,42578402,1,0,0,5120,14,5363562712
4305,17888880,24785085,42673965,3,0,0,3072,12,1194049307
4306,17890360,24153441,42043801,7,0,0,6656,8,1561299826
4307,17892190,24494388,42386578,7,0,0,37376,8,9117272463
4308,17896680,24949826,42846506,6,0,0,26624,5,3982281148
4309,17902060,45098684,63000744,6,0,1,11264,5,8425340744
4310,17902070,24988667,42890737,9,0,0,17920,19,717188273
4311,17903351,45097416,63000767,5,0,1,2048,8,8709727
4312,17903770,24762953,42666723,3,0,0,44544,12,8998232807
4313,17912201,24726717,42638918,0,0,0,16384,5,2781993214
4314,17919720,24442719,42362439,8,0,0,90624,13,5793034731
4315,17920870,24475057,42395927,1,0,0,22528,14,6511187375
4316,17924010,24835773,42759783,8,0,0,2048,13,2113388190
4317,17925170,24762273,42687443,9,0,0,22016,19,9379633594
4318,17928250,25080002,43008252,3,0,0,8704,12,9679348369
4319,17939250,24518680,42457930,3,0,0,12800,12,7294823113
4320,17940960,24657780,42598740,5,0,0,58368,8,3808015775
4321,17947770,24427397,42375167,1,0,0,25088,14,5272617980
4322,17949220,45051570,63000790,9,0,1,2048,19,1601938857
4323,17951161,24818161,42769322,0,0,0,31232,5,4408747043
4324,17951249,45049564,63000813,1,0,1,8704,14,8068030111
4325,17951340,25184442,43135782,4,0,0,27648,4,476957351
4326,17955589,45139774,63095363,1,0,1,3584,14,86094646
4327,17964200,24854175,42818375,6,0,0,39424,5,6171306330
4328,17965790,25029555,42995345,6,0,0,96768,5,4071167619
4329,17966530,24792606,42759136,1,0,0,63488,14,1054825226
4330,17967810,24944633,42912443,8,0,0,2048,13,5895922875
4331,17969400,24761845,42731245,9,0,0,43520,19,494360856
4332,17969511,24861904,42831415,0,0,0,7168,5,1322907658
4333,17980041,24473608,42453649,0,0,0,49152,5,2663994655
4334,17984151,45111235,63095386,5,0,1,1024,8,9902499588
4335,17986920,24340652,42327572,1,0,0,6144,14,468121090
4336,17992420,24266271,42258691,9,0,0,11264,19,186487754
4337,17998559,45096850,63095409,1,0,1,17408,14,1458533463
4338,18006770,25120565,43127335,1,0,0,5120,14,8803412792
4339,18008820,24797520,42806340,5,0,0,50176,8,7957668522
4340,18014270,24722980,42737250,9,0,0,2560,19,806171556
4341,18016110,45098494,63114604,9,0,1,512,19,1864906570
4342,18029810,24881301,42911111,8,0,0,12800,13,2177916583
4343,18031771,24426962,42458733,0,0,0,2560,5,9908248531
4344,18032801,24595884,42628685,0,0,0,11776,5,5196928392
4345,18033320,24972257,43005577,1,0,0,12800,14,8662822325
4346,18033650,24575120,42608770,9,0,0,4608,19,9480954005
4347,18040380,24924031,42964411,5,0,0,71168,8,840047658
4348,18043720,24323780,42367500,1,0,0,3584,14,6531982914
4349,18046580,24855287,42901867,8,0,0,32256,13,6265610807
4350,18052240,24786108,42838348,4,0,0,2560,4,4059757634
4351,18058500,25206847,43265347,6,0,0,15872,5,178276181
4352,18064220,24608032,42672252,2,0,0,1536,15,3539244488
4353,18069040,24999909,43068949,7,0,0,10752,8,9619571147
4354,18073394,24636972,42710366,4,0,0,28160,4,7241412603
4355,18074760,45049777,63124537,3,0,1,16384,12,2865485620
4356,18075709,45079962,63155671,8,0,1,5120,13,2736333119
4357,18077661,45129424,63207085,5,0,1,1024,8,8288211827
4358,18078060,24751148,42829208,8,0,0,17408,13,5433473437
4359,18083590,24882248,42965838,7,0,0,4608,8,10089291586
4360,18091640,24732241,42823881,7,0,0,14336,8,1378799998
4361,18096230,24446232,42542462,2,0,0,17408,15,8563011053
4362,18098460,24840203,42938663,9,0,0,19968,19,7133306498
4363,18104310,24632129,42736439,7,0,0,5120,8,7450852649
4364,18105229,45101879,63207108,1,0,1,3072,14,5026727837
4365,18107950,24944247,43052197,5,0,0,41472,8,5426967166
4366,18108030,24978832,43086862,6,0,0,11776,5,3992708695
4367,18108620,24757196,42865816,3,0,0,3072,12,10340257023
4368,18110610,25300996,43411606,1,0,0,99840,14,8819473070
4369,18114740,25011012,43125752,7,0,0,61440,8,8578094390
4370,18115680,24721842,42837522,4,0,0,19968,4,3546086516
4371,18123160,24545458,42668618,9,0,0,6144,19,3695515522
4372,18123681,24877973,43001654,0,0,0,12800,5,9007703127
4373,18125720,24893438,43019158,2,0,0,27136,15,2776009932
4374,18128240,24691250,42819490,1,0,0,3584,14,6174087798
4375,18130490,24542253,42672743,1,0,0,1536,14,8292536368
4376,18137339,45069792,63207131,1,0,1,10240,14,4452050849
4377,18138700,25062636,43201336,1,0,0,512,14,8100684783
4378,18138890,25333195,43472085,6,0,0,24576,5,3747896338
4379,18139700,25088159,43227859,1,0,0,22016,14,3104212679
4380,18139881,45067338,63207219,5,0,1,1536,8,6453706970
4381,18144640,45072827,63217467,3,0,1,5120,12,7639101803
4382,18146150,25212925,43359075,3,0,0,24064,12,3916907220
4383,18160340,25085037,43245377,1,0,0,53760,14,4013286983
4384,18160950,24835822,42996772,1,0,0,4608,14,296004740
4385,18161350,24901692,43063042,4,0,0,9216,4,9203021923
4386,18170151,45153094,63323245,5,0,1,4096,8,1071230732
4387,18172830,45152156,63324986,9,0,1,24576,19,9095395966
4388,18173229,45387493,63560722,1,0,1,16896,14,6505398077
4389,18177580,25082484,43260064,8,0,0,48128,13,10525084247
4390,18182590,25018567,43201157,4,0,0,33792,4,1431792824
4391,18182680,25334481,43517161,7,0,0,14336,8,8542350301
4392,18188600,45374279,63562879,2,0,1,4608,15,185789076
4393,18194710,24912299,43107009,2,0,0,66048,15,1772400097
4394,18195550,25232365,43427915,5,0,0,19968,8,7160548415
4395,18195630,25384565,43580195,2,0,0,12288,15,1207839538
4396,18200620,25429953,43630573,8,0,0,59904,13,5311471186
4397,18203960,25237893,43441853,7,0,0,19968,8,5212741277
4398,18205290,45391762,63597052,3,0,1,19968,12,3269575137
4399,18207330,25211787,43419117,7,0,0,24576,8,9651295205
4400,18214390,25096538,43310928,2,0,0,4096,15,2595808517
4401,18218810,25216636,43435446,6,0,0,18432,5,492459019
4402,18219460,25418468,43637928,8,0,0,24064,13,7973829140
4403,18219540,25009434,43228974,4,0,0,3584,4,6950693395
4404,18219810,25046808,43266618,5,0,0,4096,8,3467573094
4405,18230330,25498538,43728868,5,0,0,30720,8,7239923264
4406,18236540,25826421,44062961,5,0,0,40448,8,5934466333
4407,18238540,45369923,63608463,0,0,1,2048,5,5735064776
4408,18239340,25399547,43638887,9,0,0,3072,19,6086900547
4409,18243470,24754261,42997731,5,0,0,3072,8,2492319799
4410,18246380,45362851,63609231,4,0,1,11776,4,5045015204
4411,18250200,25233189,43483389,3,0,0,11264,12,6374309678
4412,18255190,25459436,43714626,6,0,0,37376,5,2646673783
4413,18255370,25096350,43351720,9,0,0,66048,19,6518222863
4414,18259080,45417240,63676320,0,0,1,4608,5,7601008968
4415,18259900,24884485,43144385,1,0,0,28160,14,3767332007
4416,18261280,45520479,63781759,2,0,1,5120,15,2042014546
4417,18278129,45541965,63820094,1,0,1,8704,14,3155825280
4418,18291170,24772675,43063845,8,0,0,2560,13,8219235885
4419,18294450,45560889,63855339,2,0,1,3584,15,8163174246
4420,18298860,25346914,43645774,1,0,0,22528,14,5482187578
4421,18301260,25247301,43548561,3,0,0,15360,12,10502825986
4422,18304301,24990473,43294774,0,0,0,9728,5,1652085481
4423,18305431,25058659,43364090,0,0,0,16384,5,5956800550
4424,18309150,25189261,43498411,9,0,0,38912,19,9300820375
4425,18309850,24980985,43290835,3,0,0,13824,12,4157435688
4426,18318350,24961010,43279360,8,0,0,30208,13,5886748026
4427,18320730,25199923,43520653,5,0,0,5632,8,8921322488
4428,18322860,25454388,43777248,8,0,0,17920,13,5731849846
4429,18322980,25276846,43599826,8,0,0,19968,13,7935025509
4430,18323530,25679352,44002882,4,0,0,36864,4,10407922024
4431,18326781,25614757,43941538,0,0,0,20992,5,4537358972
4432,18327370,25424627,43751997,3,0,0,24576,12,3401454847
4433,18327960,25591043,43919003,1,0,0,7680,14,9706129212
4434,18329590,25535160,43864750,1,0,0,30208,14,140428330
4435,18336150,25107754,43443904,2,0,0,6656,15,3213542210
4436,18340920,45523246,63864166,9,0,1,1536,19,2434357138
4437,18345230,25880668,44225898,1,0,0,7680,14,934976323
4438,18356920,25676548,44033468,5,0,0,22016,8,675338423
4439,18359100,24663357,43022457,1,0,0,10752,14,6613569982
4440,18360610,25519255,43879865,2,0,0,21504,15,9973844536
4441,18360930,25215498,43576428,5,0,0,51712,8,7905927200
4442,18364540,45500906,63865446,2,0,1,14336,15,9510869804
4443,18365970,25004071,43370041,5,0,0,19456,8,3059164041
4444,18366650,25135216,43501866,5,0,0,11264,8,9032463648
4445,18372919,45520815,63893734,1,0,1,4608,14,2947870958
4446,18373400,45522920,63896320,2,0,1,4096,15,5018499521
4447,18381180,25457238,43838418,4,0,0,34816,4,424811962
4448,18382200,25039592,43421792,8,0,0,8704,13,10570455821
4449,18385790,26222389,44608179,7,0,0,40448,8,7983831627
4450,18389790,25685407,44075197,2,0,0,4096,15,6989093847
4451,18391190,25983023,44374213,3,0,0,23040,12,10390548558
4452,18392591,24908281,43300872,0,0,0,1536,5,9084540542
4453,18397120,26072476,44469596,5,0,0,15360,8,6776305239
4454,18400700,24980463,43381163,5,0,0,15360,8,3373273268
4455,18402191,25532928,43935119,0,0,0,5120,5,7940882243
4456,18403040,25268509,43671549,6,0,0,61952,5,4237019091
4457,18403860,25501402,43905262,2,0,0,22016,15,3657838160
4458,18412260,25290955,43703215,8,0,0,49152,13,551548853
4459,18423160,25759348,44182508,7,0,0,71680,8,2164395386
4460,18424680,45472306,63896986,4,0,1,1024,4,5672889761
4461,18432650,45508037,63940687,0,0,1,23040,5,1919979700
4462,18435310,26177127,44612437,6,0,0,5120,5,9276135551
4463,18437160,26374345,44811505,1,0,0,89600,14,7109043614
4464,18439600,25552027,43991627,2,0,0,34304,15,9446913597
4465,18442920,25873360,44316280,5,0,0,30208,8,197103984
4466,18445340,25041192,43486532,3,0,0,10240,12,1063052556
4467,18447470,26669819,45117289,6,0,0,44544,5,2387280898
4468,18448010,24928450,43376460,1,0,0,20992,14,247580131
4469,18458640,25649518,44108158,6,0,0,5120,5,10647202929
4470,18461540,25318990,43780530,4,0,0,6144,4,4184828629
4471,18462510,25147236,43609746,5,0,0,8704,8,9412208508
4472,18470670,25716073,44186743,7,0,0,13824,8,3908761626
4473,18473880,26782431,45256311,8,0,0,114176,13,8886424341
4474,18477700,25999379,44477079,9,0,0,20992,19,5215314800
4475,18482190,25237295,43719485,2,0,0,15872,15,8573350586
4476,18482810,25644237,44127047,4,0,0,28672,4,6606305745
4477,18490770,25434280,43925050,9,0,0,19456,19,149408783
4478,18497660,25967233,44464893,5,0,0,44544,8,8701811431
4479,18498630,45445923,63944553,2,0,1,6144,15,2876735246
4480,18501330,45444209,63945539,3,0,1,1536,12,880336085
4481,18502240,45443645,63945885,0,0,1,512,5,964802597
4482,18507500,26052686,44560186,7,0,0,4096,8,2669505118
4483,18510000,25996647,44506647,4,0,0,64512,4,7311466044
4484,18514190,26856870,45371060,7,0,0,43008,8,6227907099
4485,18522400,25796399,44318799,2,0,0,8192,15,192090999
4486,18527230,25722350,44249580,5,0,0,41472,8,5321273042
4487,18536600,45409746,63946346,9,0,1,10240,19,5588718972
4488,18537030,25411239,43948269,4,0,0,22016,4,7611704729
4489,18544410,26918241,45462651,5,0,0,12800,8,3437202472
4490,18546090,25669934,44216024,5,0,0,68096,8,7835980126
4491,18547680,26127833,44675513,3,0,0,12288,12,7098039166
4492,18554590,26030202,44584792,7,0,0,3072,8,10585837142
4493,18555300,25721445,44276745,7,0,0,1024,8,1603554045
4494,18555509,45404937,63960446,8,0,1,15360,13,812509015
4495,18559040,45416369,63975409,0,0,1,1536,5,6725273273
4496,18561420,25729199,44290619,5,0,0,5120,8,1209741882
4497,18567530,25338067,43905597,4,0,0,1024,4,3717479118
4498,18579030,45431917,64010947,6,0,1,10752,5,7885008783
4499,18579519,45431451,64010970,8,0,1,10752,13,7394011519
4500,18587880,45438785,64026665,2,0,1,5120,15,1416676370
4501,18597100,25818173,44415273,8,0,0,4096,13,2903723431
4502,18602240,26120108,44722348,6,0,0,48128,5,4062642422
4503,18605870,25439537,44045407,4,0,0,13312,4,5347942331
4504,18606510,25700543,44307053,1,0,0,47616,14,5475924034
4505,18613820,26162516,44776336,6,0,0,83968,5,10540255492
4506,18615380,25522766,44138146,5,0,0,36352,8,2047346185
4507,18619340,25310701,43930041,7,0,0,2560,8,9496623076
4508,18622610,25920793,44543403,2,0,0,35328,15,7634876829
4509,18624930,45439478,64064408,4,0,1,6656,4,7876453042
4510,18627000,45437562,64064562,2,0,1,8704,15,10561871776
4511,18630930,25700795,44331725,4,0,0,17920,4,453762597
4512,18637850,45521828,64159678,6,0,1,2048,5,8214335389
4513,18637951,45521766,64159717,5,0,1,8192,8,8004470671
4514,18638340,25954511,44592851,6,0,0,14336,5,2411191193
4515,18646340,25391675,44038015,9,0,0,14848,19,10423573990
4516,18646960,25576575,44223535,7,0,0,24576,8,4300859782
4517,18648340,26169592,44817932,5,0,0,20992,8,10042529382
4518,18652330,25772867,44425197,1,0,0,3072,14,7820572269
4519,18652800,25446375,44099175,4,0,0,2048,4,1357406502
4520,18657280,45502460,64159740,3,0,1,512,12,7404073814
4521,18661550,27118728,45780278,9,0,0,21504,19,1056435028
4522,18662720,25402325,44065045,2,0,0,1024,15,4631779775
4523,18666759,45493004,64159763,1,0,1,1024,14,3526203996
4524,18668660,45491126,64159786,2,0,1,3072,15,4986701078
4525,18679150,25597081,44276231,8,0,0,48640,13,9930614785
4526,18691420,25584990,44276410,1,0,0,512,14,2592573942
4527,18691830,25593269,44285099,9,0,0,7168,19,3868560964
4528,18693370,26236951,44930321,8,0,0,22528,13,2999336342
4529,18697259,45462550,64159809,8,0,1,11776,13,8371949039
4530,18703179,45474919,64178098,8,0,1,8192,13,1145456452
4531,18706920,45471524,64178444,9,0,1,512,19,5360540672
4532,18721090,45458340,64179430,3,0,1,1536,12,4418632206
4533,18723220,26060962,44784182,5,0,0,25600,8,7902703950
4534,18727540,25625389,44352929,2,0,0,36864,15,4909461887
4535,18735360,45444326,64179686,2,0,1,9216,15,3327988965
4536,18736240,45495095,64231335,0,0,1,14848,5,94036898
4537,18736570,25817723,44554293,7,0,0,20992,8,8229125665
4538,18738339,45519793,64258132,8,0,1,4096,13,8737379475
4539,18746651,25768443,44515094,0,0,0,27648,5,7735127504
4540,18750490,25909842,44660332,1,0,0,29184,14,4098163019
4541,18753280,45506158,64259438,4,0,1,2048,4,6847209598
4542,18756150,45505874,64262024,9,0,1,4096,19,6354378110
4543,18763160,26058094,44821254,5,0,0,10240,8,4051843136
4544,18765190,26177368,44942558,2,0,0,36352,15,8905333029
4545,18766000,25763825,44529825,5,0,0,11264,8,5978651443
4546,18779050,25971671,44750721,1,0,0,46592,14,6122920890
4547,18783560,25918399,44701959,4,0,0,25600,4,5476977720
4548,18788460,45476470,64264930,0,0,1,4608,5,68343024
4549,18790520,26027591,44818111,9,0,0,512,19,1774929585
4550,18802100,25619679,44421779,7,0,0,4608,8,1223888768
4551,18805360,26266573,45071933,8,0,0,22528,13,5095604077
4552,18806590,26698428,45505018,5,0,0,69120,8,9897317656
4553,18807330,26138527,44945857,7,0,0,10752,8,9895447321
4554,18810260,26099179,44909439,9,0,0,15872,19,5836911781
4555,18814820,26277428,45092248,5,0,0,22528,8,244532329
4556,18815650,25632305,44447955,7,0,0,1024,8,929305706
4557,18815860,25704584,44520444,9,0,0,5632,19,9092129663
4558,18817590,25764753,44582343,2,0,0,52224,15,5006289321
4559,18823929,45444547,64268476,1,0,1,5632,14,9643548691
4560,18832440,25778414,44610854,6,0,0,8704,5,4006178513
4561,18836440,45438588,64275028,0,0,1,5120,5,2597183143
4562,18853010,26078114,44931124,7,0,0,2560,8,10190650194
4563,18858110,25561676,44419786,4,0,0,3584,4,3898354891
4564,18858501,25988868,44847369,0,0,0,11264,5,7281350563
4565,18863210,25655495,44518705,6,0,0,11776,5,570837048
4566,18868010,26528657,45396667,2,0,0,83968,15,4264440686
4567,18872440,25480668,44353108,5,0,0,512,8,7497913129
4568,18876020,26253959,45129979,8,0,0,13824,13,5594090776
4569,18878480,45530670,64409150,2,0,1,20480,15,4103334323
4570,18882061,45574016,64456077,7,0,1,4096,8,8069932332
4571,18885241,26269592,45154833,0,0,0,512,5,6321410946
4572,18898190,25793864,44692054,8,0,0,6144,13,8165823600
4573,18901320,26022114,44923434,2,0,0,42496,15,4297270693
4574,18903660,25780764,44684424,5,0,0,5120,8,9346818832
4575,18905270,25729035,44634305,8,0,0,3072,13,9154480514
4576,18905960,25990025,44895985,4,0,0,29696,4,9777547698
4577,18926469,45766171,64692640,8,0,1,6144,13,1703863071
4578,18928840,25635529,44564369,7,0,0,10752,8,8605378270
4579,18931220,45764326,64695546,2,0,1,4608,15,7760277883
4580,18932490,26109757,45042247,9,0,0,29696,19,7989781920
4581,18933430,26336343,45269773,2,0,0,35840,15,3652120475
4582,18935540,45781625,64717165,4,0,1,512,4,828201765
4583,18942521,25789054,44731575,0,0,0,30208,5,5394419392
4584,18950240,26640519,45590759,1,0,0,47616,14,669340967
4585,18952250,26151444,45103694,4,0,0,12288,4,5122556861
4586,18952860,26102202,45055062,8,0,0,41984,13,1751609871
4587,18953379,45765412,64718791,1,0,1,2560,14,1019777712
4588,18954290,26499307,45453597,8,0,0,13824,13,6275196776
4589,18958420,45761997,64720417,3,0,1,2560,12,894551408
4590,18960440,26477355,45437795,1,0,0,6656,14,10012410817
4591,18961300,26386938,45348238,4,0,0,52736,4,9414418517
4592,18965460,26446682,45412142,5,0,0,50688,8,9441252980
4593,18970220,26947693,45917913,5,0,0,13312,8,6376557126
4594,18973270,25763232,44736502,7,0,0,12800,8,6093727495
4595,18973290,45786335,64759625,3,0,1,16896,12,5936864742
4596,18974571,45801643,64776214,7,0,1,1536,8,4456036273
4597,18979460,26456284,45435744,1,0,0,62976,14,9764180123
4598,18980330,26050804,45031134,8,0,0,66048,13,1851197368
4599,18982370,26181222,45163592,3,0,0,28672,12,1910459321
4600,18984300,45791937,64776237,3,0,1,5120,12,5225423651
4601,19000570,25986909,44987479,8,0,0,11264,13,2023724493
4602,19006080,25898500,44904580,7,0,0,4608,8,2626424171
4603,19007700,25940285,44947985,4,0,0,5632,4,983192609
4604,19012150,25919309,44931459,8,0,0,1024,13,8112540144
4605,19012980,25867137,44880117,6,0,0,24064,5,8504269039
4606,19025830,25920362,44946192,1,0,0,1024,14,1439805040
4607,19038700,26725730,45764430,9,0,0,66048,19,5924764114
4608,19039761,26094929,45134690,0,0,0,15360,5,8121692172
4609,19041060,26567818,45608878,9,0,0,59392,19,1808407404
4610,19054790,26361743,45416533,7,0,0,14336,8,26362180
4611,19056180,26142190,45198370,5,0,0,6144,8,5296005367
4612,19056870,26963577,46020447,3,0,0,56320,12,8084083523
4613,19057360,26133580,45190940,6,0,0,5120,5,2547287749
4614,19066230,26059506,45125736,4,0,0,27648,4,4440607841
4615,19066550,26132467,45199017,1,0,0,2048,14,5180217451
4616,19066680,45727231,64793911,4,0,1,8192,4,1379850508
4617,19070690,25994356,45065046,7,0,0,26112,8,5504324576
4618,19072470,26204689,45277159,2,0,0,4608,15,4162304978
4619,19073430,45841303,64914733,0,0,1,4608,5,4170884649
4620,19073890,26670393,45744283,7,0,0,33792,8,9080651050
4621,19075151,26102672,45177823,0,0,0,8192,5,4667454764
4622,19075930,26716406,45792336,5,0,0,512,8,10193083607
4623,19077440,45837639,64915079,9,0,1,512,19,6525110458
4624,19083180,26370908,45454088,5,0,0,1536,8,1166667436
4625,19096529,45819856,64916385,1,0,1,2048,14,5399580941
4626,19098090,26259843,45357933,1,0,0,31744,14,9393306675
4627,19102990,45827331,64930321,2,0,1,6144,15,6466511451
4628,19112930,26419875,45532805,3,0,0,24064,12,1759603392
4629,19117190,26141640,45258830,2,0,0,8192,15,9962952548
4630,19120860,26774337,45895197,2,0,0,34816,15,6249198257
4631,19124640,26441269,45565909,2,0,0,38400,15,7394446124
4632,19128180,26147544,45275724,9,0,0,19456,19,7180491391
4633,19134300,26158690,45292990,3,0,0,5632,12,4738649209
4634,19140570,26659152,45799722,2,0,0,9216,15,7045817220
4635,19140590,26014064,45154654,3,0,0,24576,12,2169320553
4636,19147200,26387344,45534544,6,0,0,5632,5,3537558096
4637,19149050,26136856,45285906,7,0,0,7680,8,5821303778
4638,19150550,26704037,45854587,3,0,0,14848,12,4982766404
4639,19152210,26297152,45449362,4,0,0,37888,4,9638014392
4640,19163901,45766443,64930344,7,0,1,9216,8,6399562345
4641,19164380,26685660,45850040,6,0,0,59392,5,317569658
4642,19168959,45761408,64930367,8,0,1,512,13,3328145744
4643,19170270,25993813,45164083,9,0,0,1536,19,3774047029
4644,19182400,26591303,45773703,9,0,0,10752,19,2922515693
4645,19198811,26568138,45766949,0,0,0,8192,5,684374938
4646,19204260,26787014,45991274,3,0,0,68096,12,10199785604
4647,19208280,45722225,64930505,3,0,1,15360,12,642751185
4648,19214570,26519394,45733964,4,0,0,149504,4,2633978505
4649,19218150,26851801,46069951,9,0,0,512,19,2782828608
4650,19219630,45778077,64997707,2,0,1,2048,15,6963413570
4651,19226800,26070791,45297591,3,0,0,11264,12,10674067872
4652,19238810,26927207,46166017,8,0,0,2048,13,839246686
4653,19240830,26556053,45796883,6,0,0,14848,5,7326836897
4654,19245010,45752720,64997730,2,0,1,12288,15,9582239197
4655,19253530,26261495,45515025,7,0,0,32768,8,5695142792
4656,19254220,45806106,65060326,4,0,1,11264,4,6567222127
4657,19262070,26210744,45472814,9,0,0,33280,19,784602317
4658,19262530,26350435,45612965,3,0,0,13312,12,4255096221
4659,19264650,26505754,45770404,2,0,0,11264,15,10639257214
4660,19273520,26046212,45319732,9,0,0,1536,19,4162000498
4661,19273761,26251689,45525450,0,0,0,10240,5,2076800759
4662,19295570,45832733,65128303,2,0,1,11776,15,10396388552
4663,19299140,26653474,45952614,1,0,0,5632,14,8599664267
4664,19299390,26647406,45946796,6,0,0,94720,5,7520078037
4665,19301160,26694752,45995912,3,0,0,1536,12,8373491131
4666,19306030,26338870,45644900,6,0,0,23552,5,2815596994
4667,19311301,26480856,45792157,0,0,0,38912,5,2021657414
4668,19311700,26944657,46256357,9,0,0,3584,19,5331563852
4669,19314080,26596907,45910987,4,0,0,24576,4,2945621104
4670,19323611,26252617,45576228,0,0,0,33792,5,10231070201
4671,19327710,26556856,45884566,4,0,0,32768,4,10634655862
4672,19336850,26520603,45857453,6,0,0,8704,5,7035460341
4673,19337150,45793099,65130249,4,0,1,3072,4,5534819032
4674,19341081,26294939,45636020,0,0,0,34304,5,8249997351
4675,19343991,26478789,45822780,0,0,0,15360,5,9041533152
4676,19346770,45810427,65157197,9,0,1,1536,19,7250133601
4677,19351440,26613833,45965273,7,0,0,41472,8,763234563
4678,19357430,27018685,46376115,4,0,0,44544,4,1007455049
4679,19358130,26707251,46065381,3,0,0,6656,12,8387437429
4680,19363300,26309514,45672814,3,0,0,2560,12,2353527159
4681,19370369,45836893,65207262,1,0,1,1536,14,6746357149
4682,19372310,26531166,45903476,9,0,0,21504,19,6502418195
4683,19378120,26490276,45868396,9,0,0,35840,19,7655687431
4684,19386600,26416585,45803185,9,0,0,11264,19,5188398672
4685,19394110,26662481,46056591,5,0,0,33792,8,7795356737
4686,19396811,26836713,46233524,0,0,0,16384,5,9358302214
4687,19397010,26868917,46265927,3,0,0,18432,12,10096415952
4688,19397500,26770412,46167912,5,0,0,6144,8,356308297
4689,19400050,26675130,46075180,5,0,0,9728,8,1402631355
4690,19401650,26621940,46023590,5,0,0,10240,8,7002319507
4691,19402690,26813471,46216161,1,0,0,5120,14,1654042561
4692,19408150,26714038,46122188,6,0,0,75776,5,3573200079
4693,19410870,26920438,46331308,8,0,0,25600,13,1826336915
4694,19418220,45789065,65207285,3,0,1,10240,12,10524313124
4695,19420091,26896754,46316845,0,0,0,41472,5,9727441193
4696,19422470,26603786,46026256,1,0,0,6656,14,3680545155
4697,19426320,26924282,46350602,9,0,0,8192,19,1402033183
4698,19426731,26743388,46170119,0,0,0,7168,5,2953825578
4699,19426989,45780319,65207308,8,0,1,3584,13,6978403245
4700,19430400,26632922,46063322,1,0,0,22016,14,4391330970
4701,19430920,26966021,46396941,3,0,0,9728,12,3658115619
4702,19436870,27042864,46479734,7,0,0,18432,8,1428639022
4703,19439050,26970737,46409787,9,0,0,22016,19,5596309965
4704,19442860,26508015,45950875,8,0,0,13312,13,8855292632
4705,19448180,26677619,46125799,8,0,0,11776,13,6327406055
4706,19449950,26619822,46069772,4,0,0,14336,4,4211300770
4707,19451930,26676232,46128162,4,0,0,7680,4,9171419779
4708,19453530,27217292,46670822,0,0,0,7168,5,6867287600
4709,19455770,45884613,65340383,9,0,1,18432,19,10670510858
4710,19456270,26748010,46204280,7,0,0,11264,8,1330001785
4711,19461710,27183330,46645040,1,0,0,19456,14,9094053701
4712,19467210,46031131,65498341,9,0,1,512,19,9276985498
4713,19472350,46067491,65539841,3,0,1,4096,12,934563674
4714,19474360,26925256,46399616,9,0,0,8704,19,6287412997
4715,19474530,26829633,46304163,8,0,0,60928,13,9570697654
4716,19474760,26794021,46268781,3,0,0,8192,12,5123416414
4717,19477380,26685471,46162851,9,0,0,77824,19,5484174284
4718,19477700,46076071,65553771,3,0,1,3584,12,3845935818
4719,19478660,26686710,46165370,2,0,0,8192,15,5017695415
4720,19478710,26722115,46200825,5,0,0,10240,8,8880276916
4721,19484500,46175958,65660458,0,0,1,27648,5,8921009138
4722,19494160,27205952,46700112,8,0,0,14336,13,5624166889
4723,19502041,46158440,65660481,5,0,1,2048,8,4108671231
4724,19503420,26751822,46255242,6,0,0,48128,5,9498541583
4725,19511801,46185728,65697529,5,0,1,14336,8,10016593196
4726,19512060,46193735,65705795,4,0,1,32256,4,5773718997
4727,19512480,26835375,46347855,4,0,0,43008,4,9196104374
4728,19530940,26735322,46266262,8,0,0,1024,13,9499328994
4729,19533621,26881337,46414958,0,0,0,16896,5,8687049257
4730,19535050,26551565,46086615,3,0,0,2048,12,6692351857
4731,19535200,26599786,46134986,4,0,0,6656,4,7741760515
4732,19537540,26794103,46331643,7,0,0,1024,8,2005580463
4733,19537990,26747393,46285383,7,0,0,5120,8,10730923911
4734,19541800,46279720,65821520,2,0,1,23040,15,8367829844
4735,19544121,26674403,46218524,0,0,0,7680,5,4678649459
4736,19545600,26714680,46260280,7,0,0,12800,8,4541389398
4737,19548640,26883203,46431843,1,0,0,8704,14,1838292475
4738,19553050,46344691,65897741,3,0,1,20992,12,9266934543
4739,19558841,27049155,46607996,0,0,0,13824,5,7574625595
4740,19562311,46336749,65899060,7,0,1,1536,8,9308762154
4741,19565550,26932954,46498504,7,0,0,27648,8,7573618616
4742,19570320,27225800,46796120,2,0,0,24064,15,2791706415
4743,19570940,26848409,46419349,4,0,0,14336,4,8884470932
4744,19572670,27279338,46852008,9,0,0,6656,19,2925394771
4745,19577080,27047898,46624978,4,0,0,33280,4,6891609978
4746,19577750,26979061,46556811,6,0,0,40960,5,3516127369
4747,19579350,26867151,46446501,9,0,0,12288,19,4650135102
4748,19588160,27346955,46935115,1,0,0,4608,14,3623244023
4749,19593820,26880275,46474095,1,0,0,26112,14,4158004978
4750,19594790,26791147,46385937,2,0,0,512,15,5593640924
4751,19598170,27381147,46979317,9,0,0,95232,19,3231325870
4752,19599100,27280277,46879377,5,0,0,2048,8,10130696271
4753,19601550,27297662,46899212,8,0,0,65024,13,7074816067
4754,19601570,46297836,65899406,6,0,1,512,5,361810030
4755,19602080,26778650,46380730,4,0,0,10240,4,1479332779
4756,19604881,27163633,46768514,0,0,0,8192,5,375633283
4757,19606610,46295062,65901672,4,0,1,3584,4,3572609404
4758,19606801,27086099,46692900,0,0,0,30720,5,9368165990
4759,19607320,46295338,65902658,4,0,1,1536,4,1137347442
4760,19615860,27232670,46848530,2,0,0,38912,15,8339184501
4761,19618660,26909201,46527861,7,0,0,5120,8,663592173
4762,19626670,27323600,46950270,9,0,0,49664,19,7018346586
4763,19633760,27654777,47288537,5,0,0,18944,8,4276737948
4764,19643360,27235370,46878730,8,0,0,70144,13,6074156033
4765,19645360,46283909,65929269,3,0,1,17408,12,3802365088
4766,19646660,46288247,65934907,9,0,1,10752,19,6167813730
4767,19650430,46312830,65963260,9,0,1,1536,19,10642578533
4768,19651090,27352786,47003876,8,0,0,28160,13,4367257899
4769,19651169,46314677,65965846,1,0,1,4096,14,1460760363
4770,19654220,27441884,47096104,4,0,0,57856,4,1073631142
4771,19657350,27199985,46857335,1,0,0,17408,14,9172526016
4772,19662329,46307383,65969712,1,0,1,6144,14,1687483913
4773,19669100,46307704,65976804,0,0,1,11264,5,699511447
4774,19677101,46300049,65977150,5,0,1,512,8,3664066227
4775,19689240,27294780,46984020,4,0,0,15360,4,5028234764
4776,19690060,26964646,46654706,9,0,0,17920,19,646558416
4777,19695511,27362547,47058058,0,0,0,36864,5,8049688953
4778,19698280,27202983,46901263,4,0,0,6656,4,8695484003
4779,19699541,26957528,46657069,0,0,0,7680,5,10126030441
4780,19699680,26949543,46649223,2,0,0,10240,15,7330290563
4781,19704390,27112748,46817138,7,0,0,11264,8,6072402730
4782,19706190,27405225,47111415,0,0,0,50176,5,2561029148
4783,19706390,27527523,47233913,8,0,0,43008,13,7683078831
4784,19711370,46268072,65979442,4,0,1,3584,4,5278958170
4785,19714170,27549304,47263474,8,0,0,40960,13,4971638778
4786,19717460,27426961,47144421,5,0,0,2048,8,1847353930
4787,19724460,27101412,46825872,1,0,0,4096,14,5229165542
4788,19727150,27105972,46833122,3,0,0,13312,12,8384348460
4789,19727880,27304764,47032644,5,0,0,18432,8,8626307697
4790,19732550,27600291,47332841,6,0,0,1536,5,497940906
4791,19740500,27461809,47202309,3,0,0,30720,12,7166869038
4792,19741320,27264318,47005638,0,0,0,5632,5,3522662768
4793,19746750,27465410,47212160,2,0,0,32256,15,7930238584
4794,19752750,46233144,65985894,0,0,1,10240,5,787490737
4795,19754570,46234802,65989372,9,0,1,12288,19,3859756583
4796,19762450,26995519,46757969,3,0,0,8704,12,534956222
4797,19763420,27086537,46849957,2,0,0,4608,15,7788253675
4798,19765840,27167848,46933688,9,0,0,42496,19,1708821214
4799,19766569,46242349,66008918,8,0,1,6144,13,7848903892
4800,19769450,46239491,66008941,2,0,1,7168,15,199358784
4801,19770100,46250751,66020851,3,0,1,2560,12,1667318928
4802,19776010,27250995,47027005,9,0,0,25600,19,2796177124
4803,19777090,27352404,47129494,8,0,0,35328,13,9469260877
4804,19778470,27438237,47216707,0,0,0,14848,5,5880200452
4805,19779490,27621974,47401464,5,0,0,59904,8,8505875175
4806,19787579,46233295,66020874,8,0,1,5120,13,5933882917
4807,19788340,27196956,46985296,5,0,0,3072,8,1411297989
4808,19798160,46250614,66048774,0,0,1,11776,5,8166058897
4809,19801520,27631966,47433486,5,0,0,2560,8,6720668993
4810,19807640,46298107,66105747,2,0,1,12288,15,9924984391
4811,19809831,46295939,66105770,5,0,1,1536,8,1148039559
4812,19810360,27530772,47341132,8,0,0,27136,13,604252754
4813,19815080,46290713,66105793,2,0,1,512,15,280671297
4814,19823979,46281869,66105848,8,0,1,14336,13,868320919
4815,19825591,46280280,66105871,7,0,1,1536,8,3778718774
4816,19825690,27481088,47306778,3,0,0,52736,12,2576955683
4817,19827820,27313733,47141553,5,0,0,12800,8,128312648
4818,19833230,27412874,47246104,3,0,0,39936,12,5810170983
4819,19838550,27412421,47250971,4,0,0,15872,4,2282185417
4820,19854600,27428142,47282742,6,0,0,11264,5,4910354152
4821,19875550,27506497,47382047,5,0,0,5632,8,2397661875
4822,19879300,27276660,47155960,6,0,0,5120,5,2186206836
4823,19888410,27332376,47220786,8,0,0,13312,13,2598980018
4824,19897460,27622618,47520078,3,0,0,11264,12,906941682
4825,19903430,27587955,47491385,8,0,0,25600,13,953877416
4826,19904330,27444625,47348955,5,0,0,25600,8,6469384166
4827,19906640,27540850,47447490,4,0,0,7168,4,6712328148
4828,19919119,46261052,66180171,8,0,1,11264,13,4654714286
4829,19930640,27643742,47574382,1,0,0,10752,14,1223288401
4830,19932560,27544768,47477328,2,0,0,8192,15,9295666423
4831,19934809,46278446,66213255,8,0,1,8192,13,6833334251
4832,19938570,27484647,47423217,1,0,0,54272,14,4209636944
4833,19939120,27539791,47478911,2,0,0,5120,15,3777472535
4834,19947690,27410554,47358244,2,0,0,10752,15,375862932
4835,19951540,27474889,47426429,3,0,0,4608,12,4066823124
4836,19952010,27454648,47406658,9,0,0,16384,19,10543786933
4837,19952840,27321912,47274752,0,0,0,2560,5,6582241239
4838,19961260,46322523,66283783,2,0,1,3072,15,1992940217
4839,19962480,27439163,47401643,4,0,0,512,4,2573138655
4840,19963640,27626019,47589659,1,0,0,44544,14,4590526832
4841,19965350,27644522,47609872,4,0,0,512,4,4505688515
4842,19965389,46401412,66366801,8,0,1,13312,13,3615707827
4843,19968820,27587912,47556732,6,0,0,7680,5,6267344964
4844,19969790,27620048,47589838,6,0,0,512,5,1045838412
4845,19976039,46405595,66381634,1,0,1,9728,14,890696540
4846,19976260,27533088,47509348,8,0,0,58880,13,7485208647
4847,19981010,27664634,47645644,3,0,0,1536,12,10114648952
4848,19985170,27743262,47728432,6,0,0,15872,5,789794604
4849,19988770,27435585,47424355,3,0,0,3584,12,5232769
4850,19993250,27431752,47425002,5,0,0,2048,8,4804488456
4851,19995460,46386533,66381993,9,0,1,9728,19,1478927718
4852,20000480,27784514,47784994,6,0,0,34304,5,5730638914
4853,20005730,27855661,47861391,3,0,0,43520,12,156640350
4854,20011901,46408460,66420361,7,0,1,4608,8,9986596601
4855,20012880,27502480,47515360,7,0,0,5120,8,6662273473
4856,20019621,46405886,66425507,7,0,1,8192,8,9537797175
4857,20043659,46409259,66452918,1,0,1,3584,14,5692574960
4858,20049460,27862407,47911867,1,0,0,33792,14,2006833191
4859,20049610,27787353,47836963,2,0,0,39936,15,1420741417
4860,20051170,27699772,47750942,6,0,0,48640,5,10479210027
4861,20052980,27755060,47808040,7,0,0,31744,8,9241031028
4862,20053890,27793727,47847617,3,0,0,27648,12,7583122716
4863,20062360,46391224,66453584,2,0,1,1024,15,1064444405
4864,20064270,27671829,47736099,7,0,0,25088,8,8711559051
4865,20065790,27758982,47824772,7,0,0,44544,8,7148841632
4866,20066460,27635107,47701567,2,0,0,3584,15,8091275739
4867,20070750,27554887,47625637,7,0,0,32768,8,2793491121
4868,20082970,27886024,47968994,3,0,0,2560,12,5045119666
4869,20086170,27543019,47629189,3,0,0,4096,12,6226002398
4870,20086540,27841730,47928270,1,0,0,53760,14,9643164032
4871,20087800,27849096,47936896,3,0,0,19456,12,3210244649
4872,20094610,27947207,48041817,4,0,0,5632,4,2798224829
4873,20099471,46354472,66453943,5,0,1,9728,8,1107137118
4874,20108670,46430986,66539656,2,0,1,10752,15,3807084395
4875,20112061,46431141,66543202,7,0,1,5632,8,7957178236
4876,20112740,27833522,47946262,6,0,0,12288,5,212174534
4877,20114330,27878700,47993030,5,0,0,5632,8,7493469972
4878,20120260,27747550,47867810,7,0,0,20992,8,2702222282
4879,20123420,28026108,48149528,7,0,0,103424,8,996188926
4880,20127100,28096128,48223228,1,0,0,40960,14,9714714351
4881,20138930,27700240,47839170,8,0,0,7168,13,245452250
4882,20139169,46408539,66547708,8,0,1,7168,13,2994734017
4883,20140110,27707998,47848108,6,0,0,1536,5,4753150058
4884,20142640,27913825,48056465,9,0,0,8704,19,4078678234
4885,20142780,27930741,48073521,3,0,0,18944,12,1478972846
4886,20146200,27723349,47869549,1,0,0,5632,14,1418846486
4887,20148840,27565510,47714350,7,0,0,4096,8,7581053809
4888,20154420,28041088,48195508,1,0,0,65536,14,9740463257
4889,20160780,28324496,48485276,5,0,0,30720,8,1732785939
4890,20164720,28040662,48205382,8,0,0,21504,13,2649308730
4891,20174560,28090532,48265092,6,0,0,5632,5,12299930
4892,20174820,27783608,47958428,7,0,0,4096,8,7633587205
4893,20176220,27754725,47930945,4,0,0,8704,4,1042072947
4894,20181990,27980556,48162546,8,0,0,42496,13,1306259922
4895,20184161,46417284,66601445,5,0,1,26112,8,9939640197
4896,20188350,28383301,48571651,9,0,0,65536,19,9308616472
4897,20189910,28438893,48628803,7,0,0,32768,8,2608226628
4898,20201800,27907388,48109188,0,0,0,20480,5,4705270143
4899,20204290,27994517,48198807,0,0,0,10752,5,7423810265
4900,20204860,27833824,48038684,4,0,0,13312,4,10707412312
4901,20205180,27873755,48078935,0,0,0,14336,5,4011857639
4902,20207410,27910560,48117970,1,0,0,28672,14,8719990635
4903,20212000,28215915,48427915,9,0,0,6656,19,3680126615
4904,20212170,28452519,48664689,3,0,0,7680,12,1404991812
4905,20229220,28497316,48726536,8,0,0,14848,13,3770104019
4906,20232220,27943297,48175517,0,0,0,42496,5,5325057568
4907,20239180,28442842,48682022,3,0,0,37888,12,5692560624
4908,20240290,28101774,48342064,1,0,0,28672,14,1314395004
4909,20241360,28296495,48537855,7,0,0,52224,8,4429090363
4910,20243100,28046062,48289162,8,0,0,22528,13,8109254803
4911,20252040,27958677,48210717,9,0,0,17408,19,1258823372
4912,20252751,46407213,66659964,7,0,1,10240,8,8639500723
4913,20254540,28095024,48349564,2,0,0,23040,15,4541704823
4914,20255940,46436890,66692830,2,0,1,12800,15,2293153333
4915,20259800,46547228,66807028,2,0,1,2560,15,1041314757
4916,20260810,28277848,48538658,9,0,0,2560,19,5945118345
4917,20263410,28520110,48783520,1,0,0,26112,14,7450209121
4918,20265350,28177641,48442991,7,0,0,20480,8,10127966392
4919,20266220,28152624,48418844,6,0,0,19968,5,3067421159
4920,20272900,46572845,66845745,2,0,1,36352,15,3557611715
4921,20283360,28099362,48382722,9,0,0,32256,19,10251490063
4922,20286851,46558917,66845768,7,0,1,6144,8,10386218979
4923,20289089,46680415,66969504,1,0,1,2048,14,662169875
4924,20291420,28156636,48448056,4,0,0,3584,4,7521154370
4925,20293640,28228280,48521920,5,0,0,24576,8,1929342599
4926,20301770,28110967,48412737,2,0,0,14336,15,3205340844
4927,20306300,46681677,66987977,9,0,1,12800,19,840621925
4928,20308700,28350413,48659113,5,0,0,67584,8,2082692902
4929,20312051,46676387,66988438,5,0,1,10240,8,5214588647
4930,20312280,28239349,48551629,7,0,0,42496,8,5481181858
4931,20312760,28306036,48618796,3,0,0,34304,12,7524043175
4932,20313801,46853030,67166831,5,0,1,2560,8,11534422
4933,20319961,28169238,48489199,0,0,0,12800,5,1054086424
4934,20320790,46854325,67175115,2,0,1,3584,15,8945562096
4935,20326080,28188128,48514208,6,0,0,11776,5,2988471051
4936,20333150,28305348,48638498,8,0,0,31744,13,7465558480
4937,20335230,28384064,48719294,3,0,0,27136,12,3130242862
4938,20340950,28321360,48662310,3,0,0,10240,12,9328061299
4939,20341840,28418940,48760780,1,0,0,512,14,6919673881
4940,20344509,46831784,67176293,8,0,1,13824,13,4345051067
4941,20346920,28522507,48869427,4,0,0,512,4,623571025
4942,20347290,28540371,48887661,3,0,0,13824,12,4562588189
4943,20354820,28806452,49161272,2,0,0,13312,15,8828297182
4944,20364010,28405354,48769364,7,0,0,18944,8,3497752109
4945,20368300,28454015,48822315,7,0,0,9216,8,822124843
4946,20368350,28570393,48938743,2,0,0,23040,15,6113188710
4947,20369040,28627992,48997032,8,0,0,14336,13,7350939782
4948,20375600,28411687,48787287,9,0,0,12288,19,9031520815
4949,20375960,46887767,67263727,2,0,1,512,15,8820968907
4950,20377550,28429380,48806930,4,0,0,20480,4,8101480397
4951,20379700,28366804,48746504,6,0,0,14848,5,10141877999
4952,20380370,28521739,48902109,1,0,0,17920,14,6632823813
4953,20382380,28501000,48883380,5,0,0,38912,8,4311081334
4954,20388711,46950990,67339701,5,0,1,18432,8,6981404513
4955,20397709,46942884,67340593,1,0,1,5632,14,1032718108
4956,20398019,46976907,67374926,8,0,1,4608,13,10706548243
4957,20400040,28518124,48918164,2,0,0,51712,15,9119252112
4958,20401780,28521087,48922867,2,0,0,15360,15,9019308854
4959,20403630,28752032,49155662,4,0,0,23040,4,4740530735
4960,20406730,46968657,67375387,4,0,1,10240,4,10269251387
4961,20407849,47067554,67475403,1,0,1,8192,14,9404419434
4962,20409281,47129045,67538326,5,0,1,20992,8,4097221435
4963,20411940,28665525,49077465,9,0,0,56832,19,9135919384
4964,20412790,28606787,49019577,4,0,0,28160,4,5355606540
4965,20434540,28497160,48931700,7,0,0,16896,8,10105067989
4966,20437580,28531954,48969534,3,0,0,20992,12,7023266
4967,20440669,47316834,67757503,8,0,1,8192,13,2426685309
4968,20450660,28631695,49082355,7,0,0,6656,8,10548859700
4969,20450770,28488464,48939234,1,0,0,1536,14,8452643044
4970,20458140,28798981,49257121,7,0,0,11776,8,1509441103
4971,20460420,28544956,49005376,4,0,0,9728,4,9287199051
4972,20463590,28728520,49192110,8,0,0,35840,13,8520082129
4973,20467740,28638981,49106721,1,0,0,6656,14,2702160937
4974,20470570,28911666,49382236,7,0,0,4608,8,8047254383
4975,20476060,28901831,49377891,9,0,0,15360,19,2058443567
4976,20478720,28520675,48999395,7,0,0,7680,8,3760132994
4977,20488760,28788065,49276825,1,0,0,51712,14,10179820720
4978,20492170,28727286,49219456,7,0,0,51200,8,9807916089
4979,20495470,28623006,49118476,7,0,0,5632,8,5327247685
4980,20498670,28723461,49222131,7,0,0,8704,8,5282170222
4981,20500920,47256606,67757526,0,0,1,1536,5,488284689
4982,20508030,28745480,49253510,7,0,0,102912,8,6792589365
4983,20510320,28693513,49203833,3,0,0,38400,12,4302199912
4984,20510480,28860501,49370981,4,0,0,59904,4,5879980552
4985,20517260,28904787,49422047,8,0,0,62464,13,7946561610
4986,20523110,28604394,49127504,5,0,0,27136,8,5931536301
4987,20527320,28845868,49373188,8,0,0,7168,13,6110799054
4988,20544310,47213239,67757549,9,0,1,4096,19,7062826343
4989,20544410,47213162,67757572,2,0,1,9216,15,2038940067
4990,20546800,28765215,49312015,1,0,0,14848,14,2468009171
4991,20549830,28886082,49435912,1,0,0,19456,14,9823599703
4992,20564170,28890006,49454176,6,0,0,41472,5,10689586727
4993,20564940,28515356,49080296,9,0,0,9216,19,2048741844
4994,20566810,28714094,49280904,5,0,0,13312,8,9638816440
4995,20569600,28688012,49257612,8,0,0,1536,13,7169891993
4996,20571890,28770992,49342882,2,0,0,20992,15,10248918012
4997,20572190,28989882,49562072,1,0,0,11264,14,5333882205
4998,20572990,47250116,67823106,4,0,1,512,4,3180652167
4999,20581700,28768880,49350580,9,0,0,2048,19,681798314
5000,20583280,28873872,49457152,5,0,0,1536,8,4972391185
5001,20587090,28977366,49564456,6,0,0,512,5,512421987
5002,20601980,28559471,49161451,1,0,0,512,14,2521437928
5003,20610120,28948497,49558617,7,0,0,78336,8,8002683127
5004,20616751,47238697,67855448,5,0,1,6656,8,10233684882
5005,20630820,47241237,67872057,3,0,1,26624,12,405203037
5006,20631190,28699622,49330812,8,0,0,3584,13,4045164950
5007,20633580,47250457,67884037,2,0,1,2560,15,10033326015
5008,20638020,28802503,49440523,1,0,0,12800,14,3793201566
5009,20640380,47308538,67948918,0,0,1,15872,5,9809143514
5010,20640540,29107921,49748461,1,0,0,8704,14,7349959230
5011,20644570,29164727,49809297,4,0,0,7168,4,10022444097
5012,20644890,28861049,49505939,2,0,0,20992,15,3312349020
5013,20645030,28889696,49534726,4,0,0,28160,4,4180463348
5014,20646310,28984428,49630738,5,0,0,10240,8,8157534292
5015,20655180,28842829,49498009,4,0,0,13824,4,9459863204
5016,20657610,28935157,49592767,4,0,0,8704,4,3804283384
5017,20668469,47280472,67948941,8,0,1,6656,13,3519312335
5018,20668990,28929774,49598764,9,0,0,4608,19,8516161879
5019,20674430,47409908,68084338,9,0,1,21504,19,1772642625
5020,20680000,29059562,49739562,7,0,0,64512,8,1791550118
5021,20681860,29199528,49881388,5,0,0,3072,8,183779165
5022,20685650,28985648,49671298,6,0,0,4608,5,2707751262
5023,20686120,29274596,49960716,4,0,0,16896,4,1964069689
5024,20687300,47401820,68089120,2,0,1,13312,15,835830733
5025,20690410,28945688,49636098,1,0,0,1536,14,5837331109
5026,20694240,29186010,49880250,7,0,0,30208,8,10031140192
5027,20710310,29009573,49719883,7,0,0,54272,8,7928638699
5028,20712650,47610288,68322938,2,0,1,43008,15,8012797732
5029,20715200,29077690,49792890,8,0,0,512,13,1960010518
5030,20719040,47641956,68360996,9,0,1,6656,19,10446415677
5031,20730160,29636303,50366463,2,0,0,86528,15,4583870504
5032,20736460,29056251,49792711,8,0,0,17408,13,1385829886
5033,20740560,47661212,68401772,3,0,1,22528,12,8520153864
5034,20745860,29049206,49795066,7,0,0,6144,8,3852809200
5035,20746760,29178422,49925182,2,0,0,9216,15,5087329796
5036,20751660,28988081,49739741,9,0,0,512,19,6718212099
5037,20755620,47647433,68403053,9,0,1,9216,19,2969838839
5038,20755810,29025886,49781696,7,0,0,3584,8,5010632087
5039,20759290,29098407,49857697,6,0,0,21504,5,466453791
5040,20762940,29577136,50340076,7,0,0,48640,8,8526418894
5041,20769480,29011101,49780581,5,0,0,32768,8,5456774515
5042,20774280,29295746,50070026,5,0,0,43008,8,5588296972
5043,20777920,29211025,49988945,2,0,0,64512,15,9442027877
5044,20778630,29267950,50046580,6,0,0,13312,5,10032512255
5045,20780230,29151909,49932139,7,0,0,2560,8,6937296417
5046,20783990,29003189,49787179,2,0,0,17920,15,7237135258
5047,20785940,29629490,50415430,6,0,0,27648,5,10245250306
5048,20792180,29392405,50184585,6,0,0,17408,5,7014256436
5049,20793790,29013300,49807090,8,0,0,15360,13,4289022662
5050,20795410,29234429,50029839,6,0,0,44032,5,8652700790
5051,20808530,29071899,49880429,7,0,0,512,8,8922386480
5052,20809011,47595348,68404359,5,0,1,2048,8,1785258612
5053,20809020,29228954,50037974,1,0,0,26624,14,3320679541
5054,20811650,29151117,49962767,5,0,0,6656,8,9096322218
5055,20812970,29421599,50234569,3,0,0,27136,12,5304885983
5056,20815751,47593754,68409505,7,0,1,8192,8,4085681498
5057,20817220,29255793,50073013,4,0,0,9728,4,2406868407
5058,20818490,29145538,49964028,7,0,0,2560,8,3701698371
5059,20819670,29323395,50143065,2,0,0,7168,15,9616089918
5060,20824120,29617416,50441536,7,0,0,30208,8,9058851381
5061,20824190,29121872,49946062,4,0,0,7168,4,7219859466
5062,20825310,29363978,50189288,4,0,0,15360,4,7147588513
5063,20831640,29278132,50109772,7,0,0,59392,8,2139273688
5064,20838570,29357294,50195864,7,0,0,21504,8,1904983461
5065,20839450,29301011,50140461,4,0,0,7680,4,2480375768
5066,20841300,29215599,50056899,5,0,0,33792,8,2816192214
5067,20844790,47771724,68616514,3,0,1,4096,12,853092571
5068,20846090,29445077,50291167,1,0,0,19968,14,44905521
5069,20846460,29478766,50325226,1,0,0,3584,14,5223566920
5070,20851570,29318446,50170016,2,0,0,12288,15,3397467585
5071,20858269,47786139,68644408,1,0,1,18944,14,5766102389
5072,20868890,47790237,68659127,4,0,1,512,4,10145143875
5073,20884711,47774439,68659150,5,0,1,1536,8,3888139977
5074,20885410,29737968,50623378,4,0,0,7168,4,844881668
5075,20889171,47771897,68661068,7,0,1,4096,8,732630464
5076,20891029,47776524,68667553,8,0,1,7168,13,7903647874
5077,20892040,47811664,68703704,3,0,1,1024,12,3751404102
5078,20893540,29604384,50497924,2,0,0,55296,15,2266304730
5079,20899219,47804516,68703735,1,0,1,2560,14,449105937
5080,20900150,29482560,50382710,3,0,0,53248,12,8220497324
5081,20904000,30105423,51009423,3,0,0,4096,12,3710098444
5082,20905400,29526901,50432301,7,0,0,55296,8,7742645407
5083,20905880,29701298,50607178,4,0,0,24576,4,3369431791
5084,20908620,29480517,50389137,4,0,0,20992,4,651016231
5085,20910970,47876618,68787588,3,0,1,12800,12,1064532166
5086,20915030,29584679,50499709,5,0,0,5632,8,8011986839
5087,20917630,30206725,51124355,6,0,0,35328,5,7057527248
5088,20919650,29624425,50544075,2,0,0,12288,15,10035216326
5089,20924170,48000754,68924924,0,0,1,17408,5,151354920
5090,20925200,29713169,50638369,3,0,0,10752,12,8351970009
5091,20927661,48018827,68946488,7,0,1,7168,8,2387155473
5092,20935350,29734696,50670046,4,0,0,34304,4,1667227655
5093,20946600,29775364,50721964,4,0,0,28672,4,4502363879
5094,20949671,47996840,68946511,7,0,1,2560,8,5892395663
5095,20950180,29872693,50822873,5,0,0,145408,8,1109732787
5096,20950470,29932143,50882613,9,0,0,10240,19,6228444747
5097,20961010,48062983,69023993,2,0,1,19968,15,9334981251
5098,20961740,30028785,50990525,2,0,0,512,15,7748571419
5099,20964470,29964375,50928845,2,0,0,20480,15,3083232726
5100,20966790,29732041,50698831,5,0,0,512,8,3496848517
5101,20968920,29744226,50713146,1,0,0,1024,14,7216654064
5102,20971430,29737634,50709064,6,0,0,4608,5,7642360173
5103,20977000,29788726,50765726,7,0,0,3584,8,3079696289
5104,20978490,29897213,50875703,3,0,0,70656,12,4786887144
5105,20986350,48142622,69128972,0,0,1,11264,5,4011089617
5106,20986880,29658267,50645147,5,0,0,4608,8,8595673713
5107,20999770,29825627,50825397,8,0,0,7680,13,4818123225
5108,21002870,30276381,51279251,2,0,0,2048,15,907760157
5109,21006090,30305576,51311666,2,0,0,17408,15,718854548
5110,21008450,29999702,51008152,8,0,0,28160,13,6175595471
5111,21013689,48158983,69172672,1,0,1,4608,14,4711788123
5112,21016940,30087750,51104690,6,0,0,15872,5,9682208165
5113,21017630,30182211,51199841,4,0,0,9728,4,1509103108
5114,21020180,29902356,50922536,1,0,0,33792,14,5064860099
5115,21021190,29858280,50879470,9,0,0,12288,19,6213676920
5116,21023230,30371851,51395081,6,0,0,63488,5,10134428427
5117,21036720,30317684,51354404,8,0,0,39424,13,7238589012
5118,21040640,29802054,50842694,8,0,0,2048,13,817776442
5119,21044870,30394593,51439463,9,0,0,21504,19,2309457686
5120,21046400,30254952,51301352,2,0,0,26624,15,7200165216
5121,21054230,29854627,50908857,3,0,0,9728,12,3966569057
5122,21058640,30151209,51209849,8,0,0,2560,13,6699580949
5123,21060220,29957650,51017870,3,0,0,27648,12,10414960897
5124,21065480,30166306,51231786,2,0,0,25600,15,3842350674
5125,21066510,48275832,69342342,4,0,1,2048,4,1534700787
5126,21068600,30140446,51209046,7,0,0,20480,8,4664844224
5127,21072190,29902660,50974850,3,0,0,12800,12,1848698562
5128,21076840,48482466,69559306,2,0,1,30208,15,4619606134
5129,21082030,30842532,51924562,9,0,0,39424,19,1117215847
5130,21083440,30466542,51549982,4,0,0,14336,4,9259705507
5131,21089680,30413993,51503673,7,0,0,63488,8,103142667
5132,21089741,48477044,69566785,5,0,1,15360,8,5800125583
5133,21093320,30119516,51212836,5,0,0,9728,8,1300462717
5134,21094149,48506657,69600806,8,0,1,2560,13,1520576236
5135,21094470,30681075,51775545,7,0,0,278016,8,636742550
5136,21101550,30899565,52001115,6,0,0,77312,5,8644589872
5137,21103080,29954562,51057642,1,0,0,4608,14,6885412419
5138,21103810,30759013,51862823,3,0,0,6656,12,7790640288
5139,21113140,30257511,51370651,2,0,0,53248,15,6116551328
5140,21119191,48511827,69631018,7,0,1,5632,8,4461819421
5141,21124710,48506974,69631684,3,0,1,1024,12,1957147545
5142,21129300,30379411,51508711,5,0,0,7168,8,6594939171
5143,21139520,30543294,51682814,5,0,0,16384,8,696216047
5144,21141710,48490947,69632657,2,0,1,12800,15,7123012030
5145,21144470,30147090,51291560,7,0,0,20480,8,2340884650
5146,21154380,30263795,51418175,9,0,0,2048,19,5325979396
5147,21168901,48534460,69703361,7,0,1,2560,8,1589882537
5148,21176769,48526615,69703384,8,0,1,13312,13,4159316897
5149,21183920,30134789,51318709,2,0,0,23040,15,379409163
5150,21185640,30860848,52046488,7,0,0,16896,8,6451116977
5151,21187870,30273623,51461493,8,0,0,5120,13,5661693641
5152,21189050,30671722,51860772,9,0,0,34304,19,9061357928
5153,21189720,31032303,52222023,4,0,0,3584,4,5175370552
5154,21191600,30183979,51375579,5,0,0,1536,8,5904252373
5155,21200450,30101938,51302388,3,0,0,3072,12,835531244
5156,21203990,48605871,69809861,3,0,1,12800,12,4627466118
5157,21204010,48664482,69868492,2,0,1,3584,15,6017138252
5158,21204711,48707441,69912152,7,0,1,4608,8,6280989714
5159,21206800,30240041,51446841,7,0,0,22016,8,3362139423
5160,21217120,30289384,51506504,8,0,0,9216,13,1402146037
5161,21217450,30183582,51401032,2,0,0,19456,15,4306919956
5162,21217920,30235322,51453242,8,0,0,14848,13,6723564919
5163,21220300,30668146,51888446,3,0,0,6144,12,6554423384
5164,21237210,30290255,51527465,8,0,0,11776,13,9729836805
5165,21241780,31146154,52387934,9,0,0,41984,19,4763775128
5166,21243070,30936221,52179291,5,0,0,33280,8,9281636532
5167,21243200,30563880,51807080,9,0,0,103424,19,4588993587
5168,21243810,30895251,52139061,2,0,0,39936,15,6813984800
5169,21245230,31450087,52695317,1,0,0,35840,14,6570907117
5170,21256790,31349090,52605880,3,0,0,43520,12,8447296175
5171,21257301,48658077,69915378,5,0,1,5120,8,5240300688
5172,21266410,30373731,51640141,4,0,0,7680,4,6268744305
5173,21270989,49085910,70356899,1,0,1,20480,14,3052983000
5174,21285660,30134754,51420414,6,0,0,1024,5,5518037318
5175,21285840,30399204,51685044,6,0,0,7168,5,2279860808
5176,21288140,31218153,52506293,1,0,0,62976,14,125500114
5177,21289900,30866679,52156579,2,0,0,57344,15,9024783039
5178,21296380,49061287,70357667,9,0,1,11776,19,10425042871
5179,21297080,49193768,70490848,2,0,1,5632,15,9199744650
5180,21297711,49193496,70491207,7,0,1,9728,8,9735438434
5181,21309310,30534412,51843722,2,0,0,49664,15,7945003340
5182,21314160,30289368,51603528,4,0,0,6144,4,2736083175
5183,21314441,49237433,70551874,7,0,1,4608,8,8591015141
5184,21322359,49229538,70551897,8,0,1,2048,13,1643424682
5185,21331030,30306748,51637778,6,0,0,9728,5,8203934960
5186,21331970,30332944,51664914,1,0,0,19968,14,7487376590
5187,21344370,30484128,51828498,8,0,0,70144,13,10666295256
5188,21344580,30599973,51944553,8,0,0,65536,13,3342428839
5189,21351780,30088330,51440110,1,0,0,2048,14,5356531230
5190,21358450,49360303,70718753,2,0,1,20992,15,8125431996
5191,21359400,30534302,51893702,1,0,0,13312,14,1711459912
5192,21362030,30505051,51867081,9,0,0,7168,19,1019631416
5193,21375970,49568377,70944347,0,0,1,8704,5,6768965240
5194,21383250,30467047,51850297,6,0,0,21504,5,8482029537
5195,21387049,49557321,70944370,1,0,1,1024,14,5763847598
5196,21391000,31060552,52451552,9,0,0,108544,19,9737149653
5197,21394560,49753812,71148372,3,0,1,512,12,83347314
5198,21395420,30559194,51954614,6,0,0,32768,5,4747493880
5199,21396300,30503821,51900121,7,0,0,20992,8,3975926815
5200,21398870,30712178,52111048,7,0,0,18432,8,1847075208
5201,21402210,30203057,51605267,9,0,0,5632,19,6730426211
5202,21403610,30253200,51656810,4,0,0,6656,4,7410571275
5203,21407540,30457334,51864874,5,0,0,6656,8,3796453695
5204,21407850,30593600,52001450,4,0,0,1024,4,4697607516
5205,21417629,49732717,71150346,8,0,1,4096,13,8316934245
5206,21422260,30657385,52079645,8,0,0,26624,13,8377799888
5207,21423960,30635827,52059787,5,0,0,7168,8,9178798721
5208,21426160,30772864,52199024,7,0,0,19456,8,2646187916
5209,21426440,30631140,52057580,2,0,0,23040,15,10291317527
5210,21432300,31160297,52592597,1,0,0,27648,14,9536553277
5211,21441370,30751703,52193073,9,0,0,26624,19,7878385871
5212,21441610,30873575,52315185,8,0,0,512,13,2104253204
5213,21449980,30570753,52020733,3,0,0,11776,12,7961333453
5214,21456180,30712925,52169105,8,0,0,40960,13,8976893772
5215,21457010,30727928,52184938,7,0,0,18432,8,5623472060
5216,21457330,30576892,52034222,2,0,0,18432,15,7421571284
5217,21466160,30405842,51872002,9,0,0,15872,19,5509581246
5218,21467190,31184385,52651575,9,0,0,28672,19,7276608553
5219,21467860,49761684,71229544,3,0,1,2048,12,4639069977
5220,21479010,30725270,52204280,7,0,0,16896,8,1363433649
5221,21484070,30520991,52005061,1,0,0,11776,14,4524736609
5222,21485250,31342604,52827854,9,0,0,512,19,9538735883
5223,21485270,31285855,52771125,7,0,0,29696,8,5618442461
5224,21489900,31048353,52538253,2,0,0,41472,15,9889209824
5225,21501400,30515722,52017122,5,0,0,17408,8,8754212864
5226,21501580,31077087,52578667,4,0,0,86528,4,9162421328
5227,21506370,30892515,52398885,2,0,0,35840,15,5847638341
5228,21511760,49717807,71229567,2,0,1,1536,15,8072811928
5229,21518360,30814183,52332543,1,0,0,15872,14,8626615058
5230,21522900,30710780,52233680,4,0,0,14336,4,7471782872
5231,21523240,31382648,52905888,3,0,0,30208,12,9654153934
5232,21523590,30547920,52071510,7,0,0,38400,8,7949291312
5233,21523980,31084800,52608780,7,0,0,1024,8,6049177867
5234,21529740,30845379,52375119,1,0,0,51200,14,3462731139
5235,21538331,49691259,71229590,5,0,1,4096,8,2498431419
5236,21539171,49700545,71239716,7,0,1,3072,8,9865545155
5237,21547050,30812446,52359496,2,0,0,47104,15,7756555015
5238,21547880,31402836,52950716,7,0,0,67072,8,8143818518
5239,21557629,49774630,71332259,8,0,1,26112,13,3707355624
5240,21572951,49780647,71353598,5,0,1,2560,8,2422586718
5241,21576950,30935184,52512134,4,0,0,15360,4,2263249242
5242,21587330,30448007,52035337,4,0,0,3584,4,764149901
5243,21588281,49780971,71369252,7,0,1,6144,8,10013630421
5244,21588770,30624529,52213299,6,0,0,10240,5,3597704486
5245,21589490,31579494,53168984,6,0,0,67584,5,8646925068
5246,21607230,31103763,52710993,9,0,0,46592,19,3237947143
5247,21608610,30848916,52457526,7,0,0,19456,8,5474591923
5248,21612411,49756864,71369275,7,0,1,14848,8,9178142198
5249,21625780,30701784,52327564,2,0,0,4096,15,3856050679
5250,21630820,31456036,53086856,4,0,0,24576,4,7808340485
5251,21641040,30979463,52620503,6,0,0,38400,5,6591028990
5252,21642610,30994275,52636885,5,0,0,14336,8,3183611319
5253,21642970,49767365,71410335,9,0,1,2048,19,619523118
5254,21644460,30575036,52219496,2,0,0,3072,15,6432381647
5255,21645360,30816401,52461761,8,0,0,13824,13,5702089851
5256,21647190,49764771,71411961,9,0,1,2560,19,430621572
5257,21655810,31117990,52773800,1,0,0,8704,14,219970991
5258,21657940,49765297,71423237,0,0,1,8192,5,1544741513
5259,21659090,30655916,52315006,1,0,0,24064,14,3319816069
5260,21660170,31089631,52749801,8,0,0,37376,13,217981297
5261,21671820,31222166,52893986,8,0,0,44544,13,8977445045
5262,21675541,49819204,71494745,7,0,1,4608,8,9900632707
5263,21681640,31426665,53108305,8,0,0,66560,13,4798914148
5264,21681700,30994559,52676259,2,0,0,1024,15,934912924
5265,21683470,31078545,52762015,9,0,0,35840,19,1813920887
5266,21694450,30979829,52674279,3,0,0,4608,12,3794763412
5267,21699210,30884940,52584150,7,0,0,17920,8,4546572432
5268,21705560,30900990,52606550,1,0,0,2048,14,7383458245
5269,21708170,31553928,53262098,5,0,0,99840,8,207180556
5270,21714161,49780607,71494768,5,0,1,512,8,4568660958
5271,21724320,30783111,52507431,8,0,0,3584,13,6324459495
5272,21727950,31275496,53003446,1,0,0,32256,14,1010869393
5273,21730230,49764629,71494859,4,0,1,2560,4,5148456340
5274,21733860,31409482,53143342,8,0,0,10240,13,655883487
5275,21737100,31013972,52751072,9,0,0,4096,19,280856973
5276,21746550,31332795,53079345,7,0,0,4608,8,775772340
5277,21758580,49782407,71540987,9,0,1,19968,19,1963745467
5278,21759450,31541263,53300713,4,0,0,13312,4,9853524727
5279,21760650,49883994,71644644,3,0,1,15872,12,9804472036
5280,21762910,30845535,52608445,6,0,0,6144,5,623727587
5281,21763751,49972798,71736549,7,0,1,8192,8,3404712362
5282,21765270,31197980,52963250,4,0,0,26112,4,6692091007
5283,21768330,31237791,53006121,7,0,0,8704,8,6869578220
5284,21770040,31629692,53399732,1,0,0,2560,14,1606244078
5285,21771341,50019177,71790518,7,0,1,20480,8,5170461598
5286,21771560,31523456,53295016,8,0,0,9728,13,2266945997
5287,21775541,50015745,71791286,5,0,1,11776,8,8213812354
5288,21778020,31118641,52896661,8,0,0,8704,13,1705763765
5289,21782270,50031730,71814000,2,0,1,3584,15,7884400930
5290,21785130,50028893,71814023,2,0,1,4096,15,6537081917
5291,21787180,31384837,53172017,7,0,0,2048,8,5850281180
5292,21793440,50020606,71814046,6,0,1,4096,5,9542221349
5293,21795030,31085361,52880391,3,0,0,18432,12,10471025758
5294,21798320,31553671,53351991,7,0,0,1024,8,2290989073
5295,21798650,31416730,53215380,4,0,0,2048,4,6516578217
5296,21800100,50013969,71814069,4,0,1,1536,4,1474279679
5297,21809440,30658619,52468059,4,0,0,18432,4,8097958469
5298,21813390,31104431,52917821,7,0,0,7680,8,4468726240
5299,21814510,30981229,52795739,5,0,0,21504,8,2332600520
5300,21816930,50001219,71818149,4,0,1,6656,4,6394983782
5301,21820360,31257223,53077583,9,0,0,73216,19,628416319
5302,21832500,50031697,71864197,3,0,1,24064,12,8630498619
5303,21834410,31775645,53610055,7,0,0,93696,8,7022772104
5304,21834560,31095674,52930234,2,0,0,31744,15,9767418371
5305,21838709,50101352,71940061,8,0,1,7680,13,1384335829
5306,21840950,31886856,53727806,3,0,0,42496,12,10580142029
5307,21860250,50079834,71940084,3,0,1,1024,12,838257560
5308,21861000,31154575,53015575,4,0,0,4096,4,3149123387
5309,21867850,31589279,53457129,9,0,0,24576,19,4558725402
5310,21868200,31713284,53581484,4,0,0,104448,4,10487398209
5311,21879770,50069915,71949685,2,0,1,16896,15,1824881777
5312,21880130,31130382,53010512,7,0,0,14336,8,8604131797
5313,21881540,30946135,52827675,7,0,0,29696,8,4839415357
5314,21891850,31159011,53050861,4,0,0,85504,4,7368651962
5315,21898379,50053973,71952352,1,0,1,6656,14,1709789465
5316,21899050,31867444,53766494,7,0,0,9216,8,1145285810
5317,21900600,31906424,53807024,3,0,0,30208,12,8379181268
5318,21906650,50049568,71956218,0,0,1,6144,5,8234740806
5319,21912430,31099197,53011627,6,0,0,3584,5,8745972408
5320,21916790,31297943,53214733,2,0,0,32256,15,2709076128
5321,21920060,31135192,53055252,9,0,0,14336,19,3323503968
5322,21922041,50056708,71978749,5,0,1,7680,8,7242149496
5323,21925120,31152798,53077918,7,0,0,1024,8,4374164605
5324,21925930,31244637,53170567,4,0,0,5120,4,2409907925
5325,21925990,31988218,53914208,1,0,0,5632,14,2151510998
5326,21932110,50066469,71998579,3,0,1,11264,12,7947102164
5327,21934760,31176532,53111292,2,0,0,9728,15,4098343281
5328,21940420,31411236,53351656,7,0,0,34304,8,8496218540
5329,21942180,31145822,53088002,5,0,0,3584,8,10428829412
5330,21946580,31165359,53111939,4,0,0,2048,4,1543309765
5331,21960691,50207798,72168489,7,0,1,15360,8,3813120651
5332,21962100,31400886,53362986,3,0,0,29184,12,9992613006
5333,21972590,31201478,53174068,1,0,0,6656,14,8553384629
5334,21973220,30982051,52955271,5,0,0,14848,8,6698622977
5335,21981129,50189306,72170435,1,0,1,3072,14,8887227753
5336,21984150,31187220,53171370,7,0,0,2560,8,7531787500
5337,21986860,32057119,54043979,4,0,0,48640,4,8704502517
5338,21988980,31547152,53536132,4,0,0,17920,4,7911434831
5339,21989430,31307204,53296634,0,0,0,3072,5,2170258162
5340,21992841,50243943,72236784,7,0,1,2560,8,1063953850
5341,22003430,31190995,53194425,5,0,0,12288,8,5460152445
5342,22005280,31115079,53120359,0,0,0,21504,5,3637240158
5343,22006190,50230940,72237130,3,0,1,512,12,1685829315
5344,22010689,50226787,72237476,8,0,1,512,13,3320224853
5345,22011790,31293202,53304992,5,0,0,2560,8,10389463291
5346,22014150,31447214,53461364,0,0,0,13824,5,5491983757
5347,22020160,31253239,53273399,4,0,0,25088,4,4333340252
5348,22024239,50218383,72242622,1,0,1,8192,14,3640860702
5349,22028679,50216849,72245528,1,0,1,4608,14,5367044432
5350,22029900,31174982,53204882,2,0,0,17920,15,2849715979
5351,22030330,31753956,53784286,4,0,0,47616,4,5071189476
5352,22033240,31373680,53406920,6,0,0,22528,5,3537696046
5353,22033730,31465419,53499149,4,0,0,15872,4,7211177136
5354,22037620,31390938,53428558,9,0,0,48640,19,6813613225
5355,22038780,31226929,53265709,9,0,0,11776,19,4899543849
5356,22040240,31288354,53328594,9,0,0,8192,19,7979624297
5357,22041600,31402668,53444268,4,0,0,27648,4,7715401076
5358,22042580,31283495,53326075,2,0,0,69120,15,10701204244
5359,22044630,31425702,53470332,9,0,0,17408,19,3565469312
5360,22048300,31178859,53227159,5,0,0,16896,8,4818230853
5361,22049110,31382146,53431256,4,0,0,6656,4,9003592567
5362,22052640,31585058,53637698,9,0,0,90624,19,2552350239
5363,22056541,50189333,72245874,5,0,1,512,8,8092662045
5364,22063070,31384709,53447779,9,0,0,6144,19,690023958
5365,22073090,31810824,53883914,7,0,0,9216,8,8049097918
5366,22081580,31678944,53760524,5,0,0,2560,8,4809319158
5367,22086290,31342915,53429205,0,0,0,2048,5,2971923311
5368,22098860,31950157,54049017,9,0,0,16384,19,3600132751
5369,22101300,31875798,53977098,4,0,0,61952,4,10186832501
5370,22103061,50143581,72246642,7,0,1,11776,8,2104830595
5371,22103770,31534130,53637900,7,0,0,512,8,8911077257
5372,22105490,31440145,53545635,7,0,0,7168,8,1736959888
5373,22110990,31409287,53520277,1,0,0,31232,14,5943474230
5374,22128460,31394024,53522484,0,0,0,7168,5,4806095206
5375,22129530,31863682,53993212,3,0,0,12288,12,9524076726
5376,22132730,31231371,53364101,5,0,0,3584,8,2052376983
5377,22138421,50358084,72496505,7,0,1,27648,8,3312428156
5378,22141070,32001558,54142628,7,0,0,27136,8,5408370935
5379,22144790,31954074,54098864,0,0,0,512,5,9759456474
5380,22158400,50655970,72814370,0,0,1,20992,5,10440424726
5381,22159160,31520190,53679350,7,0,0,36352,8,766993392
5382,22159211,50659985,72819196,7,0,1,7680,8,5288388954
5383,22160180,32156371,54316551,1,0,0,47104,14,8793372398
5384,22161580,31676896,53838476,7,0,0,22528,8,3926536905
5385,22172180,31903942,54076122,7,0,0,18432,8,10275772658
5386,22178399,50644023,72822422,8,0,1,5120,13,9404278151
5387,22183150,50715541,72898691,4,0,1,8704,4,990675999
5388,22185760,31605184,53790944,4,0,0,13312,4,2955285739
5389,22189850,31281441,53471291,7,0,0,3072,8,8712879055
5390,22191950,31474380,53666330,5,0,0,2048,8,6532358391
5391,22193210,50725029,72918239,4,0,1,11776,4,141484839
5392,22199640,31826002,54025642,3,0,0,11776,12,3382701319
5393,22203450,31339306,53542756,7,0,0,8704,8,6255642469
5394,22203660,31825281,54028941,4,0,0,10752,4,3159485136
5395,22205910,31966736,54172646,5,0,0,4608,8,10006412733
5396,22207350,31294630,53501980,5,0,0,9216,8,8802847033
5397,22207590,50891556,73099146,3,0,1,11264,12,20167055
5398,22213900,50903269,73117169,0,0,1,4608,5,6971542458
5399,22215910,50903525,73119435,4,0,1,3584,4,8257524353
5400,22220170,31421753,53641923,6,0,0,12800,5,4979712356
5401,22223440,50933328,73156768,3,0,1,8192,12,2499526332
5402,22224360,50936986,73161346,2,0,1,4608,15,1060227321
5403,22225301,50980273,73205574,7,0,1,7680,8,7751838623
5404,22225870,31793151,54019021,2,0,0,30208,15,9465527379
5405,22236840,32009076,54245916,7,0,0,76288,8,322994036
5406,22238550,31783458,54022008,5,0,0,9728,8,6123544765
5407,22240660,31885132,54125792,9,0,0,7168,19,1663475195
5408,22250480,50962702,73213182,3,0,1,3072,12,7708903195
5409,22252480,31669083,53921563,6,0,0,8704,5,8022415416
5410,22256270,31855711,54111981,1,0,0,7680,14,2242745621
5411,22260920,50958337,73219257,4,0,1,7168,4,7102978743
5412,22264160,31796143,54060303,5,0,0,21504,8,6971297125
5413,22269051,51004268,73273319,7,0,1,10240,8,3394675036
5414,22269100,32058082,54327182,2,0,0,34816,15,10266956580
5415,22269910,51027952,73297862,6,0,1,10752,5,7488000370
5416,22269919,51135630,73405549,8,0,1,35328,13,8364253315
5417,22272429,51176284,73448713,1,0,1,2048,14,6555021823
5418,22281430,32001691,54283121,7,0,0,64000,8,3007438468
5419,22284550,31803309,54087859,9,0,0,4096,19,10441255565
5420,22286491,51162245,73448736,5,0,1,6144,8,2504610895
5421,22289300,32076600,54365900,8,0,0,5632,13,6623365352
5422,22290980,32011196,54302176,3,0,0,62464,12,7880243066
5423,22293900,31715715,54009615,6,0,0,53760,5,378002695
5424,22297570,31712224,54009794,7,0,0,512,8,3845837624
5425,22299780,51148979,73448759,9,0,1,1536,19,6883788524
5426,22302570,31758856,54061426,4,0,0,3584,4,1315251276
5427,22304470,32286834,54591304,4,0,0,15872,4,7958803961
5428,22306070,51237706,73543776,4,0,1,20480,4,1239828196
5429,22329049,51292761,73621810,1,0,1,10240,14,10073996371
5430,22329360,31617290,53946650,5,0,0,5120,8,4924642780
5431,22330530,32113844,54444374,1,0,0,20992,14,8714633685
5432,22342021,51279812,73621833,7,0,1,8192,8,3504124432
5433,22342620,31809121,54151741,2,0,0,4608,15,8459030594
5434,22346570,31871977,54218547,7,0,0,58880,8,10596972549
5435,22350240,31913358,54263598,4,0,0,16896,4,2898254878
5436,22356380,51268814,73625194,9,0,1,6144,19,7686977342
5437,22357970,51271090,73629060,3,0,1,6144,12,6063395153
5438,22358030,32364444,54722474,5,0,0,24064,8,598584028
5439,22361150,32020165,54381315,4,0,0,1024,4,495658002
5440,22365929,51275929,73641858,8,0,1,2560,13,2859308128
5441,22371780,32031266,54403046,4,0,0,22528,4,9940333756
5442,22373790,32079903,54453693,1,0,0,512,14,9571140373
5443,22377020,32209379,54586399,3,0,0,71680,12,6138502368
5444,22382030,31680667,54062697,4,0,0,4096,4,9824382816
5445,22390420,31599025,53989445,3,0,0,40448,12,6762961502
5446,22390990,32343832,54734822,0,0,0,40448,5,2486881728
5447,22392640,31502617,53895257,2,0,0,1536,15,3515370104
5448,22395860,32281050,54676910,7,0,0,35840,8,3501748976
5449,22396860,32259452,54656312,1,0,0,512,14,6723292417
5450,22398420,31655308,54053728,0,0,0,15360,5,2675263029
5451,22401740,32374219,54775959,9,0,0,46592,19,3902086919
5452,22403350,31971153,54374503,4,0,0,28160,4,10421919031
5453,22407050,32040779,54447829,9,0,0,11264,19,6724275377
5454,22407310,31955268,54362578,2,0,0,33792,15,5342580614
5455,22413790,32020898,54434688,6,0,0,9216,5,6207672372
5456,22413850,31615286,54029136,3,0,0,512,12,7975754552
5457,22416880,31681384,54098264,1,0,0,3584,14,1894765508
5458,22423790,31745300,54169090,5,0,0,26112,8,8592556939
5459,22424040,51217841,73641881,2,0,1,1536,15,5236219557
5460,22430710,32171693,54602403,3,0,0,36352,12,82483747
5461,22432860,31686344,54119204,6,0,0,10752,5,6176194527
5462,22434170,31630890,54065060,6,0,0,7680,5,1622395803
5463,22434240,31636243,54070483,2,0,0,11264,15,8517896513
5464,22441530,31781096,54222626,3,0,0,13312,12,5971082620
5465,22444810,32349322,54794132,5,0,0,7680,8,32004854
5466,22450000,32092202,54542202,4,0,0,33280,4,3395785200
5467,22451831,51190073,73641904,7,0,1,2560,8,726688657
5468,22455500,32241460,54696960,3,0,0,10752,12,10553115164
5469,22456460,51185467,73641927,2,0,1,512,15,8263346591
5470,22464100,51177850,73641950,9,0,1,1024,19,266225378
5471,22472990,32028936,54501926,4,0,0,6144,4,5650756163
5472,22475600,31999117,54474717,9,0,0,29184,19,5596865997
5473,22477440,32396494,54873934,3,0,0,6144,12,9055933744
5474,22480100,31778319,54258419,6,0,0,40960,5,1900458799
5475,22490030,32644535,55134565,5,0,0,7680,8,2344389873
5476,22490720,31937375,54428095,3,0,0,42496,12,10693815871
5477,22492330,32367605,54859935,9,0,0,135680,19,6316163742
5478,22495070,32509020,55004090,9,0,0,51200,19,1821794566
5479,22501080,32063456,54564536,7,0,0,27136,8,3887313575
5480,22505490,51137754,73643244,9,0,1,4608,19,5533396326
5481,22511260,51139128,73650388,6,0,1,7680,5,4136533764
5482,22514040,32805253,55319293,0,0,0,24064,5,7878244161
5483,22520650,31626215,54146865,0,0,0,11264,5,3126320391
5484,22525580,32266189,54791769,4,0,0,23552,4,509152593
5485,22527859,51147932,73675791,1,0,1,11776,14,7172875254
5486,22531440,51148217,73679657,0,0,1,6144,5,5701305220
5487,22545100,31819061,54364161,7,0,0,5120,8,7527861630
5488,22554760,32314870,54869630,7,0,0,31744,8,9437983335
5489,22562420,32331986,54894406,6,0,0,34304,5,8738673153
5490,22569200,32593988,55163188,5,0,0,23552,8,3349169714
5491,22572600,32118084,54690684,9,0,0,5120,19,9793283685
5492,22573250,32415217,54988467,3,0,0,26112,12,5736052256
5493,22573340,31813038,54386378,5,0,0,2048,8,4536979953
5494,22577600,51176074,73753674,2,0,1,2560,15,10068698296
5495,22587330,32614502,55201832,1,0,0,25600,14,967108326
5496,22587880,32309981,54897861,4,0,0,11264,4,2839253575
5497,22589900,32066233,54656133,3,0,0,17408,12,7976778739
5498,22592860,32096241,54689101,9,0,0,39936,19,4728836520
5499,22593310,31881586,54474896,3,0,0,512,12,5423049398
5500,22600120,32465195,55065315,9,0,0,30720,19,6315705132
5501,22600560,31726957,54327517,3,0,0,1024,12,6277457506
5502,22604530,32414449,55018979,0,0,0,48640,5,7300864908
5503,22610440,32370040,54980480,3,0,0,68608,12,8691283623
5504,22611910,32170982,54782892,0,0,0,11776,5,4701706383
5505,22615550,32516652,55132202,1,0,0,109056,14,9848221375
5506,22616460,51140097,73756557,9,0,1,13312,19,4472837121
5507,22617350,32259617,54876967,4,0,0,3072,4,4528367311
5508,22620701,51374899,73995600,5,0,1,1024,8,4205634008
5509,22623240,31806594,54429834,6,0,0,5632,5,756986014
5510,22636179,51359444,73995623,8,0,1,9728,13,10193955920
5511,22637190,32767667,55404857,2,0,0,19456,15,6799695077
5512,22637730,51357916,73995646,6,0,1,1024,5,3596386707
5513,22647580,32682006,55329586,3,0,0,7680,12,10011788737
5514,22653440,32306113,54959553,1,0,0,30720,14,376040022
5515,22657580,51349843,74007423,0,0,1,6656,5,4455040149
5516,22659960,32151105,54811065,9,0,0,19456,19,2895697107
5517,22661500,32638592,55300092,1,0,0,101376,14,7557483398
5518,22693840,32761814,55455654,7,0,0,6144,8,1681333469
5519,22694090,32043407,54737497,0,0,0,8704,5,1805873286
5520,22696660,32615247,55311907,5,0,0,38400,8,10414108576
5521,22698560,32080698,54779258,0,0,0,10752,5,8964219935
5522,22709370,32205140,54914510,0,0,0,16896,5,3729477337
5523,22710670,31981285,54691955,8,0,0,4096,13,3095818933
5524,22712190,32045681,54757871,4,0,0,9728,4,5364074384
5525,22715030,32478948,55193978,3,0,0,22528,12,6405699879
5526,22725240,32837338,55562578,1,0,0,12800,14,4656595148
5527,22726180,51561338,74287518,3,0,1,16384,12,10543944765
5528,22727511,51595576,74323087,5,0,1,10752,8,1129453305
5529,22740141,51620826,74360967,7,0,1,3072,8,4036834631
5530,22744550,32305870,55050420,0,0,0,21504,5,3003552671
5531,22744590,32671545,55416135,5,0,0,14848,8,6882418199
5532,22747459,51613854,74361313,1,0,1,512,14,8463759345
5533,22758500,32794196,55552696,6,0,0,14848,5,2028637941
5534,22760410,32719379,55479789,0,0,0,39424,5,1461733371
5535,22765270,32633636,55398906,2,0,0,71680,15,36881695
5536,22765440,32930749,55696189,1,0,0,26112,14,3525111523
5537,22766070,32974134,55740204,2,0,0,34816,15,2389130181
5538,22770420,33108816,55879236,9,0,0,25088,19,6836340172
5539,22775980,32660471,55436451,0,0,0,9216,5,5686879823
5540,22776740,32099268,54876008,6,0,0,6656,5,6619951732
5541,22781290,32822771,55604061,0,0,0,4608,5,4045319994
5542,22781330,32382349,55163679,5,0,0,1536,8,8390818841
5543,22800290,51588595,74388885,6,0,1,10752,5,9054672120
5544,22802920,51659601,74462521,3,0,1,1024,12,7250508191
5545,22824870,32052611,54877481,4,0,0,1536,4,9559558794
5546,22825440,32046576,54872016,3,0,0,7680,12,2282845354
5547,22830180,32312157,55142337,7,0,0,5120,8,1525881681
5548,22836280,32879688,55715968,7,0,0,19968,8,8716444840
5549,22851430,32937197,55788627,1,0,0,49664,14,4758877951
5550,22857030,51605514,74462544,9,0,1,1536,19,1544013357
5551,22857260,32026663,54883923,7,0,0,20992,8,7025313332
5552,22859000,32176086,55035086,8,0,0,2048,13,10151316968
5553,22863230,32166180,55029410,2,0,0,3584,15,8271081440
5554,22866989,51604547,74471536,1,0,1,1024,14,3067516279
5555,22868630,32698408,55567038,6,0,0,9216,5,4151994630
5556,22868820,32153302,55022122,6,0,0,10240,5,10554135139
5557,22869730,32363021,55232751,6,0,0,18432,5,7618425384
5558,22871400,32582359,55453759,9,0,0,43520,19,190075856
5559,22892510,32745401,55637911,5,0,0,39936,8,873239455
5560,22895780,32431020,55326800,3,0,0,18432,12,8756038073
5561,22895800,32019977,54915777,0,0,0,3584,5,1556893070
5562,22896150,32289202,55185352,2,0,0,14336,15,3478657983
5563,22897070,32899220,55796290,6,0,0,10240,5,418504884
5564,22897660,33073728,55971388,0,0,0,4096,5,10469946916
5565,22897780,33013722,55911502,2,0,0,15360,15,1808128292
5566,22900860,32444964,55345824,3,0,0,19456,12,4315036780
5567,22902280,32538196,55440476,9,0,0,6144,19,10125445856
5568,22905040,32462352,55367392,5,0,0,4608,8,2945523918
5569,22905930,33010092,55916022,2,0,0,11776,15,658412750
5570,22906209,51573665,74479874,8,0,1,17920,13,6988920917
5571,22912770,33214342,56127112,4,0,0,59392,4,8795129115
5572,22914050,32293557,55207607,6,0,0,8704,5,9246760199
5573,22916500,33108487,56024987,7,0,0,16384,8,8062142191
5574,22917530,33305238,56222768,4,0,0,48640,4,3288354284
5575,22920140,32491448,55411588,2,0,0,22016,15,7907145618
5576,22943120,32724523,55667643,2,0,0,37376,15,1255391282
5577,22943560,32205219,55148779,5,0,0,14336,8,5170155670
5578,22954560,32406333,55360893,7,0,0,19456,8,10291812132
5579,22959130,33306805,56265935,1,0,0,9216,14,3206186582
5580,22960430,33068636,56029066,9,0,0,13312,19,4678228805
5581,22961130,32129886,55091016,5,0,0,4096,8,8172937319
5582,22967210,51515850,74483060,0,0,1,3072,5,5112329539
5583,22967350,33839969,56807319,4,0,0,84992,4,6286179371
5584,22969260,32716275,55685535,3,0,0,17408,12,3466271398
5585,22975280,32605220,55580500,6,0,0,4608,5,1614245915
5586,22980240,32155128,55135368,6,0,0,2560,5,9075569269
5587,22983540,32672692,55656232,9,0,0,21504,19,6046409108
5588,22985300,32201791,55187091,5,0,0,5632,8,7938500473
5589,22985321,51553408,74538729,5,0,1,31744,8,792323924
5590,22988170,32384054,55372224,9,0,0,15360,19,7670570609
5591,22988920,32559229,55548149,6,0,0,39936,5,4176933451
5592,22996210,32266043,55262253,6,0,0,13312,5,1831446364
5593,22996880,33341560,56338440,4,0,0,15360,4,2441614312
5594,23000560,32578513,55579073,1,0,0,39424,14,3310112555
5595,23009880,51630980,74640860,3,0,1,23552,12,2770752381
5596,23023609,51684742,74708351,8,0,1,5120,13,613560709
5597,23024790,33069360,56094150,5,0,0,28160,8,3007902918
5598,23033240,33603915,56637155,5,0,0,1024,8,8735795537
5599,23037560,51797379,74834939,0,0,1,17920,5,2332970081
5600,23042840,32515807,55558647,3,0,0,19456,12,7461565102
5601,23046830,51788132,74834962,0,0,1,8192,5,788008750
5602,23047540,32972432,56019972,2,0,0,29184,15,4067482282
5603,23053680,32646174,55699854,3,0,0,4608,12,7417798016
5604,23075790,32598779,55674569,5,0,0,18432,8,8019333667
5605,23075840,33064274,56140114,0,0,0,15872,5,9853953580
5606,23076760,51856185,74932945,0,0,1,18432,5,7617815820
5607,23080610,32422555,55503165,0,0,0,23552,5,672690983
5608,23080939,51852672,74933611,8,0,1,1024,13,916774012
5609,23084800,33123125,56207925,6,0,0,13312,5,4651987160
5610,23102050,33761223,56863273,5,0,0,23040,8,8814864698
5611,23102930,51831667,74934597,3,0,1,1536,12,9865367948
5612,23104590,32583620,55688210,2,0,0,8704,15,9189400976
5613,23112730,32704784,55817514,3,0,0,1024,12,531296720
5614,23113810,33123512,56237322,0,0,0,25088,5,9166982115
5615,23116531,51822892,74939423,5,0,1,7680,8,9648280461
5616,23120740,33043130,56163870,5,0,0,16384,8,8691858620
5617,23124770,32524887,55649657,4,0,0,21504,4,9753902281
5618,23126580,34078084,57204664,5,0,0,157696,8,2881140305
5619,23127069,51836099,74963168,8,0,1,6656,13,7678215546
5620,23136281,51885904,75022185,7,0,1,8192,8,7340508946
5621,23144700,32535508,55680208,6,0,0,18432,5,9657833596
5622,23148290,33427533,56575823,0,0,0,6656,5,7251436014
5623,23151410,32607009,55758419,4,0,0,49152,4,8333472603
5624,23153999,51868209,75022208,1,0,1,1024,14,1738127337
5625,23163060,51859171,75022231,4,0,1,12288,4,4166774210
5626,23164220,32478862,55643082,4,0,0,16896,4,3116130813
5627,23165140,32679111,55844251,2,0,0,8192,15,8622473221
5628,23168740,32413655,55582395,7,0,0,6144,8,4146791713
5629,23171840,32963407,56135247,7,0,0,26624,8,6912391775
5630,23172850,32496080,55668930,4,0,0,4096,4,7154049924
5631,23181360,32904187,56085547,6,0,0,56832,5,426763027
5632,23184150,51921489,75105639,0,0,1,7680,5,1881805875
5633,23184480,33148987,56333467,4,0,0,11264,4,1857500945
5634,23191240,32506064,55697304,9,0,0,3584,19,7793533062
5635,23193520,32597314,55790834,3,0,0,7168,12,4989059731
5636,23198780,33494734,56693514,0,0,0,48128,5,10658967454
5637,23199131,51906531,75105662,5,0,1,2560,8,359212108
5638,23200170,51909454,75109624,6,0,1,6656,5,5645983692
5639,23204340,32999506,56203846,0,0,0,33792,5,9132935688
5640,23213100,34098604,57311704,7,0,0,18432,8,5659427645
5641,23214770,33169750,56384520,2,0,0,15360,15,9303336925
5642,23216560,32789706,56006266,0,0,0,9216,5,2332472496
5643,23217780,32739004,55956784,5,0,0,1536,8,6269032221
5644,23220780,51909210,75129990,0,0,1,512,5,3608093103
5645,23221030,32477389,55698419,3,0,0,3584,12,10310565051
5646,23224910,51905336,75130246,4,0,1,9216,4,2781118667
5647,23229020,32964507,56193527,5,0,0,22016,8,3053886081
5648,23230780,32878213,56108993,5,0,0,48640,8,779416579
5649,23239510,51963967,75203477,6,0,1,7168,5,1670700889
5650,23241220,32755610,55996830,1,0,0,10752,14,4768407172
5651,23246781,52084039,75330820,5,0,1,17920,8,6036818643
5652,23252040,32665721,55917761,6,0,0,5632,5,7182046590
5653,23262080,52131911,75393991,9,0,1,5632,19,8643753380
5654,23265500,32964155,56229655,3,0,0,22528,12,1297775074
5655,23266830,33034187,56301017,2,0,0,33792,15,843332800
5656,23278930,33357882,56636812,0,0,0,87040,5,3007807583
5657,23283890,32664082,55947972,7,0,0,4608,8,5032527816
5658,23299090,34163539,57462629,9,0,0,6144,19,1275007295
5659,23302360,52092825,75395185,3,0,1,12288,12,1792793843
5660,23324140,33249624,56573764,6,0,0,16384,5,813924610
5661,23325350,32723093,56048443,6,0,0,5632,5,9085698313
5662,23334980,34214721,57549701,4,0,0,24576,4,4460196656
5663,23344240,52105746,75449986,3,0,1,5632,12,6998345956
5664,23346790,52104272,75451062,3,0,1,13312,12,529817565
5665,23352430,32612768,55965198,5,0,0,12800,8,2790254484
5666,23360400,32826396,56186796,2,0,0,28160,15,6668375933
5667,23365170,32938834,56304004,6,0,0,9728,5,8455122287
5668,23368270,33115651,56483921,9,0,0,17408,19,7126934153
5669,23374360,32978611,56352971,1,0,0,7168,14,7034906299
5670,23395260,33308664,56703924,7,0,0,512,8,8503389932
5671,23403360,52048048,75451408,9,0,1,512,19,8910256593
5672,23403930,33183312,56587242,0,0,0,37376,5,7950163042
5673,23409450,32917319,56326769,2,0,0,3584,15,2718324017
5674,23409790,33145341,56555131,2,0,0,131584,15,8540464574
5675,23418020,33307353,56725373,0,0,0,41984,5,3222761958
5676,23421190,32621190,56042380,5,0,0,5632,8,4565985956
5677,23422460,52310840,75733300,0,0,1,12288,5,1453373641
5678,23428130,32531974,55960104,0,0,0,4096,5,8552978129
5679,23433510,32984645,56418155,9,0,0,60416,19,8493489149
5680,23433910,33073856,56507766,2,0,0,8192,15,3843945939
5681,23438920,33483629,56922549,2,0,0,46592,15,10457891907
5682,23446850,52289036,75735886,2,0,1,4096,15,5440855321
5683,23447650,33326520,56774170,5,0,0,19456,8,289341919
5684,23447720,32982938,56430658,3,0,0,40960,12,8892298700
5685,23447979,52290173,75738152,1,0,1,3584,14,8533672283
5686,23452590,33139511,56592101,2,0,0,15872,15,6156312224
5687,23453660,33188198,56641858,1,0,0,15360,14,8119449851
5688,23455640,33137896,56593536,1,0,0,4608,14,10363031168
5689,23464970,32999163,56464133,1,0,0,12800,14,9732657732
5690,23468190,52284058,75752248,9,0,1,5120,19,4690662158
5691,23472330,34123075,57595405,4,0,0,19456,4,3789034010
5692,23473190,32784088,56257278,6,0,0,16384,5,4350402686
5693,23481250,33255378,56736628,6,0,0,36864,5,7150933666
5694,23484890,52267381,75752271,9,0,1,20992,19,4445851760
5695,23487410,33732588,57219998,0,0,0,38400,5,9522407702
5696,23491230,34236685,57727915,0,0,0,30208,5,5292920629
5697,23491711,52328418,75820129,7,0,1,4608,8,3727766180
5698,23499329,52337873,75837202,1,0,1,14336,14,8460037945
5699,23499370,32960840,56460210,1,0,0,39936,14,1169238864
5700,23509570,32732619,56242189,2,0,0,10240,15,4643189254
5701,23510520,32776620,56287140,2,0,0,22528,15,8934574744
5702,23513250,52413070,75926320,0,0,1,19968,5,52145154
5703,23523300,33699529,57222829,7,0,0,9216,8,6917138432
5704,23524460,32909840,56434300,8,0,0,7680,13,4586758113
5705,23525440,33373172,56898612,5,0,0,53760,8,4291586998
5706,23529900,32902029,56431929,3,0,0,4096,12,7682048859
5707,23531210,33037539,56568749,2,0,0,39424,15,596295686
5708,23532950,33276740,56809690,2,0,0,7680,15,5175186413
5709,23534531,52391943,75926474,7,0,1,8704,8,2967172282
5710,23536660,32860045,56396705,5,0,0,23552,8,7601864571
5711,23543300,33056834,56600134,2,0,0,2560,15,3754643599
5712,23543600,33572046,57115646,7,0,0,3072,8,5123364621
5713,23552310,33223911,56776221,9,0,0,6656,19,4731361001
5714,23554959,52415243,75970202,8,0,1,1536,13,7210017824
5715,23558330,33253099,56811429,5,0,0,5632,8,8518236823
5716,23572679,52414417,75987096,1,0,1,5632,14,7382070187
5717,23576260,33034009,56610269,3,0,0,21504,12,8247653497
5718,23583349,52403770,75987119,1,0,1,5632,14,1733302112
5719,23585580,33644635,57230215,3,0,0,20992,12,3823794330
5720,23589830,33318500,56908330,7,0,0,20480,8,6308627894
5721,23594510,33004821,56599331,3,0,0,18944,12,6883681575
5722,23595440,33400672,56996112,1,0,0,12288,14,521265629
5723,23604210,33238043,56842253,2,0,0,17408,15,1435246236
5724,23621910,33318546,56940456,0,0,0,24064,5,3520483566
5725,23625330,33780764,57406094,6,0,0,24064,5,3330909324
5726,23629290,33693521,57322811,9,0,0,36352,19,8401300374
5727,23639170,52377418,76016588,9,0,1,9728,19,3053555319
5728,23645440,33256627,56902067,3,0,0,11264,12,10471504596
5729,23646370,33380906,57027276,7,0,0,74240,8,10341450739
5730,23659240,33283914,56943154,3,0,0,8192,12,6745031033
5731,23659470,33042208,56701678,3,0,0,8192,12,4255732575
5732,23667520,33306087,56973607,3,0,0,10240,12,4862082046
5733,23674300,34148625,57822925,0,0,0,1024,5,2864814671
5734,23691880,33460434,57152314,6,0,0,27648,5,6521690359
5735,23695539,52321072,76016611,8,0,1,8704,13,207164592
5736,23696090,33115518,56811608,9,0,0,512,19,4676451263
5737,23697830,33083562,56781392,9,0,0,16896,19,2141123184
5738,23705160,33363233,57068393,5,0,0,11264,8,9050521216
5739,23706300,33220484,56926784,2,0,0,13824,15,3226978087
5740,23711490,33743441,57454931,5,0,0,107520,8,4454294066
5741,23712850,33623498,57336348,0,0,0,1536,5,3048242744
5742,23721870,33046349,56768219,2,0,0,24576,15,3245483405
5743,23726510,52290124,76016634,0,0,1,9216,5,8754663231
5744,23732120,52335797,76067917,9,0,1,5120,19,1324084034
5745,23734020,33078703,56812723,8,0,0,3584,13,430007424
5746,23738360,32818354,56556714,0,0,0,5120,5,9954933405
5747,23745631,52383104,76128735,5,0,1,1024,8,5104148950
5748,23754870,33116611,56871481,1,0,0,4608,14,565879362
5749,23755911,52470082,76225993,7,0,1,9728,8,3671468307
5750,23757270,33921005,57678275,5,0,0,53248,8,5318960084
5751,23760400,33280361,57040761,9,0,0,40960,19,9148790139
5752,23764690,33188422,56953112,7,0,0,18944,8,4701071261
5753,23770880,33343807,57114687,6,0,0,13824,5,718301274
5754,23771010,32898247,56669257,8,0,0,26112,13,8702030608
5755,23777110,33528955,57306065,8,0,0,2048,13,2522574813
5756,23777190,33761381,57538571,7,0,0,24576,8,2116921824
5757,23782049,52539414,76321463,1,0,1,12800,14,504110963
5758,23783050,52557294,76340344,2,0,1,3584,15,4577924716
5759,23784760,33175664,56960424,5,0,0,1024,8,796004594
5760,23786700,52553667,76340367,0,0,1,6144,5,3538943659
5761,23789210,34166512,57955722,6,0,0,18432,5,6379747403
5762,23792120,33627509,57419629,0,0,0,31744,5,6203860751
5763,23792880,33317572,57110452,4,0,0,80384,4,9524761532
5764,23799460,52540930,76340390,4,0,1,10752,4,8056959367
5765,23805680,52612052,76417732,6,0,1,9216,5,1938612064
5766,23806860,33436794,57243654,6,0,0,9728,5,9467061457
5767,23810810,33333057,57143867,6,0,0,45056,5,4108590707
5768,23814921,52622297,76437218,5,0,1,16384,8,6023691499
5769,23817550,52631991,76449541,2,0,1,14848,15,5208122760
5770,23827260,33455550,57282810,3,0,0,15872,12,2001187957
5771,23828310,33671184,57499494,9,0,0,31744,19,7743041528
5772,23833190,52707827,76541017,4,0,1,9216,4,7612006638
5773,23834480,33438320,57272800,9,0,0,21504,19,6719844206
5774,23841561,52699479,76541040,5,0,1,4608,8,2037035095
5775,23849580,52715763,76565343,6,0,1,27136,5,6862411916
5776,23851760,33088875,56940635,2,0,0,512,15,2022784302
5777,23852190,34323882,58176072,8,0,0,29696,13,1402011944
5778,23854891,52731451,76586342,5,0,1,4608,8,10537932138
5779,23856200,33076855,56933055,1,0,0,20480,14,10150779984
5780,23865660,33254377,57120037,7,0,0,14336,8,6586827924
5781,23867590,33078099,56945689,7,0,0,8192,8,6141920199
5782,23873470,33992176,57865646,4,0,0,12800,4,961433885
5783,23879730,33181199,57060929,9,0,0,20992,19,2481731681
5784,23884950,52902845,76787795,8,0,1,43008,13,278060976
5785,23903440,33518708,57422148,4,0,0,8192,4,4638733700
5786,23906890,34073247,57980137,1,0,0,4096,14,8989795628
5787,23917410,33110825,57028235,5,0,0,3072,8,2792153527
5788,23918330,52937048,76855378,8,0,1,25600,13,8573298548
5789,23921471,53003028,76924499,5,0,1,6656,8,8577891852
5790,23929830,33344085,57273915,5,0,0,3584,8,1715333916
5791,23936470,34401488,58337958,1,0,0,20480,14,5600493378
5792,23939700,33383758,57323458,6,0,0,2048,5,7854374138
5793,23948580,33356838,57305418,9,0,0,46080,19,788691375
5794,23951731,53145275,77097006,7,0,1,23552,8,3406287515
5795,23954400,33576652,57531052,1,0,0,58880,14,7147904636
5796,23958440,33554649,57513089,0,0,0,44544,5,4742448405
5797,23958580,33249695,57208275,7,0,0,11776,8,2584401924
5798,23958700,33627143,57585843,4,0,0,38400,4,4949816488
5799,23961370,33262418,57223788,9,0,0,3072,19,1371486813
5800,23971200,33384324,57355524,1,0,0,12800,14,3784399834
5801,23971740,33318581,57290321,1,0,0,24576,14,10273848729
5802,23971820,33495402,57467222,4,0,0,9216,4,5333179606
5803,23972131,53157379,77129510,7,0,1,4608,8,9289702454
5804,23973810,33688149,57661959,7,0,0,121856,8,4907270517
5805,23974540,53154993,77129533,3,0,1,9728,12,4298646686
5806,23977130,33483604,57460734,5,0,0,18944,8,7247952117
5807,23979290,33610164,57589454,3,0,0,11776,12,1012926903
5808,23981780,34049448,58031228,7,0,0,71168,8,2982128392
5809,23982760,34694637,58677397,9,0,0,32256,19,6556324923
5810,23988530,53149745,77138275,9,0,1,4096,19,10613462171
5811,23994670,33942469,57937139,8,0,0,55296,13,3439625347
5812,23995410,33756986,57752396,7,0,0,10240,8,4188417056
5813,24006740,53177880,77184620,3,0,1,6656,12,9789914217
5814,24007030,53179968,77186998,0,0,1,1024,5,4411560206
5815,24014350,53174274,77188624,2,0,1,2560,15,7402857765
5816,24023190,53168020,77191210,3,0,1,4096,12,8997513884
5817,24026690,34719484,58746174,6,0,0,33792,5,9517126915
5818,24030240,33653237,57683477,5,0,0,16896,8,10539597905
5819,24035380,33427584,57462964,6,0,0,1024,5,3305603861
5820,24036859,53155017,77191876,1,0,1,1024,14,8119726364
5821,24039280,33793402,57832682,4,0,0,3072,4,8967386806
5822,24040240,33758708,57798948,3,0,0,4096,12,7863285315
5823,24047560,53152433,77199993,3,0,1,5632,12,3311541561
5824,24057500,53143159,77200659,0,0,1,1024,5,4884855557
5825,24057690,53146195,77203885,3,0,1,5120,12,1634409663
5826,24063440,53191798,77255238,0,0,1,15872,5,8450897416
5827,24066510,53297972,77364482,0,0,1,9216,5,137699586
5828,24069340,33395051,57464391,6,0,0,4608,5,2494312597
5829,24075440,33745567,57821007,3,0,0,56832,12,6379399806
5830,24076710,34064334,58141044,0,0,0,58880,5,6112135711
5831,24079950,33252414,57332364,7,0,0,3584,8,9786362917
5832,24080810,53292993,77373803,3,0,1,7680,12,1307292910
5833,24086970,33308503,57395473,7,0,0,23040,8,10342253563
5834,24088790,34009165,58097955,0,0,0,76288,5,2989665449
5835,24097711,53346839,77444550,5,0,1,1024,8,965643582
5836,24097720,33850921,57948641,8,0,0,11264,13,3361288124
5837,24098029,53346544,77444573,1,0,1,1024,14,2915861283
5838,24098180,33387231,57485411,6,0,0,2048,5,7359246724
5839,24107330,33360227,57467557,6,0,0,1024,5,809812166
5840,24115740,34196440,58312180,6,0,0,39936,5,5766880710
5841,24120490,33598198,57718688,8,0,0,24064,13,8306280863
5842,24128160,33414022,57542182,3,0,0,11776,12,8902054116
5843,24130540,34776401,58906941,5,0,0,44544,8,7510559777
5844,24136640,33685950,57822590,0,0,0,5120,5,5291568721
5845,24136711,53348252,77484963,5,0,1,2048,8,10048135042
5846,24141011,53343975,77484986,7,0,1,2560,8,8339192793
5847,24141170,33558043,57699213,7,0,0,1024,8,3896204269
5848,24144200,33608687,57752887,5,0,0,1536,8,9127363938
5849,24145120,34140510,58285630,0,0,0,7168,5,1008894863
5850,24145950,34521596,58667546,4,0,0,110080,4,5384875577
5851,24146220,35016452,59162672,5,0,0,44032,8,1588436255
5852,24149040,53335969,77485009,8,0,1,9728,13,1219925205
5853,24149620,33458464,57608084,8,0,0,3072,13,4890154662
5854,24150600,33787186,57937786,1,0,0,2048,14,3011964248
5855,24151660,33827206,57978866,5,0,0,62976,8,9661139350
5856,24152361,53332671,77485032,7,0,1,3584,8,7092317741
5857,24159230,33674764,57833994,8,0,0,3584,13,2615428705
5858,24166450,33774323,57940773,5,0,0,9728,8,1194082898
5859,24170900,53343251,77514151,2,0,1,22528,15,3489637843
5860,24171020,33672262,57843282,8,0,0,18944,13,2956431165
5861,24175010,34266636,58441646,0,0,0,36352,5,164008147
5862,24176950,53532132,77709082,2,0,1,16384,15,1508356756
5863,24178160,34018416,58196576,6,0,0,41984,5,5244245702
5864,24178870,34198815,58377685,7,0,0,104448,8,3133299709
5865,24183980,33570802,57754782,3,0,0,6144,12,3532032852
5866,24184250,34524081,58708331,3,0,0,88576,12,6312823526
5867,24187410,53547507,77734917,4,0,1,3584,4,5414895016
5868,24190640,34358411,58549051,8,0,0,20480,13,5320971636
5869,24191171,53565271,77756442,5,0,1,3584,8,10544113501
5870,24198211,53562737,77760948,5,0,1,7168,8,9737416500
5871,24205760,33913925,58119685,3,0,0,45056,12,1952438780
5872,24224350,35222346,59446696,3,0,0,1024,12,3964145226
5873,24226530,33985068,58211598,4,0,0,15872,4,1258915497
5874,24234050,33910422,58144472,4,0,0,2048,4,8610140164
5875,24235360,53659161,77894521,2,0,1,24576,15,2679586035
5876,24242960,33644509,57887469,8,0,0,6656,13,5495559384
5877,24245920,34501533,58747453,1,0,0,4096,14,5203759879
5878,24248570,53645974,77894544,6,0,1,5632,5,4853656366
5879,24251110,34223360,58474470,4,0,0,35328,4,513812124
5880,24258310,34141985,58400295,9,0,0,66048,19,3756817288
5881,24266420,33839514,58105934,3,0,0,26112,12,6248256873
5882,24266860,34722250,58989110,0,0,0,189440,5,6078699058
5883,24274520,35479389,59753909,2,0,0,136704,15,5871798953
5884,24285510,53611420,77896930,6,0,1,4096,5,6965766045
5885,24294630,33912109,58206739,4,0,0,33280,4,1710901714
5886,24297260,33964878,58262138,0,0,0,29184,5,1968104173
5887,24297820,34477705,58775525,0,0,0,21504,5,1473675487
5888,24299300,33984100,58283400,4,0,0,65536,4,3040616161
5889,24299480,35284878,59584358,0,0,0,40960,5,2846970460
5890,24306640,53590313,77896953,9,0,1,3584,19,6949200431
5891,24307520,34712335,59019855,0,0,0,6144,5,6383885044
5892,24322760,33973310,58296070,6,0,0,7680,5,7277813186
5893,24326940,34053131,58380071,3,0,0,7680,12,4852471081
5894,24328980,33836004,58164984,5,0,0,21504,8,660316269
5895,24332811,53605428,77938239,7,0,1,7680,8,3085509486
5896,24337890,53654246,77992136,4,0,1,19456,4,9726670826
5897,24342790,33889007,58231797,4,0,0,5120,4,6338943285
5898,24346460,53832806,78179266,9,0,1,5120,19,1226303130
5899,24350500,33993580,58344080,4,0,0,4608,4,1103728387
5900,24352120,34363730,58715850,5,0,0,24576,8,1901414021
5901,24356750,34263383,58620133,7,0,0,5632,8,9678486147
5902,24357320,35687266,60044586,3,0,0,11264,12,1420721499
5903,24370930,34036275,58407205,3,0,0,16896,12,7209475306
5904,24379060,34084623,58463683,4,0,0,27648,4,6974971011
5905,24382290,34059535,58441825,1,0,0,512,14,2407702379
5906,24390070,34052901,58442971,9,0,0,512,19,2369678552
5907,24390820,53816332,78207152,9,0,1,15360,19,7702576230
5908,24391840,34010194,58402034,1,0,0,5632,14,7566403259
5909,24392440,34083324,58475764,3,0,0,4096,12,4214615149
5910,24395550,34020520,58416070,4,0,0,11776,4,6447502798
5911,24400020,34205113,58605133,4,0,0,66048,4,8305860676
5912,24401141,53901668,78302809,7,0,1,30208,8,3779794309
5913,24403740,53904406,78308146,4,0,1,5120,4,4837133958
5914,24409080,34145669,58554749,1,0,0,10240,14,9512232129
5915,24414450,34731157,59145607,9,0,0,35840,19,5620910403
5916,24415040,34155401,58570441,9,0,0,30208,19,10569633206
5917,24426510,53884351,78310861,8,0,1,7680,13,272324438
5918,24432220,34090980,58523200,4,0,0,19456,4,2978500586
5919,24432920,34287756,58720676,6,0,0,15360,5,10038913647
5920,24443910,34291921,58735831,9,0,0,49664,19,4315321908
5921,24448580,34443339,58891919,9,0,0,39424,19,2502533893
5922,24451580,34591173,59042753,4,0,0,56320,4,3586763200
5923,24452840,35676460,60129300,5,0,0,20992,8,7078431780
5924,24456609,53854918,78311527,1,0,1,1024,14,6888316186
5925,24460180,34629675,59089855,1,0,0,15872,14,4188973530
5926,24460270,34391163,58851433,6,0,0,35328,5,6223946575
5927,24460290,34863958,59324248,6,0,0,67584,5,8589308855
5928,24462210,33980574,58442784,5,0,0,3072,8,99794647
5929,24464560,34216760,58681320,5,0,0,12800,8,9006530488
5930,24465720,35058675,59524395,0,0,0,65024,5,2096884894
5931,24466130,34551175,59017305,8,0,0,23040,13,4497477674
5932,24467850,34149018,58616868,8,0,0,5120,13,468245196
5933,24470820,53864152,78334972,2,0,1,9728,15,5829117880
5934,24476210,34608786,59084996,6,0,0,67072,5,5268475517
5935,24476530,34533732,59010262,4,0,0,4608,4,7938420566
5936,24479230,34081984,58561214,8,0,0,3072,13,1585008409
5937,24480450,35831127,60311577,1,0,0,61440,14,10533519905
5938,24492210,34343815,58836025,5,0,0,5120,8,10595654606
5939,24498080,34551271,59049351,4,0,0,21504,4,10010556839
5940,24498830,34297523,58796353,2,0,0,23040,15,9210276661
5941,24507880,34706805,59214685,0,0,0,19456,5,8557714318
5942,24509800,53839223,78349023,6,0,1,1536,5,8327129752
5943,24514410,34866083,59380493,8,0,0,40960,13,4968636730
5944,24516470,35084406,59600876,0,0,0,24576,5,8434298772
5945,24517240,34472673,58989913,8,0,0,2560,13,7754541042
5946,24519030,34498930,59017960,3,0,0,2048,12,2873568340
5947,24520220,53828826,78349046,9,0,1,9728,19,6287276610
5948,24523230,35067102,59590332,4,0,0,13824,4,5459556820
5949,24524160,34286100,58810260,8,0,0,45568,13,821404293
5950,24526650,34482185,59008835,1,0,0,53248,14,4939107498
5951,24540121,53887624,78427745,7,0,1,2560,8,3757520447
5952,24543080,35088925,59632005,1,0,0,51712,14,10577325193
5953,24545410,53882358,78427768,2,0,1,14336,15,1285881731
5954,24546650,35227117,59773767,3,0,0,16896,12,2591745250
5955,24552601,53996510,78549111,7,0,1,2048,8,6435555943
5956,24557810,34506696,59064506,0,0,0,49664,5,2445558039
5957,24557860,34671829,59229689,5,0,0,42496,8,8828266705
5958,24560441,54054189,78614630,5,0,1,4096,8,9331380520
5959,24562840,54051813,78614653,6,0,1,512,5,2419199613
5960,24563020,54065586,78628606,9,0,1,6656,19,6543682805
5961,24566370,34342154,58908524,1,0,0,5120,14,8907936898
5962,24570821,54057808,78628629,5,0,1,4608,8,3262322089
5963,24578310,54050342,78628652,6,0,1,1024,5,9211986561
5964,24581250,35805481,60386731,1,0,0,6144,14,310400335
5965,24581760,34311586,58893346,0,0,0,4608,5,10453364720
5966,24583721,54073127,78656848,5,0,1,5120,8,6471947578
5967,24583870,54098090,78681960,6,0,1,23040,5,10578600763
5968,24590310,54148881,78739191,0,0,1,5120,5,10644746004
5969,24591510,34757837,59349347,7,0,0,35840,8,2590431729
5970,24593860,34839122,59432982,4,0,0,8192,4,704758701
5971,24595110,34851251,59446361,7,0,0,11776,8,2170068285
5972,24595360,54144292,78739652,4,0,1,10240,4,4930450120
5973,24595460,34513986,59109446,6,0,0,47104,5,956305008
5974,24597330,35306900,59904230,7,0,0,12288,8,7701540590
5975,24598980,34514233,59113213,1,0,0,12288,14,6628094785
5976,24600790,34653687,59254477,3,0,0,22528,12,1559044497
5977,24606720,34964020,59570740,6,0,0,125440,5,7084798735
5978,24612340,35402152,60014492,0,0,0,65536,5,9455337431
5979,24615670,34888890,59504560,7,0,0,56832,8,6505341170
5980,24616140,54143965,78760105,9,0,1,1536,19,6798696609
5981,24624860,34367728,58992588,9,0,0,8704,19,7958346628
5982,24626700,35545833,60172533,4,0,0,68096,4,1216159590
5983,24640140,34825433,59465573,7,0,0,14336,8,5953741868
5984,24644070,34767374,59411444,5,0,0,61952,8,4168176753
5985,24653670,34513861,59167531,5,0,0,15872,8,10362988553
5986,24656610,34635420,59292030,1,0,0,1536,14,610735796
5987,24658990,34460798,59119788,1,0,0,21504,14,7947312380
5988,24662770,54129439,78792209,6,0,1,31744,5,10548725249
5989,24663291,54133430,78796721,7,0,1,5120,8,3427705362
5990,24669760,34817461,59487221,9,0,0,68608,19,10541994600
5991,24675090,34565815,59240905,8,0,0,9728,13,6236968073
5992,24692610,34637415,59330025,5,0,0,4608,8,2066018943
5993,24698440,35070156,59768596,5,0,0,48128,8,7203528452
5994,24699680,54158304,78857984,0,0,1,13824,5,5006220070
5995,24713700,34471105,59184805,3,0,0,2048,12,3153413019
5996,24717870,34919314,59637184,5,0,0,16896,8,9706479021
5997,24720200,34895527,59615727,3,0,0,48640,12,2457492260
5998,24720990,34869833,59590823,8,0,0,1536,13,7688739265
5999,24733290,54161078,78894368,4,0,1,10752,4,4822278452
6000,24741210,34790141,59531351,7,0,0,22528,8,2002820017
6001,24749520,34836577,59586097,7,0,0,5632,8,1749777876
6002,24755140,34838225,59593365,0,0,0,6144,5,3498557825
6003,24756361,54138673,78895034,5,0,1,1024,8,9568450185
6004,24759190,34773307,59532497,0,0,0,3584,5,8989642010
6005,24763960,54157059,78921019,4,0,1,9728,4,5072216502
6006,24765080,54163963,78929043,4,0,1,21504,4,9820556460
6007,24768500,54215166,78983666,2,0,1,7168,15,3807023814
6008,24772180,35061835,59834015,3,0,0,15360,12,9518650453
6009,24777160,35007087,59784247,9,0,0,11264,19,1717517894
6010,24780329,54221781,79002110,1,0,1,5632,14,1075287010
6011,24783861,54226458,79010319,7,0,1,2560,8,4353839195
6012,24786580,35019998,59806578,8,0,0,73216,13,1154921267
6013,24787160,34868143,59655303,5,0,0,59392,8,8356393755
6014,24788540,54532531,79321071,8,0,1,100352,13,7014270158
6015,24788750,35363012,60151762,4,0,0,22528,4,8714412821
6016,24797060,35288901,60085961,1,0,0,41472,14,7172947413
6017,24802740,54599657,79402397,9,0,1,25600,19,10265062936
6018,24802950,35069901,59872851,9,0,0,10752,19,3024337695
6019,24803890,34858552,59662442,7,0,0,10240,8,5754778297
6020,24814660,35500216,60314876,1,0,0,10752,14,1269747491
6021,24816710,34755145,59571855,5,0,0,3584,8,1990807057
6022,24818490,35007136,59825626,8,0,0,26112,13,1312849825
6023,24823560,34847667,59671227,9,0,0,13312,19,1655921044
6024,24825430,54587711,79413141,9,0,1,4608,19,9718313408
6025,24826390,35656415,60482805,0,0,0,6144,5,1084134747
6026,24827740,34953052,59780792,0,0,0,22528,5,4579893349
6027,24832530,54584157,79416687,2,0,1,5632,15,3730071109
6028,24842110,35739165,60581275,4,0,0,33792,4,3554423309
6029,24845140,54575093,79420233,2,0,1,5632,15,2322993417
6030,24854000,35207725,60061725,1,0,0,23040,14,6372578924
6031,24856830,34734640,59591470,3,0,0,2048,12,7893236245
6032,24866930,34749296,59616226,6,0,0,1536,5,10186032024
6033,24879400,35234650,60114050,9,0,0,22016,19,6054115546
6034,24884920,35075189,59960109,0,0,0,38912,5,8812578267
6035,24885830,35187472,60073302,7,0,0,9728,8,4574696515
6036,24891280,35172652,60063932,9,0,0,7168,19,3014104853
6037,24900031,54522148,79422179,5,0,1,3072,8,8922651338
6038,24909530,35590944,60500474,6,0,0,42496,5,5840941705
6039,24913730,35471106,60384836,1,0,0,6144,14,5987129853
6040,24914900,35507256,60422156,6,0,0,59392,5,1736944425
6041,24915370,35339548,60254918,7,0,0,24064,8,2741110674
6042,24916670,35000364,59917034,7,0,0,1536,8,4466214568
6043,24925080,35307773,60232853,4,0,0,19456,4,10504793006
6044,24929520,35392087,60321607,6,0,0,22016,5,9006292687
6045,24935490,35955263,60890753,6,0,0,49152,5,10009246264
6046,24936070,54503664,79439734,9,0,1,4608,19,1031354993
6047,24943100,54496657,79439757,9,0,1,2560,19,3477394413
6048,24955020,35574794,60529814,3,0,0,27136,12,3684244711
6049,24960620,34985240,59945860,1,0,0,14848,14,2832746473
6050,24966060,35760409,60726469,5,0,0,26112,8,3544130072
6051,24970620,35615670,60586290,3,0,0,16384,12,9384943711
6052,24972900,34968413,59941313,3,0,0,58880,12,322743336
6053,24973060,54466720,79439780,2,0,1,14336,15,10701689819
6054,24979000,35399946,60378946,4,0,0,23552,4,9978935175
6055,24984710,35242192,60226902,1,0,0,52736,14,9180821544
6056,24987850,35583106,60570956,6,0,0,30720,5,7792503396
6057,25011110,34936645,59947755,1,0,0,6144,14,4904762507
6058,25016801,54547451,79564252,7,0,1,6656,8,3393050957
6059,25019990,35370089,60390079,8,0,0,5120,13,10669442434
6060,25020030,54544245,79564275,9,0,1,2048,19,2854752771
6061,25025560,35112563,60138123,0,0,0,23040,5,3908359617
6062,25031840,35234709,60266549,5,0,0,13824,8,4304105497
6063,25036940,35070379,60107319,8,0,0,34816,13,126548212
6064,25053310,35404534,60457844,6,0,0,49152,5,5267690380
6065,25056250,35315497,60371747,0,0,0,35328,5,4483068976
6066,25056800,35135820,60192620,0,0,0,7680,5,4884984811
6067,25059500,35445388,60504888,4,0,0,10752,4,856783673
6068,25059510,35273984,60333494,9,0,0,38912,19,5721741254
6069,25064080,34953711,60017791,3,0,0,10752,12,1354358404
6070,25064760,35374671,60439431,7,0,0,14336,8,3290704337
6071,25067000,35173231,60240231,1,0,0,9216,14,6667583526
6072,25068920,35920407,60989327,7,0,0,18944,8,1418936082
6073,25078900,35548229,60627129,0,0,0,6144,5,6707082796
6074,25081240,54483058,79564298,2,0,1,512,15,3111471086
6075,25083900,35578538,60662438,6,0,0,42496,5,3571873891
6076,25085480,35603730,60689210,2,0,0,19456,15,8862093446
6077,25085640,35511437,60597077,8,0,0,35328,13,8166189496
6078,25089620,54479583,79569203,9,0,1,7680,19,68127585
6079,25089821,54479421,79569242,5,0,1,4096,8,2914829937
6080,25103890,35322657,60426547,5,0,0,14336,8,7585173476
6081,25106860,35136670,60243530,0,0,0,10752,5,7482592240
6082,25110000,35502856,60612856,1,0,0,51712,14,8656577202
6083,25111250,35292787,60404037,4,0,0,40448,4,3765379962
6084,25113690,35123710,60237400,0,0,0,14848,5,3597841598
6085,25114900,36145176,61260076,8,0,0,25088,13,10283752005
6086,25120650,35650466,60771116,8,0,0,19968,13,4735266147
6087,25121780,35793330,60915110,1,0,0,27648,14,9174419348
6088,25124750,54496616,79621366,8,0,1,12288,13,9041350912
6089,25137970,35671594,60809564,4,0,0,30208,4,6356370265
6090,25140900,54480489,79621389,4,0,1,6656,4,2553748806
6091,25141490,54844717,79986207,2,0,1,22016,15,7536290105
6092,25142480,54875965,80018445,2,0,1,1024,15,9493626666
6093,25143370,54876253,80019623,0,0,1,13824,5,10540148915
6094,25145400,36049658,61195058,8,0,0,142848,13,3291846507
6095,25150620,36131966,61282586,5,0,0,3072,8,9226571082
6096,25151670,35873261,61024931,3,0,0,11776,12,2202977420
6097,25155000,36185499,61340499,0,0,0,6144,5,3944218686
6098,25161039,55100816,80261855,1,0,1,29696,14,3940777098
6099,25183070,35197927,60380997,3,0,0,6656,12,1251070479
6100,25185410,35360761,60546171,9,0,0,16384,19,4716197423
6101,25186550,35323041,60509591,8,0,0,15360,13,3820768086
6102,25193290,35525200,60718490,9,0,0,24064,19,4415286718
6103,25199250,35628557,60827807,5,0,0,10240,8,7350688146
6104,25208860,35569618,60778478,4,0,0,8704,4,9290578419
6105,25212010,35413216,60625226,6,0,0,34816,5,5558545460
6106,25222960,35278629,60501589,4,0,0,3584,4,1816113436
6107,25224730,36234835,61459565,5,0,0,15872,8,10518891546
6108,25248360,35193641,60442001,3,0,0,7680,12,704867361
6109,25252140,35610426,60862566,7,0,0,1024,8,6361086396
6110,25253070,35453226,60706296,8,0,0,28672,13,6705295356
6111,25259880,36141374,61401254,5,0,0,30208,8,2844314162
6112,25267550,35347045,60614595,3,0,0,5632,12,4222133027
6113,25270980,35561374,60832354,6,0,0,14848,5,4179730647
6114,25277500,35498303,60775803,9,0,0,14848,19,7950410190
6115,25278080,36103449,61381529,0,0,0,57344,5,6897605441
6116,25278970,36159652,61438622,3,0,0,25600,12,5144315741
6117,25283740,35387788,60671528,4,0,0,13824,4,2115984860
6118,25287300,36051125,61338425,5,0,0,15872,8,9717429324
6119,25296660,35370633,60667293,2,0,0,7680,15,7235721907
6120,25303870,55234820,80538690,8,0,1,72704,13,3344407827
6121,25308760,35566994,60875754,8,0,0,17408,13,7847332695
6122,25310610,36227427,61538037,8,0,0,70656,13,8633844943
6123,25311250,35749886,61061136,0,0,0,105472,5,2579772640
6124,25326500,35437816,60764316,3,0,0,52736,12,1840668
6125,25336550,36691366,62027916,1,0,0,13312,14,9615682853
6126,25346000,36407699,61753699,3,0,0,89600,12,3699104772
6127,25352630,36535428,61888058,2,0,0,132608,15,9023951157
6128,25355330,35922553,61277883,8,0,0,58368,13,6026643750
6129,25361230,35403421,60764651,7,0,0,1024,8,10367397393
6130,25367230,35885179,61252409,4,0,0,36352,4,8703086958
6131,25367790,36931708,62299498,4,0,0,28160,4,8470465842
6132,25373800,35718464,61092264,3,0,0,25600,12,4410519464
6133,25378200,35765332,61143532,0,0,0,41472,5,4333074893
6134,25382210,35396759,60778969,1,0,0,1536,14,2038796493
6135,25392950,36035042,61427992,0,0,0,52224,5,1982658917
6136,25393520,35590012,60983532,1,0,0,44032,14,1772214936
6137,25395050,35756461,61151511,9,0,0,26112,19,9100538436
6138,25399800,36154819,61554619,3,0,0,29696,12,7659734133
6139,25403490,35406721,60810211,4,0,0,2048,4,3090511288
6140,25404370,36163875,61568245,8,0,0,5120,13,4861302395
6141,25406340,36724523,62130863,6,0,0,49664,5,8177381612
6142,25408760,55176065,80584825,4,0,1,8704,4,1720926460
6143,25419000,37173857,62592857,2,0,0,15360,15,2696759849
6144,25423880,55314324,80738204,0,0,1,115200,5,5331079895
6145,25426150,35776263,61202413,5,0,0,24064,8,9812537314
6146,25428180,35586490,61014670,3,0,0,17920,12,5403214019
6147,25442390,35666918,61109308,1,0,0,14848,14,3261304771
6148,25442420,35969637,61412057,0,0,0,9728,5,6282144502
6149,25444991,55333166,80778157,7,0,1,4096,8,5561608715
6150,25445400,35918634,61364034,1,0,0,17408,14,9507817081
6151,25446310,36735234,62181544,4,0,0,5120,4,2336195133
6152,25450440,36387652,61838092,5,0,0,54784,8,7440085514
6153,25453590,35442081,60895671,6,0,0,12800,5,9412218305
6154,25454710,36913834,62368544,5,0,0,18432,8,4558531376
6155,25456740,35837827,61294567,3,0,0,6656,12,2217319392
6156,25459020,36017587,61476607,5,0,0,13312,8,9917943478
6157,25459630,35745302,61204932,4,0,0,8192,4,8842415624
6158,25462370,37004577,62466947,9,0,0,31744,19,9812744449
6159,25463660,35480922,60944582,6,0,0,7680,5,8507544792
6160,25463990,35600289,61064279,7,0,0,10240,8,1206964675
6161,25470690,36321317,61792007,6,0,0,32256,5,8666701154
6162,25471090,35853717,61324807,0,0,0,24064,5,7382937252
6163,25474650,35842467,61317117,0,0,0,33792,5,8675268597
6164,25475920,37524754,63000674,1,0,0,118272,14,1821038905
6165,25476900,36173789,61650689,6,0,0,38400,5,1974692986
6166,25478459,55301557,80780016,1,0,1,3584,14,9370518879
6167,25481210,35825588,61306798,6,0,0,16896,5,4649671697
6168,25481270,36120911,61602181,3,0,0,63488,12,3031336179
6169,25482280,37271812,62754092,5,0,0,15872,8,4362171198
6170,25482380,35851186,61333566,2,0,0,28672,15,9737792357
6171,25490440,36551874,62042314,4,0,0,32256,4,9155724078
6172,25500420,35707343,61207763,2,0,0,9216,15,9258286936
6173,25507750,36058904,61566654,4,0,0,39424,4,3446116220
6174,25512470,35879557,61392027,3,0,0,8192,12,571165206
6175,25515150,36517313,62032463,0,0,0,14848,5,1747142009
6176,25516070,35776367,61292437,4,0,0,32256,4,3001140689
6177,25518890,36084874,61603764,6,0,0,5120,5,10565149811
6178,25519050,36653533,62172583,9,0,0,9216,19,7007402125
6179,25520810,36381779,61902589,2,0,0,47616,15,7473872711
6180,25525470,36741657,62267127,9,0,0,33792,19,7387571337
6181,25527350,35790102,61317452,4,0,0,1024,4,1266993993
6182,25528590,36244130,61772720,8,0,0,4608,13,1745178120
6183,25535950,36225260,61761210,6,0,0,24576,5,6241274460
6184,25542450,35847058,61389508,1,0,0,26112,14,4458141415
6185,25542990,36854279,62397269,8,0,0,11776,13,10082453111
6186,25548371,55251857,80800228,5,0,1,7680,8,10492965811
6187,25549550,35881249,61430799,0,0,0,7168,5,6351597367
6188,25552210,35786394,61338604,5,0,0,512,8,6746077968
6189,25556640,35904976,61461616,9,0,0,6656,19,1735930124
6190,25559030,36366279,61925309,8,0,0,11776,13,9000929802
6191,25562959,55237292,80800251,1,0,1,3584,14,2752821144
6192,25570000,36008851,61578851,2,0,0,28160,15,3136310549
6193,25571420,36963352,62534772,5,0,0,32256,8,4352530320
6194,25577030,36335745,61912775,5,0,0,3584,8,10360960536
6195,25577240,35906289,61483529,2,0,0,2560,15,7295744792
6196,25590280,35955268,61545548,6,0,0,24576,5,415129831
6197,25591970,37503370,63095340,9,0,0,34816,19,4950361880
6198,25595190,36473463,62068653,8,0,0,8192,13,1787402668
6199,25601020,35871508,61472528,9,0,0,20480,19,1981204652
6200,25602570,35875697,61478267,4,0,0,4096,4,4138402780
6201,25605490,36215887,61821377,6,0,0,31744,5,6855799447
6202,25607480,36020927,61628407,6,0,0,1024,5,3163451
6203,25609120,36506580,62115700,4,0,0,56320,4,6063375606
6204,25610060,36645937,62255997,1,0,0,45568,14,6533628370
6205,25614470,36110406,61724876,6,0,0,61952,5,3888110401
6206,25616170,55263696,80879866,6,0,1,11776,5,5363950364
6207,25616660,36550550,62167210,7,0,0,55808,8,5451306554
6208,25618220,36373059,61991279,6,0,0,28672,5,5674605152
6209,25634810,55273509,80908319,4,0,1,3072,4,3020566510
6210,25634990,36515193,62150183,1,0,0,42496,14,3531887611
6211,25638720,36419739,62058459,1,0,0,18944,14,876245247
6212,25639871,55269434,80909305,7,0,1,1536,8,6016909451
6213,25643620,36278070,61921690,7,0,0,29184,8,3519290175
6214,25648440,36608368,62256808,7,0,0,2560,8,9104824734
6215,25655080,36301411,61956491,8,0,0,45568,13,7141275285
6216,25656560,36585530,62242090,4,0,0,37888,4,5328927381
6217,25663140,37592901,63256041,8,0,0,4096,13,9268245832
6218,25677779,55232192,80909971,1,0,1,1024,14,6769952151
6219,25678071,55364351,81042422,5,0,1,24576,8,4660268493
6220,25678790,36387336,62066126,2,0,0,25088,15,5417034795
6221,25683430,36338824,62022254,4,0,0,97792,4,9354816070
6222,25685420,36483685,62169105,9,0,0,6144,19,8821915996
6223,25688410,55375837,81064247,2,0,1,1536,15,2129851832
6224,25698120,36276104,61974224,8,0,0,34304,13,9572255668
6225,25703160,36208500,61911660,4,0,0,29696,4,7323087607
6226,25709110,36460642,62169752,8,0,0,2048,13,2182625043
6227,25709611,55404350,81113961,7,0,1,12800,8,1560522564
6228,25714750,36383767,62098517,3,0,0,26624,12,9357145967
6229,25721730,36302107,62023837,4,0,0,5120,4,933221934
6230,25722190,36329975,62052165,3,0,0,32256,12,163127266
6231,25725300,36833046,62558346,1,0,0,7680,14,7921833075
6232,25727100,36704960,62432060,4,0,0,33792,4,4455673587
6233,25749190,36772970,62522160,0,0,0,61440,5,5175693957
6234,25750510,36302146,62052656,8,0,0,1536,13,4196528257
6235,25750880,36625331,62376211,0,0,0,25088,5,2863424885
6236,25754040,36458435,62212475,6,0,0,16384,5,644228975
6237,25755560,36461110,62216670,3,0,0,6656,12,7091829699
6238,25755581,55452217,81207798,5,0,1,8704,8,1802316179
6239,25758040,36556301,62314341,3,0,0,48640,12,1769883133
6240,25760000,37603507,63363507,2,0,0,17920,15,1692971300
6241,25762800,36903324,62666124,8,0,0,22528,13,9424489831
6242,25767300,37700265,63467565,8,0,0,25600,13,6889631829
6243,25769020,36638056,62407076,1,0,0,13824,14,4082582852
6244,25771470,36707267,62478737,5,0,0,10240,8,10392285168
6245,25772160,36458363,62230523,5,0,0,35328,8,9763959501
6246,25777000,36807776,62584776,2,0,0,2560,15,1834444685
6247,25791920,36527793,62319713,0,0,0,14336,5,5449996672
6248,25792060,36553920,62345980,8,0,0,6144,13,6957034794
6249,25798941,55408880,81207821,7,0,1,2048,8,10546439177
6250,25800700,36525025,62325725,0,0,0,1024,5,761158491
6251,25802719,55454521,81257240,1,0,1,17920,14,7816181633
6252,25805170,36919329,62724499,9,0,0,5120,19,10427346317
6253,25809791,55447472,81257263,5,0,1,8704,8,6154639971
6254,25825150,36823606,62648756,4,0,0,43520,4,6453357378
6255,25834540,56071022,81905562,0,0,1,168960,5,7196672007
6256,25836970,36504225,62341195,4,0,0,22016,4,6302335172
6257,25841930,36627068,62468998,0,0,0,6656,5,7516684040
6258,25843370,36516347,62359717,4,0,0,1024,4,8260729317
6259,25843910,36699153,62543063,7,0,0,27136,8,5442924850
6260,25844020,36558420,62402440,0,0,0,16896,5,6162096814
6261,25844160,37201517,63045677,9,0,0,76288,19,4439506467
6262,25849880,56076622,81926502,9,0,1,1024,19,376101257
6263,25853230,56073295,81926525,2,0,1,2560,15,7574638282
6264,25857840,36850877,62708717,6,0,0,46592,5,10450959818
6265,25857940,36690785,62548725,9,0,0,18432,19,536766901
6266,25865949,56062182,81928131,1,0,1,6144,14,7127843660
6267,25866500,36805731,62672231,3,0,0,19968,12,5913838106
6268,25869240,36766233,62635473,7,0,0,43520,8,9692291554
6269,25869350,36842065,62711415,4,0,0,7168,4,6504961315
6270,25870750,56092946,81963696,2,0,1,4096,15,6699795441
6271,25873250,37175258,63048508,1,0,0,9216,14,5189438355
6272,25874020,37045125,62919145,1,0,0,37888,14,8411057524
6273,25877840,56125541,82003381,6,0,1,14848,5,8407121159
6274,25883140,36771263,62654403,8,0,0,18432,13,3388338160
6275,25888390,36830742,62719132,4,0,0,24576,4,7104227233
6276,25890460,37037288,62927748,9,0,0,28160,19,10622131502
6277,25893420,56138111,82031531,0,0,1,2048,5,9676812510
6278,25895480,36717283,62612763,5,0,0,1536,8,10196029643
6279,25895690,36955732,62851422,9,0,0,58368,19,10709558017
6280,25895740,37118668,63014408,1,0,0,44544,14,10354161441
6281,25902241,56170410,82072651,7,0,1,2048,8,7133226639
6282,25905760,37155430,63061190,9,0,0,10752,19,7575724854
6283,25914770,37018149,62932919,3,0,0,16896,12,1870419466
6284,25916770,36792438,62709208,5,0,0,1536,8,2562943967
6285,25922880,37284182,63207062,0,0,0,27136,5,1933167197
6286,25929740,37087655,63017395,1,0,0,9728,14,5247079497
6287,25935230,37701745,63636975,9,0,0,15872,19,281527602
6288,25937140,36743100,62680240,8,0,0,9216,13,9781189237
6289,25938270,37174711,63112981,2,0,0,21504,15,10617486986
6290,25939230,37015598,62954828,8,0,0,2560,13,1711684719
6291,25943700,37830213,63773913,9,0,0,222208,19,7397290794
6292,25943730,37254356,63198086,4,0,0,12800,4,10005558592
6293,25952130,36929880,62882010,6,0,0,11776,5,309134857
6294,25954010,36902739,62856749,1,0,0,17408,14,1745343417
6295,25956810,37105963,63062773,7,0,0,5120,8,3893023620
6296,25964790,37526689,63491479,3,0,0,5120,12,6221087895
6297,25965040,36988985,62954025,3,0,0,51712,12,10469011516
6298,25973440,36683073,62656513,1,0,0,1024,14,7656048049
6299,25977340,36820842,62798182,8,0,0,5632,13,5943485633
6300,25978530,36912540,62891070,5,0,0,11264,8,537006064
6301,25985550,56099533,82085083,6,0,1,18944,5,2536855734
6302,26001940,37283693,63285633,9,0,0,25600,19,1745873437
6303,26003200,36935046,62938246,5,0,0,17408,8,7558534568
6304,26015060,37140588,63155648,9,0,0,76288,19,7546665229
6305,26019510,37043450,63062960,2,0,0,512,15,10409904362
6306,26021920,37035971,63057891,8,0,0,30720,13,8437773036
6307,26029290,36929653,62958943,8,0,0,1024,13,2034244765
6308,26030740,56087850,82118590,2,0,1,8704,15,5672638391
6309,26035620,37355859,63391479,0,0,0,54272,5,9649893853
6310,26039960,36982450,63022410,5,0,0,16384,8,5846560984
6311,26042400,37042309,63084709,1,0,0,19456,14,3454759013
6312,26042880,37958451,64001331,3,0,0,22528,12,6217644088
6313,26043080,37382137,63425217,1,0,0,3072,14,7751540918
6314,26054530,37862651,63917181,8,0,0,17920,13,1515833745
6315,26054690,56063923,82118613,9,0,1,512,19,4936831991
6316,26058190,37490059,63548249,9,0,0,121856,19,8355692050
6317,26070490,56048146,82118636,6,0,1,2560,5,5680249515
6318,26072790,38273484,64346274,3,0,0,74240,12,10195977776
6319,26073370,56971449,83044819,0,0,1,325632,5,6497246246
6320,26075100,37224307,63299407,2,0,0,33792,15,15671194
6321,26085340,37362185,63447525,9,0,0,10752,19,6379109781
6322,26085590,56959252,83044842,6,0,1,512,5,1428775418
6323,26091110,37398786,63489896,3,0,0,73216,12,8213035174
6324,26101450,37680286,63781736,9,0,0,25600,19,6159614109
6325,26101610,56943255,83044865,2,0,1,512,15,4380299829
6326,26106390,37182698,63289088,5,0,0,11264,8,6460550362
6327,26106600,56962811,83069411,6,0,1,10752,5,1886785098
6328,26112370,37439669,63552039,6,0,0,11776,5,7062475361
6329,26114900,37710061,63824961,5,0,0,15872,8,10654726416
6330,26119630,37254768,63374398,6,0,0,5120,5,8875959233
6331,26121350,37470166,63591516,8,0,0,32768,13,829058500
6332,26139820,38077585,64217405,3,0,0,77312,12,9658965353
6333,26140420,38268707,64409127,8,0,0,28160,13,5001543470
6334,26143130,37528216,63671346,9,0,0,8704,19,2213254633
6335,26145550,37184192,63329742,8,0,0,14336,13,4023262436
6336,26147340,37444511,63591851,9,0,0,1024,19,10729994580
6337,26147800,37649582,63797382,7,0,0,51200,8,9201336449
6338,26150841,56918593,83069434,5,0,1,13824,8,5140971784
6339,26155770,37292090,63447860,2,0,0,1024,15,7324311387
6340,26156410,37673730,63830140,2,0,0,16896,15,3832982326
6341,26157620,37403079,63560699,2,0,0,15872,15,2350751191
6342,26167730,37486312,63654042,4,0,0,15360,4,9575920496
6343,26192720,37385953,63578673,3,0,0,3072,12,7238945835
6344,26202220,37820459,64022679,9,0,0,22016,19,168616530
6345,26222510,37652899,63875409,3,0,0,3584,12,2029940539
6346,26223960,37401987,63625947,9,0,0,20992,19,9249471233
6347,26227810,37683888,63911698,5,0,0,31744,8,3504547052
6348,26228170,37282928,63511098,8,0,0,22016,13,10651705495
6349,26228910,38346717,64575627,1,0,0,85504,14,7250014130
6350,26230500,37384238,63614738,3,0,0,17408,12,9877098097
6351,26238630,56911890,83150520,9,0,1,8192,19,4928394799
6352,26242020,56969968,83211988,2,0,1,25600,15,9246231231
6353,26246950,37898885,64145835,4,0,0,131584,4,3513918302
6354,26251150,37406924,63658074,2,0,0,3072,15,3006040765
6355,26254270,37755063,64009333,3,0,0,19968,12,5227296308
6356,26260630,37823145,64083775,7,0,0,5120,8,3707721548
6357,26261930,38424068,64685998,7,0,0,9728,8,1273732410
6358,26263320,37556416,63819736,8,0,0,65024,13,8613851952
6359,26267570,37280858,63548428,9,0,0,512,19,5674597864
6360,26276560,56989266,83265826,2,0,1,8704,15,4770594136
6361,26281600,37644028,63925628,1,0,0,27648,14,3046335144
6362,26287200,38262352,64549552,8,0,0,35328,13,9364603918
6363,26289740,56976109,83265849,9,0,1,11776,19,10367576680
6364,26294200,37691299,63985499,3,0,0,14336,12,5027674841
6365,26296950,37729652,64026602,5,0,0,12800,8,5645723412
6366,26302610,37497291,63799901,1,0,0,8192,14,8164072562
6367,26303790,37583270,63887060,9,0,0,25600,19,5520369247
6368,26307430,37388264,63695694,2,0,0,20992,15,3750911312
6369,26310270,38483618,64793888,3,0,0,57856,12,6726705379
6370,26314371,57069517,83383888,7,0,1,51200,8,2621058817
6371,26318850,57354212,83673062,0,0,1,132096,5,3057338375
6372,26329700,37832007,64161707,2,0,0,5632,15,3389149693
6373,26335519,57358609,83694128,1,0,1,1024,14,4004891213
6374,26336921,57360753,83697674,5,0,1,5632,8,9936000282
6375,26338870,37936135,64275005,1,0,0,18432,14,8176742600
6376,26343720,38563706,64907426,5,0,0,10752,8,4443289651
6377,26345150,37734991,64080141,9,0,0,18944,19,3995703916
6378,26351700,57365737,83717437,0,0,1,25088,5,2356930310
6379,26361190,37687739,64048929,3,0,0,11264,12,9328393004
6380,26369150,37491596,63860746,3,0,0,1536,12,8941030903
6381,26371940,38311071,64683011,2,0,0,30720,15,3469361469
6382,26372930,37480346,63853276,9,0,0,18432,19,2551618448
6383,26376460,37686009,64062469,7,0,0,18944,8,3776193716
6384,26388230,37973205,64361435,3,0,0,33792,12,2154773972
6385,26392990,38346957,64739947,9,0,0,17920,19,8859725104
6386,26402789,57321481,83724270,1,0,1,12800,14,4048258728
6387,26410720,37286245,63696965,1,0,0,4096,14,6196631241
6388,26415330,37778496,64193826,5,0,0,39936,8,4339703117
6389,26418170,37982354,64400524,1,0,0,30208,14,10307797645
6390,26421770,37398301,63820071,3,0,0,1024,12,9670418360
6391,26425300,37734355,64159655,5,0,0,17920,8,10305228112
6392,26434930,57292246,83727176,0,0,1,4608,5,2704982182
6393,26440160,38617445,65057605,2,0,0,35840,15,9902527062
6394,26443500,38429297,64872797,3,0,0,12288,12,685206562
6395,26445340,37994108,64439448,9,0,0,20992,19,1667951434
6396,26459110,37469505,63928615,5,0,0,9728,8,3504661251
6397,26461410,57284256,83745666,4,0,1,12800,4,5170068628
6398,26463190,38245748,64708938,5,0,0,12800,8,3266290709
6399,26464550,57282201,83746751,3,0,1,9728,12,370686826
6400,26465110,37965688,64430798,3,0,0,43520,12,4937657613
6401,26488800,37967075,64455875,3,0,0,36864,12,10161413045
6402,26493880,57253217,83747097,6,0,1,512,5,5055564332
6403,26497440,37733872,64231312,4,0,0,45568,4,3572442301
6404,26504400,37648657,64153057,1,0,0,21504,14,9846193090
6405,26505410,37497816,64003226,6,0,0,6144,5,7175958929
6406,26518780,37492144,64010924,9,0,0,5120,19,10125520641
6407,26521700,38376991,64898691,1,0,0,28672,14,8481089824
6408,26525580,37995499,64521079,2,0,0,2560,15,3660064616
6409,26526920,38627267,65154187,2,0,0,17408,15,3934713634
6410,26533540,57217103,83750643,4,0,1,5632,4,2383068190
6411,26533950,57255427,83789377,2,0,1,5120,15,5146713018
6412,26534960,37716365,64251325,4,0,0,17920,4,1133937759
6413,26535551,57253857,83789408,5,0,1,7168,8,1167262014
6414,26538940,37543252,64082192,7,0,0,6656,8,971337892
6415,26547570,37619359,64166929,9,0,0,3072,19,1129900385
6416,26551390,57238041,83789431,0,0,1,512,5,4119970740
6417,26562790,37583692,64146482,7,0,0,2048,8,8308402920
6418,26574270,38574590,65148860,3,0,0,48640,12,9910388041
6419,26581480,38368838,64950318,6,0,0,6144,5,7674853152
6420,26582120,38464518,65046638,2,0,0,72192,15,8479488340
6421,26583170,37804118,64387288,0,0,0,4096,5,837602605
6422,26588020,38010626,64598646,9,0,0,28160,19,1270635301
6423,26598900,38398784,64997684,2,0,0,23552,15,2511506492
6424,26602790,39310094,65912884,1,0,0,17920,14,3196594995
6425,26606380,38209916,64816296,5,0,0,8704,8,8851203452
6426,26612580,37541592,64154172,2,0,0,3584,15,4532109974
6427,26616850,38240255,64857105,2,0,0,121856,15,9412389619
6428,26624940,37906487,64531427,1,0,0,9728,14,5121178345
6429,26631470,37824584,64456054,5,0,0,512,8,10491700170
6430,26633720,57155734,83789454,0,0,1,3072,5,4200428317
6431,26637700,38470563,65108263,7,0,0,87552,8,6544310920
6432,26641440,38288858,64930298,1,0,0,40448,14,9977533267
6433,26649340,37668952,64318292,9,0,0,3072,19,5413278720
6434,26663121,57149311,83812432,5,0,1,14848,8,9259226504
6435,26668200,37635602,64303802,4,0,0,8192,4,903203514
6436,26671550,37701626,64373176,4,0,0,8192,4,9892362794
6437,26673690,37998203,64671893,3,0,0,51200,12,6214804653
6438,26677570,57166517,83844087,4,0,1,5632,4,10402195861
6439,26698890,57229265,83928155,4,0,1,16384,4,4147641159
6440,26700750,37944747,64645497,9,0,0,26112,19,8511167443
6441,26701350,38167501,64868851,9,0,0,32256,19,1865625085
6442,26705620,38625334,65330954,9,0,0,65536,19,2333675835
6443,26708490,57223967,83932457,9,0,1,3072,19,7280335547
6444,26714509,57224631,83939140,1,0,1,20480,14,1710004859
6445,26718470,37742108,64460578,9,0,0,1536,19,9132582184
6446,26719460,37978392,64697852,9,0,0,4608,19,1933598326
6447,26727870,57221837,83949707,9,0,1,12800,19,3090446465
6448,26733151,57289126,84022277,5,0,1,4608,8,8768784442
6449,26734310,37938074,64672384,5,0,0,1536,8,7679761967
6450,26743760,38209422,64953182,9,0,0,4096,19,5960856828
6451,26752900,38116130,64869030,2,0,0,512,15,1554965249
6452,26774380,38647216,65421596,4,0,0,94720,4,1127791482
6453,26776020,38043575,64819595,3,0,0,10752,12,3929425622
6454,26797180,38016441,64813621,7,0,0,9728,8,1449502393
6455,26797720,37836137,64633857,5,0,0,33280,8,1541704325
6456,26797740,38271657,65069397,7,0,0,29696,8,10347503801
6457,26805680,37970511,64776191,9,0,0,44544,19,3183624619
6458,26823680,38253423,65077103,3,0,0,23040,12,10187917267
6459,26825290,38411067,65236357,4,0,0,30208,4,5310629800
6460,26830669,57257353,84088022,1,0,1,17408,14,7460365989
6461,26834750,37985204,64819954,9,0,0,1024,19,2591184745
6462,26839230,38177931,65017161,9,0,0,17920,19,6884182948
6463,26857640,38260245,65117885,2,0,0,8704,15,6720235018
6464,26864060,38020997,64885057,4,0,0,1536,4,2333447029
6465,26864320,38510536,65374856,1,0,0,15360,14,2153593562
6466,26865030,37945596,64810626,1,0,0,54784,14,8458582081
6467,26897810,37833387,64731197,0,0,0,17920,5,2898986385
6468,26901920,37586960,64488880,9,0,0,2560,19,10398868268
6469,26902680,37956320,64859000,7,0,0,6144,8,9489948641
6470,26906150,38041422,64947572,2,0,0,13312,15,3208582884
6471,26911080,38099245,65010325,1,0,0,13312,14,1501147762
6472,26914020,39094875,66008895,7,0,0,64000,8,9485364685
6473,26914030,38359420,65273450,2,0,0,52736,15,9806659841
6474,26916809,57198936,84115745,1,0,1,7168,14,9699405910
6475,26920490,37969426,64889916,3,0,0,15872,12,333963394
6476,26926920,57188944,84115864,6,0,1,5632,5,4980378977
6477,26930070,37954317,64884387,9,0,0,28672,19,9733366439
6478,26930570,38047723,64978293,4,0,0,16384,4,5746380944
6479,26932380,38709631,65642011,3,0,0,3584,12,5257350080
6480,26935910,39191691,66127601,1,0,0,24576,14,2015615775
6481,26937300,38192589,65129889,3,0,0,1024,12,6277577421
6482,26945280,57176521,84121801,4,0,1,1024,4,8744359117
6483,26957270,38102854,65060124,3,0,0,8192,12,4785335420
6484,26963700,37979793,64943493,1,0,0,31744,14,5224858303
6485,26968350,38905921,65874271,1,0,0,1024,14,6811953403
6486,26968580,38661217,65629797,4,0,0,18432,4,2977730833
6487,26974320,37997563,64971883,8,0,0,512,13,8586023161
6488,26976381,57147046,84123427,5,0,1,2560,8,851231756
6489,26979620,38824584,65804204,9,0,0,1536,19,7019137234
6490,26983910,38038050,65021960,1,0,0,4096,14,2994605703
6491,26989230,38218009,65207239,7,0,0,44032,8,5192612113
6492,26990439,57196226,84186665,1,0,1,9728,14,2782338129
6493,26991360,57195328,84186688,6,0,1,3584,5,7915728370
6494,26998950,38061353,65060303,9,0,0,512,19,9108933412
6495,27027350,38269639,65296989,2,0,0,26112,15,458921172
6496,27028611,57890630,84919241,7,0,1,175616,8,2986240765
6497,27033070,37851496,64884566,2,0,0,512,15,144445886
6498,27035470,39203883,66239353,4,0,0,77824,4,5403174755
6499,27037070,57882194,84919264,9,0,1,512,19,6734926063
6500,27037080,37969166,65006246,4,0,0,4608,4,9708089881
6501,27039760,38330393,65370153,5,0,0,45568,8,291957524
6502,27042250,37833378,64875628,1,0,0,9216,14,4627146347
6503,27045020,38148780,65193800,2,0,0,34816,15,4064583236
6504,27045570,38630421,65675991,5,0,0,2560,8,1182513194
6505,27048360,38988233,66036593,9,0,0,28160,19,3588223669
6506,27050770,38019274,65070044,9,0,0,2048,19,7135221894
6507,27056150,38276699,65332849,5,0,0,6144,8,4325585592
6508,27068220,39267377,66335597,2,0,0,34304,15,5583507368
6509,27074589,57844698,84919287,1,0,1,13312,14,1587145510
6510,27084440,57848987,84933427,6,0,1,10240,5,8846505893
6511,27085900,39034190,66120090,0,0,0,46592,5,8503400929
6512,27093030,38298870,65391900,5,0,0,6144,8,6499455509
6513,27101080,39534128,66635208,1,0,0,15872,14,5761906722
6514,27104730,57842650,84947380,0,0,1,3072,5,10732972125
6515,27107529,57852872,84960401,1,0,1,1536,14,5987653619
6516,27113420,57849668,84963088,0,0,1,5632,5,8904208658
6517,27122700,39364236,66486936,6,0,0,20480,5,7360245067
6518,27130401,57976742,85107143,7,0,1,51712,8,2037430854
6519,27132090,38146086,65278176,4,0,0,10240,4,749212532
6520,27132370,38024804,65157174,9,0,0,9728,19,463387656
6521,27132930,38212000,65344930,2,0,0,14848,15,4742722684
6522,27137140,38147783,65284923,5,0,0,22016,8,4166492785
6523,27145950,38194410,65340360,4,0,0,24576,4,7217210087
6524,27147590,39231753,66379343,1,0,0,20480,14,2278183581
6525,27148330,38140680,65289010,5,0,0,13312,8,2628177553
6526,27151259,57999367,85150626,1,0,1,1024,14,6769936326
6527,27158100,39567582,66725682,5,0,0,9216,8,5167579221
6528,27160799,57989850,85150649,1,0,1,2560,14,9501572371
6529,27164600,38048815,65213415,9,0,0,19968,19,3976399028
6530,27171370,38396198,65567568,2,0,0,31232,15,5163425643
6531,27176640,38483795,65660435,5,0,0,58880,8,6830888379
6532,27178140,38410654,65588794,5,0,0,33792,8,4118736158
6533,27186620,38198413,65385033,1,0,0,7168,14,3118625205
6534,27191010,37986656,65177666,1,0,0,9216,14,2023995763
6535,27195010,57955662,85150672,2,0,1,1536,15,6231528909
6536,27202930,38350818,65553748,9,0,0,45568,19,7984021138
6537,27225620,38031739,65257359,7,0,0,21504,8,1686278830
6538,27231171,58857487,86088658,7,0,1,340992,8,9786233715
6539,27234680,38281193,65515873,3,0,0,4096,12,5986731261
6540,27236570,38257282,65493852,1,0,0,14336,14,9297700090
6541,27249970,38239491,65489461,4,0,0,53760,4,2153838936
6542,27252429,58836252,86088681,1,0,1,512,14,235316113
6543,27258160,38298754,65556914,4,0,0,10240,4,1772195040
6544,27260260,38538750,65799010,1,0,0,11776,14,2105841668
6545,27260560,38458212,65718772,5,0,0,6656,8,397734679
6546,27268490,38228161,65496651,7,0,0,3072,8,7300380061
6547,27275769,58812935,86088704,1,0,1,3072,14,4262702678
6548,27283090,58861264,86144354,4,0,1,17920,4,10734547840
6549,27283530,38398412,65681942,8,0,0,19456,13,1958974848
6550,27289890,38164230,65454120,4,0,0,8704,4,9123627265
6551,27290610,38320515,65611125,3,0,0,73216,12,1862276268
6552,27296620,38324535,65621155,0,0,0,11776,5,7981301377
6553,27301210,39048273,66349483,6,0,0,20992,5,5718963170
6554,27301680,38453330,65755010,9,0,0,32768,19,9512091515
6555,27304940,38318701,65623641,7,0,0,6656,8,9987981751
6556,27309430,39155391,66464821,2,0,0,10240,15,1403077094
6557,27311220,58843476,86154696,4,0,1,37376,4,8885643502
6558,27312961,58930761,86243722,7,0,1,22528,8,5845806051
6559,27317700,37957333,65275033,1,0,0,5120,14,9634728223
6560,27320710,38621309,65942019,7,0,0,18432,8,1029719061
6561,27333440,38094256,65427696,3,0,0,7680,12,1916922890
6562,27334300,38306596,65640896,2,0,0,36352,15,1674013844
6563,27334610,38138448,65473058,3,0,0,16384,12,4326828141
6564,27344130,38273414,65617544,5,0,0,20992,8,7307016924
6565,27359810,38154792,65514602,3,0,0,42496,12,5694696009
6566,27370520,39047590,66418110,1,0,0,4608,14,5561525189
6567,27373090,38616259,65989349,2,0,0,11264,15,1583974426
6568,27373270,38895647,66268917,1,0,0,22016,14,1375661082
6569,27376509,58871783,86248292,1,0,1,11776,14,3024049543
6570,27381340,38724384,66105724,3,0,0,96768,12,7267975615
6571,27386500,38499955,65886455,1,0,0,28160,14,515501771
6572,27388400,38314510,65702910,1,0,0,11264,14,6120683987
6573,27389400,39411756,66801156,3,0,0,13824,12,4463426605
6574,27390690,38126010,65516700,2,0,0,2560,15,9971507062
6575,27391060,38313901,65704961,2,0,0,6656,15,6118512584
6576,27391070,58895879,86286949,4,0,1,4608,4,6241975746
6577,27399050,58887922,86286972,2,0,1,512,15,9868545734
6578,27402560,39488693,66891253,2,0,0,6656,15,7498130674
6579,27407300,38467462,65874762,2,0,0,1536,15,9126539659
6580,27416750,58870245,86286995,9,0,1,7680,19,321520799
6581,27418201,58906555,86324756,5,0,1,6656,8,9628701911
6582,27428570,38111248,65539818,2,0,0,31744,15,9957585179
6583,27437020,58899272,86336292,6,0,1,12800,5,9322064190
6584,27441410,58929832,86371242,9,0,1,3584,19,832228139
6585,27441750,38432186,65873936,0,0,0,33792,5,5113898321
6586,27481290,39075883,66557173,1,0,0,3584,14,5155928040
6587,27485460,39583810,67069270,2,0,0,32256,15,3240403659
6588,27489830,38234630,65724460,1,0,0,2048,14,7830794007
6589,27490951,58900678,86391629,7,0,1,40448,8,7141770062
6590,27492130,38454168,65946298,2,0,0,11776,15,9456543550
6591,27498540,38408861,65907401,3,0,0,14336,12,8975522198
6592,27501820,38056209,65558029,3,0,0,3584,12,2362213281
6593,27502290,38221523,65723813,7,0,0,2048,8,3345012914
6594,27505470,38337156,65842626,0,0,0,33792,5,6080499404
6595,27508950,39614863,67123813,7,0,0,26624,8,2259275509
6596,27513010,38308487,65821497,4,0,0,28672,4,3930193805
6597,27514321,58989592,86503913,7,0,1,61952,8,3545842790
6598,27515001,59571130,87086131,7,0,1,192512,8,9968852713
6599,27523280,59632641,87155921,4,0,1,10240,4,9591397259
6600,27529980,38302327,65832307,7,0,0,35328,8,4704276049
6601,27535020,59628633,87163653,6,0,1,12288,5,10482661355
6602,27538700,39688486,67227186,7,0,0,12288,8,2725635786
6603,27539620,59649107,87188727,0,0,1,4096,5,10443269533
6604,27540540,59655721,87196261,2,0,1,5120,15,5963323089
6605,27547680,38175486,65723166,4,0,0,7168,4,2376890604
6606,27550321,59645963,87196284,5,0,1,11776,8,5990677958
6607,27551930,38301495,65853425,1,0,0,1536,14,7087793946
6608,27567540,38844143,66411683,4,0,0,8704,4,8516243474
6609,27569250,38392421,65961671,4,0,0,10240,4,1834407647
6610,27577790,38127982,65705772,9,0,0,2560,19,3485594414
6611,27590100,38549218,66139318,4,0,0,14336,4,8127693573
6612,27591010,38254759,65845769,1,0,0,10240,14,3808095459
6613,27597680,59598627,87196307,6,0,1,13824,5,1353301252
6614,27598180,39715096,67313276,1,0,0,2048,14,2809795301
6615,27602170,38201543,65803713,0,0,0,15360,5,9585518793
6616,27606780,38414741,66021521,4,0,0,2048,4,876317321
6617,27609310,59684443,87293753,8,0,1,25600,13,1652053522
6618,27613770,38566378,66180148,7,0,0,70144,8,413166393
6619,27614110,39767554,67381664,8,0,0,16384,13,271334880
6620,27614610,38129422,65744032,2,0,0,512,15,1606134104
6621,27615310,38366828,65982138,8,0,0,5120,13,8331654827
6622,27626300,59667914,87294214,0,0,1,10240,5,5806538215
6623,27628470,38622660,66251130,7,0,0,3072,8,7634843041
6624,27630090,38390738,66020828,7,0,0,29696,8,7897874542
6625,27633710,38406147,66039857,5,0,0,3584,8,6343467476
6626,27636540,38705674,66342214,5,0,0,18944,8,6002090538
6627,27639000,38621178,66260178,8,0,0,14848,13,5522761836
6628,27644650,59650230,87294880,0,0,1,1024,5,4635134229
6629,27645650,59987586,87633236,8,0,1,158208,13,2499167308
6630,27647270,39108279,66755549,7,0,0,24576,8,4327045300
6631,27647470,38964896,66612366,0,0,0,32768,5,10709388335
6632,27649160,38601003,66250163,0,0,0,14336,5,7379196400
6633,27649350,39964138,67613488,7,0,0,6144,8,482320854
6634,27650310,38792387,66442697,3,0,0,38912,12,1590713151
6635,27651480,38530118,66181598,5,0,0,4608,8,188481437
6636,27670310,38575462,66245772,4,0,0,20992,4,10182180171
6637,27674550,38538682,66213232,7,0,0,79360,8,10414109189
6638,27681870,39837500,67519370,1,0,0,27648,14,7389057224
6639,27682010,38769991,66452001,3,0,0,5632,12,266650672
6640,27690230,38718778,66409008,0,0,0,30208,5,6642700651
6641,27694990,40002995,67697985,3,0,0,7680,12,808569305
6642,27725290,38325788,66051078,3,0,0,4096,12,4121748594
6643,27727350,38858031,66585381,4,0,0,2560,4,8867091232
6644,27740660,59893807,87634467,2,0,1,2560,15,5764267673
6645,27741850,38541910,66283760,0,0,0,48640,5,6849198742
6646,27742850,38810401,66553251,4,0,0,4096,4,2129925435
6647,27745210,38996469,66741679,8,0,0,20992,13,2042139117
6648,27750140,39135137,66885277,7,0,0,42496,8,9586387136
6649,27760630,39274665,67035295,1,0,0,90112,14,5376004780
6650,27764919,59872134,87637053,1,0,1,4096,14,9380633101
6651,27766430,59874489,87640919,2,0,1,6144,15,10198565640
6652,27776781,60166692,87943473,7,0,1,176128,8,5041422952
6653,27780920,38635763,66416683,9,0,0,3584,19,8299994993
6654,27784390,38345054,66129444,8,0,0,3072,13,7758925677
6655,27787750,38744392,66532142,0,0,0,7168,5,893522788
6656,27794720,38881525,66676245,1,0,0,15872,14,694660937
6657,27794880,38713613,66508493,5,0,0,7168,8,6223489434
6658,27807910,60135586,87943496,6,0,1,6144,5,9639999273
6659,27812260,60771256,88583516,8,0,1,411136,13,7586199173
6660,27820350,38835873,66656223,3,0,0,2048,12,10076705831
6661,27825510,38390108,66215618,7,0,0,7680,8,434650083
6662,27830140,39221269,67051409,4,0,0,512,4,6497527231
6663,27831070,39335730,67166800,5,0,0,45056,8,4637234290
6664,27831190,38480547,66311737,7,0,0,3072,8,5018327907
6665,27835200,40014570,67849770,7,0,0,7680,8,4317790162
6666,27844430,39120325,66964755,8,0,0,30720,13,3844655355
6667,27852850,38791787,66644637,4,0,0,1024,4,5163635040
6668,27853090,39102282,66955372,2,0,0,117248,15,8811517631
6669,27853240,38512255,66365495,4,0,0,15360,4,6617965481
6670,27853971,60906420,88760391,5,0,1,74240,8,4977450802
6671,27857870,40266834,68124704,0,0,0,71680,5,1896332755
6672,27859150,38642697,66501847,3,0,0,4608,12,10081929195
6673,27861380,60921654,88783034,6,0,1,12288,5,951476529
6674,27867970,38492037,66360007,9,0,0,5120,19,5893915886
6675,27872260,38973462,66845722,2,0,0,30720,15,3228936282
6676,27875900,39175330,67051230,0,0,0,52224,5,3353055250
6677,27878200,39224017,67102217,5,0,0,1024,8,10226220525
6678,27879810,60903247,88783057,2,0,1,512,15,5163809066
6679,27885170,38903722,66788892,3,0,0,10752,12,9175428109
6680,27885340,38604430,66489770,4,0,0,2048,4,2189501348
6681,27893530,39891258,67784788,2,0,0,29184,15,8573078980
6682,27900650,39077925,66978575,7,0,0,29696,8,4477137469
6683,27901310,60881770,88783080,6,0,1,5120,5,1604934507
6684,27907630,39432048,67339678,9,0,0,3072,19,9339109186
6685,27910330,39203552,67113882,2,0,0,23552,15,7790080278
6686,27913930,38532517,66446447,8,0,0,1536,13,2108559564
6687,27916490,39185392,67101882,5,0,0,19456,8,3738496801
6688,27921680,39826550,67748230,0,0,0,15360,5,9520019691
6689,27927450,38537550,66465000,3,0,0,512,12,1449430709
6690,27932980,38703499,66636479,3,0,0,4096,12,678861774
6691,27933400,39048006,66981406,4,0,0,9216,4,4853960781
6692,27943330,40058321,68001651,2,0,0,41472,15,5665571786
6693,27945750,60877850,88823600,0,0,1,27136,5,3197249387
6694,27948720,39295146,67243866,3,0,0,6144,12,2829588437
6695,27948740,39292035,67240775,5,0,0,20992,8,6308298328
6696,27949330,38439417,66388747,1,0,0,7680,14,7125831788
6697,27949520,38548147,66497667,0,0,0,8192,5,9825568036
6698,27952200,38735458,66687658,1,0,0,8704,14,3082848389
6699,27952550,38599424,66551974,7,0,0,3072,8,7901070864
6700,27954700,60869886,88824586,0,0,1,1536,5,4361067311
6701,27955950,38561966,66517916,1,0,0,2560,14,4591338677
6702,27957200,39654385,67611585,0,0,0,4608,5,4366757616
6703,27971570,38792367,66763937,8,0,0,11776,13,9011442644
6704,27974000,38697386,66671386,0,0,0,34816,5,44655552
6705,27977820,39245599,67223419,9,0,0,34816,19,10215062999
6706,27993090,39475091,67468181,0,0,0,27136,5,2247391680
6707,27995580,60830184,88825764,8,0,1,13824,13,8435366817
6708,27996780,38747152,66743932,2,0,0,4608,15,3945338122
6709,27997180,39234241,67231421,9,0,0,13824,19,289339989
6710,28001830,39473550,67475380,3,0,0,23552,12,6043345482
6711,28006080,39728501,67734581,7,0,0,86528,8,4405420312
6712,28013890,39833517,67847407,9,0,0,51712,19,3270632338
6713,28026970,39300182,67327152,8,0,0,41472,13,7313845571
6714,28031280,39388740,67420020,4,0,0,58880,4,2641339314
6715,28031620,38783010,66814630,0,0,0,14848,5,4393702261
6716,28034080,39661542,67695622,2,0,0,23552,15,4319318721
6717,28039060,39460546,67499606,2,0,0,79360,15,7837775437
6718,28039870,38780078,66819948,5,0,0,16896,8,9598882089
6719,28044580,39533733,67578313,4,0,0,15872,4,1880086359
6720,28050741,60799435,88850176,7,0,1,21504,8,8786396046
6721,28055160,60795686,88850846,6,0,1,3584,5,4887918639
6722,28057070,40081490,68138560,5,0,0,22016,8,7292203552
6723,28063560,61197819,89261379,8,0,1,284160,13,544093281
6724,28069410,38899736,66969146,7,0,0,14336,8,7200469276
6725,28079850,38920578,67000428,1,0,0,2048,14,5240992556
6726,28083720,39427203,67510923,4,0,0,2048,4,2188972029
6727,28089350,38907586,66996936,5,0,0,10752,8,4760177439
6728,28093610,39875657,67969267,0,0,0,26624,5,1256345827
6729,28097070,40112072,68209142,3,0,0,55296,12,6793571519
6730,28097890,39035535,67133425,7,0,0,12288,8,2480306491
6731,28100100,61161302,89261402,2,0,1,13312,15,3105938995
6732,28107430,38659338,66766768,8,0,0,9216,13,4749806687
6733,28115140,39716488,67831628,1,0,0,19456,14,6262011899
6734,28118460,61142965,89261425,2,0,1,3072,15,45533430
6735,28119030,39639657,67758687,1,0,0,3584,14,4051565930
6736,28123320,38701285,66824605,1,0,0,9728,14,2757678312
6737,28126870,38926902,67053772,1,0,0,7680,14,3439524055
6738,28128580,39832552,67961132,2,0,0,39936,15,780110596
6739,28128590,39253253,67381843,8,0,0,512,13,628210262
6740,28129390,38742198,66871588,1,0,0,3584,14,1155031658
6741,28131370,39013076,67144446,7,0,0,18432,8,3152170117
6742,28135090,38924321,67059411,9,0,0,18432,19,207700993
6743,28136980,39802680,67939660,5,0,0,100864,8,9263883790
6744,28137430,38832051,66969481,7,0,0,1024,8,2161761556
6745,28142190,38650625,66792815,1,0,0,12800,14,3835807146
6746,28147300,39005749,67153049,0,0,0,28160,5,5030873212
6747,28152000,39930264,68082264,3,0,0,62976,12,754475621
6748,28162280,39220366,67382646,3,0,0,2560,12,7467146599
6749,28164100,39446058,67610158,0,0,0,22528,5,1960538867
6750,28166750,40047750,68214500,8,0,0,10752,13,6523963583
6751,28168280,39144349,67312629,8,0,0,95232,13,6908531379
6752,28171221,61106006,89277227,7,0,1,1024,8,2073901020
6753,28177880,61099370,89277250,2,0,1,2048,15,5817055298
6754,28178130,39096012,67274142,7,0,0,9728,8,6374185663
6755,28178880,39386728,67565608,7,0,0,49152,8,9503598155
6756,28179080,39874416,68053496,1,0,0,31744,14,4205604213
6757,28185851,61091422,89277273,5,0,1,512,8,8153290334
6758,28186620,39983130,68169750,3,0,0,18944,12,9529900707
6759,28188740,39149979,67338719,8,0,0,37888,13,4876705411
6760,28191050,38813362,67004412,2,0,0,3584,15,1957770651
6761,28193740,39549779,67743519,6,0,0,28672,5,1473160090
6762,28196320,61080976,89277296,6,0,1,8192,5,4523376636
6763,28196990,61127557,89324547,2,0,1,17408,15,4600704088
6764,28198050,39490373,67688423,2,0,0,86016,15,2211975452
6765,28204060,39306216,67510276,2,0,0,22016,15,9198903282
6766,28209830,61261021,89470851,8,0,1,107520,13,3094953702
6767,28215850,39539423,67755273,3,0,0,23040,12,6951078412
6768,28216230,40239725,68455955,2,0,0,22528,15,9915539264
6769,28224671,61252924,89477595,5,0,1,7168,8,6211593723
6770,28226760,39276769,67503529,7,0,0,12800,8,3958771950
6771,28229130,39433062,67662192,0,0,0,38400,5,3623909258
6772,28234630,61245413,89480043,6,0,1,10752,5,2960416279
6773,28234779,61284808,89519587,1,0,1,16896,14,3827304495
6774,28237840,39184312,67422152,7,0,0,2560,8,3600798500
6775,28241530,39520932,67762462,0,0,0,12288,5,6531529488
6776,28246120,40035168,68281288,3,0,0,60416,12,5404896332
6777,28246790,39213100,67459890,0,0,0,37376,5,10271071619
6778,28254330,40300269,68554599,7,0,0,32768,8,8993216302
6779,28255210,39799401,68054611,7,0,0,3584,8,5292024572
6780,28257770,40035740,68293510,7,0,0,10240,8,5757596889
6781,28260900,39312554,67573454,1,0,0,18944,14,745866369
6782,28261720,39305939,67567659,5,0,0,6656,8,5743223879
6783,28263490,39888072,68151562,7,0,0,23040,8,2407636823
6784,28267270,39586111,67853381,7,0,0,11776,8,9554621327
6785,28269380,39892969,68162349,5,0,0,35328,8,8021697699
6786,28272290,39426030,67698320,5,0,0,1024,8,1462868712
6787,28274570,39888894,68163464,8,0,0,3584,13,3474209791
6788,28278110,39246938,67525048,5,0,0,5120,8,4960892427
6789,28280670,39708322,67988992,0,0,0,43520,5,10645444827
6790,28283010,61236608,89519618,0,0,1,12800,5,3954942612
6791,28284110,39479779,67763889,2,0,0,4608,15,7606687035
6792,28292600,40156468,68449068,4,0,0,67584,4,1500127840
6793,28296360,40380435,68676795,0,0,0,3072,5,336852818
6794,28299940,39990419,68290359,5,0,0,29696,8,10554689162
6795,28312200,40014060,68326260,0,0,0,4608,5,2275074528
6796,28318800,39941226,68260026,0,0,0,5120,5,9204655591
6797,28318970,39939138,68258108,7,0,0,73728,8,5941383770
6798,28320121,61199520,89519641,5,0,1,10240,8,5181999940
6799,28328210,39543824,67872034,4,0,0,37888,4,4306868239
6800,28333450,38924623,67258073,1,0,0,1024,14,4927995768
6801,28333740,61203675,89537415,6,0,1,3072,5,6922046988
6802,28334960,40611505,68946465,9,0,0,68096,19,1217702592
6803,28335150,39188307,67523457,4,0,0,13312,4,3629534802
6804,28347920,40033995,68381915,0,0,0,1536,5,9026189770
6805,28349630,61188041,89537671,8,0,1,9216,13,7946854972
6806,28352430,39682406,68034836,0,0,0,15872,5,3064469359
6807,28358960,39589927,67948887,8,0,0,30208,13,8586261430
6808,28360880,39396600,67757480,2,0,0,7168,15,8418763763
6809,28363110,39345084,67708194,4,0,0,25088,4,10126652040
6810,28364100,61175517,89539617,6,0,1,3072,5,10393872525
6811,28369220,40520023,68889243,4,0,0,57856,4,9519165188
6812,28371630,39963752,68335382,5,0,0,3584,8,8354023924
6813,28379100,39355660,67734760,7,0,0,512,8,8808032336
6814,28384540,40639430,69023970,3,0,0,2560,12,7265296959
6815,28391110,39309417,67700527,3,0,0,7168,12,3225606748
6816,28397820,40159766,68557586,2,0,0,9728,15,7444239784
6817,28401420,39453232,67854652,0,0,0,4096,5,5976901115
6818,28404041,61139122,89543163,7,0,1,5632,8,765767610
6819,28408950,39721616,68130566,1,0,0,16384,14,5476883545
6820,28415140,40603168,69018308,4,0,0,88064,4,5517921114
6821,28416360,39359513,67775873,1,0,0,7168,14,8478185558
6822,28424320,39551389,67975709,5,0,0,14848,8,3164682437
6823,28429670,39578423,68008093,3,0,0,13312,12,8971573370
6824,28431791,61112857,89544648,7,0,1,15360,8,7812280093
6825,28433570,40209544,68643114,7,0,0,59904,8,1517195761
6826,28439360,40221685,68661045,8,0,0,6144,13,889023140
6827,28439630,39866250,68305880,2,0,0,32256,15,3172167488
6828,28455670,40066562,68522232,5,0,0,2048,8,1405733114
6829,28456510,40629575,69086085,7,0,0,19968,8,3835488301
6830,28457451,61117155,89574606,5,0,1,5632,8,5023797626
6831,28466470,61128853,89595323,6,0,1,20480,5,5727842141
6832,28466950,39406378,67873328,0,0,0,4096,5,4984635042
6833,28472490,61140790,89613280,2,0,1,5120,15,1960087134
6834,28472630,61141636,89614266,2,0,1,1536,15,5628131462
6835,28473020,40582524,69055544,4,0,0,21504,4,7831719127
6836,28474030,39991799,68465829,2,0,0,14336,15,4142667500
6837,28474231,61147319,89621550,5,0,1,24576,8,4782592016
6838,28475130,40756615,69231745,9,0,0,33280,19,2401512146
6839,28477710,40764145,69241855,9,0,0,5632,19,10085727972
6840,28479260,39605055,68084315,3,0,0,6656,12,5354683998
6841,28479940,40010728,68490668,3,0,0,19456,12,4778128492
6842,28492640,39416265,67908905,5,0,0,20480,8,8916033516
6843,28508950,39518620,68027570,1,0,0,1024,14,10505880817
6844,28512809,61109407,89622216,1,0,1,1024,14,773019377
6845,28514240,40280422,68794662,9,0,0,1536,19,2007556209
6846,28514760,61108736,89623496,0,0,1,14336,5,8817919189
6847,28518380,39379522,67897902,8,0,0,2048,13,2185245092
6848,28522880,39800027,68322907,1,0,0,55808,14,3032677614
6849,28534030,39469984,68004014,4,0,0,7680,4,2751645304
6850,28537730,39929682,68467412,3,0,0,5120,12,9173186318
6851,28537830,39957096,68494926,2,0,0,8704,15,7193591290
6852,28538770,40120334,68659104,3,0,0,12800,12,966085369
6853,28540340,61094562,89634902,2,0,1,18432,15,9810336975
6854,28541820,40676775,69218595,9,0,0,100864,19,9983824707
6855,28546780,40201181,68747961,3,0,0,9728,12,275018409
6856,28548970,61086496,89635466,4,0,1,10752,4,4651474178
6857,28551710,39419452,67971162,2,0,0,6144,15,5082831623
6858,28564330,39782742,68347072,8,0,0,14336,13,7324782391
6859,28571451,61093631,89665082,5,0,1,9728,8,10035238328
6860,28576600,61115115,89691715,0,0,1,6656,5,7711976430
6861,28586951,61126019,89712970,7,0,1,25088,8,9010154548
6862,28591070,39911367,68502437,8,0,0,24576,13,1590306737
6863,28596770,39661673,68258443,3,0,0,1024,12,867940548
6864,28616710,61159761,89776471,4,0,1,8704,4,1180346550
6865,28627810,39733163,68360973,1,0,0,24576,14,932744592
6866,28634951,61142186,89777137,5,0,1,1024,8,9742417553
6867,28643211,61134912,89778123,7,0,1,1536,8,5270992439
6868,28645050,40253576,68898626,7,0,0,30720,8,8279442030
6869,28661890,39482629,68144519,3,0,0,19456,12,6026374198
6870,28664110,39717314,68381424,9,0,0,22016,19,553386161
6871,28664210,40754694,69418904,3,0,0,45568,12,5015645098
6872,28666941,61115991,89782932,5,0,1,5632,8,4042178675
6873,28667810,39595047,68262857,5,0,0,9216,8,5327406474
6874,28688081,61097134,89785215,5,0,1,5632,8,2684633067
6875,28689420,39496839,68186259,2,0,0,9216,15,1749223457
6876,28695820,39468135,68163955,4,0,0,1536,4,3639082244
6877,28698080,39773122,68471202,7,0,0,8192,8,5415667606
6878,28707670,39784581,68492251,4,0,0,5120,4,3000654254
6879,28709160,40102603,68811763,7,0,0,512,8,6996644786
6880,28710060,40007563,68717623,2,0,0,14848,15,9722819152
6881,28710631,61097621,89808252,7,0,1,10240,8,8409158296
6882,28722290,39616242,68338532,9,0,0,7168,19,10619097702
6883,28724820,39759897,68484717,9,0,0,41472,19,4418239301
6884,28729170,39869652,68598822,9,0,0,15360,19,5441424834
6885,28734500,39476693,68211193,2,0,0,6656,15,5287817007
6886,28738950,40167389,68906339,5,0,0,13312,8,460665611
6887,28739750,39963931,68703681,0,0,0,19456,5,3952055505
6888,28744370,40163240,68907610,9,0,0,4096,19,3003949165
6889,28744490,40529695,69274185,4,0,0,25088,4,262322960
6890,28751190,39622521,68373711,5,0,0,26112,8,62389596
6891,28754160,39714523,68468683,4,0,0,4096,4,1585079389
6892,28758190,39566643,68324833,3,0,0,6144,12,2055791981
6893,28760990,40210782,68971772,5,0,0,43008,8,9601314957
6894,28765260,39696178,68461438,1,0,0,17920,14,1057620232
6895,28770350,40339039,69109389,1,0,0,51200,14,4137357487
6896,28774740,40036844,68811584,0,0,0,6144,5,7805268675
6897,28775390,40783692,69559082,0,0,0,7168,5,3615015636
6898,28775960,39870967,68646927,0,0,0,8192,5,3427346977
6899,28778140,40031549,68809689,7,0,0,34816,8,7282963261
6900,28779900,40800166,69580066,0,0,0,12288,5,248287059
6901,28788430,39507599,68296029,4,0,0,8192,4,202977856
6902,28788630,61027033,89815663,2,0,1,25088,15,5682287013
6903,28788700,61133397,89922097,0,0,1,36352,5,8091273078
6904,28807940,40026154,68834094,2,0,0,73216,15,6848695256
6905,28820360,39877370,68697730,8,0,0,22528,13,2603590418
6906,28821760,40025543,68847303,9,0,0,31232,19,2526303760
6907,28827580,40301369,69128949,4,0,0,25600,4,5782988452
6908,28834760,39745273,68580033,9,0,0,15360,19,3954479247
6909,28843810,40450991,69294801,5,0,0,3072,8,9701632176
6910,28846040,39821490,68667530,8,0,0,14848,13,8381347175
6911,28856000,39814696,68670696,5,0,0,10240,8,9811170859
6912,28857320,61245519,90102839,4,0,1,16896,4,3697556901
6913,28875680,61546972,90422652,8,0,1,143360,13,10600668368
6914,28876510,40375637,69252147,9,0,0,24576,19,3222521864
6915,28885010,40189933,69074943,7,0,0,46080,8,3259633485
6916,28887650,39784629,68672279,4,0,0,5120,4,5102256519
6917,28891699,61550684,90442383,1,0,1,512,14,3013927239
6918,28894010,39812088,68706098,8,0,0,7680,13,10243523132
6919,28894610,40007650,68902260,3,0,0,6656,12,479942587
6920,28894720,40005489,68900209,9,0,0,5120,19,157826134
6921,28900890,40248963,69149853,5,0,0,32768,8,6889620424
6922,28908550,39820089,68728639,7,0,0,25088,8,1032976779
6923,28910611,61531795,90442406,5,0,1,1536,8,8251151667
6924,28923230,40298352,69221582,1,0,0,9728,14,9171570345
6925,28929660,40773678,69703338,4,0,0,37888,4,9233168026
6926,28933650,41017580,69951230,5,0,0,44544,8,7134478460
6927,28947480,39696905,68644385,4,0,0,4096,4,5134846565
6928,28948630,40097897,69046527,0,0,0,17408,5,7115896832
6929,28956350,40002295,68958645,8,0,0,32768,13,2298978929
6930,28959900,40225011,69184911,0,0,0,28160,5,713679712
6931,28961270,40405441,69366711,2,0,0,1024,15,2948363194
6932,28966920,39957981,68924901,8,0,0,22528,13,6064949528
6933,28980230,41047638,70027868,0,0,0,2560,5,10123504338
6934,28981680,39812483,68794163,1,0,0,21504,14,3364767888
6935,28990810,40371149,69361959,0,0,0,35840,5,904984756
6936,28991511,61452157,90443668,7,0,1,3584,8,4905147469
6937,28993000,41189134,70182134,9,0,0,38912,19,4132782994
6938,28993340,40029827,69023167,5,0,0,15872,8,2614692700
6939,29000810,61443204,90444014,2,0,1,512,15,3048621402
6940,29010401,61471716,90482117,7,0,1,12800,8,4397739528
6941,29011610,39977178,68988788,0,0,0,6144,5,7998866305
6942,29017060,40377922,69394982,0,0,0,17920,5,6457408660
6943,29019370,39602268,68621638,2,0,0,9728,15,7163973406
6944,29020800,40789038,69809838,2,0,0,2048,15,8480331668
6945,29023350,40216241,69239591,5,0,0,15360,8,8811717542
6946,29031410,41787289,70818699,1,0,0,41472,14,4243943305
6947,29050440,39931497,68981937,4,0,0,33280,4,8592754713
6948,29057100,40177788,69234888,0,0,0,10240,5,9597526066
6949,29057470,40347519,69404989,8,0,0,32768,13,2520937932
6950,29067200,61425865,90493065,6,0,1,17408,5,444212228
6951,29069840,42023187,71093027,9,0,0,64000,19,9731528114
6952,29084320,40646185,69730505,8,0,0,39936,13,7211684367
6953,29093840,40414901,69508741,0,0,0,1024,5,6050208504
6954,29099920,61405732,90505652,2,0,1,18944,15,10373948598
6955,29100060,41844264,70944324,9,0,0,24576,19,10700828337
6956,29106240,40256834,69363074,0,0,0,3584,5,8257384306
6957,29106310,39681255,68787565,3,0,0,5632,12,2299903878
6958,29107340,40823585,69930925,5,0,0,3584,8,836165531
6959,29108180,40273075,69381255,1,0,0,23552,14,2156077174
6960,29110960,61443254,90554214,6,0,1,28672,5,4119830666
6961,29131050,40305412,69436462,5,0,0,15872,8,7751526116
6962,29132780,40393255,69526035,1,0,0,27648,14,7367875500
6963,29138900,40796884,69935784,0,0,0,15872,5,2585067729
6964,29139010,40357556,69496566,9,0,0,10752,19,5636956906
6965,29142540,40970275,70112815,1,0,0,87552,14,6552437345
6966,29147030,40186158,69333188,3,0,0,6144,12,4283075616
6967,29148360,40443295,69591655,9,0,0,19968,19,1333298172
6968,29151540,40179753,69331293,1,0,0,51200,14,8308437032
6969,29157590,61407795,90565385,8,0,1,49664,13,3799157901
6970,29165920,40667619,69833539,9,0,0,30208,19,9903086057
6971,29168720,40307929,69476649,3,0,0,17920,12,8365781907
6972,29173020,39859923,69032943,7,0,0,1024,8,9576455729
6973,29174791,61472435,90647226,7,0,1,20480,8,8890371542
6974,29179660,41978296,71157956,7,0,0,5120,8,5581676470
6975,29182980,40952399,70135379,0,0,0,9216,5,1951497178
6976,29190730,61459165,90649895,0,0,1,20992,5,7902982747
6977,29193180,40616011,69809191,1,0,0,46080,14,6409635483
6978,29194850,61459551,90654401,2,0,1,7168,15,10612536951
6979,29206440,41039944,70246384,5,0,0,77312,8,6114773553
6980,29215960,41049308,70265268,5,0,0,12800,8,9668303758
6981,29219410,42134165,71353575,4,0,0,23040,4,10488507070
6982,29229370,61428257,90657627,6,0,1,5120,5,8982057595
6983,29235580,39897783,69133363,9,0,0,14336,19,2997249292
6984,29238470,40661969,69900439,1,0,0,51200,14,8203741775
6985,29247820,40538546,69786366,0,0,0,23040,5,10437969314
6986,29263200,40620902,69884102,7,0,0,512,8,5622288786
6987,29264730,40724633,69989363,6,0,0,76288,5,4075386850
6988,29273250,40896163,70169413,8,0,0,30208,13,4614652925
6989,29281020,40648790,69929810,5,0,0,39424,8,8475110996
6990,29281870,40865363,70147233,5,0,0,30720,8,8931960388
6991,29284100,40502913,69787013,0,0,0,2048,5,8029327223
6992,29285580,41091414,70376994,0,0,0,50688,5,7030374040
6993,29298820,40155940,69454760,3,0,0,57856,12,1331655209
6994,29303800,40574698,69878498,9,0,0,17408,19,5169549178
6995,29306990,40535776,69842766,5,0,0,30208,8,976276595
6996,29307000,40114267,69421267,9,0,0,7680,19,1389859336
6997,29312190,40119405,69431595,3,0,0,29696,12,9792042078
6998,29321750,40722707,70044457,9,0,0,47104,19,4214965414
6999,29324900,39830227,69155127,7,0,0,1536,8,2777268777
7000,29340510,41211006,70551516,3,0,0,162304,12,8434902662
7001,29354840,40609673,69964513,0,0,0,43520,5,9073752827
7002,29368020,40406096,69774116,8,0,0,38912,13,7542223975
7003,29371940,40065169,69437109,8,0,0,2048,13,8968453491
7004,29373430,39885371,69258801,2,0,0,19968,15,6704648233
7005,29375220,40198598,69573818,5,0,0,5120,8,6451263951
7006,29375721,61298155,90673876,5,0,1,3584,8,10203723748
7007,29376130,40177613,69553743,8,0,0,39424,13,1890818106
7008,29377350,40186221,69563571,0,0,0,6144,5,4708669278
7009,29384640,40838165,70222805,9,0,0,8192,19,9670124112
7010,29389660,41005629,70395289,7,0,0,33280,8,10642793666
7011,29391689,61290532,90682221,1,0,1,2048,14,538545903
7012,29401800,61719255,91121055,8,0,1,276992,13,10044464567
7013,29407680,42681581,72089261,3,0,0,211968,12,1935973455
7014,29410610,40720503,70131113,4,0,0,34816,4,2270609848
7015,29415310,40468036,69883346,5,0,0,3072,8,5916648591
7016,29417790,40162767,69580557,5,0,0,1536,8,6595799520
7017,29423630,42069649,71493279,4,0,0,55296,4,4647277522
7018,29426851,61705872,91132723,5,0,1,6144,8,4766310461
7019,29427300,40236260,69663560,5,0,0,6144,8,9395129024
7020,29428440,40873763,70302203,9,0,0,35840,19,5132880557
7021,29430950,61740710,91171660,2,0,1,15360,15,6360406595
7022,29438610,43103098,72541708,4,0,0,14336,4,10289077959
7023,29439370,42957792,72397162,5,0,0,19968,8,3259440855
7024,29439650,40526446,69966096,0,0,0,5120,5,3657266136
7025,29453050,39969474,69422524,5,0,0,3584,8,8069681447
7026,29458489,61791745,91250234,1,0,1,4096,14,6003249860
7027,29460510,40724143,70184653,3,0,0,8192,12,8563078192
7028,29469720,41147969,70617689,8,0,0,94208,13,9546110694
7029,29469750,40777125,70246875,4,0,0,1536,4,8803871418
7030,29470900,61792484,91263384,3,0,1,5632,12,8797192045
7031,29481730,40809530,70291260,5,0,0,30208,8,10482470715
7032,29484200,40792549,70276749,0,0,0,15872,5,6324248552
7033,29485760,61777655,91263415,0,0,1,6144,5,5836311242
7034,29486390,40593877,70080267,3,0,0,10752,12,5603997561
7035,29490320,41085647,70575967,3,0,0,71168,12,8220890198
7036,29540100,61737603,91277703,8,0,1,32768,13,8722656152
7037,29540769,61740215,91280984,1,0,1,4096,14,5249445873
7038,29541270,40863139,70404409,8,0,0,12800,13,6250465267
7039,29545701,61760379,91306080,7,0,1,2560,8,8835121167
7040,29550610,40452377,70002987,5,0,0,2048,8,3934270077
7041,29555970,40257482,69813452,5,0,0,7680,8,4061339647
7042,29563620,61744406,91308026,2,0,1,3072,15,4134718673
7043,29566450,61746638,91313088,2,0,1,1024,15,7969748354
7044,29576660,61746926,91323586,0,0,1,6144,5,948601176
7045,29577850,41095388,70673238,8,0,0,23552,13,6106690214
7046,29582850,40911861,70494711,3,0,0,512,12,7560950768
7047,29591440,61732169,91323609,0,0,1,3584,5,6579346399
7048,29592130,40872843,70464973,0,0,0,43008,5,8135807586
7049,29593040,41050645,70643685,4,0,0,12288,4,5794141849
7050,29595801,61727831,91323632,5,0,1,3072,8,7045136692
7051,29597060,41276406,70873466,3,0,0,16896,12,4552983728
7052,29605060,40515422,70120482,3,0,0,25088,12,3266565689
7053,29608900,43096386,72705286,8,0,0,5632,13,10016137918
7054,29614290,40880242,70494532,9,0,0,3584,19,1791937175
7055,29622860,40698927,70321787,9,0,0,18944,19,9211051822
7056,29630500,40783292,70413792,2,0,0,30720,15,5753804614
7057,29632780,40587506,70220286,3,0,0,35328,12,3523750477
7058,29632980,61690675,91323655,4,0,1,512,4,8801143393
7059,29639320,40546604,70185924,0,0,0,4096,5,61351624
7060,29641730,41164310,70806040,4,0,0,95232,4,443882065
7061,29645140,41499130,71144270,8,0,0,36352,13,1445115550
7062,29647530,40410386,70057916,9,0,0,11264,19,5842470152
7063,29647910,41374566,71022476,9,0,0,111616,19,5083716730
7064,29648290,40827158,70475448,5,0,0,34304,8,9432014603
7065,29654590,40477958,70132548,0,0,0,4608,5,5289746127
7066,29659161,61664517,91323678,5,0,1,1024,8,7702677846
7067,29659640,42106734,71766374,8,0,0,29696,13,306373268
7068,29675150,40913812,70588962,8,0,0,42496,13,3160133873
7069,29678030,41774886,71452916,8,0,0,93184,13,5106501654
7070,29681080,40573693,70254773,1,0,0,13824,14,4096207387
7071,29684590,40981114,70665704,8,0,0,72192,13,3398395847
7072,29695850,41056272,70752122,0,0,0,29184,5,6560092076
7073,29699940,41236873,70936813,4,0,0,18432,4,4993037003
7074,29706010,41951950,71657960,0,0,0,43008,5,5451092085
7075,29706230,41059955,70766185,4,0,0,46080,4,864447996
7076,29711900,41219274,70931174,9,0,0,39936,19,8125206396
7077,29720590,40762566,70483156,4,0,0,1536,4,1116130697
7078,29722320,40831940,70554260,4,0,0,7680,4,6357493303
7079,29725829,61597872,91323701,1,0,1,11776,14,4033585251
7080,29737290,40814561,70551851,0,0,0,1024,5,6342473669
7081,29739170,61593485,91332655,4,0,1,3584,4,7846529041
7082,29741890,43298127,73040017,0,0,0,186368,5,4018638795
7083,29752880,40869356,70622236,5,0,0,14848,8,3323832085
7084,29754960,41928002,71682962,4,0,0,8192,4,9386664645
7085,29757650,41067000,70824650,9,0,0,19456,19,8986642564
7086,29758460,40580823,70339283,5,0,0,15872,8,2719156774
7087,29762950,40876968,70639918,7,0,0,13312,8,10038454520
7088,29764310,61570663,91334973,6,0,1,7168,5,3764598368
7089,29765770,41855602,71621372,1,0,0,5120,14,9082274444
7090,29771520,40644167,70415687,3,0,0,6144,12,8826931532
7091,29774310,61578844,91353154,2,0,1,19968,15,8790712798
7092,29779610,40491337,70270947,9,0,0,9216,19,1810962570
7093,29784280,40851559,70635839,8,0,0,44544,13,3335526969
7094,29790930,40986071,70777001,4,0,0,14336,4,10178429978
7095,29811841,61543579,91355420,7,0,1,3584,8,5504648545
7096,29820020,41125309,70945329,4,0,0,3072,4,538667512
7097,29823380,40855809,70679189,1,0,0,19456,14,313092392
7098,29827411,61531043,91358454,5,0,1,15360,8,8906665653
7099,29829270,40672771,70502041,9,0,0,12800,19,7909256039
7100,29829780,41150969,70980749,9,0,0,17408,19,7822743794
7101,29834640,40904749,70739389,0,0,0,15872,5,9936580119
7102,29839160,40884008,70723168,6,0,0,5632,5,9061185911
7103,29843491,61516346,91359837,7,0,1,14848,8,2371675518
7104,29843620,40822419,70666039,0,0,0,1024,5,3148181483
7105,29846260,41211840,71058100,8,0,0,59904,13,2549467247
7106,29846840,61543679,91390519,6,0,1,3584,5,1939348085
7107,29850660,42001112,71851772,8,0,0,21504,13,7753877889
7108,29851530,40995185,70846715,9,0,0,18432,19,1756630365
7109,29852170,41211889,71064059,4,0,0,19456,4,5176411836
7110,29852270,41219947,71072217,9,0,0,22528,19,1628291924
7111,29855170,42169484,72024654,7,0,0,37376,8,6687621686
7112,29859870,41319327,71179197,9,0,0,19456,19,4845921622
7113,29860930,41023861,70884791,0,0,0,19968,5,9396784693
7114,29862710,61579650,91442360,4,0,1,1536,4,2833147120
7115,29866900,40867630,70734530,4,0,0,11776,4,1053153267
7116,29866919,61577067,91443986,1,0,1,2560,14,8932158999
7117,29870940,40900436,70771376,5,0,0,512,8,1248986101
7118,29872000,61572242,91444242,4,0,1,9216,4,6812112508
7119,29872780,40967649,70840429,4,0,0,51712,4,9120868375
7120,29873490,41191840,71065330,4,0,0,4096,4,975327212
7121,29873510,61571398,91444908,6,0,1,1024,5,8276187403
7122,29873630,41344613,71218243,7,0,0,71680,8,38977608
7123,29875120,40965956,70841076,9,0,0,2048,19,8154229895
7124,29876760,41352761,71229521,5,0,0,24576,8,2516678888
7125,29886740,42319549,72206289,1,0,0,6144,14,8912098144
7126,29893640,42227381,72121021,7,0,0,21504,8,4425716092
7127,29895930,41337271,71233201,8,0,0,11776,13,5352229707
7128,29899400,41124503,71023903,7,0,0,4608,8,9959060847
7129,29900661,61572182,91472843,5,0,1,3584,8,964647003
7130,29914080,61633807,91547887,8,0,1,56320,13,4152365000
7131,29921650,41415944,71337594,4,0,0,17408,4,7519590140
7132,29927910,41473749,71401659,8,0,0,1536,13,3127733469
7133,29932820,40791971,70724791,5,0,0,5120,8,6930111648
7134,29946470,41249910,71196380,2,0,0,56320,15,3756460007
7135,29946621,61646063,91592684,7,0,1,8704,8,5094122331
7136,29950630,41375499,71326129,8,0,0,84992,13,3477071312
7137,29952689,61717543,91670232,1,0,1,4608,14,6690906505
7138,29954250,41377986,71332236,1,0,0,19968,14,5518215441
7139,29954670,61751728,91706398,6,0,1,6144,5,3337178896
7140,29957680,41619953,71577633,1,0,0,48640,14,1112584162
7141,29964340,61757275,91721615,4,0,1,10240,4,1762786313
7142,29979620,41060205,71039825,2,0,0,23552,15,2897127709
7143,29982210,42165510,72147720,4,0,0,28160,4,5275369594
7144,29984870,41315340,71300210,3,0,0,67072,12,1115719779
7145,29985780,41087708,71073488,4,0,0,4096,4,1977300022
7146,29985840,41992886,71978726,9,0,0,64000,19,5416812712
7147,29987540,42206245,72193785,0,0,0,34304,5,7490756012
7148,29997580,40849938,70847518,9,0,0,2560,19,2905497242
7149,30005770,41468743,71474513,5,0,0,63488,8,6844600368
7150,30011450,41608004,71619454,3,0,0,44032,12,6612944976
7151,30014690,41133659,71148349,0,0,0,13312,5,1576016355
7152,30015610,42290285,72305895,2,0,0,88576,15,7331955000
7153,30029180,61701843,91731023,2,0,1,15872,15,733937316
7154,30035450,61696034,91731484,2,0,1,10240,15,2981354984
7155,30037510,61699933,91737443,6,0,1,3584,5,6325608953
7156,30041480,61698869,91740349,9,0,1,4608,19,5567017250
7157,30044870,61703873,91748743,6,0,1,5120,5,8914259749
7158,30045840,41323381,71369221,1,0,0,51200,14,2966419848
7159,30047130,41429278,71476408,8,0,0,6144,13,5414084015
7160,30053210,41168800,71222010,9,0,0,12288,19,6282745625
7161,30053550,41585595,71639145,2,0,0,16896,15,9604290343
7162,30059340,41568195,71627535,0,0,0,4608,5,716933873
7163,30065080,61683686,91748766,2,0,1,4096,15,7964448321
7164,30068500,41025806,71094306,5,0,0,4096,8,4627623364
7165,30075050,41204701,71279751,9,0,0,66048,19,1722459633
7166,30077430,41581333,71658763,7,0,0,2560,8,7946590294
7167,30080380,41446961,71527341,4,0,0,34816,4,10139104229
7168,30081340,42412335,72493675,4,0,0,32768,4,1274112818
7169,30086980,41407726,71494706,8,0,0,4608,13,58095439
7170,30095850,41915951,72011801,1,0,0,9728,14,10663241589
7171,30097280,61651509,91748789,4,0,1,11776,4,6923768284
7172,30106750,41476522,71583272,3,0,0,18432,12,6631866713
7173,30108040,41645503,71753543,3,0,0,16896,12,4933670700
7174,30115120,42472581,72587701,3,0,0,43520,12,8934750073
7175,30117510,42543754,72661264,4,0,0,35840,4,4088929410
7176,30118770,42840951,72959721,2,0,0,40960,15,3005119381
7177,30118850,41722828,71841678,8,0,0,5632,13,1042967328
7178,30124530,61702174,91826704,6,0,1,1536,5,7087946059
7179,30134191,61692536,91826727,5,0,1,8704,8,1405339534
7180,30145120,41719054,71864174,2,0,0,7168,15,6131831864
7181,30168160,61699291,91867451,6,0,1,21504,5,9221494686
7182,30168640,61698834,91867474,6,0,1,2560,5,10065659679
7183,30170000,43152689,73322689,4,0,0,81408,4,2621411158
7184,30170940,41769098,71940038,9,0,0,61952,19,1970716885
7185,30172440,41921836,72094276,8,0,0,16384,13,3525704717
7186,30179200,42977537,73156737,3,0,0,38912,12,7883307444
7187,30180590,61688038,91868628,2,0,1,5120,15,5469120043
7188,30181100,41555426,71736526,0,0,0,37376,5,5699364345
7189,30187360,61730371,91917731,4,0,1,512,4,7639157584
7190,30192030,41477574,71669604,4,0,0,15360,4,8754309003
7191,30201290,41582244,71783534,7,0,0,20480,8,315863987
7192,30201530,41253616,71455146,5,0,0,1536,8,1364976916
7193,30205920,41248735,71454655,3,0,0,5632,12,4465140345
7194,30216580,41590042,71806622,4,0,0,16896,4,6975066347
7195,30217030,41402759,71619789,3,0,0,1024,12,10467885907
7196,30218200,41497174,71715374,3,0,0,28672,12,6817093735
7197,30219550,41701098,71920648,9,0,0,86016,19,8148919248
7198,30221020,41553645,71774665,9,0,0,27136,19,454968439
7199,30223210,41367417,71590627,5,0,0,24064,8,1320901817
7200,30229010,42002478,72231488,7,0,0,2560,8,959485821
7201,30231260,43063592,73294852,2,0,0,44544,15,1373947312
7202,30233210,41580767,71813977,5,0,0,24064,8,2432778053
7203,30234041,61684676,91918717,5,0,1,1536,8,9131104165
7204,30242600,41707046,71949646,2,0,0,14336,15,4974819164
7205,30244020,41895097,72139117,2,0,0,19456,15,5835180319
7206,30244971,61674924,91919895,7,0,1,13824,8,1807039998
7207,30245220,61675341,91920561,2,0,1,1024,15,405810051
7208,30250670,42118045,72368715,2,0,0,22528,15,4024841880
7209,30254530,42245176,72499706,8,0,0,9216,13,3125229441
7210,30256560,61701255,91957815,4,0,1,15360,4,1065397355
7211,30256740,61707673,91964413,0,0,1,10240,5,1982205702
7212,30257070,41407020,71664090,1,0,0,17408,14,10591257033
7213,30258610,41447345,71705955,0,0,0,8192,5,9686163486
7214,30260690,41969995,72230685,2,0,0,74752,15,861172913
7215,30265460,41679795,71945255,1,0,0,16896,14,2069363884
7216,30272989,61783491,92056480,8,0,1,10240,13,9652489082
7217,30273350,41442983,71716333,1,0,0,3072,14,9958947581
7218,30275490,43060559,73336049,2,0,0,16384,15,4561309612
7219,30278481,61778022,92056503,5,0,1,1024,8,2058019334
7220,30280680,42199065,72479745,0,0,0,43008,5,9303516317
7221,30283020,41397423,71680443,5,0,0,5120,8,9166896681
7222,30285999,61777253,92063252,1,0,1,8192,14,7218897443
7223,30289130,41632009,71921139,1,0,0,1536,14,10610969077
7224,30291720,41373181,71664901,5,0,0,2560,8,6694945824
7225,30296890,61820565,92117455,3,0,1,15360,12,2904877488
7226,30299500,43081265,73380765,2,0,0,44544,15,486560427
7227,30300100,41559651,71859751,7,0,0,26112,8,3388861794
7228,30302540,43214302,73516842,8,0,0,12800,13,6509848993
7229,30303700,42294640,72598340,4,0,0,34816,4,8353774709
7230,30313200,41673551,71986751,3,0,0,17920,12,1746615565
7231,30313289,61818305,92131594,1,0,1,2560,14,4191328902
7232,30316520,41664748,71981268,7,0,0,8192,8,7815585107
7233,30321860,61883117,92204977,8,0,1,7680,13,5916138303
7234,30330130,41784316,72114446,2,0,0,23552,15,3443042448
7235,30332690,41844810,72177500,2,0,0,8704,15,1667572080
7236,30334090,41674724,72008814,4,0,0,27648,4,1634993658
7237,30351010,41756237,72107247,2,0,0,42496,15,4609401405
7238,30357880,61847120,92205000,6,0,1,2048,5,2148692141
7239,30358670,41975507,72334177,1,0,0,54272,14,3716471272
7240,30367561,61837937,92205498,5,0,1,7168,8,6076858502
7241,30371299,61836785,92208084,1,0,1,4096,14,6681345804
7242,30372280,43185739,73558019,3,0,0,21504,12,9898000855
7243,30373620,42462963,72836583,1,0,0,26112,14,3466460546
7244,30381940,41774220,72156160,5,0,0,14848,8,4749527768
7245,30384559,61855556,92240115,1,0,1,3584,14,10190970690
7246,30390400,43104837,73495237,5,0,0,48128,8,8525395349
7247,30392890,41596071,71988961,2,0,0,512,15,8051082075
7248,30393730,61876025,92269755,6,0,1,3584,5,3499344285
7249,30396820,41871044,72267864,7,0,0,37888,8,7869458134
7250,30397070,42220558,72617628,9,0,0,16896,19,1408489327
7251,30400700,43453413,73854113,8,0,0,132096,13,1287260762
7252,30407060,42019297,72426357,4,0,0,24064,4,1047009194
7253,30409820,41999968,72409788,2,0,0,22528,15,7084888853
7254,30412040,41947330,72359370,9,0,0,54784,19,2003173545
7255,30414630,41986455,72401085,5,0,0,12800,8,7225372634
7256,30416570,41818685,72235255,7,0,0,12288,8,7505645602
7257,30419080,42631724,73050804,1,0,0,35328,14,5011265755
7258,30421300,42013538,72434838,8,0,0,17920,13,6389605148
7259,30424000,41738579,72162579,9,0,0,20992,19,4109804322
7260,30425400,61844378,92269778,6,0,1,15872,5,8691128727
7261,30427809,61841992,92269801,1,0,1,8704,14,1894443663
7262,30432300,42102963,72535263,9,0,0,17408,19,8188060564
7263,30437851,61831997,92269848,7,0,1,3584,8,2288984654
7264,30444350,42654773,73099123,1,0,0,37888,14,3315346834
7265,30444531,61825340,92269871,5,0,1,8704,8,237670212
7266,30451970,41865648,72317618,9,0,0,38400,19,10184702952
7267,30467150,42388987,72856137,7,0,0,49152,8,10297610028
7268,30469420,42785601,73255021,3,0,0,27136,12,3328856092
7269,30470390,61875759,92346149,2,0,1,1536,15,6355580601
7270,30471929,61875846,92347775,8,0,1,2560,13,10080078319
7271,30482560,43167805,73650365,2,0,0,20992,15,4374854594
7272,30485120,42227699,72712819,7,0,0,16384,8,7453946161
7273,30493100,41990568,72483668,5,0,0,12800,8,2189046364
7274,30494030,42744409,73238439,4,0,0,52224,4,6326205317
7275,30494460,42346670,72841130,2,0,0,14848,15,9281442312
7276,30495990,42049398,72545388,7,0,0,1536,8,9297023994
7277,30500320,42196613,72696933,3,0,0,27648,12,8296972193
7278,30506530,42067888,72574418,8,0,0,38400,13,4392941388
7279,30509130,61840591,92349721,0,0,1,3072,5,896324841
7280,30520459,61832488,92352947,1,0,1,5120,14,6623559697
7281,30523330,42278369,72801699,4,0,0,22528,4,10476801158
7282,30528180,43358913,73887093,0,0,0,512,5,3314460604
7283,30528730,42794138,73322868,7,0,0,512,8,7059932082
7284,30529050,42118284,72647334,8,0,0,22016,13,18681804
7285,30529310,42440730,72970040,1,0,0,33792,14,7661760516
7286,30529960,42799647,73329607,2,0,0,22016,15,9064902421
7287,30533180,42376127,72909307,4,0,0,8704,4,3448103695
7288,30536740,61833865,92370605,4,0,1,17920,4,4946060450
7289,30541840,42125866,72667706,4,0,0,11776,4,7559421011
7290,30543480,42171390,72714870,9,0,0,6656,19,8861788391
7291,30544610,43560963,74105573,7,0,0,43520,8,4381078409
7292,30549140,42334754,72883894,2,0,0,34304,15,10176753178
7293,30556870,42426340,72983210,8,0,0,27136,13,1018154500
7294,30561540,42079063,72640603,9,0,0,44544,19,139560981
7295,30567100,43428477,73995577,1,0,0,10240,14,2633152445
7296,30574040,42172961,72747001,4,0,0,59904,4,9950365668
7297,30579590,43882908,74462498,9,0,0,59904,19,5463038855
7298,30582620,42578695,73161315,0,0,0,14848,5,1771625767
7299,30589330,61806410,92395740,0,0,1,2560,5,4663376954
7300,30592880,42595627,73188507,5,0,0,49664,8,2391862372
7301,30596330,42862280,73458610,9,0,0,32256,19,2773976504
7302,30601600,42513635,73115235,9,0,0,15872,19,9560794522
7303,30607750,43156261,73764011,5,0,0,9728,8,2178938833
7304,30611300,42467497,73078797,3,0,0,63488,12,3074759802
7305,30613600,42605634,73219234,5,0,0,15360,8,10075068127
7306,30617529,61785344,92402873,8,0,1,5120,13,1700082086
7307,30620750,42969055,73589805,4,0,0,47616,4,7135331220
7308,30622620,42720784,73343404,0,0,0,24064,5,6102312054
7309,30629600,42617130,73246730,3,0,0,27136,12,8074160996
7310,30630560,42033535,72664095,8,0,0,9216,13,8068473080
7311,30630881,61809804,92440685,5,0,1,1536,8,462976429
7312,30646140,42411083,73057223,8,0,0,20992,13,856777541
7313,30651270,41999051,72650321,8,0,0,9728,13,6168212325
7314,30653879,61798731,92452610,8,0,1,8704,13,1510352293
7315,30657400,42791290,73448690,2,0,0,121344,15,2820010140
7316,30658040,42639799,73297839,9,0,0,9728,19,3198456457
7317,30666530,41886770,72553300,4,0,0,3072,4,9886450406
7318,30666980,42392450,73059430,7,0,0,7168,8,1975730918
7319,30667680,61909986,92577666,8,0,1,11776,13,10166744077
7320,30667830,61909859,92577689,0,0,1,3072,5,7601223027
7321,30671510,42694077,73365587,4,0,0,72704,4,7325877235
7322,30676490,42411066,73087556,8,0,0,28672,13,1448905309
7323,30683600,42714499,73398099,0,0,0,22016,5,10043557876
7324,30685090,61892622,92577712,4,0,1,1024,4,6550299545
7325,30685660,61892075,92577735,2,0,1,12288,15,8593307386
7326,30688429,62035303,92723732,1,0,1,20992,14,3829243709
7327,30694840,42836173,73531013,9,0,0,14848,19,7815221936
7328,30695111,62028967,92724078,7,0,1,512,8,5003827859
7329,30710850,62061970,92772820,0,0,1,13312,5,10679120138
7330,30713230,62059613,92772843,0,0,1,2048,5,3907803582
7331,30723210,42932684,73655894,9,0,0,3584,19,433541600
7332,30727140,42927639,73654779,2,0,0,14336,15,7970131875
7333,30727590,42740293,73467883,2,0,0,6144,15,8705431433
7334,30728350,42193104,72921454,3,0,0,8192,12,1370512357
7335,30737360,42368985,73106345,7,0,0,23552,8,3036222228
7336,30738140,42649691,73387831,3,0,0,12288,12,2726743162
7337,30738260,42645804,73384064,5,0,0,10752,8,1765132016
7338,30740490,43383069,74123559,4,0,0,57856,4,2080600384
7339,30741730,43328069,74069799,8,0,0,74752,13,837462130
7340,30743390,43431343,74174733,0,0,0,15360,5,734110399
7341,30743970,43607355,74351325,8,0,0,47616,13,4300052110
7342,30755480,42848937,73604417,5,0,0,16384,8,6072625099
7343,30756710,43758660,74515370,4,0,0,3072,4,4639868887
7344,30758430,42386428,73144858,9,0,0,73728,19,1426641903
7345,30759101,62013765,92772866,7,0,1,512,8,7152298505
7346,30760810,62034878,92795688,4,0,1,17408,4,3633640740
7347,30766150,42507146,73273296,2,0,0,59904,15,3911370005
7348,30768940,43675283,74444223,0,0,0,33792,5,8726626956
7349,30769080,62026631,92795711,2,0,1,3584,15,10005541018
7350,30778440,62017310,92795750,0,0,1,3584,5,2057847283
7351,30780020,42926247,73706267,2,0,0,11776,15,6288708545
7352,30783080,42963661,73746741,7,0,0,11264,8,7229223183
7353,30794130,62061284,92855414,2,0,1,5632,15,9387364750
7354,30797390,43481635,74279025,3,0,0,57344,12,4719883382
7355,30797700,42739569,73537269,2,0,0,1536,15,4301614124
7356,30805840,43936190,74742030,9,0,0,9216,19,3023596206
7357,30807410,42997861,73805271,7,0,0,5632,8,4456544283
7358,30807530,44041339,74848869,4,0,0,45568,4,8972889762
7359,30813320,42652489,73465809,2,0,0,23552,15,3965738544
7360,30819810,42801977,73621787,7,0,0,39936,8,687587259
7361,30821960,43786057,74608017,8,0,0,22528,13,5170281410
7362,30822030,42509004,73331034,9,0,0,4608,19,7373516133
7363,30829020,42538150,73367170,7,0,0,5120,8,1594696770
7364,30850430,44005091,74855521,8,0,0,512,13,47581857
7365,30859340,42621202,73480542,2,0,0,41472,15,7604616914
7366,30862680,42641628,73504308,8,0,0,29696,13,6062268764
7367,30869260,42542435,73411695,0,0,0,6144,5,1592900644
7368,30871510,42594478,73465988,5,0,0,512,8,1201067087
7369,30874200,42939642,73813842,9,0,0,26112,19,6202230516
7370,30877120,42766101,73643221,7,0,0,4096,8,3998052833
7371,30885750,61979159,92864909,0,0,1,19968,5,8634414660
7372,30886660,61994269,92880929,0,0,1,20480,5,4528336391
7373,30891610,62145563,93037173,2,0,1,8192,15,8771260388
7374,30900380,62223861,93124241,2,0,1,9216,15,279178381
7375,30901770,42740065,73641835,3,0,0,40960,12,9518138179
7376,30902580,42623886,73526466,3,0,0,2048,12,2637810323
7377,30905281,62218983,93124264,5,0,1,1536,8,5592957045
7378,30906640,42606271,73512911,7,0,0,28160,8,2569755152
7379,30912070,43034495,73946565,5,0,0,28672,8,5237580006
7380,30926660,62231234,93157894,8,0,1,2560,13,1739036022
7381,30930639,62245620,93176259,1,0,1,7168,14,7893882162
7382,30931720,44173896,75105616,2,0,0,8704,15,10362026937
7383,30935070,42674518,73609588,4,0,0,16896,4,7812951648
7384,30935410,42763174,73698584,5,0,0,512,8,7280353977
7385,30942351,62252947,93195298,7,0,1,1536,8,8143278276
7386,30942740,43062913,74005653,7,0,0,32768,8,10166062544
7387,30943190,43697647,74640837,9,0,0,27648,19,4232416928
7388,30960659,62287817,93248476,1,0,1,9216,14,4686229369
7389,30961720,43266530,74228250,9,0,0,33280,19,5119438129
7390,30962950,42905093,73868043,7,0,0,25600,8,521396011
7391,30975350,43109783,74085133,9,0,0,45568,19,77179637
7392,30976960,43241127,74218087,8,0,0,15360,13,2296713202
7393,30981000,43554638,74535638,4,0,0,34304,4,6450280918
7394,30982440,62329689,93312129,4,0,1,2048,4,4782271271
7395,30989880,43635967,74625847,8,0,0,12800,13,974585719
7396,31012080,42959276,73971356,4,0,0,61440,4,5558595830
7397,31025010,42851948,73876958,9,0,0,29184,19,6774564633
7398,31028351,62283801,93312152,5,0,1,1024,8,8126828619
7399,31032710,43252422,74285132,2,0,0,19968,15,4512014592
7400,31048400,62279538,93327938,6,0,1,18432,5,1995622173
7401,31049880,42996089,74045969,0,0,0,9216,5,6979968967
7402,31050110,62279134,93329244,9,0,1,2048,19,5306968584
7403,31057640,42640765,73698405,3,0,0,33792,12,3933317739
7404,31057939,62272278,93330217,1,0,1,12800,14,8512510050
7405,31059070,42930845,73989915,9,0,0,39424,19,8127028589
7406,31059150,43774963,74834113,0,0,0,107008,5,3932356094
7407,31060920,43025024,74085944,8,0,0,2560,13,5180127150
7408,31062280,44469221,75531501,3,0,0,77824,12,8420742825
7409,31064070,43140867,74204937,2,0,0,52224,15,5100248420
7410,31064940,42795280,73860220,8,0,0,19968,13,1235751284
7411,31065450,42906709,73972159,7,0,0,2560,8,3697082698
7412,31067780,43443463,74511243,0,0,0,50176,5,6335067723
7413,31068620,44478019,75546639,2,0,0,23040,15,620095104
7414,31068840,62337377,93406217,3,0,1,9728,12,9811061091
7415,31071580,43763336,74834916,2,0,0,2560,15,3661972439
7416,31085190,44564960,75650150,5,0,0,1024,8,913599162
7417,31087190,43656111,74743301,2,0,0,4096,15,635230912
7418,31090180,43202559,74292739,2,0,0,3072,15,1867788542
7419,31094890,62342641,93437531,8,0,1,14848,13,541231338
7420,31100000,42784937,73884937,8,0,0,26112,13,8091640935
7421,31102731,62386124,93488855,7,0,1,11776,8,4067972330
7422,31104050,43070862,74174912,2,0,0,512,15,2951164066
7423,31105919,62383500,93489419,1,0,1,10752,14,7633889090
7424,31112680,43688806,74801486,3,0,0,23552,12,6985607808
7425,31113200,42894200,74007400,9,0,0,5632,19,6812425897
7426,31117040,43972427,75089467,5,0,0,3584,8,7517444717
7427,31123240,43046790,74170030,9,0,0,43008,19,1162937693
7428,31137700,62387596,93525296,0,0,1,2048,5,3873910357
7429,31149720,43745921,74895641,7,0,0,93696,8,4691980199
7430,31163490,43076672,74240162,3,0,0,7680,12,6586725187
7431,31169630,43043754,74213384,0,0,0,27648,5,167951565
7432,31172290,43621997,74794287,0,0,0,152064,5,9101690883
7433,31175830,42914817,74090647,4,0,0,15360,4,8876950023
7434,31176760,43146304,74323064,5,0,0,29184,8,9596892430
7435,31182420,44533396,75715816,9,0,0,58368,19,4270893224
7436,31188680,42968223,74156903,0,0,0,21504,5,4231449359
7437,31190901,62335061,93525962,7,0,1,1024,8,2322978352
7438,31197481,62329467,93526948,7,0,1,1536,8,6417075449
7439,31198270,43651870,74850140,0,0,0,4096,5,3410221474
7440,31199840,62331294,93531134,4,0,1,6656,4,5518971249
7441,31207611,62326967,93534578,5,0,1,17408,8,6444488770
7442,31210720,44472548,75683268,8,0,0,45056,13,3720169493
7443,31215460,42855766,74071226,9,0,0,4608,19,480575781
7444,31229720,62308724,93538444,2,0,1,6144,15,9942690904
7445,31233690,42950792,74184482,2,0,0,14848,15,3728240246
7446,31234680,43504519,74739199,8,0,0,54784,13,414765838
7447,31240960,62337983,93578943,6,0,1,22528,5,3220539606
7448,31249791,62329175,93578966,7,0,1,4096,8,8663408165
7449,31253600,43076374,74329974,5,0,0,22528,8,8833938778
7450,31258610,44539906,75798516,5,0,0,70144,8,7370961466
7451,31264260,42841648,74105908,9,0,0,1024,19,6668558610
7452,31265440,42878645,74144085,2,0,0,13824,15,2155336553
7453,31267960,43201970,74469930,8,0,0,9728,13,8845777170
7454,31273070,42719364,73992434,7,0,0,8192,8,1686767746
7455,31276430,43037719,74314149,8,0,0,29696,13,8035855424
7456,31278590,62300399,93578989,3,0,1,8192,12,3156996535
7457,31281990,42897937,74179927,2,0,0,16384,15,4311913449
7458,31283010,62394999,93678009,8,0,1,20992,13,8603596897
7459,31292000,43329924,74621924,3,0,0,45568,12,3546927583
7460,31296570,44525922,75822492,0,0,0,7680,5,8238008102
7461,31306460,42981035,74287495,8,0,0,7680,13,4310679151
7462,31310260,43906656,75216916,2,0,0,44032,15,2200306789
7463,31312750,44641494,75954244,2,0,0,7680,15,6119347758
7464,31313919,62365076,93678995,1,0,1,1536,14,1398910804
7465,31316190,44538694,75854884,0,0,0,39936,5,718847648
7466,31319870,43278476,74598346,8,0,0,23552,13,4112053276
7467,31320480,43642665,74963145,3,0,0,20992,12,1614454668
7468,31330460,44578394,75908854,7,0,0,31232,8,9905617707
7469,31330600,62349708,93680308,2,0,1,2048,15,7109956751
7470,31341310,44431732,75773042,7,0,0,68096,8,2141874988
7471,31345430,43080043,74425473,5,0,0,11776,8,5497266040
7472,31345750,62339083,93684833,6,0,1,7168,5,9191399798
7473,31356960,43109975,74466935,5,0,0,14336,8,9199283758
7474,31359740,43560439,74920179,8,0,0,35840,13,2893769500
7475,31369660,43352824,74722484,9,0,0,39936,19,4640621615
7476,31370140,43101373,74471513,4,0,0,5120,4,10099520904
7477,31373200,43578672,74951872,3,0,0,25600,12,9330460824
7478,31376390,43891428,75267818,5,0,0,14336,8,9438691916
7479,31380259,62306200,93686459,1,0,1,2560,14,8069128930
7480,31384561,62311276,93695837,7,0,1,8192,8,3158048970
7481,31386510,44054648,75441158,5,0,0,32256,8,4929450006
7482,31388850,43699502,75088352,7,0,0,21504,8,1746050479
7483,31392800,62303060,93695860,6,0,1,512,5,3439756077
7484,31397040,44034267,75431307,4,0,0,19968,4,4302353739
7485,31406420,43261007,74667427,4,0,0,15360,4,3404232571
7486,31407630,43143825,74551455,8,0,0,10752,13,9843452514
7487,31419020,43784434,75203454,9,0,0,48128,19,5417854935
7488,31421260,42994061,74415321,4,0,0,8704,4,114188383
7489,31421490,44585162,76006652,0,0,0,1024,5,9569625760
7490,31427720,62268163,93695883,2,0,1,3072,15,7454021194
7491,31429170,62303828,93732998,3,0,1,40960,12,1895591204
7492,31432820,62421837,93854657,2,0,1,6656,15,8702515198
7493,31446830,43876300,75323130,8,0,0,24064,13,3979757201
7494,31464310,43617467,75081777,7,0,0,26624,8,5468938043
7495,31468410,43194314,74662724,6,0,0,5120,5,1256136021
7496,31472301,62382379,93854680,5,0,1,2048,8,9095526738
7497,31476710,44635233,76111943,7,0,0,109568,8,2420366328
7498,31477580,62377123,93854703,6,0,1,6656,5,8065418400
7499,31479901,62496245,93976146,5,0,1,23552,8,8827143958
7500,31491270,44495803,75987073,3,0,0,55296,12,2150584190
7501,31494330,44116845,75611175,4,0,0,51712,4,4154192867
7502,31505110,44219621,75724731,3,0,0,29184,12,2822722093
7503,31505790,43739166,75244956,7,0,0,512,8,9075770044
7504,31506390,43567252,75073642,8,0,0,76288,13,2411121969
7505,31507490,43917710,75425200,8,0,0,42496,13,4852508629
7506,31508990,43802636,75311626,3,0,0,4608,12,6956930703
7507,31509190,44730577,76239767,9,0,0,2560,19,8849557281
7508,31512310,44264811,75777121,4,0,0,13312,4,3804375135
7509,31517220,62458949,93976169,8,0,1,10240,13,883714090
7510,31531740,44034297,75566037,4,0,0,12800,4,2745293361
7511,31534410,43153557,74687967,0,0,0,1536,5,4803333781
7512,31545670,43848298,75393968,2,0,0,49152,15,3395677668
7513,31547751,62628344,94176095,7,0,1,2048,8,10415435474
7514,31557371,62639362,94196733,5,0,1,3072,8,5099773504
7515,31562140,43293023,74855163,2,0,0,16384,15,1387904076
7516,31563530,43359561,74923091,3,0,0,1536,12,1593356026
7517,31565550,43529400,75094950,5,0,0,17920,8,1570307033
7518,31568960,43809216,75378176,4,0,0,22528,4,6889082922
7519,31569540,43339696,74909236,2,0,0,44544,15,10488894691
7520,31574990,43447172,75022162,0,0,0,33792,5,1627631669
7521,31576170,43167934,74744104,9,0,0,2560,19,4914607251
7522,31577320,62694894,94272214,6,0,1,23040,5,8882517738
7523,31591010,43264332,74855342,0,0,0,512,5,4597868389
7524,31605060,43511176,75116236,8,0,0,8704,13,7949540385
7525,31608440,43722357,75330797,7,0,0,25088,8,2411181033
7526,31610350,43576834,75187184,0,0,0,88576,5,4882116008
7527,31611730,44985653,76597383,0,0,0,12800,5,4113398612
7528,31612790,44224389,75837179,5,0,0,48128,8,1053471010
7529,31613290,43755739,75369029,7,0,0,9216,8,7329896061
7530,31613811,62661201,94275012,7,0,1,512,8,6057009385
7531,31616090,43946024,75562114,5,0,0,47104,8,931685838
7532,31617230,43643468,75260698,0,0,0,12800,5,3409820190
7533,31630320,43703175,75333495,3,0,0,8704,12,1812481004
7534,31630460,62756682,94387142,0,0,1,24064,5,9805906011
7535,31634049,62779135,94413184,1,0,1,10240,14,2901858435
7536,31640320,43353347,74993667,3,0,0,4096,12,7476089232
7537,31645840,43861926,75507766,3,0,0,17408,12,10506761433
7538,31646680,44771029,76417709,5,0,0,141824,8,1545756441
7539,31660080,62824373,94484453,6,0,1,7680,5,8194714801
7540,31660100,43967665,75627765,5,0,0,24064,8,9143518825
7541,31661550,43840889,75502439,8,0,0,52736,13,2893060432
7542,31665150,43672112,75337262,8,0,0,12288,13,3603252446
7543,31668420,43605562,75273982,8,0,0,5632,13,344916130
7544,31669691,62814785,94484476,5,0,1,512,8,8729711431
7545,31678260,62806239,94484499,2,0,1,11264,15,461521854
7546,31693010,62968437,94661447,6,0,1,512,5,6147001727
7547,31701340,43745301,75446641,5,0,0,17920,8,677620442
7548,31707970,44947969,76655939,8,0,0,26112,13,10456728576
7549,31712330,43937477,75649807,5,0,0,25088,8,9707854327
7550,31713940,43590733,75304673,5,0,0,3072,8,3695430264
7551,31717290,43385566,75102856,2,0,0,9728,15,5572760482
7552,31725310,62986950,94712260,2,0,1,7680,15,2972597005
7553,31733800,62991679,94725479,3,0,1,20480,12,3959920747
7554,31734740,43860648,75595388,7,0,0,96256,8,1681013785
7555,31738500,63003452,94741952,3,0,1,17408,12,5078171323
7556,31750490,63050901,94801391,9,0,1,3072,19,2948080089
7557,31753761,63048936,94802697,7,0,1,2048,8,4136299572
7558,31757890,43430877,75188767,0,0,0,5120,5,1957229968
7559,31761110,45398049,77159159,8,0,0,14336,13,5596814602
7560,31762620,43467368,75229988,9,0,0,5120,19,585847013
7561,31766310,43531228,75297538,5,0,0,13824,8,1652432257
7562,31767380,45153789,76921169,8,0,0,90624,13,9933356777
7563,31769760,63199260,94969020,4,0,1,18432,4,8079140902
7564,31785790,44091648,75877438,3,0,0,13824,12,2061471512
7565,31797530,43894497,75692027,4,0,0,28672,4,6682703552
7566,31800380,43951845,75752225,0,0,0,37376,5,857269845
7567,31801030,63189075,94990105,8,0,1,2048,13,9707909600
7568,31809730,44307228,76116958,7,0,0,16384,8,6544123545
7569,31811060,44900000,76711060,2,0,0,24576,15,9887454479
7570,31814980,44347639,76162619,3,0,0,3584,12,8772565863
7571,31815270,43854247,75669517,7,0,0,63488,8,5586022922
7572,31820991,63288049,95109040,7,0,1,17920,8,3974191454
7573,31821480,43539876,75361356,2,0,0,3584,15,9420455018
7574,31824230,43904892,75729122,5,0,0,14336,8,10016593864
7575,31825170,63285176,95110346,6,0,1,2048,5,8756781471
7576,31832120,43810020,75642140,8,0,0,47104,13,4343003816
7577,31834490,45012395,76846885,4,0,0,136704,4,4828688214
7578,31836460,43983646,75820106,9,0,0,45568,19,2130214559
7579,31848280,43772130,75620410,8,0,0,30208,13,1929780416
7580,31848720,43993973,75842693,2,0,0,17920,15,3296611704
7581,31851810,44440740,76292550,5,0,0,38400,8,1420048192
7582,31852400,63260212,95112612,4,0,1,3584,4,4913748987
7583,31861090,44310288,76171378,4,0,0,28672,4,8900336253
7584,31870880,44469441,76340321,2,0,0,49152,15,411574807
7585,31884019,63230539,95114558,8,0,1,3072,13,6153714239
7586,31888880,63306604,95195484,6,0,1,2048,5,2965487689
7587,31895411,63385498,95280909,5,0,1,5632,8,2220526281
7588,31903620,63390127,95293747,4,0,1,7680,4,5915063576
7589,31913810,43784199,75698009,0,0,0,7168,5,7464992752
7590,31924120,45065654,76989774,8,0,0,57344,13,8049794335
7591,31925250,44044929,75970179,0,0,0,52224,5,4788962225
7592,31925970,43769824,75695794,8,0,0,12288,13,7660162820
7593,31927040,44394400,76321440,3,0,0,1024,12,5321028996
7594,31928380,45195468,77123848,5,0,0,8704,8,8835400001
7595,31933410,63443598,95377008,8,0,1,2048,13,2065969039
7596,31936030,44142328,76078358,8,0,0,1024,13,6750420299
7597,31940440,44357905,76298345,4,0,0,18944,4,5554198666
7598,31964201,63500006,95464207,7,0,1,27136,8,2962100058
7599,31964400,43841791,75806191,9,0,0,25088,19,1454683126
7600,31988180,45326292,77314472,9,0,0,46592,19,7854752271
7601,32009950,44430702,76440652,0,0,0,9216,5,10630934429
7602,32011760,43904545,75916305,6,0,0,23040,5,1580787743
7603,32012170,63681606,95693776,8,0,1,4096,13,7196556732
7604,32012530,43918050,75930580,4,0,0,5632,4,5689553685
7605,32025740,44616870,76642610,2,0,0,25600,15,5533355336
7606,32026190,45154923,77181113,3,0,0,4608,12,3480107031
7607,32027360,44537960,76565320,9,0,0,15360,19,6000761419
7608,32036570,44281318,76317888,6,0,0,24064,5,1896796742
7609,32045050,43950836,75995886,8,0,0,28672,13,7404721996
7610,32055720,43799655,75855375,2,0,0,1536,15,2626166048
7611,32061170,45279743,77340913,2,0,0,29184,15,7189579850
7612,32062670,63649653,95712323,8,0,1,1024,13,2550532096
7613,32074020,63672516,95746536,4,0,1,18432,4,8567097199
7614,32076800,45431655,77508455,7,0,0,76800,8,6454585860
7615,32078020,63790600,95868620,8,0,1,5120,13,7996700525
7616,32079910,45364617,77444527,0,0,0,39936,5,8720363761
7617,32083390,44045314,76128704,5,0,0,37888,8,1408315511
7618,32085560,43850491,75936051,5,0,0,1024,8,9489706002
7619,32085630,44338365,76423995,0,0,0,20480,5,8814707291
7620,32086100,44164983,76251083,7,0,0,22528,8,696039560
7621,32087729,63797036,95884765,1,0,1,512,14,6171992980
7622,32098310,44847817,76946127,8,0,0,30208,13,9677807470
7623,32099110,44018027,76117137,0,0,0,512,5,9766261782
7624,32102930,44890501,76993431,3,0,0,10240,12,6874710650
7625,32107500,44047308,76154808,7,0,0,20992,8,2547954322
7626,32109950,44343849,76453799,8,0,0,2048,13,5245498420
7627,32113169,63772896,95886065,1,0,1,8192,14,7137879567
7628,32115630,45778377,77894007,4,0,0,37888,4,5689498917
7629,32122101,63767830,95889931,7,0,1,6144,8,5885527105
7630,32128970,44064221,76193191,5,0,0,12288,8,4674200707
7631,32141230,43875335,76016565,8,0,0,32256,13,2776369379
7632,32147090,45541262,77688352,8,0,0,35840,13,6647694857
7633,32150250,43801526,75951776,4,0,0,5120,4,3488872775
7634,32154890,44028045,76182935,2,0,0,2560,15,1751578934
7635,32157921,63732676,95890597,7,0,1,1024,8,3575657704
7636,32160730,44158886,76319616,5,0,0,5120,8,894090895
7637,32161880,63729690,95891570,8,0,1,12800,13,2816458620
7638,32166390,44380601,76546991,1,0,0,19456,14,6885538104
7639,32184799,63739566,95924365,1,0,1,6144,14,4904686131
7640,32187970,45809643,77997613,8,0,0,2560,13,7366711857
7641,32194080,43995344,76189424,7,0,0,14336,8,7191610315
7642,32198520,44125040,76323560,2,0,0,512,15,10078330328
7643,32199600,45365691,77565291,9,0,0,24064,19,5137959236
7644,32202280,44058966,76261246,4,0,0,33280,4,10549110990
7645,32212680,43845664,76058344,8,0,0,26624,13,9705251775
7646,32220780,63703608,95924388,8,0,1,10752,13,3382338202
7647,32221060,44055779,76276839,4,0,0,31744,4,3701079765
7648,32221370,44648383,76869753,1,0,0,47104,14,8780784518
7649,32222890,44145198,76368088,6,0,0,10240,5,1807698081
7650,32237230,44026067,76263297,7,0,0,6656,8,5704316507
7651,32240950,45490125,77731075,5,0,0,48640,8,8947436311
7652,32242480,63700547,95943027,2,0,1,8704,15,8931566047
7653,32252810,44737478,76990288,1,0,0,512,14,69887005
7654,32255240,63866276,96121516,0,0,1,8704,5,7084147891
7655,32255940,44271436,76527376,9,0,0,127488,19,212125714
7656,32256900,63865602,96122502,8,0,1,1536,13,2286552004
7657,32260360,44269691,76530051,1,0,0,8704,14,10345131295
7658,32261920,44699073,76960993,9,0,0,23552,19,5486074979
7659,32265520,44158810,76424330,5,0,0,1024,8,7152973204
7660,32270610,44427319,76697929,0,0,0,28160,5,6130950897
7661,32273380,63997889,96271269,8,0,1,18432,13,6951112831
7662,32294790,43970090,76264880,1,0,0,5120,14,4428695449
7663,32300300,44062607,76362907,5,0,0,16896,8,540426725
7664,32300440,44581036,76881476,9,0,0,38400,19,966158333
7665,32302440,44253318,76555758,0,0,0,28672,5,8944019647
7666,32309200,44251417,76560617,6,0,0,15872,5,8316433063
7667,32311930,44336030,76647960,5,0,0,4608,8,4769138367
7668,32313450,44688532,77001982,4,0,0,7168,4,2546354304
7669,32319680,44038056,76357736,4,0,0,16896,4,5552893872
7670,32320860,44220134,76540994,9,0,0,35840,19,5411801048
7671,32322450,64029005,96351455,4,0,1,7168,4,309138545
7672,32324140,44356868,76681008,1,0,0,10240,14,6185845674
7673,32324500,44109919,76434419,6,0,0,6144,5,6492382193
7674,32328770,44600120,76928890,7,0,0,14336,8,4451323832
7675,32336189,64015289,96351478,8,0,1,10752,13,8261161140
7676,32336410,44328444,76664854,9,0,0,29184,19,1916827365
7677,32345210,64052777,96397987,0,0,1,4608,5,1049962995
7678,32346670,44288117,76634787,3,0,0,29696,12,8433508947
7679,32357260,44579640,76936900,5,0,0,22016,8,8340141011
7680,32359230,44113904,76473134,0,0,0,9728,5,4923281251
7681,32361660,44531874,76893534,8,0,0,27136,13,9768807974
7682,32362280,45208806,77571086,3,0,0,18944,12,1776097597
7683,32366110,44420639,76786749,1,0,0,25088,14,10540658554
7684,32379500,44267033,76646533,0,0,0,12800,5,4694246820
7685,32393510,45297072,77690582,8,0,0,2048,13,6327667780
7686,32423850,44381360,76805210,6,0,0,11264,5,4619961170
7687,32424940,63978987,96403927,3,0,1,1536,12,8723572675
7688,32427719,63976909,96404628,1,0,1,2560,14,5582253909
7689,32428220,44256711,76684931,4,0,0,12800,4,4256251351
7690,32430300,45674181,78104481,4,0,0,12288,4,6093948441
7691,32447780,44407575,76855355,5,0,0,15360,8,9930651602
7692,32451340,44768130,77219470,8,0,0,49664,13,1084245024
7693,32456500,44247049,76703549,6,0,0,11776,5,1314848291
7694,32458541,63947713,96406254,5,0,1,2560,8,6340672921
7695,32460000,63946920,96406920,3,0,1,1024,12,465985423
7696,32461860,45787245,78249105,1,0,0,39424,14,4583333081
7697,32464860,44322224,76787084,4,0,0,1024,4,2376079008
7698,32465840,44458636,76924476,3,0,0,10752,12,3437766118
7699,32468680,44521429,76990109,3,0,0,1024,12,2572432397
7700,32472640,44324110,76796750,0,0,0,18432,5,6202832677
7701,32472730,44648443,77121173,8,0,0,77312,13,322433163
7702,32474200,44614859,77089059,0,0,0,49152,5,527247392
7703,32474730,63933176,96407906,2,0,1,1536,15,5125002841
7704,32475090,44572203,77047293,5,0,0,35328,8,8882558965
7705,32477390,63934831,96412221,2,0,1,4096,15,7630920799
7706,32477760,44692809,77170569,9,0,0,22016,19,8070666984
7707,32479410,44492869,76972279,7,0,0,28160,8,5938740915
7708,32482780,44367872,76850652,0,0,0,12288,5,1353387560
7709,32487210,44398033,76885243,6,0,0,12288,5,726485127
7710,32508050,45169359,77677409,7,0,0,33792,8,1150589765
7711,32509530,44626578,77136108,9,0,0,21504,19,4634901236
7712,32511490,44632261,77143751,5,0,0,4096,8,7929434151
7713,32514010,44817988,77331998,9,0,0,39936,19,10525017525
7714,32515410,44780140,77295550,5,0,0,45056,8,8814504021
7715,32517719,63915150,96432869,1,0,1,6144,14,364587373
7716,32524350,44429444,76953794,3,0,0,25088,12,2491360951
7717,32530930,45769931,78300861,5,0,0,14336,8,4390847770
7718,32537740,44894588,77432328,2,0,0,66560,15,9463539744
7719,32543620,44420048,76963668,9,0,0,8704,19,686274690
7720,32545050,44755203,77300253,1,0,0,15360,14,4886169828
7721,32545650,63903870,96449520,6,0,1,20480,5,7373081452
7722,32547830,45266512,77814342,0,0,0,29696,5,3419115622
7723,32550740,44379421,76930161,1,0,0,4096,14,9705362614
7724,32559730,44577657,77137387,9,0,0,4096,19,9937114143
7725,32561040,63936047,96497087,0,0,1,10752,5,4041453992
7726,32561190,44568297,77129487,9,0,0,18432,19,8534808155
7727,32565420,44225691,76791111,6,0,0,3584,5,5304383668
7728,32583210,44828815,77412025,8,0,0,23040,13,6084723699
7729,32584700,63990098,96574798,0,0,1,5120,5,10692671881
7730,32587290,45566103,78153393,0,0,0,26624,5,7757155845
7731,32587940,44418896,77006836,8,0,0,3072,13,5110967254
7732,32588430,44444486,77032916,0,0,0,4096,5,9764921962
7733,32594361,63980460,96574821,5,0,1,2560,8,2427435149
7734,32594390,44565856,77160246,4,0,0,1024,4,6656156586
7735,32595520,44640378,77235898,1,0,0,48128,14,6642481386
7736,32607460,44734568,77342028,1,0,0,3584,14,1661112597
7737,32608181,63966663,96574844,7,0,1,15872,8,6630268414
7738,32610850,45189936,77800786,5,0,0,25088,8,2470405695
7739,32621410,44742714,77364124,8,0,0,22016,13,7352404407
7740,32622760,44747665,77370425,6,0,0,15360,5,8829359996
7741,32626890,44725613,77352503,7,0,0,34304,8,659784057
7742,32627900,44991142,77619042,4,0,0,44032,4,6447168469
7743,32628489,64049058,96677547,1,0,1,15360,14,7102546191
7744,32630010,44818681,77448691,5,0,0,6144,8,7636287967
7745,32630250,44623162,77253412,7,0,0,8704,8,8186545711
7746,32630730,45321330,77952060,2,0,0,15360,15,8392129389
7747,32631050,64051223,96682273,3,0,1,10752,12,10585084576
7748,32631370,44721624,77352994,9,0,0,1536,19,2500730156
7749,32634070,44897725,77531795,2,0,0,17920,15,1324922908
7750,32651400,45115045,77766445,5,0,0,7168,8,7870110688
7751,32654740,45227700,77882440,7,0,0,4608,8,2049932875
7752,32660910,44897026,77557936,8,0,0,53248,13,638997864
7753,32665340,45201376,77866716,3,0,0,15360,12,9762266552
7754,32665990,44914814,77580804,4,0,0,2048,4,2174977179
7755,32668920,44998170,77667090,2,0,0,70656,15,8338565768
7756,32669611,64136085,96805696,5,0,1,8704,8,8422542624
7757,32673790,44646009,77319799,4,0,0,17408,4,8020132001
7758,32674720,44570405,77245125,3,0,0,30208,12,1606067648
7759,32678310,44960411,77638721,7,0,0,64512,8,3894790939
7760,32685749,64160865,96846614,1,0,1,8704,14,2887447430
7761,32687690,44710691,77398381,1,0,0,28672,14,3511790794
7762,32688580,45015753,77704333,4,0,0,45056,4,6041617541
7763,32692031,64166820,96858851,7,0,1,8192,8,9644111614
7764,32693300,44664085,77357385,1,0,0,14336,14,138729014
7765,32710330,44774610,77484940,0,0,0,70656,5,7105178871
7766,32711630,45250247,77961877,0,0,0,10240,5,4336874508
7767,32717270,45286138,78003408,4,0,0,18944,4,6218432112
7768,32728081,64154760,96882841,5,0,1,8704,8,7970959443
7769,32734250,45096765,77831015,4,0,0,7680,4,7264131371
7770,32742650,45309367,78052017,2,0,0,18944,15,7435292647
7771,32743959,64138905,96882864,1,0,1,9216,14,8545279605
7772,32747960,45313284,78061244,6,0,0,30208,5,5670276874
7773,32748670,45119634,77868304,5,0,0,3584,8,9871963192
7774,32751960,45789101,78541061,0,0,0,10752,5,3129437246
7775,32760860,44641744,77402604,2,0,0,6656,15,10147976621
7776,32761910,64254630,97016540,8,0,1,8704,13,2419200570
7777,32762470,64330322,97092792,4,0,1,2560,4,8831264359
7778,32763150,45879908,78643058,1,0,0,31744,14,7523655206
7779,32770200,44937900,77708100,8,0,0,12288,13,6835642387
7780,32770430,45126477,77896907,7,0,0,7680,8,1020080150
7781,32770750,44593709,77364459,5,0,0,1024,8,8343019717
7782,32781390,64314948,97096338,2,0,1,5632,15,894623667
7783,32783120,45665263,78448383,7,0,0,67584,8,2298589128
7784,32785500,64327367,97112867,9,0,1,20480,19,1938076426
7785,32785620,45548084,78333704,6,0,0,50688,5,1489496902
7786,32785670,64543699,97329369,4,0,1,14336,4,4813759133
7787,32790690,45029759,77820449,3,0,0,19968,12,7729353143
7788,32791250,44788907,77580157,1,0,0,29696,14,8832785040
7789,32801900,45139326,77941226,9,0,0,9728,19,7793360899
7790,32808860,64630587,97439447,0,0,1,1536,5,8331994669
7791,32809490,64637345,97446835,9,0,1,13824,19,6241276752
7792,32817450,45116219,77933669,2,0,0,31744,15,9712110997
7793,32833770,45707470,78541240,0,0,0,512,5,1983593521
7794,32842190,64785621,97627811,8,0,1,5120,13,5873787062
7795,32842239,64785595,97627834,1,0,1,8704,14,4360574564
7796,32844430,45321466,78165896,6,0,0,40960,5,7377238265
7797,32846139,64781718,97627857,1,0,1,10752,14,7678485574
7798,32848630,45409133,78257763,8,0,0,1536,13,2404802319
7799,32850330,45087886,77938216,0,0,0,14848,5,4527503426
7800,32858130,45631419,78489549,7,0,0,46592,8,8681622484
7801,32861320,45184902,78046222,0,0,0,72192,5,8117607485
7802,32873140,44816795,77689935,3,0,0,5120,12,2815585477
7803,32874740,64894010,97768750,6,0,1,16384,5,7143969220
7804,32879890,45000895,77880785,7,0,0,8192,8,10294652787
7805,32880940,44965867,77846807,4,0,0,8704,4,1161306744
7806,32884990,45896973,78781963,0,0,0,512,5,9833032505
7807,32888220,45640273,78528493,3,0,0,44032,12,9379233217
7808,32888460,45518913,78407373,4,0,0,93184,4,1989720577
7809,32888850,65017725,97906575,2,0,1,16896,15,6071142369
7810,32892301,65017820,97910121,5,0,1,5632,8,6595135050
7811,32895470,45761355,78656825,7,0,0,45056,8,1305477885
7812,32897200,65023137,97920337,9,0,1,4608,19,3803567581
7813,32901370,65034988,97936358,4,0,1,512,4,5118905685
7814,32902840,45108809,78011649,6,0,0,14848,5,3504016786
7815,32913140,45514403,78427543,1,0,0,1024,14,5598074945
7816,32913550,45206549,78120099,0,0,0,512,5,5469912132
7817,32915070,44816496,77731566,7,0,0,1536,8,4107896262
7818,32916870,44911782,77828652,5,0,0,21504,8,4283763140
7819,32920300,45713055,78633355,2,0,0,15360,15,7354525933
7820,32925830,45194090,78119920,0,0,0,25600,5,10441032231
7821,32932980,45940489,78873469,2,0,0,17408,15,7973254668
7822,32936710,44772349,77709059,1,0,0,3072,14,4518941300
7823,32937810,45258315,78196125,0,0,0,512,5,747826740
7824,32938380,44928671,77867051,3,0,0,1024,12,7449981397
7825,32939070,45017849,77956919,5,0,0,15872,8,3083522220
7826,32940830,45006503,77947333,8,0,0,19968,13,9311199908
7827,32942920,45142585,78085505,9,0,0,7680,19,5483677426
7828,32946170,45219905,78166075,5,0,0,512,8,8186849021
7829,32954259,65006839,97961098,1,0,1,6144,14,4712761378
7830,32957220,46272574,79229794,2,0,0,35840,15,1779715803
7831,32971660,46083780,79055440,4,0,0,35328,4,7071194654
7832,32975320,45780749,78756069,4,0,0,3072,4,7881613571
7833,32980100,45695911,78676011,0,0,0,3584,5,2364492543
7834,32981920,45445802,78427722,1,0,0,512,14,6936678987
7835,32983780,45842487,78826267,0,0,0,14848,5,4144150823
7836,32989470,45247600,78237070,7,0,0,40960,8,9835528514
7837,32996910,46100230,79097140,4,0,0,91648,4,9364067109
7838,32997650,44896848,77894498,3,0,0,1536,12,4584914323
7839,33000060,45097880,78097940,2,0,0,3584,15,9216289034
7840,33001860,45425348,78427208,8,0,0,65024,13,10471885316
7841,33002960,45688131,78691091,0,0,0,28160,5,2683977997
7842,33003820,45250308,78254128,5,0,0,16384,8,1054985144
7843,33011071,64950066,97961137,7,0,1,8192,8,10643651529
7844,33012320,64952139,97964459,3,0,1,2560,12,9828528970
7845,33012340,45799163,78811503,8,0,0,24064,13,447077236
7846,33014800,44949284,77964084,4,0,0,7168,4,9629992076
7847,33016680,45493796,78510476,6,0,0,68608,5,7903886392
7848,33019680,45088590,78108270,0,0,0,1024,5,340238760
7849,33020500,64951132,97971632,0,0,1,17408,5,7592915122
7850,33031660,45190681,78222341,6,0,0,512,5,5507122328
7851,33036200,64987795,98023995,0,0,1,17408,5,1682283563
7852,33040840,65009577,98050417,4,0,1,4096,4,3940594483
7853,33046960,45483592,78530552,2,0,0,6656,15,10698289159
7854,33048790,65032079,98080869,0,0,1,1536,5,10652407169
7855,33053660,46256243,79309903,3,0,0,62976,12,8541248281
7856,33060510,45849781,78910291,7,0,0,1024,8,8183039013
7857,33060720,45273943,78334663,2,0,0,3072,15,8333564276
7858,33082360,45204686,78287046,5,0,0,3072,8,4497405400
7859,33088310,45118318,78206628,0,0,0,5120,5,10201039520
7860,33096400,45769218,78865618,1,0,0,16384,14,3759116815
7861,33098630,45777202,78875832,0,0,0,7680,5,1657156088
7862,33100189,64981986,98082175,1,0,1,2048,14,4535492655
7863,33100870,45259874,78360744,1,0,0,22016,14,9674829757
7864,33107701,65000837,98108538,7,0,1,7168,8,10506369456
7865,33115900,45234665,78350565,3,0,0,1024,12,118094376
7866,33116260,45776156,78892416,9,0,0,5120,19,294363175
7867,33118630,64989931,98108561,8,0,1,8704,13,10139373542
7868,33119590,65082633,98202223,3,0,1,16384,12,1479135432
7869,33122690,65080146,98202836,9,0,1,4608,19,5810144318
7870,33128110,45220890,78349000,8,0,0,24064,13,60471367
7871,33129120,46020739,79149859,5,0,0,60416,8,8704556251
7872,33142050,46064394,79206444,5,0,0,26112,8,7834569289
7873,33143060,45371986,78515046,9,0,0,12288,19,8659811442
7874,33143100,46128202,79271302,4,0,0,57856,4,9395605708
7875,33147710,45461414,78609124,8,0,0,124416,13,4395340375
7876,33149700,45361579,78511279,8,0,0,2560,13,5780831293
7877,33151390,45463217,78614607,9,0,0,17920,19,10559399417
7878,33156040,65184364,98340404,9,0,1,22016,19,3165213373
7879,33158540,45910653,79069193,6,0,0,26624,5,9607617345
7880,33166650,45874236,79040886,7,0,0,65024,8,2042994196
7881,33168640,65171787,98340427,8,0,1,8704,13,10625122552
7882,33174050,46146351,79320401,9,0,0,8192,19,6469713997
7883,33174400,45928254,79102654,3,0,0,9216,12,6343050014
7884,33175390,46374341,79549731,4,0,0,130048,4,5939548749
7885,33201869,65212093,98413962,1,0,1,15360,14,8612356856
7886,33204150,45816901,79021051,7,0,0,23040,8,102914386
7887,33213320,65222009,98435329,0,0,1,2560,5,7196717656
7888,33214990,45773691,78988681,3,0,0,16384,12,2070683392
7889,33223440,45667393,78890833,9,0,0,24576,19,9312142199
7890,33223490,45084633,78308123,4,0,0,8704,4,4239143029
7891,33223950,65218937,98442887,9,0,1,12288,19,6749164703
7892,33248580,46137712,79386292,4,0,0,5632,4,736503289
7893,33250470,46189241,79439711,4,0,0,30720,4,5311622693
7894,33252660,45650866,78903526,1,0,0,9728,14,4372086025
7895,33252800,65255259,98508059,2,0,1,2048,15,3532183030
7896,33254540,45905794,79160334,6,0,0,34304,5,6151396588
7897,33258200,65335306,98593506,4,0,1,28160,4,698651416
7898,33261251,65378874,98640125,5,0,1,6656,8,1588747894
7899,33269530,65370618,98640148,3,0,1,2048,12,10353236864
7900,33271480,46015289,79286769,0,0,0,50688,5,8983036316
7901,33275880,45384735,78660615,4,0,0,12288,4,6198590412
7902,33293650,45829063,79122713,2,0,0,40960,15,5722402377
7903,33297220,45331363,78628583,9,0,0,26624,19,5835080797
7904,33298490,46730079,80028569,9,0,0,16896,19,5525891607
7905,33306350,45537961,78844311,8,0,0,10752,13,60600682
7906,33308120,46300377,79608497,3,0,0,15872,12,1364404279
7907,33309730,65330449,98640179,3,0,1,8192,12,4825065221
7908,33312070,46239579,79551649,5,0,0,4096,8,9179195717
7909,33314930,45305518,78620448,9,0,0,18944,19,10068533136
7910,33315740,45667903,78983643,2,0,0,34304,15,9950360454
7911,33318800,46123499,79442299,3,0,0,8192,12,1276890379
7912,33319800,45379738,78699538,5,0,0,27648,8,9239807959
7913,33327400,46308208,79635608,8,0,0,46592,13,7377610793
7914,33338440,45674086,79012526,3,0,0,7168,12,2787351695
7915,33341340,65461390,98802730,9,0,1,14848,19,1888908234
7916,33352530,45496253,78848783,5,0,0,9728,8,6624598175
7917,33355250,65447503,98802753,6,0,1,1536,5,9213360863
7918,33356360,46194018,79550378,9,0,0,2048,19,5882929924
7919,33356680,46804423,80161103,6,0,0,37376,5,3396797655
7920,33358210,65444566,98802776,2,0,1,6144,15,1366818865
7921,33359100,45827632,79186732,8,0,0,13312,13,3047989244
7922,33364790,46002471,79367261,3,0,0,15872,12,4671033628
7923,33365780,65437019,98802799,4,0,1,1536,4,3578806925
7924,33374270,45670383,79044653,8,0,0,12288,13,9779099371
7925,33375011,65630021,99005032,5,0,1,32256,8,3192144690
7926,33376110,46005246,79381356,6,0,0,3072,5,8394865498
7927,33378540,45437963,78816503,7,0,0,4608,8,6851467178
7928,33379820,45630476,79010296,6,0,0,13824,5,2302215845
7929,33387171,65617892,99005063,7,0,1,4096,8,2070122193
7930,33401410,65611813,99013223,3,0,1,512,12,6371963875
7931,33404610,65613119,99017729,9,0,1,7168,19,1081702025
7932,33405280,45567888,78973168,1,0,0,23040,14,3876873637
7933,33413870,46143886,79557756,1,0,0,19968,14,5742013787
7934,33428270,45500750,78929020,4,0,0,9216,4,8916576170
7935,33429570,65588825,99018395,0,0,1,1024,5,3275646150
7936,33431619,65611745,99043364,1,0,1,4096,14,9014708757
7937,33436170,45805659,79241829,8,0,0,39424,13,7220730730
7938,33436250,65607137,99043387,8,0,1,10752,13,9926109248
7939,33438680,46182655,79621335,3,0,0,32256,12,3301662787
7940,33441490,45849202,79290692,0,0,0,12800,5,1314731438
7941,33448990,45448743,78897733,1,0,0,8704,14,97187273
7942,33455490,46286915,79742405,7,0,0,62976,8,1309181128
7943,33456170,45437213,78893383,3,0,0,3072,12,299278491
7944,33456350,46109531,79565881,9,0,0,5120,19,8735840060
7945,33467650,46042434,79510084,7,0,0,21504,8,3899629787
7946,33473760,45925547,79399307,7,0,0,29184,8,9706096358
7947,33479290,45702508,79181798,9,0,0,12800,19,3678297545
7948,33482380,46120923,79603303,7,0,0,76800,8,5365610323
7949,33489920,45992293,79482213,2,0,0,8192,15,1437662963
7950,33492490,46983925,80476415,0,0,0,17408,5,5342647598
7951,33497410,46180432,79677842,8,0,0,11776,13,9239715609
7952,33501270,45751431,79252701,6,0,0,8704,5,1929871245
7953,33506261,65537149,99043410,5,0,1,8192,8,9896793409
7954,33511780,46484590,79996370,1,0,0,33280,14,374867722
7955,33512540,45547447,79059987,9,0,0,14848,19,4701115341
7956,33523340,45799470,79322810,3,0,0,5632,12,10707664217
7957,33528860,46165385,79694245,4,0,0,53760,4,8242803522
7958,33532960,65545926,99078886,2,0,1,4096,15,4347067852
7959,33540380,46219699,79760079,1,0,0,5632,14,8844318993
7960,33541680,47158241,80699921,7,0,0,79360,8,7429279252
7961,33547060,46124808,79671868,3,0,0,15872,12,7412631280
7962,33551650,46059834,79611484,3,0,0,9728,12,6631362179
7963,33553300,45791724,79345024,1,0,0,24064,14,8456204473
7964,33553751,65533292,99087043,7,0,1,3584,8,2336659085
7965,33565870,65592015,99157885,0,0,1,22016,5,195896681
7966,33566130,65674038,99240168,3,0,1,3584,12,7555838648
7967,33567350,45532473,79099823,3,0,0,8704,12,473388701
7968,33567450,45680954,79248404,2,0,0,21504,15,10682585495
7969,33569920,46634389,80204309,0,0,0,6656,5,3936257304
7970,33570690,65670144,99240834,6,0,1,1024,5,10063711219
7971,33576570,45784431,79361001,8,0,0,9216,13,1790968807
7972,33579690,45923337,79503027,8,0,0,1536,13,7756705948
7973,33582120,46237811,79819931,8,0,0,13824,13,6782606351
7974,33582330,45735552,79317882,9,0,0,26112,19,5393097570
7975,33583721,65691994,99275715,7,0,1,4608,8,4406148539
7976,33585801,66063560,99649361,5,0,1,92160,8,776233194
7977,33590130,45889564,79479694,3,0,0,33792,12,2403117833
7978,33591441,66060930,99652371,7,0,1,23040,8,10563604461
7979,33601610,46002028,79603638,8,0,0,1024,13,9966256817
7980,33610250,66091761,99702011,3,0,1,1536,12,4644202528
7981,33612490,45846546,79459036,6,0,0,17920,5,1237694386
7982,33613680,46491755,80105435,1,0,0,49152,14,4218336027
7983,33615289,66095504,99710793,8,0,1,1536,13,2332169356
7984,33615441,66095375,99710816,5,0,1,10240,8,6372415523
7985,33617920,45884616,79502536,3,0,0,24576,12,2202748297
7986,33619960,46350890,79970850,3,0,0,37376,12,1257053457
7987,33621020,46220801,79841821,8,0,0,49664,13,2722800374
7988,33622940,45698108,79321048,0,0,0,2048,5,5180237258
7989,33625060,66087151,99712211,2,0,1,6144,15,7420004586
7990,33625540,66091817,99717357,6,0,1,8192,5,7190703936
7991,33632640,45700341,79332981,8,0,0,33280,13,3158920068
7992,33639880,46466358,80106238,5,0,0,2560,8,8221542230
7993,33643210,46668206,80311416,1,0,0,63488,14,2930991416
7994,33659630,45904591,79564221,4,0,0,9728,4,10203058337
7995,33660450,66089764,99750214,4,0,1,8704,4,7938617499
7996,33664600,45988680,79653280,2,0,0,23040,15,8290434440
7997,33666560,66097461,99764021,3,0,1,14336,12,523134412
7998,33667140,46466762,80133902,3,0,0,10240,12,4837217652
7999,33673700,46257579,79931279,6,0,0,29184,5,7188644551
8000,33675060,45895141,79570201,3,0,0,3072,12,7635423044
8001,33676500,45884734,79561234,2,0,0,8704,15,9776356953
8002,33684440,46117502,79801942,1,0,0,3072,14,3403486215
8003,33686040,45972022,79658062,7,0,0,2560,8,5441170897
8004,33687240,45951741,79638981,5,0,0,6656,8,3978014084
8005,33687550,46309311,79996861,6,0,0,1536,5,5546802000
8006,33688390,45870169,79558559,0,0,0,2560,5,6921118566
8007,33688890,66104341,99793231,4,0,1,22016,4,2972928545
8008,33689800,46848867,80538667,9,0,0,102912,19,1907201293
8009,33693291,66140293,99833584,7,0,1,8192,8,8227353354
8010,33695450,46095896,79791346,8,0,0,11264,13,1012132019
8011,33695590,45978641,79674231,4,0,0,7680,4,9887768033
8012,33696701,66180855,99877556,7,0,1,7680,8,5162583533
8013,33697790,66217800,99915590,6,0,1,4096,5,844691560
8014,33702480,66215340,99917820,0,0,1,18944,5,10129210827
8015,33704540,45991288,79695828,6,0,0,5120,5,1295159404
8016,33704860,47121130,80825990,4,0,0,23040,4,6935318546
8017,33705070,46293062,79998132,2,0,0,4096,15,4984311303
8018,33708620,45860560,79569180,6,0,0,10752,5,1471529704
8019,33709050,46049290,79758340,5,0,0,52224,8,5998825871
8020,33711050,46325500,80036550,0,0,0,3072,5,3958736993
8021,33716670,46616647,80333317,5,0,0,14848,8,9363006533
8022,33731090,46359346,80090436,7,0,0,78848,8,3075951379
8023,33735160,46714356,80449516,6,0,0,20992,5,9863116020
8024,33735530,46223909,79959439,1,0,0,66560,14,790811120
8025,33737100,46650167,80387267,3,0,0,19456,12,2352892222
8026,33742920,46368217,80111137,0,0,0,13824,5,4861741640
8027,33753860,47450616,81204476,4,0,0,129024,4,648231137
8028,33759490,46376368,80135858,7,0,0,1536,8,9585028503
8029,33762080,46940048,80702128,6,0,0,7168,5,2675866115
8030,33768020,46485833,80253853,5,0,0,36352,8,9907116560
8031,33775260,46224611,79999871,2,0,0,5632,15,7120851069
8032,33775870,46705916,80481786,1,0,0,6144,14,7833543439
8033,33778330,46232743,80011073,3,0,0,27136,12,3968356727
8034,33781860,46875307,80657167,3,0,0,14336,12,2839954582
8035,33783950,46947861,80731811,6,0,0,26624,5,7830720045
8036,33789350,46450530,80239880,9,0,0,34304,19,852624267
8037,33790390,66219758,100010148,4,0,1,1536,4,8294018900
8038,33795520,46647577,80443097,8,0,0,60416,13,3657128241
8039,33795920,47138991,80934911,4,0,0,20480,4,7843363379
8040,33799320,66210851,100010171,9,0,1,9728,19,4062759209
8041,33799849,66214744,100014593,1,0,1,12800,14,7732490674
8042,33802240,45978215,79780455,6,0,0,13312,5,4348198091
8043,33806380,66219198,100025578,4,0,1,3072,4,6142420214
8044,33806779,66219145,100025924,8,0,1,512,13,10192421769
8045,33807030,46299722,80106752,5,0,0,512,8,10088900878
8046,33807271,66218999,100026270,7,0,1,512,8,5065757161
8047,33809630,46766078,80575708,4,0,0,87552,4,6473706350
8048,33820351,66236123,100056474,7,0,1,512,8,8661261181
8049,33820360,47059483,80879843,1,0,0,16896,14,1292895480
8050,33822220,46790530,80612750,1,0,0,29184,14,1538040016
8051,33826901,66229596,100056497,5,0,1,7168,8,7365371711
8052,33826970,46987225,80814195,4,0,0,13824,4,1355727102
8053,33834750,46151434,79986184,4,0,0,25088,4,7254766035
8054,33839240,46709769,80549009,7,0,0,33792,8,6115395359
8055,33839631,66245515,100085146,5,0,1,1536,8,3446804127
8056,33840620,46137897,79978517,1,0,0,25088,14,7892397481
8057,33844870,46511231,80356101,1,0,0,44544,14,1773739431
8058,33845930,47163796,81009726,6,0,0,36864,5,7120657116
8059,33855930,46854758,80710688,9,0,0,8704,19,9825854554
8060,33869520,46498711,80368231,6,0,0,17408,5,920286807
8061,33871110,47529442,81400552,5,0,0,27648,8,527821147
8062,33874630,46408851,80283481,5,0,0,44032,8,1094464425
8063,33879310,46920895,80800205,9,0,0,28160,19,10025666873
8064,33888430,46218143,80106573,1,0,0,1024,14,3643338283
8065,33889230,46177159,80066389,1,0,0,14336,14,2817321943
8066,33895980,47117513,81013493,4,0,0,12288,4,7176812552
8067,33896260,47051021,80947281,0,0,0,26112,5,9404594159
8068,33900810,47092860,80993670,2,0,0,19456,15,1254427450
8069,33902760,47321940,81224700,0,0,0,55296,5,5264837321
8070,33903010,46679585,80582595,9,0,0,22528,19,998439535
8071,33905270,66181014,100086284,4,0,1,10752,4,6875389340
8072,33912170,46865964,80778134,9,0,0,37376,19,9207967555
8073,33915520,66980336,100895856,9,0,1,258560,19,7115166611
8074,33916510,47165018,81081528,1,0,0,44544,14,6010231606
8075,33922959,66972912,100895871,8,0,1,13312,13,9575694661
8076,33928890,47185048,81113938,7,0,0,17920,8,5514519102
8077,33933500,47428510,81362010,3,0,0,1024,12,291406085
8078,33945750,47586061,81531811,1,0,0,17408,14,213767479
8079,33949950,47315947,81265897,7,0,0,2560,8,443170845
8080,33954830,47079278,81034108,0,0,0,67584,5,10640718637
8081,33961390,47303696,81265086,0,0,0,25600,5,9788431383
8082,33965490,66930396,100895886,0,0,1,512,5,5420840784
8083,33969070,46292762,80261832,2,0,0,26112,15,3083766723
8084,33973790,66922755,100896545,8,0,1,2048,13,10727528525
8085,33974400,47089824,81064224,6,0,0,23040,5,6346789372
8086,33977460,66951459,100928919,0,0,1,1536,5,1607196417
8087,33978950,46340523,80319473,1,0,0,16384,14,3260119229
8088,33986330,46473152,80459482,7,0,0,20480,8,5461467766
8089,33987080,47264654,81251734,1,0,0,45568,14,192535267
8090,33987840,46432681,80420521,9,0,0,2560,19,4972665074
8091,33989260,46472763,80462023,7,0,0,1536,8,772182242
8092,33995510,46625398,80620908,1,0,0,1024,14,9393604963
8093,34001960,66926974,100928934,2,0,1,17920,15,5952528833
8094,34005040,46391204,80396244,9,0,0,24064,19,10347479201
8095,34005350,46804610,80809960,7,0,0,23040,8,3996059745
8096,34007370,46577432,80584802,9,0,0,7168,19,3793982942
8097,34013570,46488310,80501880,7,0,0,1024,8,7569790337
8098,34016990,46405981,80422971,0,0,0,4608,5,8817718230
8099,34026891,66932743,100959634,5,0,1,21504,8,8331143874
8100,34030440,46590133,80620573,0,0,0,25600,5,4005765736
8101,34033370,47337052,81370422,8,0,0,16384,13,9724243746
8102,34046330,66944359,100990689,9,0,1,1536,19,3128157564
8103,34050230,46346349,80396579,1,0,0,1024,14,338665173
8104,34054420,46649135,80703555,6,0,0,4608,5,9332662624
8105,34055670,47182157,81237827,6,0,0,43008,5,15184501
8106,34055910,47545169,81601079,8,0,0,11776,13,3794158858
8107,34056640,47327556,81384196,7,0,0,25600,8,10271660272
8108,34057081,66935406,100992487,5,0,1,1536,8,1636598152
8109,34057490,46578430,80635920,8,0,0,29184,13,5566752158
8110,34059340,47705065,81764405,2,0,0,63488,15,7579883287
8111,34063620,46783194,80846814,9,0,0,39424,19,4759578980
8112,34065570,47867272,81932842,5,0,0,15360,8,1342150981
8113,34066090,47666091,81732181,4,0,0,31744,4,3309405743
8114,34069020,46635806,80704826,2,0,0,4096,15,3097354943
8115,34071100,47793380,81864480,0,0,0,11264,5,7036526378
8116,34072800,46903349,80976149,9,0,0,9216,19,299283464
8117,34072830,66935400,101008230,3,0,1,14848,12,834085864
8118,34074790,46683146,80757936,0,0,0,14848,5,8303329729
8119,34074850,46678539,80753389,6,0,0,28160,5,784234410
8120,34090720,46951679,81042399,7,0,0,27136,8,3754247278
8121,34093979,66945078,101039057,1,0,1,6144,14,2061202560
8122,34108440,46598437,80706877,0,0,0,6656,5,3977515762
8123,34113090,47050156,81163246,6,0,0,48640,5,6371302253
8124,34115890,46936133,81052023,6,0,0,6144,5,5140480439
8125,34118260,47175800,81294060,8,0,0,19456,13,6608270984
8126,34120200,46819102,80939302,0,0,0,14336,5,2349105546
8127,34120240,47368724,81488964,9,0,0,1024,19,10294147127
8128,34124050,46925103,81049153,3,0,0,22016,12,6131060862
8129,34128510,66910562,101039072,6,0,1,4608,5,8273833765
8130,34131910,47125307,81257217,9,0,0,17920,19,10111018148
8131,34135360,47321381,81456741,0,0,0,152064,5,7455979527
8132,34143860,66906318,101050178,0,0,1,7168,5,10058253632
8133,34145430,47161913,81307343,1,0,0,43520,14,4588625802
8134,34146730,46688049,80834779,6,0,0,16896,5,10494931890
8135,34156320,66913016,101069336,9,0,1,57856,19,5935048392
8136,34158140,47203535,81361675,7,0,0,54272,8,5789062219
8137,34158230,47540968,81699198,5,0,0,50688,8,1530119838
8138,34161060,46931099,81092159,2,0,0,34816,15,3018862317
8139,34171840,47095796,81267636,0,0,0,5632,5,3653376002
8140,34172780,47295996,81468776,2,0,0,39424,15,10439735117
8141,34173460,47034315,81207775,8,0,0,10752,13,9038211427
8142,34189050,47867487,82056537,2,0,0,17920,15,8128059387
8143,34190460,47091239,81281699,9,0,0,46080,19,1007448702
8144,34200020,47913212,82113232,4,0,0,42496,4,5925307187
8145,34207570,48089436,82297006,0,0,0,23552,5,5469634353
8146,34216970,46740041,80957011,4,0,0,1024,4,7413743453
8147,34217030,47331424,81548454,7,0,0,3584,8,3984153625
8148,34224660,46825460,81050120,3,0,0,3072,12,8154144225
8149,34226410,47732924,81959334,2,0,0,6656,15,9694694445
8150,34227920,47058366,81286286,6,0,0,1536,5,4868350705
8151,34230729,66841193,101071922,1,0,1,4096,14,6620240076
8152,34236210,66840884,101077094,8,0,1,8192,13,7422684815
8153,34238490,47358978,81597468,5,0,0,32256,8,10259195876
8154,34241970,48256504,82498474,6,0,0,54272,5,3548569120
8155,34251630,47458120,81709750,8,0,0,3584,13,3129505417
8156,34253070,66830504,101083574,3,0,1,7680,12,5292377328
8157,34253840,66830400,101084240,2,0,1,11264,15,8945950691
8158,34258600,47425131,81683731,1,0,0,10752,14,8586061545
8159,34259850,47050355,81310205,1,0,0,6656,14,1239200336
8160,34259900,47358539,81618439,6,0,0,8192,5,2485935721
8161,34263730,47313281,81577011,4,0,0,31232,4,1447547730
8162,34264340,48143167,82407507,3,0,0,65536,12,3974066650
8163,34265990,47260494,81526484,4,0,0,5120,4,8410485717
8164,34273580,46891561,81165141,1,0,0,6144,14,6527527135
8165,34275900,47100473,81376373,3,0,0,19456,12,4672921009
8166,34276410,47582876,81859286,6,0,0,65024,5,8348116711
8167,34286480,47054458,81340938,2,0,0,50688,15,109295066
8168,34292260,47015886,81308146,9,0,0,2560,19,4335443301
8169,34297800,66787106,101084906,2,0,1,11264,15,5949859078
8170,34298080,47562945,81861025,8,0,0,5632,13,7434925483
8171,34303470,47168137,81471607,1,0,0,9216,14,9315496783
8172,34306480,66851018,101157498,6,0,1,32256,5,10565385707
8173,34306980,47401655,81708635,7,0,0,5632,8,5780546915
8174,34308510,47215137,81523647,8,0,0,17408,13,6756620604
8175,34310310,47468397,81778707,2,0,0,6656,15,4186353373
8176,34323040,47708468,82031508,4,0,0,60928,4,5455343918
8177,34323550,66895982,101219532,9,0,1,91648,19,7888595133
8178,34325120,48220926,82546046,8,0,0,6656,13,1695016254
8179,34326280,47305442,81631722,1,0,0,43520,14,5195256464
8180,34327840,47480133,81807973,5,0,0,17920,8,243989918
8181,34328650,66902069,101230719,3,0,1,6144,12,8675592618
8182,34338820,48283314,82622134,2,0,0,9216,15,9044475200
8183,34340880,47139521,81480401,2,0,0,28160,15,5670538879
8184,34340900,47558414,81899314,7,0,0,82432,8,10494913918
8185,34343410,47530765,81874175,0,0,0,31744,5,10467358340
8186,34343910,47733140,82077050,8,0,0,14336,13,10455342712
8187,34357490,47322942,81680432,2,0,0,58880,15,3148708550
8188,34358110,47742151,82100261,3,0,0,29696,12,2223319038
8189,34365140,47756506,82121646,4,0,0,1024,4,1274476954
8190,34376740,47445620,81822360,5,0,0,22016,8,4823564333
8191,34377661,66855004,101232665,5,0,1,3072,8,8980969884
8192,34383970,47667084,82051054,8,0,0,64000,13,5414087351
8193,34384520,47417970,81802490,7,0,0,39936,8,3952528102
8194,34385350,47230570,81615920,3,0,0,19456,12,839750336
8195,34387210,48370218,82757428,5,0,0,28672,8,9826267479
8196,34390681,66843290,101233971,5,0,1,2048,8,1339078749
8197,34398130,47388311,81786441,3,0,0,4096,12,4881508254
8198,34400759,66837603,101238362,8,0,1,19968,13,6416833076
8199,34400920,47521324,81922244,7,0,0,53760,8,6244920638
8200,34405740,47301148,81706888,7,0,0,20480,8,3788869043
8201,34407440,47683750,82091190,7,0,0,19968,8,9338503682
8202,34409050,47291575,81700625,8,0,0,4608,13,2153126138
8203,34414190,47330848,81745038,5,0,0,16896,8,9185463718
8204,34415140,47511339,81926479,6,0,0,13824,5,6315396324
8205,34419450,47653178,82072628,4,0,0,52736,4,10085469070
8206,34432429,66817354,101249783,1,0,1,1024,14,1957094639
8207,34434010,47684557,82118567,6,0,0,17408,5,8122766008
8208,34441690,47643027,82084717,0,0,0,25088,5,4785060605
8209,34446870,47493502,81940372,0,0,0,3072,5,1268041180
8210,34454560,47961261,82415821,6,0,0,24064,5,8273497853
8211,34454750,66795048,101249798,3,0,1,12800,12,7192063645
8212,34459430,47699809,82159239,3,0,0,50688,12,6896030913
8213,34462140,47270844,81732984,0,0,0,2560,5,9826251353
8214,34462880,47658431,82121311,2,0,0,8704,15,3292435746
8215,34471420,47736035,82207455,4,0,0,47616,4,8400847606
8216,34482240,47228937,81711177,3,0,0,4608,12,1085978539
8217,34493470,47456939,81950409,8,0,0,8192,13,7370455656
8218,34500260,47837945,82338205,7,0,0,109056,8,3240678132
8219,34507440,48531561,83039001,2,0,0,53760,15,775389466
8220,34510700,66760570,101271270,0,0,1,12800,5,5231243629
8221,34520650,66764446,101285096,0,0,1,3584,5,8589102269
8222,34521290,47406818,81928108,9,0,0,5120,19,7415918825
8223,34534860,47550192,82085052,1,0,0,1024,14,182248130
8224,34543570,66743792,101287362,8,0,1,3584,13,10103759359
8225,34550570,47808342,82358912,0,0,0,16896,5,3316622139
8226,34557130,47621655,82178785,1,0,0,19456,14,9387453888
8227,34560150,47697069,82257219,2,0,0,32256,15,1026448964
8228,34560210,66743974,101304184,9,0,1,43008,19,9557646381
8229,34566010,66741400,101307410,4,0,1,5120,4,9374766269
8230,34570991,66738045,101309036,7,0,1,2560,8,713609812
8231,34571290,47617203,82188493,8,0,0,3072,13,9166493743
8232,34572440,66739502,101311942,3,0,1,4608,12,8211709995
8233,34576690,47950565,82527255,7,0,0,84480,8,9047265864
8234,34581090,66770468,101351558,2,0,1,14848,15,5053657581
8235,34584120,47588714,82172834,7,0,0,44544,8,5463872882
8236,34594950,66759344,101354294,4,0,1,5632,4,1442806267
8237,34598210,66757710,101355920,0,0,1,2560,5,9994982069
8238,34605910,47758295,82364205,0,0,0,9216,5,7802563724
8239,34606521,66750705,101357226,7,0,1,2048,8,8465268237
8240,34615800,66747520,101363320,8,0,1,23040,13,60028193
8241,34619990,47797102,82417092,3,0,0,4096,12,1553539677
8242,34620330,47850225,82470555,8,0,0,57856,13,3736786558
8243,34620400,47382958,82003358,2,0,0,16384,15,4277898861
8244,34620980,47787486,82408466,3,0,0,3072,12,7255538790
8245,34625160,66742986,101368146,8,0,1,7680,13,226161039
8246,34632780,47737699,82370479,1,0,0,7168,14,9436674856
8247,34633800,66907904,101541704,9,0,1,269312,19,8940924875
8248,34638650,48379557,83018207,2,0,0,99840,15,6960108686
8249,34638740,47893218,82531958,7,0,0,15360,8,5297036369
8250,34642870,47930565,82573435,4,0,0,11264,4,2780721845
8251,34648190,48495077,83143267,0,0,0,61952,5,1841453394
8252,34652170,48055326,82707496,4,0,0,7168,4,720712323
8253,34657541,66895274,101552815,7,0,1,5120,8,4337189191
8254,34658461,66895980,101554441,7,0,1,2560,8,8708606753
8255,34668400,48170672,82839072,8,0,0,2560,13,4268468121
8256,34670970,47682771,82353741,8,0,0,7680,13,751782393
8257,34675220,47533506,82208726,3,0,0,4096,12,3246302670
8258,34677340,47623589,82300929,9,0,0,12800,19,3470483577
8259,34678900,48254833,82933733,7,0,0,10240,8,8602919282
8260,34680711,66875036,101555747,7,0,1,2048,8,982708281
8261,34683410,47860585,82543995,0,0,0,16896,5,720455893
8262,34689480,48165417,82854897,5,0,0,24576,8,4026822760
8263,34690981,66865125,101556106,7,0,1,9728,8,1925939103
8264,34699130,47835191,82534321,8,0,0,7680,13,2914627590
8265,34700940,47539263,82240203,6,0,0,6656,5,752126088
8266,34704040,47895114,82599154,9,0,0,15872,19,4314046494
8267,34712660,47628532,82341192,3,0,0,9728,12,9145768962
8268,34716030,48160108,82876138,9,0,0,40448,19,2500425663
8269,34718190,66846604,101564794,0,0,1,4608,5,10162164070
8270,34719040,47624515,82343555,8,0,0,7680,13,2062067169
8271,34720320,48222005,82942325,6,0,0,8192,5,3921095577
8272,34720730,66845037,101565767,8,0,1,12800,13,3661023876
8273,34727931,66840504,101568435,7,0,1,4096,8,799228336
8274,34728540,47622838,82351378,1,0,0,25600,14,6742601571
8275,34735930,48009762,82745692,0,0,0,23040,5,902492931
8276,34757910,66813111,101571021,0,0,1,4096,5,1469163925
8277,34763070,48078053,82841123,1,0,0,6656,14,9662267575
8278,34763150,48259448,83022598,1,0,0,14336,14,1815791209
8279,34763550,47972572,82736122,1,0,0,46080,14,8015105567
8280,34763620,47657707,82421327,8,0,0,13824,13,5923033489
8281,34791390,48148005,82939395,8,0,0,13824,13,403517604
8282,34791900,47851492,82643392,7,0,0,28672,8,750342241
8283,34814330,48501549,83315879,3,0,0,35328,12,9399239987
8284,34816191,66757212,101573403,5,0,1,15360,8,8604281528
8285,34816440,48009638,82826078,2,0,0,15872,15,9097226347
8286,34819360,48559441,83378801,8,0,0,49152,13,4763400006
8287,34821651,66780752,101602403,5,0,1,16384,8,7346673772
8288,34825121,66781468,101606589,5,0,1,6656,8,3429666446
8289,34826150,47858347,82684497,7,0,0,33280,8,5333380834
8290,34827970,47720448,82548418,1,0,0,5632,14,4986590002
8291,34843000,48201796,83044796,7,0,0,18944,8,3425669546
8292,34846281,66763534,101609815,7,0,1,5120,8,6507984505
8293,34848470,48260366,83108836,7,0,0,49664,8,9375829760
8294,34854830,48080330,82935160,5,0,0,4608,8,9259974421
8295,34856130,47596774,82452904,9,0,0,5632,19,4076649221
8296,34866230,47718931,82585161,1,0,0,9728,14,5061256410
8297,34869060,47952159,82821219,2,0,0,97792,15,9521507186
8298,34875560,48068972,82944532,1,0,0,7168,14,2400077877
8299,34880670,48021454,82902124,0,0,0,8704,5,549319979
8300,34881190,48566605,83447795,3,0,0,47616,12,9370135853
8301,34884760,47992493,82877253,6,0,0,3584,5,6347245581
8302,34889140,48332486,83221626,4,0,0,11776,4,6991443326
8303,34892180,48190762,83082942,1,0,0,8704,14,5787732308
8304,34893080,48176308,83069388,1,0,0,80384,14,10562217166
8305,34893240,47866923,82760163,9,0,0,6656,19,202076422
8306,34905040,48606398,83511438,1,0,0,72704,14,9175295304
8307,34907070,47831571,82738641,4,0,0,8192,4,7850393778
8308,34911750,47975739,82887489,6,0,0,6656,5,10543098213
8309,34912270,47935116,82847386,2,0,0,20480,15,10210045728
8310,34916520,47921749,82838269,2,0,0,39936,15,5045445572
8311,34920270,48159997,83080267,1,0,0,2560,14,419067454
8312,34921260,66689477,101610737,6,0,1,20480,5,3251457675
8313,34922330,48156019,83078349,0,0,0,29184,5,1323366956
8314,34925900,66688703,101614603,8,0,1,6144,13,8087923273
8315,34926890,48356820,83283710,0,0,0,4608,5,8649215129
8316,34939110,48211200,83150310,8,0,0,23040,13,3249189096
8317,34952760,48534168,83486928,7,0,0,11264,8,2538344867
8318,34956780,66660424,101617204,0,0,1,3584,5,9572071808
8319,34957720,66660632,101618352,4,0,1,10240,4,7194635488
8320,34957850,48388371,83346221,7,0,0,38912,8,8119366406
8321,34960910,48256719,83217629,7,0,0,4096,8,327179177
8322,34962210,48117254,83079464,3,0,0,3584,12,717687656
8323,34963230,48390438,83353668,6,0,0,21504,5,4081579213
8324,34964970,48659239,83624209,8,0,0,38400,13,4544663429
8325,34966930,47935529,82902459,8,0,0,1024,13,3513771529
8326,34967550,48298253,83265803,6,0,0,63488,5,1983397350
8327,34979000,48609370,83588370,9,0,0,133632,19,3079580531
8328,34979200,48299932,83279132,1,0,0,43520,14,5537629632
8329,34983000,48734414,83717414,1,0,0,50176,14,2397532147
8330,34983170,48908331,83891501,9,0,0,28672,19,9250953930
8331,34986250,66642276,101628526,6,0,1,6656,5,3054844456
8332,34988950,48338887,83327837,8,0,0,18944,13,1695183415
8333,34989480,48175572,83165052,6,0,0,4608,5,6638966236
8334,34989760,48822649,83812409,8,0,0,75264,13,5413542075
8335,34993000,48609612,83602612,3,0,0,36864,12,4587517167
8336,34993910,48308847,83302757,7,0,0,7168,8,10019156473
8337,35001690,48148799,83150489,0,0,0,512,5,3267339938
8338,35002719,66629673,101632392,1,0,1,6144,14,3850272912
8339,35010490,48778864,83789354,4,0,0,29184,4,10652061071
8340,35011260,48989912,84001172,8,0,0,1024,13,10050066847
8341,35017740,66641517,101659257,6,0,1,22528,5,3273328095
8342,35018620,48401857,83420477,4,0,0,44032,4,2517533386
8343,35019330,48506718,83526048,7,0,0,33792,8,4807092137
8344,35020120,48892773,83912893,6,0,0,45056,5,8625949530
8345,35021030,48427412,83448442,0,0,0,2048,5,10011883413
8346,35028050,48254225,83282275,8,0,0,10240,13,2486536348
8347,35028840,48950423,83979263,5,0,0,33280,8,10299969525
8348,35032310,48651573,83683883,6,0,0,16384,5,6493494374
8349,35034890,48372148,83407038,0,0,0,47616,5,3725650024
8350,35049470,49011034,84060504,6,0,0,6656,5,5086188204
8351,35057400,48454529,83511929,0,0,0,1536,5,4233802128
8352,35058930,48553556,83612486,7,0,0,12288,8,10460110506
8353,35063410,49150476,84213886,8,0,0,11264,13,1771548195
8354,35064550,66595271,101659821,3,0,1,10752,12,4348740670
8355,35068440,66598917,101667357,3,0,1,4608,12,9911167437
8356,35072980,49022794,84095774,2,0,0,15872,15,1883120167
8357,35073570,66595093,101668663,6,0,1,2048,5,270007244
8358,35079790,66590205,101669995,2,0,1,22528,15,47269069
8359,35085560,49083673,84169233,3,0,0,62976,12,562634452
8360,35098390,48492967,83591357,2,0,0,9728,15,5715799463
8361,35100220,48673020,83773240,4,0,0,69632,4,528121731
8362,35112820,48267408,83380228,1,0,0,4608,14,2655886785
8363,35114300,49469061,84583361,1,0,0,59392,14,2691845062
8364,35116940,66554643,101671583,6,0,1,15872,5,3352164284
8365,35121040,48980810,84101850,4,0,0,5120,4,9243588507
8366,35122380,49099092,84221472,7,0,0,23552,8,7904727695
8367,35125330,49294114,84419444,9,0,0,66560,19,4776185765
8368,35125410,66547159,101672569,0,0,1,1536,5,10475125223
8369,35128860,48404078,83532938,9,0,0,6144,19,8736440514
8370,35131260,48477459,83608719,8,0,0,19968,13,4058785299
8371,35132560,49046228,84178788,2,0,0,31232,15,8987835923
8372,35132780,66592860,101725640,9,0,1,70144,19,10023168182
8373,35132990,66668508,101801498,9,0,1,113152,19,5241904769
8374,35133070,48867767,84000837,6,0,0,4096,5,1102057119
8375,35133430,49475241,84608671,9,0,0,11776,19,3363819480
8376,35138269,66690532,101828801,1,0,1,5120,14,5996288935
8377,35141180,49792224,84933404,5,0,0,2560,8,9247764232
8378,35146180,49773038,84919218,3,0,0,142336,12,2207104888
8379,35148170,66683857,101832027,2,0,1,5120,15,8086732140
8380,35148820,48631619,83780439,3,0,0,23552,12,6901820484
8381,35153090,49489420,84642510,6,0,0,5632,5,4123618724
8382,35156340,48959382,84115722,2,0,0,15360,15,5006697095
8383,35158040,49324864,84482904,2,0,0,42496,15,772089722
8384,35163540,48986482,84150022,5,0,0,57344,8,3302685537
8385,35167640,48684010,83851650,6,0,0,5120,5,5464102814
8386,35168970,48830596,83999566,1,0,0,66560,14,5596958542
8387,35170930,49073690,84244620,4,0,0,13824,4,7473924012
8388,35173130,48863866,84036996,8,0,0,5120,13,2971601841
8389,35178720,49122852,84301572,4,0,0,39424,4,8235947409
8390,35180470,48698589,83879059,6,0,0,10752,5,4543168088
8391,35182020,66654475,101836495,2,0,1,1024,15,1946795875
8392,35184570,49487719,84672289,7,0,0,8192,8,10543790506
8393,35185919,66656684,101842603,1,0,1,20992,14,4814154284
8394,35186340,66664872,101851212,8,0,1,3072,13,2483848127
8395,35187930,66663538,101851468,3,0,1,9216,12,5814560172
8396,35197740,49952863,85150603,6,0,0,96256,5,5256459432
8397,35198340,49089695,84288035,6,0,0,512,5,2858818177
8398,35207500,49311668,84519168,1,0,0,45568,14,222871721
8399,35213520,49793670,85007190,0,0,0,28160,5,2743104478
8400,35224250,48863427,84087677,4,0,0,2048,4,58246817
8401,35227030,49395080,84622110,3,0,0,44032,12,6807800041
8402,35228840,48858190,84087030,6,0,0,11776,5,8024677841
8403,35235540,48771020,84006560,7,0,0,11264,8,9133755614
8404,35240320,66613414,101853734,2,0,1,3584,15,6157665380
8405,35241650,48957336,84198986,8,0,0,8704,13,7786092349
8406,35248690,48795823,84044513,7,0,0,19456,8,2002391545
8407,35252620,49272187,84524807,0,0,0,18432,5,572476920
8408,35256530,49187652,84444182,2,0,0,4608,15,2150079835
8409,35257240,48929394,84186634,9,0,0,1024,19,6761204297
8410,35259380,49506089,84765469,4,0,0,3584,4,3884956089
8411,35259580,50421169,85680749,7,0,0,30208,8,964546300
8412,35262300,50163582,85425882,0,0,0,20992,5,504688338
8413,35265650,49404120,84669770,5,0,0,50176,8,4475671530
8414,35267110,50343488,85610598,9,0,0,25088,19,10567159730
8415,35269890,49605937,84875827,8,0,0,77312,13,4175580844
8416,35280120,49084817,84364937,2,0,0,14848,15,9201662314
8417,35280860,48905439,84186299,8,0,0,24576,13,2483671886
8418,35286650,49140305,84426955,8,0,0,24576,13,6110219198
8419,35291560,49388552,84680112,0,0,0,25600,5,4425074402
8420,35298540,49415282,84713822,2,0,0,26624,15,3502326501
8421,35306000,48904431,84210431,9,0,0,18432,19,3034589698
8422,35307970,49539166,84847136,9,0,0,66560,19,8581200390
8423,35311210,49293850,84605060,1,0,0,42496,14,5733294598
8424,35312090,66553320,101865410,4,0,1,18432,4,8034724003
8425,35324600,66543076,101867676,0,0,1,3584,5,4122872779
8426,35326780,49031426,84358206,6,0,0,22528,5,6696303789
8427,35329920,66790698,102120618,9,0,1,382464,19,4657620911
8428,35331600,49374087,84705687,9,0,0,27648,19,3098385702
8429,35335920,50499783,85835703,4,0,0,116736,4,1899611785
8430,35341280,49468938,84810218,1,0,0,7168,14,5934638671
8431,35352760,49096281,84449041,6,0,0,15872,5,4007642995
8432,35354380,66772488,102126868,6,0,1,13312,5,3659419543
8433,35367680,49316823,84684503,6,0,0,14336,5,7032485060
8434,35370810,49598064,84968874,8,0,0,13312,13,9918150162
8435,35375420,49114839,84490259,2,0,0,24064,15,7249849057
8436,35376420,49744832,85121252,3,0,0,16896,12,5604969523
8437,35378170,49897578,85275748,6,0,0,4608,5,3404180307
8438,35386120,49721000,85107120,4,0,0,138240,4,4541174540
8439,35386920,66756564,102143484,9,0,1,15360,19,2130812838
8440,35392250,49723831,85116081,1,0,0,19456,14,8889949264
8441,35396930,49523012,84919942,2,0,0,2048,15,4189738030
8442,35397000,49157540,84554540,9,0,0,12800,19,3360912191
8443,35397140,66747330,102144470,6,0,1,1536,5,9592454665
8444,35401350,49531251,84932601,9,0,0,41472,19,82267128
8445,35405400,49554978,84960378,7,0,0,35840,8,7372404684
8446,35410700,48915546,84326246,6,0,0,2048,5,3663350629
8447,35414370,49210727,84625097,5,0,0,9728,8,6953069443
8448,35415400,49384556,84799956,8,0,0,24064,13,3537951198
8449,35419920,66727776,102147696,4,0,1,5120,4,976233182
8450,35423330,50513353,85936683,9,0,0,148480,19,10030292864
8451,35435230,49286883,84722113,9,0,0,27136,19,492259713
8452,35444510,49794014,85238524,2,0,0,12800,15,1069264142
8453,35445410,50207764,85653174,3,0,0,4096,12,4028352257
8454,35455160,49267912,84723072,4,0,0,3072,4,1878163608
8455,35458190,66693052,102151242,3,0,1,5632,12,9601129996
8456,35460860,50329156,85790016,2,0,0,58880,15,10550133234
8457,35465980,49123949,84589929,4,0,0,6656,4,2787661944
8458,35467770,49186509,84654279,5,0,0,5120,8,5777468742
8459,35473030,49743429,85216459,2,0,0,54784,15,9849562121
8460,35474690,49756300,85230990,0,0,0,47616,5,3087427219
8461,35474850,49316360,84791210,2,0,0,15360,15,7287781968
8462,35475270,49535063,85010333,3,0,0,10240,12,3065795251
8463,35478040,49465706,84943746,4,0,0,33792,4,8249625506
8464,35487730,49766332,85254062,2,0,0,5120,15,3995556646
8465,35492170,49894464,85386634,8,0,0,36352,13,125357643
8466,35493210,66658186,102151396,9,0,1,8704,19,5241792517
8467,35497830,49548227,85046057,5,0,0,26624,8,4936168575
8468,35502970,66650692,102153662,9,0,1,3584,19,10143603250
8469,35506510,50519438,86025948,6,0,0,39936,5,7901563330
8470,35523420,50429119,85952539,7,0,0,5120,8,2475247582
8471,35535470,50640332,86175802,6,0,0,65024,5,3475063796
8472,35536310,49698291,85234601,0,0,0,11776,5,8352053916
8473,35536590,66629999,102166589,6,0,1,9216,5,5243817913
8474,35536640,66630935,102167575,4,0,1,1536,4,5634297845
8475,35542730,49783823,85326553,0,0,0,6656,5,7251242813
8476,35545170,50402144,85947314,8,0,0,34816,13,4615180060
8477,35548760,49695559,85244319,5,0,0,18944,8,4678894777
8478,35554409,66615432,102169841,1,0,1,3584,14,10478845787
8479,35562740,49547390,85110130,0,0,0,9728,5,9600452552
8480,35568440,50873975,86442415,5,0,0,13312,8,3388998613
8481,35574020,66596487,102170507,0,0,1,1024,5,5025044682
8482,35575810,49371547,84947357,1,0,0,11776,14,2052245356
8483,35576160,66604017,102180177,0,0,1,9216,5,953482961
8484,35583130,49454049,85037179,5,0,0,17920,8,4649892300
8485,35586210,50117174,85703384,5,0,0,24576,8,9089919260
8486,35588050,50143054,85731104,7,0,0,52736,8,7024317789
8487,35590070,50688877,86278947,9,0,0,72192,19,4803243192
8488,35596751,66584412,102181163,5,0,1,1536,8,9029203569
8489,35599440,49843447,85442887,2,0,0,44544,15,309313585
8490,35608330,50342618,85950948,0,0,0,11264,5,2553640978
8491,35613320,49552959,85166279,0,0,0,512,5,1031184496
8492,35616580,49847115,85463695,8,0,0,47104,13,2357319335
8493,35617380,50362262,85979642,5,0,0,20480,8,6793825321
8494,35617750,49656571,85274321,6,0,0,47616,5,6168929915
8495,35620670,49964951,85585621,6,0,0,32768,5,5691564946
8496,35621980,50584015,86205995,4,0,0,81408,4,9457486014
8497,35626380,50088617,85714997,6,0,0,9216,5,9301530075
8498,35626770,50499731,86126501,8,0,0,94208,13,2483308572
8499,35628950,49713778,85342728,7,0,0,22016,8,5235665920
8500,35631210,49761531,85392741,6,0,0,19968,5,8924020515
8501,35635210,49740325,85375535,3,0,0,71168,12,10655447213
8502,35636030,50452605,86088635,4,0,0,51712,4,6254761932
8503,35641340,49909973,85551313,4,0,0,20992,4,1965518029
8504,35646050,49852629,85498679,9,0,0,14336,19,4097364356
8505,35646710,50064965,85711675,0,0,0,27136,5,6161668006
8506,35658020,50140926,85798946,2,0,0,13824,15,9737091880
8507,35660000,50583699,86243699,6,0,0,49664,5,5146011912
8508,35663530,49984556,85648086,9,0,0,32768,19,6914826943
8509,35672720,49925248,85597968,3,0,0,40448,12,326031363
8510,35687840,49981631,85669471,6,0,0,34816,5,2040769092
8511,35693020,49928919,85621939,4,0,0,19968,4,10356227410
8512,35698030,49768964,85466994,9,0,0,10752,19,3595252512
8513,35702480,49769722,85472202,1,0,0,12288,14,7721741569
8514,35708900,50324091,86032991,7,0,0,23040,8,3809791220
8515,35710410,50080565,85790975,4,0,0,3072,4,8958969037
8516,35712030,49774993,85487023,3,0,0,23040,12,2670928722
8517,35715770,50428561,86144331,0,0,0,53760,5,520967441
8518,35725900,49945622,85671522,7,0,0,6656,8,2499901815
8519,35726660,49931711,85658371,5,0,0,13312,8,8930040785
8520,35727710,50160395,85888105,8,0,0,23552,13,6537359686
8521,35730820,49736353,85467173,4,0,0,512,4,10607998304
8522,35731530,49747998,85479528,4,0,0,4608,4,8825016674
8523,35735960,50328120,86064080,7,0,0,4096,8,1756144675
8524,35737020,50318204,86055224,0,0,0,15360,5,7407590962
8525,35741140,50386788,86127928,6,0,0,4608,5,2420776208
8526,35742800,50776625,86519425,8,0,0,17920,13,9678943994
8527,35744180,50561373,86305553,2,0,0,4096,15,925983758
8528,35744450,50096892,85841342,9,0,0,18432,19,8937867476
8529,35746940,49887200,85634140,2,0,0,4608,15,7408046969
8530,35748460,50751663,86500123,5,0,0,6144,8,3488901417
8531,35749010,49862079,85611089,3,0,0,1536,12,8338930814
8532,35750961,66432468,102183429,7,0,1,3584,8,1119146199
8533,35750980,49989975,85740955,2,0,0,32256,15,4415641193
8534,35751580,50040042,85791622,8,0,0,2048,13,3354605099
8535,35753030,50094575,85847605,5,0,0,20480,8,916090368
8536,35755380,50453313,86208693,0,0,0,5120,5,147899690
8537,35756700,50340318,86097018,1,0,0,13824,14,8832928419
8538,35760470,49923734,85684204,8,0,0,11264,13,136298635
8539,35768640,49943526,85712166,7,0,0,1536,8,4276427703
8540,35772950,50530327,86303277,5,0,0,19456,8,4140230440
8541,35774330,66409867,102184197,6,0,1,11776,5,321400121
8542,35774471,66410494,102184965,7,0,1,11776,8,5879451167
8543,35776930,50404238,86181168,9,0,0,6656,19,6200651185
8544,35781510,50466759,86248269,3,0,0,14848,12,4023403684
8545,35794100,49959020,85753120,1,0,0,9728,14,5631971424
8546,35796540,50272850,86069390,3,0,0,5120,12,4471673150
8547,35797290,50529017,86326307,3,0,0,512,12,5560124697
8548,35798880,50355793,86154673,8,0,0,33792,13,9255633423
8549,35812890,50415654,86228544,7,0,0,65024,8,3751558949
8550,35815080,50779825,86594905,3,0,0,16384,12,7068813805
8551,35821480,50334487,86155967,6,0,0,4096,5,6782130767
8552,35825670,50140171,85965841,8,0,0,10752,13,1109513604
8553,35825821,66359810,102185631,7,0,1,1024,8,9282002727
8554,35827240,66362577,102189817,0,0,1,6656,5,10719910650
8555,35839319,66351804,102191123,1,0,1,2048,14,9186678686
8556,35840360,50149573,85989933,0,0,0,512,5,4650759608
8557,35850730,50728877,86579607,8,0,0,45568,13,1448721465
8558,35851830,66341777,102193607,0,0,1,15872,5,9526448833
8559,35859830,50644060,86503890,8,0,0,12288,13,3746272170
8560,35864210,50762389,86626599,6,0,0,4096,5,4359328295
8561,35865510,50171593,86037103,7,0,0,1536,8,1482549137
8562,35877940,50863506,86741446,2,0,0,58368,15,9872698010
8563,35887260,66307525,102194785,9,0,1,13824,19,8892874529
8564,35894090,50068169,85962259,1,0,0,28672,14,2111951539
8565,35899570,50307540,86207110,4,0,0,3584,4,9672320538
8566,35909140,50038353,85947493,5,0,0,512,8,1223540877
8567,35910650,50841435,86752085,2,0,0,34816,15,1632792564
8568,35912790,50179993,86092783,3,0,0,13312,12,9926112705
8569,35926469,66273929,102200398,1,0,1,6656,14,8913297362
8570,35927050,51014416,86941466,6,0,0,42496,5,3486432210
8571,35930170,50248931,86179101,1,0,0,10752,14,2092789414
8572,35931350,50891561,86822911,2,0,0,15360,15,5184939210
8573,35934010,66269294,102203304,8,0,1,4608,13,4967010501
8574,35935060,66270830,102205890,8,0,1,4096,13,2098017347
8575,35939930,50346996,86286926,2,0,0,26112,15,4776898979
8576,35943430,50390915,86334345,8,0,0,4096,13,6123804720
8577,35950100,50548128,86498228,0,0,0,81408,5,6544257182
8578,35950750,50300373,86251123,2,0,0,9216,15,9517924205
8579,35952379,66277951,102230330,1,0,1,23040,14,915346520
8580,35953740,66279816,102233556,9,0,1,5120,19,8241126032
8581,35957420,66278082,102235502,0,0,1,3072,5,5871482959
8582,35958850,51366316,87325166,8,0,0,37888,13,6421581260
8583,35959350,50429037,86388387,0,0,0,32256,5,8953417836
8584,35963300,50510101,86473401,8,0,0,73216,13,3769405535
8585,35969310,50885937,86855247,9,0,0,10240,19,7037968168
8586,35970880,66268808,102239688,8,0,1,6656,13,4965885324
8587,35975990,51108839,87084829,2,0,0,74752,15,7998291587
8588,35978890,50586810,86565700,2,0,0,4096,15,2786585512
8589,35981840,50351234,86333074,8,0,0,14336,13,1200633718
8590,35982860,50775956,86758816,3,0,0,22016,12,425329148
8591,35984640,50465933,86450573,4,0,0,6144,4,6140762693
8592,35985321,66254623,102239944,7,0,1,9216,8,652513602
8593,35985990,50630423,86616413,8,0,0,55808,13,5377429107
8594,36008909,66235541,102244450,1,0,1,7168,14,6569706603
8595,36014410,50610918,86625328,2,0,0,29184,15,5188764029
8596,36016530,50235084,86251614,3,0,0,1536,12,9655304509
8597,36018160,66238375,102256535,0,0,1,36864,5,5479225754
8598,36019000,50379696,86398696,0,0,0,22528,5,10648355165
8599,36019960,51038927,87058887,4,0,0,20480,4,8541254144
8600,36022420,50321876,86344296,1,0,0,6144,14,8783625696
8601,36022560,66241067,102263627,6,0,1,11264,5,5155971476
8602,36042220,50837239,86879459,2,0,0,11776,15,2017257228
8603,36048120,50400558,86448678,6,0,0,20480,5,800500321
8604,36059809,66207044,102266853,1,0,1,5120,14,3421127533
8605,36060840,50708139,86768979,8,0,0,33280,13,4034221104
8606,36061110,51472664,87533774,3,0,0,125440,12,5205787831
8607,36063930,51353174,87417104,7,0,0,15360,8,7479342543
8608,36066390,50496593,86562983,3,0,0,13824,12,9928738815
8609,36067120,50751088,86818208,6,0,0,56320,5,10612672015
8610,36075920,51613746,87689666,6,0,0,9728,5,8554234554
8611,36079080,50626305,86705385,8,0,0,6656,13,6936733746
8612,36079450,51083043,87162493,8,0,0,4096,13,4972761318
8613,36082080,50951310,87033390,3,0,0,93696,12,7374227139
8614,36084600,66183879,102268479,0,0,1,2560,5,639140214
8615,36088940,50889869,86978809,8,0,0,3072,13,10218977388
8616,36094270,50730692,86824962,1,0,0,6656,14,1072919741
8617,36094630,50629009,86723639,3,0,0,18432,12,7724404644
8618,36096820,51757527,87854347,8,0,0,29184,13,10018161621
8619,36100060,50742108,86842168,2,0,0,28672,15,10201097288
8620,36120499,66153145,102273644,1,0,1,7680,14,6040745195
8621,36132530,51648311,87780841,0,0,0,7168,5,357670625
8622,36147150,51658370,87805520,4,0,0,76288,4,3016020928
8623,36148640,50554694,86703334,2,0,0,10752,15,9982220386
8624,36155560,50772935,86928495,6,0,0,43520,5,9981640589
8625,36156681,66120829,102277510,5,0,1,6144,8,7353805406
8626,36159330,50628563,86787893,6,0,0,21504,5,10278325951
8627,36160180,51960971,88121151,8,0,0,66560,13,17091202
8628,36166370,66115979,102282349,0,0,1,18944,5,6927659473
8629,36168180,50774713,86942893,2,0,0,4608,15,5996429295
8630,36171570,50661839,86833409,4,0,0,27648,4,2106546408
8631,36173840,50888190,87062030,8,0,0,10240,13,7813376639
8632,36176400,50674054,86850454,5,0,0,1536,8,2740141240
8633,36176790,51766660,87943450,7,0,0,52224,8,6174868999
8634,36179930,51877841,88057771,9,0,0,144384,19,5575328811
8635,36198720,50896310,87095030,7,0,0,4096,8,6575649051
8636,36205050,51075375,87280425,1,0,0,50688,14,10224188102
8637,36206050,50846574,87052624,4,0,0,61440,4,10502166868
8638,36206900,50643063,86849963,7,0,0,10752,8,8905091336
8639,36208970,50979734,87188704,6,0,0,33280,5,10037939333
8640,36210860,50646219,86857079,8,0,0,3072,13,8226663584
8641,36216140,66079879,102296019,8,0,1,15872,13,7712402510
8642,36220780,50680735,86901515,4,0,0,5120,4,7108049621
8643,36224500,51905441,88129941,3,0,0,17408,12,9068193447
8644,36230350,50855758,87086108,5,0,0,4096,8,2487247968
8645,36243090,66059701,102302791,0,0,1,10752,5,4564061262
8646,36252780,50781101,87033881,3,0,0,1536,12,836497484
8647,36253230,66053107,102306337,6,0,1,5632,5,5124664912
8648,36261410,50865195,87126605,5,0,0,29696,8,1283993765
8649,36262121,66046482,102308603,7,0,1,3584,8,268728014
8650,36265279,66046550,102311829,1,0,1,5120,14,3247910831
8651,36267130,51981751,88248881,3,0,0,51712,12,579781270
8652,36267170,50911371,87178541,6,0,0,41472,5,8440996221
8653,36274780,51010816,87285596,5,0,0,16896,8,10199268143
8654,36282440,50913798,87196238,4,0,0,24576,4,3062416570
8655,36286040,66026775,102312815,0,0,1,1536,5,3385949418
8656,36288940,50939653,87228593,5,0,0,4096,8,9451231394
8657,36289860,66023621,102313481,6,0,1,1024,5,5763229970
8658,36303770,66011337,102315107,4,0,1,2560,4,5819343994
8659,36308160,66010173,102318333,4,0,1,5120,4,588609174
8660,36309539,66012980,102322519,1,0,1,6656,14,9149866468
8661,36315690,50891089,87206779,0,0,0,7168,5,1517088226
8662,36317510,50896906,87214416,9,0,0,15872,19,6172860210
8663,36319290,51093111,87412401,8,0,0,30720,13,617983780
8664,36323360,52078208,88401568,7,0,0,37888,8,9840318087
8665,36324950,66004739,102329689,8,0,1,28672,13,6138415530
8666,36325360,51017833,87343193,8,0,0,10752,13,7448376983
8667,36329020,50978373,87307393,2,0,0,33792,15,629153980
8668,36329271,66003644,102332915,7,0,1,5120,8,5640856720
8669,36336750,50878625,87215375,7,0,0,3072,8,3553723250
8670,36341940,51111867,87453807,0,0,0,9216,5,8101512263
8671,36344050,65990811,102334861,8,0,1,3072,13,10238588624
8672,36349360,51004714,87354074,9,0,0,11776,19,7334656962
8673,36353360,51224341,87577701,5,0,0,21504,8,4570598975
8674,36355100,51062339,87417439,8,0,0,1024,13,10604414406
8675,36356921,65978926,102335847,7,0,1,1536,8,8362003190
8676,36358920,51237824,87596744,4,0,0,18432,4,1018887078
8677,36369621,65966892,102336513,7,0,1,1024,8,2524584913
8678,36373090,50985375,87358465,1,0,0,14336,14,6634423105
8679,36376780,51968560,88345340,4,0,0,86016,4,1704961790
8680,36379110,51159835,87538945,2,0,0,16896,15,6146781208
8681,36380440,65959299,102339739,4,0,1,5120,4,6251066440
8682,36386700,51283718,87670418,5,0,0,13312,8,8357996171
8683,36396870,51614523,88011393,3,0,0,133120,12,2667863437
8684,36397420,65946185,102343605,6,0,1,6144,5,5155528298
8685,36400000,51233213,87633213,4,0,0,67584,4,9263000017
8686,36402650,50937244,87339894,5,0,0,7680,8,4720079972
8687,36408220,51716394,88124614,7,0,0,11264,8,1163131676
8688,36411040,51260223,87671263,6,0,0,1536,5,2638658296
8689,36414770,51185897,87600667,8,0,0,12800,13,7242929366
8690,36414800,51770742,88185542,7,0,0,88064,8,6915589143
8691,36422940,51466591,87889531,9,0,0,50176,19,1103403399
8692,36424100,51421332,87845432,5,0,0,10752,8,9945578842
8693,36426680,65917591,102344271,9,0,1,1024,19,7551432591
8694,36426970,51338886,87765856,5,0,0,25600,8,3387607197
8695,36428190,51523441,87951631,8,0,0,26624,13,7635921504
8696,36434640,51200006,87634646,1,0,0,512,14,8554797129
8697,36438950,51101110,87540060,7,0,0,3584,8,7748554358
8698,36439030,51574726,88013756,6,0,0,7680,5,7209752693
8699,36446780,65898464,102345244,6,0,1,12800,5,7405003788
8700,36449740,51751193,88200933,7,0,0,10240,8,10302386699
8701,36452370,51636560,88088930,3,0,0,19968,12,3375652213
8702,36461860,51619068,88080928,3,0,0,512,12,5802375767
8703,36463590,51378543,87842133,5,0,0,25088,8,5921244715
8704,36463600,51637053,88100653,1,0,0,38400,14,6379002571
8705,36463810,51726279,88190089,6,0,0,14848,5,7653915500
8706,36465280,51390517,87855797,4,0,0,2560,4,7603220051
8707,36468180,51289853,87758033,6,0,0,29184,5,149532190
8708,36469730,51948896,88418626,6,0,0,40448,5,6208009748
8709,36476660,51655644,88132304,4,0,0,7680,4,9142932442
8710,36483230,51784981,88268211,8,0,0,36864,13,1173188695
8711,36484930,51413184,87898114,5,0,0,14336,8,7684769026
8712,36485660,51369334,87854994,8,0,0,2048,13,4493331824
8713,36495621,65849969,102345590,7,0,1,512,8,8896514119
8714,36502550,65846586,102349136,9,0,1,5632,19,5351018719
8715,36503180,65852408,102355588,4,0,1,10240,4,3210076852
8716,36504730,51368125,87872855,8,0,0,5632,13,7063042410
8717,36508070,51572679,88080749,9,0,0,12800,19,2276569141
8718,36513460,51563366,88076826,7,0,0,62464,8,5335044005
8719,36518500,51843701,88362201,4,0,0,26624,4,9803885710
8720,36520620,65836274,102356894,3,0,1,2048,12,3725875045
8721,36521560,51579288,88100848,9,0,0,512,19,4277352599
8722,36523740,65838646,102362386,4,0,1,8704,4,2796430260
8723,36526241,65837451,102363692,7,0,1,2048,8,8057771394
8724,36535990,51546833,88082823,1,0,0,6144,14,6562062120
8725,36550130,51588445,88138575,4,0,0,20480,4,9073470829
8726,36552080,51767029,88319109,5,0,0,75264,8,7727054561
8727,36562920,52000595,88563515,8,0,0,77824,13,1481855063
8728,36571640,51891500,88463140,8,0,0,29696,13,5437189322
8729,36578260,51773366,88351626,0,0,0,12288,5,7926288388
8730,36579300,51571065,88150365,0,0,0,4096,5,9623256981
8731,36581890,51824389,88406279,6,0,0,15360,5,3107048734
8732,36583220,65782431,102365651,3,0,1,14336,12,3372214982
8733,36586700,51606220,88192920,1,0,0,9216,14,7994599908
8734,36589120,65789431,102378551,9,0,1,15360,19,4343291250
8735,36596821,65791411,102388232,7,0,1,1024,8,3507832754
8736,36597710,51750149,88347859,9,0,0,8192,19,5481355216
8737,36597930,51792071,88390001,2,0,0,54272,15,959613842
8738,36599960,52149530,88749490,3,0,0,40448,12,3794973614
8739,36602330,51907604,88509934,3,0,0,2560,12,968552185
8740,36610441,65779097,102389538,7,0,1,2048,8,6630881863
8741,36623930,65765967,102389897,6,0,1,9728,5,4929807390
8742,36627000,51872548,88499548,8,0,0,38400,13,2160891027
8743,36633520,51795808,88429328,7,0,0,6656,8,9592033278
8744,36643010,51840631,88483641,2,0,0,27648,15,4976660782
8745,36650549,65755484,102406033,1,0,1,2560,14,7131231350
8746,36650960,65757659,102408619,8,0,1,4096,13,7497069687
8747,36653990,51967214,88621204,2,0,0,8704,15,6517708259
8748,36659530,51875132,88534662,8,0,0,20480,13,5150932858
8749,36661180,52188973,88850153,3,0,0,66048,12,10541622147
8750,36663590,51838009,88501599,1,0,0,6656,14,3547820873
8751,36664660,51708768,88373428,1,0,0,9728,14,9212800261
8752,36667820,51816156,88483976,4,0,0,1024,4,9997898051
8753,36672120,52088248,88760368,1,0,0,25088,14,8244463539
8754,36672620,51754657,88427277,2,0,0,14848,15,277506378
8755,36674080,51905378,88579458,1,0,0,52224,14,6105926945
8756,36681190,52015372,88696562,6,0,0,40448,5,4761801712
8757,36682680,51857100,88539780,2,0,0,6656,15,7315123808
8758,36682950,52115449,88798399,8,0,0,50176,13,7748568254
8759,36688120,52285848,88973968,4,0,0,24576,4,4743636192
8760,36688960,52088100,88777060,1,0,0,48128,14,2867730954
8761,36693330,51887243,88580573,7,0,0,3584,8,1200287318
8762,36694710,52502728,89197438,2,0,0,29184,15,9198913220
8763,36696720,52009173,88705893,6,0,0,23552,5,3665376931
8764,36699611,65712554,102412165,5,0,1,5632,8,8220679459
8765,36703360,52149693,88853053,5,0,0,7168,8,5286095284
8766,36706400,51902893,88609293,7,0,0,17408,8,6063162752
8767,36707560,52075451,88783011,1,0,0,19456,14,145371006
8768,36708450,51975765,88684215,2,0,0,35328,15,4279136358
8769,36718510,52182564,88901074,2,0,0,13312,15,7929926857
8770,36719010,52090956,88809966,7,0,0,37888,8,5300815561
8771,36719700,51881682,88601382,8,0,0,1024,13,7958991710
8772,36722020,52217205,88939225,4,0,0,22528,4,513772598
8773,36726390,65686761,102413151,6,0,1,1536,5,8170562409
8774,36727430,65690288,102417718,8,0,1,512,13,1680090330
8775,36736679,65685865,102422544,1,0,1,7680,14,2637421229
8776,36749530,52307692,89057222,3,0,0,4608,12,5777586384
8777,36750200,65678982,102429182,8,0,1,8192,13,8614710204
8778,36750650,52157935,88908585,9,0,0,24576,19,3541654332
8779,36754710,52198543,88953253,3,0,0,44544,12,3891578995
8780,36755590,52231374,88986964,4,0,0,18944,4,1884415518
8781,36760130,65670722,102430852,4,0,1,9728,4,5788339775
8782,36766520,52088592,88855112,9,0,0,6656,19,1709873478
8783,36770260,65662672,102432932,3,0,1,10240,12,4327640839
8784,36770740,52269463,89040203,0,0,0,12800,5,3337294567
8785,36771020,52506184,89277204,0,0,0,51712,5,1178248813
8786,36783440,52206066,88989506,1,0,0,1024,14,2688974383
8787,36785250,52065573,88850823,9,0,0,2048,19,2123635943
8788,36786530,52193798,88980328,6,0,0,12288,5,7261253697
8789,36788379,65679478,102467857,1,0,1,20480,14,10016309631
8790,36790460,52295018,89085478,6,0,0,23552,5,2078196292
8791,36796109,65681288,102477397,1,0,1,6656,14,9396499981
8792,36796740,52202758,88999498,5,0,0,7168,8,6584430942
8793,36816380,52933335,89749715,2,0,0,30208,15,6667545809
8794,36816760,52444596,89261356,2,0,0,26112,15,311253475
8795,36817400,52171771,88989171,7,0,0,7168,8,8280716414
8796,36821790,52466926,89288716,3,0,0,20480,12,7132035617
8797,36823150,52751433,89574583,4,0,0,59904,4,8619243131
8798,36823550,52683153,89506703,1,0,0,39936,14,4917155886
8799,36824410,52281127,89105537,3,0,0,3072,12,2321291795
8800,36828010,52538765,89366775,1,0,0,15360,14,4788972855
8801,36829770,52325380,89155150,7,0,0,51712,8,9697058294
8802,36833820,52232783,89066603,3,0,0,8704,12,5092424167
8803,36840890,52607003,89447893,4,0,0,8192,4,903079348
8804,36844910,65632948,102477858,6,0,1,10240,5,8957045095
8805,36846550,52470641,89317191,1,0,0,5120,14,34578077
8806,36855630,52268721,89124351,4,0,0,27136,4,2867076463
8807,36863130,52492546,89355676,2,0,0,19456,15,2715340911
8808,36869180,52475374,89344554,4,0,0,31744,4,77149293
8809,36874760,53078964,89953724,8,0,0,86528,13,4126888830
8810,36875070,52550650,89425720,0,0,0,13824,5,4192021731
8811,36877840,52437768,89315608,1,0,0,32768,14,8116026282
8812,36885440,52801907,89687347,7,0,0,49664,8,9143751374
8813,36885790,52585038,89470828,8,0,0,29184,13,1180780150
8814,36893690,52456035,89349725,5,0,0,16896,8,9065341123
8815,36896320,65588618,102484938,9,0,1,33792,19,10495762040
8816,36898440,52621124,89519564,9,0,0,25088,19,7710256057
8817,36904760,52416822,89321582,8,0,0,14336,13,5594438542
8818,36906950,65581214,102488164,9,0,1,5120,19,5285370198
8819,36908100,65593628,102501728,8,0,1,20992,13,6452415459
8820,36908480,52586032,89494512,4,0,0,41984,4,4788511003
8821,36909340,52760803,89670143,3,0,0,5632,12,7787252600
8822,36915640,65590914,102506554,9,0,1,7680,19,1743580968
8823,36917420,52405121,89322541,2,0,0,3072,15,3330625450
8824,36920440,52462669,89383109,1,0,0,7680,14,4282612212
8825,36930160,52838917,89769077,7,0,0,1536,8,10392772991
8826,36937680,52611970,89549650,8,0,0,1024,13,4580974071
8827,36940130,52865483,89805613,1,0,0,8192,14,6461767367
8828,36941740,52771207,89712947,0,0,0,50688,5,9495840524
8829,36947170,65565334,102512504,8,0,1,3072,13,2107001213
8830,36953560,52437763,89391323,7,0,0,3584,8,6277937265
8831,36953850,52806965,89760815,3,0,0,6144,12,7036229091
8832,36958710,52732872,89691582,1,0,0,13824,14,7347935960
8833,36962900,65567180,102530080,3,0,1,9216,12,8732492558
8834,36973130,52538767,89511897,4,0,0,9728,4,2388378748
8835,36973970,52808939,89782909,8,0,0,14336,13,8436327113
8836,36975810,52533100,89508910,8,0,0,7168,13,1638073539
8837,36981951,65552315,102534266,5,0,1,6656,8,3050912134
8838,36987330,52780959,89768289,3,0,0,20992,12,2589024810
8839,36995300,52914263,89909563,1,0,0,25600,14,4382551504
8840,37000680,52838343,89839023,1,0,0,30208,14,8695825694
8841,37000730,52696270,89697000,9,0,0,3584,19,4668041523
8842,37002060,53028410,90030470,8,0,0,34816,13,8228496801
8843,37010440,65525452,102535892,6,0,1,2560,5,1280739500
8844,37010810,53020619,90031429,2,0,0,3072,15,358498899
8845,37013220,65522826,102536046,9,0,1,8704,19,7219811034
8846,37016220,52905846,89922066,0,0,0,40960,5,10557126160
8847,37021040,53188236,90209276,6,0,0,89088,5,4258681666
8848,37029850,52864687,89894537,2,0,0,12800,15,6944501142
8849,37033380,52757484,89790864,8,0,0,14848,13,6857373437
8850,37033750,53148359,90182109,2,0,0,28672,15,4270530616
8851,37034930,52837289,89872219,1,0,0,54272,14,2033927778
8852,37035110,53226215,90261325,5,0,0,70656,8,6810370757
8853,37038420,65498932,102537352,9,0,1,2048,19,6463005662
8854,37041760,52913243,89955003,6,0,0,4096,5,3726429469
8855,37043390,53347918,90391308,7,0,0,36352,8,5264186244
8856,37044930,52833419,89878349,2,0,0,4096,15,1919699742
8857,37047400,53233612,90281012,3,0,0,64512,12,3966519026
8858,37048290,53076308,90124598,6,0,0,19456,5,1516751813
8859,37048360,52834395,89882755,8,0,0,8192,13,9970736828
8860,37048720,65491538,102540258,4,0,1,4608,4,5578620382
8861,37054930,52902436,89957366,5,0,0,7680,8,9870703341
8862,37061470,53077994,90139464,6,0,0,35328,5,527110453
8863,37064560,53377800,90442360,6,0,0,34304,5,2671393936
8864,37070580,52893716,89964296,9,0,0,15360,19,6430273271
8865,37070969,65473564,102544533,1,0,1,512,14,7859362261
8866,37073860,53408234,90482094,5,0,0,30720,8,10681262785
8867,37079770,53222474,90302244,8,0,0,10240,13,6404267064
8868,37079890,53542990,90622880,1,0,0,24064,14,6947592288
8869,37080290,65482088,102562378,9,0,1,3072,19,1090421245
8870,37082810,53014991,90097801,3,0,0,34304,12,6867732907
8871,37084420,53018396,90102816,6,0,0,16384,5,7220091262
8872,37108149,65463899,102572048,1,0,1,5632,14,6326968890
8873,37110530,65467205,102577735,3,0,1,6656,12,1650879441
8874,37110680,53236430,90347110,3,0,0,23040,12,4693893615
8875,37113860,52728618,89842478,6,0,0,11264,5,8913220468
8876,37117410,53195250,90312660,6,0,0,4096,5,5773551699
8877,37122119,65455962,102578081,1,0,1,512,14,1672471279
8878,37123090,53727400,90850490,1,0,0,1536,14,7737924309
8879,37129290,52999387,90128677,0,0,0,13312,5,3569054116
8880,37136980,52949699,90086679,2,0,0,96256,15,893612044
8881,37140570,53629430,90770000,1,0,0,35840,14,1405208951
8882,37142770,52734308,89877078,4,0,0,15872,4,408800383
8883,37143930,53095844,90239774,2,0,0,23552,15,4744073372
8884,37147600,52862518,90010118,1,0,0,18432,14,4853202634
8885,37159420,53061433,90220853,3,0,0,10240,12,2221913858
8886,37159690,52927636,90087326,8,0,0,2048,13,1529889684
8887,37161250,65422220,102583470,8,0,1,17408,13,7286808757
8888,37167340,52876111,90043451,1,0,0,21504,14,2756130148
8889,37170980,52947667,90118647,7,0,0,34816,8,10561011191
8890,37177900,53135204,90313104,2,0,0,512,15,7493876291
8891,37180590,53239512,90420102,3,0,0,12800,12,2005689178
8892,37182450,53402610,90585060,5,0,0,34816,8,4034930599
8893,37182930,65402806,102585736,0,0,1,3584,5,1330716068
8894,37192480,53024954,90217434,9,0,0,10240,19,1146959933
8895,37193180,53361011,90554191,2,0,0,51200,15,8249934351
8896,37193440,65423732,102617172,4,0,1,22016,4,7224707895
8897,37200160,53222461,90422621,5,0,0,8192,8,6458527279
8898,37213890,65403641,102617531,6,0,1,9728,5,9908378205
8899,37217550,53153478,90371028,7,0,0,35328,8,6699175839
8900,37223990,52945151,90169141,2,0,0,16896,15,4246532805
8901,37225620,53061195,90286815,3,0,0,18944,12,4622298904
8902,37228720,53303756,90532476,1,0,0,23552,14,4797122211
8903,37231690,53255541,90487231,3,0,0,1024,12,9523318366
8904,37234730,53684423,90919153,7,0,0,14336,8,4181772757
8905,37236460,65389904,102626364,8,0,1,22528,13,6561661084
8906,37238530,52975761,90214291,2,0,0,16384,15,9775405158
8907,37242749,65387161,102629910,1,0,1,5632,14,7346399110
8908,37242750,53642288,90885038,9,0,0,59392,19,4697427846
8909,37243740,53317381,90561121,7,0,0,2048,8,4265602529
8910,37247720,53679310,90927030,2,0,0,4608,15,2469267083
8911,37248920,53165062,90413982,9,0,0,17920,19,4394684229
8912,37252430,53525651,90778081,3,0,0,512,12,2465879774
8913,37263100,53257713,90520813,1,0,0,14336,14,8835085943
8914,37266850,53026852,90293702,4,0,0,22528,4,342385554
8915,37267190,65364346,102631536,3,0,1,2560,12,1359929119
8916,37275140,53816813,91091953,1,0,0,26112,14,6912933980
8917,37281910,53022796,90304706,0,0,0,1024,5,3600096573
8918,37289350,53142535,90431885,7,0,0,6656,8,4975752350
8919,37296780,53297195,90593975,0,0,0,29184,5,1443414855
8920,37297870,53207759,90505629,5,0,0,36352,8,7730008846
8921,37304340,53779634,91083974,9,0,0,38912,19,9874945809
8922,37309340,65326062,102635402,8,0,1,6144,13,3088387463
8923,37311910,53335293,90647203,0,0,0,34816,5,4611176538
8924,37312380,53549256,90861636,9,0,0,2560,19,7572265123
8925,37312510,53440054,90752564,2,0,0,8192,15,353843794
8926,37315700,53465070,90780770,1,0,0,2048,14,9439764892
8927,37321410,53798692,91120102,6,0,0,27648,5,10567607458
8928,37333980,53406776,90740756,0,0,0,45056,5,6800335907
8929,37338030,65298806,102636836,3,0,1,23040,12,8711699491
8930,37338520,65307455,102645975,6,0,1,17920,5,7223463666
8931,37341111,65314059,102655170,7,0,1,3072,8,5114554894
8932,37352209,65307467,102659676,1,0,1,7168,14,9244225176
8933,37354921,65312788,102667709,7,0,1,3584,8,3746392690
8934,37357040,53148791,90505831,3,0,0,512,12,6552181268
8935,37357240,53237850,90595090,0,0,0,3584,5,2492866578
8936,37360870,53499963,90860833,6,0,0,3072,5,2080077505
8937,37363580,53496294,90859874,0,0,0,21504,5,10570906429
8938,37372821,65299714,102672535,5,0,1,7680,8,4178137316
8939,37377850,53177439,90555289,6,0,0,3072,5,2192882664
8940,37385940,53305898,90691838,4,0,0,9216,4,6942930911
8941,37387530,53208215,90595745,7,0,0,2048,8,7664123190
8942,37391300,53907108,91298408,5,0,0,49664,8,5181219279
8943,37393210,54000694,91393904,6,0,0,1024,5,4216532035
8944,37399410,65274508,102673918,9,0,1,14848,19,4848253885
8945,37400520,53525083,90925603,9,0,0,512,19,2591205026
8946,37404140,53544685,90948825,4,0,0,20992,4,5771159827
8947,37415680,53362222,90777902,3,0,0,12800,12,553230516
8948,37423770,53512940,90936710,9,0,0,27648,19,4568649078
8949,37424560,53469393,90893953,7,0,0,29184,8,4110240540
8950,37425250,53300794,90726044,1,0,0,24576,14,777069746
8951,37429270,53313225,90742495,9,0,0,5632,19,4518476771
8952,37430150,54246168,91676318,7,0,0,15872,8,1428773798
8953,37431400,53845321,91276721,5,0,0,28672,8,295327024
8954,37433900,53416099,90849999,6,0,0,24064,5,4035611352
8955,37434130,65245194,102679324,8,0,1,8192,13,3748742790
8956,37446770,53511572,90958342,1,0,0,6656,14,1017052662
8957,37447390,53478026,90925416,1,0,0,20480,14,7050860174
8958,37460700,53702114,91162814,0,0,0,9216,5,7651961433
8959,37466890,65217619,102684509,0,0,1,16384,5,8768227562
8960,37468950,65217825,102686775,6,0,1,3584,5,2280614254
8961,37476550,65211710,102688260,6,0,1,15360,5,257950296
8962,37477810,53790152,91267962,6,0,0,14848,5,10722814056
8963,37480070,53939394,91419464,4,0,0,14336,4,3735332945
8964,37480630,53351633,90832263,0,0,0,32768,5,1538149372
8965,37482640,54266080,91748720,2,0,0,20480,15,10317745334
8966,37484300,53627355,91111655,0,0,0,61440,5,1633996825
8967,37487770,65215851,102703621,3,0,1,7168,12,314431686
8968,37489980,53842636,91332616,1,0,0,29184,14,7128965676
8969,37491770,54056094,91547864,7,0,0,30208,8,10087939904
8970,37499050,54518477,92017527,7,0,0,43520,8,1855433632
8971,37500571,65203716,102704287,5,0,1,1024,8,9797733865
8972,37501990,65204883,102706873,6,0,1,4096,5,2548996836
8973,37506200,54946387,92452587,4,0,0,3584,4,3917573341
8974,37506690,54604315,92111005,7,0,0,5120,8,3749653724
8975,37509831,65205088,102714919,7,0,1,19968,8,941323265
8976,37513351,65515307,103028658,5,0,1,428544,8,7660873668
8977,37514630,53578282,91092912,3,0,0,3072,12,10490242053
8978,37516451,65518741,103035192,7,0,1,15360,8,7178131955
8979,37517550,53732661,91250211,6,0,0,34304,5,1676493849
8980,37520730,53742631,91263361,2,0,0,43008,15,7040618599
8981,37522440,55044720,92567160,6,0,0,25088,5,251721636
8982,37530880,65504978,103035858,8,0,1,1024,13,8883124612
8983,37531590,53362698,90894288,2,0,0,1024,15,1514549894
8984,37537550,55258115,92795665,5,0,0,74752,8,71330676
8985,37543420,54091635,91635055,6,0,0,16896,5,4837825625
8986,37545680,54040006,91585686,1,0,0,1024,14,3706653805
8987,37552410,53647826,91200236,5,0,0,27136,8,2182300077
8988,37555870,53474128,91029998,6,0,0,24064,5,9050773670
8989,37556920,54164656,91721576,1,0,0,42496,14,10489584733
8990,37559880,53930594,91490474,0,0,0,49664,5,6482124276
8991,37564260,55316646,92880906,0,0,0,7680,5,379670477
8992,37565730,53711950,91277680,5,0,0,3072,8,1426676409
8993,37567270,53756293,91323563,9,0,0,34304,19,2038243998
8994,37570810,53800307,91371117,3,0,0,31744,12,1266341936
8995,37571900,53588083,91159983,2,0,0,20992,15,8909465932
8996,37580820,53925016,91505836,1,0,0,512,14,2801613115
8997,37599710,65469522,103069232,9,0,1,37376,19,8953333833
8998,37599910,53701329,91301239,0,0,0,9216,5,9418024030
8999,37602480,53530220,91132700,3,0,0,37376,12,3199228842
9000,37607270,53540010,91147280,6,0,0,3584,5,10006705724
9001,37609320,53525610,91134930,2,0,0,7168,15,9154041596
9002,37612380,53887477,91499857,7,0,0,30720,8,10094728458
9003,37624490,65457934,103082424,9,0,1,29696,19,6201987898
9004,37626511,65471072,103097583,7,0,1,7168,8,4402364304
9005,37628000,54173593,91801593,1,0,0,65024,14,6509800977
9006,37630660,54445408,92076068,9,0,0,11776,19,3926520838
9007,37631020,54200410,91831430,9,0,0,15360,19,4185972964
9008,37635910,54190771,91826681,4,0,0,40960,4,10288991867
9009,37639710,65479516,103119226,3,0,1,18944,12,9165970654
9010,37650140,53697438,91347578,6,0,0,13312,5,8089803194
9011,37655990,53657067,91313057,7,0,0,15872,8,2229651859
9012,37657450,54281576,91939026,2,0,0,34304,15,8381772165
9013,37659030,53978700,91637730,3,0,0,8704,12,8771526664
9014,37660030,65461142,103121172,3,0,1,3072,12,1172310732
9015,37666120,55623297,93289417,0,0,0,64000,5,465841015
9016,37668470,65454008,103122478,6,0,1,2048,5,1801955988
9017,37673240,54033135,91706375,3,0,0,57856,12,5739096199
9018,37677970,54009447,91687417,6,0,0,36352,5,5097220950
9019,37680910,65443834,103124744,6,0,1,3584,5,8258052975
9020,37684240,53931911,91616151,1,0,0,36352,14,142549685
9021,37687070,53895388,91582458,7,0,0,512,8,10211553120
9022,37689870,54177558,91867428,9,0,0,37376,19,553625206
9023,37698920,54193460,91892380,4,0,0,512,4,1075877730
9024,37702610,53723016,91425626,1,0,0,512,14,4036188008
9025,37705420,54208349,91913769,0,0,0,67072,5,5803354069
9026,37709020,54830866,92539886,6,0,0,43520,5,2578810083
9027,37709340,65420081,103129421,4,0,1,6656,4,3902436314
9028,37712280,65417295,103129575,0,0,1,8704,5,5695720122
9029,37712590,53917294,91629884,3,0,0,36352,12,6597275532
9030,37721650,53920343,91641993,2,0,0,4096,15,7676376307
9031,37723429,65411292,103134721,1,0,1,8192,14,6365662185
9032,37724300,65412367,103136667,9,0,1,3072,19,5288811752
9033,37729220,54084958,91814178,7,0,0,21504,8,1763653817
9034,37735140,54469814,92204954,7,0,0,47104,8,2367186798
9035,37736980,65402273,103139253,3,0,1,4096,12,9401724557
9036,37742260,54367162,92109422,6,0,0,9216,5,10089696276
9037,37744650,53895915,91640565,7,0,0,2560,8,5690698363
9038,37749430,54438474,92187904,1,0,0,50688,14,1128052518
9039,37749679,65397003,103146682,1,0,1,21504,14,9125732865
9040,37751550,54212840,91964390,0,0,0,21504,5,6371349701
9041,37756240,54208672,91964912,1,0,0,1536,14,547080610
9042,37756500,54306729,92063229,0,0,0,20992,5,6225856680
9043,37758200,53950405,91708605,9,0,0,7168,19,3970987321
9044,37762510,54293947,92056457,1,0,0,23040,14,548746530
9045,37762770,54476519,92239289,3,0,0,6144,12,720389919
9046,37764770,53957336,91722106,2,0,0,1536,15,4825422430
9047,37774900,54093689,91868589,5,0,0,3584,8,7646069795
9048,37775450,65381905,103157355,6,0,1,15360,5,9758510927
9049,37775850,53961318,91737168,0,0,0,16896,5,6111123437
9050,37776890,53882467,91659357,4,0,0,5632,4,3307835367
9051,37776930,54204688,91981618,1,0,0,25088,14,65934134
9052,37784020,54347551,92131571,1,0,0,16384,14,8095172916
9053,37788491,65377731,103166222,5,0,1,20992,8,2629246852
9054,37793050,55682018,93475068,6,0,0,11264,5,870796211
9055,37797980,53840709,91638689,1,0,0,3072,14,4389624137
9056,37802510,54034825,91837335,2,0,0,14848,15,5499989571
9057,37809720,54938360,92748080,6,0,0,68096,5,6765064950
9058,37813811,65362409,103176220,7,0,1,25088,8,340391901
9059,37834320,54492634,92326954,5,0,0,17408,8,10571367386
9060,37836270,54403822,92240092,0,0,0,2560,5,6817917348
9061,37838810,54462345,92301155,2,0,0,17408,15,7432837724
9062,37839780,65339026,103178806,8,0,1,4096,13,3857776092
9063,37843210,65338822,103182032,3,0,1,5120,12,8894221550
9064,37843730,54561194,92404924,2,0,0,6656,15,5596063062
9065,37845130,54526483,92371613,4,0,0,512,4,6647878520
9066,37847020,54408314,92255334,3,0,0,28160,12,5182107322
9067,37847260,54390134,92237394,7,0,0,94208,8,1920335091
9068,37863740,65336396,103200136,4,0,1,62976,4,1547094403
9069,37874190,55704730,93578920,5,0,0,51712,8,9000913859
9070,37880800,54570672,92451472,5,0,0,35328,8,9484872441
9071,37882000,54387732,92269732,3,0,0,44032,12,7274252368
9072,37886070,54204113,92090183,5,0,0,1536,8,10654305615
9073,37889120,55028986,92918106,5,0,0,13824,8,2750733768
9074,37890560,54066741,91957301,3,0,0,59904,12,110985713
9075,37893010,65308112,103201122,9,0,1,1536,19,4845524533
9076,37900930,54417086,92318016,3,0,0,44032,12,9387224708
9077,37902490,54708006,92610496,5,0,0,40448,8,2414712253
9078,37904050,53966368,91870418,7,0,0,5632,8,2849329939
9079,37907609,65295459,103203068,1,0,1,3072,14,3562513200
9080,37907680,65304888,103212568,4,0,1,18432,4,4088293216
9081,37914250,54407377,92321627,9,0,0,11776,19,553767110
9082,37919800,54881144,92800944,1,0,0,5632,14,21542890
9083,37926181,65296306,103222487,5,0,1,11264,8,7667077502
9084,37929001,65296392,103225393,5,0,1,4608,8,4000070687
9085,37945740,54171684,92117424,3,0,0,20992,12,8669513318
9086,37947500,55820908,93768408,9,0,0,6656,19,5442850255
9087,37951200,54451650,92402850,5,0,0,13824,8,4533182638
9088,37964760,53993032,91957792,3,0,0,1536,12,10298459534
9089,37966630,54537660,92504290,5,0,0,5632,8,10417809952
9090,37975670,54832005,92807675,4,0,0,22016,4,5343209840
9091,37982760,54457902,92440662,6,0,0,58368,5,4915751692
9092,38006480,65220859,103227339,9,0,1,3072,19,2974023928
9093,38007840,65224645,103232485,9,0,1,8192,19,5479574792
9094,38008450,54182129,92190579,1,0,0,8704,14,10490729723
9095,38008540,54962941,92971481,7,0,0,19456,8,291884012
9096,38009110,65231747,103240857,0,0,1,13312,5,7195294254
9097,38009840,55098370,93108210,4,0,0,20480,4,1958975681
9098,38012250,54005612,92017862,1,0,0,1024,14,8931290262
9099,38021390,54311196,92332586,7,0,0,13824,8,1683835122
9100,38022670,55030121,93052791,6,0,0,12800,5,9327676405
9101,38024211,65225782,103249993,7,0,1,13824,8,4821938515
9102,38026540,54106949,92133489,5,0,0,6144,8,2094476085
9103,38039960,65214590,103254550,3,0,1,2048,12,10082888573
9104,38042700,54213593,92256293,6,0,0,3072,5,3187771036
9105,38048810,54566389,92615199,3,0,0,15360,12,606755178
9106,38059150,65205983,103265133,8,0,1,4608,13,275149459
9107,38063220,65203219,103266439,8,0,1,2048,13,7927087194
9108,38072660,54563800,92636460,7,0,0,27136,8,48242513
9109,38077110,65189483,103266593,8,0,1,8704,13,6374426766
9110,38082510,55227701,93310211,9,0,0,58880,19,870899912
9111,38084920,65188765,103273685,8,0,1,11264,13,8628954833
9112,38091101,65184530,103275631,5,0,1,3072,8,1869314074
9113,38103840,54370070,92473910,8,0,0,3072,13,7976504319
9114,38104730,54493419,92598149,8,0,0,50688,13,7981155715
9115,38106450,65174775,103281225,0,0,1,18432,5,6323445270
9116,38115130,54462513,92577643,7,0,0,34304,8,2655911200
9117,38116350,65181163,103297513,8,0,1,27136,13,9662941735
9118,38119670,65213318,103332988,9,0,1,45568,19,4665052165
9119,38130080,65218696,103348776,3,0,1,10240,12,1177097236
9120,38141220,54325687,92466907,9,0,0,8704,19,2618914434
9121,38142250,54417243,92559493,2,0,0,59392,15,2058738315
9122,38142290,54360261,92502551,8,0,0,40960,13,5341728808
9123,38167300,65183742,103351042,4,0,1,3584,4,10258078659
9124,38172210,54233213,92405423,3,0,0,1536,12,5184010680
9125,38172500,54340083,92512583,4,0,0,23040,4,2985240232
9126,38172790,55694420,93867210,7,0,0,7168,8,4599949787
9127,38181190,54683696,92864886,4,0,0,30720,4,4768547016
9128,38188500,55198710,93387210,6,0,0,80896,5,1597243376
9129,38189660,54728781,92918441,9,0,0,1024,19,2758632466
9130,38190780,65160608,103351388,8,0,1,512,13,4296221310
9131,38197400,65157534,103354934,6,0,1,5632,5,8437713479
9132,38197640,55116251,93313891,7,0,0,5632,8,3318505706
9133,38207310,54591895,92799205,7,0,0,11264,8,7862497832
9134,38207820,54212346,92420166,5,0,0,5120,8,3681018273
9135,38207920,54332613,92540533,7,0,0,2048,8,8349505973
9136,38209840,54553083,92762923,6,0,0,48640,5,1562334901
9137,38214030,54401972,92616002,4,0,0,2560,4,4274414120
9138,38216110,54405219,92621329,4,0,0,17408,4,3131141882
9139,38225610,54478589,92704199,4,0,0,19968,4,1882275918
9140,38242501,65221070,103463571,5,0,1,183296,8,4017501279
9141,38244900,54777473,93022373,9,0,0,12288,19,3904115309
9142,38247230,54401019,92648249,7,0,0,18944,8,2407912278
9143,38255120,55684696,93939816,7,0,0,22528,8,7964270274
9144,38259220,54513577,92772797,3,0,0,27136,12,10733166424
9145,38260661,65321025,103581686,5,0,1,215040,8,5799699961
9146,38290390,65300851,103591241,6,0,1,3072,5,6555588123
9147,38291550,54619876,92911426,8,0,0,18944,13,7035882040
9148,38303110,54461396,92764506,9,0,0,5120,19,2714828722
9149,38304830,65288357,103593187,0,0,1,3072,5,5900787233
9150,38310010,54595621,92905631,1,0,0,18432,14,487364455
9151,38316459,65284976,103601435,1,0,1,7168,14,2443735223
9152,38319190,54506756,92825946,8,0,0,13824,13,1614458310
9153,38322150,54742967,93065117,4,0,0,21504,4,7946746211
9154,38328350,55067018,93395368,8,0,0,20992,13,6024789901
9155,38337830,54924085,93261915,6,0,0,44032,5,9494500529
9156,38338760,54905770,93244530,6,0,0,104448,5,7623677376
9157,38341340,55047609,93388949,3,0,0,5632,12,2110761911
9158,38349739,65256202,103605941,1,0,1,7168,14,1633410480
9159,38355090,54317019,92672109,9,0,0,32256,19,3871289100
9160,38355621,65335732,103691353,5,0,1,151040,8,5798698479
9161,38359980,54346192,92706172,4,0,0,5632,4,4098735129
9162,38367390,54483119,92850509,3,0,0,30208,12,10408923467
9163,38369830,54485561,92855391,9,0,0,12288,19,7437882765
9164,38375450,54873003,93248453,8,0,0,12800,13,10304624210
9165,38379670,55137032,93516702,3,0,0,5632,12,8991434442
9166,38393700,54764171,93157871,9,0,0,42496,19,10107882085
9167,38410270,54605895,93016165,9,0,0,17920,19,6014296355
9168,38416870,55058533,93475403,1,0,0,1024,14,6354330559
9169,38422100,65270559,103692659,4,0,1,2048,4,4842113810
9170,38422549,65276315,103698864,1,0,1,14848,14,1330236840
9171,38429950,55265864,93695814,6,0,0,26624,5,10735162792
9172,38432920,54915715,93348635,4,0,0,26112,4,3836841530
9173,38434260,54761015,93195275,3,0,0,59392,12,1113177601
9174,38438510,54556617,92995127,9,0,0,5632,19,7035796328
9175,38444140,54848108,93292248,3,0,0,9216,12,3113927066
9176,38445010,54824884,93269894,4,0,0,26112,4,6847618677
9177,38459540,65239785,103699325,3,0,1,10240,12,6523749500
9178,38467160,54384464,92851624,9,0,0,3584,19,6331597028
9179,38468220,54937958,93406178,3,0,0,14336,12,6612613472
9180,38470710,65229076,103699786,6,0,1,10240,5,6866052574
9181,38471110,54522278,92993388,1,0,0,43008,14,2110130825
9182,38474400,65233486,103707886,8,0,1,15872,13,9637941992
9183,38475460,54528964,93004424,4,0,0,512,4,140841355
9184,38480490,54732193,93212683,9,0,0,10240,19,3633715763
9185,38482690,65225555,103708245,6,0,1,9728,5,2108935100
9186,38482850,55225091,93707941,1,0,0,23552,14,470919283
9187,38483730,54565138,93048868,7,0,0,11776,8,4388613401
9188,38483741,65341819,103825560,5,0,1,236544,8,4514451095
9189,38485790,55533061,94018851,4,0,0,29696,4,2323830965
9190,38503730,54959230,93462960,9,0,0,16896,19,4581506245
9191,38504529,65323643,103828172,1,0,1,4096,14,6916579638
9192,38510080,54891707,93401787,9,0,0,20992,19,9343169346
9193,38510690,55333914,93844604,3,0,0,61440,12,6632298292
9194,38511850,55051291,93563141,1,0,0,68608,14,2008642135
9195,38514930,54656351,93171281,8,0,0,12800,13,6382593582
9196,38515090,55608710,94123800,1,0,0,34304,14,10523584655
9197,38526790,54646542,93173332,9,0,0,6656,19,10323084685
9198,38528910,54632774,93161684,4,0,0,11264,4,5878066242
9199,38529850,65301894,103831744,3,0,1,5632,12,4264970295
9200,38534320,54589898,93124218,3,0,0,27648,12,2587200982
9201,38540590,54668771,93209361,9,0,0,46080,19,10668504779
9202,38552550,65282760,103835310,0,0,1,3584,5,4150039310
9203,38561720,65283100,103844820,8,0,1,7168,13,2902507097
9204,38562060,55328623,93890683,1,0,0,5120,14,9900795067
9205,38565100,55256035,93821135,9,0,0,100352,19,2239362555
9206,38584920,55823076,94407996,4,0,0,27136,4,8800715700
9207,38587320,65274625,103861945,8,0,1,4608,13,653803016
9208,38614480,54885414,93499894,9,0,0,34304,19,4270528825
9209,38617280,65369308,103986588,3,0,1,229888,12,837809433
9210,38619960,55000664,93620624,3,0,0,11264,12,6255961549
9211,38625510,54391614,93017124,9,0,0,3072,19,2081152268
9212,38637460,54975763,93613223,4,0,0,94208,4,4570832832
9213,38637910,54807517,93445427,7,0,0,16896,8,5016265518
9214,38656700,54655406,93312106,6,0,0,6144,5,8731561341
9215,38662950,55013915,93676865,3,0,0,1024,12,8438821486
9216,38666150,65330843,103996993,0,0,1,14336,5,6761387341
9217,38673470,55180985,93854455,3,0,0,32256,12,8922982996
9218,38673730,55298938,93972668,7,0,0,52224,8,5007603476
9219,38680320,55105140,93785460,9,0,0,7168,19,9506401498
9220,38695550,65303709,103999259,4,0,1,3584,4,178576966
9221,38698380,54778546,93476926,2,0,0,4608,15,1010633605
9222,38700460,55319506,94019966,7,0,0,3584,8,3712973381
9223,38700681,65301484,104002165,7,0,1,4608,8,10313892988
9224,38707399,65296712,104004111,1,0,1,3072,14,1221488675
9225,38714580,54907627,93622207,4,0,0,5120,4,9803092828
9226,38720141,65291556,104011697,7,0,1,10752,8,8041905889
9227,38732640,54425589,93158229,8,0,0,1024,13,2541390517
9228,38744610,54464930,93209540,4,0,0,512,4,5907205381
9229,38760550,65264897,104025447,0,0,1,13312,5,4854035492
9230,38760600,54748989,93509589,6,0,0,31744,5,955667518
9231,38764910,54672598,93437508,6,0,0,59392,5,3276192457
9232,38782770,55173784,93956554,8,0,0,18432,13,3255247244
9233,38788890,65252711,104041601,9,0,1,2560,19,5511632472
9234,38792140,54882013,93674153,7,0,0,12288,8,6399542891
9235,38802841,65265042,104067883,5,0,1,76800,8,8755705397
9236,38804060,54548966,93353026,7,0,0,14336,8,2901228437
9237,38805090,55679340,94484430,3,0,0,39936,12,4946096567
9238,38808360,54641339,93449699,4,0,0,5632,4,1370268398
9239,38814160,65255605,104069765,6,0,1,11776,5,2828200173
9240,38817691,65260254,104077945,7,0,1,22528,8,2964059451
9241,38821830,54965771,93787601,7,0,0,2560,8,3006018904
9242,38828410,65250841,104079251,0,0,1,2048,5,3204559168
9243,38831450,54885117,93716567,1,0,0,9216,14,9862990705
9244,38833060,55294686,94127746,8,0,0,2048,13,9458613584
9245,38838410,65254501,104092911,3,0,1,41472,12,6850522835
9246,38839680,54861062,93700742,9,0,0,15872,19,10089825411
9247,38843180,65251357,104094537,8,0,1,2560,13,8763545301
9248,38844470,55205080,94049550,9,0,0,28672,19,8838379675
9249,38852720,54893211,93745931,0,0,0,14848,5,3943852372
9250,38853620,55977280,94830900,3,0,0,39424,12,4644128182
9251,38853660,65632048,104485708,3,0,1,704000,12,9618310165
9252,38857050,54776628,93633678,7,0,0,9216,8,5083157469
9253,38857350,55236095,94093445,8,0,0,7680,13,1972035191
9254,38868730,54748439,93617169,8,0,0,12288,13,8210506782
9255,38873130,56129838,95002968,2,0,0,32256,15,10357939385
9256,38873990,55357317,94231307,2,0,0,50688,15,7579443576
9257,38877220,54948641,93825861,9,0,0,3072,19,5802226622
9258,38878140,55010580,93888720,9,0,0,1024,19,10477090510
9259,38884870,55370039,94254909,8,0,0,3584,13,7075647679
9260,38886810,54753612,93640422,9,0,0,6144,19,64520924
9261,38888730,54760237,93648967,2,0,0,27136,15,897925379
9262,38891330,55084793,93976123,7,0,0,11264,8,6735979351
9263,38894470,54835538,93730008,1,0,0,6656,14,1921115589
9264,38894790,55281282,94176072,9,0,0,44544,19,4736340641
9265,38897370,54753960,93651330,8,0,0,7680,13,9215312418
9266,38899660,54954974,93854634,5,0,0,512,8,4753664666
9267,38900960,54712442,93613402,3,0,0,512,12,3749114710
9268,38902280,55104045,94006325,7,0,0,14848,8,2213127662
9269,38905149,65592784,104497933,1,0,1,2048,14,7853636499
9270,38915050,54669446,93584496,9,0,0,10240,19,3773051610
9271,38918790,55335004,94253794,7,0,0,73728,8,6375791106
9272,38921400,55361178,94282578,0,0,0,3072,5,6848714814
9273,38922620,65760499,104683119,3,0,1,363520,12,1541700932
9274,38923320,55426553,94349873,0,0,0,40448,5,9685450305
9275,38924110,55159790,94083900,0,0,0,13824,5,8514542034
9276,38928400,55268310,94196710,7,0,0,67584,8,1135277099
9277,38930640,55020275,93950915,2,0,0,36352,15,3038191571
9278,38941120,65742345,104683465,0,0,1,512,5,5650725647
9279,38944190,65742207,104686397,4,0,1,4608,4,619837561
9280,38950400,55408232,94358632,0,0,0,28672,5,5309560665
9281,38950960,56573042,95524002,0,0,0,32768,5,8324210642
9282,38961440,56178967,95140407,0,0,0,39936,5,5951237314
9283,38963811,65911003,104874814,5,0,1,411136,8,834832074
9284,38964351,65913369,104877720,7,0,1,4608,8,10580401565
9285,38967030,65958962,104925992,3,0,1,106496,12,1205750502
9286,38968650,54856252,93824902,6,0,0,12288,5,9918665201
9287,38970500,55337614,94308114,1,0,0,58368,14,5979500209
9288,38972270,54740530,93712800,4,0,0,15872,4,7961512207
9289,38972950,65954988,104927938,0,0,1,3072,5,1736518607
9290,38977470,55744999,94722469,0,0,0,5120,5,9093405396
9291,38978170,56469097,95447267,5,0,0,17920,8,6267527835
9292,38979110,55733127,94712237,5,0,0,38400,8,3643303003
9293,38984710,55803383,94788093,2,0,0,26624,15,9703587542
9294,38987910,55744948,94732858,2,0,0,24064,15,7311290339
9295,38993620,65938824,104932444,4,0,1,7168,4,4158144583
9296,38995540,56446244,95441784,1,0,0,96768,14,9661873753
9297,38995670,65951403,104947073,8,0,1,9216,13,10185470414
9298,38999750,55564741,94564491,7,0,0,22528,8,8090216629
9299,39002610,66013215,105015825,3,0,1,144384,12,5344619829
9300,39005160,55367285,94372445,7,0,0,10752,8,10337294488
9301,39006640,66011288,105017928,4,0,1,10240,4,5960011808
9302,39006960,55358091,94365051,0,0,0,20992,5,6528104620
9303,39010120,56269955,95280075,0,0,0,104448,5,7256868274
9304,39011790,55246730,94258520,6,0,0,11776,5,4339479874
9305,39013660,56693898,95707558,3,0,0,11264,12,6357031622
9306,39017650,55062015,94079665,0,0,0,23552,5,8325374457
9307,39032490,54977290,94009780,9,0,0,11264,19,9605697606
9308,39035750,56266756,95302506,5,0,0,28672,8,8916777849
9309,39038060,54918673,93956733,2,0,0,512,15,326067641
9310,39043100,65975289,105018389,6,0,1,10240,5,2557992544
9311,39044390,55328398,94372788,4,0,0,1024,4,3619333696
9312,39047300,65978546,105025846,6,0,1,6144,5,9671321647
9313,39049530,55675926,94725456,9,0,0,9728,19,4845316575
9314,39049890,55528950,94578840,9,0,0,4096,19,8755898682
9315,39053400,65972600,105026000,8,0,1,8704,13,6894778024
9316,39057320,55498233,94555553,2,0,0,27648,15,7024085861
9317,39063040,55458915,94521955,5,0,0,6144,8,747226803
9318,39065590,54829941,93895531,1,0,0,5120,14,3116703239
9319,39066400,65969227,105035627,9,0,1,17408,19,347069340
9320,39069850,55299296,94369146,2,0,0,13312,15,2920203878
9321,39070950,65965983,105036933,3,0,1,2048,12,1323428345
9322,39072380,55648171,94720551,2,0,0,27136,15,6308589431
9323,39075220,55826870,94902090,1,0,0,32768,14,8445515101
9324,39078390,56561975,95640365,8,0,0,11264,13,4902898107
9325,39080720,56506925,95587645,2,0,0,23040,15,6968091100
9326,39086850,55312733,94399583,9,0,0,20992,19,8266047590
9327,39090120,65950999,105041119,6,0,1,6656,5,5650689357
9328,39092300,56267113,95359413,8,0,0,43008,13,3897176974
9329,39098090,55980391,95078481,5,0,0,12800,8,7246023255
9330,39112501,65929924,105042425,7,0,1,2048,8,5814667845
9331,39113770,55456600,94570370,6,0,0,5120,5,8578145051
9332,39118210,65924561,105042771,8,0,1,512,13,7006364007
9333,39119720,55457849,94577569,6,0,0,23552,5,7432941448
9334,39139640,65907957,105047597,9,0,1,7680,19,3895438266
9335,39139689,65909650,105049339,1,0,1,24576,14,4447913510
9336,39140670,56914052,96054722,7,0,0,30720,8,7949888215
9337,39142610,55675361,94817971,7,0,0,30208,8,4168879969
9338,39148190,55510511,94658701,7,0,0,73216,8,9529993500
9339,39149140,55551374,94700514,8,0,0,116736,13,3397403315
9340,39150500,55629458,94779958,5,0,0,19968,8,2799873522
9341,39155550,55709023,94864573,4,0,0,35840,4,4197150533
9342,39164640,65885045,105049685,2,0,1,512,15,7145021408
9343,39168260,54958839,94127099,7,0,0,10752,8,4912684617
9344,39168650,65884261,105052911,4,0,1,5120,4,9010586680
9345,39168840,55675125,94843965,0,0,0,11264,5,9824769800
9346,39173250,65882332,105055582,6,0,1,11776,5,6559165358
9347,39177290,55950926,95128216,6,0,0,8704,5,4353704423
9348,39190350,55571442,94761792,9,0,0,9216,19,1370397142
9349,39192470,55699613,94892083,5,0,0,31744,8,7347627932
9350,39196250,55655553,94851803,7,0,0,7680,8,5971972924
9351,39201490,55844181,95045671,0,0,0,29184,5,9290103141
9352,39203910,55976282,95180192,0,0,0,28672,5,6784028753
9353,39204790,56934106,96138896,4,0,0,23552,4,299324341
9354,39207190,55820775,95027965,1,0,0,78336,14,6980653973
9355,39209020,56251374,95460394,2,0,0,43008,15,8439280442
9356,39215710,55505176,94720886,4,0,0,1024,4,3535871349
9357,39217070,55321855,94538925,3,0,0,3584,12,3684080804
9358,39219080,55855478,95074558,7,0,0,70656,8,10368332237
9359,39223889,65833959,105057848,1,0,1,3584,14,4702973988
9360,39229880,56439148,95669028,2,0,0,21504,15,5415598233
9361,39230770,57273712,96504482,4,0,0,5120,4,3667973334
9362,39236530,55843165,95079695,4,0,0,3072,4,287223909
9363,39240200,56101071,95341271,3,0,0,3584,12,681863562
9364,39240500,55748999,94989499,1,0,0,6144,14,9973932175
9365,39246370,55910454,95156824,4,0,0,16896,4,56442064
9366,39247630,55129393,94377023,2,0,0,13824,15,677876748
9367,39248460,55999768,95248228,3,0,0,81920,12,1276838195
9368,39252350,57048804,96301154,9,0,0,60928,19,2260532360
9369,39257020,55300584,94557604,0,0,0,6656,5,8833778307
9370,39260130,56569010,95829140,8,0,0,9728,13,1495309016
9371,39260650,55700242,94960892,0,0,0,7680,5,8010715912
9372,39261760,55276050,94537810,2,0,0,24576,15,7400146176
9373,39262250,65801220,105063470,9,0,1,6656,19,6584588212
9374,39263620,55478309,94741929,9,0,0,29696,19,4824408193
9375,39265860,56215218,95481078,2,0,0,55296,15,756213127
9376,39273080,55877722,95150802,6,0,0,7168,5,2350956995
9377,39275600,56361310,95636910,9,0,0,19456,19,1120293258
9378,39285270,56079626,95364896,4,0,0,17920,4,5304474499
9379,39287880,55935365,95223245,9,0,0,14336,19,4174252621
9380,39289130,65774686,105063816,3,0,1,512,12,9530424213
9381,39290360,65774442,105064802,6,0,1,1536,5,7187588522
9382,39291360,65774108,105065468,6,0,1,1024,5,5832534545
9383,39296210,55802318,95098528,0,0,0,3584,5,9100508948
9384,39297130,55476721,94773851,2,0,0,27136,15,7311939911
9385,39297150,55799772,95096922,8,0,0,47104,13,3973586626
9386,39300900,56408093,95708993,2,0,0,4608,15,10326507149
9387,39305960,57285474,96591434,3,0,0,1536,12,4029664720
9388,39306630,56259377,95566007,1,0,0,41984,14,7448063588
9389,39308360,56612363,95920723,2,0,0,18432,15,7758264778
9390,39315340,56345218,95660558,1,0,0,8192,14,3091781712
9391,39323420,56048675,95372095,8,0,0,23552,13,8462416112
9392,39325260,56697820,96023080,6,0,0,8192,5,8359728529
9393,39329760,55963964,95293724,5,0,0,41984,8,1459661009
9394,39342540,55966237,95308777,3,0,0,20480,12,9113666430
9395,39345740,65722775,105068515,3,0,1,14336,12,6902876585
9396,39345750,55419615,94765365,1,0,0,5120,14,1806548259
9397,39349730,56203058,95552788,5,0,0,81920,8,2240993756
9398,39351210,56382017,95733227,3,0,0,10752,12,6671852128
9399,39351360,55929526,95280886,5,0,0,2560,8,1966773446
9400,39359160,65715500,105074660,0,0,1,28160,5,8174683654
9401,39360690,56146567,95507257,9,0,0,38912,19,8401591595
9402,39377320,56303743,95681063,6,0,0,39424,5,10358024672
9403,39390040,56215445,95605485,7,0,0,29184,8,335372609
9404,39391940,56492794,95884734,7,0,0,23552,8,10067021922
9405,39394480,55507789,94902269,6,0,0,512,5,1971709563
9406,39396940,65679000,105075940,0,0,1,14336,5,4103256417
9407,39407780,65672125,105079905,6,0,1,8704,5,7628819244
9408,39417450,56150296,95567746,3,0,0,5632,12,5716065201
9409,39419100,55957885,95376985,8,0,0,10240,13,7993823704
9410,39436029,65650313,105086342,1,0,1,4608,14,6483911099
9411,39437120,56159450,95596570,7,0,0,13824,8,9285081526
9412,39438750,55663389,95102139,2,0,0,11776,15,8532041345
9413,39440220,55899936,95340156,6,0,0,102912,5,5088172011
9414,39447300,55673616,95120916,3,0,0,15360,12,8733189686
9415,39449920,55896366,95346286,1,0,0,16384,14,6095554565
9416,39452920,56205119,95658039,4,0,0,49664,4,7273544434
9417,39457130,56004535,95461665,6,0,0,4096,5,593925320
9418,39458780,56234973,95693753,1,0,0,34304,14,2729981469
9419,39461810,56200643,95662453,4,0,0,6144,4,4233411406
9420,39463160,57174666,96637826,9,0,0,27136,19,6410632843
9421,39464570,56116032,95580602,7,0,0,33792,8,2187157854
9422,39464840,55715999,95180839,9,0,0,2048,19,1824307706
9423,39464880,56568959,96033839,6,0,0,23040,5,4925363573
9424,39467300,56215978,95683278,9,0,0,7168,19,3400378029
9425,39473500,56051149,95524649,9,0,0,2048,19,880484616
9426,39473730,56302689,95776419,2,0,0,2560,15,1669320836
9427,39478680,55618733,95097413,9,0,0,1536,19,1226936356
9428,39492230,55919036,95411266,4,0,0,11776,4,3873457893
9429,39498250,55965934,95464184,1,0,0,8192,14,440589817
9430,39499900,56142984,95642884,7,0,0,8192,8,8708756653
9431,39508820,56203472,95712292,2,0,0,10752,15,3195884789
9432,39512150,56118809,95630959,8,0,0,18432,13,8110178378
9433,39514240,55859594,95373834,2,0,0,5632,15,8401956451
9434,39518230,65594113,105112343,9,0,1,14336,19,9408229675
9435,39518550,65599923,105118473,2,0,1,20480,15,3567863688
9436,39524320,56301833,95826153,3,0,0,53760,12,8279888917
9437,39526770,56634244,96161014,2,0,0,66560,15,6893163636
9438,39527970,56648511,96176481,4,0,0,50688,4,10321657867
9439,39531030,56361442,95892472,9,0,0,2560,19,6065171698
9440,39535980,56202418,95738398,6,0,0,16896,5,3647262250
9441,39538940,65582439,105121379,3,0,1,4608,12,1444593768
9442,39539900,65583308,105123208,4,0,1,1024,4,2144368244
9443,39544130,65582304,105126434,3,0,1,5120,12,7477091902
9444,39544990,57567394,97112384,2,0,0,41472,15,9872156601
9445,39552550,57220198,96772748,9,0,0,65536,19,5881481643
9446,39562019,65569600,105131619,1,0,1,16384,14,10096593937
9447,39574660,56776772,96351432,4,0,0,19968,4,3328706644
9448,39576520,65559911,105136431,3,0,1,3072,12,6264200140
9449,39578740,65558677,105137417,2,0,1,1536,15,5855892523
9450,39584310,56459841,96044151,1,0,0,16384,14,7569510867
9451,39587600,56336734,95924334,0,0,0,11776,5,9693252658
9452,39590590,56113505,95704095,7,0,0,33792,8,1501487739
9453,39593010,56246293,95839303,7,0,0,33280,8,98643726
9454,39593080,56032240,95625320,1,0,0,65024,14,9554389725
9455,39597830,56747495,96345325,2,0,0,144896,15,2543978943
9456,39602730,65535353,105138083,8,0,1,1024,13,6896159302
9457,39609540,57325199,96934739,6,0,0,13312,5,7513491133
9458,39613650,65525611,105139261,0,0,1,13824,5,9545014172
9459,39617920,56112008,95729928,1,0,0,15872,14,8735267600
9460,39621710,65535050,105156760,0,0,1,3072,5,7974380671
9461,39622620,56761843,96384463,4,0,0,19456,4,10149912131
9462,39623490,56312482,95935972,4,0,0,9216,4,760472810
9463,39631840,56295924,95927764,8,0,0,5120,13,8200392850
9464,39641510,56969322,96610832,4,0,0,33280,4,2817289790
9465,39641530,56236005,95877535,4,0,0,29184,4,1944668325
9466,39647380,55847998,95495378,8,0,0,6144,13,1170340493
9467,39652120,56579469,96231589,1,0,0,38912,14,3627309357
9468,39656050,57324796,96980846,4,0,0,4096,4,502386653
9469,39660220,56106270,95766490,6,0,0,3584,5,1594301163
9470,39660570,65496536,105157106,6,0,1,512,5,5528480476
9471,39662050,57655751,97317801,8,0,0,2048,13,6669298394
9472,39665320,56419588,96084908,9,0,0,7680,19,2827112404
9473,39674100,56177173,95851273,4,0,0,7680,4,5694483532
9474,39677530,65479832,105157362,3,0,1,9216,12,10589752080
9475,39686810,57046031,96732841,2,0,0,32768,15,9326172011
9476,39688290,56555871,96244161,4,0,0,23552,4,8543519426
9477,39704570,56960873,96665443,0,0,0,79872,5,7903598102
9478,39712910,56665602,96378512,9,0,0,52736,19,5464024561
9479,39718040,57095346,96813386,6,0,0,7168,5,2591949943
9480,39718430,56465183,96183613,0,0,0,14848,5,2111398573
9481,39729520,65434910,105164430,3,0,1,8192,12,8323451780
9482,39729920,56661750,96391670,4,0,0,23552,4,2394599019
9483,39731740,56257023,95988763,9,0,0,4096,19,1518369349
9484,39732170,65432606,105164776,9,0,1,512,19,4238699056
9485,39737600,56494948,96232548,2,0,0,3072,15,416922944
9486,39740050,57588598,97328648,3,0,0,15360,12,4820908402
9487,39740590,57649468,97390058,8,0,0,35840,13,6267418232
9488,39751730,57215033,96966763,2,0,0,39936,15,3823588417
9489,39758240,65407842,105166082,8,0,1,2048,13,10349664728
9490,39759510,57481148,97240658,8,0,0,60416,13,10051298348
9491,39760070,56714813,96474883,7,0,0,2048,8,160294999
9492,39761511,65410780,105172291,7,0,1,37376,8,10670073449
9493,39764580,56238739,96003319,1,0,0,11264,14,9806288806
9494,39783450,56303509,96086959,3,0,0,6656,12,2021532115
9495,39783490,56996301,96779791,4,0,0,23040,4,7376394357
9496,39790670,56780806,96571476,3,0,0,9216,12,3446299282
9497,39791070,56606886,96397956,2,0,0,14848,15,7667201779
9498,39791320,56777325,96568645,1,0,0,41472,14,10664213822
9499,39797610,57618533,97416143,1,0,0,3584,14,5886715244
9500,39802240,56632949,96435189,3,0,0,7168,12,4592155547
9501,39810170,65365667,105175837,8,0,1,5632,13,3700692269
9502,39811530,56227606,96039136,9,0,0,16896,19,6853289230
9503,39814060,56054537,95868597,6,0,0,31744,5,4064171123
9504,39816740,56892485,96709225,8,0,0,40960,13,8604297496
9505,39819260,65357141,105176401,0,0,1,10752,5,7113875938
9506,39819770,65357092,105176862,2,0,1,10240,15,9534316513
9507,39821220,57731516,97552736,8,0,0,62976,13,2618116162
9508,39821330,57683262,97504592,8,0,0,17408,13,2465182891
9509,39826760,65381248,105208008,4,0,1,8192,4,1470000221
9510,39827030,57024131,96851161,7,0,0,14848,8,5570065818
9511,39829470,56269732,96099202,0,0,0,11264,5,3385405212
9512,39831330,57089167,96920497,1,0,0,107008,14,8375319908
9513,39837450,56566454,96403904,3,0,0,18944,12,7997839027
9514,39839770,65369314,105209084,8,0,1,13312,13,2478948386
9515,39843960,56256574,96100534,8,0,0,512,13,8151521338
9516,39858520,56202423,96060943,7,0,0,1536,8,5400190647
9517,39860810,56196119,96056929,1,0,0,7168,14,8689972244
9518,39866960,56723983,96590943,8,0,0,52736,13,8835196530
9519,39870480,56366303,96236783,9,0,0,13824,19,10514642377
9520,39872490,56377778,96250268,9,0,0,19968,19,7544208133
9521,39881290,65340699,105221989,8,0,1,1536,13,4587912287
9522,39888060,65335875,105223935,4,0,1,3072,4,5558079202
9523,39889880,56780133,96670013,2,0,0,1536,15,6335151950
9524,39892800,56889845,96782645,1,0,0,1536,14,2204555942
9525,39893180,65335607,105228787,3,0,1,7680,12,3394271037
9526,39893770,65336400,105230170,6,0,1,14848,5,8012850903
9527,39895170,65360611,105255781,6,0,1,1536,5,1259300388
9528,39896950,56703719,96600669,6,0,0,30208,5,7811036006
9529,39898630,57702124,97600754,1,0,0,44544,14,4697164157
9530,39908000,56623277,96531277,6,0,0,65024,5,8814935742
9531,39918549,65338717,105257266,1,0,1,15360,14,7748673823
9532,39918780,65345995,105264775,0,0,1,11264,5,232896552
9533,39928839,65339482,105268321,1,0,1,5632,14,9722088475
9534,39930970,56260699,96191669,7,0,0,512,8,8551302244
9535,39932150,56783962,96716112,9,0,0,22528,19,9037627038
9536,39933410,56286300,96219710,3,0,0,86016,12,5297535957
9537,39933780,57757156,97690936,7,0,0,33792,8,2495554664
9538,39938820,65336141,105274961,9,0,1,4608,19,7246706474
9539,39941110,56480710,96421820,7,0,0,7168,8,8338415808
9540,39942770,65337337,105280107,8,0,1,8192,13,6734306528
9541,39948870,56413551,96362421,3,0,0,35840,12,7210808230
9542,39961350,57062126,97023476,1,0,0,4096,14,10134354522
9543,39961570,56897258,96858828,8,0,0,25088,13,6206017952
9544,39961970,65321043,105283013,8,0,1,4608,13,9920028665
9545,39963440,57101095,97064535,1,0,0,54272,14,10103284562
9546,39964340,56717910,96682250,2,0,0,15360,15,7422502951
9547,39964500,56923112,96887612,2,0,0,11776,15,8657678779
9548,39966061,65320178,105286239,7,0,1,5120,8,9250845843
9549,39982260,56900558,96882818,9,0,0,13312,19,5099374146
9550,39983370,56700665,96684035,1,0,0,512,14,5681212370
9551,39986340,56250622,96236962,6,0,0,512,5,5930090501
9552,39991701,65296164,105287865,7,0,1,2560,8,8928493872
9553,39992760,56400649,96393409,9,0,0,5632,19,9542669098
9554,39995940,56824652,96820592,1,0,0,16896,14,1822004530
9555,39999830,65289341,105289171,6,0,1,2048,5,8311174702
9556,40005760,56481313,96487073,8,0,0,2048,13,10549714465
9557,40008240,65283517,105291757,9,0,1,4096,19,3448128052
9558,40015080,56603918,96618998,7,0,0,9216,8,5608879820
9559,40015450,57202794,97218244,0,0,0,17920,5,4524317868
9560,40021530,57109460,97130990,6,0,0,28160,5,1361664312
9561,40022840,56551935,96574775,7,0,0,10752,8,6004761842
9562,40024610,56821981,96846591,0,0,0,63488,5,1223507482
9563,40028940,56640582,96669522,2,0,0,13312,15,124199841
9564,40031060,57625188,97656248,1,0,0,13824,14,5824117191
9565,40031080,56936642,96967722,9,0,0,3072,19,8196764291
9566,40033830,56378368,96412198,8,0,0,5632,13,9635881494
9567,40034020,57156041,97190061,0,0,0,21504,5,6908242079
9568,40034150,57264738,97298888,2,0,0,23552,15,9330822487
9569,40034710,57330144,97364854,3,0,0,27136,12,7612259506
9570,40044071,65249312,105293383,7,0,1,2560,8,5603494194
9571,40046070,57722657,97768727,3,0,0,29696,12,7113724511
9572,40054560,57314217,97368777,1,0,0,12800,14,9509234362
9573,40055400,56664947,96720347,2,0,0,13824,15,9967573990
9574,40057650,56626206,96683856,3,0,0,5120,12,10087773548
9575,40058260,57397176,97455436,3,0,0,10752,12,3292857238
9576,40063510,57006196,97069706,8,0,0,16896,13,10499617649
9577,40065120,65253896,105319016,9,0,1,28160,19,9498121526
9578,40070910,57504180,97575090,6,0,0,56832,5,5365152656
9579,40077640,57664317,97741957,3,0,0,50176,12,3918845813
9580,40080841,65251081,105331922,7,0,1,30208,8,9084354298
9581,40081900,57803042,97884942,3,0,0,30720,12,4157018443
9582,40099870,56711309,96811179,0,0,0,17920,5,199960150
9583,40114170,56629739,96743909,9,0,0,5120,19,8161260
9584,40115300,56562224,96677524,3,0,0,24576,12,8307869896
9585,40116320,65238190,105354510,8,0,1,30208,13,6655907526
9586,40116370,57377098,97493468,0,0,0,34816,5,5085526823
9587,40121440,65238216,105359656,9,0,1,8192,19,7819431641
9588,40132020,65227982,105360002,3,0,1,512,12,9396598569
9589,40132520,57724269,97856789,9,0,0,1536,19,2866780072
9590,40132930,57271636,97404566,7,0,0,16384,8,3696435816
9591,40144300,56637854,96782154,1,0,0,7680,14,3505237438
9592,40147460,57434049,97581509,3,0,0,20992,12,7607216192
9593,40149300,65212648,105361948,4,0,1,3072,4,5343300277
9594,40150430,56655243,96805673,1,0,0,36864,14,7361404428
9595,40152620,56463547,96616167,0,0,0,17408,5,1908463628
9596,40156639,65209495,105366134,1,0,1,6656,14,5691753793
9597,40165690,65202096,105367786,4,0,1,12800,4,355220298
9598,40172590,56781982,96954572,2,0,0,9728,15,8120042699
9599,40179870,65194381,105374251,4,0,1,30720,4,2082514008
9600,40187600,58096045,98283645,1,0,0,22528,14,7559443861
9601,40188010,57646660,97834670,3,0,0,58880,12,6095211143
9602,40190130,56740530,96930660,3,0,0,33280,12,8876308589
9603,40213000,56761258,96974258,3,0,0,8704,12,6022583865
9604,40213710,65175921,105389631,2,0,1,7168,15,1086402860
9605,40215700,57720635,97936335,1,0,0,4096,14,3166731379
9606,40217680,65172873,105390553,8,0,1,20480,13,9195803019
9607,40223461,65191455,105414916,7,0,1,4096,8,455973857
9608,40233580,56712726,96946306,9,0,0,37888,19,9862013955
9609,40237610,57749157,97986767,2,0,0,33792,15,6853217678
9610,40251390,57802794,98054184,8,0,0,3072,13,3617718363
9611,40256040,56615930,96871970,9,0,0,13824,19,4826387439
9612,40260410,56689663,96950073,7,0,0,12288,8,6392036870
9613,40266880,56722918,96989798,3,0,0,13312,12,2483539369
9614,40269370,57529537,97798907,0,0,0,12800,5,4605593429
9615,40269690,56897070,97166760,8,0,0,23552,13,1216648951
9616,40274471,65140791,105415262,7,0,1,512,8,3589087513
9617,40278430,57596010,97874440,8,0,0,57856,13,2859305762
9618,40280540,58154766,98435306,1,0,0,40448,14,267275865
9619,40289220,58304263,98593483,9,0,0,40448,19,1599704922
9620,40290520,57733452,98023972,3,0,0,43008,12,1004667248
9621,40294850,56906950,97201800,7,0,0,27648,8,1598426890
9622,40295220,56704920,97000140,6,0,0,3072,5,2369507761
9623,40297750,56843114,97140864,8,0,0,1024,13,6253538609
9624,40299520,57661555,97961075,6,0,0,37888,5,55027137
9625,40310110,56764981,97075091,0,0,0,15360,5,10209335555
9626,40311540,56687641,96999181,2,0,0,30720,15,2827619592
9627,40314280,57574897,97889177,8,0,0,13824,13,1198671762
9628,40316920,56692805,97009725,1,0,0,10752,14,4304330374
9629,40326850,57308206,97635056,6,0,0,23552,5,9193100855
9630,40339190,57595874,97935064,1,0,0,34304,14,9571231204
9631,40355720,56857041,97212761,7,0,0,17408,8,3963262223
9632,40359070,58185075,98544145,2,0,0,106496,15,1050196196
9633,40361150,58100043,98461193,1,0,0,48640,14,6480081340
9634,40368170,57419352,97787522,6,0,0,19456,5,2015704869
9635,40369550,56770979,97140529,3,0,0,31232,12,6889770958
9636,40371500,57965582,98337082,0,0,0,6144,5,5862959995
9637,40373190,57254598,97627788,8,0,0,73216,13,3334259058
9638,40374211,65044917,105419128,7,0,1,6144,8,2068458625
9639,40384730,58539068,98923798,7,0,0,154624,8,5178015042
9640,40394960,57020068,97415028,3,0,0,19456,12,5048700913
9641,40395410,57569026,97964436,0,0,0,10752,5,5955460527
9642,40400290,58326468,98726758,2,0,0,44544,15,792013590
9643,40405280,58231055,98636335,8,0,0,39936,13,674660653
9644,40414270,57550376,97964646,7,0,0,512,8,8082074203
9645,40421640,58024702,98446342,7,0,0,11264,8,283700158
9646,40422610,58342614,98765224,9,0,0,18432,19,10341196859
9647,40423050,57244928,97667978,2,0,0,10240,15,5520646458
9648,40424450,65000618,105425068,6,0,1,12800,5,10162577114
9649,40427700,58248816,98676516,7,0,0,4096,8,3841397955
9650,40430710,56916599,97347309,0,0,0,3072,5,9291508721
9651,40439550,58160709,98600259,2,0,0,9728,15,6807521695
9652,40446130,57280516,97726646,3,0,0,41472,12,2510756151
9653,40453620,58589721,99043341,6,0,0,53760,5,8454381418
9654,40455490,65009141,105464631,8,0,1,32256,13,3977079585
9655,40458601,65007336,105465937,7,0,1,2048,8,4094656876
9656,40472860,56898488,97371348,0,0,0,7168,5,2700640529
9657,40481760,64984843,105466603,4,0,1,1024,4,7516547964
9658,40481780,56923277,97405057,2,0,0,1536,15,1493087868
9659,40483641,64986188,105469829,7,0,1,5120,8,4966099427
9660,40493340,64977462,105470802,6,0,1,12800,5,10131816092
9661,40495140,64997324,105492464,4,0,1,512,4,7834167211
9662,40501390,58257246,98758636,3,0,0,22016,12,1342323060
9663,40511350,57094107,97605457,8,0,0,15360,13,7092605443
9664,40519450,57254003,97773453,8,0,0,15360,13,4475138463
9665,40521230,57667229,98188459,3,0,0,512,12,8497601976
9666,40523490,57575299,98098789,0,0,0,2048,5,4123143254
9667,40528120,64967890,105496010,6,0,1,5632,5,9774219880
9668,40545470,57229098,97774568,7,0,0,3584,8,3638571360
9669,40546690,64953814,105500504,2,0,1,20480,15,4938203125
9670,40549150,64955964,105505114,9,0,1,5120,19,6630987882
9671,40571860,56985891,97557751,9,0,0,16384,19,6983578542
9672,40581840,64923838,105505678,4,0,1,10752,4,8295271908
9673,40584940,64934162,105519102,4,0,1,8192,4,1809930286
9674,40591780,56847644,97439424,2,0,0,5632,15,1158602022
9675,40596840,56921289,97518129,6,0,0,11264,5,9155872900
9676,40597240,64944992,105542232,8,0,1,37888,13,10469530619
9677,40604220,64938678,105542898,4,0,1,1024,4,1975860270
9678,40608270,56822880,97431150,6,0,0,512,5,4628997110
9679,40617510,57331998,97949508,2,0,0,33792,15,4209374488
9680,40618620,57279894,97898514,0,0,0,9728,5,7858522993
9681,40619080,57220293,97839373,3,0,0,15360,12,9786797864
9682,40623000,57383446,98006446,8,0,0,64512,13,4175790685
9683,40623370,57183204,97806574,0,0,0,25088,5,8380635369
9684,40629260,58547678,99176938,0,0,0,19968,5,8714610526
9685,40638860,58180243,98819103,8,0,0,19968,13,4322622609
9686,40646660,58196357,98843017,0,0,0,33280,5,6333508666
9687,40674020,56974751,97648771,2,0,0,2560,15,10080964133
9688,40682070,57476258,98158328,2,0,0,51200,15,6192137707
9689,40686960,57236949,97923909,7,0,0,7680,8,8744574093
9690,40687750,58308344,98996094,8,0,0,1536,13,7552908403
9691,40693210,56954582,97647792,6,0,0,5120,5,1268042993
9692,40693910,57316927,98010837,3,0,0,14336,12,2663613736
9693,40694120,64856985,105551105,0,0,1,5632,5,8843717780
9694,40697010,64854761,105551771,2,0,1,11264,15,6696762468
9695,40700750,58101957,98802707,6,0,0,38912,5,5723840968
9696,40701320,58231393,98932713,6,0,0,29184,5,3534624918
9697,40707360,57392232,98099592,6,0,0,2560,5,7048272907
9698,40710020,57045011,97755031,2,0,0,7680,15,9102797829
9699,40718720,58413824,99132544,3,0,0,92160,12,6552979538
9700,40721210,57376932,98098142,0,0,0,31232,5,4334816025
9701,40723380,57699579,98422959,7,0,0,18944,8,4733676436
9702,40738810,64842138,105580948,4,0,1,2560,4,10041523066
9703,40745880,57362635,98108515,0,0,0,29184,5,10269843775
9704,40747290,57219267,97966557,7,0,0,6144,8,5734263567
9705,40753650,57448550,98202200,8,0,0,38912,13,6429254646
9706,40756930,57656519,98413449,9,0,0,13312,19,4691724215
9707,40771380,57072228,97843608,3,0,0,13824,12,1242111980
9708,40775720,57141875,97917595,9,0,0,4608,19,9403638794
9709,40777820,57784646,98562466,4,0,0,17408,4,9099628463
9710,40782460,64802354,105584814,9,0,1,6144,19,3623843209
9711,40788880,64798840,105587720,4,0,1,4608,4,2104105697
9712,40800900,57138289,97939189,4,0,0,9216,4,4047976678
9713,40800970,58457136,99258106,9,0,0,34304,19,6631396459
9714,40805910,64785676,105591586,3,0,1,6144,12,3919965959
9715,40818200,57084323,97902523,0,0,0,512,5,5767227650
9716,40820090,57532544,98352634,3,0,0,39936,12,10441749277
9717,40835110,57947801,98782911,6,0,0,32256,5,7565065375
9718,40840340,58116553,98956893,3,0,0,47616,12,8411043397
9719,40864140,57351212,98215352,9,0,0,27136,19,2878848764
9720,40866310,58558367,99424677,8,0,0,37376,13,390208867
9721,40878410,64718426,105596836,8,0,1,9216,13,10504039207
9722,40901330,57402344,98303674,8,0,0,12288,13,804466116
9723,40904601,64693221,105597822,7,0,1,1536,8,9484147251
9724,40915120,64684648,105599768,0,0,1,3072,5,8951278397
9725,40915221,64688093,105603314,7,0,1,5632,8,4506189884
9726,40917430,57263254,98180684,0,0,0,4096,5,2504079912
9727,40926840,57261440,98188280,9,0,0,18432,19,7235202866
9728,40927540,57181512,98109052,6,0,0,1536,5,2053442357
9729,40930930,57102170,98033100,9,0,0,8192,19,1832352243
9730,40933860,57724407,98658267,3,0,0,2560,12,5140991379
9731,40950360,57521932,98472292,9,0,0,36352,19,8229589491
9732,40953980,64668076,105622056,0,0,1,46080,5,2103438833
9733,40954720,57593660,98548380,0,0,0,13824,5,10489020259
9734,40960340,57711159,98671499,0,0,0,5632,5,9528713934
9735,40961510,57373677,98335187,3,0,0,71680,12,9296570405
9736,40962930,57523992,98486922,8,0,0,19456,13,1709294599
9737,40979501,64645820,105625321,7,0,1,14336,8,4825448437
9738,40980020,64645647,105625667,0,0,1,512,5,2244773689
9739,40980760,58512281,99493041,9,0,0,41984,19,319751015
9740,40985060,64642873,105627933,9,0,1,3584,19,6715880127
9741,40994411,64651764,105646175,7,0,1,9728,8,3133156369
9742,40997880,64649601,105647481,9,0,1,2048,19,10715917025
9743,40998740,58461917,99460657,6,0,0,34816,5,10078633640
9744,41007580,58551443,99559023,3,0,0,35328,12,7742261386
9745,41014050,57428798,98442848,6,0,0,24576,5,7285620517
9746,41018450,58582765,99601215,9,0,0,40960,19,3191051364
9747,41023480,57584281,98607761,3,0,0,2560,12,9396446677
9748,41028360,64619467,105647827,6,0,1,512,5,4561063048
9749,41036270,64634578,105670848,8,0,1,24064,13,472257813
9750,41037390,57632370,98669760,0,0,0,23552,5,10676099378
9751,41039460,57956143,98995603,0,0,0,1024,5,5965123983
9752,41048260,57356719,98404979,6,0,0,10752,5,5017910947
9753,41048530,57353150,98401680,8,0,0,28160,13,4541585398
9754,41050550,57506589,98557139,0,0,0,28672,5,9430599832
9755,41051080,57262244,98313324,8,0,0,24576,13,9541968995
9756,41056970,64615056,105672026,3,0,1,13824,12,6911754265
9757,41057770,64619576,105677346,9,0,1,1024,19,6000243674
9758,41059540,57688961,98748501,0,0,0,10240,5,3905061749
9759,41059990,64640245,105700235,8,0,1,25088,13,9455058901
9760,41061110,57578992,98640102,8,0,0,12288,13,4243362371
9761,41068190,57272191,98340381,8,0,0,10752,13,4173730798
9762,41069320,57921401,98990721,0,0,0,92160,5,1572239487
9763,41077930,64625211,105703141,3,0,1,4608,12,1167555378
9764,41082230,58655048,99737278,0,0,0,16384,5,7095288423
9765,41084580,57150707,98235287,6,0,0,3072,5,1844155660
9766,41091740,58456488,99548228,3,0,0,29696,12,8432783684
9767,41100030,57309340,98409370,9,0,0,14336,19,9543112169
9768,41123210,57352291,98475501,0,0,0,9728,5,10521402536
9769,41124050,57886036,99010086,0,0,0,16384,5,9769833771
9770,41131450,58520898,99652348,4,0,0,9728,4,10668417713
9771,41136530,57157359,98293889,9,0,0,8192,19,9995363559
9772,41137120,58331672,99468792,8,0,0,26624,13,4711039383
9773,41138290,57571859,98710149,8,0,0,16384,13,10285175948
9774,41144170,58865947,100010117,4,0,0,43008,4,3287436812
9775,41150350,57640478,98790828,7,0,0,15360,8,6921017401
9776,41152590,57501942,98654532,4,0,0,18944,4,9851421462
9777,41156170,57575759,98731929,3,0,0,16896,12,8833638861
9778,41175790,57657064,98832854,4,0,0,45056,4,10417490207
9779,41203350,64511082,105714432,6,0,1,28160,5,2774168844
9780,41203620,64514358,105717978,6,0,1,5632,5,7694983950
9781,41205260,57799749,99005009,4,0,0,29184,4,5001691144
9782,41215050,57465857,98680907,0,0,0,14336,5,3114985865
9783,41243520,58533957,99777477,6,0,0,1536,5,7201663582
9784,41253970,64489230,105743200,0,0,1,7680,5,5556793985
9785,41257460,57347915,98605375,4,0,0,3072,4,3299379940
9786,41259510,58799038,100058548,8,0,0,6656,13,9753574776
9787,41267190,57295923,98563113,9,0,0,2048,19,7195586838
9788,41267470,57667941,98935411,4,0,0,4608,4,5441974847
9789,41269640,57804849,99074489,4,0,0,1536,4,6284448813
9790,41285540,64459926,105745466,4,0,1,3584,4,3081852864
9791,41290470,64455764,105746234,4,0,1,11776,4,9676203931
9792,41291270,64459790,105751060,0,0,1,7680,5,4761731521
9793,41308990,64458244,105767234,4,0,1,2048,4,2681214258
9794,41316680,58598887,99915567,6,0,0,60416,5,10518888534
9795,41328050,57538059,98866109,6,0,0,15360,5,464704516
9796,41329270,64446499,105775769,8,0,1,1536,13,3031710659
9797,41332450,57825412,99157862,0,0,0,44544,5,2715207552
9798,41336100,57525306,98861406,8,0,0,37888,13,2740437719
9799,41342880,58713571,100056451,9,0,0,98816,19,5367211312
9800,41351690,64424745,105776435,4,0,1,1024,4,6629281274
9801,41354060,57518936,98872996,9,0,0,22528,19,1045527039
9802,41366820,58492903,99859723,4,0,0,42496,4,8332683677
9803,41378400,64401901,105780301,4,0,1,6144,4,6906666705
9804,41387150,58044570,99431720,9,0,0,23040,19,2433883010
9805,41390100,64410529,105800629,9,0,1,40960,19,657457424
9806,41390160,64412415,105802575,8,0,1,3072,13,950109110
9807,41391570,57961011,99352581,4,0,0,25088,4,1661995665
9808,41400980,64412939,105813919,6,0,1,13824,5,4209235888
9809,41402100,64415685,105817785,9,0,1,6144,19,1501280979
9810,41403680,57333784,98737464,6,0,0,1536,5,2151632938
9811,41410170,64412441,105822611,9,0,1,7680,19,4436360317
9812,41411240,57522744,98933984,4,0,0,4096,4,6815852536
9813,41411330,64416453,105827783,6,0,1,8192,5,564069880
9814,41416070,57728197,99144267,4,0,0,38400,4,6896551806
9815,41424430,58820866,100245296,8,0,0,40448,13,9235597607
9816,41441590,57498498,98940088,8,0,0,2048,13,3314508303
9817,41444680,57840569,99285249,3,0,0,10752,12,9450123052
9818,41448620,64379522,105828142,3,0,1,9728,12,6848754486
9819,41465070,57699593,99164663,4,0,0,512,4,4743442242
9820,41468930,64360838,105829768,9,0,1,2560,19,10657222480
9821,41488230,58011261,99499491,9,0,0,19968,19,7585621392
9822,41490970,57557567,99048537,8,0,0,5632,13,7751580679
9823,41494890,57669578,99164468,6,0,0,21504,5,9785086045
9824,41515040,57691465,99206505,6,0,0,2560,5,2886910394
9825,41518420,64312654,105831074,3,0,1,2048,12,6132898993
9826,41523740,58546049,100069789,4,0,0,20480,4,400550719
9827,41526410,57468858,98995268,9,0,0,14848,19,7824270308
9828,41529960,58365216,99895176,4,0,0,1536,4,9885818274
9829,41535950,57559008,99094958,8,0,0,15872,13,7481396542
9830,41548500,58682554,100231054,6,0,0,58368,5,8616730513
9831,41556080,64279500,105835580,9,0,1,7168,19,7835971453
9832,41578690,57495308,99073998,4,0,0,27136,4,5215727138
9833,41581800,64256686,105838486,9,0,1,4608,19,5609120403
9834,41595830,58465392,100061222,9,0,0,3584,19,5404049315
9835,41606120,64233992,105840112,6,0,1,2560,5,5181442039
9836,41616040,58967675,100583715,3,0,0,49152,12,1062480208
9837,41621830,64218628,105840458,4,0,1,512,4,4203692450
9838,41624720,57855506,99480226,3,0,0,26624,12,240419523
9839,41626990,57651926,99278916,9,0,0,6144,19,165067997
9840,41629280,64211524,105840804,8,0,1,512,13,8662071566
9841,41630090,64211380,105841470,3,0,1,1024,12,3333740484
9842,41634780,58067208,99701988,4,0,0,16384,4,2806292360
9843,41636310,58013028,99649338,4,0,0,117760,4,8394163151
9844,41639300,58488647,100127947,3,0,0,33792,12,5716122987
9845,41640790,58054262,99695052,4,0,0,40448,4,5115274131
9846,41641660,64200156,105841816,6,0,1,512,5,2709509005
9847,41646130,59086743,100732873,4,0,0,13312,4,8016600495
9848,41650980,64196123,105847103,3,0,1,16896,12,7798260732
9849,41662090,64189353,105851443,9,0,1,15360,19,1362058511
9850,41679960,58303568,99983528,4,0,0,73216,4,2760431441
9851,41684950,59215221,100900171,9,0,0,11776,19,4395922327
9852,41695120,64160509,105855629,9,0,1,6656,19,7291170964
9853,41706710,58379551,100086261,3,0,0,3584,12,82360997
9854,41720890,57661666,99382556,4,0,0,23040,4,7600094207
9855,41726770,58468270,100195040,9,0,0,68608,19,3625590698
9856,41730010,64130471,105860481,9,0,1,7680,19,10155638770
9857,41741010,57705865,99446875,6,0,0,49664,5,9302920705
9858,41754890,59295273,101050163,8,0,0,36352,13,5034354618
9859,41758230,57713861,99472091,8,0,0,10752,13,3377662498
9860,41763030,58154767,99917797,7,0,0,7168,8,4597898141
9861,41771960,58549784,100321744,6,0,0,51200,5,9212307247
9862,41789260,57704124,99493384,3,0,0,1024,12,10132587676
9863,41790680,58515441,100306121,8,0,0,30208,13,9792151370
9864,41798330,64066017,105864347,8,0,1,6144,13,6094632904
9865,41819751,64045262,105865013,7,0,1,1024,8,4100326263
9866,41825900,64039574,105865474,9,0,1,10240,19,2771847111
9867,41826500,57432877,99259377,4,0,0,4096,4,7614290002
9868,41828210,58044077,99872287,4,0,0,6656,4,2083737488
9869,41834490,58162500,99996990,6,0,0,9728,5,7449591159
9870,41846840,64021540,105868380,8,0,1,4608,13,3796264781
9871,41855991,64017215,105873206,7,0,1,7680,8,6790569956
9872,41884680,63990085,105874765,6,0,1,1024,5,1589420105
9873,41893090,57646067,99539157,6,0,0,26112,5,2712830490
9874,41912920,57493785,99406705,6,0,0,13312,5,779132939
9875,41935900,57564082,99499982,4,0,0,1536,4,5547868718
9876,41957320,57753450,99710770,4,0,0,28672,4,1362822721
9877,41964490,57617700,99582190,8,0,0,24064,13,8439160882
9878,41967250,57482776,99450026,3,0,0,10240,12,6824967231
9879,41971500,58493513,100465013,6,0,0,48640,5,5881520520
9880,41978370,63897381,105875751,4,0,1,1536,4,858277235
9881,41982260,63901821,105884081,9,0,1,17408,19,2764980608
9882,41991760,58095951,100087711,4,0,0,4608,4,1378095944
9883,42000890,58525040,100525930,4,0,0,41472,4,3020493959
9884,42002640,63886587,105889227,4,0,1,8192,4,5936423942
9885,42027590,63861893,105889483,8,0,1,9216,13,9384605728
9886,42035800,57632562,99668362,9,0,0,8192,19,5947967727
9887,42045460,63844369,105889829,3,0,1,512,12,4344001703
9888,42053260,57643713,99696973,4,0,0,4608,4,8445691345
9889,42054750,57749063,99803813,6,0,0,9216,5,10648369944
9890,42074340,58375830,100450170,4,0,0,26112,4,7409730626
9891,42080230,57752060,99832290,3,0,0,5632,12,1312157003
9892,42094800,57655391,99750191,8,0,0,40960,13,2614112007
9893,42100590,63801703,105902293,4,0,1,9728,4,6661551188
9894,42116670,57942525,100059195,8,0,0,2048,13,919299385
9895,42122130,57594991,99717121,3,0,0,10240,12,4770791634
9896,42128010,57766675,99894685,4,0,0,40448,4,9887220244
9897,42130090,63778140,105908230,6,0,1,17920,5,3262817257
9898,42135050,58206997,100342047,8,0,0,66560,13,1855730331
9899,42163280,63747741,105911021,4,0,1,17408,4,1458556738
9900,42178850,58319435,100498285,6,0,0,2048,5,8462557008
9901,42192420,59159123,101351543,6,0,0,67072,5,555522368
9902,42196700,57797303,99994003,6,0,0,34304,5,3804931932
9903,42196990,59064523,101261513,3,0,0,38400,12,7624237163
9904,42200660,57822253,100022913,3,0,0,8704,12,8064895241
9905,42200940,57945900,100146840,3,0,0,34304,12,1975076124
9906,42201840,57609341,99811181,3,0,0,20992,12,4450546159
9907,42226150,57856298,100082448,8,0,0,41472,13,7421673734
9908,42238400,57846723,100085123,3,0,0,8704,12,1124851976
9909,42239560,57867822,100107382,9,0,0,2560,19,4603114122
9910,42243110,58613478,100856588,6,0,0,19968,5,6075263032
9911,42255060,57706137,99961197,3,0,0,30208,12,4714137312
9912,42259970,63651717,105911687,8,0,1,1024,13,10004581729
9913,42261530,59067519,101329049,8,0,0,1024,13,6101313633
9914,42269450,57612888,99882338,3,0,0,4608,12,5822106816
9915,42270730,58215227,100485957,4,0,0,41984,4,1442320031
9916,42277250,58666522,100943772,3,0,0,9216,12,6856924270
9917,42280850,57817729,100098579,4,0,0,23552,4,4877499062
9918,42284510,57913268,100197778,8,0,0,4608,13,9935938176
9919,42287200,58105188,100392388,8,0,0,2560,13,4210625663
9920,42291700,63621267,105912967,8,0,1,14336,13,3535605707
9921,42294570,63620356,105914926,6,0,1,14336,5,8222962393
9922,42312240,58285145,100597385,3,0,0,27648,12,9897502503
9923,42314890,63600702,105915592,8,0,1,1024,13,10236464280
9924,42323240,58811009,101134249,9,0,0,15872,19,9815387480
9925,42324840,58291607,100616447,6,0,0,45568,5,3659065260
9926,42325290,57689272,100014562,9,0,0,14336,19,9998399966
9927,42328800,57954132,100282932,8,0,0,69632,13,971530383
9928,42329550,58301591,100631141,6,0,0,6656,5,5305660810
9929,42340560,63576108,105916668,3,0,1,13312,12,9375763388
9930,42349830,57763968,100113798,6,0,0,14848,5,7767177011
9931,42368050,59018767,101386817,6,0,0,15360,5,5587216299
9932,42374320,58386047,100760367,6,0,0,26112,5,9668849501
9933,42388290,58462199,100850489,6,0,0,83456,5,9121993839
9934,42393740,58048451,100442191,8,0,0,111104,13,3049634181
9935,42406340,57942929,100349269,8,0,0,23040,13,2010304467
9936,42409590,58309769,100719359,3,0,0,25088,12,8291564705
9937,42439640,58484569,100924209,8,0,0,3584,13,6200508265
9938,42454080,58012524,100466604,3,0,0,5120,12,8608236332
9939,42458060,58470844,100928904,8,0,0,15360,13,4728062941
9940,42468900,63456396,105925296,9,0,1,5632,19,1762115927
9941,42486430,63440457,105926887,9,0,1,512,19,4489957834
9942,42500580,58321093,100821673,8,0,0,17408,13,4716046485
9943,42507280,58512324,101019604,3,0,0,32768,12,6898984127
9944,42513740,57742141,100255881,9,0,0,2560,19,8106819338
9945,42517250,58191003,100708253,6,0,0,66048,5,707000461
9946,42520450,63406783,105927233,8,0,1,512,13,8598301934
9947,42543790,57689159,100232949,3,0,0,6144,12,1853368835
9948,42547940,57978637,100526577,8,0,0,2048,13,4193701514
9949,42554490,57932270,100486760,3,0,0,2560,12,9363190786
9950,42567360,57816669,100384029,9,0,0,10752,19,4987331368
9951,42605910,57736316,100342226,3,0,0,512,12,4955315478
9952,42606810,63323649,105930459,6,0,1,5120,5,9394724737
9953,42620300,57587682,100207982,8,0,0,4096,13,1135312802
9954,42620580,58091120,100711700,9,0,0,11264,19,5989688774
9955,42620970,58047320,100668290,6,0,0,3072,5,9528903203
9956,42622940,58048803,100671743,9,0,0,2048,19,4678204768
9957,42656260,58400797,101057057,6,0,0,22528,5,9977597021
9958,42663840,57692472,100356312,3,0,0,23040,12,815996942
9959,42677090,58405654,101082744,3,0,0,11264,12,3615792493
9960,42691650,63247297,105938947,8,0,1,16896,13,7698669530
9961,42715860,57847204,100563064,8,0,0,6144,13,10314256617
9962,42741440,57861108,100602548,3,0,0,16896,12,5792872208
9963,42779300,58180319,100959619,3,0,0,45568,12,9402792551
9964,42794300,57834798,100629098,3,0,0,41472,12,6634904867
9965,42811550,63160448,105971998,3,0,1,44032,12,8869620898
9966,42837630,63140781,105978411,6,0,1,22528,5,7792593837
9967,42856090,57688811,100544901,3,0,0,7168,12,10497753122
9968,42856900,63137885,105994785,6,0,1,1024,5,5963144127
9969,42866040,58013455,100879495,3,0,0,24576,12,3384269225
9970,42874630,57851505,100726135,3,0,0,4096,12,787058369
9971,42972880,58156518,101129398,3,0,0,34816,12,9547023173
9972,43043430,57606391,100649821,6,0,0,16896,5,6331264470
9973,43142740,57404368,100547108,6,0,0,7168,5,9786966755
9974,43160930,57644637,100805567,6,0,0,11264,5,6056121333
9975,43237750,62763071,106000821,6,0,1,3072,5,996002425
9976,43247490,57744982,100992472,6,0,0,3072,5,7764639384
9977,43404970,57238687,100643657,6,0,0,15360,5,1117748218
9978,43409190,57486651,100895841,6,0,0,51200,5,4397554076
9979,43413760,57780162,101193922,6,0,0,37376,5,8742978947
9980,43466060,57093476,100559536,6,0,0,31744,5,5058491387
9981,43467440,57455662,100923102,6,0,0,31744,5,2146702809
9982,43520740,57729028,101249768,6,0,0,26624,5,792808520
9983,43521670,57633030,101154700,6,0,0,67072,5,1757276790
9984,43536750,57207065,100743815,6,0,0,10240,5,9621848807
9985,43587060,57741662,101328722,6,0,0,52736,5,2200834378
9986,43587280,62414847,106002127,6,0,1,2048,5,998647317
9987,43637000,57030339,100667339,6,0,0,12800,5,9374122588
9988,43640520,57398522,101039042,6,0,0,61952,5,6161070973
9989,43666820,57846545,101513365,6,0,0,36352,5,1304599928
9990,43670530,62334823,106005353,6,0,1,5120,5,2976224348
9991,43689150,57575498,101264648,6,0,0,10240,5,10600724361
9992,43730190,62276789,106006979,6,0,1,2560,5,6440068929
9993,43735770,57245647,100981417,6,0,0,54784,5,10229824750
9994,43798910,62212921,106011831,6,0,1,7680,5,10619804659
9995,43819240,57352105,101171345,6,0,0,18944,5,3766712419
9996,43852340,57144432,100996772,6,0,0,2048,5,2202909767
9997,43892310,62120507,106012817,6,0,1,1536,5,6048741706
9998,43915030,57145786,101060816,6,0,0,12288,5,8897363003
9999,44150080,57225389,101375469,6,0,0,12288,5,1758431306
