RequestID,ArrivalTime,DelayTime,FinishTime,InitiatorID,TargetID,IOType,Size,VolumeID,Offset
0,0,67656,67656,0,0,0,7680,6,386222144
1,1,172907,172908,3,0,0,15360,18,7135794760
2,2,230188,230190,4,0,0,175616,7,5622199029
3,3,234570,234573,1,0,0,14336,1,8652746889
4,4,247157,247161,5,0,0,14848,12,4984170026
5,5,113491,113496,9,0,0,5632,4,5514461859
6,6,410521,410527,6,0,0,34816,12,1391982931
7,7,943549,943556,7,0,0,6656,1,2686922558
8,8,251263,251271,8,0,0,2048,11,9584480619
9,9,241911,241920,2,0,0,24064,1,5362256133
10,3520,268418,271938,9,0,0,31744,4,2392277062
11,10060,240564,250624,8,0,0,11264,11,10214175897
12,20050,156617,176667,3,0,0,12288,18,4000945095
13,27400,289619,317019,3,0,0,32768,18,6869052147
14,67850,1148989,1216839,6,0,0,52224,12,2260568799
15,71871,14545,86416,9,0,1,28160,4,2233096035
16,72350,385818,458168,2,0,0,20480,1,6285924351
17,83020,159602,242622,1,0,0,2048,1,1702144951
18,86620,588554,675174,1,0,0,32256,1,10685389558
19,92510,337243,429753,2,0,0,45056,1,5920674435
20,92930,7706,100636,7,0,1,8192,1,4481768924
21,99150,252884,352034,1,0,0,64512,1,774579490
22,115950,258251,374201,4,0,0,72704,7,2583617428
23,123970,448909,572879,5,0,0,89088,12,2471851632
24,132400,5802,138202,1,0,1,6144,1,1651000323
25,138850,447582,586432,2,0,0,24064,1,2851453461
26,156090,2946,159036,6,0,1,3072,12,4087411241
27,160311,81672,241983,9,0,1,62976,4,9095061832
28,162690,478916,641606,5,0,0,26112,12,6087931017
29,178340,574696,753036,4,0,0,44544,7,1144112955
30,180190,194822,375012,9,0,0,2560,4,5546775661
31,187460,294935,482395,3,0,0,3072,18,5757391368
32,189810,1147743,1337553,7,0,0,8704,1,5941835838
33,195680,1051651,1247331,0,0,0,36352,6,2132575048
34,211300,239896,451196,4,0,0,10752,7,7473792573
35,212470,452861,665331,0,0,0,13312,6,2706599614
36,218110,847036,1065146,0,0,0,10240,6,4524233617
37,250760,341443,592203,1,0,0,512,1,1987444972
38,257860,677226,935086,9,0,0,30720,4,1679707380
39,265690,1431539,1697229,7,0,0,244224,1,1276143888
40,268760,590768,859528,9,0,0,106496,4,5361374884
41,269490,196368,465858,1,0,0,2048,1,6573175210
42,270590,670907,941497,6,0,0,20992,12,5633468415
43,275970,992182,1268152,5,0,0,37376,12,10273758664
44,278571,11533,290104,8,0,1,18944,11,8255303066
45,290590,1518,292108,0,0,1,1536,6,10593059987
46,297270,524126,821396,4,0,0,35328,7,2318898325
47,299210,351771,650981,5,0,0,30720,12,10036276351
48,299820,245884,545704,6,0,0,51712,12,3488672023
49,304130,418182,722312,9,0,0,32768,4,9426708834
50,348940,569939,918879,0,0,0,21504,6,5424254915
51,350500,612575,963075,4,0,0,51712,7,6968613508
52,361391,228421,589812,9,0,1,348160,4,7216889191
53,383160,206998,590158,7,0,1,512,1,719730363
54,388360,520526,908886,6,0,0,25600,12,9392965446
55,397300,890718,1288018,0,0,0,65024,6,4362803411
56,402630,639012,1041642,1,0,0,20480,1,6793016398
57,429720,1691554,2121274,9,0,0,102400,4,582258565
58,430200,1272722,1702922,1,0,0,1536,1,8237118020
59,436110,157274,593384,4,0,1,5120,7,7896910638
60,443540,737246,1180786,5,0,0,3072,12,9027936557
61,452940,1273280,1726220,4,0,0,70656,7,2943308157
62,454690,616997,1071687,0,0,0,7680,6,6531366282
63,459280,1857548,2316828,9,0,0,23552,4,5510248167
64,486170,661888,1148058,1,0,0,47104,1,5551950150
65,488500,2019016,2507516,7,0,0,56320,1,8605678765
66,494620,830950,1325570,0,0,0,10752,6,8125397685
67,496250,2416125,2912375,7,0,0,957952,1,8938727834
68,500901,95069,595970,8,0,1,4096,11,9687248111
69,503031,98636,601667,8,0,1,18944,11,622481543
70,516360,643282,1159642,8,0,0,30208,11,7320282341
71,537060,1227480,1764540,6,0,0,65024,12,5591511211
72,539830,481409,1021239,9,0,0,34816,4,5396919731
73,546771,260783,807554,9,0,1,379904,4,3978902115
74,548490,878028,1426518,3,0,0,13824,18,303184208
75,555681,465573,1021254,9,0,1,535040,4,2350700016
76,560700,1141723,1702423,9,0,0,10240,4,7244125861
77,570040,977513,1547553,9,0,0,6144,4,357220236
78,570460,954113,1524573,8,0,0,20480,11,3118781371
79,570610,450659,1021269,7,0,1,1024,1,1265949330
80,574730,446554,1021284,4,0,1,14336,7,563640558
81,579000,1765097,2344097,1,0,0,39424,1,6007486553
82,584740,1490008,2074748,2,0,0,54272,1,3141005240
83,584950,1298311,1883261,6,0,0,4608,12,2198062040
84,595750,1661021,2256771,7,0,0,56832,1,6469861621
85,600460,2462934,3063394,3,0,0,2048,18,3306734872
86,603700,417599,1021299,6,0,1,9728,12,6547794733
87,614810,1534815,2149625,7,0,0,18432,1,2413307793
88,615030,2002155,2617185,7,0,0,9728,1,6192690311
89,643180,1087135,1730315,4,0,0,13312,7,8070642234
90,700420,547862,1248282,5,0,0,3072,12,10707345694
91,702590,2463535,3166125,1,0,0,33792,1,6162575132
92,703630,317684,1021314,2,0,1,2560,1,4793541291
93,704200,1535209,2239409,6,0,0,71680,12,8995566555
94,704910,1578523,2283433,6,0,0,34816,12,7557691405
95,706120,821285,1527405,2,0,0,512,1,10438845311
96,726641,299105,1025746,9,0,1,8192,4,2843903364
97,728430,1643929,2372359,6,0,0,58368,12,4811069419
98,736440,1405469,2141909,4,0,0,1024,7,2346115675
99,758020,1833745,2591765,1,0,0,145408,1,4250341805
100,758510,946167,1704677,3,0,0,5632,18,10388043430
101,758560,1446294,2204854,2,0,0,33280,1,5991222644
102,761260,2324495,3085755,6,0,0,8704,12,10394939927
103,765110,261302,1026412,2,0,1,1024,1,6741326044
104,765180,1426751,2191931,8,0,0,25088,11,6547996760
105,779710,2331310,3111020,5,0,0,26624,12,5125887838
106,787340,241018,1028358,1,0,1,3072,1,8376520467
107,799580,985218,1784798,1,0,0,6144,1,5323336125
108,802230,231620,1033850,6,0,1,17920,12,6949711429
109,803920,1735640,2539560,5,0,0,20992,12,3224167462
110,836060,718147,1554207,5,0,0,17920,12,4932445506
111,837990,206792,1044782,4,0,1,35840,7,1328607778
112,842290,1121988,1964278,0,0,0,10752,6,8050393872
113,842990,928429,1771419,7,0,0,22528,1,1848437165
114,859230,1486466,2345696,8,0,0,5120,11,1564628924
115,863240,1420700,2283940,1,0,0,1536,1,9592671809
116,866880,1430078,2296958,6,0,0,36352,12,9583154185
117,868450,2494874,3363324,3,0,0,51200,18,4257277406
118,870780,828500,1699280,7,0,0,6656,1,10533214075
119,881520,1079459,1960979,4,0,0,61952,7,320889286
120,906060,2020784,2926844,3,0,0,27136,18,10396460031
121,910040,3182814,4092854,9,0,0,56832,4,8693295331
122,931230,2059518,2990748,6,0,0,7680,12,2651934270
123,931460,1191701,2123161,4,0,0,6144,7,10495781919
124,935380,1199620,2135000,8,0,0,30208,11,1860715539
125,951811,98258,1050069,9,0,1,16896,4,9963595480
126,955810,1577323,2533133,9,0,0,23552,4,6547766941
127,959420,2028949,2988369,0,0,0,118272,6,7197703132
128,969120,516528,1485648,0,0,0,5120,6,9911631454
129,978730,77650,1056380,4,0,1,22016,7,6261427076
130,985970,1104081,2090051,2,0,0,50176,1,6289581479
131,988080,3297838,4285918,7,0,0,23040,1,3692474885
132,991770,1383896,2375666,0,0,0,10752,6,9698309046
133,1004980,55906,1060886,7,0,1,7168,1,4273513024
134,1010300,2235329,3245629,0,0,0,176128,6,9690567738
135,1026270,40005,1066275,6,0,1,25600,12,2112116854
136,1027370,1973689,3001059,1,0,0,33792,1,3635709535
137,1033740,1586744,2620484,3,0,0,10752,18,3038120783
138,1038370,1229204,2267574,3,0,0,35328,18,7455235446
139,1040760,2035137,3075897,4,0,0,40960,7,7696288606
140,1047380,802405,1849785,1,0,0,12800,1,1318020997
141,1050720,1900631,2951351,2,0,0,2048,1,9650369672
142,1055140,12121,1067261,1,0,1,1536,1,9488218927
143,1057220,1380619,2437839,5,0,0,25600,12,5021504482
144,1057680,3000146,4057826,2,0,0,113152,1,5253905913
145,1059280,8340,1067620,4,0,1,9728,7,3856722152
146,1059530,3173756,4233286,6,0,0,126464,12,4637463196
147,1061530,2021558,3083088,3,0,0,23552,18,2167319772
148,1061580,2244397,3305977,8,0,0,14848,11,5213191660
149,1066310,1217809,2284119,3,0,0,512,18,344143314
150,1068820,2123130,3191950,4,0,0,73216,7,4839872150
151,1072590,961096,2033686,8,0,0,1024,11,6263076375
152,1078720,2611523,3690243,8,0,0,14336,11,2610008663
153,1079940,1429635,2509575,0,0,0,6656,6,3359037094
154,1085980,1528194,2614174,9,0,0,40960,4,7424460634
155,1099630,2198033,3297663,3,0,0,14848,18,1493110074
156,1109040,1905310,3014350,4,0,0,43520,7,10593564377
157,1110940,1186813,2297753,8,0,0,2560,11,5041584739
158,1161220,12737,1173957,7,0,1,24576,1,5315876322
159,1167340,1892701,3060041,6,0,0,69120,12,5572543777
160,1175540,1204681,2380221,0,0,0,14848,6,1843140219
161,1186110,1031429,2217539,8,0,0,24576,11,1158175435
162,1195880,3898,1199778,2,0,1,4096,1,7294851814
163,1214100,3239237,4453337,6,0,0,63488,12,2304112845
164,1217570,1994,1219564,0,0,1,2048,6,4569011637
165,1225840,1800576,3026416,0,0,0,37888,6,6425560395
166,1230390,1861940,3092330,7,0,0,21504,1,336044508
167,1235350,12947,1248297,2,0,1,4096,1,948602591
168,1239321,11905,1251226,9,0,1,8704,4,4827097948
169,1239570,2042400,3281970,1,0,0,85504,1,5295560617
170,1245370,1698557,2943927,7,0,0,55808,1,5235095674
171,1245630,22537,1268167,7,0,1,6144,1,1669788501
172,1258380,1254268,2512648,9,0,0,6656,4,9414588304
173,1259230,3401520,4660750,8,0,0,17920,11,7711401007
174,1261540,2702171,3963711,3,0,0,12288,18,6506730613
175,1273070,1201374,2474444,1,0,0,12800,1,1888286753
176,1281780,3426941,4708721,5,0,0,25600,12,3696570923
177,1305130,3344818,4649948,6,0,0,44544,12,4855784204
178,1305690,1946546,3252236,4,0,0,21504,7,839368728
179,1308460,1610029,2918489,3,0,0,13312,18,6535831035
180,1321080,2044295,3365375,7,0,0,6656,1,7937476564
181,1327130,1800955,3128085,6,0,0,39424,12,6275104395
182,1337000,3520722,4857722,9,0,0,59904,4,4615332502
183,1341751,13341,1355092,8,0,1,22528,11,7811352291
184,1352030,3132772,4484802,7,0,0,20480,1,113005551
185,1353250,3125297,4478547,3,0,0,74240,18,10531693073
186,1358790,1809254,3168044,8,0,0,6144,11,3210192293
187,1378910,3162491,4541401,4,0,0,32256,7,8228747505
188,1384620,3387,1388007,4,0,1,9728,7,4030700164
189,1396960,1755039,3151999,1,0,0,69632,1,2943931376
190,1406220,2984881,4391101,5,0,0,30208,12,9026315432
191,1421890,1693825,3115715,2,0,0,15360,1,4092174404
192,1426670,1525640,2952310,1,0,0,3072,1,7325647536
193,1427620,1994,1429614,0,0,1,2048,6,7139948470
194,1431820,1723978,3155798,8,0,0,12288,11,5135771781
195,1433961,2470,1436431,9,0,1,2560,4,759212465
196,1447770,3466829,4914599,9,0,0,29696,4,7932019785
197,1448280,2099481,3547761,6,0,0,40960,12,1118059689
198,1452319,3128,1455447,5,0,1,9216,12,4903408001
199,1452450,2824686,4277136,0,0,0,15360,6,264320352
200,1457290,2139941,3597231,0,0,0,22016,6,1557842021
201,1464510,1905404,3369914,1,0,0,14848,1,2823358187
202,1494470,1675149,3169619,4,0,0,5120,7,5565330736
203,1511950,3105382,4617332,8,0,0,33280,11,2514484449
204,1518750,20619,1539369,2,0,1,28672,1,2108221842
205,1536320,5971,1542291,0,0,1,14848,6,7809897427
206,1540830,3810980,5351810,3,0,0,62976,18,7762195360
207,1543980,597587,2141567,4,0,0,21504,7,6820201059
208,1556570,3433316,4989886,5,0,0,73216,12,8031319069
209,1558890,1042733,2601623,0,0,0,15360,6,3172821081
210,1569240,1469710,3038950,0,0,0,1024,6,7423669680
211,1569760,3211822,4781582,7,0,0,36864,1,6181046998
212,1573830,1556930,3130760,4,0,0,8704,7,9272706724
213,1574750,1718358,3293108,6,0,0,9728,12,3831524096
214,1601600,3913720,5515320,0,0,0,128512,6,8320771306
215,1606570,2646317,4252887,7,0,0,43008,1,6847183783
216,1614370,1641469,3255839,3,0,0,11776,18,10528172927
217,1623100,1667005,3290105,3,0,0,26624,18,10522753913
218,1653120,1449765,3102885,3,0,0,34304,18,10716956607
219,1666580,3971702,5638282,6,0,0,20480,12,870272183
220,1667090,63288,1730378,0,0,1,2560,6,9343596815
221,1673450,3638010,5311460,4,0,0,65024,7,5196106282
222,1673490,3158648,4832138,3,0,0,41472,18,10710736082
223,1682930,4264078,5947008,5,0,0,512,12,9692280077
224,1701930,30463,1732393,6,0,1,2048,12,219471589
225,1704380,3679199,5383579,2,0,0,20480,1,5827763097
226,1716970,1230124,2947094,9,0,0,10240,4,9764772835
227,1718230,3925373,5643603,5,0,0,15360,12,5901056908
228,1718551,16384,1734935,8,0,1,10752,11,8250477729
229,1723230,16879,1740109,1,0,1,6144,1,9879196353
230,1723250,17525,1740775,0,0,1,11264,6,7050085759
231,1748251,77030,1825281,8,0,1,91136,11,3244590421
232,1757430,4160508,5917938,6,0,0,91136,12,7006203992
233,1757771,68176,1825947,8,0,1,1024,11,10056675989
234,1760970,1760568,3521538,0,0,0,62464,6,2306687968
235,1763890,1250951,3014841,0,0,0,1536,6,9291708341
236,1770650,826278,2596928,2,0,0,16896,1,4547891580
237,1772521,64972,1837493,8,0,1,38912,11,2885491478
238,1779270,2511975,4291245,5,0,0,17408,12,37359073
239,1783180,3286206,5069386,0,0,0,45568,6,7664392918
240,1788210,1159679,2947889,9,0,0,2560,4,4834229581
241,1832920,1575797,3408717,7,0,0,33280,1,3220214697
242,1836350,2058409,3894759,8,0,0,22016,11,1339322871
243,1840590,1948595,3789185,5,0,0,22528,12,9827501159
244,1841610,1459828,3301438,7,0,0,12288,1,3854406075
245,1846490,1921615,3768105,7,0,0,10752,1,6198795765
246,1847580,1785771,3633351,1,0,0,8192,1,1806223064
247,1861800,1052618,2914418,6,0,0,6656,12,300238437
248,1870280,1245770,3116050,7,0,0,1024,1,1606745709
249,1873320,3057533,4930853,8,0,0,32256,11,4295491414
250,1879680,1789619,3669299,7,0,0,13312,1,2344036710
251,1887630,3400392,5288022,3,0,0,44032,18,92055521
252,1913710,1918541,3832251,9,0,0,23552,4,819103433
253,1927580,1023132,2950712,2,0,0,9216,1,7602597478
254,1946290,3486210,5432500,8,0,0,48128,11,1474629553
255,1958080,1902590,3860670,2,0,0,29184,1,7585111281
256,1968260,2946,1971206,6,0,1,3072,12,3479018567
257,1968910,298999,2267909,4,0,0,1024,7,1623908103
258,1969740,2652295,4622035,2,0,0,15360,1,5544690205
259,1978961,4937,1983898,8,0,1,12800,11,6433437631
260,1980710,2609063,4589773,2,0,0,29696,1,6834946256
261,1981900,3964913,5946813,7,0,0,94720,1,1673933979
262,1987300,2893569,4880869,5,0,0,19968,12,1508016354
263,2001629,121547,2123176,5,0,1,127488,12,7246595711
264,2004551,118648,2123199,9,0,1,512,4,4453609302
265,2005350,3539750,5545100,9,0,0,11264,4,10067014927
266,2011690,3655048,5666738,2,0,0,1024,1,5684182547
267,2017400,4148241,6165641,2,0,0,34304,1,8483574270
268,2026360,2300271,4326631,9,0,0,46592,4,6333641886
269,2043210,2924353,4967563,6,0,0,26112,12,3314942389
270,2050090,3120796,5170886,5,0,0,167424,12,10479713259
271,2051060,4133355,6184415,2,0,0,27648,1,10327091808
272,2057850,65388,2123238,7,0,1,26112,1,2575630936
273,2058320,980303,3038623,4,0,0,39936,7,88615747
274,2077450,64132,2141582,6,0,1,30208,12,3065277813
275,2079140,4777026,6856166,7,0,0,13824,1,10418550511
276,2079450,62474,2141924,1,0,1,14336,1,4106394851
277,2083190,4378054,6461244,8,0,0,32768,11,5736465154
278,2090780,51401,2142181,2,0,1,3072,1,10170010394
279,2092760,1350580,3443340,5,0,0,69632,12,50531921
280,2101210,2554057,4655267,7,0,0,17408,1,2863271449
281,2104310,45330,2149640,1,0,1,18944,1,6915398887
282,2106300,2172567,4278867,1,0,0,5632,1,8289385914
283,2138780,11943,2150723,1,0,1,2048,1,931071305
284,2153150,2660156,4813306,6,0,0,22528,12,6299896060
285,2154040,2343105,4497145,7,0,0,28160,1,2188426160
286,2165340,3721836,5887176,3,0,0,49152,18,4199853835
287,2165870,894662,3060532,2,0,0,1536,1,7537831585
288,2167230,2024787,4192017,9,0,0,2048,4,2605030759
289,2173470,5210888,7384358,9,0,0,8704,4,9710104050
290,2178800,264564,2443364,9,0,0,2048,4,10266111996
291,2180720,3638844,5819564,8,0,0,57856,11,7315639032
292,2200890,4957145,7158035,4,0,0,71680,7,10341809780
293,2202070,15484,2217554,4,0,1,14336,7,5797596660
294,2204130,35294,2239424,0,0,1,7680,6,3530234874
295,2217140,1805236,4022376,7,0,0,16896,1,319546591
296,2218150,7906712,10124862,4,0,1,12800,7,3971617866
297,2224180,3930978,6155158,3,0,0,116224,18,2225898860
298,2227700,8894308,11122008,7,0,1,11264,1,2300093075
299,2232010,1527553,3759563,2,0,0,13824,1,419746905
300,2260830,1814677,4075507,3,0,0,47104,18,2694359036
301,2261510,4322689,6584199,1,0,0,88064,1,5555966731
302,2272380,8850294,11122674,0,0,1,1024,6,487080870
303,2272780,2779091,5051871,3,0,0,72704,18,9410113175
304,2273970,5301417,7575387,4,0,0,22016,7,2476535517
305,2281580,1726383,4007963,9,0,0,72704,4,5401500795
306,2297570,8825450,11123020,6,0,1,512,12,4791765296
307,2304250,5603965,7908215,6,0,0,27648,12,127830522
308,2311690,4295663,6607353,5,0,0,24064,12,10284514904
309,2313040,1070747,3383787,9,0,0,24064,4,2945704019
310,2318240,2185553,4503793,8,0,0,4608,11,5610449377
311,2327920,734835,3062755,0,0,0,7168,6,7811947057
312,2329801,9356856,11686657,8,0,1,17920,11,90432738
313,2330560,5429446,7760006,8,0,0,79872,11,8458909152
314,2333680,3556475,5890155,3,0,0,9728,18,1168400392
315,2339890,12639286,14979176,7,0,1,7168,1,9898453638
316,2344710,2905755,5250465,8,0,0,20992,11,10202027617
317,2344770,2089200,4433970,4,0,0,27648,7,6406968629
318,2357320,3715715,6073035,6,0,0,19456,12,8200819416
319,2363200,1320343,3683543,5,0,0,4608,12,522847378
320,2366180,3251784,5617964,9,0,0,89088,4,1502673855
321,2366250,12748167,15114417,4,0,1,11264,7,1500187373
322,2370110,3367152,5737262,9,0,0,71168,4,5770044921
323,2397230,5668200,8065430,9,0,0,308736,4,8648531155
324,2399221,12720183,15119404,9,0,1,3584,4,1406377424
325,2405340,2927227,5332567,1,0,0,69120,1,7256854995
326,2412670,5105574,7518244,8,0,0,143872,11,4234602107
327,2435350,3196669,5632019,8,0,0,46080,11,10307450839
328,2437390,1532229,3969619,1,0,0,11264,1,10164164776
329,2437640,4088962,6526602,6,0,0,9216,12,663178243
330,2444910,4498586,6943496,4,0,0,57344,7,2713686490
331,2451550,4771612,7223162,8,0,0,6656,11,5812438842
332,2452250,1172865,3625115,8,0,0,18432,11,1589405533
333,2452410,12668459,15120869,0,0,1,6656,6,9458994273
334,2454840,17309379,19764219,7,0,1,12288,1,4283265835
335,2462320,2458690,4921010,4,0,0,20992,7,3621989684
336,2467539,17713232,20180771,5,0,1,20480,12,6730633362
337,2470760,2649091,5119851,3,0,0,21504,18,9722297434
338,2474770,1586362,4061132,7,0,0,512,1,464434839
339,2487800,3904569,6392369,5,0,0,29696,12,6520641504
340,2495460,2949418,5444878,8,0,0,1536,11,3280898361
341,2496790,4663616,7160406,0,0,0,7680,6,521497899
342,2507869,19416642,21924511,5,0,1,41472,12,10580192160
343,2508460,4535436,7043896,2,0,0,6656,1,2681960993
344,2526070,19398464,21924534,2,0,1,512,1,337364454
345,2529740,3764007,6293747,3,0,0,45056,18,7346154169
346,2533980,3487814,6021794,1,0,0,1536,1,2136594985
347,2534000,5010051,7544051,6,0,0,14336,12,8159568198
348,2538760,3502870,6041630,5,0,0,6144,12,2784735782
349,2541800,6357977,8899777,9,0,0,39936,4,2500484708
350,2543290,2483485,5026775,0,0,0,67072,6,3446089807
351,2564560,3221668,5786228,6,0,0,20992,12,5607411979
352,2565330,2660683,5226013,3,0,0,15872,18,9954369444
353,2571520,6114989,8686509,4,0,0,122880,7,4283878191
354,2573470,1084805,3658275,6,0,0,10240,12,6648131422
355,2574410,20659469,23233879,6,0,1,45056,12,3724198163
356,2583610,1745392,4329002,1,0,0,7680,1,6685084026
357,2583960,2879511,5463471,8,0,0,24576,11,4416577446
358,2591790,4081752,6673542,3,0,0,11264,18,6301231052
359,2592920,2960902,5553822,7,0,0,8704,1,1596260647
360,2593050,6550877,9143927,5,0,0,132608,12,3121850891
361,2594370,1678055,4272425,0,0,0,56832,6,5895597244
362,2621160,1799991,4421151,0,0,0,14848,6,245971564
363,2623160,5174848,7798008,2,0,0,50176,1,8072921294
364,2624130,20941791,23565921,7,0,1,65536,1,1430713588
365,2625300,5087511,7712811,4,0,0,21504,7,9492916561
366,2626230,1434731,4060961,9,0,0,10240,4,8064812638
367,2635470,3580339,6215809,0,0,0,75264,6,4678060258
368,2643260,2886991,5530251,1,0,0,16896,1,9506732966
369,2645850,1593894,4239744,6,0,0,11776,12,4271419988
370,2648570,4912656,7561226,6,0,0,56320,12,6175692728
371,2654440,4477966,7132406,2,0,0,177152,1,3197440212
372,2657020,20930327,23587347,7,0,1,6656,1,8566992586
373,2665051,20922319,23587370,8,0,1,13824,11,15082961
374,2668020,2138407,4806427,6,0,0,27648,12,2321686377
375,2669650,3423697,6093347,8,0,0,18944,11,8431307160
376,2671430,3707920,6379350,9,0,0,38912,4,3130337277
377,2672230,2441038,5113268,9,0,0,58368,4,237593314
378,2680380,6701708,9382088,4,0,0,16896,7,10000666210
379,2696620,2675985,5372605,3,0,0,68096,18,9427000182
380,2702590,21030914,23733504,2,0,1,15360,1,4120018744
381,2703120,5866450,8569570,9,0,0,50176,4,9479012816
382,2703910,1661572,4365482,7,0,0,2048,1,4018367918
383,2722880,4440193,7163073,5,0,0,8704,12,10583859675
384,2737000,4480204,7217204,1,0,0,40960,1,9642997677
385,2757170,2196717,4953887,0,0,0,22528,6,4509731877
386,2761260,2128827,4890087,8,0,0,1536,11,2605850505
387,2766090,3230851,5996941,3,0,0,23552,18,8612133815
388,2781210,5185211,7966421,8,0,0,18944,11,3964532255
389,2782340,6124355,8906695,9,0,0,16896,4,4990756853
390,2800260,1216953,4017213,0,0,0,15360,6,9348474747
391,2800651,3319064,6119715,5,0,0,81920,12,8320534348
392,2805370,1944718,4750088,8,0,0,10752,11,5847959947
393,2809350,2286103,5095453,6,0,0,85504,12,9145383473
394,2819080,8221040,11040120,6,0,0,34304,12,10720050889
395,2835460,3834611,6670071,1,0,0,148992,1,1966008015
396,2842320,2567482,5409802,8,0,0,86016,11,9235502706
397,2864150,6765698,9629848,8,0,0,71680,11,3918889714
398,2868540,8042061,10910601,6,0,0,31232,12,10125872858
399,2883840,6597154,9480994,3,0,0,98304,18,9546477823
400,2887680,2530141,5417821,4,0,0,26112,7,6640125609
401,2888580,1206637,4095217,8,0,0,7680,11,4420181331
402,2894010,5281453,8175463,8,0,0,4096,11,1782105561
403,2926670,8632041,11558711,6,0,0,53760,12,7573591303
404,2929380,3695280,6624660,6,0,0,44544,12,5704622373
405,2935040,2898447,5833487,4,0,0,45568,7,6854611608
406,2941110,1295007,4236117,8,0,0,9216,11,6331758474
407,2944480,6827839,9772319,8,0,0,34304,11,2417761975
408,2951960,6708861,9660821,6,0,0,67072,12,8902612257
409,2959270,4415116,7374386,6,0,0,11264,12,8573327624
410,2960550,2213223,5173773,0,0,0,9216,6,1684814676
411,2968530,7186802,10155332,5,0,0,2560,12,6937334040
412,2979620,2464759,5444379,6,0,0,38912,12,3494753140
413,2990210,7707536,10697746,5,0,0,89600,12,9690272282
414,2991510,6286470,9277980,1,0,0,14336,1,9964716292
415,3007480,2284145,5291625,2,0,0,11776,1,2077141819
416,3011159,20739396,23750555,5,0,1,8704,12,1615949298
417,3012979,20737922,23750901,5,0,1,512,12,3567587543
418,3024800,5805104,8829904,5,0,0,12800,12,3588785731
419,3041580,3553882,6595462,4,0,0,36864,7,8912128406
420,3042910,2154245,5197155,3,0,0,35328,18,9245873310
421,3043250,1211836,4255086,7,0,0,7168,1,6619253388
422,3044280,3263864,6308144,4,0,0,24064,7,1962534056
423,3049640,1096118,4145758,2,0,0,512,1,2549952533
424,3050620,8654599,11705219,9,0,0,8192,4,5980697621
425,3053060,2638198,5691258,3,0,0,24064,18,1225273961
426,3054100,20699387,23753487,7,0,1,4096,1,5390919761
427,3088330,20665721,23754051,7,0,1,10752,1,2811721047
428,3095470,2118350,5213820,8,0,0,1536,11,8273693098
429,3103820,2739036,5842856,3,0,0,10240,18,2924827960
430,3127430,21019131,24146561,7,0,1,12288,1,1930124179
431,3128620,7142451,10271071,4,0,0,52736,7,10203849226
432,3137080,9113445,12250525,0,0,0,62976,6,837730725
433,3162780,860547,4023327,3,0,0,3072,18,6094166587
434,3168000,21187162,24355162,0,0,1,26112,6,9329566607
435,3177540,5648441,8825981,2,0,0,33792,1,9015416151
436,3195950,8148033,11343983,0,0,0,236544,6,5357737617
437,3204860,8916938,12121798,5,0,0,21504,12,1789232664
438,3234400,4301487,7535887,6,0,0,57856,12,9904704535
439,3251980,3789865,7041845,3,0,0,152064,18,3461413707
440,3284790,21087789,24372579,1,0,1,2560,1,2074181120
441,3287431,21085171,24372602,9,0,1,1024,4,1349949304
442,3287900,2410705,5698605,9,0,0,24064,4,220244030
443,3296510,3189011,6485521,6,0,0,12288,12,4520756549
444,3297630,3697860,6995490,5,0,0,63488,12,3963485213
445,3305181,21070431,24375612,8,0,1,4096,11,2115403243
446,3324180,3810893,7135073,0,0,0,8704,6,9277622853
447,3324320,3989608,7313928,5,0,0,46592,12,1699666673
448,3327530,5890947,9218477,0,0,0,52736,6,5051297570
449,3338340,2837628,6175968,2,0,0,33792,1,6957399694
450,3340430,2180677,5521107,9,0,0,18944,4,3975856283
451,3341000,2036300,5377300,0,0,0,15360,6,730087261
452,3342260,2937105,6279365,7,0,0,16384,1,6498122918
453,3361341,21065250,24426591,9,0,1,7168,4,10519480456
454,3366300,5569739,8936039,7,0,0,10752,1,1273530765
455,3371579,21055035,24426614,5,0,1,2560,12,6098658949
456,3380390,3508230,6888620,6,0,0,16896,12,1032262058
457,3381390,21045247,24426637,4,0,1,9216,7,10231301743
458,3387750,21038910,24426660,6,0,1,512,12,9308708185
459,3397200,4792879,8190079,2,0,0,36352,1,7392313219
460,3398000,21028683,24426683,0,0,1,3072,6,2221194780
461,3399440,3776926,7176366,5,0,0,18432,12,1510862621
462,3403220,288544,3691764,3,0,0,512,18,7914756512
463,3414910,5732004,9146914,6,0,0,9728,12,3384588950
464,3421340,21005366,24426706,6,0,1,1024,12,4385819894
465,3428500,21031204,24459704,6,0,1,29696,12,4049694655
466,3439950,21131331,24571281,1,0,1,25088,1,609074611
467,3441461,21319352,24760813,9,0,1,6656,4,3218704883
468,3473440,21288858,24762298,4,0,1,15360,7,3088790386
469,3476100,4202603,7678703,2,0,0,53760,1,103124669
470,3484380,5890954,9375334,3,0,0,86528,18,10667922909
471,3514160,21355402,24869562,7,0,1,1536,1,4611941596
472,3518580,21351853,24870433,7,0,1,12288,1,7711600149
473,3519470,21352602,24872072,1,0,1,24064,1,4987855653
474,3520100,9011188,12531288,0,0,0,29696,6,1210950130
475,3523330,4572481,8095811,2,0,0,54272,1,7863999238
476,3527110,4322750,7849860,8,0,0,69120,11,3974685110
477,3550780,6280045,9830825,7,0,0,23552,1,397715914
478,3584170,2288015,5872185,6,0,0,72192,12,2953949091
479,3605491,21282206,24887697,8,0,1,5120,11,7968837705
480,3622360,2570494,6192854,7,0,0,27648,1,6854068908
481,3624120,3613018,7237138,0,0,0,27136,6,3220053372
482,3627160,2666758,6293918,3,0,0,512,18,9325374143
483,3630200,4622369,8252569,4,0,0,29184,7,10233241541
484,3643250,651934,4295184,3,0,0,12800,18,5902859844
485,3659110,21230853,24889963,4,0,1,3584,7,4285147594
486,3661610,9151051,12812661,7,0,0,132096,1,5310445573
487,3670500,2013411,5683911,7,0,0,28672,1,4667568681
488,3674010,1775251,5449261,5,0,0,14336,12,1319790584
489,3676190,4618786,8294976,9,0,0,5120,4,201805846
490,3680500,3919791,7600291,4,0,0,18432,7,1965735462
491,3685320,4791907,8477227,4,0,0,74752,7,5894166744
492,3688220,2564358,6252578,2,0,0,35840,1,2824918279
493,3691950,4627459,8319409,7,0,0,61440,1,9193426025
494,3711640,21272680,24984320,4,0,1,19456,7,3193405928
495,3734090,21250253,24984343,6,0,1,5120,12,2599153109
496,3735080,3833584,7568664,3,0,0,16896,18,5907180168
497,3736690,9582882,13319572,3,0,0,1536,18,5991005189
498,3776340,6302356,10078696,4,0,0,4608,7,8699681101
499,3776400,4483562,8259962,3,0,0,10240,18,9132645665
500,3785590,4939612,8725202,2,0,0,45568,1,6814664391
501,3792510,4595274,8387784,9,0,0,2048,4,3249642776
502,3816720,22199509,26016229,7,0,1,31744,1,8760923649
503,3836890,9314112,13151002,0,0,0,65024,6,7363808421
504,3841701,22174551,26016252,9,0,1,27648,4,2332486779
505,3850870,6044138,9895008,9,0,0,13824,4,5773090633
506,3863040,22153235,26016275,2,0,1,4608,1,3394424963
507,3865310,3609075,7474385,3,0,0,83456,18,2032746455
508,3877520,2107327,5984847,3,0,0,20992,18,10135025007
509,3906720,22441523,26348243,4,0,1,512,7,1797391067
510,3907640,4171612,8079252,2,0,0,24064,1,4040467775
511,3920500,9588162,13508662,7,0,0,61440,1,10294769379
512,3946330,2135759,6082089,8,0,0,16384,11,4059579984
513,3958810,6114536,10073346,9,0,0,7168,4,1187813856
514,3970170,6498211,10468381,7,0,0,125440,1,8979239031
515,3975780,4096117,8071897,3,0,0,20992,18,6184680340
516,3985920,4359743,8345663,7,0,0,73728,1,1317842677
517,3987180,3912596,7899776,0,0,0,6144,6,7865706035
518,3988860,22363017,26351877,4,0,1,13312,7,9704595703
519,3988970,4923832,8912802,9,0,0,19968,4,1830577902
520,4012300,3230945,7243245,7,0,0,19968,1,8112019108
521,4019380,3878501,7897881,0,0,0,43008,6,7095895339
522,4053110,22298790,26351900,4,0,1,2048,7,1083405505
523,4060300,23135954,27196254,7,0,1,23040,1,10607242228
524,4072730,6459726,10532456,2,0,0,69120,1,4096970443
525,4115020,23082434,27197454,1,0,1,2048,1,6703774173
526,4116620,23081398,27198018,6,0,1,10752,12,5765353868
527,4133220,2812655,6945875,1,0,0,5120,1,8539684290
528,4136550,6153443,10289993,7,0,0,32768,1,28104964
529,4141150,4138089,8279239,3,0,0,45056,18,4180152324
530,4141230,5408597,9549827,4,0,0,50176,7,7725654455
531,4148180,3072939,7221119,0,0,0,12800,6,3838818589
532,4154340,5736433,9890773,8,0,0,50688,11,5264875765
533,4159990,3010721,7170711,7,0,0,16896,1,4732579175
534,4176500,6930911,11107411,4,0,0,51712,7,10068978221
535,4178180,4708135,8886315,7,0,0,25600,1,4784855130
536,4187780,23139953,27327733,1,0,1,12288,1,8983819829
537,4195120,6721588,10916708,8,0,0,19968,11,2405444192
538,4200020,2146641,6346661,7,0,0,20480,1,2365187285
539,4201050,2166429,6367479,9,0,0,9216,4,2655315301
540,4201880,3626821,7828701,2,0,0,4096,1,919212745
541,4212290,23131112,27343402,2,0,1,7680,1,532837977
542,4214850,2320498,6535348,5,0,0,11776,12,8958071842
543,4220760,1995720,6216480,0,0,0,2048,6,2327457963
544,4232430,4265591,8498021,8,0,0,52736,11,5711462400
545,4237341,23106084,27343425,9,0,1,7168,4,355501522
546,4260300,23085645,27345945,2,0,1,30720,1,1990966997
547,4269680,4306777,8576457,0,0,0,22528,6,9751783642
548,4282700,3151607,7434307,4,0,0,4608,7,6333992137
549,4283110,4405317,8688427,8,0,0,2560,11,508153420
550,4290880,2589200,6880080,8,0,0,58880,11,4403579452
551,4298580,4225213,8523793,8,0,0,75264,11,5422614854
552,4316490,2730869,7047359,3,0,0,11264,18,6022351350
553,4324920,4420920,8745840,3,0,0,14848,18,6837520332
554,4332300,9328636,13660936,7,0,0,512,1,3887840020
555,4343810,7025670,11369480,2,0,0,16896,1,2516050520
556,4353580,5818133,10171713,4,0,0,36864,7,837233360
557,4365490,1649367,6014857,9,0,0,11776,4,6397023924
558,4368860,6113584,10482444,3,0,0,46080,18,3671668667
559,4370430,5634031,10004461,8,0,0,37376,11,2458130932
560,4384170,9818762,14202932,2,0,0,69632,1,7267365112
561,4399310,4449973,8849283,9,0,0,26624,4,3593017745
562,4409690,4122238,8531928,7,0,0,26624,1,5266960676
563,4419960,5187066,9607026,3,0,0,29184,18,3130421220
564,4426990,2933803,7360793,8,0,0,18944,11,4297990503
565,4430160,23479751,27909911,0,0,1,11264,6,1991373620
566,4432770,23509998,27942768,4,0,1,5632,7,9245388940
567,4474490,4592216,9066706,6,0,0,8704,12,2191383042
568,4479420,9495130,13974550,6,0,0,50688,12,4666952665
569,4487400,5687768,10175168,8,0,0,11264,11,5285001014
570,4487770,1033672,5521442,3,0,0,1024,18,5205446752
571,4489119,23461570,27950689,5,0,1,16896,12,7245988332
572,4489210,2068134,6557344,2,0,0,18432,1,7629438768
573,4498240,4661177,9159417,3,0,0,40960,18,3010473342
574,4514540,5392175,9906715,3,0,0,6144,18,7941297219
575,4536910,5574155,10111065,7,0,0,51712,1,4274060179
576,4552739,23397973,27950712,5,0,1,2560,12,2519094010
577,4560510,5810631,10371141,7,0,0,15872,1,4409631711
578,4590851,23361972,27952823,9,0,1,4096,4,6307270429
579,4597340,6373873,10971213,9,0,0,51200,4,8247493991
580,4607170,5246011,9853181,7,0,0,41472,1,7885179031
581,4611590,3711586,8323176,7,0,0,12288,1,5460598669
582,4615500,4630300,9245800,4,0,0,89600,7,10162775288
583,4615520,3500100,8115620,9,0,0,26624,4,6692571391
584,4617250,3594012,8211262,3,0,0,62464,18,1821344817
585,4651630,23480129,28131759,0,0,1,4608,6,1351290012
586,4660160,2249344,6909504,2,0,0,44544,1,2976285993
587,4664240,23467775,28132015,0,0,1,9216,6,10400714477
588,4682460,9797039,14479499,5,0,0,56320,12,8252216785
589,4687790,6901129,11588919,7,0,0,3584,1,6938831933
590,4702280,3206730,7909010,8,0,0,2560,11,5378771963
591,4706190,1725260,6431450,2,0,0,9216,1,3380279448
592,4712310,4632870,9345180,4,0,0,129024,7,5996714806
593,4737900,4947170,9685070,4,0,0,5632,7,5390021333
594,4750430,5835337,10585767,8,0,0,44544,11,7527488997
595,4764010,23436262,28200272,0,0,1,18944,6,4605840466
596,4767910,3474943,8242853,2,0,0,9216,1,2656753506
597,4778400,5616045,10394445,9,0,0,72192,4,6585989369
598,4778710,5360874,10139584,0,0,0,14848,6,2783659849
599,4779980,3568982,8348962,7,0,0,10752,1,3955553529
600,4782070,4974500,9756570,3,0,0,3584,18,7864664194
601,4793290,23407005,28200295,7,0,1,2048,1,5045174115
602,4812300,2986503,7798803,9,0,0,2560,4,5134155434
603,4844230,5711360,10555590,3,0,0,58368,18,1663597802
604,4844760,5137183,9981943,8,0,0,31232,11,303075156
605,4872670,23355123,28227793,2,0,1,4608,1,2998408118
606,4874200,2788100,7662300,9,0,0,33280,4,4288645667
607,4875711,23727064,28602775,2,0,1,30720,1,4518701507
608,4878700,4804631,9683331,2,0,0,52736,1,3878642133
609,4882880,6550637,11433517,9,0,0,19968,4,1156558131
610,4919421,23683377,28602798,2,0,1,1024,1,3486169887
611,4925710,4672401,9598111,2,0,0,78848,1,6825450768
612,4931590,3652409,8583999,3,0,0,13824,18,742839978
613,4932650,6338747,11271397,7,0,0,355328,1,7001143334
614,4959560,9735980,14695540,7,0,0,61952,1,2354510564
615,4973620,1704336,6677956,9,0,0,2048,4,2161997680
616,4973650,3866695,8840345,3,0,0,33280,18,6992332167
617,5016661,23586160,28602821,9,0,1,1024,4,702082553
618,5017480,6753906,11771386,3,0,0,217088,18,5420013048
619,5025480,6451653,11477133,9,0,0,9728,4,9041825144
620,5029850,1385995,6415845,3,0,0,1024,18,7142725522
621,5041351,23561493,28602844,8,0,1,4096,11,5149906699
622,5043580,5857482,10901062,3,0,0,84992,18,5900185821
623,5046140,4401268,9447408,2,0,0,69120,1,6229117588
624,5062160,1615157,6677317,2,0,0,12288,1,6545408663
625,5066030,5471753,10537783,7,0,0,17408,1,10218775504
626,5085570,6770647,11856217,8,0,0,62464,11,5216104282
627,5088450,6742917,11831367,7,0,0,19968,1,1315182963
628,5103580,1335214,6438794,4,0,0,3072,7,1496036261
629,5111000,3790516,8901516,9,0,0,5632,4,9281983321
630,5119689,23565808,28685497,5,0,1,26112,12,5672407977
631,5126680,1933330,7060010,9,0,0,41472,4,4831168668
632,5136360,6455078,11591438,2,0,0,8192,1,7076893146
633,5146210,2951340,8097550,8,0,0,5632,11,10161306731
634,5146250,2998608,8144858,9,0,0,30720,4,4011932218
635,5153030,23649805,28802835,1,0,1,4096,1,9386688707
636,5160300,4929963,10090263,9,0,0,37888,4,3990090298
637,5165790,1114214,6280004,3,0,0,2048,18,2499891286
638,5187711,23615147,28802858,8,0,1,9216,11,8778359540
639,5209020,3578461,8787481,5,0,0,1024,12,4276215747
640,5215930,6791196,12007126,2,0,0,59904,1,10207946642
641,5216270,5135173,10351443,3,0,0,45056,18,9401350332
642,5220290,6401862,11622152,9,0,0,42496,4,50679050
643,5224920,6807859,12032779,8,0,0,38912,11,6942192660
644,5225890,1684121,6910011,3,0,0,1536,18,5675466179
645,5228520,23923589,29152109,1,0,1,9216,1,6620214364
646,5240090,2720536,7960626,4,0,0,33280,7,9808588816
647,5247420,5324752,10572172,2,0,0,25088,1,9169657415
648,5250100,8975062,14225162,7,0,0,33792,1,1895764499
649,5260911,23963252,29224163,9,0,1,12288,4,3271936837
650,5264490,6560770,11825260,4,0,0,24064,7,3671035641
651,5279730,6835493,12115223,8,0,0,113152,11,10181735942
652,5290480,5584663,10875143,5,0,0,64512,12,1611833437
653,5294400,3546748,8841148,8,0,0,2560,11,10110999842
654,5297270,1540979,6838249,4,0,0,4608,7,6362994302
655,5300229,24045811,29346040,5,0,1,1024,12,611515828
656,5313410,4810158,10123568,6,0,0,40960,12,7418319400
657,5313921,24032142,29346063,8,0,1,7168,11,887355364
658,5317130,4433622,9750752,2,0,0,83456,1,3179486392
659,5317830,6573891,11891721,7,0,0,39424,1,7696119823
660,5321360,6900860,12222220,7,0,0,39936,1,6730251281
661,5338290,3014306,8352596,9,0,0,2560,4,772168569
662,5339870,1796310,7136180,5,0,0,3584,12,4271557094
663,5349710,3204549,8554259,2,0,0,73216,1,1630357370
664,5352211,24001698,29353909,9,0,1,9216,4,5321222743
665,5356570,6250069,11606639,8,0,0,32768,11,8262907562
666,5359690,6458215,11817905,8,0,0,152576,11,5129736056
667,5364530,1437361,6801891,2,0,0,12800,1,9019446619
668,5368330,2314591,7682921,4,0,0,10240,7,10079301972
669,5377441,24109238,29486679,9,0,1,46592,4,8305844102
670,5384610,9532000,14916610,3,0,0,95744,18,10622598851
671,5404530,3185108,8589638,3,0,0,18432,18,5119604359
672,5407840,3333453,8741293,5,0,0,52736,12,9627352731
673,5432100,4436235,9868335,3,0,0,13824,18,5327111522
674,5480040,24020437,29500477,6,0,1,15360,12,3897464075
675,5501380,5590252,11091632,4,0,0,53760,7,6640245619
676,5504630,2057859,7562489,5,0,0,4096,12,927688345
677,5509980,4842266,10352246,5,0,0,2560,12,6211975456
678,5529280,5944866,11474146,5,0,0,9728,12,8596607547
679,5534010,3157404,8691414,3,0,0,9728,18,65596001
680,5535470,1144709,6680179,8,0,0,7168,11,5949283746
681,5543760,3243386,8787146,2,0,0,87552,1,4997571026
682,5547000,9505228,15052228,3,0,0,20480,18,2696141595
683,5562590,2585411,8148001,5,0,0,10240,12,7618612092
684,5563850,3946565,9510415,8,0,0,4096,11,1394571872
685,5571710,24006391,29578101,6,0,1,6656,12,2940997598
686,5580550,4488850,10069400,3,0,0,118784,18,1006264207
687,5586820,4606646,10193466,2,0,0,14848,1,5039926346
688,5589170,1576266,7165436,8,0,0,7680,11,10674023804
689,5611391,23966733,29578124,2,0,1,6144,1,5198261756
690,5621360,2545453,8166813,4,0,0,30720,7,908649360
691,5628270,3766165,9394435,6,0,0,40448,12,3085348278
692,5631000,6690938,12321938,4,0,0,6656,7,9119922515
693,5662170,3436156,9098326,2,0,0,7680,1,3102612913
694,5676780,1051369,6728149,4,0,0,11264,7,9492028541
695,5678549,23899598,29578147,5,0,1,1024,12,3370704219
696,5680670,2760991,8441661,8,0,0,10752,11,5120657348
697,5690030,4107846,9797876,5,0,0,76800,12,1779849180
698,5719190,23858980,29578170,2,0,1,11776,1,4337286495
699,5719530,5199853,10919383,4,0,0,8704,7,6915230752
700,5719889,23877850,29597739,5,0,1,512,12,5073626742
701,5728010,753133,6481143,8,0,0,9216,11,2478141027
702,5733270,2560123,8293393,6,0,0,22016,12,8395268044
703,5737410,23860352,29597762,2,0,1,10752,1,5132071730
704,5742980,3924260,9667240,6,0,0,20992,12,7759879546
705,5745150,6773144,12518294,4,0,0,58880,7,8600591613
706,5747720,3752516,9500236,6,0,0,11776,12,2796032742
707,5755240,1048642,6803882,4,0,0,2048,7,3437424563
708,5759949,23837836,29597785,5,0,1,4608,12,2447338544
709,5769390,4433482,10202872,7,0,0,15872,1,3954088010
710,5781060,3974395,9755455,3,0,0,15360,18,6537210026
711,5786540,2793216,8579756,8,0,0,10752,11,5352554896
712,5802780,2584357,8387137,8,0,0,5632,11,10046174574
713,5812390,1445603,7257993,3,0,0,6656,18,6804983620
714,5813570,3683047,9496617,2,0,0,51200,1,7465838711
715,5840610,5234619,11075229,2,0,0,33280,1,2451317479
716,5886320,3564699,9451019,3,0,0,11776,18,1358050728
717,5888850,23708966,29597816,7,0,1,6144,1,4047384736
718,5890061,23707778,29597839,9,0,1,8704,4,1052454221
719,5899180,6241213,12140393,4,0,0,60928,7,1745899754
720,5911770,4343210,10254980,4,0,0,28672,7,1497689216
721,5912940,5358948,11271888,5,0,0,1536,12,8442633695
722,5917340,1938643,7855983,4,0,0,19968,7,6647992711
723,5918540,23788233,29706773,1,0,1,7168,1,3394851412
724,5921130,1680292,7601422,0,0,0,3584,6,1714860163
725,5935161,23771635,29706796,9,0,1,3072,4,10388881205
726,5944920,23775696,29720616,4,0,1,26624,7,119751607
727,5957270,5460913,11418183,5,0,0,159744,12,9222379409
728,5984030,5702604,11686634,6,0,0,15872,12,1871081004
729,5986871,23916011,29902882,8,0,1,67584,11,3410831374
730,5995770,6261338,12257108,3,0,0,21504,18,2468700784
731,5996340,2863449,8859789,6,0,0,11776,12,7840061050
732,5998300,5933005,11931305,2,0,0,64000,1,6030115103
733,6010530,3236073,9246603,1,0,0,2560,1,7231421231
734,6011980,6192512,12204492,4,0,0,29696,7,4543963321
735,6022220,4733279,10755499,8,0,0,28160,11,1898574167
736,6043849,24267973,30311822,5,0,1,38400,12,431924418
737,6076440,2878046,8954486,8,0,0,7680,11,1072045226
738,6092470,5449838,11542308,2,0,0,36864,1,9140976764
739,6101290,2957628,9058918,0,0,0,1024,6,2209618067
740,6110760,24202547,30313307,6,0,1,15360,12,7242261053
741,6116700,2235093,8351793,5,0,0,9216,12,5142544817
742,6147450,3124083,9271533,4,0,0,10240,7,4138296499
743,6151740,5727946,11879686,4,0,0,44032,7,1115471248
744,6165880,24274565,30440445,1,0,1,32768,1,2831306370
745,6201341,24345790,30547131,9,0,1,33792,4,2296186125
746,6205010,2502568,8707578,2,0,0,7168,1,7580891832
747,6206880,24340274,30547154,0,0,1,1024,6,1054600041
748,6209250,6140845,12350095,7,0,0,48128,1,7832203368
749,6218000,6040847,12258847,3,0,0,5632,18,9130500697
750,6231650,5963771,12195421,8,0,0,53248,11,9383287361
751,6241250,5595912,11837162,8,0,0,18944,11,458021056
752,6252880,2667527,8920407,6,0,0,21504,12,4997376186
753,6253520,4339954,10593474,6,0,0,25088,12,10048803661
754,6257110,4162653,10419763,2,0,0,14848,1,10439491631
755,6258410,4156806,10415216,7,0,0,68096,1,151334011
756,6288810,4213336,10502146,3,0,0,38400,18,4815411844
757,6303581,24341632,30645213,9,0,1,27136,4,3462957658
758,6310100,24386739,30696839,7,0,1,13824,1,2891485552
759,6315490,5261340,11576830,3,0,0,59392,18,10113173154
760,6317480,2164450,8481930,5,0,0,15360,12,2962756803
761,6322050,6112607,12434657,8,0,0,121856,11,4683560042
762,6326480,6354056,12680536,2,0,0,5120,1,4831762265
763,6329870,3379677,9709547,5,0,0,9216,12,6346401390
764,6330960,4276733,10607693,5,0,0,46592,12,970519545
765,6336120,4468926,10805046,6,0,0,60416,12,3826756746
766,6358690,4493601,10852291,4,0,0,32256,7,6247825936
767,6381730,25084682,31466412,4,0,1,16384,7,10499560143
768,6381880,25198147,31580027,6,0,1,4608,12,6183567937
769,6394840,3676299,10071139,2,0,0,5632,1,5402997248
770,6397070,2237423,8634493,4,0,0,30208,7,4150658497
771,6411890,2986959,9398849,4,0,0,4096,7,5303030021
772,6426040,25429024,31855064,7,0,1,41472,1,5715040401
773,6440851,25434897,31875748,8,0,1,16896,11,6727375268
774,6462230,6306393,12768623,2,0,0,45568,1,9498283695
775,6467490,2706807,9174297,2,0,0,11776,1,10149493977
776,6479850,4084655,10564505,5,0,0,29184,12,5385646175
777,6483820,2126822,8610642,2,0,0,15360,1,3836740896
778,6487510,5491178,11978688,5,0,0,29184,12,9989653307
779,6489660,25395338,31884998,1,0,1,7680,1,6493182729
780,6504600,3698451,10203051,4,0,0,512,7,7956964980
781,6507429,25541939,32049368,5,0,1,14848,12,2503529893
782,6509310,3615529,10124839,8,0,0,4096,11,1716081717
783,6518240,2442703,8960943,7,0,0,18432,1,10289208544
784,6524150,5943157,12467307,2,0,0,77312,1,8794188248
785,6552571,25554648,32107219,8,0,1,36352,11,6063694642
786,6559040,3081314,9640354,2,0,0,17920,1,3930239186
787,6579060,3911363,10490423,2,0,0,26112,1,7873985958
788,6584199,25660998,32245197,5,0,1,9216,12,8123660994
789,6585350,25700944,32286294,6,0,1,12800,12,2129579017
790,6588480,25752763,32341243,6,0,1,22016,12,5631841671
791,6590030,25752203,32342233,4,0,1,4096,7,2801745795
792,6603470,25738786,32342256,1,0,1,3584,1,8614676244
793,6621240,2066384,8687624,1,0,0,3584,1,7314405908
794,6629661,25816243,32445904,8,0,1,512,11,8200157556
795,6639170,1589631,8228801,8,0,0,34304,11,85036117
796,6643770,3433499,10077269,2,0,0,12800,1,10448863886
797,6645220,4865632,11510852,6,0,0,110592,12,10474156227
798,6658230,5913499,12571729,7,0,0,111104,1,5989336764
799,6667800,5394712,12062512,7,0,0,37376,1,4906916774
800,6668960,4113412,10782372,7,0,0,14848,1,352512783
801,6671870,25776300,32448170,4,0,1,3584,7,5249116885
802,6672460,4306888,10979348,6,0,0,26624,12,591265616
803,6706280,6344695,13050975,7,0,0,34816,1,9633307352
804,6726430,4738622,11465052,1,0,0,103424,1,8337368907
805,6733320,6468607,13201927,1,0,0,96256,1,842370282
806,6735060,3889590,10624650,3,0,0,512,18,5989635849
807,6753630,3492591,10246221,8,0,0,39424,11,2569448610
808,6753710,25763671,32517381,4,0,1,3072,7,6186442059
809,6760240,4921535,11681775,6,0,0,195584,12,5388182866
810,6772920,6233804,13006724,4,0,0,71680,7,9624028418
811,6773010,6540137,13313147,3,0,0,14848,18,905509622
812,6773360,4814444,11587804,5,0,0,27648,12,6908766132
813,6778070,5800234,12578304,5,0,0,21504,12,4854608963
814,6778810,6076125,12854935,1,0,0,60928,1,5971654536
815,6788710,3204332,9993042,5,0,0,36352,12,6447661753
816,6795770,1565258,8361028,6,0,0,23552,12,1816866728
817,6811360,25707627,32518987,2,0,1,16384,1,7830310859
818,6817000,1350148,8167148,1,0,0,1024,1,7939392150
819,6819910,3472798,10292708,8,0,0,8704,11,482175208
820,6823260,6108166,12931426,4,0,0,10752,7,3454719555
821,6825010,5757841,12582851,5,0,0,14848,12,3142225753
822,6831110,6616079,13447189,2,0,0,38400,1,4046127975
823,6848710,2908507,9757217,6,0,0,2048,12,8766437315
824,6849120,3357953,10207073,7,0,0,2048,1,7249870430
825,6860290,2643401,9503691,3,0,0,11264,18,10579037854
826,6862680,26004170,32866850,4,0,1,31232,7,8803332345
827,6867480,5887236,12754716,5,0,0,54272,12,8312986152
828,6867830,2158749,9026579,4,0,0,34816,7,9333032005
829,6868111,26201666,33069777,8,0,1,43008,11,9264573786
830,6880770,6291806,13172576,3,0,0,17920,18,1594104096
831,6881950,2494967,9376917,3,0,0,5120,18,6360172198
832,6885370,26244107,33129477,4,0,1,9728,7,277340950
833,6917760,1938418,8856178,2,0,0,22528,1,10714397002
834,6931610,6444353,13375963,1,0,0,31232,1,6917819828
835,6959850,4554933,11514783,3,0,0,12800,18,3824730991
836,6962690,2139247,9101937,4,0,0,11776,7,4542432885
837,6963800,4092648,11056448,6,0,0,44032,12,3008168961
838,6969900,4971412,11941312,6,0,0,32768,12,7128536965
839,6976400,4935382,11911782,7,0,0,12288,1,2828789239
840,6995721,26133779,33129500,8,0,1,10752,11,2315821436
841,7009570,1749717,8759287,1,0,0,5120,1,4810933723
842,7012860,6916157,13929017,1,0,0,5120,1,2319759981
843,7027260,2607603,9634863,2,0,0,16384,1,6886406974
844,7031010,26238783,33269793,6,0,1,39936,12,5009422869
845,7036300,4666400,11702700,3,0,0,14336,18,1827703618
846,7048520,2254421,9302941,8,0,0,19968,11,2092126540
847,7054320,6213688,13268008,3,0,0,111104,18,9376031302
848,7055200,8377699,15432899,5,0,0,501248,12,7567624094
849,7058080,5277328,12335408,2,0,0,35840,1,10001779153
850,7065450,8459159,15524609,1,0,0,9216,1,2749287171
851,7069931,26199885,33269816,8,0,1,6144,11,7095113798
852,7073540,5321097,12394637,3,0,0,68096,18,2801365410
853,7074390,1984193,9058583,7,0,0,13824,1,8524688474
854,7077560,5277082,12354642,4,0,0,14848,7,8259006935
855,7086560,6343454,13430014,3,0,0,61952,18,6612299052
856,7094220,6025346,13119566,7,0,0,52736,1,4796472600
857,7106890,6814195,13921085,3,0,0,6656,18,4572266738
858,7123330,4948120,12071450,5,0,0,26112,12,6517852929
859,7128010,4480368,11608378,9,0,0,5632,4,3480069067
860,7131280,5312448,12443728,9,0,0,29696,4,10254351822
861,7131920,4856931,11988851,7,0,0,33280,1,6108124962
862,7135070,26136976,33272046,0,0,1,512,6,1849451093
863,7137871,26134198,33272069,9,0,1,8192,4,2757474809
864,7139400,26150393,33289793,6,0,1,7680,12,2101454067
865,7146720,2427344,9574064,7,0,0,19968,1,1782111277
866,7147490,4903603,12051093,5,0,0,44544,12,2132327457
867,7147580,4803450,11951030,5,0,0,15360,12,4367067892
868,7153510,4710998,11864508,1,0,0,27136,1,4164970971
869,7153910,6583531,13737441,2,0,0,110592,1,896161981
870,7156400,4452781,11609181,5,0,0,2560,12,6571495943
871,7156440,8276950,15433390,4,0,0,1536,7,1172646410
872,7168910,5331413,12500323,5,0,0,75776,12,4244142478
873,7180210,4184099,11364309,8,0,0,2560,11,8989792537
874,7190280,7210475,14400755,9,0,0,13312,4,7575486924
875,7192070,3087916,10279986,4,0,0,29184,7,8278956969
876,7193530,8768256,15961786,2,0,0,35840,1,1545595392
877,7193881,26096066,33289947,8,0,1,8704,11,8336201028
878,7234760,3276613,10511373,2,0,0,30208,1,3418522984
879,7252861,26131442,33384303,9,0,1,5120,4,10295949980
880,7255640,6367280,13622920,5,0,0,31744,12,7481804783
881,7276851,26334243,33611094,2,0,1,31744,1,849848595
882,7277270,5458368,12735638,8,0,0,115712,11,5941960109
883,7278461,26601026,33879487,8,0,1,2560,11,744804176
884,7286550,5187831,12474381,8,0,0,17408,11,5191343324
885,7330020,2765266,10095286,7,0,0,16384,1,5632648111
886,7343000,4354654,11697654,1,0,0,26624,1,10406458745
887,7343040,5017420,12360460,5,0,0,16896,12,2151889285
888,7345441,26534069,33879510,9,0,1,5632,4,3888104064
889,7348080,8272840,15620920,5,0,0,66048,12,1350838792
890,7353220,2835699,10188919,8,0,0,45056,11,2058669375
891,7356980,7164066,14521046,1,0,0,25088,1,1133504178
892,7358360,3797707,11156067,8,0,0,32256,11,8774265219
893,7370150,5402240,12772390,3,0,0,12288,18,9182922442
894,7371790,4792993,12164783,5,0,0,35328,12,3212984975
895,7383530,5201068,12584598,8,0,0,5632,11,2586828579
896,7386780,5431052,12817832,4,0,0,16896,7,5843613401
897,7388790,26490743,33879533,2,0,1,512,1,9482178065
898,7399340,4609837,12009177,5,0,0,6656,12,6895613431
899,7413810,4013600,11427410,1,0,0,30208,1,10081294584
900,7427620,5496124,12923744,9,0,0,27136,4,3802168756
901,7428950,1968628,9397578,2,0,0,10240,1,8996825647
902,7433150,8820476,16253626,5,0,0,90112,12,2372209373
903,7435630,4771381,12207011,9,0,0,8192,4,10186819414
904,7438580,6896878,14335458,9,0,0,60928,4,888783241
905,7439179,26440377,33879556,5,0,1,24064,12,9945978906
906,7450250,4129107,11579357,3,0,0,8192,18,5202034033
907,7468930,5846461,13315391,2,0,0,2048,1,2362839004
908,7479759,26448249,33928008,5,0,1,1024,12,5757917644
909,7483870,4670126,12153996,1,0,0,44544,1,9188239821
910,7486100,7365623,14851723,7,0,0,104448,1,5626684649
911,7486500,4777206,12263706,5,0,0,15872,12,5438922869
912,7488930,7479416,14968346,3,0,0,55808,18,9675470007
913,7489970,4796269,12286239,2,0,0,7680,1,4392057166
914,7503660,5162338,12665998,9,0,0,22528,4,9131212004
915,7513671,26456370,33970041,8,0,1,4608,11,7723712609
916,7517850,4786539,12304389,3,0,0,58880,18,9707827882
917,7520360,8163543,15683903,8,0,0,24064,11,1795957242
918,7522990,6312146,13835136,3,0,0,4096,18,6306718768
919,7525800,3421168,10946968,7,0,0,10240,1,4940286878
920,7525970,5379522,12905492,2,0,0,36864,1,9823409140
921,7533360,4530111,12063471,5,0,0,3072,12,2764211953
922,7537830,4984387,12522217,7,0,0,12800,1,8133172614
923,7546090,26423974,33970064,7,0,1,2560,1,4310630392
924,7575130,5979858,13554988,2,0,0,42496,1,2105242200
925,7595320,3921982,11517302,2,0,0,8192,1,7098834715
926,7595510,6533337,14128847,4,0,0,95232,7,350133559
927,7597081,26374745,33971826,8,0,1,5632,11,8611505733
928,7614800,8093485,15708285,1,0,0,22528,1,5958898489
929,7617110,26356322,33973432,7,0,1,2560,1,8642705333
930,7621510,3002961,10624471,4,0,0,7680,7,8489633589
931,7622660,1985325,9607985,7,0,0,3072,1,8795222143
932,7626150,26347305,33973455,1,0,1,10752,1,5171943813
933,7643740,4428201,12071941,5,0,0,1536,12,3967903223
934,7651200,2576224,10227424,2,0,0,10752,1,8121095992
935,7653570,4571325,12224895,3,0,0,8704,18,5540401339
936,7655270,5181070,12836340,1,0,0,16384,1,7231736550
937,7656060,6288256,13944316,4,0,0,17408,7,577845541
938,7665540,1222046,8887586,4,0,0,4096,7,3212085405
939,7672910,4193337,11866247,9,0,0,5632,4,843915152
940,7689960,2675569,10365529,2,0,0,43520,1,5103904903
941,7709130,3654376,11363506,3,0,0,64000,18,819579793
942,7721291,26263598,33984889,8,0,1,8704,11,546102152
943,7732180,1616767,9348947,2,0,0,12288,1,2524489896
944,7740561,26244351,33984912,8,0,1,2560,11,6863033075
945,7746390,7229521,14975911,1,0,0,1024,1,2011261536
946,7746620,6520496,14267116,8,0,0,36352,11,3012607505
947,7760070,6556801,14316871,5,0,0,18432,12,218057033
948,7774440,26289202,34063642,1,0,1,14848,1,6923306088
949,7802590,8203725,16006315,7,0,0,23040,1,7460473106
950,7805790,7754612,15560402,7,0,0,77312,1,6612800501
951,7805850,5997306,13803156,2,0,0,38400,1,9091111692
952,7818540,5153743,12972283,7,0,0,6656,1,8098475491
953,7830930,2364119,10195049,4,0,0,5120,7,5488104028
954,7835830,6605201,14441031,3,0,0,65536,18,3622498294
955,7846790,26216875,34063665,6,0,1,4096,12,801556410
956,7859371,26204317,34063688,2,0,1,7680,1,3584555768
957,7866310,8482509,16348819,2,0,0,27136,1,7320278269
958,7866990,3664063,11531053,8,0,0,45056,11,7890269551
959,7869350,4211358,12080708,1,0,0,28672,1,870462353
960,7878050,4951848,12829898,6,0,0,16896,12,188015815
961,7878110,3042544,10920654,2,0,0,4096,1,4575623803
962,7885620,4135280,12020900,9,0,0,38400,4,8300276695
963,7900750,5951559,13852309,5,0,0,27648,12,6497383355
964,7931710,6314246,14245956,5,0,0,30208,12,7594372633
965,7938629,26157631,34096260,5,0,1,17920,12,10586854017
966,7951460,6405626,14357086,9,0,0,6144,4,3178644035
967,7965960,4003813,11969773,3,0,0,61440,18,6608147053
968,7969430,4350457,12319887,8,0,0,35840,11,4853366129
969,7973680,6488636,14462316,9,0,0,18432,4,2760261322
970,7986490,4192676,12179166,2,0,0,47104,1,10430649378
971,7989360,4297058,12286418,7,0,0,512,1,4501781404
972,7995980,6496857,14492837,1,0,0,18944,1,1724614944
973,8001760,3112070,11113830,9,0,0,20992,4,1735274593
974,8004950,8497748,16502698,3,0,0,117760,18,4638661562
975,8009140,4522795,12531935,1,0,0,2048,1,5279347975
976,8015920,5996892,14012812,3,0,0,80896,18,5975814138
977,8046921,26072215,34119136,8,0,1,18944,11,5155798858
978,8059050,6860859,14919909,9,0,0,10752,4,956802383
979,8062980,26066240,34129220,0,0,1,7680,6,8825612289
980,8064820,26081500,34146320,8,0,1,512,11,9662179486
981,8067170,26079496,34146666,6,0,1,512,12,47195817
982,8069260,3618512,11687772,7,0,0,3584,1,10670970208
983,8096110,5762485,13858595,7,0,0,10240,1,7493811159
984,8107770,4263638,12371408,7,0,0,8704,1,4238225063
985,8124760,8434620,16559380,5,0,0,163328,12,2777859710
986,8127530,26158848,34286378,4,0,1,11776,7,1843626006
987,8128080,6213961,14342041,7,0,0,21504,1,8957412536
988,8148660,26206343,34355003,7,0,1,12288,1,8278650765
989,8164780,4451383,12616163,8,0,0,15872,11,2842160253
990,8169370,6426594,14595964,2,0,0,4096,1,6999240772
991,8192950,26203750,34396700,1,0,1,20480,1,9753911106
992,8203860,4151429,12355289,7,0,0,2048,1,6629133457
993,8216090,27346838,35562928,2,0,1,62976,1,8210740266
994,8218010,4672035,12890045,8,0,0,11264,11,8676377457
995,8233100,4235946,12469046,9,0,0,5632,4,3215912585
996,8246380,8720137,16966517,5,0,0,641024,12,6515541621
997,8250350,4916743,13167093,2,0,0,52736,1,8702661385
998,8264090,3945939,12210029,5,0,0,1024,12,5573005840
999,8267400,6851981,15119381,1,0,0,11776,1,3425997787
1000,8270480,6150560,14421040,8,0,0,57344,11,2088683324
1001,8271750,3636265,11908015,5,0,0,16896,12,6395114876
1002,8284490,3992655,12277145,2,0,0,44032,1,6707581644
1003,8284980,27277971,35562951,0,0,1,4096,6,6095242434
1004,8286670,5531797,13818467,1,0,0,50176,1,872767429
1005,8306890,2527378,10834268,4,0,0,1536,7,5704935326
1006,8307001,27255973,35562974,9,0,1,2048,4,6312036301
1007,8314620,2400153,10714773,1,0,0,55808,1,6688137925
1008,8322810,2287730,10610540,3,0,0,9216,18,7705881886
1009,8333940,27229057,35562997,7,0,1,8192,1,5580999450
1010,8337670,6270723,14608393,9,0,0,7680,4,2594724659
1011,8342700,6894568,15237268,5,0,0,77824,12,5679857409
1012,8347349,27228353,35575702,5,0,1,6656,12,8645239494
1013,8351490,27265199,35616689,0,0,1,26112,6,1428628233
1014,8352260,5992144,14344404,4,0,0,7680,7,3671968558
1015,8357600,4995171,13352771,0,0,0,10752,6,8056073405
1016,8370820,4453907,12824727,9,0,0,22528,4,712722061
1017,8376710,5978481,14355191,2,0,0,35328,1,7133675385
1018,8385570,27239144,35624714,6,0,1,30208,12,3637692719
1019,8404060,6201970,14606030,3,0,0,27136,18,4587136270
1020,8432150,5311086,13743236,3,0,0,18944,18,2602806489
1021,8435230,27198266,35633496,4,0,1,5632,7,1952380172
1022,8440360,2722750,11163110,9,0,0,23040,4,3920118871
1023,8443890,4581058,13024948,7,0,0,8192,1,5857862800
1024,8447510,8608073,17055583,9,0,0,115712,4,6621724811
1025,8462680,7034092,15496772,7,0,0,177664,1,5233788381
1026,8472290,7414038,15886328,9,0,0,82944,4,2143848412
1027,8481450,27155524,35636974,6,0,1,4608,12,2514133307
1028,8508490,7028333,15536823,5,0,0,36352,12,6785473555
1029,8510490,4700196,13210686,3,0,0,28672,18,1404763805
1030,8513500,5054459,13567959,2,0,0,42496,1,948576096
1031,8515760,27121237,35636997,6,0,1,12288,12,2067828839
1032,8516500,7562245,16078745,1,0,0,19968,1,194193104
1033,8519610,6282280,14801890,2,0,0,83968,1,2963369761
1034,8532820,5606346,14139166,5,0,0,33792,12,3417395425
1035,8532910,27229796,35762706,6,0,1,61952,12,8651618116
1036,8535000,7366959,15901959,4,0,0,51200,7,3601349088
1037,8535580,3367264,11902844,3,0,0,36352,18,5885710702
1038,8563390,7147905,15711295,3,0,0,6656,18,508935463
1039,8565880,6521471,15087351,7,0,0,9728,1,10522328117
1040,8571090,6505139,15076229,1,0,0,40960,1,235958465
1041,8574070,3124239,11698309,8,0,0,2048,11,7123739406
1042,8576140,8565381,17141521,0,0,0,22016,6,7147770078
1043,8584170,4247155,12831325,4,0,0,4608,7,4197340653
1044,8585420,27177309,35762729,1,0,1,11264,1,9889581696
1045,8585500,7322566,15908066,5,0,0,19968,12,4448446292
1046,8594990,6039829,14634819,8,0,0,38400,11,5777539704
1047,8626870,3062649,11689519,8,0,0,5632,11,9473151953
1048,8629410,7594998,16224408,7,0,0,8704,1,5841543404
1049,8650300,27112460,35762760,7,0,1,4608,1,3957597479
1050,8656880,4617547,13274427,7,0,0,20992,1,4300100734
1051,8664290,7557443,16221733,1,0,0,288768,1,4752228698
1052,8673000,27143532,35816532,4,0,1,22016,7,9202547028
1053,8696060,7160738,15856798,1,0,0,101376,1,9198849202
1054,8704040,6896725,15600765,2,0,0,29696,1,1364695836
1055,8705950,4511646,13217596,0,0,0,11264,6,4050681977
1056,8709511,27107044,35816555,9,0,1,16384,4,7223867543
1057,8717010,27116782,35833792,6,0,1,7680,12,10717315207
1058,8717450,8437510,17154960,5,0,0,44032,12,4384099244
1059,8740250,27271147,36011397,1,0,1,8192,1,3231891058
1060,8746030,5468805,14214835,5,0,0,38912,12,6824302437
1061,8749520,5165747,13915267,1,0,0,16384,1,6258494898
1062,8756770,7899499,16656269,8,0,0,26624,11,6414812080
1063,8757980,5423713,14181693,8,0,0,44544,11,1943668352
1064,8771610,7089423,15861033,2,0,0,13824,1,5390358215
1065,8778010,5288639,14066649,5,0,0,30208,12,9017892802
1066,8783920,27227500,36011420,1,0,1,10752,1,4119263163
1067,8788770,5500736,14289506,5,0,0,4096,12,5345934867
1068,8795580,6877981,15673561,1,0,0,55808,1,2188676491
1069,8800000,7272638,16072638,9,0,0,217600,4,3365687706
1070,8801210,28843033,37644243,2,0,1,387584,1,4458430651
1071,8806421,28886804,37693225,8,0,1,6144,11,2517052056
1072,8807720,8395731,17203451,4,0,0,71168,7,7311079303
1073,8815280,2781352,11596632,1,0,0,15872,1,8748531593
1074,8818220,28981073,37799293,4,0,1,6144,7,6270492895
1075,8825230,3812065,12637295,8,0,0,24576,11,9138252731
1076,8831260,5879926,14711186,5,0,0,34304,12,2446028143
1077,8834840,5311213,14146053,1,0,0,22528,1,2439688941
1078,8847270,5639764,14487034,1,0,0,24576,1,3274426232
1079,8890370,6217520,15107890,2,0,0,42496,1,6983888214
1080,8901310,3836847,12738157,4,0,0,8192,7,3137734948
1081,8909820,28909955,37819775,6,0,1,17408,12,4166159565
1082,8909900,6611878,15521778,2,0,0,60416,1,5863964526
1083,8939080,8129988,17069068,3,0,0,26112,18,1304420509
1084,8949520,4969514,13919034,9,0,0,12288,4,5278217824
1085,8957250,8346474,17303724,1,0,0,55296,1,9170783655
1086,8993620,7301929,16295549,8,0,0,37888,11,1494587768
1087,9005800,28813998,37819798,0,0,1,7680,6,1766739623
1088,9007800,28816256,37824056,6,0,1,7168,12,9706758236
1089,9009420,4846032,13855452,3,0,0,10240,18,4373323938
1090,9013460,28810619,37824079,0,0,1,1536,6,1628290448
1091,9020361,29137589,38157950,2,0,1,149504,1,6205177737
1092,9058110,29099863,38157973,0,0,1,5120,6,8409435061
1093,9060210,30515445,39575655,2,0,1,396800,1,8210332414
1094,9065890,8272457,17338347,7,0,0,34304,1,4267281092
1095,9066500,30587367,39653867,1,0,1,27648,1,4757303106
1096,9071750,3159564,12231314,9,0,0,20992,4,7930834205
1097,9080530,30584498,39665028,0,0,1,2048,6,571100062
1098,9087050,30647545,39734595,7,0,1,15360,1,7659210980
1099,9099060,5353070,14452130,1,0,0,36352,1,2543197808
1100,9105030,4275805,13380835,8,0,0,13312,11,5761983062
1101,9108410,30631202,39739612,7,0,1,22528,1,2029500386
1102,9118230,6133150,15251380,1,0,0,8192,1,10452217670
1103,9122090,6056432,15178522,4,0,0,20480,7,7047620332
1104,9128881,31830318,40959199,2,0,1,573440,1,696476716
1105,9130840,8374747,17505587,1,0,0,14336,1,9042764309
1106,9137900,3171044,12308944,4,0,0,14848,7,8883080608
1107,9138390,8271833,17410223,7,0,0,29184,1,4648317916
1108,9150690,5240972,14391662,4,0,0,6656,7,9880915213
1109,9153760,2317399,11471159,0,0,0,19968,6,9582068128
1110,9164240,5920124,15084364,9,0,0,26624,4,2898702209
1111,9172760,31803530,40976290,1,0,1,18944,1,1728159429
1112,9175140,6416554,15591694,8,0,0,49152,11,4579675205
1113,9177580,3106296,12283876,8,0,0,22016,11,2075701411
1114,9191290,5525067,14716357,5,0,0,16896,12,9513061774
1115,9194470,31852808,41047278,1,0,1,46592,1,6836273196
1116,9203190,4317351,13520541,7,0,0,38912,1,9052224424
1117,9216870,32412292,41629162,2,0,1,532480,1,7138170937
1118,9223160,2814338,12037498,1,0,0,15360,1,8068428499
1119,9243710,6861422,16105132,1,0,0,86528,1,8330602346
1120,9251250,6517249,15768499,0,0,0,62976,6,2773520626
1121,9261430,5927411,15188841,3,0,0,33792,18,5831663759
1122,9261960,4817972,14079932,7,0,0,43520,1,6724823939
1123,9266480,32681952,41948432,2,0,1,308736,1,2322529790
1124,9277700,8356208,17633908,7,0,0,74240,1,1372404127
1125,9279910,4994561,14274471,2,0,0,24064,1,4196487878
1126,9289520,5223859,14513379,8,0,0,14848,11,4613406306
1127,9290440,32664599,41955039,0,0,1,4096,6,8743951235
1128,9292910,5264085,14556995,1,0,0,38912,1,8108143505
1129,9300870,5650441,14951311,4,0,0,77824,7,9152360283
1130,9305920,3018545,12324465,8,0,0,8192,11,7863108354
1131,9309540,7941412,17250952,5,0,0,132096,12,8334785597
1132,9309800,32680869,41990669,2,0,1,31232,1,6749979150
1133,9315660,6421577,15737237,8,0,0,72192,11,6046676293
1134,9318350,3158862,12477212,4,0,0,9216,7,8095958146
1135,9335520,5521998,14857518,8,0,0,18944,11,6434649528
1136,9343130,4912879,14256009,5,0,0,18432,12,7855056521
1137,9344710,6227906,15572616,3,0,0,13312,18,9764129387
1138,9347860,6177864,15525724,3,0,0,3584,18,7090767068
1139,9352510,32643455,41995965,6,0,1,7680,12,6968679908
1140,9362560,5094117,14456677,5,0,0,14848,12,3072668066
1141,9377900,7270226,16648126,4,0,0,112640,7,6451599922
1142,9387879,32610672,41998551,5,0,1,4096,12,4616063423
1143,9417450,4832117,14249567,3,0,0,11776,18,2863935798
1144,9419060,5553053,14972113,6,0,0,12288,12,2327643778
1145,9422000,32587753,42009753,6,0,1,6656,12,3746565615
1146,9429691,32580085,42009776,9,0,1,10752,4,1434709459
1147,9433530,5267181,14700711,1,0,0,16896,1,9641269685
1148,9447949,32561850,42009799,5,0,1,6144,12,5796785029
1149,9452180,32557642,42009822,0,0,1,1536,6,5640115921
1150,9457340,1663347,11120687,3,0,0,18944,18,878936672
1151,9476680,2733014,12209694,2,0,0,8704,1,1158160108
1152,9483020,6970937,16453957,3,0,0,16896,18,8383488301
1153,9483450,4353822,13837272,5,0,0,1024,12,6354979882
1154,9502430,8702436,18204866,1,0,0,114688,1,2822792967
1155,9515930,2430397,11946327,2,0,0,16384,1,738142400
1156,9519279,32490566,42009845,5,0,1,9216,12,6198844340
1157,9532010,32480905,42012915,6,0,1,7168,12,2849906159
1158,9538820,32475171,42013991,1,0,1,13312,1,5842740385
1159,9539710,5279051,14818761,6,0,0,55296,12,2086874173
1160,9541330,6773159,16314489,7,0,0,35840,1,2766350971
1161,9550610,6723833,16274443,2,0,0,33280,1,1177931014
1162,9550630,8447108,17997738,6,0,0,139776,12,2812644093
1163,9557150,4069510,13626660,7,0,0,9216,1,1605859768
1164,9557530,7503559,17061089,4,0,0,14336,7,8396968967
1165,9558780,5634764,15193544,1,0,0,15360,1,5319056316
1166,9567360,7850694,17418054,8,0,0,25600,11,9775355084
1167,9578150,7406798,16984948,4,0,0,60416,7,7651221514
1168,9578700,8906480,18485180,8,0,0,88576,11,7639859447
1169,9586530,5341046,14927576,5,0,0,25088,12,8722745132
1170,9588010,2003763,11591773,3,0,0,1024,18,9072583080
1171,9600900,6820072,16420972,4,0,0,79360,7,9879671349
1172,9604620,7558319,17162939,3,0,0,26112,18,10253781581
1173,9605130,7077549,16682679,2,0,0,21504,1,635764081
1174,9606020,9043596,18649616,9,0,0,57344,4,8474779129
1175,9606270,6363651,15969921,8,0,0,26624,11,9297610156
1176,9613450,5362796,14976246,5,0,0,1024,12,1555953906
1177,9613950,7082191,16696141,7,0,0,21504,1,8667527358
1178,9631640,8220967,17852607,9,0,0,29696,4,9959442596
1179,9635220,7919295,17554515,2,0,0,21504,1,5813394127
1180,9646120,3263919,12910039,9,0,0,14848,4,8565484433
1181,9670710,6943073,16613783,3,0,0,4096,18,8553742933
1182,9670770,8572027,18242797,5,0,0,124416,12,3418610942
1183,9672420,5896117,15568537,9,0,0,26624,4,189712795
1184,9676770,32342406,42019176,7,0,1,16384,1,373668791
1185,9680800,6267169,15947969,9,0,0,56832,4,9011390341
1186,9683020,4108413,13791433,1,0,0,52736,1,9911552975
1187,9695049,32340941,42035990,5,0,1,12288,12,8037174950
1188,9696650,3523309,13219959,6,0,0,7680,12,8696681060
1189,9704010,6908502,16612512,7,0,0,56832,1,1337045902
1190,9706650,32330966,42037616,7,0,1,2560,1,5125475017
1191,9763390,6049908,15813298,2,0,0,11776,1,232468245
1192,9771140,6228132,15999272,3,0,0,96256,18,6033293785
1193,9771640,9672492,19444132,7,0,0,103936,1,8562478594
1194,9776440,6342911,16119351,8,0,0,46592,11,9355917350
1195,9788670,6887434,16676104,4,0,0,65024,7,9628398215
1196,9789279,32251883,42041162,5,0,1,5632,12,7698744300
1197,9789470,9112954,18902424,7,0,0,33280,1,7577121015
1198,9805640,4731497,14537137,3,0,0,52736,18,6409884234
1199,9806481,32236307,42042788,9,0,1,2560,4,478576709
1200,9842889,32200885,42043774,5,0,1,1536,12,2486466733
1201,9843830,5264707,15108537,9,0,0,2048,4,172774449
1202,9848390,32196255,42044645,7,0,1,12288,1,3575945221
1203,9858290,5386980,15245270,1,0,0,8704,1,2855402619
1204,9860970,6479558,16340528,6,0,0,55808,12,8462439104
1205,9871420,4948456,14819876,4,0,0,3584,7,895696711
1206,9885290,6885892,16771182,4,0,0,24064,7,3855854371
1207,9894070,5081506,14975576,5,0,0,11264,12,9143689297
1208,9903450,5339145,15242595,6,0,0,17408,12,4093141501
1209,9908910,7347704,17256614,8,0,0,512,11,1843395145
1210,9914360,7679155,17593515,4,0,0,18432,7,1750943942
1211,9917700,6846127,16763827,7,0,0,22528,1,5325943752
1212,9927580,7966055,17893635,4,0,0,33280,7,4196099780
1213,9929240,4307489,14236729,0,0,0,37888,6,9154321391
1214,9930750,32118081,42048831,4,0,1,6656,7,8002628641
1215,9930890,32125098,42055988,1,0,1,19456,1,9602039608
1216,9938240,7640254,17578494,6,0,0,28160,12,4314437386
1217,9950050,5706484,15656534,0,0,0,62976,6,9259939631
1218,9952460,5762758,15715218,9,0,0,12800,4,495355278
1219,9967420,7486840,17454260,4,0,0,27648,7,8267119809
1220,9990710,7265725,17256435,8,0,0,17920,11,9082898381
1221,10005530,32104699,42110229,6,0,1,30208,12,7616858637
1222,10010690,4546484,14557174,1,0,0,512,1,1717460591
1223,10023530,32087979,42111509,6,0,1,14336,12,2216933113
1224,10031331,32086591,42117922,8,0,1,22528,11,6694215311
1225,10042490,3088677,13131167,8,0,0,30208,11,9026190187
1226,10058620,32064132,42122752,6,0,1,5632,12,9091280660
1227,10062410,7669318,17731728,8,0,0,40960,11,7944265777
1228,10070790,5566533,15637323,8,0,0,53760,11,8945731343
1229,10081080,5837804,15918884,3,0,0,23040,18,9605695173
1230,10094330,6415263,16509593,3,0,0,22528,18,5641922871
1231,10101310,5607934,15709244,7,0,0,3072,1,220710048
1232,10110230,32074723,42184953,2,0,1,47616,1,6898672145
1233,10116110,3452340,13568450,6,0,0,1536,12,2533274768
1234,10122910,2969705,13092615,5,0,0,2048,12,4683072967
1235,10131449,32079118,42210567,5,0,1,8192,12,4046471576
1236,10135790,32486444,42622234,2,0,1,175616,1,4792022240
1237,10141290,3142702,13283992,6,0,0,9216,12,7781374368
1238,10141650,7127022,17268672,1,0,0,35328,1,7848022129
1239,10153320,8198049,18351369,7,0,0,45056,1,1386871984
1240,10167280,32515939,42683219,1,0,1,4096,1,3149546578
1241,10179300,32506505,42685805,6,0,1,4096,12,3170028924
1242,10182000,6935295,17117295,7,0,0,158208,1,6114184761
1243,10189140,9429114,19618254,5,0,0,7680,12,8183902715
1244,10217870,32491758,42709628,7,0,1,14848,1,6778885292
1245,10220651,32490603,42711254,8,0,1,2560,11,6195836037
1246,10238320,7162988,17401308,9,0,0,112640,4,1939330428
1247,10252330,2961811,13214141,5,0,0,11264,12,176276712
1248,10259160,3991210,14250370,9,0,0,2560,4,912154243
1249,10259410,5516631,15776041,3,0,0,18944,18,4241049983
1250,10262920,6742354,17005274,5,0,0,39424,12,9759840860
1251,10270780,32441140,42711920,6,0,1,1024,12,6691991416
1252,10270990,7042928,17313918,6,0,0,25600,12,5643997303
1253,10278690,32581531,42860221,2,0,1,50176,1,3460355433
1254,10287060,7040812,17327872,8,0,0,40448,11,7914220583
1255,10296360,5452912,15749272,5,0,0,39424,12,8055951994
1256,10301160,5610673,15911833,3,0,0,12288,18,8265585562
1257,10301520,6880224,17181744,8,0,0,44032,11,1199352487
1258,10301840,5201507,15503347,3,0,0,21504,18,6885233331
1259,10307130,32553114,42860244,8,0,1,27648,11,10480131642
1260,10321300,4957113,15278413,3,0,0,35840,18,5834563971
1261,10348720,8205179,18553899,2,0,0,23040,1,8877630669
1262,10352340,6814374,17166714,3,0,0,12288,18,9544348473
1263,10353100,32511604,42864704,7,0,1,23040,1,2145239138
1264,10363580,7726786,18090366,6,0,0,17920,12,6027850752
1265,10376500,3776934,14153434,8,0,0,21504,11,1153655172
1266,10378680,6936829,17315509,2,0,0,5120,1,3978375446
1267,10387020,6630289,17017309,4,0,0,39424,7,8619474675
1268,10406350,7091076,17497426,3,0,0,30720,18,7767411458
1269,10417930,8141764,18559694,9,0,0,18944,4,10117204442
1270,10430560,7070636,17501196,1,0,0,10240,1,9988867900
1271,10454420,9930903,20385323,8,0,0,443904,11,327616293
1272,10458330,32526747,42985077,8,0,1,6656,11,1920473311
1273,10460690,5799199,16259889,6,0,0,20480,12,217003062
1274,10461410,5239988,15701398,9,0,0,57344,4,9622044597
1275,10466230,8148974,18615204,5,0,0,39936,12,8018178335
1276,10470570,7574418,18044988,4,0,0,89600,7,2929432061
1277,10476370,7605191,18081561,8,0,0,1024,11,4325257718
1278,10483220,3338546,13821766,4,0,0,10752,7,4050339269
1279,10497290,3332611,13829901,8,0,0,26624,11,6040064765
1280,10497690,2777540,13275230,7,0,0,2560,1,350497741
1281,10498350,5635376,16133726,9,0,0,47104,4,5533109630
1282,10513260,3531613,14044873,5,0,0,2048,12,4203939275
1283,10516040,9370606,19886646,1,0,0,69632,1,8630386132
1284,10534269,32450831,42985100,3,0,1,512,18,5028751467
1285,10554520,32430603,42985123,0,0,1,19456,6,1490624270
1286,10558990,5902946,16461936,1,0,0,26112,1,2782934329
1287,10559730,8671655,19231385,4,0,0,25088,7,7300797757
1288,10565249,32419897,42985146,3,0,1,512,18,4387615693
1289,10578920,8796893,19375813,2,0,0,47104,1,4132384745
1290,10579930,32438513,43018443,4,0,1,4608,7,2612592815
1291,10588400,5637747,16226147,7,0,0,5632,1,10204684803
1292,10605960,4836657,15442617,7,0,0,30208,1,6905433698
1293,10618820,9806274,20425094,3,0,0,37376,18,4361185288
1294,10626910,10420334,21047244,3,0,0,99840,18,7038566682
1295,10631100,10064470,20695570,1,0,0,214528,1,5846267636
1296,10644520,32376504,43021024,4,0,1,52736,7,9445118338
1297,10668230,6758583,17426813,2,0,0,28672,1,9993657239
1298,10669120,10217467,20886587,2,0,0,4608,1,4406577166
1299,10674280,32495399,43169679,0,0,1,41984,6,2578759293
1300,10678580,6378118,17056698,8,0,0,3584,11,8193125081
1301,10685970,32877429,43563399,2,0,1,113152,1,2070879820
1302,10694850,32897670,43592520,4,0,1,19456,7,5557578882
1303,10704020,5226610,15930630,1,0,0,17920,1,6037145777
1304,10704101,32940777,43644878,9,0,1,6144,4,1437333053
1305,10707730,4403958,15111688,5,0,0,7680,12,8686697898
1306,10732430,5957136,16689566,5,0,0,22528,12,6089228088
1307,10734090,8256765,18990855,7,0,0,72192,1,3935301016
1308,10741600,5522680,16264280,4,0,0,14336,7,8392025823
1309,10751970,32897802,43649772,0,0,1,16384,6,1237471121
1310,10753310,7599018,18352328,6,0,0,3072,12,4193984199
1311,10756740,6914427,17671167,6,0,0,72704,12,9577358163
1312,10772360,5676426,16448786,3,0,0,69632,18,796462931
1313,10778800,32871638,43650438,8,0,1,1024,11,9570098485
1314,10788170,7930865,18719035,8,0,0,12288,11,3923184079
1315,10799790,32890750,43690540,4,0,1,13824,7,4613140495
1316,10812200,6750918,17563118,5,0,0,28160,12,10499536137
1317,10814530,4762165,15576695,9,0,0,13312,4,5158285763
1318,10823620,8199951,19023571,5,0,0,32256,12,2720831991
1319,10827040,7186234,18013274,3,0,0,2560,18,7929893982
1320,10828550,8370162,19198712,4,0,0,228864,7,1036324970
1321,10850400,10385846,21236246,7,0,0,43520,1,4869669818
1322,10857951,32832612,43690563,9,0,1,9216,4,9183575706
1323,10860910,3684206,14545116,9,0,0,26112,4,9071026871
1324,10868760,7632199,18500959,1,0,0,51712,1,4386436965
1325,10879410,3481755,14361165,0,0,0,13312,6,8918447457
1326,10886470,10243997,21130467,4,0,0,14848,7,9893761546
1327,10888950,32801636,43690586,0,0,1,15360,6,8030549648
1328,10911570,5515977,16427547,5,0,0,21504,12,10320941750
1329,10922120,8837301,19759421,0,0,0,48640,6,2601603835
1330,10923160,6287521,17210681,0,0,0,18432,6,8803912434
1331,10926110,8328542,19254652,5,0,0,76288,12,4136125241
1332,10933830,5660696,16594526,5,0,0,81408,12,2300187704
1333,10945100,4731448,15676548,0,0,0,9728,6,6580185960
1334,10945840,5520955,16466795,5,0,0,15872,12,4584741440
1335,10951100,7133783,18084883,7,0,0,8704,1,2669154807
1336,10972800,9111606,20084406,3,0,0,552960,18,5649305211
1337,10979030,5758341,16737371,7,0,0,86528,1,4066487559
1338,10982320,6366822,17349142,3,0,0,35328,18,1102779125
1339,11001940,5991299,16993239,6,0,0,27136,12,7524691533
1340,11007061,32688525,43695586,9,0,1,17408,4,9175218060
1341,11032110,4248042,15280152,5,0,0,5632,12,7006944557
1342,11060750,6411319,17472069,2,0,0,40448,1,7898029558
1343,11085380,7574578,18659958,5,0,0,13824,12,10057689704
1344,11086770,6048020,17134790,3,0,0,57344,18,6653072024
1345,11104430,6262527,17366957,5,0,0,58368,12,3133058063
1346,11117470,6765524,17882994,8,0,0,9728,11,6140197936
1347,11130540,7498750,18629290,1,0,0,16896,1,10547049690
1348,11142779,32578858,43721637,5,0,1,11264,12,821029747
1349,11143550,7392537,18536087,4,0,0,7680,7,9710441793
1350,11181670,32574631,43756301,7,0,1,1024,1,8944042342
1351,11191660,32568507,43760167,4,0,1,6144,7,7705806305
1352,11209170,32617993,43827163,4,0,1,25600,7,7172943992
1353,11213170,5540939,16754109,2,0,0,22016,1,4481006502
1354,11215460,7288174,18503634,9,0,0,8704,4,8715579616
1355,11224390,32698306,43922696,7,0,1,23552,1,1177810109
1356,11228960,5527980,16756940,2,0,0,9216,1,547224160
1357,11233460,8913827,20147287,6,0,0,30208,12,974940762
1358,11233840,6626902,17860742,5,0,0,26624,12,5158120580
1359,11235170,32687549,43922719,4,0,1,4096,7,2244167894
1360,11236700,6209113,17445813,3,0,0,25088,18,942580229
1361,11241820,6305150,17546970,0,0,0,86016,6,10286669038
1362,11245400,5349773,16595173,7,0,0,2048,1,8597229486
1363,11251020,8141703,19392723,2,0,0,28160,1,4312914645
1364,11252090,6815853,18067943,4,0,0,75264,7,2668101915
1365,11261700,6176446,17438146,5,0,0,7168,12,39155479
1366,11263330,6341459,17604789,8,0,0,31744,11,3002961549
1367,11273930,7500521,18774451,4,0,0,5120,7,347702603
1368,11275170,10206794,21481964,4,0,0,68096,7,5956592604
1369,11279670,5431314,16710984,4,0,0,48640,7,6908223098
1370,11284070,7414037,18698107,4,0,0,512,7,3768727153
1371,11295600,7664165,18959765,8,0,0,81408,11,2182115475
1372,11302740,3359001,14661741,0,0,0,3072,6,1312169101
1373,11303580,5983078,17286658,3,0,0,28672,18,4819069982
1374,11324370,32622043,43946413,4,0,1,26112,7,6869290398
1375,11336400,10023652,21360052,5,0,0,26624,12,713243100
1376,11345120,5823177,17168297,4,0,0,5120,7,2454070131
1377,11345200,6493100,17838300,5,0,0,15872,12,5052541453
1378,11347070,7666650,19013720,4,0,0,23040,7,4476808945
1379,11351090,32991535,44342625,2,0,1,299008,1,10426281580
1380,11354589,33028810,44383399,3,0,1,6144,18,8143118977
1381,11386590,6858414,18245004,8,0,0,7168,11,7456046885
1382,11405510,32977912,44383422,8,0,1,3584,11,688308572
1383,11407110,32976335,44383445,0,0,1,1536,6,7769993481
1384,11412280,33008041,44420321,7,0,1,29696,1,6233347928
1385,11414260,10194405,21608665,7,0,0,252928,1,8244248085
1386,11414390,7501394,18915784,9,0,0,4608,4,293208408
1387,11425620,3826875,15252495,9,0,0,3584,4,4901960913
1388,11440240,7335482,18775722,9,0,0,4096,4,10357015863
1389,11454270,33019423,44473693,7,0,1,13312,1,2873987107
1390,11456630,4827352,16283982,9,0,0,31232,4,10475490974
1391,11474530,5955894,17430424,4,0,0,11776,7,7888427314
1392,11495450,7075967,18571417,3,0,0,38400,18,8898637786
1393,11497570,6283892,17781462,1,0,0,56832,1,1900027664
1394,11500010,5935913,17435923,5,0,0,17920,12,2876363931
1395,11500380,33020914,44521294,6,0,1,2048,12,9142922513
1396,11519700,33003403,44523103,1,0,1,12800,1,8812233565
1397,11528030,4242216,15770246,5,0,0,5632,12,6018726328
1398,11541320,7776275,19317595,7,0,0,8192,1,5520444960
1399,11558910,7664808,19223718,0,0,0,47616,6,1291072549
1400,11571180,10264841,21836021,5,0,0,9728,12,6087840027
1401,11582510,7546447,19128957,9,0,0,61440,4,6603870329
1402,11637270,6267308,17904578,3,0,0,35840,18,9877295785
1403,11650110,6431116,18081226,0,0,0,43520,6,338374258
1404,11654810,10036308,21691118,5,0,0,22528,12,7795905758
1405,11655310,6514589,18169899,3,0,0,36352,18,8445984532
1406,11660449,32894000,44554449,3,0,1,24576,18,4467643982
1407,11661851,32988581,44650432,9,0,1,32256,4,2184506275
1408,11673770,32978288,44652058,4,0,1,2560,7,6665173972
1409,11673910,6019289,17693199,8,0,0,33792,11,7376230179
1410,11677489,32997463,44674952,3,0,1,1024,18,9035734844
1411,11728370,7362633,19091003,0,0,0,87552,6,10235172937
1412,11748300,5954750,17703050,4,0,0,32256,7,6719188637
1413,11749790,6068983,17818773,0,0,0,20992,6,812351884
1414,11755470,7751023,19506493,9,0,0,9728,4,9358775513
1415,11757480,9085015,20842495,7,0,0,15872,1,4941391910
1416,11758220,7625892,19384112,5,0,0,27136,12,5740705540
1417,11759350,6322858,18082208,7,0,0,2048,1,2333170929
1418,11762530,7347684,19110214,8,0,0,62976,11,7330029656
1419,11767640,7970831,19738471,8,0,0,58368,11,4713123526
1420,11770800,32904818,44675618,6,0,1,1024,12,1896156032
1421,11771930,33022207,44794137,8,0,1,27648,11,6701934230
1422,11774400,7540676,19315076,6,0,0,13312,12,8471198041
1423,11788180,33008543,44796723,7,0,1,4096,1,1224566286
1424,11797300,5480599,17277899,6,0,0,30208,12,2739662124
1425,11813500,6634818,18448318,4,0,0,111616,7,10018140919
1426,11822050,4103097,15925147,6,0,0,20480,12,10035021314
1427,11827030,33024288,44851318,6,0,1,1024,12,4300119388
1428,11833980,6484056,18318036,1,0,0,28160,1,7941093130
1429,11841760,5445077,17286837,9,0,0,512,4,4247356324
1430,11846230,9106404,20952634,2,0,0,36352,1,1129193035
1431,11850480,5884547,17735027,8,0,0,10752,11,7610470374
1432,11854410,6777711,18632121,0,0,0,9216,6,1554430971
1433,11854629,32996712,44851341,3,0,1,20480,18,1310526200
1434,11858010,7997697,19855707,1,0,0,6656,1,1690312920
1435,11890780,7938504,19829284,8,0,0,120832,11,63384646
1436,11894450,33017322,44911772,7,0,1,43520,1,1763575657
1437,11909939,33003216,44913155,3,0,1,512,18,1938528071
1438,11912400,6492482,18404882,5,0,0,3072,12,3734305345
1439,11917000,33025746,44942746,7,0,1,25600,1,437900470
1440,11919250,10005238,21924488,2,0,0,69632,1,6397985975
1441,11920010,6613714,18533724,4,0,0,24576,7,2095975476
1442,11938640,5846589,17785229,2,0,0,12288,1,9119592340
1443,11948091,33059329,45007420,8,0,1,9216,11,7218264466
1444,11957760,9258129,21215889,7,0,0,19456,1,5891702824
1445,11959530,33047913,45007443,2,0,1,1536,1,4193901455
1446,11963270,7757394,19720664,0,0,0,15872,6,3400225080
1447,11980290,33089778,45070068,4,0,1,19968,7,4090679435
1448,12011460,6105045,18116505,1,0,0,8192,1,4139065967
1449,12012580,33075196,45087776,0,0,1,22528,6,1313859179
1450,12015580,33088489,45104069,0,0,1,3584,6,1014057174
1451,12051880,4695498,16747378,8,0,0,32768,11,6185974769
1452,12059350,7850430,19909780,4,0,0,38912,7,2890558687
1453,12063591,33046190,45109781,9,0,1,6656,4,9630282938
1454,12095520,5905205,18000725,4,0,0,9728,7,2577360249
1455,12105250,7534024,19639274,5,0,0,27136,12,668943367
1456,12106960,6439580,18546540,3,0,0,6144,18,1451026220
1457,12109160,7181050,19290210,6,0,0,5120,12,2605591146
1458,12110940,33000493,45111433,6,0,1,2560,12,1493411420
1459,12122890,32992409,45115299,4,0,1,6144,7,3552727967
1460,12123310,6743017,18866327,4,0,0,12800,7,4778259421
1461,12134390,5123495,17257885,7,0,0,4096,1,3268595526
1462,12169420,6354423,18523843,7,0,0,11264,1,8224819578
1463,12177510,6537758,18715268,7,0,0,7168,1,2219723806
1464,12188380,6507021,18695401,8,0,0,116224,11,216244634
1465,12195300,7013887,19209187,9,0,0,34304,4,9121563598
1466,12199580,7375776,19575356,3,0,0,30208,18,4707652327
1467,12203090,4366609,16569699,0,0,0,33792,6,4135591088
1468,12207100,32909505,45116605,7,0,1,2048,1,6093471159
1469,12208200,6798477,19006677,4,0,0,18944,7,7545683071
1470,12214900,7040711,19255611,9,0,0,3072,4,6571184106
1471,12215300,5521934,17737234,3,0,0,7168,18,1546650495
1472,12215400,6196525,18411925,5,0,0,23040,12,848816755
1473,12235230,7031815,19267045,5,0,0,15872,12,917051790
1474,12238460,7855805,20094265,0,0,0,32256,6,4246217250
1475,12242870,6090943,18333813,8,0,0,18432,11,10162237816
1476,12263040,7047941,19310981,7,0,0,68096,1,9303224025
1477,12264510,9745004,22009514,3,0,0,14848,18,9341517319
1478,12265590,5529441,17795031,5,0,0,2048,12,2138436809
1479,12291070,9008510,21299580,1,0,0,67584,1,858181155
1480,12292830,5724835,18017665,3,0,0,14336,18,8171205013
1481,12305010,6628642,18933652,0,0,0,50176,6,6827181583
1482,12309040,7288367,19597407,9,0,0,1536,4,3650128489
1483,12316690,6198667,18515357,8,0,0,38400,11,2512625678
1484,12320340,33196230,45516570,1,0,1,198144,1,2066989163
1485,12323330,33199251,45522581,6,0,1,3072,12,9574532991
1486,12328070,7909935,20238005,8,0,0,79360,11,8955741110
1487,12328540,6129629,18458169,7,0,0,32256,1,7303359349
1488,12330219,33266237,45596456,3,0,1,24576,18,5066116632
1489,12338930,7018585,19357515,4,0,0,8192,7,5401872341
1490,12342780,7052306,19395086,3,0,0,7680,18,8720596525
1491,12353740,6376082,18729822,4,0,0,35328,7,5748046145
1492,12374730,6980266,19354996,3,0,0,5120,18,3203370645
1493,12383370,33214674,45598044,7,0,1,15872,1,5700340346
1494,12390990,7142238,19533228,8,0,0,12800,11,8145638742
1495,12391581,33279872,45671453,9,0,1,34304,4,3604345902
1496,12392480,7255241,19647721,0,0,0,27648,6,6819345465
1497,12392900,33367312,45760212,7,0,1,7680,1,8747608538
1498,12393140,33408576,45801716,7,0,1,4608,1,9195754168
1499,12415040,6648097,19063137,7,0,0,12288,1,7602433721
1500,12426780,5585691,18012471,1,0,0,33280,1,2758413692
1501,12427350,6228373,18655723,3,0,0,19968,18,7094266531
1502,12429300,4876795,17306095,4,0,0,7680,7,2118766239
1503,12433240,5725560,18158800,1,0,0,24064,1,10292335278
1504,12435890,8110086,20545976,0,0,0,246272,6,8024449740
1505,12442830,8394806,20837636,8,0,0,171008,11,4738399522
1506,12456090,5852514,18308604,6,0,0,18432,12,3833292452
1507,12456580,6063800,18520380,0,0,0,16384,6,2744758289
1508,12463770,5013093,17476863,0,0,0,3584,6,9045481925
1509,12467130,4737912,17205042,4,0,0,5120,7,752908122
1510,12469560,7973497,20443057,2,0,0,58880,1,4378949293
1511,12492490,6131629,18624119,5,0,0,29184,12,6429838970
1512,12504510,6907923,19412433,7,0,0,56832,1,8905545272
1513,12509960,7172265,19682225,0,0,0,68608,6,643441530
1514,12511160,6457676,18968836,4,0,0,29696,7,6074527243
1515,12522660,6175268,18697928,8,0,0,8192,11,8148277325
1516,12527430,7645152,20172582,4,0,0,82944,7,1379205949
1517,12527500,8524166,21051666,5,0,0,2560,12,3510007348
1518,12529440,7681219,20210659,8,0,0,15360,11,10096136616
1519,12541270,4479034,17020304,1,0,0,9728,1,1374974671
1520,12572070,8058113,20630183,2,0,0,52224,1,6428232653
1521,12590500,5689319,18279819,0,0,0,8704,6,3298868561
1522,12600470,6903036,19503506,7,0,0,20992,1,8314080156
1523,12606260,33465742,46072002,0,0,1,30720,6,119397787
1524,12609450,5024637,17634087,7,0,0,512,1,4303762068
1525,12640010,8259392,20899402,7,0,0,41984,1,9508704537
1526,12650400,7193290,19843690,0,0,0,19456,6,4053703955
1527,12661900,6110968,18772868,7,0,0,39424,1,1923181179
1528,12664260,6792522,19456782,0,0,0,32256,6,7133540810
1529,12678780,9719438,22398218,8,0,0,118784,11,7370210338
1530,12687880,7450180,20138060,6,0,0,52224,12,6904261268
1531,12702300,33468834,46171134,0,0,1,11264,6,3188748315
1532,12711210,7408240,20119450,1,0,0,27136,1,5167249129
1533,12718060,9804634,22522694,5,0,0,7168,12,3125679889
1534,12721030,5228441,17949471,5,0,0,512,12,1245226858
1535,12735000,7048374,19783374,8,0,0,58368,11,1059837704
1536,12748160,5198973,17947133,6,0,0,6144,12,718127850
1537,12753310,5339419,18092729,3,0,0,7680,18,178545953
1538,12760900,33413460,46174360,4,0,1,5120,7,9351207251
1539,12763760,8287103,21050863,1,0,0,11776,1,4735407658
1540,12773270,6546946,19320216,7,0,0,3584,1,8703757584
1541,12780850,6745936,19526786,8,0,0,63488,11,889816777
1542,12784190,5313250,18097440,6,0,0,15360,12,4231099018
1543,12786510,6130857,18917367,1,0,0,5120,1,9514630577
1544,12800320,8532534,21332854,0,0,0,67584,6,8581689270
1545,12802840,7914655,20717495,5,0,0,29184,12,8576482091
1546,12805480,6483139,19288619,7,0,0,63488,1,6600249159
1547,12805550,9989461,22795011,2,0,0,120320,1,2415187619
1548,12816770,6544668,19361438,2,0,0,12800,1,10050758341
1549,12822880,34484255,47307135,1,0,1,477184,1,331714719
1550,12828470,5996323,18824793,5,0,0,37376,12,5113721420
1551,12834170,7371786,20205956,7,0,0,60416,1,3775430724
1552,12835290,8579609,21414899,7,0,0,6656,1,2718114104
1553,12843050,7617502,20460552,8,0,0,57344,11,8085783420
1554,12846770,34460388,47307158,6,0,1,512,12,758447675
1555,12848660,8823216,21671876,3,0,0,207360,18,7521916643
1556,12852770,34454411,47307181,4,0,1,1536,7,257866430
1557,12862681,34444523,47307204,8,0,1,1536,11,4846333532
1558,12865040,7599747,20464787,5,0,0,13824,12,10505112715
1559,12890750,5111558,18002308,6,0,0,5120,12,7899761081
1560,12902600,6450813,19353413,7,0,0,60416,1,9137642605
1561,12920660,6871785,19792445,8,0,0,29696,11,2530099006
1562,12921530,7993907,20915437,7,0,0,15360,1,2528599631
1563,12925620,7816117,20741737,4,0,0,65024,7,1693310662
1564,12941140,34366087,47307227,6,0,1,12800,12,8263751912
1565,12953610,6040544,18994154,7,0,0,10752,1,5708042391
1566,12958110,8393807,21351917,5,0,0,62464,12,177899714
1567,12974719,34332718,47307437,5,0,1,3072,12,5366862582
1568,12983430,34324030,47307460,4,0,1,1024,7,3033740370
1569,12988080,6274106,19262186,3,0,0,21504,18,10608027306
1570,13006660,7381962,20388622,7,0,0,10752,1,862160187
1571,13010160,7093488,20103648,8,0,0,30720,11,8382991713
1572,13016390,7996956,21013346,1,0,0,74752,1,1561894779
1573,13016850,7562868,20579718,4,0,0,68608,7,5879927224
1574,13019220,34302669,47321889,0,0,1,62464,6,3189596880
1575,13025381,34296539,47321920,9,0,1,5632,4,9822416998
1576,13025530,7224510,20250040,3,0,0,39424,18,8934180180
1577,13037710,34319111,47356821,1,0,1,165888,1,3496924707
1578,13043650,7741859,20785509,7,0,0,33280,1,7893538901
1579,13061260,8064660,21125920,0,0,0,16896,6,256758740
1580,13062550,6384132,19446682,4,0,0,512,7,5357794641
1581,13064230,6833671,19897901,3,0,0,36864,18,2230765607
1582,13067250,7118692,20185942,7,0,0,16896,1,3211390786
1583,13069380,34289289,47358669,4,0,1,11264,7,6991338378
1584,13084470,8101211,21185681,8,0,0,34304,11,8789116196
1585,13085019,34293521,47378540,3,0,1,23040,18,3107436426
1586,13097579,34293108,47390687,5,0,1,4608,12,4497701833
1587,13098270,34293083,47391353,8,0,1,1024,11,5245905202
1588,13102180,8037670,21139850,7,0,0,30720,1,2720832046
1589,13113940,7073585,20187525,2,0,0,5120,1,514379713
1590,13114140,34726655,47840795,1,0,1,294912,1,4691458813
1591,13122100,34722561,47844661,0,0,1,6144,6,895579435
1592,13122219,34786692,47908911,3,0,1,7168,18,5355751412
1593,13122330,34786726,47909056,6,0,1,512,12,3749943195
1594,13123180,9811872,22935052,1,0,0,70656,1,7653798008
1595,13141520,7072282,20213802,2,0,0,10240,1,1806819154
1596,13143450,7737319,20880769,6,0,0,123392,12,6818042410
1597,13171370,7537194,20708564,3,0,0,29696,18,6643518557
1598,13178040,10036510,23214550,1,0,0,88064,1,3512437519
1599,13180860,7760675,20941535,8,0,0,81920,11,7487989211
1600,13185460,7219269,20404729,0,0,0,52736,6,3210954670
1601,13187470,7803077,20990547,2,0,0,11776,1,10638186529
1602,13194880,8069367,21264247,7,0,0,33280,1,6608600106
1603,13200660,9942910,23143570,1,0,0,113664,1,10012670642
1604,13217060,7767958,20985018,8,0,0,83456,11,4745087556
1605,13220670,6523908,19744578,2,0,0,19968,1,9540958296
1606,13243090,7715963,20959053,0,0,0,20992,6,8100326282
1607,13246280,7222430,20468710,5,0,0,12800,12,7190039021
1608,13259070,6010182,19269252,5,0,0,7168,12,2002554809
1609,13262640,6326398,19589038,6,0,0,7168,12,2674010784
1610,13266950,10097115,23364065,3,0,0,7680,18,5016142865
1611,13271940,7286851,20558791,4,0,0,41984,7,7959746721
1612,13276260,34640288,47916548,6,0,1,16384,12,9204050615
1613,13278280,7606880,20885160,2,0,0,14336,1,1670606003
1614,13281110,7824000,21105110,7,0,0,84480,1,8782040824
1615,13293010,7120665,20413675,8,0,0,16384,11,8284517971
1616,13293860,34693629,47987489,4,0,1,1536,7,3688056315
1617,13294260,7616295,20910555,1,0,0,4608,1,4365222197
1618,13298751,34688761,47987512,9,0,1,6144,4,3000349282
1619,13305260,7767668,21072928,5,0,0,60928,12,7214057408
1620,13309640,34677895,47987535,7,0,1,5120,1,756680161
1621,13318800,34720502,48039302,1,0,1,18944,1,9392762375
1622,13324300,8381574,21705874,6,0,0,9216,12,10456589623
1623,13334600,6215300,19549900,5,0,0,20992,12,4683484306
1624,13339100,8438157,21777257,3,0,0,2048,18,42932814
1625,13349020,7667781,21016801,9,0,0,11264,4,1810255635
1626,13363250,6133837,19497087,3,0,0,22016,18,5602913433
1627,13368719,34675629,48044348,5,0,1,27648,12,7409101294
1628,13381400,6534503,19915903,2,0,0,19968,1,5979287110
1629,13383290,7870794,21254084,7,0,0,32768,1,7750758926
1630,13387620,34656751,48044371,8,0,1,5120,11,5006192855
1631,13397240,8004657,21401897,2,0,0,37376,1,4519179532
1632,13400300,7976693,21376993,5,0,0,9728,12,5256834902
1633,13401970,7910269,21312239,6,0,0,41472,12,683219306
1634,13412900,7950007,21362907,7,0,0,9216,1,10031074788
1635,13451710,10281771,23733481,4,0,0,15872,7,5206388729
1636,13458500,8400975,21859475,5,0,0,68096,12,3628362174
1637,13459840,6194768,19654608,5,0,0,22528,12,9552424600
1638,13460150,10073284,23533434,8,0,0,46592,11,8167593476
1639,13469240,8057916,21527156,4,0,0,91136,7,3143454018
1640,13471720,7807237,21278957,0,0,0,512,6,4064991502
1641,13488160,34575187,48063347,6,0,1,31232,12,9880675093
1642,13490120,7124120,20614240,3,0,0,99840,18,948033521
1643,13491920,6345819,19837739,1,0,0,27648,1,3488230301
1644,13498520,8626984,22125504,6,0,0,123392,12,7997868180
1645,13509160,8264299,21773459,5,0,0,37888,12,9608419239
1646,13524280,6005025,19529305,1,0,0,8192,1,9356577984
1647,13555380,7565361,21120741,5,0,0,51200,12,2019811386
1648,13570440,8723946,22294386,1,0,0,1024,1,2380725838
1649,13577930,8106301,21684231,7,0,0,40448,1,5379878593
1650,13579830,5866673,19446503,0,0,0,7680,6,3289734470
1651,13581320,7194026,20775346,7,0,0,60928,1,6058348431
1652,13618241,34455810,48074051,9,0,1,6656,4,6721338743
1653,13622690,7134069,20756759,3,0,0,38400,18,903000673
1654,13623260,34517735,48140995,7,0,1,34816,1,8015165633
1655,13637290,34504371,48141661,0,0,1,1024,6,2342063129
1656,13646060,6465099,20111159,4,0,0,24576,7,1844835975
1657,13653310,8293532,21946842,8,0,0,27136,11,6560992601
1658,13673110,34498878,48171988,4,0,1,33280,7,4185170311
1659,13674400,6506348,20180748,5,0,0,20480,12,4127668843
1660,13687930,8134933,21822863,3,0,0,104448,18,3698841837
1661,13691360,7474752,21166112,0,0,0,57856,6,3249989764
1662,13698039,34559195,48257234,3,0,1,23040,18,1505000226
1663,13725240,34558459,48283699,7,0,1,8192,1,8828753681
1664,13725290,8729290,22454580,6,0,0,148992,12,4542388895
1665,13736690,7676150,21412840,1,0,0,35840,1,419811899
1666,13736810,34546912,48283722,8,0,1,9216,11,9445037138
1667,13738790,34548722,48287512,4,0,1,12800,7,7248761044
1668,13755919,34663797,48419716,3,0,1,23040,18,2113953986
1669,13759260,7461184,21220444,1,0,0,14848,1,9675904380
1670,13759320,7414459,21173779,8,0,0,25088,11,10240814271
1671,13778810,6629850,20408660,0,0,0,12800,6,6481272254
1672,13783209,34696947,48480156,5,0,1,8192,12,7114357613
1673,13784980,8082630,21867610,1,0,0,26624,1,5014054749
1674,13788200,10003815,23792015,1,0,0,103424,1,13532509
1675,13803160,8221671,22024831,0,0,0,18944,6,3873525180
1676,13809180,6912706,20721886,5,0,0,14336,12,265090142
1677,13813520,6360957,20174477,3,0,0,6144,18,9551314609
1678,13815930,7975078,21791008,4,0,0,45056,7,4592858522
1679,13816450,34685953,48502403,6,0,1,21504,12,802584739
1680,13817530,34704276,48521806,7,0,1,7168,1,6899866881
1681,13842560,8518221,22360781,3,0,0,9216,18,5436134238
1682,13852530,7295923,21148453,8,0,0,28160,11,10200840550
1683,13852540,8434824,22287364,2,0,0,41472,1,3839990336
1684,13912230,6209895,20122125,7,0,0,8704,1,1000192709
1685,13916420,7042968,20959388,9,0,0,1024,4,2796242441
1686,13954150,7125197,21079347,3,0,0,20992,18,8224602734
1687,13956360,6627437,20583797,0,0,0,13312,6,8628233352
1688,13960201,34613961,48574162,9,0,1,14336,4,8747254076
1689,13961080,6948048,20909128,8,0,0,30720,11,8618150305
1690,13965030,7416198,21381228,2,0,0,13824,1,10263632070
1691,13970740,34650195,48620935,6,0,1,5632,12,8761193619
1692,13998070,10165252,24163322,0,0,0,15360,6,9958855161
1693,13998260,34659489,48657749,6,0,1,28672,12,1088614201
1694,13999480,7961150,21960630,1,0,0,26112,1,2691098114
1695,14000770,7498579,21499349,7,0,0,48128,1,5526534360
1696,14007050,10012005,24019055,8,0,0,78336,11,4447667078
1697,14014100,6829042,20843142,6,0,0,2048,12,4131571948
1698,14040110,34626044,48666154,6,0,1,4608,12,2594979292
1699,14045430,6914137,20959567,8,0,0,512,11,8556427386
1700,14053260,6691776,20745036,8,0,0,10752,11,2923692978
1701,14055940,34629262,48685202,4,0,1,512,7,7152638825
1702,14061360,8479314,22540674,4,0,0,512,7,10111355482
1703,14062890,8066225,22129115,8,0,0,11776,11,2676140308
1704,14077770,7166299,21244069,8,0,0,25600,11,1685087296
1705,14089360,6964981,21054341,1,0,0,8704,1,5225757728
1706,14099160,6371757,20470917,0,0,0,7168,6,6981185720
1707,14101920,7091748,21193668,2,0,0,26112,1,9355815036
1708,14108731,34578417,48687148,9,0,1,3072,4,2383329238
1709,14117190,8057250,22174440,4,0,0,11776,7,10241140548
1710,14118510,6781235,20899745,5,0,0,1024,12,8641101031
1711,14122579,34565875,48688454,5,0,1,2048,12,8830456085
1712,14127940,7073551,21201491,2,0,0,25600,1,5685859442
1713,14133240,8074809,22208049,8,0,0,78336,11,9227966556
1714,14137120,8596124,22733244,5,0,0,147456,12,6810213192
1715,14141691,34648563,48790254,9,0,1,15360,4,2743288327
1716,14145160,7851003,21996163,2,0,0,96256,1,6634684964
1717,14155040,7606852,21761892,2,0,0,70656,1,7351906781
1718,14159080,6751654,20910734,1,0,0,512,1,5356088476
1719,14161320,8295467,22456787,8,0,0,7168,11,10503539534
1720,14162810,8105944,22268754,2,0,0,11776,1,7224728369
1721,14164780,10052839,24217619,5,0,0,3584,12,493980159
1722,14167540,7270314,21437854,7,0,0,19968,1,10619381898
1723,14169710,34620567,48790277,7,0,1,13824,1,5392175395
1724,14175970,34614330,48790300,4,0,1,13824,7,5067410878
1725,14192510,8450866,22643376,5,0,0,13824,12,1009978716
1726,14215400,8668006,22883406,9,0,0,29184,4,4964348756
1727,14229149,34561182,48790331,5,0,1,4608,12,494858431
1728,14237470,6462023,20699493,8,0,0,12800,11,3929885600
1729,14244720,34545634,48790354,6,0,1,10752,12,4717452007
1730,14252710,34537675,48790385,4,0,1,1536,7,1378041885
1731,14257100,7162549,21419649,8,0,0,3072,11,2577628362
1732,14257690,7453199,21710889,3,0,0,16384,18,9226180709
1733,14262399,34528009,48790408,3,0,1,3584,18,7108592854
1734,14263620,7569406,21833026,3,0,0,33280,18,138518428
1735,14269030,7213737,21482767,4,0,0,2560,7,9099729275
1736,14271600,8242444,22514044,8,0,0,26624,11,4937525742
1737,14271910,34552449,48824359,7,0,1,13824,1,10030071077
1738,14282500,6996278,21278778,7,0,0,47616,1,7134721430
1739,14283600,8734403,23018003,4,0,0,5120,7,2217504335
1740,14291540,7095639,21387179,6,0,0,19456,12,7001911212
1741,14311940,6604612,20916552,1,0,0,3584,1,2094678984
1742,14312631,34547173,48859804,9,0,1,6656,4,1233304951
1743,14312700,6897238,21209938,9,0,0,27648,4,7679097004
1744,14321900,7390112,21712012,1,0,0,3584,1,5780003508
1745,14324500,7939460,22263960,1,0,0,39424,1,3866417203
1746,14331650,9983954,24315604,4,0,0,29696,7,6886816015
1747,14335370,7196208,21531578,9,0,0,4096,4,7727931013
1748,14337310,8676225,23013535,1,0,0,102400,1,3188187355
1749,14341320,7351716,21693036,1,0,0,3584,1,7575464470
1750,14348310,8462526,22810836,3,0,0,25600,18,1983265790
1751,14348910,6826296,21175206,5,0,0,4608,12,5420178037
1752,14349000,34513390,48862390,7,0,1,4096,1,9242387530
1753,14352319,34657370,49009689,5,0,1,37376,12,10339166836
1754,14358160,7860491,22218651,2,0,0,10752,1,2268148948
1755,14358870,34650842,49009712,7,0,1,2560,1,3095952976
1756,14366410,7472286,21838696,4,0,0,8704,7,8979118872
1757,14367330,7663563,22030893,3,0,0,5632,18,6990785215
1758,14371850,34637885,49009735,0,0,1,6144,6,2835198853
1759,14378970,6995036,21374006,6,0,0,36352,12,6721871197
1760,14391160,8765271,23156431,9,0,0,18944,4,4989205038
1761,14394030,34619147,49013177,2,0,1,6656,1,9832232247
1762,14404980,34702257,49107237,2,0,1,33792,1,6657272251
1763,14406800,7929757,22336557,2,0,0,23552,1,6221567653
1764,14423521,34691406,49114927,9,0,1,23040,4,2358226441
1765,14434420,34685085,49119505,6,0,1,7680,12,7538388244
1766,14446770,8051628,22498398,5,0,0,9728,12,1434629060
1767,14448080,10011601,24459681,9,0,0,16896,4,5949826045
1768,14456590,6933888,21390478,5,0,0,10752,12,2723316588
1769,14456770,8147973,22604743,2,0,0,37376,1,5697111504
1770,14459660,6527276,20986936,8,0,0,1536,11,326863545
1771,14460720,8937688,23398408,3,0,0,112640,18,3277208853
1772,14476050,34643628,49119678,7,0,1,4096,1,2453419116
1773,14477823,8013463,22491286,9,0,0,113152,4,3740418967
1774,14479600,8338279,22817879,3,0,0,23040,18,3197209806
1775,14489670,8490747,22980417,2,0,0,40960,1,2916374735
1776,14494840,6491605,20986445,2,0,0,4608,1,8166312372
1777,14496070,8597019,23093089,8,0,0,52224,11,6393903184
1778,14503989,34630920,49134909,5,0,1,512,12,5656354660
1779,14531730,34968398,49500128,1,0,1,133632,1,658789253
1780,14545759,34967990,49513749,3,0,1,7168,18,5729243869
1781,14549220,6981079,21530299,7,0,0,10240,1,10201396075
1782,14556360,7162446,21718806,3,0,0,22016,18,4093161799
1783,14560010,35050566,49610576,2,0,1,22016,1,5654423606
1784,14564370,35046229,49610599,4,0,1,28672,7,4192189282
1785,14567120,10004138,24571258,7,0,0,14336,1,7652372754
1786,14593970,8911026,23504996,1,0,0,108544,1,10632582305
1787,14596300,6626663,21222963,0,0,0,8192,6,2064365479
1788,14597270,35061937,49659207,1,0,1,3072,1,608840045
1789,14598040,7093881,21691921,6,0,0,2560,12,9737570692
1790,14603360,35055870,49659230,6,0,1,1536,12,7383462558
1791,14607980,7619430,22227410,7,0,0,28672,1,5905719903
1792,14614220,9009093,23623313,8,0,0,75264,11,10703249832
1793,14624050,35546395,50170445,1,0,1,199168,1,4024363448
1794,14625290,35745188,50370478,7,0,1,7680,1,700793037
1795,14637340,10073933,24711273,3,0,0,47616,18,9516508664
1796,14639190,8437964,23077154,7,0,0,9728,1,3956492533
1797,14646330,35755144,50401474,0,0,1,8192,6,521999452
1798,14654920,10329377,24984297,8,0,0,45056,11,9933065686
1799,14667560,7584365,22251925,3,0,0,80384,18,6960843200
1800,14668100,35734360,50402460,7,0,1,1536,1,5920204261
1801,14669920,7739241,22409161,8,0,0,35840,11,6796580296
1802,14670140,6814522,21484662,5,0,0,6144,12,668773766
1803,14678420,8144630,22823050,0,0,0,16896,6,3559461193
1804,14679750,10441989,25121739,5,0,0,96768,12,583185835
1805,14682570,8583960,23266530,0,0,0,41984,6,4517873454
1806,14684340,8588609,23272949,7,0,0,16896,1,8285708652
1807,14684376,10490721,25175097,2,0,0,3584,1,3731709721
1808,14693240,7918546,22611786,4,0,0,23040,7,9112792326
1809,14699270,7027515,21726785,8,0,0,26112,11,338147178
1810,14705340,35698426,50403766,4,0,1,2048,7,6793016125
1811,14705470,10568321,25273791,7,0,0,13824,1,8077199845
1812,14718020,8731725,23449745,4,0,0,13824,7,7954397226
1813,14725830,8316798,23042628,3,0,0,41472,18,7289417039
1814,14740580,8407225,23147805,1,0,0,13824,1,10625570996
1815,14744290,8979161,23723451,2,0,0,98816,1,9280443667
1816,14745990,9412629,24158619,2,0,0,4608,1,10201241011
1817,14753590,7738187,22491777,0,0,0,1536,6,2449954217
1818,14756610,35647412,50404022,6,0,1,9216,12,5530698331
1819,14762990,10945924,25708914,0,0,0,16384,6,4259038230
1820,14763930,6939113,21703043,8,0,0,32768,11,698732138
1821,14769809,35719752,50489561,3,0,1,18944,18,4690797069
1822,14778450,10701053,25479503,7,0,0,47616,1,8192785921
1823,14786130,7395821,22181951,6,0,0,24576,12,205890434
1824,14811580,35754774,50566354,6,0,1,42496,12,2068484059
1825,14823040,8134054,22957094,5,0,0,25600,12,5317400798
1826,14827610,8154702,22982312,4,0,0,6144,7,3274261869
1827,14839280,9585549,24424829,7,0,0,24576,1,8005810373
1828,14841440,36345062,51186502,1,0,1,221696,1,5630270169
1829,14841810,36344715,51186525,7,0,1,2048,1,2852941194
1830,14853140,11119317,25972457,7,0,0,287232,1,4149793610
1831,14862930,8568596,23431526,0,0,0,108032,6,9739290438
1832,14863430,7302925,22166355,5,0,0,38912,12,3907817354
1833,14864340,6596853,21461193,8,0,0,13824,11,981684355
1834,14864770,7938243,22803013,6,0,0,15872,12,10508015589
1835,14872740,7633169,22505909,9,0,0,24576,4,6363375920
1836,14873920,7965738,22839658,0,0,0,10752,6,6544302569
1837,14880970,8269666,23150636,7,0,0,9216,1,6664810006
1838,14900350,6518340,21418690,3,0,0,12288,18,695245826
1839,14915119,36271429,51186548,5,0,1,5632,12,506056103
1840,14916490,11219754,26136244,8,0,0,12288,11,5996265728
1841,14919330,7576081,22495411,4,0,0,8704,7,5151569113
1842,14921970,8911289,23833259,4,0,0,22528,7,9398794595
1843,14938060,6838550,21776610,5,0,0,10240,12,7146972594
1844,14946440,7574023,22520463,5,0,0,20992,12,8879026083
1845,14957100,7673740,22630840,9,0,0,13312,4,1479245983
1846,14960739,36225832,51186571,3,0,1,6656,18,8631694849
1847,14969430,9500985,24470415,9,0,0,25088,4,6811138007
1848,14977380,36244807,51222187,1,0,1,18944,1,10269749914
1849,14993600,9163592,24157192,5,0,0,34816,12,8307618090
1850,15005890,8355812,23361702,1,0,0,61952,1,273010214
1851,15014860,7169298,22184158,8,0,0,7168,11,3879051402
1852,15016770,36207043,51223813,6,0,1,2560,12,4159614520
1853,15018910,8568406,23587316,4,0,0,70144,7,6724014374
1854,15028531,36195628,51224159,9,0,1,512,4,2833259342
1855,15046980,8646340,23693320,0,0,0,62976,6,5768848926
1856,15049050,11083427,26132477,2,0,0,205312,1,927937862
1857,15060220,7214485,22274705,8,0,0,19456,11,10572426127
1858,15062700,9083838,24146538,2,0,0,135680,1,8493585628
1859,15069150,36198372,51267522,6,0,1,30208,12,2232139957
1860,15083460,11264760,26348220,0,0,0,97280,6,7919454315
1861,15084130,8137026,23221156,9,0,0,10752,4,7736251904
1862,15086670,7927044,23013714,1,0,0,512,1,3709128042
1863,15089320,7573319,22662639,7,0,0,9728,1,4988355717
1864,15095330,9145414,24240744,5,0,0,40448,12,1975910650
1865,15101740,7515373,22617113,5,0,0,17408,12,2877596765
1866,15109019,36160129,51269148,5,0,1,2560,12,3706757057
1867,15110980,7784095,22895075,5,0,0,35328,12,8742139432
1868,15119700,8067995,23187695,2,0,0,55808,1,5852100205
1869,15119999,36149495,51269494,5,0,1,512,12,2437921627
1870,15129570,36140270,51269840,2,0,1,512,1,10008590770
1871,15132609,36138857,51271466,3,0,1,2560,18,6670235913
1872,15135140,8808844,23943984,5,0,0,21504,12,868242779
1873,15137280,36137438,51274718,0,0,1,5120,6,1252826715
1874,15139330,11310131,26449461,8,0,0,110592,11,10258884330
1875,15152010,7922157,23074167,4,0,0,67584,7,4440434799
1876,15152429,36125515,51277944,5,0,1,5120,12,5032521973
1877,15152750,6861427,22014177,0,0,0,11264,6,8372325821
1878,15156150,7793121,22949271,7,0,0,46592,1,10693084206
1879,15163640,8402258,23565898,3,0,0,27136,18,1388302220
1880,15166480,9777510,24943990,8,0,0,13312,11,7581824115
1881,15175140,36107950,51283090,6,0,1,8192,12,2185850728
1882,15203771,36080395,51284166,9,0,1,13312,4,7391321812
1883,15204660,9488315,24692975,7,0,0,32256,1,8229727519
1884,15210670,36098808,51309478,2,0,1,18432,1,2159990209
1885,15212560,9626268,24838828,5,0,0,60928,12,9757715800
1886,15214511,36094990,51309501,8,0,1,2048,11,1398448003
1887,15235680,8205549,23441229,9,0,0,31744,4,111462476
1888,15251420,36058104,51309524,6,0,1,2048,12,3564794365
1889,15255580,7237156,22492736,3,0,0,3072,18,9695824000
1890,15263119,36046428,51309547,3,0,1,12288,18,1258690802
1891,15278870,8377405,23656275,3,0,0,93184,18,5619214662
1892,15287770,9652141,24939911,4,0,0,27648,7,9704794429
1893,15290581,36018989,51309570,9,0,1,18432,4,7318650220
1894,15296130,11296557,26592687,6,0,0,56320,12,5338270609
1895,15315920,36038716,51354636,0,0,1,1024,6,5012799114
1896,15321950,7476204,22798154,9,0,0,10240,4,9236808124
1897,15333630,9189576,24523206,4,0,0,16384,7,10084607534
1898,15336100,7680320,23016420,8,0,0,6656,11,3908229936
1899,15341890,11383142,26725032,8,0,0,78336,11,9135156614
1900,15348620,36027840,51376460,4,0,1,20992,7,6936130220
1901,15359100,10105872,25464972,0,0,0,101376,6,4794974893
1902,15359751,36106700,51466451,9,0,1,19456,4,4729226402
1903,15365290,8485108,23850398,2,0,0,32768,1,5375883702
1904,15375170,8716861,24092031,9,0,0,25600,4,4306182576
1905,15381209,36087957,51469166,5,0,1,5120,12,7382900962
1906,15381829,36088003,51469832,3,0,1,11264,18,7651700440
1907,15382640,8417042,23799682,3,0,0,25088,18,5066910191
1908,15383260,9815023,25198283,9,0,0,27648,4,7336544337
1909,15396970,8147906,23544876,1,0,0,33280,1,8050356117
1910,15397440,36136394,51533834,7,0,1,512,1,793499068
1911,15400380,7998207,23398587,5,0,0,512,12,8473389839
1912,15402760,9998761,25401521,8,0,0,320512,11,2220869676
1913,15436760,8490380,23927140,5,0,0,56832,12,4915752446
1914,15442990,8002341,23445331,5,0,0,4608,12,4560815350
1915,15449520,8545644,23995164,9,0,0,28160,4,8202951218
1916,15459370,8724570,24183940,5,0,0,5120,12,8122566703
1917,15464979,36078362,51543341,5,0,1,26112,12,7392394345
1918,15468820,8050395,23519215,7,0,0,46592,1,7354009936
1919,15473610,9960451,25434061,7,0,0,14336,1,8472810708
1920,15486499,36230783,51717282,3,0,1,19968,18,289656354
1921,15493310,8235312,23728622,5,0,0,16896,12,2007854118
1922,15499890,36217415,51717305,8,0,1,5120,11,5525739742
1923,15509500,8659929,24169429,4,0,0,19968,7,7789715821
1924,15510570,8117290,23627860,4,0,0,14848,7,7524329021
1925,15515190,9125145,24640335,1,0,0,51200,1,2568807564
1926,15520090,8149939,23670029,1,0,0,7168,1,88991343
1927,15525050,36225631,51750681,1,0,1,36864,1,1292932870
1928,15528150,8029457,23557607,9,0,0,25088,4,1129424628
1929,15550720,11518038,27068758,7,0,0,36352,1,266546651
1930,15560040,8638383,24198423,7,0,0,47104,1,7464494006
1931,15567470,8833437,24400907,9,0,0,82944,4,675732400
1932,15579930,8759027,24338957,5,0,0,75776,12,3444372315
1933,15608530,10008114,25616644,0,0,0,56832,6,580585686
1934,15610100,7486140,23096240,4,0,0,10240,7,1922699148
1935,15623520,9073222,24696742,3,0,0,12288,18,7475294893
1936,15640730,10085211,25725941,6,0,0,55808,12,10573400571
1937,15643689,36222212,51865901,5,0,1,1536,12,1117587824
1938,15645770,8913674,24559444,7,0,0,23552,1,4508074535
1939,15646000,8920867,24566867,7,0,0,10240,1,614570911
1940,15648000,7665423,23313423,2,0,0,8704,1,1809755012
1941,15662200,7994574,23656774,1,0,0,1536,1,8685321305
1942,15664260,8887985,24552245,4,0,0,95232,7,2377763160
1943,15667200,36202567,51869767,8,0,1,6144,11,9756744456
1944,15672140,36369288,52041428,8,0,1,31232,11,2777038486
1945,15676780,36479275,52156055,2,0,1,4096,1,7368622001
1946,15695880,7521977,23217857,9,0,0,10752,4,4084909227
1947,15696380,7052659,22749039,7,0,0,3584,1,7470069228
1948,15701709,36454369,52156078,3,0,1,512,18,3568011093
1949,15704550,7830155,23534705,3,0,0,4096,18,864833612
1950,15707530,8709780,24417310,1,0,0,53760,1,5434912891
1951,15709150,36446951,52156101,8,0,1,11264,11,6341626124
1952,15716700,7297661,23014361,3,0,0,2048,18,5714173416
1953,15728640,9179525,24908165,5,0,0,21504,12,10619418790
1954,15738360,9422135,25160495,6,0,0,56320,12,3848571967
1955,15744710,7593955,23338665,2,0,0,4608,1,9592548838
1956,15762621,36587916,52350537,9,0,1,33280,4,7981438632
1957,15771050,10293521,26064571,3,0,0,43520,18,8757922928
1958,15777190,10225710,26002900,4,0,0,99840,7,7793409000
1959,15778590,10103497,25882087,8,0,0,219648,11,1254235971
1960,15784890,9710837,25495727,8,0,0,25088,11,7065628340
1961,15785480,10392337,26177817,2,0,0,35328,1,9575830807
1962,15793100,11541988,27335088,2,0,0,24064,1,2097670912
1963,15798069,36569314,52367383,3,0,1,12800,18,2910817724
1964,15817280,9029223,24846503,2,0,0,25088,1,3828882714
1965,15822400,11359332,27181732,1,0,0,78336,1,4802372487
1966,15824880,8547676,24372556,7,0,0,55296,1,5373898946
1967,15830350,8195288,24025638,4,0,0,21504,7,10088658908
1968,15832150,10438579,26270729,7,0,0,28672,1,8594522308
1969,15835660,9423993,25259653,3,0,0,13824,18,5570004539
1970,15840940,10421030,26261970,8,0,0,259584,11,1151697606
1971,15847220,8324268,24171488,2,0,0,6656,1,2372697115
1972,15850570,36525825,52376395,6,0,1,2560,12,1895443958
1973,15860940,8565628,24426568,8,0,0,5632,11,3660081991
1974,15866160,36572094,52438254,0,0,1,16384,6,1981798913
1975,15866700,7577204,23443904,2,0,0,8704,1,3129766148
1976,15878751,36585184,52463935,9,0,1,30208,4,183762643
1977,15887230,36645001,52532231,2,0,1,5120,1,8062712907
1978,15887400,7558110,23445510,9,0,0,512,4,3120439352
1979,15894360,7946031,23840391,9,0,0,4608,4,2079927683
1980,15896670,10696976,26593646,5,0,0,3072,12,7228511160
1981,15902900,36671797,52574697,4,0,1,12800,7,10319902606
1982,15912660,8362247,24274907,2,0,0,71680,1,3147089802
1983,15918400,8334644,24253044,2,0,0,10240,1,5555790904
1984,15927330,8414458,24341788,8,0,0,9216,11,1539956383
1985,15928470,8799819,24728289,1,0,0,31232,1,4768280009
1986,15939770,10919272,26859042,9,0,0,109056,4,1184045216
1987,15942880,10730121,26673001,9,0,0,18432,4,9128705365
1988,15986740,36601931,52588671,7,0,1,6656,1,724825112
1989,15988630,10649820,26638450,8,0,0,33792,11,649585831
1990,15989400,8862742,24852142,9,0,0,18432,4,9127965468
1991,15989990,8521700,24511690,7,0,0,26624,1,10392912766
1992,16009530,8041221,24050751,3,0,0,32256,18,4503050417
1993,16045410,36543284,52588694,8,0,1,9216,11,8962085546
1994,16051120,36644603,52695723,1,0,1,14336,1,3754976720
1995,16053150,36677796,52730946,0,0,1,22528,6,330048124
1996,16056910,36679893,52736803,1,0,1,29184,1,7761843271
1997,16066260,9689579,25755839,4,0,0,24576,7,6586004121
1998,16068310,36887013,52955323,4,0,1,37376,7,6889411083
1999,16076780,11549286,27626066,3,0,0,68096,18,8746380693
2000,16081080,8739161,24820241,4,0,0,79872,7,1309802140
2001,16084480,8291109,24375589,7,0,0,9728,1,2299794811
2002,16086200,10198638,26284838,2,0,0,23552,1,1296981360
2003,16098180,36919306,53017486,4,0,1,9728,7,4541959960
2004,16102170,9317314,25419484,1,0,0,58880,1,6908219957
2005,16103450,8815853,24919303,8,0,0,26624,11,9772667492
2006,16105880,9493425,25599305,9,0,0,61440,4,10667264048
2007,16106230,8946621,25052851,5,0,0,26624,12,2485154674
2008,16109810,37127293,53237103,1,0,1,41984,1,8766843424
2009,16116940,11569384,27686324,9,0,0,32768,4,4368471014
2010,16119110,10706681,26825791,7,0,0,34816,1,7022413819
2011,16135090,10915188,27050278,2,0,0,57344,1,2086527400
2012,16148710,37095342,53244052,4,0,1,15872,7,1969230669
2013,16155240,9051685,25206925,6,0,0,22016,12,8627164786
2014,16169820,10981692,27151512,8,0,0,80896,11,9390353613
2015,16181240,8729920,24911160,1,0,0,9728,1,1941026810
2016,16194200,8236148,24430348,6,0,0,2048,12,6225103715
2017,16209310,9813072,26022382,2,0,0,19968,1,3232879737
2018,16230751,37013324,53244075,9,0,1,4608,4,6884609351
2019,16238830,10245871,26484701,3,0,0,30208,18,7688476793
2020,16240110,9926920,26167030,7,0,0,78336,1,1001664334
2021,16249120,11078590,27327710,3,0,0,106496,18,7568148253
2022,16269120,9353171,25622291,3,0,0,18432,18,8270380866
2023,16281830,9144073,25425903,3,0,0,20992,18,1429086830
2024,16298570,11567679,27866249,5,0,0,8192,12,8075867664
2025,16301900,36942198,53244098,7,0,1,512,1,1011714799
2026,16303230,10748787,27052017,7,0,0,5632,1,3370740190
2027,16319989,36924132,53244121,3,0,1,12288,18,8496767680
2028,16326519,36917625,53244144,5,0,1,1024,12,7613999143
2029,16327770,8248994,24576764,1,0,0,17920,1,6337919513
2030,16338330,11438676,27777006,2,0,0,33792,1,7746275539
2031,16343570,7935595,24279165,0,0,0,12288,6,618660527
2032,16351320,36972589,53323909,4,0,1,17408,7,6169768957
2033,16361230,10905195,27266425,1,0,0,35840,1,6678326275
2034,16371980,36951952,53323932,1,0,1,11776,1,68518019
2035,16407550,7867848,24275398,8,0,0,1536,11,5543035409
2036,16416360,9141829,25558189,5,0,0,68608,12,769487428
2037,16431580,9272319,25703899,9,0,0,16384,4,6918447482
2038,16436780,7992921,24429701,4,0,0,9728,7,6333067869
2039,16437410,36987994,53425404,2,0,1,17408,1,627121756
2040,16452880,9081559,25534439,2,0,0,25600,1,2325336773
2041,16457930,8729860,25187790,4,0,0,8704,7,10438601943
2042,16471720,9532763,26004483,0,0,0,5120,6,7946798317
2043,16471750,11478916,27950666,3,0,0,9728,18,3445916435
2044,16475930,8189457,24665387,9,0,0,1024,4,6139766597
2045,16476910,37014653,53491563,0,0,1,512,6,1097275666
2046,16488930,37003619,53492549,0,0,1,1536,6,8134427399
2047,16497000,9304055,25801055,9,0,0,36864,4,1116672883
2048,16502460,8560398,25062858,2,0,0,32768,1,5447500388
2049,16504050,8681065,25185115,9,0,0,12288,4,5096477469
2050,16509220,36984507,53493727,0,0,1,13824,6,4019287907
2051,16514470,36986473,53500943,4,0,1,12288,7,8302271470
2052,16534750,7968805,24503555,7,0,0,7680,1,4364757346
2053,16536200,8359953,24896153,3,0,0,13824,18,10313432456
2054,16537220,11065065,27602285,0,0,0,136192,6,678144983
2055,16543040,9734599,26277639,3,0,0,6656,18,2609428104
2056,16552010,11307017,27859027,6,0,0,45056,12,5775723357
2057,16560290,11639624,28199914,6,0,0,45056,12,4141867666
2058,16582940,37068998,53651938,0,0,1,27648,6,8150524929
2059,16596900,37168744,53765644,7,0,1,23040,1,5876862540
2060,16615780,37273438,53889218,7,0,1,7680,1,10115447799
2061,16616230,10934685,27550915,9,0,0,138752,4,5518469862
2062,16623190,37309017,53932207,4,0,1,17920,7,5895839005
2063,16626670,9516461,26143131,2,0,0,22528,1,2258583837
2064,16645520,9400129,26045649,0,0,0,76288,6,1225853964
2065,16655970,9662587,26318557,1,0,0,110592,1,1729237799
2066,16657420,8138462,24795882,4,0,0,50688,7,6225755596
2067,16668610,37263620,53932230,0,0,1,512,6,356554856
2068,16682810,37282696,53965506,1,0,1,17920,1,5340478165
2069,16704810,11205078,27909888,5,0,0,4096,12,5306142554
2070,16714660,10888272,27602932,0,0,0,2048,6,4740894422
2071,16730190,11293766,28023956,3,0,0,7168,18,772323838
2072,16748280,37333529,54081809,0,0,1,18944,6,3604137194
2073,16757730,9049276,25807006,5,0,0,19456,12,7488492899
2074,16758020,9311878,26069898,7,0,0,17408,1,8691118913
2075,16769850,37313733,54083583,2,0,1,12288,1,7825205266
2076,16793750,10972134,27765884,6,0,0,74240,12,3104638313
2077,16795800,9387055,26182855,8,0,0,11264,11,7855290263
2078,16802190,8627480,25429670,9,0,0,12288,4,5609537149
2079,16805870,11481434,28287304,9,0,0,68608,4,849781822
2080,16812760,11305137,28117897,5,0,0,23552,12,8498452813
2081,16826530,9224758,26051288,5,0,0,18432,12,1061974092
2082,16838540,9526674,26365214,7,0,0,22528,1,2592029367
2083,16841300,9517019,26358319,5,0,0,20992,12,780575521
2084,16862370,9022548,25884918,5,0,0,9216,12,4540509795
2085,16868920,37217569,54086489,4,0,1,4608,7,3197856308
2086,16871600,10315326,27186926,9,0,0,4096,4,10684472946
2087,16873170,9777315,26650485,2,0,0,39424,1,2601802790
2088,16888740,9290660,26179400,7,0,0,5120,1,9558027898
2089,16902040,10038969,26941009,9,0,0,64000,4,6566556118
2090,16947470,9328118,26275588,9,0,0,15872,4,7174525806
2091,16961860,11299839,28261699,2,0,0,55808,1,4375262033
2092,16969770,9489105,26458875,2,0,0,14848,1,5422869394
2093,16976659,37128706,54105365,3,0,1,6656,18,5484845971
2094,16979320,9436422,26415742,7,0,0,69120,1,6211935566
2095,16983020,8004154,24987174,5,0,0,9216,12,2310962104
2096,16985410,9409249,26394659,5,0,0,59904,12,1132706681
2097,16994950,8133745,25128695,9,0,0,22528,4,6100797860
2098,17003270,9796925,26800195,5,0,0,46592,12,3777506314
2099,17018530,9455968,26474498,1,0,0,51200,1,1623048857
2100,17029990,8061277,25091267,0,0,0,4096,6,8926901101
2101,17040340,37065048,54105388,7,0,1,512,1,736940861
2102,17043160,7947001,24990161,6,0,0,9728,12,8199600706
2103,17077860,8938346,26016206,4,0,0,38400,7,5234424864
2104,17081780,8400398,25482178,9,0,0,8704,4,1764107540
2105,17081940,9269914,26351854,8,0,0,11776,11,5564584889
2106,17081980,9619161,26701141,5,0,0,45056,12,4365873626
2107,17082300,8403653,25485953,0,0,0,12288,6,4186179635
2108,17084739,37123843,54208582,5,0,1,47104,12,10647865107
2109,17086870,9922857,27009727,7,0,0,36352,1,2608407595
2110,17092380,37117585,54209965,0,0,1,14848,6,8049731771
2111,17093050,37519960,54613010,8,0,1,2560,11,4640373535
2112,17093680,8482869,25576549,0,0,0,3072,6,2994042422
2113,17102900,9351428,26454328,0,0,0,15872,6,7619257191
2114,17110540,37502493,54613033,8,0,1,2560,11,4854967322
2115,17110880,9263062,26373942,7,0,0,19968,1,9455220716
2116,17112600,11474350,28586950,9,0,0,612352,4,5088786725
2117,17113110,10732166,27845276,1,0,0,91136,1,8402313885
2118,17122180,10786437,27908617,4,0,0,54784,7,5830313236
2119,17123500,37489556,54613056,0,0,1,5632,6,4591923573
2120,17124030,37531716,54655746,4,0,1,9216,7,6218234586
2121,17128190,11984039,29112229,9,0,0,1015296,4,1827911867
2122,17129380,37633098,54762478,1,0,1,5120,1,8468977227
2123,17138810,9988031,27126841,9,0,0,31232,4,1895455304
2124,17141890,10135011,27276901,7,0,0,29696,1,7450626859
2125,17148060,10346181,27494241,0,0,0,79360,6,2721690911
2126,17156770,10543469,27700239,3,0,0,43520,18,10141368567
2127,17166250,11462659,28628909,0,0,0,1536,6,8587520534
2128,17168680,11587575,28756255,0,0,0,80384,6,8560742868
2129,17174710,9699728,26874438,9,0,0,4608,4,577856986
2130,17198880,9275797,26474677,1,0,0,512,1,10044851344
2131,17209770,12014370,29224140,0,0,0,57856,6,2084075261
2132,17210020,37638177,54848197,7,0,1,12800,1,7191870513
2133,17227260,12054871,29282131,1,0,0,76288,1,3334096478
2134,17232510,10110869,27343379,2,0,0,27136,1,8606082634
2135,17243810,11487930,28731740,3,0,0,31232,18,4478789485
2136,17254070,12152964,29407034,9,0,0,100352,4,9390032299
2137,17271690,9924541,27196231,3,0,0,15872,18,1665099166
2138,17286400,37586491,54872891,7,0,1,41472,1,7452837653
2139,17301860,10499811,27801671,9,0,0,14848,4,9204106822
2140,17308070,10673645,27981715,5,0,0,11264,12,6784494125
2141,17315090,10312559,27627649,9,0,0,5120,4,7594324335
2142,17323460,9590661,26914121,6,0,0,23552,12,9528971339
2143,17326250,37546664,54872914,8,0,1,9216,11,7289900606
2144,17331180,11973085,29304265,3,0,0,14336,18,5164266496
2145,17349660,12004226,29353886,9,0,0,25600,4,1779664182
2146,17357600,11769948,29127548,9,0,0,50176,4,7830789004
2147,17369240,37544465,54913705,7,0,1,18432,1,8205931404
2148,17369680,12208398,29578078,5,0,0,244736,12,9133456544
2149,17371190,9517667,26888857,2,0,0,33792,1,3945740262
2150,17374210,37550100,54924310,1,0,1,1024,1,4357989729
2151,17377600,10084125,27461725,4,0,0,4608,7,6858935267
2152,17378980,10181786,27560766,5,0,0,32256,12,866669952
2153,17388000,10677457,28065457,9,0,0,43008,4,5979656428
2154,17394590,12106846,29501436,0,0,0,3072,6,4746728272
2155,17398810,8968923,26367733,4,0,0,8192,7,1255788207
2156,17405320,9461568,26866888,4,0,0,20480,7,8183693564
2157,17411410,12089020,29500430,6,0,0,45056,12,8305000817
2158,17429750,9624474,27054224,5,0,0,7168,12,2508605807
2159,17436340,10306089,27742429,6,0,0,6144,12,2259393005
2160,17438710,9762837,27201547,3,0,0,3072,18,2751412864
2161,17445610,9628186,27073796,6,0,0,14336,12,4808881420
2162,17460740,9399885,26860625,4,0,0,5120,7,8049851360
2163,17463420,10617769,28081189,5,0,0,35328,12,3223313194
2164,17499140,9257175,26756315,2,0,0,29696,1,526386087
2165,17503600,10676655,28180255,7,0,0,15360,1,6133699139
2166,17506140,9019673,26525813,8,0,0,15360,11,4306223279
2167,17506480,12478090,29984570,2,0,0,38400,1,58817796
2168,17507130,37417203,54924333,4,0,1,10752,7,2677654757
2169,17538380,11064372,28602752,3,0,0,48128,18,3704905757
2170,17548870,12208351,29757221,9,0,0,69632,4,5185641272
2171,17553220,12153530,29706750,3,0,0,357376,18,978401547
2172,17559580,10207107,27766687,2,0,0,2560,1,10331036559
2173,17564650,11734265,29298915,6,0,0,10752,12,1135542486
2174,17566660,12278824,29845484,6,0,0,78336,12,3339774618
2175,17590430,9419632,27010062,5,0,0,1024,12,268382142
2176,17597780,9587875,27185655,0,0,0,12800,6,467703889
2177,17599110,11182284,28781394,4,0,0,82432,7,7627159020
2178,17603420,9465985,27069405,9,0,0,2048,4,5734149783
2179,17641710,10744502,28386212,9,0,0,28672,4,5620680767
2180,17647530,10742605,28390135,6,0,0,12800,12,3792834347
2181,17648080,10472336,28120416,5,0,0,8192,12,6333190374
2182,17657470,37266886,54924356,1,0,1,7168,1,2612773019
2183,17658070,11494016,29152086,9,0,0,79360,4,3559994384
2184,17658660,9849956,27508616,4,0,0,47104,7,10549544883
2185,17659990,10274139,27934129,5,0,0,77824,12,1894065792
2186,17666170,10940308,28606478,9,0,0,5632,4,1843996068
2187,17673000,12400736,30073736,9,0,0,52224,4,6259084319
2188,17703980,11601556,29305536,9,0,0,4096,4,1649820883
2189,17705870,12080748,29786618,6,0,0,9728,12,5196845939
2190,17708080,10918747,28626827,4,0,0,28672,7,8254036543
2191,17720980,10867085,28588065,0,0,0,3584,6,5255721881
2192,17721640,10453061,28174701,6,0,0,19456,12,4794486527
2193,17725730,37232208,54957938,1,0,1,16384,1,2028665603
2194,17742740,10143843,27886583,4,0,0,37376,7,218457808
2195,17744910,10144044,27888954,6,0,0,7680,12,10679379425
2196,17761280,11725360,29486640,9,0,0,82944,4,10634598693
2197,17762620,37196959,54959579,0,0,1,4096,6,4044655165
2198,17763060,10329633,28092693,1,0,0,5632,1,8638266601
2199,17770100,12102464,29872564,9,0,0,4608,4,2186628714
2200,17779640,12758530,30538170,7,0,0,273920,1,9160905559
2201,17782010,9675509,27457519,2,0,0,4096,1,6055552913
2202,17784880,37205210,54990090,8,0,1,13824,11,9180074346
2203,17785390,11414813,29200203,3,0,0,157184,18,3610929336
2204,17785920,10003439,27789359,7,0,0,9728,1,10474158427
2205,17790990,10084174,27875164,8,0,0,29184,11,9311712350
2206,17801910,37251893,55053803,2,0,1,4096,1,2686029833
2207,17803550,11911716,29715266,4,0,0,5632,7,9471642827
2208,17808120,9902906,27711026,3,0,0,35328,18,4258721156
2209,17810970,10052760,27863730,4,0,0,15360,7,1717008261
2210,17812540,12090319,29902859,4,0,0,99328,7,3366867272
2211,17816450,9276458,27092908,1,0,0,3584,1,245861394
2212,17824499,37235103,55059602,5,0,1,19456,12,8990899050
2213,17845610,12799580,30645190,0,0,0,55296,6,9019694294
2214,17852940,10302613,28155553,2,0,0,15872,1,9991848316
2215,17861940,37229826,55091766,8,0,1,29184,11,7261458675
2216,17881180,11464837,29346017,3,0,0,83968,18,819706923
2217,17887439,37230627,55118066,3,0,1,6144,18,7888548173
2218,17887450,10717289,28604739,0,0,0,6144,6,5547134760
2219,17912100,37320627,55232727,8,0,1,6656,11,90862536
2220,17927161,37313412,55240573,8,0,1,16384,11,1917426518
2221,17941190,11358684,29299874,4,0,0,3072,7,10367222871
2222,17942429,37423212,55365641,3,0,1,16896,18,4673849836
2223,17946160,12363920,30310080,1,0,0,72192,1,9007862127
2224,17954530,37412097,55366627,7,0,1,1536,1,10612339888
2225,17957480,9478236,27435716,4,0,0,6144,7,8974929623
2226,17964300,12082067,30046367,4,0,0,75776,7,7532501928
2227,17973900,37397233,55371133,0,0,1,7168,6,838259374
2228,17980850,12150194,30131044,1,0,0,77312,1,7312874635
2229,17997480,9607815,27605295,2,0,0,7680,1,2145176788
2230,18005150,10639546,28644696,8,0,0,51712,11,3304073522
2231,18014079,37358360,55372439,3,0,1,2048,18,1172174966
2232,18021710,37353955,55375665,8,0,1,5120,11,7240492666
2233,18025940,10634543,28660483,0,0,0,51712,6,9790327902
2234,18038630,37343422,55382052,1,0,1,8192,1,1300247037
2235,18039680,9391352,27431032,1,0,0,7168,1,1661666987
2236,18051180,12688183,30739363,6,0,0,72192,12,9561481532
2237,18054040,11199942,29253982,1,0,0,97792,1,10466782026
2238,18058560,10744252,28802812,8,0,0,11264,11,7790755187
2239,18063410,10164360,28227770,9,0,0,29696,4,3472151520
2240,18069520,11391825,29461345,0,0,0,178176,6,5318652106
2241,18071730,12331541,30403271,7,0,0,11776,1,3088110200
2242,18076590,10123659,28200249,7,0,0,1024,1,3994249347
2243,18096220,11493205,29589425,3,0,0,36864,18,9532804493
2244,18118510,9698975,27817485,4,0,0,13824,7,1556464420
2245,18123360,12756667,30880027,9,0,0,53248,4,6218745905
2246,18134230,12479714,30613944,1,0,0,132096,1,6721575076
2247,18146940,9791580,27938520,5,0,0,14336,12,8324233892
2248,18150840,12532015,30682855,4,0,0,88064,7,2470611731
2249,18151430,11144186,29295616,3,0,0,12288,18,2773377751
2250,18186490,12643021,30829511,3,0,0,35328,18,5785467900
2251,18188890,12262966,30451856,1,0,0,37376,1,7897561310
2252,18192070,13244850,31436920,1,0,0,74240,1,28660246
2253,18194280,10139276,28333556,4,0,0,12800,7,3067466745
2254,18194620,13473657,31668277,5,0,0,19968,12,4147108882
2255,18217380,11140140,29357520,1,0,0,11776,1,1719835801
2256,18221950,13334475,31556425,4,0,0,80384,7,10052360853
2257,18232930,12775935,31008865,5,0,0,6144,12,5982789431
2258,18266480,12970739,31237219,9,0,0,53760,4,2758439431
2259,18277571,37184978,55462549,8,0,1,5632,11,5452713369
2260,18279640,11456342,29735982,1,0,0,15360,1,3704666763
2261,18282540,10920338,29202878,7,0,0,8704,1,5062611733
2262,18288550,10323567,28612117,9,0,0,18432,4,4629934324
2263,18292500,10325568,28618068,0,0,0,19456,6,2022660767
2264,18293380,10505977,28799357,8,0,0,58880,11,6565265852
2265,18296941,37165631,55462572,8,0,1,3072,11,7087406245
2266,18308730,37160159,55468889,0,0,1,15360,6,9191265643
2267,18320100,13024537,31344637,8,0,0,57344,11,8737220942
2268,18330220,10298190,28628410,8,0,0,5120,11,7976504760
2269,18333750,11487843,29821593,5,0,0,114688,12,6331887962
2270,18341470,10971577,29313047,2,0,0,24576,1,9212843094
2271,18345490,10946359,29291849,5,0,0,22528,12,3782231304
2272,18357271,37175577,55532848,9,0,1,2560,4,3888089487
2273,18358770,37263937,55622707,1,0,1,12288,1,1592837038
2274,18365070,9836184,28201254,3,0,0,3072,18,5230876982
2275,18369330,37535566,55904896,0,0,1,20480,6,5390117191
2276,18371200,9951009,28322209,3,0,0,1024,18,2692640896
2277,18371390,10314084,28685474,9,0,0,81920,4,3537610870
2278,18376370,11797027,30173397,1,0,0,63488,1,6121974665
2279,18379010,13200994,31580004,7,0,0,77312,1,3168401906
2280,18387780,11332813,29720593,7,0,0,17408,1,2549625748
2281,18394750,9959436,28354186,4,0,0,9728,7,1585703858
2282,18394840,13460201,31855041,2,0,0,16384,1,5853879301
2283,18397860,10754428,29152288,9,0,0,512,4,1987474082
2284,18406629,37582448,55989077,3,0,1,8192,18,608181540
2285,18413460,37575656,55989116,0,0,1,16896,6,9531168852
2286,18421650,10784839,29206489,7,0,0,11776,1,1516997704
2287,18421730,37584744,56006474,7,0,1,4096,1,3923505865
2288,18433790,11556887,29990677,0,0,0,19968,6,1149053593
2289,18435830,12128062,30563892,5,0,0,53760,12,9800497287
2290,18451760,11051727,29503487,8,0,0,6656,11,1389360778
2291,18455330,10921089,29376419,7,0,0,61952,1,9757466594
2292,18468579,37801793,56270372,3,0,1,47104,18,2637672868
2293,18484831,37785564,56270395,8,0,1,9728,11,307993797
2294,18485580,11298051,29783631,9,0,0,31744,4,5742972192
2295,18499609,37773484,56273093,5,0,1,6144,12,8594956616
2296,18500620,11212907,29713527,6,0,0,22016,12,7577762219
2297,18508510,37764606,56273116,4,0,1,15360,7,3084414287
2298,18512970,11441103,29954073,6,0,0,167936,12,898420527
2299,18517850,37859250,56377100,2,0,1,9728,1,5551248986
2300,18519140,11347918,29867058,7,0,0,55808,1,2966180887
2301,18526340,10794070,29320410,7,0,0,24064,1,658772748
2302,18529210,10729654,29258864,5,0,0,10240,12,2252146847
2303,18548060,12436071,30984131,3,0,0,3072,18,2494696031
2304,18555750,11218186,29773936,9,0,0,54784,4,1036626131
2305,18569940,10685781,29255721,0,0,0,5632,6,6867382010
2306,18584420,13522776,32107196,4,0,0,81408,7,4473182112
2307,18585040,11264991,29850031,2,0,0,14848,1,9721374461
2308,18593780,37824723,56418503,0,0,1,22016,6,9607793305
2309,18601050,11487061,30088111,7,0,0,47104,1,8445870688
2310,18606730,11451071,30057801,3,0,0,35328,18,8599709371
2311,18611470,11259667,29871137,9,0,0,13312,4,3636941303
2312,18625310,37796047,56421357,2,0,1,17920,1,5561690864
2313,18652430,11501592,30154022,2,0,0,61952,1,3332093904
2314,18653180,12042513,30695693,1,0,0,33792,1,8317016208
2315,18655420,11539239,30194659,4,0,0,49664,7,6677106973
2316,18658749,37767425,56426174,5,0,1,7680,12,130159134
2317,18663400,13642463,32305863,6,0,0,24576,12,1722825228
2318,18668850,11351427,30020277,9,0,0,30208,4,343299898
2319,18680430,12998213,31678643,7,0,0,33280,1,3972204078
2320,18683700,10601262,29284962,8,0,0,9216,11,10143431367
2321,18686840,38053366,56740206,8,0,1,8192,11,8714280131
2322,18693020,11698018,30391038,3,0,0,19968,18,7792000362
2323,18696650,10431233,29127883,2,0,0,1024,1,7833178671
2324,18724220,38181607,56905827,1,0,1,27648,1,8275750158
2325,18726860,11240028,29966888,2,0,0,41984,1,5016106557
2326,18732860,10864856,29597716,9,0,0,27136,4,2942915702
2327,18736820,11274222,30011042,0,0,0,26112,6,10688452414
2328,18743590,38293799,57037389,2,0,1,22016,1,8938277575
2329,18751900,12448135,31200035,0,0,0,8704,6,5207163745
2330,18753690,11246690,30000380,4,0,0,31744,7,7602177788
2331,18758660,11626271,30384931,3,0,0,106496,18,547740329
2332,18759370,13034205,31793575,8,0,0,60416,11,8938487009
2333,18759650,13113244,31872894,6,0,0,42496,12,3053419102
2334,18764180,38339910,57104090,0,0,1,2560,6,6235945273
2335,18766740,11521321,30288061,2,0,0,26624,1,8972513078
2336,18767260,13655580,32422840,0,0,0,74752,6,1605793284
2337,18772960,12740610,31513570,2,0,0,16896,1,10655933050
2338,18777580,38326533,57104113,8,0,1,512,11,10043499797
2339,18804070,13236153,32040223,8,0,0,89088,11,2845651454
2340,18804160,11938042,30742202,8,0,0,9216,11,1568606820
2341,18808700,13744644,32553344,3,0,0,22528,18,10184210139
2342,18818650,11316473,30135123,6,0,0,13312,12,4088879632
2343,18821850,10909429,29731279,0,0,0,34816,6,7842177670
2344,18824249,38288304,57112553,3,0,1,21504,18,4137216480
2345,18825360,11802959,30628319,6,0,0,47104,12,6183327121
2346,18827940,11219074,30047014,9,0,0,2048,4,8718905582
2347,18831310,11734345,30565655,7,0,0,5632,1,2473081525
2348,18834290,11441349,30275639,9,0,0,10752,4,1623310081
2349,18859130,38298001,57157131,4,0,1,3072,7,5210469280
2350,18860900,11951888,30812788,5,0,0,63488,12,5286249980
2351,18862771,38294383,57157154,9,0,1,1024,4,10115878069
2352,18865050,11589637,30454687,2,0,0,9216,1,9753753327
2353,18876710,11670398,30547108,4,0,0,4096,7,7376912154
2354,18883960,11687490,30571450,3,0,0,18944,18,4478375231
2355,18886340,11687317,30573657,4,0,0,7168,7,8207627950
2356,18901010,11784364,30685374,7,0,0,8192,1,7440087536
2357,18919409,38239933,57159342,5,0,1,5632,12,215509527
2358,18920000,11520422,30440422,9,0,0,121856,4,7222731504
2359,18924910,11789736,30714646,9,0,0,58368,4,9229823005
2360,18926120,11770688,30696808,3,0,0,3584,18,843103643
2361,18926290,38233398,57159688,7,0,1,512,1,8130677161
2362,18938640,11979917,30918557,2,0,0,46080,1,3978555178
2363,18939710,38225688,57165398,8,0,1,18944,11,4780010094
2364,18942960,11029879,29972839,6,0,0,19456,12,183467978
2365,18945270,38337031,57282301,7,0,1,5632,1,9314703255
2366,18954820,11299203,30254023,1,0,0,100352,1,7692026606
2367,18967390,13657782,32625172,2,0,0,11264,1,9012991509
2368,18969270,11747271,30716541,9,0,0,6144,4,982009595
2369,18970780,11818524,30789304,0,0,0,36352,6,7654897816
2370,18975170,11204334,30179504,4,0,0,19968,7,4499894483
2371,18998620,11718724,30717344,4,0,0,2560,7,10195197958
2372,19013720,11533769,30547489,8,0,0,1024,11,3474809325
2373,19015660,13779018,32794678,0,0,0,14848,6,4804058091
2374,19030550,11999124,31029674,4,0,0,57344,7,6330724292
2375,19030690,38287216,57317906,2,0,1,10240,1,8454856751
2376,19030700,39147274,58177974,8,0,1,296448,11,8848668489
2377,19069460,11202880,30272340,3,0,0,40960,18,4822466973
2378,19072520,39136806,58209326,4,0,1,42496,7,8796443291
2379,19072890,13213381,32286271,7,0,0,120832,1,991646956
2380,19078920,11697671,30776591,1,0,0,37376,1,8334119001
2381,19083249,39130614,58213863,3,0,1,512,18,6361075382
2382,19084019,39131150,58215169,5,0,1,2048,12,2950295475
2383,19091420,11888840,30980260,5,0,0,26112,12,10058071283
2384,19111340,10996125,30107465,4,0,0,28160,7,7525196454
2385,19127050,14002404,33129454,2,0,0,74752,1,2803422940
2386,19132500,11968733,31101233,7,0,0,8192,1,8868870734
2387,19146360,10856695,30003055,6,0,0,8704,12,6908394731
2388,19151610,14181963,33333573,1,0,0,18432,1,3012858638
2389,19158740,39077410,58236150,2,0,1,17920,1,9488031164
2390,19160160,12089585,31249745,0,0,0,19456,6,9736439848
2391,19163080,11602100,30765180,0,0,0,23040,6,2284887124
2392,19171260,11374577,30545837,0,0,0,25088,6,1490873327
2393,19172190,12485113,31657303,2,0,0,28672,1,4930540058
2394,19184870,11933660,31118530,8,0,0,25088,11,6072732408
2395,19201240,11055362,30256602,5,0,0,2560,12,4232154866
2396,19206460,11571737,30778197,1,0,0,3584,1,246469749
2397,19209370,12143064,31352434,5,0,0,4096,12,10091763995
2398,19227400,14319935,33547335,1,0,0,35328,1,1021909499
2399,19227800,11027338,30255138,7,0,0,3584,1,9793624324
2400,19228619,39007787,58236406,3,0,1,9216,18,8832165185
2401,19228880,11427120,30656000,3,0,0,35328,18,7226835576
2402,19243410,11648402,30891812,4,0,0,14336,7,4251061702
2403,19255330,11855507,31110837,3,0,0,18944,18,6979770268
2404,19259920,11820041,31079961,8,0,0,83456,11,10265299022
2405,19263090,12231082,31494172,1,0,0,54784,1,5545714233
2406,19273560,39033614,58307174,7,0,1,16896,1,3385777576
2407,19282190,39029424,58311614,7,0,1,1536,1,4479534510
2408,19297570,12228035,31525605,7,0,0,39424,1,7575500744
2409,19298250,11881549,31179799,3,0,0,26624,18,1262352451
2410,19310600,11447537,30758137,0,0,0,52224,6,8121411467
2411,19319260,11970335,31289595,6,0,0,4608,12,5314932432
2412,19319450,38992523,58311973,4,0,1,9728,7,5937588593
2413,19326710,11634355,30961065,8,0,0,15872,11,6132700305
2414,19332540,11444542,30777082,8,0,0,1536,11,5642075876
2415,19333900,39006615,58340515,8,0,1,16384,11,16766521
2416,19341950,13033915,32375865,2,0,0,45056,1,6292763672
2417,19343220,11687413,31030633,8,0,0,3072,11,6325405278
2418,19343500,12372900,31716400,4,0,0,66048,7,9872920484
2419,19358930,12081133,31440063,7,0,0,10240,1,10479034537
2420,19361021,39259131,58620152,9,0,1,3072,4,3753873316
2421,19369390,39394681,58764071,7,0,1,11264,1,1252164928
2422,19383400,13004224,32387624,6,0,0,20992,12,2607619614
2423,19389510,12118881,31508391,4,0,0,46592,7,3632626757
2424,19407130,39522186,58929316,0,0,1,13824,6,9905136914
2425,19407390,12236919,31644309,5,0,0,133120,12,4659550380
2426,19411960,11509272,30921232,5,0,0,8704,12,4394679363
2427,19412150,12391365,31803515,6,0,0,8704,12,9805856100
2428,19428850,40328853,59757703,8,0,1,315392,11,9210316573
2429,19465310,12384716,31850026,4,0,0,90112,7,2439481567
2430,19482690,41392939,60875629,8,0,1,640512,11,6333816445
2431,19487180,12998574,32485754,7,0,0,74752,1,3088494157
2432,19488250,11926027,31414277,3,0,0,125952,18,713283166
2433,19499210,11714385,31213595,5,0,0,17920,12,4521873527
2434,19500209,41375574,60875783,5,0,1,8704,12,665322641
2435,19504600,12084654,31589254,4,0,0,30208,7,3116860820
2436,19507710,12434123,31941833,2,0,0,17920,1,5750893415
2437,19521650,12285981,31807631,2,0,0,2048,1,2459151203
2438,19534430,11839828,31374258,4,0,0,512,7,4900724500
2439,19534491,41342918,60877409,9,0,1,2560,4,4191093683
2440,19542810,12046943,31589753,3,0,0,1536,18,6502254803
2441,19547280,11714615,31261895,3,0,0,20480,18,5925608700
2442,19549530,13200999,32750529,1,0,0,1536,1,4964717377
2443,19553840,41392821,60946661,8,0,1,88064,11,521770803
2444,19555790,12457266,32013056,1,0,0,10752,1,1028192305
2445,19563210,41383474,60946684,4,0,1,10240,7,8999032741
2446,19574330,12915659,32489989,1,0,0,13824,1,1648195961
2447,19575000,12669683,32244683,2,0,0,17408,1,2366659757
2448,19583140,11542535,31125675,7,0,0,9216,1,4667890324
2449,19609211,41352778,60961989,9,0,1,6656,4,5577447018
2450,19614290,14199219,33813509,0,0,0,527872,6,6968967011
2451,19616460,41471625,61088085,8,0,1,94208,11,2714556194
2452,19622970,12584291,32207261,5,0,0,317952,12,9198334645
2453,19663520,11710559,31374079,2,0,0,17408,1,2631055865
2454,19665720,14213744,33879464,0,0,0,19968,6,6816973018
2455,19668500,14316366,33984866,4,0,0,37376,7,1048882639
2456,19680200,41477765,61157965,7,0,1,2048,1,4501324513
2457,19704370,12155553,31859923,3,0,0,15872,18,1139786525
2458,19705470,12583967,32289437,5,0,0,10240,12,2237192043
2459,19707190,11941354,31648544,5,0,0,13824,12,5106946809
2460,19728520,11515274,31243794,4,0,0,21504,7,4330950814
2461,19743150,13116446,32859596,0,0,0,19456,6,1301464062
2462,19760200,12322169,32082369,2,0,0,57856,1,771343184
2463,19767690,12277373,32045063,0,0,0,12800,6,4337965165
2464,19769670,13132821,32902491,7,0,0,70656,1,963269821
2465,19772310,11670272,31442582,4,0,0,8192,7,8219407365
2466,19778340,41382531,61160871,1,0,1,4608,1,10699967090
2467,19786170,12118175,31904345,0,0,0,15872,6,4514776687
2468,19788940,12096035,31884975,7,0,0,30208,1,363794263
2469,19789700,12832017,32621717,3,0,0,49664,18,7540405288
2470,19812220,11849942,31662162,8,0,0,15872,11,276636315
2471,19813029,41405012,61218041,3,0,1,2560,18,3503306780
2472,19822900,13246854,33069754,3,0,0,82944,18,7416249255
2473,19824690,41393915,61218605,4,0,1,10752,7,10354831593
2474,19826090,12386966,32213056,5,0,0,18944,12,6267272790
2475,19840941,41488665,61329606,9,0,1,23040,4,7160526300
2476,19848721,41513636,61362357,9,0,1,512,4,9070360107
2477,19850160,11753566,31603726,5,0,0,11264,12,1290829281
2478,19852639,41510704,61363343,3,0,1,1536,18,3406611063
2479,19858420,12182614,32041034,5,0,0,2560,12,1764719734
2480,19864830,13230375,33095205,6,0,0,23040,12,10572050690
2481,19874120,41490196,61364316,1,0,1,12800,1,6467027107
2482,19881990,41577572,61459562,2,0,1,19456,1,2815450974
2483,19888700,12511341,32400041,2,0,0,25088,1,10593090410
2484,19897030,11978695,31875725,7,0,0,9216,1,1162321130
2485,19901690,12416567,32318257,5,0,0,30208,12,9705473657
2486,19904170,12613188,32517358,2,0,0,30208,1,9390519928
2487,19908589,41645970,61554559,3,0,1,54272,18,1767078098
2488,19928310,12412902,32341212,7,0,0,75264,1,7166105004
2489,19936590,12299155,32235745,5,0,0,12800,12,2085533614
2490,19937820,12371186,32309006,0,0,0,10240,6,3888666952
2491,19950270,12281552,32231822,3,0,0,55808,18,5677389998
2492,19963340,12147022,32110362,0,0,0,10240,6,1219798677
2493,19975550,11753064,31728614,5,0,0,14336,12,6765014326
2494,20013190,12691114,32704304,6,0,0,26624,12,3387062139
2495,20017820,12221536,32239356,0,0,0,11776,6,3667111378
2496,20021880,12192915,32214795,5,0,0,5632,12,1959164135
2497,20022980,12401755,32424735,0,0,0,6144,6,10428769368
2498,20030760,11499178,31529938,8,0,0,9728,11,10354875933
2499,20040550,41689594,61730144,8,0,1,192512,11,5771564863
2500,20061620,13115624,33177244,0,0,0,36352,6,7516040238
2501,20064510,41682618,61747128,2,0,1,15360,1,9083180688
2502,20067970,11656253,31724223,2,0,0,25600,1,2413971131
2503,20087530,11580934,31668464,6,0,0,512,12,320462225
2504,20090670,13237264,33327934,5,0,0,30720,12,8643239197
2505,20112130,13424418,33536548,5,0,0,159744,12,9443190979
2506,20116790,12327744,32444534,7,0,0,30208,1,5207404107
2507,20125640,12236474,32362114,8,0,0,46080,11,4266540957
2508,20128260,12418197,32546457,7,0,0,29696,1,5912705338
2509,20146790,12151562,32298352,3,0,0,29184,18,9427476399
2510,20150630,41601004,61751634,7,0,1,7168,1,7887121102
2511,20152911,41598979,61751890,9,0,1,9216,4,9876488712
2512,20154870,41637048,61791918,6,0,1,13824,12,10527517129
2513,20160631,41658231,61818862,9,0,1,11264,4,8708721366
2514,20163830,13709192,33873022,4,0,0,157184,7,4373940886
2515,20168310,13888258,34056568,8,0,0,51712,11,3224407803
2516,20181050,41668735,61849785,8,0,1,12288,11,4947475917
2517,20182870,12399048,32581918,5,0,0,24576,12,3493014502
2518,20184850,11701575,31886425,6,0,0,4608,12,8217393163
2519,20189470,12055704,32245174,6,0,0,1536,12,6805090219
2520,20190780,41670150,61860930,2,0,1,12288,1,9149634121
2521,20203770,12304361,32508131,1,0,0,34304,1,9651960512
2522,20222770,41679326,61902096,8,0,1,56832,11,7869056151
2523,20250211,41684842,61935053,9,0,1,20992,4,8459482267
2524,20260249,41677070,61937319,3,0,1,3584,18,848594279
2525,20263369,41676216,61939585,3,0,1,3584,18,5715962556
2526,20266100,13830137,34096237,8,0,0,86016,11,9562379486
2527,20268350,12079701,32348051,3,0,0,18944,18,8381460593
2528,20269460,13658525,33927985,2,0,0,108032,1,3512497529
2529,20272750,12655240,32927990,0,0,0,15872,6,2266598873
2530,20281270,12824911,33106181,8,0,0,22016,11,10102978380
2531,20293540,13907767,34201307,7,0,0,124416,1,7352039499
2532,20303610,11945822,32249432,1,0,0,13824,1,4494892491
2533,20315360,12694633,33009993,2,0,0,53760,1,882814525
2534,20318280,14254131,34572411,0,0,0,2048,6,479405402
2535,20318930,12545369,32864299,8,0,0,15360,11,10051755379
2536,20319960,14418840,34738800,4,0,0,93184,7,5687356237
2537,20322130,12671460,32993590,0,0,0,54784,6,9179219766
2538,20325030,12172626,32497656,6,0,0,25088,12,8876526481
2539,20331960,14713962,35045922,1,0,0,54272,1,2914363953
2540,20335490,12336357,32671847,2,0,0,17408,1,593145308
2541,20338939,41603552,61942491,5,0,1,4608,12,2601864930
2542,20348190,12233907,32582097,2,0,0,512,1,1044768432
2543,20351740,41620019,61971759,7,0,1,15360,1,3147690318
2544,20351960,12409466,32761426,0,0,0,33280,6,8347244674
2545,20366380,41687178,62053558,0,0,1,22016,6,2879447512
2546,20376690,12278657,32655347,0,0,0,7680,6,6285013626
2547,20379380,41675619,62054999,1,0,1,20992,1,2966264020
2548,20385770,12396660,32782430,8,0,0,14336,11,10033718790
2549,20386990,14017572,34404562,5,0,0,25088,12,7204331781
2550,20452120,12066844,32518964,7,0,0,5120,1,9804877526
2551,20469080,12501264,32970344,7,0,0,32768,1,174293161
2552,20473720,12545656,33019376,2,0,0,30720,1,1689109619
2553,20477140,14094624,34571764,1,0,0,68608,1,7709775010
2554,20481420,11860790,32342210,1,0,0,3072,1,7879509775
2555,20485170,14695048,35180218,1,0,0,72192,1,3325824437
2556,20493750,12924260,33418010,6,0,0,7168,12,4113321498
2557,20494240,12241541,32735781,3,0,0,12800,18,10458081432
2558,20500970,12716445,33217415,7,0,0,8192,1,9697972711
2559,20507930,13098898,33606828,6,0,0,53760,12,2391399735
2560,20515940,12899863,33415803,8,0,0,512,11,7155467614
2561,20527910,41535640,62063550,1,0,1,7680,1,1622605807
2562,20535940,41646786,62182726,4,0,1,6144,7,2638748417
2563,20548189,41634560,62182749,3,0,1,3072,18,5070672187
2564,20549840,12787188,33337028,2,0,0,11264,1,10201315765
2565,20556370,12261487,32817857,5,0,0,512,12,9037525855
2566,20565150,12749747,33314897,7,0,0,54784,1,2187363778
2567,20566180,12663967,33230147,3,0,0,4608,18,6194818281
2568,20567420,41615352,62182772,2,0,1,1536,1,16907526
2569,20568220,41614575,62182795,7,0,1,13312,1,1295411147
2570,20579440,12737508,33316948,3,0,0,6656,18,8339162584
2571,20585190,12867746,33452936,3,0,0,3584,18,2141970134
2572,20586130,12980805,33566935,2,0,0,26624,1,5649931943
2573,20622010,14021904,34643914,5,0,0,52224,12,10491190937
2574,20661130,12249923,32911053,6,0,0,1024,12,4128730035
2575,20666880,12944183,33611063,1,0,0,13824,1,8127331173
2576,20682670,41563099,62245769,8,0,1,1536,11,2206689551
2577,20683380,41568290,62251670,4,0,1,19968,7,701293382
2578,20698630,12716994,33415624,5,0,0,85504,12,2227777577
2579,20706720,11989449,32696169,3,0,0,4608,18,4714971221
2580,20711900,12557870,33269770,5,0,0,107008,12,8222323396
2581,20714550,13355424,34069974,6,0,0,5120,12,8204800174
2582,20721210,12123861,32845071,0,0,0,22528,6,10252525471
2583,20723320,12301227,33024547,1,0,0,16896,1,9393570573
2584,20733220,41719331,62452551,0,0,1,67584,6,612654284
2585,20737930,14796381,35534311,2,0,0,670720,1,222842912
2586,20738160,13086947,33825107,4,0,0,36864,7,1230075959
2587,20738320,41726966,62465286,8,0,1,23552,11,1036888191
2588,20740410,13154636,33895046,5,0,0,12288,12,1618417262
2589,20759550,12163035,32922585,7,0,0,3584,1,8918247085
2590,20775340,14849351,35624691,0,0,0,20992,6,6303160371
2591,20778560,12834585,33613145,5,0,0,6656,12,4415562287
2592,20783520,13335593,34119113,0,0,0,51200,6,6257889863
2593,20798290,13342387,34140677,7,0,0,10752,1,1302437040
2594,20802730,13160869,33963599,2,0,0,116736,1,8456801176
2595,20805480,13298010,34103490,2,0,0,16896,1,10274623904
2596,20827600,12243604,33071204,0,0,0,4608,6,7346604583
2597,20832510,41891193,62723703,8,0,1,47616,11,2520788109
2598,20836390,13176983,34013373,7,0,0,22528,1,375025863
2599,20837070,13036287,33873357,1,0,0,1024,1,5094988560
2600,20840550,13195809,34036359,3,0,0,72192,18,5309599596
2601,20840959,41902937,62743896,5,0,1,1536,12,4098229186
2602,20840990,12617889,33458879,7,0,0,512,1,2678201736
2603,20844899,41899020,62743919,5,0,1,6144,12,846416177
2604,20847590,13451962,34299552,8,0,0,7168,11,9047088002
2605,20856690,13280688,34137378,4,0,0,19456,7,166213704
2606,20859170,14869991,35729161,8,0,0,81408,11,5994926085
2607,20862700,12691077,33553777,4,0,0,4608,7,6271480865
2608,20869250,12204161,33073411,3,0,0,7168,18,5786326168
2609,20873570,13132916,34006486,2,0,0,40448,1,3046720151
2610,20892270,13101869,33994139,2,0,0,30208,1,2722466154
2611,20909830,13130000,34039830,2,0,0,11264,1,9432455791
2612,20910660,13157731,34068391,2,0,0,15360,1,4096505540
2613,20912799,41831143,62743942,3,0,1,8704,18,9593726858
2614,20924160,41819805,62743965,2,0,1,11264,1,9209210141
2615,20927440,12344583,33272023,1,0,0,7168,1,9249965052
2616,20952490,41825289,62777779,7,0,1,12800,1,8070264711
2617,20954540,13169954,34124494,1,0,0,4096,1,5405815154
2618,20963970,12594822,33558792,3,0,0,16384,18,615648814
2619,20972330,13424347,34396677,8,0,0,15872,11,4801921431
2620,20972570,13324535,34297105,1,0,0,2048,1,7338946492
2621,20975140,12673735,33648875,3,0,0,43520,18,1852708571
2622,20979360,13488612,34467972,6,0,0,8192,12,2844204153
2623,20979790,12407741,33387531,6,0,0,6144,12,1058712098
2624,20991190,13661483,34652673,6,0,0,28672,12,8523001925
2625,20993170,13517405,34510575,8,0,0,58368,11,10691714291
2626,21032210,13359608,34391818,8,0,0,13312,11,6484110225
2627,21068330,12484020,33552350,1,0,0,16384,1,4635166154
2628,21068740,41715619,62784359,4,0,1,19968,7,1601653340
2629,21068890,12904519,33973409,6,0,0,5120,12,4524639568
2630,21076910,12814369,33891279,0,0,0,38400,6,6442194046
2631,21078330,13397686,34476016,6,0,0,11264,12,7958693776
2632,21078430,12735414,33813844,2,0,0,1024,1,1810219154
2633,21082350,12532690,33615040,1,0,0,6144,1,7916577080
2634,21084180,13878548,34962728,4,0,0,17408,7,4860120076
2635,21102080,12961539,34063619,0,0,0,23040,6,2287937015
2636,21107540,41680685,62788225,6,0,1,6144,12,2820637085
2637,21119440,41678014,62797454,4,0,1,8192,7,2175650462
2638,21123829,41677811,62801640,3,0,1,6656,18,939417309
2639,21129100,12443006,33572106,0,0,0,16896,6,9859049212
2640,21133330,12519312,33652642,6,0,0,12288,12,628482339
2641,21161800,12467080,33628880,5,0,0,4096,12,3982275771
2642,21170530,13378700,34549230,7,0,0,1536,1,8177639315
2643,21186710,41617516,62804226,8,0,1,4096,11,9209453932
2644,21188170,13385356,34573526,4,0,0,3584,7,6101924774
2645,21201261,41633445,62834706,9,0,1,12288,4,3090126795
2646,21207780,13021967,34229747,8,0,0,19968,11,1192622752
2647,21210420,13086038,34296458,6,0,0,19456,12,1355586371
2648,21218580,13922482,35141062,2,0,0,10752,1,8613390875
2649,21229020,13728381,34957401,1,0,0,69632,1,3340011796
2650,21259510,12712293,33971803,1,0,0,5632,1,4220998192
2651,21268090,13494624,34762714,6,0,0,39936,12,6199057265
2652,21271350,12698668,33970018,5,0,0,20992,12,4436922255
2653,21278750,41567496,62846246,7,0,1,6656,1,1394330486
2654,21280040,13821489,35101529,2,0,0,17920,1,6071278517
2655,21305620,41541932,62847552,7,0,1,2048,1,2633358509
2656,21318100,41925970,63244070,8,0,1,76288,11,7879431541
2657,21322010,12807187,34129197,6,0,0,15360,12,7073757610
2658,21324840,13117484,34442324,8,0,0,11776,11,7481874197
2659,21332320,41911773,63244093,1,0,1,2560,1,4003710297
2660,21348340,12665992,34014332,8,0,0,3072,11,5182470082
2661,21349890,13808309,35158199,5,0,0,41472,12,161949884
2662,21355300,13311644,34666944,5,0,0,38912,12,10113858686
2663,21360690,12762533,34123223,6,0,0,13312,12,10196521667
2664,21378219,41919502,63297721,3,0,1,58368,18,6047620554
2665,21395270,13880781,35276051,1,0,0,53760,1,9397564933
2666,21402830,14413671,35816501,5,0,0,68608,12,5316931267
2667,21403870,13902055,35305925,3,0,0,26112,18,2488889761
2668,21425980,42040392,63466372,4,0,1,40448,7,6494677764
2669,21429080,12611709,34040789,1,0,0,3072,1,3873787632
2670,21429640,42036755,63466395,6,0,1,10240,12,1250070664
2671,21443570,42357012,63800582,0,0,1,189440,6,4656708844
2672,21453670,13094490,34548160,3,0,0,33792,18,2395680688
2673,21457330,14098064,35555394,1,0,0,69120,1,8218207717
2674,21461590,42375938,63837528,7,0,1,12800,1,9795391695
2675,21477230,14490505,35967735,7,0,0,403968,1,8449350387
2676,21516039,42321512,63837551,5,0,1,512,12,2902921828
2677,21519490,12611937,34131427,7,0,0,7168,1,7074575497
2678,21525750,12764686,34290436,0,0,0,8704,6,3165027882
2679,21535100,12563219,34098319,7,0,0,6656,1,4804062093
2680,21538460,13083536,34621996,2,0,0,9216,1,444696247
2681,21541120,14068503,35609623,3,0,0,68608,18,128820663
2682,21545710,42333555,63879265,1,0,1,9728,1,806391062
2683,21546490,13781585,35328075,0,0,0,27648,6,4848932545
2684,21552770,12976274,34529044,5,0,0,8192,12,500690725
2685,21566540,43683230,65249770,0,0,1,233472,6,6728691719
2686,21574070,14632048,36206118,3,0,0,11776,18,8812267706
2687,21576960,12914422,34491382,1,0,0,41984,1,2269598951
2688,21580119,43673517,65253636,3,0,1,6144,18,9132805996
2689,21623010,14210751,35833761,3,0,0,36352,18,651571365
2690,21631850,13586359,35218209,6,0,0,20992,12,2735134063
2691,21643209,43701027,65344236,3,0,1,7168,18,5707606069
2692,21663700,44515446,66179146,0,0,1,288256,6,1263092874
2693,21670680,14086832,35757512,4,0,0,30720,7,1202417130
2694,21671230,14033088,35704318,5,0,0,23040,12,2595064249
2695,21679860,44574102,66253962,4,0,1,31744,7,7986615540
2696,21705840,12911126,34616966,6,0,0,54272,12,7734386280
2697,21713470,13299156,35012626,4,0,0,72704,7,4107685052
2698,21724560,13025963,34750523,7,0,0,38400,1,1036134377
2699,21726991,44526994,66253985,9,0,1,20992,4,1675384232
2700,21760120,13043052,34803172,8,0,0,26624,11,6597819849
2701,21791120,13132206,34923326,9,0,0,80896,4,610283051
2702,21803770,12551210,34354980,5,0,0,2560,12,1214849427
2703,21805910,13181698,34987608,3,0,0,45568,18,6364568141
2704,21808290,14253899,36062189,7,0,0,36864,1,8036902033
2705,21811611,44452404,66264015,9,0,1,4608,4,2336326342
2706,21819020,14168550,35987570,0,0,0,65024,6,2942482135
2707,21828880,14222054,36050934,3,0,0,57856,18,8113762787
2708,21851830,12748577,34600407,4,0,0,25600,7,1755997595
2709,21876380,44395481,66271861,8,0,1,6656,11,4304798717
2710,21887250,13688429,35575679,3,0,0,19968,18,6585233258
2711,21891140,13171965,35063105,8,0,0,56320,11,5700747342
2712,21892250,13006405,34898655,0,0,0,9728,6,10593133664
2713,21932190,12506523,34438713,2,0,0,10240,1,6980179649
2714,21938120,14181084,36119204,7,0,0,26112,1,7435764995
2715,21939400,12956268,34895668,2,0,0,54784,1,7419150050
2716,21951250,14138518,36089768,5,0,0,9728,12,1289052238
2717,21951470,13016429,34967899,6,0,0,16896,12,10486873143
2718,21952390,12743628,34696018,1,0,0,13824,1,3537494521
2719,21979430,13280218,35259648,6,0,0,33792,12,5109536081
2720,21979870,14234227,36214097,2,0,0,26112,1,504031705
2721,21986239,44285645,66271884,5,0,1,10240,12,5301509835
2722,22004130,14282530,36286660,8,0,0,29696,11,1039409637
2723,22006200,13017351,35023551,5,0,0,18432,12,4927969599
2724,22007200,13198944,35206144,8,0,0,83456,11,7764594358
2725,22017529,44357361,66374890,3,0,1,3584,18,2269272307
2726,22033470,14623894,36657364,6,0,0,160256,12,531587393
2727,22033780,14142777,36176557,3,0,0,156672,18,1968830351
2728,22054030,13643245,35697275,6,0,0,184832,12,534358729
2729,22059650,12622777,34682427,3,0,0,5120,18,6707971436
2730,22059740,14209507,36269247,8,0,0,12800,11,9995571763
2731,22073830,13158750,35232580,2,0,0,32256,1,3578132658
2732,22074950,14493387,36568337,1,0,0,75264,1,8293144667
2733,22099420,14263303,36362723,2,0,0,61952,1,1891007584
2734,22100269,44295423,66395692,5,0,1,3584,12,2231550839
2735,22109770,12757337,34867107,1,0,0,21504,1,7915372714
2736,22118000,13978031,36096031,7,0,0,20480,1,7121880120
2737,22133190,13144912,35278102,5,0,0,6656,12,1701095215
2738,22149680,13596398,35746078,2,0,0,10752,1,4765316054
2739,22154020,14286558,36440578,6,0,0,24576,12,8972842500
2740,22157720,13875563,36033283,4,0,0,71680,7,2977797633
2741,22170129,44225586,66395715,5,0,1,2560,12,5520350537
2742,22172300,13445972,35618272,0,0,0,5120,6,3000961058
2743,22173030,14337804,36510834,8,0,0,19456,11,6512707541
2744,22189810,13373095,35562905,3,0,0,24576,18,8481024986
2745,22191741,44203997,66395738,9,0,1,10752,4,7435764023
2746,22192880,13918337,36111217,1,0,0,16384,1,1630300717
2747,22206839,44188922,66395761,3,0,1,50176,18,495836888
2748,22213510,14502948,36716458,0,0,0,45568,6,5477553083
2749,22224450,13056194,35280644,4,0,0,3584,7,5571300204
2750,22224510,14785156,37009666,8,0,0,93184,11,2654093057
2751,22229100,13404373,35633473,8,0,0,28672,11,6008957068
2752,22266530,12797846,35064376,6,0,0,4096,12,5544490761
2753,22268670,13526904,35795574,1,0,0,103424,1,4938798393
2754,22274030,14955481,37229511,1,0,0,17920,1,6013251846
2755,22274610,14385897,36660507,6,0,0,10240,12,7441069136
2756,22304600,12974929,35279529,6,0,0,4608,12,10162300099
2757,22312370,14482213,36794583,7,0,0,119296,1,371860754
2758,22358630,13210942,35569572,7,0,0,21504,1,5473450151
2759,22362540,13400143,35762683,4,0,0,16896,7,1220159256
2760,22365560,12917267,35282827,6,0,0,6656,12,6344749898
2761,22375760,13212936,35588696,5,0,0,30208,12,2007834211
2762,22387190,13249761,35636951,5,0,0,11264,12,7699733522
2763,22394860,12915966,35310826,5,0,0,5632,12,1522878182
2764,22405700,13676838,36082538,5,0,0,23552,12,9600636694
2765,22408280,13355759,35764039,6,0,0,4096,12,9770195320
2766,22412860,14253754,36666614,2,0,0,19968,1,806805627
2767,22417490,13592145,36009635,1,0,0,39936,1,8282710923
2768,22418260,13324519,35742779,5,0,0,12800,12,4769040277
2769,22433639,43962145,66395784,5,0,1,2048,12,4184673406
2770,22442520,13548193,35990713,1,0,0,10240,1,3458164841
2771,22466090,13982711,36448801,1,0,0,1024,1,1990379047
2772,22473710,13167210,35640920,1,0,0,12800,1,5230420722
2773,22484900,13588544,36073444,8,0,0,36864,11,575991149
2774,22486920,14874680,37361600,8,0,0,45056,11,3767593672
2775,22487880,13334782,35822662,3,0,0,19968,18,7427222505
2776,22490739,43905068,66395807,3,0,1,3584,18,568801055
2777,22490879,43905138,66396017,5,0,1,512,12,2969307110
2778,22495580,43924998,66420578,8,0,1,29184,11,9008596
2779,22499039,43921562,66420601,3,0,1,11264,18,8123594493
2780,22499090,13624037,36123127,5,0,0,12800,12,1802783130
2781,22509170,43916937,66426107,8,0,1,6656,11,9324446824
2782,22517280,13062189,35579469,7,0,0,12288,1,3765620689
2783,22524910,13091756,35616666,9,0,0,23040,4,6645274989
2784,22531710,14275064,36806774,1,0,0,39936,1,6253392772
2785,22547250,13200879,35748129,5,0,0,6656,12,712732973
2786,22555260,14999605,37554865,8,0,0,8192,11,6383290644
2787,22565190,13173666,35738856,6,0,0,31744,12,6662765301
2788,22572520,13556278,36128798,6,0,0,18432,12,6455526934
2789,22578870,43847260,66426130,0,0,1,4096,6,10331785417
2790,22579541,43846612,66426153,9,0,1,1536,4,8158992031
2791,22591969,43834207,66426176,5,0,1,1024,12,4244196984
2792,22592419,43833780,66426199,5,0,1,8704,12,10192131762
2793,22594790,14443470,37038260,5,0,0,40448,12,5456305925
2794,22596400,15046861,37643261,0,0,0,145920,6,8225916234
2795,22608760,13969740,36578500,0,0,0,33280,6,5660903736
2796,22609290,14461441,37070731,4,0,0,106496,7,768879771
2797,22611390,43821251,66432641,2,0,1,14848,1,1728585856
2798,22616910,13394464,36011374,8,0,0,5632,11,1483850709
2799,22622660,13452679,36075339,8,0,0,6144,11,3799172369
2800,22644490,13442291,36086781,5,0,0,13824,12,20015526
2801,22645000,14941891,37586891,2,0,0,12800,1,7815053209
2802,22647210,13186761,35833971,2,0,0,512,1,1955069638
2803,22652380,43780284,66432664,7,0,1,19456,1,10403685178
2804,22659100,13338344,35997444,6,0,0,22016,12,2681530622
2805,22678920,43761902,66440822,1,0,1,31744,1,2265643327
2806,22683220,13422982,36106202,5,0,0,33280,12,1866261388
2807,22692780,13532283,36225063,5,0,0,12800,12,7495262756
2808,22694440,43746405,66440845,2,0,1,1536,1,2328319868
2809,22698050,14412143,37110193,0,0,0,27136,6,3608687148
2810,22708160,13494347,36202507,4,0,0,51200,7,760574841
2811,22720010,13750475,36470485,1,0,0,6656,1,4380540204
2812,22721660,13465216,36186876,6,0,0,33792,12,4219370711
2813,22723320,13512652,36235972,7,0,0,29696,1,5179560400
2814,22730610,14249778,36980388,0,0,0,13312,6,173090606
2815,22740630,13480510,36221140,1,0,0,23040,1,3906763740
2816,22742810,13751670,36494480,7,0,0,31232,1,9709995620
2817,22747800,13929312,36677112,4,0,0,10240,7,7780625266
2818,22769170,13524941,36294111,5,0,0,8704,12,4938856511
2819,22778130,13823878,36602008,2,0,0,6144,1,898146974
2820,22779970,14638024,37417994,3,0,0,68096,18,7527610189
2821,22794009,43646859,66440868,5,0,1,512,12,1302878570
2822,22805779,43635112,66440891,3,0,1,16384,18,8671741742
2823,22818450,14379507,37197957,7,0,0,512,1,6304467895
2824,22835050,13838919,36673969,8,0,0,24064,11,1219401441
2825,22842440,13852323,36694763,0,0,0,57856,6,439501526
2826,22844359,43596555,66440914,5,0,1,6144,12,863486658
2827,22855770,13978433,36834203,6,0,0,35328,12,7500589223
2828,22858520,14693826,37552346,8,0,0,100864,11,9580421424
2829,22860130,13398374,36258504,4,0,0,11776,7,3969867816
2830,22865340,14933930,37799270,6,0,0,347136,12,3170712320
2831,22867230,14817323,37684553,0,0,0,71680,6,2459804189
2832,22868490,13727840,36596330,7,0,0,33792,1,9231764550
2833,22872500,43585464,66457964,8,0,1,5120,11,8738064301
2834,22881310,14269731,37151041,1,0,0,2048,1,6531757639
2835,22884420,14197878,37082298,7,0,0,37888,1,8573037400
2836,22886670,13699341,36586011,0,0,0,24576,6,5731551646
2837,22892710,14133203,37025913,4,0,0,53248,7,7000009045
2838,22893910,14930123,37824033,3,0,0,13824,18,7895621527
2839,22905350,43552677,66458027,4,0,1,23040,7,4752319600
2840,22909370,14382676,37292046,3,0,0,23552,18,186507903
2841,22912070,13811393,36723463,1,0,0,1536,1,3353703420
2842,22919120,14352254,37271374,5,0,0,22528,12,8995310332
2843,22934610,14041699,36976309,0,0,0,47616,6,7095614105
2844,22940330,14981162,37921492,6,0,0,232960,12,9181375998
2845,22947360,14877054,37824414,7,0,0,1024,1,6950721616
2846,22947890,43629142,66577032,0,0,1,67072,6,8382665504
2847,22949349,43628759,66578108,5,0,1,13312,12,7231689170
2848,22951810,14150092,37101902,1,0,0,32256,1,4917310916
2849,22955369,43623405,66578774,3,0,1,1024,18,902323228
2850,22957841,43837630,66795471,9,0,1,11264,4,6325567604
2851,22958330,45112124,68070454,0,0,1,348160,6,5314244720
2852,22960870,45179791,68140661,2,0,1,33280,1,8404926442
2853,22983260,13334456,36317716,2,0,0,5120,1,7449136110
2854,22997860,14193853,37191713,3,0,0,10752,18,9058308475
2855,22999570,45147932,68147502,8,0,1,1536,11,10273256906
2856,23000300,14214324,37214624,7,0,0,53248,1,7796908661
2857,23002660,14082001,37084661,5,0,0,7680,12,5965252830
2858,23003800,13812105,36815905,3,0,0,5120,18,152679849
2859,23011190,14976725,37987915,5,0,0,131584,12,10113355072
2860,23011230,14416178,37427408,0,0,0,7680,6,5106661648
2861,23028840,13571273,36600113,9,0,0,12288,4,3312736575
2862,23041250,15015154,38056404,3,0,0,52224,18,9183713555
2863,23047420,13559819,36607239,1,0,0,6656,1,1574047375
2864,23065330,14175197,37240527,0,0,0,8704,6,1077642232
2865,23067760,14357285,37425045,9,0,0,23040,4,9702667358
2866,23070630,14104071,37174701,1,0,0,30720,1,1282359281
2867,23087560,14369667,37457227,1,0,0,97792,1,3769522398
2868,23100300,14482668,37582968,0,0,0,92160,6,7634807127
2869,23102480,45045368,68147848,4,0,1,512,7,2127506804
2870,23102930,14262593,37365523,6,0,0,12800,12,7195670203
2871,23103240,14906850,38010090,3,0,0,72704,18,174854618
2872,23107480,14196571,37304051,1,0,0,2560,1,3964209145
2873,23140890,14376057,37516947,0,0,0,35840,6,7867812258
2874,23144080,45046094,68190174,2,0,1,20992,1,6239484355
2875,23148510,14916029,38064539,1,0,0,26624,1,8367270027
2876,23149830,14131250,37281080,9,0,0,3072,4,3021162561
2877,23153600,14320708,37474308,8,0,0,36352,11,565398908
2878,23157880,14363711,37521591,9,0,0,10752,4,8058775439
2879,23160990,45031539,68192529,4,0,1,15872,7,10222048379
2880,23166980,45027368,68194348,8,0,1,4096,11,9258167185
2881,23171650,13651766,36823416,6,0,0,24576,12,5323845352
2882,23173760,15007488,38181248,0,0,0,76288,6,1475640702
2883,23185220,15102891,38288111,4,0,0,3584,7,799808007
2884,23190730,13946164,37136894,1,0,0,26112,1,3539464865
2885,23190810,14908563,38099373,2,0,0,26112,1,6436079491
2886,23196080,15053875,38249955,8,0,0,95744,11,167804080
2887,23200850,14101639,37302489,4,0,0,3072,7,935632418
2888,23203840,14615912,37819752,5,0,0,67072,12,578547311
2889,23218550,44998680,68217230,1,0,1,7168,1,6123763612
2890,23229480,14917458,38146938,1,0,0,38912,1,10114780720
2891,23235980,14708981,37944961,2,0,0,27648,1,5768526740
2892,23240940,15221912,38462852,2,0,0,55296,1,4586918926
2893,23256710,14433973,37690683,7,0,0,512,1,10338416543
2894,23260070,14676444,37936514,0,0,0,34816,6,5993215353
2895,23261270,14779199,38040469,4,0,0,54272,7,2119600786
2896,23263880,15085513,38349393,3,0,0,2560,18,2443794872
2897,23270210,15367580,38637790,6,0,0,6656,12,1484206599
2898,23275220,15288263,38563483,0,0,0,22016,6,3344559899
2899,23281390,14409114,37690504,1,0,0,19456,1,1175407028
2900,23312570,14974426,38286996,0,0,0,79360,6,1125746953
2901,23324440,15004566,38329006,6,0,0,67072,12,2223193666
2902,23327080,14932258,38259338,7,0,0,30720,1,10108300893
2903,23331050,14313170,37644220,9,0,0,3072,4,6214846780
2904,23334690,14817263,38151953,2,0,0,16384,1,1646643636
2905,23337030,14060193,37397223,1,0,0,23552,1,8545054938
2906,23342550,14256220,37598770,7,0,0,38912,1,5828813111
2907,23355270,44864190,68219460,7,0,1,4096,1,5264043622
2908,23362790,44875436,68238226,6,0,1,3072,12,7045484752
2909,23373560,14705354,38078914,6,0,0,47104,12,203229738
2910,23382310,13924376,37306686,5,0,0,1536,12,5928467588
2911,23387760,14633296,38021056,8,0,0,23040,11,9071592545
2912,23388719,44849530,68238249,3,0,1,512,18,7606965801
2913,23390390,14992719,38383109,4,0,0,4096,7,7072335027
2914,23398390,44839882,68238272,4,0,1,33792,7,8437757558
2915,23400720,14449769,37850489,2,0,0,85504,1,5310646525
2916,23400870,45737635,69138505,0,0,1,351744,6,8182283245
2917,23401740,15135184,38536924,6,0,0,35840,12,4328017743
2918,23403990,15297981,38701971,4,0,0,24576,7,7804486549
2919,23405580,14608433,38014013,6,0,0,12800,12,7429112202
2920,23410750,14537042,37947792,4,0,0,9216,7,7767829155
2921,23412530,14235096,37647626,4,0,0,10752,7,3764788234
2922,23417280,14508603,37925883,3,0,0,14336,18,10020369195
2923,23422900,14599895,38022795,7,0,0,5632,1,348390244
2924,23426060,45854822,69280882,6,0,1,57344,12,7050773085
2925,23426100,45902449,69328549,6,0,1,3584,12,7032147815
2926,23428380,14264822,37693202,5,0,0,8192,12,1959356627
2927,23435240,14763260,38198500,5,0,0,28160,12,5921736868
2928,23440580,45890667,69331247,2,0,1,20480,1,3705007446
2929,23454280,15164022,38618302,7,0,0,116736,1,1080639334
2930,23466100,15412989,38879089,8,0,0,18432,11,7612727956
2931,23490500,15203960,38694460,7,0,0,30208,1,2279079693
2932,23491780,14935668,38427448,9,0,0,40960,4,167800671
2933,23520940,14502970,38023910,6,0,0,3584,12,9858658210
2934,23524020,45807250,69331270,6,0,1,1536,12,4726066509
2935,23525210,15344294,38869504,1,0,0,111616,1,6566276136
2936,23532400,14676903,38209303,7,0,0,35328,1,655066031
2937,23549730,15131031,38680761,5,0,0,104448,12,8330318103
2938,23554720,14635177,38189897,1,0,0,6144,1,7784779226
2939,23570830,14564229,38135059,9,0,0,28672,4,1368670420
2940,23571550,14513175,38084725,5,0,0,18944,12,10208023802
2941,23579850,14898694,38478544,7,0,0,3072,1,4334592571
2942,23583530,15288181,38871711,8,0,0,7168,11,1135041957
2943,23584860,14785334,38370194,5,0,0,13824,12,7005182683
2944,23600450,14789809,38390259,5,0,0,1024,12,8969819223
2945,23605500,14552427,38157927,0,0,0,9728,6,10619114458
2946,23611060,14914921,38525981,5,0,0,140288,12,10027108293
2947,23618820,14566507,38185327,5,0,0,13312,12,9102957165
2948,23666950,14487990,38154940,9,0,0,9728,4,7392287702
2949,23676250,14614388,38290638,9,0,0,8192,4,7041195570
2950,23676670,15146314,38822984,8,0,0,6656,11,5074017702
2951,23682720,14611217,38293937,5,0,0,10752,12,380349687
2952,23683240,14789174,38472414,1,0,0,4096,1,6205646299
2953,23683760,14949284,38633044,3,0,0,27648,18,10326617395
2954,23685029,45646264,69331293,5,0,1,10752,12,854235847
2955,23692610,15351055,39043665,4,0,0,40960,7,8091702106
2956,23719780,15370442,39090222,4,0,0,88064,7,6055851087
2957,23720290,15511603,39231893,9,0,0,52736,4,8088463603
2958,23729410,15486392,39215802,2,0,0,12800,1,2847898255
2959,23731720,14531073,38262793,5,0,0,11264,12,3385587530
2960,23736180,14846287,38582467,3,0,0,8704,18,2962802941
2961,23744200,15129250,38873450,2,0,0,5632,1,751392282
2962,23751530,15308226,39059756,1,0,0,52736,1,10727982588
2963,23754670,15195300,38949970,4,0,0,23552,7,10385016573
2964,23755440,14432562,38188002,0,0,0,8704,6,1531101838
2965,23776600,15573658,39350258,5,0,0,140800,12,2515909217
2966,23778470,14692673,38471143,9,0,0,27136,4,6984367270
2967,23780590,45550726,69331316,7,0,1,10752,1,2625972391
2968,23781770,15249392,39031162,5,0,0,66048,12,2946149591
2969,23783150,14841415,38624565,0,0,0,20480,6,8363506327
2970,23788420,45663740,69452160,7,0,1,16384,1,9608935590
2971,23792540,45686726,69479266,6,0,1,2048,12,859162211
2972,23808210,15403669,39211879,1,0,0,113152,1,10574998775
2973,23811600,14980704,38792304,4,0,0,24576,7,5380596916
2974,23813140,14538821,38351961,0,0,0,512,6,7111510390
2975,23818440,14571484,38389924,9,0,0,13824,4,9034238807
2976,23818560,14759752,38578312,9,0,0,14848,4,7851708997
2977,23830299,45652193,69482492,3,0,1,5120,18,3311591478
2978,23831120,15346260,39177380,9,0,0,33280,4,10704081252
2979,23837060,15602180,39439240,7,0,0,35840,1,6702157624
2980,23839150,14640041,38479191,0,0,0,2048,6,10381167337
2981,23844440,15441746,39286186,1,0,0,94208,1,4854302100
2982,23852950,45656899,69509849,0,0,1,14848,6,869693134
2983,23906900,45643362,69550262,4,0,1,512,7,3170897717
2984,23912520,14565065,38477585,1,0,0,16896,1,2167946287
2985,23917170,14984238,38901408,6,0,0,52736,12,1873492573
2986,23919390,15244302,39163692,0,0,0,24064,6,1507881670
2987,23919780,15726401,39646181,9,0,0,20992,4,7528674954
2988,23922129,45648303,69570432,3,0,1,14336,18,5278003675
2989,23922310,15314933,39237243,7,0,0,15360,1,7183480449
2990,23925770,47016326,70942096,0,0,1,527360,6,5017041113
2991,23926970,47500350,71427320,0,0,1,490496,6,1365605500
2992,23938850,15526368,39465218,8,0,0,41984,11,10460133467
2993,23941319,47518073,71459392,3,0,1,20992,18,7935969510
2994,23946100,16061992,40008092,5,0,0,161792,12,2349051937
2995,23946760,16182599,40129359,4,0,0,19968,7,5993747096
2996,23950020,15872785,39822805,3,0,0,56320,18,2080264278
2997,23951840,15464063,39415903,5,0,0,21504,12,7337468683
2998,23958430,15404019,39362449,3,0,0,39936,18,4713415459
2999,23959760,15438376,39398136,0,0,0,13824,6,2537301109
3000,23959880,15403372,39363252,4,0,0,2560,7,7183839148
3001,23980090,16353133,40333223,6,0,0,226304,12,6427431204
3002,23981420,14927366,38908786,1,0,0,11776,1,2991203019
3003,23988820,15074547,39063367,5,0,0,11776,12,6606918397
3004,23994199,47465539,71459738,3,0,1,512,18,686924070
3005,23994409,47530200,71524609,3,0,1,74240,18,6337379629
3006,24001170,47550922,71552092,7,0,1,16896,1,551109727
3007,24017590,47534525,71552115,1,0,1,12800,1,8419372957
3008,24022990,14886451,38909441,8,0,0,2048,11,4537868528
3009,24037620,15433104,39470724,4,0,0,3584,7,2587649147
3010,24042370,15692202,39734572,7,0,0,45056,1,9530500374
3011,24050290,15242315,39292605,8,0,0,20992,11,2955073954
3012,24055630,15584132,39639762,9,0,0,92672,4,6385416648
3013,24061330,15041894,39103224,9,0,0,26112,4,6576626996
3014,24068800,15340528,39409328,0,0,0,20992,6,1345799584
3015,24072230,15610850,39683080,5,0,0,37376,12,1220964375
3016,24079750,15369832,39449582,3,0,0,17920,18,7732067444
3017,24086440,16274615,40361055,3,0,0,2048,18,2920055965
3018,24088550,15510711,39599261,9,0,0,63488,4,5078264715
3019,24093940,14811235,38905175,4,0,0,12288,7,9723977972
3020,24106710,16015872,40122582,2,0,0,115712,1,7900570479
3021,24117140,15115400,39232540,0,0,0,2048,6,5769133684
3022,24127160,15960143,40087303,0,0,0,120832,6,2010780565
3023,24127810,14967435,39095245,4,0,0,16384,7,4865452101
3024,24138030,47414108,71552138,6,0,1,2048,12,10300454730
3025,24140191,47411970,71552161,9,0,1,20480,4,9180890579
3026,24144011,47414248,71558259,9,0,1,12800,4,5556360898
3027,24149750,14968702,39118452,1,0,0,6656,1,13925835
3028,24155960,15639179,39795139,8,0,0,13312,11,2206842809
3029,24169530,16001440,40170970,9,0,0,102400,4,10110888348
3030,24170860,15123952,39294812,0,0,0,7168,6,6872582685
3031,24172640,15271459,39444099,9,0,0,15872,4,4394561501
3032,24179260,47403041,71582301,1,0,1,32256,1,1114894029
3033,24199690,15689218,39888908,5,0,0,31232,12,10498112432
3034,24203110,15266499,39469609,5,0,0,14336,12,3096377633
3035,24213160,15437568,39650728,8,0,0,14848,11,335954289
3036,24230320,15296679,39526999,8,0,0,16384,11,741462795
3037,24232310,15282701,39515011,9,0,0,3584,4,8128772642
3038,24233020,15452579,39685599,9,0,0,8192,4,5834363668
3039,24241660,15637709,39879369,8,0,0,48640,11,4491861615
3040,24280100,15623534,39903634,4,0,0,35328,7,3276883442
3041,24284130,15479975,39764105,6,0,0,22528,12,1162065278
3042,24309600,15822598,40132198,9,0,0,9216,4,8755309435
3043,24311370,16181669,40493039,3,0,0,102400,18,1135274250
3044,24320570,15802682,40123252,0,0,0,512,6,6992856095
3045,24330860,15933388,40264248,6,0,0,44544,12,9311888182
3046,24349570,15556895,39906465,7,0,0,9216,1,3472160693
3047,24353840,16003742,40357582,5,0,0,79872,12,241038598
3048,24355910,47269460,71625370,8,0,1,19456,11,8201717099
3049,24361080,15570615,39931695,5,0,0,12288,12,10563556409
3050,24372130,16327273,40699403,3,0,0,54272,18,5189159745
3051,24373490,15540102,39913592,5,0,0,23040,12,4354184326
3052,24373730,15519101,39892831,7,0,0,12800,1,2011128666
3053,24387300,47246690,71633990,6,0,1,7168,12,8192093994
3054,24398430,15407184,39805614,6,0,0,34304,12,6170508537
3055,24403480,16131053,40534533,9,0,0,40960,4,8990029659
3056,24406330,15458196,39864526,6,0,0,72192,12,1924447221
3057,24408140,15540860,39949000,1,0,0,27648,1,1134319255
3058,24422409,47211735,71634144,3,0,1,8704,18,8613609918
3059,24423610,16174784,40598394,7,0,0,10752,1,2776496805
3060,24427880,15308454,39736334,9,0,0,5632,4,8432270566
3061,24441870,47197699,71639569,4,0,1,13824,7,1942571509
3062,24463070,15979977,40443047,0,0,0,39936,6,10348841787
3063,24475590,15560362,40035952,5,0,0,28160,12,2988056455
3064,24476271,47166204,71642475,9,0,1,4608,4,5420780110
3065,24489440,15633633,40123073,7,0,0,1536,1,1142897489
3066,24491940,16190904,40682844,5,0,0,22528,12,4659353976
3067,24494339,47182152,71676491,3,0,1,512,18,500341625
3068,24508530,47168320,71676850,2,0,1,9728,1,4684433395
3069,24508800,15849593,40358393,3,0,0,2560,18,9462951586
3070,24521020,15658085,40179105,6,0,0,26624,12,2985615782
3071,24529170,16025400,40554570,3,0,0,26112,18,3363039320
3072,24531050,47146364,71677414,4,0,1,10752,7,10464340312
3073,24543890,15373937,39917827,1,0,0,13824,1,3848484833
3074,24548320,16046775,40595095,2,0,0,89088,1,1260113443
3075,24560840,16225206,40786046,6,0,0,43008,12,1058179676
3076,24584160,15846696,40430856,2,0,0,19456,1,5131913587
3077,24597560,47145549,71743109,0,0,1,77824,6,1072002708
3078,24597700,16359425,40957125,4,0,0,148480,7,10051201856
3079,24599130,16373230,40972360,1,0,0,4608,1,9975698041
3080,24607771,47143349,71751120,9,0,1,16896,4,4496263499
3081,24615020,47139326,71754346,4,0,1,5120,7,4579086328
3082,24615910,15566026,40181936,7,0,0,9216,1,386668043
3083,24616920,16202364,40819284,2,0,0,75776,1,10658200023
3084,24619080,15580483,40199563,6,0,0,16896,12,6447420177
3085,24631170,16508163,41139333,0,0,0,117760,6,3901059742
3086,24633100,16366728,40999828,7,0,0,4608,1,8669488473
3087,24649330,16204521,40853851,4,0,0,47104,7,3061561675
3088,24653870,47105622,71759492,7,0,1,8192,1,10509915586
3089,24654500,47110950,71765450,7,0,1,4096,1,4394104226
3090,24659350,16205257,40864607,1,0,0,18432,1,1334035853
3091,24669770,16031840,40701610,0,0,0,7168,6,4789973418
3092,24671660,16496193,41167853,2,0,0,36352,1,1006246737
3093,24683620,15871753,40555373,9,0,0,2560,4,606316233
3094,24683990,47086286,71770276,2,0,1,7680,1,4447242772
3095,24686880,16623615,41310495,3,0,0,95232,18,2504191762
3096,24688700,16215677,40904377,2,0,0,16384,1,10729505851
3097,24689660,47736113,72425773,0,0,1,301056,6,7696619925
3098,24711030,16725379,41436409,6,0,0,45056,12,5089268840
3099,24712390,16391040,41103430,2,0,0,111616,1,6999654444
3100,24727420,15915851,40643271,2,0,0,64000,1,8901225121
3101,24732870,16413974,41146844,5,0,0,24576,12,512813440
3102,24738520,16531307,41269827,8,0,0,102912,11,2919932890
3103,24739110,47691643,72430753,1,0,1,19968,1,5477726689
3104,24743110,15750576,40493686,7,0,0,2048,1,6378093314
3105,24744890,15975619,40720509,4,0,0,61952,7,1607336384
3106,24746150,16581380,41327530,3,0,0,55808,18,1592504376
3107,24755210,16129641,40884851,0,0,0,44544,6,10445622452
3108,24756970,16032464,40789434,2,0,0,9728,1,3659286786
3109,24766440,16132922,40899362,7,0,0,37888,1,9159792149
3110,24777310,47658627,72435937,8,0,1,2560,11,10436839213
3111,24787970,16033232,40821202,2,0,0,3072,1,174628581
3112,24799450,16708401,41507851,6,0,0,41472,12,5197406319
3113,24810180,16046190,40856370,2,0,0,8192,1,6874029316
3114,24815640,16458133,41273773,4,0,0,6656,7,10272911279
3115,24817580,16002663,40820243,2,0,0,3072,1,1091421896
3116,24818050,16204711,41022761,5,0,0,32256,12,8607217581
3117,24818640,16338114,41156754,3,0,0,3072,18,8589864379
3118,24837460,16230541,41068001,6,0,0,39424,12,6865316295
3119,24838851,47641577,72480428,9,0,1,22528,4,10130690266
3120,24841200,16117976,40959176,6,0,0,6656,12,2078724346
3121,24846650,16735487,41582137,8,0,0,22016,11,4772801641
3122,24851710,16420012,41271722,0,0,0,6144,6,1636164666
3123,24854530,16315218,41169748,3,0,0,6144,18,8567667703
3124,24862320,16337493,41199813,0,0,0,6144,6,869010021
3125,24873280,16298831,41172111,3,0,0,7680,18,4368634223
3126,24876360,16494497,41370857,1,0,0,4096,1,3062060400
3127,24883350,47607370,72490720,4,0,1,27648,7,4749231157
3128,24888030,47629924,72517954,6,0,1,3072,12,5744490317
3129,24894280,47633396,72527676,2,0,1,17920,1,8278174657
3130,24904710,16313743,41218453,5,0,0,27648,12,3239715205
3131,24906560,16303273,41209833,7,0,0,13824,1,10720890999
3132,24912370,47641715,72554085,8,0,1,16896,11,4386473440
3133,24912780,16323048,41235828,8,0,0,26112,11,7265552596
3134,24915930,16274637,41190567,6,0,0,4096,12,10492394812
3135,24923360,16496356,41419716,4,0,0,20992,7,9106401403
3136,24931990,16401803,41333793,9,0,0,20480,4,8108394160
3137,24951140,16223072,41174212,9,0,0,4608,4,3217033411
3138,24956190,16553400,41509590,7,0,0,5632,1,8201490328
3139,24965080,16386944,41352024,3,0,0,4608,18,8138525874
3140,24980130,16648483,41628613,4,0,0,8192,7,2893378928
3141,24989230,16567016,41556246,2,0,0,45056,1,7348099216
3142,24998540,47659793,72658333,0,0,1,112128,6,6648545778
3143,25004400,16277040,41281440,8,0,0,25088,11,7988003555
3144,25012330,16325386,41337716,2,0,0,12800,1,2393529904
3145,25012480,16997250,42009730,5,0,0,24064,12,50440350
3146,25014020,16701932,41715952,5,0,0,20480,12,7934571655
3147,25016629,47961169,72977798,5,0,1,180224,12,5143956556
3148,25027761,47950060,72977821,9,0,1,6656,4,1859081992
3149,25046039,47939202,72985241,3,0,1,13824,18,2363118469
3150,25049570,16606189,41655759,9,0,0,19456,4,17085910
3151,25051470,16685627,41737097,0,0,0,3584,6,220500180
3152,25092960,16449535,41542495,6,0,0,22016,12,419816382
3153,25098630,16290415,41389045,0,0,0,15872,6,10709329442
3154,25102630,47883789,72986419,8,0,1,13824,11,9312177645
3155,25112260,16451185,41563445,3,0,0,23552,18,6873471068
3156,25118990,47884064,73003054,0,0,1,6656,6,3165002777
3157,25119170,47889335,73008505,2,0,1,6656,1,2220766230
3158,25131870,16403894,41535764,4,0,0,46080,7,9318034671
3159,25136210,16955462,42091672,9,0,0,65024,4,7344099133
3160,25139479,47892149,73031628,3,0,1,7168,18,4295179450
3161,25148280,16587694,41735974,2,0,0,50176,1,2917666900
3162,25152750,16647449,41800199,4,0,0,17408,7,1250922903
3163,25155250,16744241,41899491,2,0,0,32256,1,3473573025
3164,25157300,17053244,42210544,9,0,0,79872,4,9040155770
3165,25170450,17129476,42299926,5,0,0,135168,12,7736898342
3166,25172370,16522266,41694636,3,0,0,24064,18,9430550498
3167,25173330,16547325,41720655,9,0,0,15360,4,9933173026
3168,25183670,16580629,41764299,9,0,0,6656,4,10604920864
3169,25184020,16695830,41879850,4,0,0,40960,7,9937781496
3170,25187160,47847054,73034214,1,0,1,4096,1,6344258501
3171,25194670,47856489,73051159,1,0,1,3584,1,1553426354
3172,25196910,16611426,41808336,7,0,0,7168,1,2314055995
3173,25222670,17110658,42333328,5,0,0,11776,12,8817300600
3174,25232980,16617311,41850291,1,0,0,22016,1,2136498052
3175,25256020,16719755,41975775,6,0,0,18432,12,1160726504
3176,25266630,47784552,73051182,2,0,1,3584,1,6092919842
3177,25267150,17191824,42458974,3,0,0,4608,18,10343273859
3178,25271469,48499296,73770765,5,0,1,387072,12,7958646103
3179,25281600,48494657,73776257,4,0,1,17920,7,5677387290
3180,25282670,16880415,42163085,1,0,0,46592,1,4030880670
3181,25294020,16844332,42138352,6,0,0,14336,12,2816514198
3182,25294550,48500460,73795010,8,0,1,4096,11,3389301492
3183,25303030,17003962,42306992,3,0,0,12288,18,10630949018
3184,25333610,16649448,41983058,7,0,0,8192,1,6305584683
3185,25335250,16978317,42313567,8,0,0,21504,11,7027328552
3186,25338120,48483901,73822021,7,0,1,30720,1,9890070804
3187,25343830,16959395,42303225,3,0,0,10752,18,1521667670
3188,25350150,16865525,42215675,6,0,0,11264,12,6962777772
3189,25354750,16902705,42257455,1,0,0,23552,1,4297136917
3190,25360640,16811787,42172427,7,0,0,512,1,3954923250
3191,25384110,17000196,42384306,2,0,0,1024,1,5712877667
3192,25389140,48432904,73822044,4,0,1,14336,7,5483421186
3193,25390160,48452785,73842945,4,0,1,12800,7,8605243841
3194,25396719,48490199,73886918,5,0,1,15360,12,10141993522
3195,25399340,17377900,42777240,6,0,0,22016,12,10463204241
3196,25404610,17418437,42823047,8,0,0,15872,11,10161129061
3197,25407760,48593513,74001273,7,0,1,61440,1,1454252831
3198,25413580,16908746,42322326,7,0,0,28672,1,4904968873
3199,25425430,16995205,42420635,9,0,0,41472,4,10627564431
3200,25432560,16752370,42184930,5,0,0,40960,12,435082764
3201,25443229,48652797,74096026,3,0,1,4608,18,4352068411
3202,25444020,17420661,42864681,6,0,0,6656,12,4448024759
3203,25450110,48661447,74111557,0,0,1,25600,6,5822224709
3204,25470030,16975505,42445535,2,0,0,12288,1,3696598185
3205,25473380,16752496,42225876,6,0,0,8704,12,2245959018
3206,25477320,48773209,74250529,8,0,1,5632,11,5301296771
3207,25485230,16945579,42430809,0,0,0,24576,6,3823836187
3208,25488710,48856111,74344821,8,0,1,36864,11,2351342233
3209,25489200,17085970,42575170,0,0,0,48128,6,7183988575
3210,25498300,16884252,42382552,5,0,0,27136,12,9675230591
3211,25504050,48844637,74348687,7,0,1,6144,1,9470792923
3212,25512700,48845982,74358682,4,0,1,4608,7,7627024120
3213,25514570,17527264,43041834,4,0,0,35840,7,5540053141
3214,25526900,17063335,42590235,3,0,0,47616,18,3564216291
3215,25543079,48915879,74458958,5,0,1,84480,12,9544576254
3216,25549590,17442131,42991721,4,0,0,21504,7,4178052222
3217,25551501,48939865,74491366,9,0,1,17408,4,532500645
3218,25558830,16920645,42479475,7,0,0,11776,1,6905981723
3219,25560940,17667068,43228008,1,0,0,145920,1,6782006675
3220,25566930,48924459,74491389,2,0,1,8704,1,4762175884
3221,25591640,17198594,42790234,1,0,0,40448,1,7604269933
3222,25592090,17438785,43030875,1,0,0,32256,1,9996936783
3223,25613200,16947283,42560483,5,0,0,14848,12,2366908642
3224,25623090,17361964,42985054,1,0,0,143872,1,2561032745
3225,25625430,48865982,74491412,2,0,1,512,1,3685957839
3226,25629950,16972788,42602738,7,0,0,40960,1,1578431004
3227,25634460,17700743,43335203,0,0,0,65024,6,4226459835
3228,25638130,16997497,42635627,0,0,0,11264,6,9651084884
3229,25645420,17214778,42860198,0,0,0,121856,6,9640359790
3230,25651440,17163123,42814563,0,0,0,15360,6,9453076025
3231,25653041,48838394,74491435,9,0,1,4096,4,987489616
3232,25691660,17462749,43154409,8,0,0,113664,11,1649756534
3233,25692430,17325990,43018420,1,0,0,87552,1,3588059171
3234,25708060,48783398,74491458,1,0,1,14336,1,6674788195
3235,25711959,48779522,74491481,3,0,1,4096,18,1373902541
3236,25719910,17301075,43020985,8,0,0,1024,11,8203289013
3237,25757980,17019907,42777887,9,0,0,2048,4,35438642
3238,25762310,17100320,42862630,6,0,0,3072,12,4445136337
3239,25767030,17306508,43073538,6,0,0,33280,12,8960190322
3240,25784220,48826827,74611047,7,0,1,512,1,6476263660
3241,25793640,17362820,43156460,1,0,0,6656,1,9854472074
3242,25798930,17122724,42921654,4,0,0,20992,7,1901081783
3243,25800050,17246019,43046069,2,0,0,13824,1,3434402347
3244,25812731,48804013,74616744,9,0,1,18944,4,8934819410
3245,25819700,16978348,42798048,9,0,0,1536,4,6380281066
3246,25821260,17442274,43263534,7,0,0,44544,1,6556987942
3247,25826760,17448809,43275569,2,0,0,39424,1,2404786728
3248,25830060,48874119,74704179,0,0,1,1024,6,208225214
3249,25839850,17021821,42861671,5,0,0,4608,12,6232682721
3250,25842570,17277184,43119754,0,0,0,44544,6,1510780689
3251,25845700,17677544,43523244,4,0,0,21504,7,4288510790
3252,25855950,17306564,43162514,9,0,0,3072,4,8833562745
3253,25857851,48846351,74704202,9,0,1,1024,4,1863818842
3254,25869110,17554273,43423383,8,0,0,6656,11,2975306645
3255,25875150,17524228,43399378,4,0,0,12288,7,1864631057
3256,25887840,17602844,43490684,4,0,0,7680,7,9417158801
3257,25913260,17470422,43383682,6,0,0,6144,12,7815865651
3258,25931610,17354746,43286356,8,0,0,35328,11,1108153416
3259,25946880,17073770,43020650,2,0,0,7168,1,693169714
3260,25947390,17672904,43620294,8,0,0,34816,11,10573091758
3261,25957470,48746755,74704225,6,0,1,7168,12,1585381405
3262,25966010,17698854,43664864,5,0,0,28160,12,5417652839
3263,25982530,17552593,43535123,9,0,0,38912,4,7060560293
3264,25992570,48869673,74862243,1,0,1,26624,1,4120653524
3265,26001000,17168137,43169137,0,0,0,18432,6,9906747336
3266,26003960,48858306,74862266,1,0,1,2560,1,1850342164
3267,26008640,17966756,43975396,1,0,0,68096,1,810207261
3268,26009010,48853279,74862289,0,0,1,18944,6,9899479633
3269,26015350,17400133,43415483,2,0,0,13312,1,4350699606
3270,26019150,17209349,43228499,0,0,0,1536,6,5104332475
3271,26027090,17418422,43445512,2,0,0,16384,1,1699108362
3272,26045550,17795098,43840648,2,0,0,10240,1,977830210
3273,26048650,17863392,43912042,2,0,0,158720,1,6175074179
3274,26049170,48827781,74876951,7,0,1,4608,1,4786703710
3275,26069820,48807899,74877719,8,0,1,11776,11,571975972
3276,26070890,17179049,43249939,9,0,0,9728,4,5325257226
3277,26080640,17166312,43246952,8,0,0,22528,11,5658940875
3278,26080850,17963535,44044385,4,0,0,32256,7,9514526784
3279,26085790,17418834,43504624,9,0,0,44032,4,7714383365
3280,26090920,18033607,44124527,0,0,0,147968,6,1077265259
3281,26099510,18180166,44279676,6,0,0,15872,12,3812541796
3282,26109240,17316856,43426096,4,0,0,3072,7,2264369720
3283,26110950,17251224,43362174,9,0,0,8192,4,6563228230
3284,26119139,48939576,75058715,3,0,1,54272,18,1351800635
3285,26121090,17812416,43933506,0,0,0,35328,6,3544851019
3286,26123400,17504249,43627649,2,0,0,24064,1,7698009359
3287,26130650,17374309,43504959,2,0,0,1024,1,733233607
3288,26143870,17497218,43641088,6,0,0,44032,12,7143638592
3289,26151460,17598377,43749837,0,0,0,57856,6,2988202723
3290,26168040,17380130,43548170,1,0,0,8704,1,7158181016
3291,26180050,48882531,75062581,8,0,1,6144,11,5536597315
3292,26189200,17496458,43685658,7,0,0,61440,1,279362303
3293,26192060,17564883,43756943,6,0,0,512,12,7986120990
3294,26197380,17447475,43644855,4,0,0,12288,7,847044311
3295,26200620,17626520,43827140,1,0,0,35840,1,7252263033
3296,26203470,17487047,43690517,2,0,0,15872,1,1865855659
3297,26206610,17730195,43936805,3,0,0,10752,18,9624510863
3298,26206750,17488562,43695312,8,0,0,1536,11,7888039102
3299,26213080,18159163,44372243,4,0,0,31744,7,6065550177
3300,26218550,48845977,75064527,8,0,1,3072,11,599549685
3301,26261300,48937267,75198567,2,0,1,11264,1,6796309803
3302,26268760,17387501,43656261,3,0,0,13312,18,3150481618
3303,26271250,17863954,44135204,4,0,0,2560,7,10093402478
3304,26273310,17555436,43828746,3,0,0,5120,18,7286958774
3305,26277420,17389495,43666915,2,0,0,6656,1,1615707403
3306,26290610,17948087,44238697,9,0,0,5632,4,10622928217
3307,26296430,17649960,43946390,0,0,0,8704,6,3999351221
3308,26306720,17675586,43982306,5,0,0,2560,12,6377553042
3309,26311980,17441936,43753916,7,0,0,13312,1,1260903634
3310,26311990,17669513,43981503,4,0,0,19968,7,9799746302
3311,26332440,17590233,43922673,1,0,0,34816,1,1735920603
3312,26340250,17677969,44018219,1,0,0,28160,1,4998600852
3313,26356430,17375748,43732178,5,0,0,13824,12,2433286107
3314,26356989,48883767,75240756,5,0,1,75776,12,7867007502
3315,26361990,17626423,43988413,8,0,0,19968,11,2722584104
3316,26369450,17468055,43837505,0,0,0,28672,6,2399023607
3317,26375130,17757688,44132818,5,0,0,27136,12,6301554336
3318,26378510,17755891,44134401,0,0,0,5120,6,10049318544
3319,26379940,17479498,43859438,1,0,0,15872,1,1612192195
3320,26391369,48849418,75240787,3,0,1,32256,18,2611026682
3321,26400520,48990535,75391055,6,0,1,84480,12,5065266211
3322,26401080,17542635,43943715,5,0,0,8704,12,5275592166
3323,26404559,48986519,75391078,5,0,1,8704,12,252032997
3324,26408270,48982831,75391101,2,0,1,2560,1,5302521070
3325,26410800,17530240,43941040,8,0,0,13824,11,1512715944
3326,26415820,17630304,44046124,0,0,0,5632,6,6816728217
3327,26419120,18215779,44634899,7,0,0,105984,1,6739379943
3328,26425560,17712943,44138503,8,0,0,10752,11,5931575769
3329,26427250,17809708,44236958,6,0,0,27136,12,1544807344
3330,26437220,17512188,43949408,0,0,0,9728,6,8232064218
3331,26442860,48948264,75391124,1,0,1,11264,1,6868067983
3332,26444830,48964070,75408900,8,0,1,11776,11,6370600424
3333,26452700,48957186,75409886,2,0,1,1536,1,6319603768
3334,26460790,17728280,44189070,1,0,0,93696,1,5625756841
3335,26465430,17689844,44155274,3,0,0,1024,18,1429653930
3336,26468890,17867156,44336046,2,0,0,88064,1,8799238096
3337,26469220,17951070,44420290,4,0,0,25088,7,9555008024
3338,26477720,17720510,44198230,4,0,0,19456,7,5967946504
3339,26484240,48929192,75413432,8,0,1,5632,11,2298633795
3340,26486190,17659090,44145280,3,0,0,3072,18,4474668842
3341,26487560,17895816,44383376,8,0,0,27648,11,9790874530
3342,26487700,17924923,44412623,3,0,0,28160,18,10479765376
3343,26496310,17801314,44297624,3,0,0,18432,18,8358021523
3344,26496550,18143916,44640466,2,0,0,4096,1,8484346879
3345,26501250,48942871,75444121,1,0,1,4096,1,7713837437
3346,26511750,18037085,44548835,5,0,0,25600,12,4778365981
3347,26518660,17918902,44437562,5,0,0,12800,12,7965724579
3348,26521070,48940076,75461146,8,0,1,17920,11,7617785213
3349,26524120,17785071,44309191,2,0,0,37888,1,3350520296
3350,26531890,48949571,75481461,7,0,1,25600,1,9195841080
3351,26532240,17825735,44357975,5,0,0,26112,12,1812985824
3352,26533560,17710816,44244376,3,0,0,3072,18,6341838329
3353,26538470,17724112,44262582,2,0,0,46592,1,1418590851
3354,26546160,17792873,44339033,5,0,0,9728,12,4691627260
3355,26556380,48986617,75542997,0,0,1,9216,6,3135773712
3356,26556520,18211333,44767853,4,0,0,117760,7,8290618273
3357,26559900,18291395,44851295,1,0,0,52736,1,10151856351
3358,26560340,17841645,44401985,0,0,0,3072,6,8521607031
3359,26563510,48980793,75544303,1,0,1,2048,1,3567795303
3360,26567520,48980969,75548489,8,0,1,6656,11,72405622
3361,26570330,49040662,75610992,6,0,1,37376,12,5847904008
3362,26573029,49087416,75660445,3,0,1,9216,18,5762528578
3363,26588220,17952792,44541012,0,0,0,53760,6,3863300731
3364,26591670,17991843,44583513,1,0,0,66048,1,4614132923
3365,26614380,18159112,44773492,9,0,0,18432,4,10039191038
3366,26628710,18027829,44656539,4,0,0,7168,7,3113453486
3367,26629290,49042272,75671562,6,0,1,6656,12,5719329403
3368,26632470,17790682,44423152,4,0,0,9216,7,8138896898
3369,26642310,49030558,75672868,8,0,1,2048,11,8607119579
3370,26654620,49025813,75680433,1,0,1,14848,1,3914458252
3371,26656850,18229514,44886364,0,0,0,58880,6,4457642193
3372,26659530,18229353,44888883,2,0,0,8192,1,1320961358
3373,26672180,18107130,44779310,3,0,0,11264,18,5696585149
3374,26675141,49071689,75746830,9,0,1,2048,4,4327820791
3375,26684760,18334874,45019634,1,0,0,39936,1,6203994231
3376,26686950,18096751,44783701,6,0,0,14336,12,5483915860
3377,26690020,49057374,75747394,0,0,1,10752,6,371858513
3378,26693040,18082815,44775855,1,0,0,7680,1,1725144353
3379,26694430,49054590,75749020,7,0,1,2560,1,5943401409
3380,26699970,49072929,75772899,6,0,1,2560,12,6090622589
3381,26711640,18364410,45076050,9,0,0,3584,4,8061687833
3382,26712570,18357475,45070045,7,0,0,165376,1,5837424341
3383,26717501,49055654,75773155,9,0,1,9216,4,7365591920
3384,26729080,18274082,45003162,6,0,0,155648,12,373843830
3385,26732800,17904774,44637574,9,0,0,8704,4,7528650070
3386,26746360,18331429,45077789,3,0,0,5632,18,7970850568
3387,26755200,18032596,44787796,4,0,0,13312,7,4879165449
3388,26770330,18097137,44867467,3,0,0,41472,18,139445836
3389,26772440,50186657,76959097,1,0,1,477696,1,6107686762
3390,26773320,18312760,45086080,1,0,0,27136,1,2039602594
3391,26777060,18511298,45288358,5,0,0,31744,12,5775505944
3392,26777839,50282479,77060318,5,0,1,1536,12,5981938683
3393,26777911,50312222,77090133,9,0,1,25600,4,10106872337
3394,26791160,18590483,45381643,4,0,0,26112,7,1647358914
3395,26815429,50274727,77090156,5,0,1,14848,12,81692935
3396,26829650,50284264,77113914,0,0,1,10752,6,9512763528
3397,26843160,18571910,45415070,2,0,0,52736,1,2458124485
3398,26844150,18163247,45007397,8,0,0,13824,11,7851069672
3399,26845540,18043834,44889374,4,0,0,1536,7,9658912206
3400,26848600,18642376,45490976,8,0,0,18432,11,8696856626
3401,26861130,18289710,45150840,1,0,0,64512,1,6270707916
3402,26872860,50241077,77113937,7,0,1,5120,1,6700102873
3403,26875800,18402216,45278016,0,0,0,10240,6,5463174093
3404,26880689,50285162,77165851,5,0,1,2048,12,10736526028
3405,26895240,18379633,45274873,2,0,0,191488,1,6071851897
3406,26896620,50337766,77234386,4,0,1,23552,7,10558197588
3407,26902970,18249297,45152267,4,0,0,4608,7,4586184612
3408,26909610,18759145,45668755,8,0,0,31744,11,6232598261
3409,26912320,18704469,45616789,4,0,0,50176,7,10734928078
3410,26925960,18245785,45171745,0,0,0,14336,6,4844798356
3411,26934850,18825339,45760189,6,0,0,54784,12,1723267317
3412,26973700,18214460,45188160,3,0,0,23552,18,6898644417
3413,26984070,18090865,45074935,5,0,0,15872,12,6636680552
3414,26984900,18888419,45873319,3,0,0,97280,18,9117654313
3415,26985510,50257584,77243094,4,0,1,3584,7,1195086593
3416,26986690,18382065,45368755,5,0,0,54272,12,3471600154
3417,26987490,18167938,45155428,3,0,0,3072,18,3674567805
3418,26989150,18715515,45704665,7,0,0,38912,1,5166481972
3419,27009730,50966005,77975735,1,0,1,333312,1,7616443802
3420,27013690,18264973,45278663,7,0,0,2048,1,5737422062
3421,27016430,50977654,77994084,2,0,1,1536,1,6199728480
3422,27029630,18531077,45560707,6,0,0,48128,12,9321737342
3423,27040700,18328234,45368934,8,0,0,512,11,6701780921
3424,27043580,18379625,45423205,4,0,0,26624,7,5712805758
3425,27058190,18957670,46015860,9,0,0,30720,4,10099774944
3426,27060170,18946307,46006477,6,0,0,54272,12,10724554025
3427,27067020,50939514,78006534,4,0,1,33792,7,4125559599
3428,27072680,19279391,46352071,0,0,0,96256,6,486071195
3429,27073160,18527986,45601146,1,0,0,4096,1,10264818942
3430,27076850,19119023,46195873,1,0,0,8192,1,6567213851
3431,27078640,18937555,46016195,3,0,0,1024,18,2426702166
3432,27079320,19074469,46153789,6,0,0,3072,12,8386322504
3433,27081650,18577410,45659060,0,0,0,98816,6,9653950870
3434,27084649,50960849,78045498,3,0,1,18944,18,3639032571
3435,27088370,18799324,45887694,8,0,0,47104,11,5956310702
3436,27096750,18361351,45458101,9,0,0,23040,4,10358965339
3437,27101620,18689152,45790772,2,0,0,48640,1,10685687157
3438,27108730,50946442,78055172,2,0,1,10240,1,7591959988
3439,27109881,50957700,78067581,9,0,1,38400,4,4168091830
3440,27112420,50955507,78067927,2,0,1,512,1,4249219685
3441,27126971,50948365,78075336,9,0,1,5632,4,3977136602
3442,27144280,18696031,45840311,4,0,0,32768,7,4067386304
3443,27148990,18427522,45576512,5,0,0,19456,12,255953790
3444,27169620,18956650,46126270,4,0,0,52736,7,3092910185
3445,27179180,19010036,46189216,4,0,0,6144,7,5902985590
3446,27196360,19269285,46465645,6,0,0,69632,12,3690920159
3447,27208460,19179158,46387618,7,0,0,86528,1,10680798212
3448,27211829,51390704,78602533,3,0,1,153088,18,7321987542
3449,27221250,18399331,45620581,6,0,0,1536,12,10294662070
3450,27226430,18729616,45956046,3,0,0,20480,18,7894249642
3451,27227010,19326761,46553771,0,0,0,19456,6,6229372539
3452,27262340,18409090,45671430,9,0,0,8704,4,2555168231
3453,27270370,19237513,46507883,5,0,0,18944,12,9121988988
3454,27280420,18493672,45774092,8,0,0,15360,11,5982755455
3455,27311330,18638453,45949783,5,0,0,25600,12,1283773215
3456,27314330,18757649,46071979,3,0,0,61440,18,1878457656
3457,27332930,19798915,47131845,1,0,0,919552,1,7237186310
3458,27333920,18395172,45729092,8,0,0,3072,11,6876237151
3459,27353230,51263707,78616937,0,0,1,19968,6,380416579
3460,27355240,18807511,46162751,7,0,0,25088,1,6683288002
3461,27372810,18780020,46152830,1,0,0,32256,1,5963004608
3462,27375110,18931350,46306460,0,0,0,31232,6,108645876
3463,27378360,19344042,46722402,7,0,0,282112,1,8097801347
3464,27380060,19117803,46497863,1,0,0,11264,1,3645986214
3465,27389830,19353435,46743265,8,0,0,38400,11,10120178390
3466,27402150,51286551,78688701,4,0,1,19456,7,917823118
3467,27421650,18891076,46312726,2,0,0,2048,1,7486776721
3468,27424491,51264233,78688724,9,0,1,2048,4,2859500751
3469,27425570,19338528,46764098,3,0,0,61440,18,2539582094
3470,27426220,51262527,78688747,8,0,1,1024,11,2899905496
3471,27437710,19003867,46441577,7,0,0,4096,1,5415287982
3472,27450400,19095837,46546237,5,0,0,26624,12,7857248544
3473,27453420,19273575,46726995,3,0,0,9216,18,775937165
3474,27466690,19110385,46577075,0,0,0,5120,6,6507369405
3475,27467370,19690706,47158076,1,0,0,86016,1,3324215017
3476,27478140,19253402,46731542,2,0,0,14848,1,6432199792
3477,27478190,19768343,47246533,7,0,0,53248,1,5465359391
3478,27480020,18986740,46466760,0,0,0,3584,6,1399883779
3479,27517710,19287633,46805343,0,0,0,86016,6,1885453901
3480,27520720,19027100,46547820,0,0,0,5120,6,5344161048
3481,27522590,51166180,78688770,6,0,1,15360,12,2423383793
3482,27529850,19214998,46744848,6,0,0,5120,12,5671943838
3483,27534990,19695296,47230286,8,0,0,43008,11,8170235323
3484,27536350,19187814,46724164,3,0,0,1536,18,886673080
3485,27543560,19723368,47266928,1,0,0,12288,1,6924295354
3486,27547080,51154567,78701647,4,0,1,7168,7,5768726858
3487,27553240,19709921,47263161,3,0,0,20992,18,4123331957
3488,27555119,51147728,78702847,3,0,1,5632,18,5353802826
3489,27559600,19657559,47217159,0,0,0,55808,6,1316063610
3490,27566760,19740352,47307112,1,0,0,27648,1,7300879535
3491,27572220,51170390,78742610,1,0,1,29184,1,5472739473
3492,27574110,19062133,46636243,9,0,0,18432,4,10183467569
3493,27575270,51246596,78821866,0,0,1,512,6,2158593964
3494,27576150,18982781,46558931,5,0,0,1024,12,3231148223
3495,27598030,19730621,47328651,6,0,0,22016,12,1373928870
3496,27604410,19160187,46764597,7,0,0,1536,1,9762569489
3497,27621330,19124017,46745347,4,0,0,1536,7,5367106728
3498,27621600,19655023,47276623,3,0,0,31744,18,1440808457
3499,27627800,19095873,46723673,7,0,0,4096,1,3755552971
3500,27631520,19704642,47336162,1,0,0,24576,1,683249156
3501,27637210,51184679,78821889,8,0,1,5632,11,2861075051
3502,27642480,19536679,47179159,8,0,0,69120,11,4883076664
3503,27647270,19164336,46811606,5,0,0,20480,12,3483573778
3504,27655630,19531219,47186849,9,0,0,9216,4,7350227707
3505,27656640,19642025,47298665,4,0,0,61952,7,5348154545
3506,27662820,19655583,47318403,3,0,0,35840,18,9803199347
3507,27667420,19532712,47200132,3,0,0,43520,18,7582225433
3508,27679340,19577402,47256742,6,0,0,23552,12,8153763173
3509,27680510,19566982,47247492,5,0,0,3072,12,441682409
3510,27684759,51137153,78821912,5,0,1,1536,12,6229337023
3511,27684860,51137075,78821935,8,0,1,3072,11,4685916935
3512,27706430,19645823,47352253,3,0,0,52736,18,332139593
3513,27721870,19462148,47184018,9,0,0,15872,4,2112081898
3514,27723709,51098249,78821958,5,0,1,13824,12,977773550
3515,27724550,19524993,47249543,7,0,0,6656,1,5561551
3516,27728190,19593668,47321858,5,0,0,11264,12,10501333443
3517,27748470,19531296,47279766,2,0,0,10240,1,477546709
3518,27751070,19556344,47307414,5,0,0,512,12,4855387134
3519,27761810,19915844,47677654,8,0,0,84992,11,7874836794
3520,27778260,19753891,47532151,1,0,0,27136,1,5894652409
3521,27786040,19640122,47426162,1,0,0,4608,1,928163440
3522,27790590,19575786,47366376,6,0,0,3584,12,9191691225
3523,27791490,20195976,47987466,0,0,0,87552,6,5874040566
3524,27792090,51029891,78821981,8,0,1,2048,11,2977861935
3525,27805580,19727645,47533225,2,0,0,1024,1,10447026967
3526,27811460,19780064,47591524,3,0,0,35328,18,784579192
3527,27812240,19663995,47476235,9,0,0,13312,4,3542855673
3528,27825520,50996484,78822004,0,0,1,4096,6,8203377502
3529,27830150,50991877,78822027,2,0,1,5632,1,5509385908
3530,27832160,19734278,47566438,2,0,0,16384,1,8385289898
3531,27845780,19731624,47577404,4,0,0,22528,7,4425945137
3532,27845810,20063078,47908888,5,0,0,91648,12,1882977141
3533,27849180,19782244,47631424,0,0,0,11776,6,5628638408
3534,27853780,20147974,48001754,2,0,0,46592,1,9835218515
3535,27865310,19748952,47614262,8,0,0,5120,11,6096432864
3536,27902620,19621240,47523860,0,0,0,3072,6,4301718338
3537,27905080,19586062,47491142,6,0,0,8704,12,10207932650
3538,27909390,20129881,48039271,6,0,0,64000,12,9362802992
3539,27909420,19930059,47839479,0,0,0,7168,6,6517219723
3540,27913590,19878062,47791652,6,0,0,17408,12,2538559908
3541,27927400,50953820,78881220,0,0,1,7168,6,6686211283
3542,27934580,20195064,48129644,6,0,0,16896,12,1319735934
3543,27947790,50933461,78881251,4,0,1,36352,7,9271014739
3544,27951270,19886002,47837272,5,0,0,34816,12,4279301299
3545,27954000,19654885,47608885,5,0,0,8192,12,10588866603
3546,27955230,50926044,78881274,0,0,1,6144,6,4037505874
3547,27961900,20715018,48676918,0,0,0,6656,6,5111877748
3548,27964450,20552909,48517359,2,0,0,47104,1,284216894
3549,27984630,19503837,47488467,2,0,0,14848,1,7761494726
3550,27998200,19818648,47816848,0,0,0,15872,6,9981917465
3551,28004970,19699828,47704798,5,0,0,43008,12,3377404997
3552,28014290,20078193,48092483,3,0,0,5120,18,10508321458
3553,28015290,19997571,48012861,9,0,0,36352,4,7300851130
3554,28023110,50868506,78891616,4,0,1,31232,7,4466097050
3555,28033220,50900164,78933384,4,0,1,27648,7,8768682012
3556,28035780,50933357,78969137,1,0,1,9728,1,8090399666
3557,28036950,19836085,47873035,2,0,0,6656,1,1801497783
3558,28046470,19700304,47746774,9,0,0,19456,4,67869818
3559,28047660,20239829,48287489,8,0,0,12288,11,9187104463
3560,28050870,19668278,47719148,3,0,0,1536,18,7608288833
3561,28054700,19989617,48044317,9,0,0,16384,4,5039053861
3562,28059700,20469093,48528793,6,0,0,10752,12,10386402262
3563,28060170,20341795,48401965,0,0,0,35328,6,6787433926
3564,28071430,20014091,48085521,7,0,0,33792,1,8753306116
3565,28085510,19875257,47960767,1,0,0,30208,1,9249991848
3566,28088800,20160588,48249388,5,0,0,69632,12,1697399068
3567,28091980,20725637,48817617,1,0,0,17920,1,6336606557
3568,28096850,19922898,48019748,9,0,0,22528,4,4632748847
3569,28099960,20024513,48124473,4,0,0,36352,7,1472749764
3570,28107100,19809425,47916525,7,0,0,24064,1,10337476656
3571,28116840,20166836,48283676,7,0,0,32256,1,6975673512
3572,28117740,20110401,48228141,2,0,0,45568,1,946716967
3573,28130620,20005662,48136282,4,0,0,20992,7,961925397
3574,28133010,20124201,48257211,9,0,0,25600,4,2995904258
3575,28152950,50816210,78969160,7,0,1,8704,1,7597934388
3576,28159310,20215043,48374353,9,0,0,26112,4,8018489435
3577,28161849,50845039,79006888,5,0,1,2048,12,5413584755
3578,28168880,20017529,48186409,0,0,0,8704,6,10702846786
3579,28170580,20001385,48171965,9,0,0,81408,4,9705488269
3580,28176630,20033369,48209999,6,0,0,28672,12,10720609367
3581,28204480,20230719,48435199,9,0,0,7168,4,4737942210
3582,28217640,19996594,48214234,1,0,0,13824,1,7718724311
3583,28220310,20259823,48480133,8,0,0,6144,11,8573827672
3584,28224240,50783212,79007452,0,0,1,10752,6,9389698075
3585,28226210,19949545,48175755,3,0,0,12288,18,7778585821
3586,28228120,50812557,79040677,2,0,1,4096,1,8508092613
3587,28229700,20243066,48472766,3,0,0,1536,18,7665676238
3588,28234670,20286456,48521126,0,0,0,12288,6,8457812041
3589,28236190,50836733,79072923,7,0,1,15872,1,10576973629
3590,28259710,20212565,48472275,0,0,0,30208,6,6898900830
3591,28261680,19922054,48183734,2,0,0,26112,1,7246106280
3592,28262760,20234152,48496912,6,0,0,7168,12,8544440347
3593,28265090,20392636,48657726,3,0,0,8704,18,8702380827
3594,28269351,50808718,79078069,9,0,1,8192,4,5275733731
3595,28281960,50796775,79078735,7,0,1,1024,1,4706714358
3596,28283680,20424825,48708505,3,0,0,14848,18,3226830906
3597,28285130,20081244,48366374,2,0,0,70656,1,4429386642
3598,28290050,20000132,48290182,0,0,0,4608,6,2936248891
3599,28291810,20532526,48824336,4,0,0,13312,7,4709614782
3600,28312400,50840646,79153046,1,0,1,73728,1,5618723371
3601,28316190,20461001,48777191,4,0,0,72704,7,6856266934
3602,28322600,20170453,48493053,1,0,0,10752,1,1673844553
3603,28335559,50854566,79190125,3,0,1,512,18,5202236017
3604,28336650,20266876,48603526,9,0,0,60416,4,6968023858
3605,28345030,20433588,48778618,3,0,0,4608,18,84319195
3606,28345430,20034924,48380354,1,0,0,5632,1,9189947043
3607,28352340,20621196,48973536,9,0,0,22528,4,4533333287
3608,28365130,20289921,48655051,1,0,0,101376,1,6978583455
3609,28367230,20387786,48755016,3,0,0,152576,18,6793461324
3610,28367930,20598719,48966649,0,0,0,48128,6,8665994839
3611,28370770,20683548,49054318,9,0,0,25088,4,9863820937
3612,28376070,20407095,48783165,7,0,0,14848,1,6457795274
3613,28380050,20278190,48658240,5,0,0,1536,12,5125850051
3614,28381340,20682201,49063541,8,0,0,26624,11,10153160659
3615,28398100,50801263,79199363,8,0,1,13312,11,5245022600
3616,28407920,20750451,49158371,5,0,0,64512,12,1511750360
3617,28431200,20437813,48869013,6,0,0,10240,12,9083304609
3618,28432730,20478644,48911374,1,0,0,16896,1,5676118623
3619,28439010,20771589,49210599,0,0,0,73728,6,1447791571
3620,28449130,20395247,48844377,5,0,0,30208,12,8093524356
3621,28453270,50746759,79200029,4,0,1,1024,7,3339985104
3622,28485860,20702252,49188112,9,0,0,19456,4,10662035329
3623,28486430,20050136,48536566,1,0,0,24576,1,10327218711
3624,28506560,20282556,48789116,7,0,0,19456,1,5502623410
3625,28507700,20808154,49315854,7,0,0,18944,1,3479913791
3626,28514710,20177826,48692536,7,0,0,11776,1,10123771624
3627,28520511,50681144,79201655,9,0,1,2560,4,8193795048
3628,28534830,50668451,79203281,0,0,1,2560,6,166531614
3629,28563090,50685760,79248850,1,0,1,36864,1,1892615796
3630,28563920,20971559,49535479,6,0,0,36352,12,2146925902
3631,28566160,20706734,49272894,7,0,0,22528,1,1184864005
3632,28567570,20090849,48658419,7,0,0,512,1,8175975300
3633,28571300,50793185,79364485,2,0,1,16896,1,5401418210
3634,28577300,20273340,48850640,5,0,0,20480,12,3265788459
3635,28581360,50783381,79364741,0,0,1,9216,6,3791320107
3636,28581580,20230554,48812134,8,0,0,13824,11,10035398261
3637,28600820,20673345,49274165,5,0,0,4096,12,5387192480
3638,28629810,20312109,48941919,0,0,0,8192,6,6194264185
3639,28635060,20342867,48977927,9,0,0,14336,4,2446506840
3640,28637671,50874855,79512526,9,0,1,23040,4,10310793951
3641,28648010,20471464,49119474,3,0,0,14848,18,3010459450
3642,28649940,50867092,79517032,4,0,1,7168,7,8012458080
3643,28658280,50871713,79529993,8,0,1,512,11,8581002280
3644,28664060,20345606,49009666,8,0,0,6656,11,7870622618
3645,28677840,20244894,48922734,7,0,0,19456,1,6024157882
3646,28681440,20205321,48886761,3,0,0,36352,18,8401014595
3647,28696460,20666739,49363199,7,0,0,37888,1,10681310007
3648,28700200,20407014,49107214,1,0,0,37376,1,6204865405
3649,28715300,20137859,48853159,1,0,0,8192,1,1674950368
3650,28715560,20292055,49007615,2,0,0,19456,1,7200030877
3651,28718990,20071241,48790231,6,0,0,3584,12,5640618374
3652,28724820,50809359,79534179,2,0,1,6656,1,6335374693
3653,28728970,20272694,49001664,3,0,0,40448,18,752056299
3654,28729890,20746450,49476340,2,0,0,52736,1,7899046346
3655,28730010,20309451,49039461,8,0,0,17920,11,1034135473
3656,28759840,50776285,79536125,2,0,1,3072,1,6261916081
3657,28781250,20333654,49114904,9,0,0,25088,4,1989066939
3658,28781640,20559300,49340940,4,0,0,48128,7,10591339558
3659,28787080,20506044,49293124,8,0,0,4608,11,8284889039
3660,28794510,51136119,79930629,7,0,1,16384,1,5070735840
3661,28795351,51160741,79956092,9,0,1,27136,4,5833074882
3662,28802450,20514363,49316813,2,0,0,3072,1,5704484859
3663,28807540,51280418,80087958,1,0,1,10240,1,860801236
3664,28822140,51304267,80126407,1,0,1,15872,1,8655256762
3665,28822190,51364137,80186327,6,0,1,18432,12,7228608378
3666,28831060,20582653,49413713,6,0,0,79360,12,10731502113
3667,28832630,51353953,80186583,2,0,1,9216,1,5381810587
3668,28834570,20251460,49086030,9,0,0,8704,4,1709211103
3669,28836060,20806542,49642602,8,0,0,104960,11,6860865213
3670,28837920,20937745,49775665,2,0,0,29696,1,7129378218
3671,28844520,20723064,49567584,1,0,0,64000,1,4995903808
3672,28847330,51714141,80561471,8,0,1,39936,11,6777656927
3673,28861570,20625855,49487425,7,0,0,11264,1,2879026187
3674,28870550,20493920,49364470,4,0,0,4096,7,3125872551
3675,28882420,20728133,49610553,7,0,0,43520,1,2372986925
3676,28885920,20701655,49587575,0,0,0,65536,6,7259304638
3677,28890000,20283216,49173216,8,0,0,21504,11,1884949498
3678,28893140,51687517,80580657,1,0,1,8192,1,9005491548
3679,28898360,51843571,80741931,0,0,1,30208,6,7736029896
3680,28932320,20306091,49238411,1,0,0,34816,1,5238595269
3681,28959360,51782594,80741954,1,0,1,10240,1,3772182166
3682,28963430,20633840,49597270,0,0,0,31744,6,8227108464
3683,28965660,20708037,49673697,6,0,0,5120,12,2655396901
3684,28969761,51840278,80810039,9,0,1,36864,4,7581440158
3685,28975869,51834193,80810062,3,0,1,9728,18,1433223950
3686,28994360,20664824,49659184,5,0,0,34816,12,5445703895
3687,28995340,51814745,80810085,4,0,1,9728,7,7007427635
3688,28998010,20214484,49212494,7,0,0,6144,1,8238987500
3689,29001490,20660883,49662373,0,0,0,10240,6,3652752471
3690,29002590,20929711,49932301,2,0,0,7168,1,8587983543
3691,29002670,51807438,80810108,1,0,1,8704,1,9644891930
3692,29009480,20781977,49791457,3,0,0,6656,18,8432673616
3693,29009620,20444054,49453674,9,0,0,18944,4,2771144271
3694,29025170,20646944,49672114,9,0,0,16896,4,5715056809
3695,29028530,21122888,50151418,1,0,0,40960,1,7636605119
3696,29031750,20387290,49419040,4,0,0,17408,7,258637099
3697,29036970,21195630,50232600,4,0,0,5632,7,10532491177
3698,29041620,20856424,49898044,5,0,0,59392,12,9860985537
3699,29050440,20473940,49524380,7,0,0,34816,1,4039899029
3700,29056960,21096821,50153781,2,0,0,7680,1,8829123221
3701,29058310,20449309,49507619,2,0,0,24064,1,4558786044
3702,29067350,51750760,80818110,2,0,1,12800,1,6386436286
3703,29068440,20771596,49840036,0,0,0,5120,6,3376238281
3704,29068480,20596880,49665360,4,0,0,9728,7,124249431
3705,29068750,51777174,80845924,2,0,1,4096,1,1014775781
3706,29070920,20676825,49747745,6,0,0,5632,12,3479455720
3707,29088860,20424866,49513726,2,0,0,19968,1,4834056236
3708,29099180,20361069,49460249,8,0,0,21504,11,8693671838
3709,29114460,52098476,81212936,6,0,1,211456,12,4667849841
3710,29116530,20550413,49666943,0,0,0,5120,6,10533807454
3711,29118700,21251755,50370455,0,0,0,30720,6,6248832168
3712,29119580,20422318,49541898,3,0,0,20992,18,8882701698
3713,29121459,52100622,81222081,3,0,1,17408,18,5191153986
3714,29137900,20786607,49924507,4,0,0,38912,7,9948727092
3715,29139230,20606776,49746006,9,0,0,76800,4,8167415932
3716,29150580,21346698,50497278,2,0,0,19456,1,6690070698
3717,29162320,20486233,49648553,4,0,0,19456,7,9871929895
3718,29209060,21280478,50489538,7,0,0,24064,1,3185964952
3719,29221000,20586930,49807930,8,0,0,23040,11,7510484824
3720,29230290,52027577,81257867,0,0,1,10752,6,4804164264
3721,29247080,52012413,81259493,2,0,1,2560,1,4636985900
3722,29251229,52008930,81260159,3,0,1,1024,18,2362867652
3723,29259500,20910922,50170422,0,0,0,19456,6,10010014892
3724,29272180,20656406,49928586,6,0,0,13312,12,2152747344
3725,29286730,21018110,50304840,5,0,0,81408,12,7326381622
3726,29289190,20384694,49673884,2,0,0,512,1,4338643423
3727,29296790,20539141,49835931,3,0,0,10752,18,5601861512
3728,29298690,20840225,50138915,5,0,0,24064,12,5507544154
3729,29328190,21247696,50575886,9,0,0,16896,4,2201889668
3730,29355660,20476972,49832632,7,0,0,31232,1,1880884403
3731,29367160,20601969,49969129,4,0,0,512,7,7313771232
3732,29413920,20441346,49855266,6,0,0,9728,12,9340130912
3733,29421910,20430369,49852279,9,0,0,16384,4,6112843487
3734,29427740,20667113,50094853,2,0,0,32256,1,405563582
3735,29437030,20694530,50131560,8,0,0,52736,11,7712847836
3736,29439470,20407765,49847235,5,0,0,23552,12,856979951
3737,29439740,21534256,50973996,2,0,0,607744,1,6869830847
3738,29441070,20372031,49813101,9,0,0,16896,4,9284495082
3739,29452550,20305429,49757979,6,0,0,5120,12,2149116704
3740,29462300,21568659,51030959,7,0,0,186880,1,9871703544
3741,29502660,20757856,50260516,1,0,0,17920,1,2612303165
3742,29509230,21559642,51068872,1,0,0,27136,1,6693868929
3743,29517020,20997129,50514149,8,0,0,55296,11,3209290934
3744,29520110,21096827,50616937,7,0,0,134656,1,9442698309
3745,29521870,51748061,81269931,8,0,1,6656,11,9106756028
3746,29526090,21578286,51104376,3,0,0,14336,18,1620958686
3747,29546420,20551103,50097523,1,0,0,4608,1,4818685240
3748,29559481,51747050,81306531,9,0,1,8704,4,9040745555
3749,29559770,20525232,50085002,8,0,0,17408,11,3711186583
3750,29562290,51790092,81352382,2,0,1,17920,1,6939189590
3751,29565260,20767811,50333071,2,0,0,23552,1,4924745214
3752,29574640,21466638,51041278,5,0,0,33792,12,7993110027
3753,29578210,20981115,50559325,1,0,0,17408,1,9493428948
3754,29594430,20887753,50482183,4,0,0,17408,7,4700497347
3755,29596170,21176437,50772607,8,0,0,60928,11,3602670558
3756,29601470,21129677,50731147,6,0,0,30720,12,10707485783
3757,29607800,21173901,50781701,0,0,0,17408,6,10315987832
3758,29609220,21037207,50646427,8,0,0,11264,11,4613045009
3759,29613450,21074359,50687809,9,0,0,66048,4,1101356278
3760,29615560,51761360,81376920,2,0,1,7680,1,150971851
3761,29621730,21007585,50629315,7,0,0,16896,1,3035112515
3762,29624860,21161306,50786166,7,0,0,8192,1,5765520464
3763,29630710,21439433,51070143,8,0,0,4096,11,10054092657
3764,29632630,21099164,50731794,6,0,0,2048,12,5901964124
3765,29633860,21421348,51055208,4,0,0,37376,7,8428036416
3766,29644520,21861658,51506178,6,0,0,21504,12,4597626103
3767,29650200,21675210,51325410,9,0,0,40448,4,6456615346
3768,29650440,21428462,51078902,5,0,0,28672,12,2029754166
3769,29650640,20865248,50515888,2,0,0,5632,1,1776936792
3770,29650910,51748239,81399149,0,0,1,37888,6,9645456344
3771,29656370,20689788,50346158,8,0,0,10240,11,2750365342
3772,29659960,21400442,51060402,2,0,0,15872,1,10041556451
3773,29662210,20961926,50624136,6,0,0,23552,12,9498775519
3774,29669200,21107174,50776374,6,0,0,12288,12,7180801783
3775,29676490,51722682,81399172,4,0,1,10752,7,7199522581
3776,29685620,21497716,51183336,6,0,0,163328,12,1837659396
3777,29686650,21435244,51121894,6,0,0,47616,12,7580288984
3778,29689440,51830719,81520159,7,0,1,40960,1,3194146316
3779,29690899,51971605,81662504,5,0,1,6656,12,6166299335
3780,29698840,51966570,81665410,2,0,1,4608,1,5962407089
3781,29733090,20902488,50635578,4,0,0,20480,7,10462588010
3782,29733910,21452569,51186479,2,0,0,10240,1,6353542382
3783,29735280,21320263,51055543,4,0,0,1024,7,8462065670
3784,29736350,21473185,51209535,0,0,0,13312,6,5257048140
3785,29737270,51929126,81666396,4,0,1,1536,7,892317990
3786,29754250,20959503,50713753,7,0,0,14336,1,5657649410
3787,29756780,21552675,51309455,1,0,0,70144,1,7252909349
3788,29769250,21948009,51717259,1,0,0,53760,1,9398673062
3789,29784510,51883192,81667702,8,0,1,2048,11,7045125298
3790,29786980,21313005,51099985,3,0,0,69120,18,6658287314
3791,29792660,22115396,51908056,6,0,0,47104,12,175412890
3792,29803360,21484700,51288060,7,0,0,10752,1,5652712369
3793,29813960,21293403,51107363,4,0,0,9728,7,9556188311
3794,29816530,51901827,81718357,2,0,1,25088,1,7771532899
3795,29821330,21397445,51218775,9,0,0,18432,4,4112619039
3796,29825400,20957884,50783284,0,0,0,5120,6,1817185650
3797,29826700,21538994,51365694,9,0,0,17408,4,8295243202
3798,29827350,22328682,52156032,7,0,0,32768,1,3807336388
3799,29833950,51938552,81772502,4,0,1,17920,7,2596792599
3800,29836290,52076194,81912484,1,0,1,18432,1,771214188
3801,29843280,21200517,51043797,7,0,0,8192,1,5029040487
3802,29845210,21818063,51663273,8,0,0,89600,11,2402704574
3803,29849199,52075549,81924748,5,0,1,1536,12,4861466802
3804,29866180,22427583,52293763,6,0,0,75776,12,3183566688
3805,29866610,22497486,52364096,6,0,0,36864,12,5858156045
3806,29873340,21187241,51060581,0,0,0,512,6,8510571881
3807,29878520,22512856,52391376,8,0,0,35840,11,3317810135
3808,29880260,22376329,52256589,5,0,0,182272,12,2326616283
3809,29898240,21635571,51533811,8,0,0,69120,11,5240797787
3810,29905560,21880059,51785619,2,0,0,1024,1,2974204233
3811,29915070,22221393,52136463,0,0,0,187392,6,6288283411
3812,29924600,21465348,51389948,2,0,0,2560,1,8755084857
3813,29929520,21900942,51830462,7,0,0,21504,1,9637039284
3814,29931720,22576959,52508679,2,0,0,13312,1,415621196
3815,29962670,21759066,51721736,2,0,0,7168,1,2815450037
3816,29963030,22182995,52146025,5,0,0,25600,12,7036077321
3817,29973080,22216061,52189141,2,0,0,6656,1,2659653363
3818,30004910,21327138,51332048,5,0,0,3072,12,2120773788
3819,30005880,21887785,51893665,1,0,0,48128,1,15614654
3820,30011650,21522675,51534325,3,0,0,1536,18,4853627307
3821,30025050,21793666,51818716,0,0,0,33280,6,3780086002
3822,30036490,21767989,51804479,4,0,0,18944,7,10675638123
3823,30037710,22003695,52041405,3,0,0,74240,18,5110253974
3824,30042690,22395541,52438231,6,0,0,5632,12,8238605027
3825,30044720,22396966,52441686,8,0,0,10240,11,8965393911
3826,30054480,22682300,52736780,1,0,0,12288,1,2397601108
3827,30058389,51867025,81925414,3,0,1,1024,18,4987139537
3828,30071900,21862621,51934521,6,0,0,28160,12,5421038885
3829,30073370,22197282,52270652,0,0,0,46080,6,8388176019
3830,30075950,22574231,52650181,6,0,0,201728,12,1426016177
3831,30078170,21519727,51597897,8,0,0,36352,11,4030290238
3832,30090110,51835970,81926080,0,0,1,1024,6,6615461590
3833,30094540,21371888,51466428,8,0,0,3072,11,9747215591
3834,30096380,21782598,51878978,7,0,0,23040,1,10484176516
3835,30097650,22060130,52157780,7,0,0,512,1,5100804410
3836,30110390,51849247,81959637,4,0,1,16384,7,869213737
3837,30111600,22683789,52795389,5,0,0,109056,12,5672221043
3838,30132960,21561423,51694383,8,0,0,34304,11,6480208908
3839,30135420,51998919,82134339,4,0,1,40448,7,7199486511
3840,30146630,51990615,82137245,1,0,1,4608,1,8359809327
3841,30197390,21340747,51538137,7,0,0,1536,1,10657427027
3842,30212490,22309031,52521521,6,0,0,16896,12,9373489856
3843,30234860,21823569,52058429,6,0,0,8704,12,1876441282
3844,30242380,21720718,51963098,3,0,0,11776,18,9472425119
3845,30244620,21579267,51823887,0,0,0,16896,6,6223844442
3846,30245480,51990038,82235518,8,0,1,23552,11,5353034564
3847,30255140,21797387,52052527,2,0,0,36352,1,4842462080
3848,30262110,22220774,52482884,1,0,0,45568,1,229185203
3849,30279800,52481545,82761345,7,0,1,173056,1,3569710333
3850,30296420,22033893,52330313,3,0,0,114688,18,4413988112
3851,30306000,22224436,52530436,3,0,0,29184,18,9869247226
3852,30312189,52449179,82761368,5,0,1,512,12,1455301946
3853,30322410,21696352,52018762,7,0,0,37376,1,81762612
3854,30346410,22312093,52658503,2,0,0,10240,1,7012346359
3855,30354200,22466523,52820723,4,0,0,12288,7,8065450075
3856,30357110,21809541,52166651,2,0,0,19968,1,5014822088
3857,30360920,52420229,82781149,6,0,1,20480,12,10685700525
3858,30364879,52420157,82785036,5,0,1,8192,12,2940059563
3859,30367750,22470936,52838686,9,0,0,58880,4,7726876081
3860,30370100,22446840,52816940,7,0,0,70656,1,5033299195
3861,30373520,21813570,52187090,3,0,0,38912,18,3800231794
3862,30390630,21672970,52063600,8,0,0,16896,11,8312014976
3863,30390660,21952000,52342660,3,0,0,40448,18,379579700
3864,30407130,21359477,51766607,7,0,0,512,1,4946749318
3865,30412290,22104060,52516350,8,0,0,13312,11,7298761485
3866,30413300,22023192,52436492,7,0,0,113152,1,6669493229
3867,30414930,22495383,52910313,6,0,0,235008,12,4812122167
3868,30415660,22539640,52955300,2,0,0,16384,1,666778360
3869,30415830,22315085,52730915,1,0,0,35328,1,9536342627
3870,30416470,21425871,51842341,4,0,0,38912,7,7901459750
3871,30418890,22036958,52455848,6,0,0,16384,12,2240896676
3872,30424000,22026833,52450833,9,0,0,20480,4,8885946248
3873,30429580,22303425,52733005,5,0,0,6656,12,9080803002
3874,30429800,22578487,53008287,7,0,0,40448,1,10247512026
3875,30430610,22158038,52588648,8,0,0,6656,11,9414894088
3876,30461390,22913647,53375037,3,0,0,60416,18,5761580312
3877,30462810,21885333,52348143,4,0,0,17920,7,7538597738
3878,30466020,22120577,52586597,7,0,0,26112,1,3038530674
3879,30480920,22214780,52695700,1,0,0,80384,1,10605230655
3880,30491720,52933107,83424827,7,0,1,299008,1,10440730731
3881,30491870,22228258,52720128,0,0,0,49152,6,6965784813
3882,30498340,22172845,52671185,4,0,0,22528,7,10249459810
3883,30515219,52913193,83428412,5,0,1,8704,12,3016613843
3884,30516169,52921992,83438161,5,0,1,36352,12,4180304054
3885,30531880,22032966,52564846,6,0,0,8704,12,3334710969
3886,30569760,22580382,53150142,7,0,0,17920,1,4760491240
3887,30574340,21563862,52138202,5,0,0,5632,12,4794782355
3888,30581700,22390954,52972654,6,0,0,4608,12,5568486200
3889,30585350,22158831,52744181,7,0,0,7680,1,4826917237
3890,30590470,22346151,52936621,9,0,0,34816,4,657458222
3891,30592350,21908873,52501223,9,0,0,11776,4,4817568446
3892,30596400,52955603,83552003,2,0,1,16384,1,1555660311
3893,30603520,22516147,53119667,1,0,0,14848,1,7019078724
3894,30613380,22306168,52919548,7,0,0,30208,1,9355152057
3895,30618830,21676516,52295346,5,0,0,5120,12,2779329428
3896,30619730,22084284,52704014,0,0,0,27136,6,7992313252
3897,30622410,22326916,52949326,1,0,0,1536,1,711819337
3898,30623240,22128596,52751836,9,0,0,5632,4,4677801306
3899,30628960,21863176,52492136,6,0,0,20480,12,4957790963
3900,30637330,22026968,52664298,6,0,0,18944,12,4203092050
3901,30645649,52958428,83604077,3,0,1,26624,18,7046487058
3902,30651960,52953423,83605383,2,0,1,2048,1,6931293672
3903,30657940,52949709,83607649,8,0,1,3584,11,8059119591
3904,30671190,22672422,53343612,2,0,0,61952,1,6756730218
3905,30672950,21677564,52350514,7,0,0,7680,1,5261398831
3906,30679220,22065560,52744780,0,0,0,1024,6,9618188701
3907,30679419,52991838,83671257,3,0,1,13824,18,4472785455
3908,30693310,22246454,52939764,2,0,0,10240,1,923848567
3909,30701130,22313264,53014394,0,0,0,19968,6,7881228456
3910,30713300,22841093,53554393,4,0,0,20480,7,6796014103
3911,30713350,22523730,53237080,4,0,0,71168,7,2233396463
3912,30717380,52973518,83690898,6,0,1,2048,12,1313731944
3913,30721140,22245658,52966798,6,0,0,512,12,7380121422
3914,30729340,53204134,83933474,6,0,1,112640,12,9125769010
3915,30744010,22650151,53394161,4,0,0,9728,7,10283482585
3916,30778300,22332264,53110564,0,0,0,26624,6,649155595
3917,30780510,22475209,53255719,7,0,0,37888,1,2655026710
3918,30816210,22348619,53164829,7,0,0,48128,1,10596784811
3919,30817280,22425774,53243054,3,0,0,19456,18,3455005368
3920,30838230,22234780,53073010,8,0,0,512,11,1648385800
3921,30839580,53184362,84023942,1,0,1,8704,1,8748726613
3922,30839860,21815500,52655360,1,0,0,16896,1,10609679884
3923,30862060,22154385,53016445,2,0,0,6656,1,10364724929
3924,30862800,22621095,53483895,5,0,0,65024,12,10454241509
3925,30897730,22367918,53265648,5,0,0,1536,12,8025254075
3926,30898310,22050525,52948835,7,0,0,29696,1,357443498
3927,30928020,22166902,53094922,6,0,0,16384,12,5799191278
3928,30931990,21809828,52741818,6,0,0,16384,12,1509757201
3929,30935920,22418947,53354867,5,0,0,36864,12,3805632114
3930,30939270,22671020,53610290,8,0,0,31744,11,3273367829
3931,30950270,22867802,53818072,3,0,0,11776,18,3807026487
3932,30952130,21752999,52705129,7,0,0,3584,1,7320598985
3933,30959100,53135790,84094890,0,0,1,6656,6,4169322798
3934,30964830,22249108,53213938,9,0,0,86528,4,2981752631
3935,30967910,21955093,52923003,9,0,0,11264,4,528218761
3936,30989490,22870808,53860298,9,0,0,31232,4,5183984130
3937,31002780,22399204,53401984,1,0,0,25600,1,2228337179
3938,31002890,22381842,53384732,9,0,0,31744,4,4983876372
3939,31009210,22497652,53506862,2,0,0,6656,1,7164227528
3940,31016650,22387853,53404503,3,0,0,8192,18,2473919169
3941,31018650,53081937,84100587,2,0,1,18944,1,9439917332
3942,31019330,22053501,53072831,6,0,0,17920,12,10317633143
3943,31020990,22120082,53141072,1,0,0,14336,1,10032831183
3944,31031110,21894880,52925990,7,0,0,9728,1,9781540400
3945,31040440,22222166,53262606,1,0,0,22528,1,7386769512
3946,31049750,53325584,84375334,7,0,1,90112,1,3897978069
3947,31058369,53345578,84403947,5,0,1,5120,12,10445441572
3948,31058520,22558680,53617200,0,0,0,1536,6,2739986354
3949,31063059,53356981,84420040,3,0,1,20992,18,326858351
3950,31077320,22246566,53323886,3,0,0,78848,18,9675621948
3951,31085200,21865085,52950285,3,0,0,3072,18,2734927938
3952,31089690,22492906,53582596,5,0,0,32768,12,6902300130
3953,31104070,22252536,53356606,9,0,0,5632,4,2364576145
3954,31115340,22272535,53387875,0,0,0,10240,6,6831173756
3955,31121180,22426950,53548130,7,0,0,61440,1,1331748432
3956,31129250,22114779,53244029,0,0,0,3072,6,5515607916
3957,31129870,22486839,53616709,7,0,0,20992,1,8228019611
3958,31140840,21815598,52956438,6,0,0,3584,12,9107041148
3959,31144040,53293006,84437046,1,0,1,17920,1,4738615499
3960,31146300,21978070,53124370,7,0,0,15360,1,4116414907
3961,31155020,53883491,85038511,7,0,1,421888,1,7056838577
3962,31170220,22780308,53950528,5,0,0,55296,12,2583748760
3963,31186500,22236566,53423066,6,0,0,25088,12,8210548432
3964,31188150,53850384,85038534,2,0,1,7680,1,666642470
3965,31195660,22517061,53712721,8,0,0,7168,11,6448697897
3966,31217070,21970481,53187551,7,0,0,5632,1,4654128555
3967,31217970,22173204,53391174,1,0,0,10752,1,3051184239
3968,31222339,53816218,85038557,5,0,1,1024,12,3859023580
3969,31226550,22412068,53638618,3,0,0,66560,18,4466958973
3970,31256060,22182255,53438315,5,0,0,9728,12,9089196196
3971,31256890,21958475,53215365,4,0,0,4608,7,3297547626
3972,31257510,22009877,53267387,3,0,0,5632,18,3987746599
3973,31257850,23096328,54354178,7,0,0,25600,1,1303883748
3974,31263860,22423476,53687336,6,0,0,5120,12,1206631296
3975,31283870,22121904,53405774,1,0,0,4096,1,868549089
3976,31297480,22666237,53963717,6,0,0,12800,12,4162821820
3977,31300880,21964245,53265125,1,0,0,8192,1,7015595675
3978,31304230,22627954,53932184,9,0,0,98304,4,2318331830
3979,31342530,22223141,53565671,8,0,0,18432,11,3616559295
3980,31343010,22104854,53447864,3,0,0,17920,18,471152479
3981,31346840,23206384,54553224,6,0,0,80384,12,7031611011
3982,31369600,54384682,85754282,6,0,1,507392,12,8206535827
3983,31385080,22030319,53415399,5,0,0,1536,12,8006857560
3984,31386890,22654872,54041762,6,0,0,23552,12,7940216792
3985,31388650,22229665,53618315,8,0,0,3584,11,7024307268
3986,31401980,22603816,54005796,6,0,0,69632,12,5160509558
3987,31410100,22488210,53898310,1,0,0,16896,1,5799533143
3988,31420299,54334006,85754305,5,0,1,512,12,3561587662
3989,31420990,22151599,53572589,3,0,0,4608,18,623787968
3990,31424060,22354242,53778302,9,0,0,5120,4,968047745
3991,31433070,54321258,85754328,8,0,1,12288,11,9656966762
3992,31438200,54316151,85754351,0,0,1,7680,6,9479758741
3993,31439970,22120062,53560032,1,0,0,18432,1,7042360379
3994,31440650,54313724,85754374,2,0,1,3072,1,1594253422
3995,31443080,54311317,85754397,1,0,1,3072,1,2139397339
3996,31450080,54304340,85754420,6,0,1,6656,12,7453671615
3997,31460650,22712572,54173222,1,0,0,4096,1,9025991869
3998,31461940,54292503,85754443,2,0,1,5632,1,1616018929
3999,31481750,54296327,85778077,1,0,1,4608,1,4173953065
4000,31482879,54295221,85778100,5,0,1,1536,12,1648437727
4001,31487800,22264042,53751842,3,0,0,22016,18,2227508436
4002,31488690,22784331,54273021,4,0,0,113664,7,1231070575
4003,31490529,54287594,85778123,5,0,1,4096,12,5555138149
4004,31493210,22077944,53571154,3,0,0,17920,18,10691175238
4005,31493460,22244165,53737625,4,0,0,40960,7,10441471595
4006,31493599,54284547,85778146,3,0,1,1024,18,3763652882
4007,31497860,22458151,53956011,9,0,0,17920,4,9573943223
4008,31504760,23381749,54886509,8,0,0,44544,11,1800516617
4009,31518150,22587192,54105342,1,0,0,16896,1,7355147565
4010,31523240,22141152,53664392,5,0,0,18432,12,5184495552
4011,31527760,22072835,53600595,7,0,0,16896,1,3959789171
4012,31533780,24044687,55578467,7,0,0,70144,1,1946630021
4013,31540080,22328353,53868433,2,0,0,26624,1,9685862671
4014,31545680,23427974,54973654,9,0,0,37888,4,10336547017
4015,31555460,22906812,54462272,8,0,0,107520,11,4414974668
4016,31573310,23039677,54612987,6,0,0,114176,12,4488231489
4017,31577400,23655304,55232704,6,0,0,98304,12,6664247013
4018,31582360,22377418,53959778,0,0,0,12288,6,6102927518
4019,31582710,22317258,53899968,1,0,0,4608,1,8546504862
4020,31583440,22723443,54306883,4,0,0,9728,7,1798975923
4021,31594890,23085990,54680880,5,0,0,3072,12,6269461338
4022,31605230,22418198,54023428,3,0,0,28160,18,3920532040
4023,31605380,22239560,53844940,3,0,0,9216,18,6604707906
4024,31607340,54338556,85945896,7,0,1,254464,1,9942905926
4025,31608380,22665600,54273980,6,0,0,3072,12,4967427483
4026,31614920,22759108,54374028,2,0,0,3072,1,5369508889
4027,31618839,54336519,85955358,5,0,1,1024,12,6583776469
4028,31627310,54338746,85966056,8,0,1,3072,11,1886825194
4029,31628110,54351554,85979664,7,0,1,12800,1,5709649965
4030,31631350,23131105,54762455,1,0,0,10240,1,3170642295
4031,31636970,22296687,53933657,1,0,0,4608,1,6909305928
4032,31670270,22485956,54156226,4,0,0,39936,7,2588861803
4033,31671880,54317138,85989018,8,0,1,11776,11,8907273376
4034,31672950,23284965,54957915,7,0,0,17920,1,6177554238
4035,31677930,54328199,86006129,8,0,1,26624,11,874776719
4036,31688130,54320585,86008715,2,0,1,4096,1,9767754691
4037,31692450,22381369,54073819,4,0,0,13312,7,5656446107
4038,31697560,22923163,54620723,1,0,0,25088,1,3540812602
4039,31701700,23222587,54924287,4,0,0,30208,7,6467568785
4040,31709000,23989592,55698592,9,0,0,156160,4,8178921398
4041,31710930,54301331,86012261,6,0,1,5632,12,7921402940
4042,31716590,22812119,54528709,6,0,0,106496,12,10011344528
4043,31720350,22833365,54553715,6,0,0,1536,12,325391590
4044,31722810,24009171,55731981,5,0,0,27648,12,8318505929
4045,31723120,23125054,54848174,2,0,0,60928,1,8649441616
4046,31737820,54288245,86026065,2,0,1,6656,1,6755530814
4047,31747140,24196582,55943722,2,0,0,27136,1,1678810106
4048,31765630,22919017,54684647,4,0,0,12288,7,1989382582
4049,31768100,22577276,54345376,2,0,0,13824,1,6067845181
4050,31779390,24147860,55927250,7,0,0,62976,1,9095689156
4051,31797170,22900939,54698109,6,0,0,9216,12,8589654587
4052,31800580,22773664,54574244,5,0,0,2048,12,6902655860
4053,31804690,23311926,55116616,1,0,0,64000,1,3306667691
4054,31813620,23426930,55240550,9,0,0,25600,4,9567091765
4055,31822269,54204142,86026411,5,0,1,512,12,10516735597
4056,31834340,23432986,55267326,6,0,0,76800,12,9760198036
4057,31838420,24237489,56075909,2,0,0,83968,1,8853811169
4058,31869020,22173545,54042565,0,0,0,2560,6,4129010924
4059,31876230,54555762,86431992,4,0,1,235520,7,2702874061
4060,31886560,22680126,54566686,5,0,0,42496,12,1556042044
4061,31896130,54569285,86465415,6,0,1,20992,12,357047263
4062,31914370,54569264,86483634,8,0,1,3072,11,1214773046
4063,31919350,22421516,54340866,1,0,0,12800,1,10602139639
4064,31924150,22355633,54279783,1,0,0,18944,1,6482226693
4065,31932600,23889501,55822101,1,0,0,80896,1,9479093378
4066,31934650,23853202,55787852,1,0,0,183296,1,6146285408
4067,31956440,23392862,55349302,5,0,0,76288,12,3442453137
4068,31966830,22858258,54825088,4,0,0,3584,7,8113236928
4069,31995810,22242556,54238366,9,0,0,32256,4,1323469429
4070,31998560,22372358,54370918,8,0,0,16384,11,6824473216
4071,32002090,23871670,55873760,3,0,0,169472,18,6304905295
4072,32043979,54439686,86483665,3,0,1,6144,18,1255148448
4073,32060300,24290525,56350825,9,0,0,29696,4,3931728092
4074,32067730,54416069,86483799,2,0,1,13312,1,2299520770
4075,32068470,23055966,55124436,2,0,0,2560,1,2062074062
4076,32079260,22600661,54679921,8,0,0,57344,11,7051120198
4077,32081070,22302092,54383162,7,0,0,15360,1,148918960
4078,32082450,23895303,55977753,9,0,0,111616,4,974146915
4079,32095700,23199022,55294722,9,0,0,81408,4,1236828972
4080,32095980,22678786,54774766,1,0,0,9728,1,715765832
4081,32098030,22907025,55005055,9,0,0,9216,4,5142703852
4082,32103399,54425152,86528551,3,0,1,5120,18,10007051689
4083,32112070,22690400,54802470,8,0,0,5120,11,734035312
4084,32125660,22447913,54573573,6,0,0,22528,12,5626321050
4085,32133430,22775990,54909420,5,0,0,7168,12,5843713884
4086,32133750,22923937,55057687,2,0,0,512,1,5800277889
4087,32133910,22599556,54733466,3,0,0,2048,18,10315352227
4088,32147600,22725268,54872868,9,0,0,80896,4,1431082705
4089,32148260,54380752,86529012,0,0,1,10240,6,8935418785
4090,32153800,23321756,55475556,7,0,0,18432,1,3838915279
4091,32161670,54463967,86625637,1,0,1,10240,1,7669318968
4092,32192850,54433018,86625868,6,0,1,6656,12,3653893521
4093,32197890,23265329,55463219,3,0,0,2048,18,6055933654
4094,32198410,23432900,55631310,1,0,0,28160,1,3427135775
4095,32211590,24020424,56232014,4,0,0,67584,7,3856154280
4096,32221620,22473658,54695278,2,0,0,34816,1,1096715873
4097,32226780,22870313,55097093,0,0,0,17408,6,1221874849
4098,32232150,23385028,55617178,8,0,0,126976,11,6136757757
4099,32236640,22855103,55091743,2,0,0,71680,1,2471110625
4100,32258660,23443878,55702538,3,0,0,2560,18,9358088125
4101,32260970,54500639,86761609,7,0,1,83456,1,332838092
4102,32263440,55089131,87352571,4,0,1,418816,7,6589668090
4103,32279950,55403610,87683560,4,0,1,290304,7,2070952993
4104,32283970,55407488,87691458,6,0,1,44544,12,10182717594
4105,32289600,23006861,55296461,0,0,0,5632,6,3794688572
4106,32296500,23354489,55650989,7,0,0,64512,1,6627200561
4107,32305150,23134242,55439392,0,0,0,56832,6,8003965696
4108,32310620,23481327,55791947,1,0,0,13312,1,9297070000
4109,32320340,23947022,56267362,5,0,0,32256,12,5272093757
4110,32327230,22865395,55192625,6,0,0,20480,12,10716775874
4111,32347840,23190611,55538451,5,0,0,8704,12,8404143419
4112,32353060,22764983,55118043,1,0,0,4608,1,7711389113
4113,32354760,23744664,56099424,8,0,0,18432,11,4326906908
4114,32360060,23262624,55622684,0,0,0,16384,6,5098132872
4115,32369140,55382723,87751863,0,0,1,3584,6,3702914705
4116,32369940,22816422,55186362,3,0,0,4096,18,8936703612
4117,32371770,55380116,87751886,1,0,1,5632,1,5166358264
4118,32376151,55379681,87755832,9,0,1,1536,4,8912884822
4119,32376310,23528563,55904873,3,0,0,23040,18,3004909893
4120,32393750,23223919,55617669,9,0,0,1536,4,3260831893
4121,32396810,22637444,55034254,0,0,0,7680,6,298751746
4122,32401970,22910114,55312084,6,0,0,51200,12,8502050556
4123,32410750,24264801,56675551,4,0,0,43520,7,4265555440
4124,32420240,22823476,55243716,7,0,0,10240,1,3445418484
4125,32420520,55335335,87755855,1,0,1,4608,1,10668091023
4126,32426220,22758871,55185091,8,0,0,63488,11,5919294597
4127,32434950,24042673,56477623,5,0,0,6144,12,3723088150
4128,32453420,55302458,87755878,1,0,1,8704,1,6438919411
4129,32454910,24446191,56901101,1,0,0,51712,1,947901397
4130,32479190,22926002,55405192,8,0,0,31744,11,4885677453
4131,32491230,23980883,56472113,4,0,0,6144,7,9455888806
4132,32497440,23527800,56025240,9,0,0,26624,4,3827876024
4133,32509120,22981709,55490829,6,0,0,14848,12,8252562752
4134,32509140,55246761,87755901,1,0,1,11776,1,6663256180
4135,32513430,22934877,55448307,9,0,0,29184,4,3086782303
4136,32530370,23367460,55897830,7,0,0,31744,1,2932339444
4137,32537030,23563509,56100539,2,0,0,3584,1,9217199059
4138,32538790,55231508,87770298,2,0,1,6656,1,1803030642
4139,32544780,55246899,87791679,0,0,1,9728,6,9225406007
4140,32554430,24486890,57041320,6,0,0,12800,12,5855541772
4141,32603290,55192895,87796185,6,0,1,7168,12,4671192994
4142,32612380,24025196,56637576,0,0,0,27648,6,4471530402
4143,32615880,22806173,55422053,7,0,0,49152,1,4274729656
4144,32632430,24889175,57521605,3,0,0,51712,18,7882258180
4145,32634740,22827786,55462526,6,0,0,46592,12,6254286267
4146,32650320,22818546,55468866,0,0,0,18432,6,8379018070
4147,32661890,24057832,56719722,4,0,0,13824,7,6793809043
4148,32671660,23259357,55931017,2,0,0,12288,1,5202320024
4149,32673560,55245947,87919507,7,0,1,66560,1,6589654602
4150,32690810,22553085,55243895,5,0,0,512,12,7334289553
4151,32702910,23715570,56418480,8,0,0,58880,11,1912682015
4152,32715200,55204330,87919530,6,0,1,9216,12,3959197900
4153,32724570,23899890,56624460,1,0,0,77312,1,2676739895
4154,32738780,23169259,55908039,2,0,0,10240,1,6887547551
4155,32745080,24196910,56941990,8,0,0,69632,11,6136199299
4156,32749789,55169780,87919569,3,0,1,16896,18,6665820421
4157,32750030,22973504,55723534,5,0,0,18944,12,9433707781
4158,32750850,23562186,56313036,1,0,0,10240,1,5293475373
4159,32770920,23161524,55932444,4,0,0,4608,7,5798958966
4160,32772560,23418201,56190761,2,0,0,56832,1,10201276517
4161,32781520,22936219,55717739,3,0,0,25088,18,2841087005
4162,32784990,22921627,55706617,9,0,0,13312,4,6366187643
4163,32790840,23382582,56173422,6,0,0,52224,12,9105000480
4164,32791850,23214601,56006451,3,0,0,44032,18,4722785081
4165,32796500,24314656,57111156,3,0,0,23040,18,10331267740
4166,32796670,23409402,56206072,9,0,0,50176,4,7186213234
4167,32814290,22887445,55701735,9,0,0,10240,4,3128705384
4168,32819270,23883255,56702525,3,0,0,32768,18,10419430214
4169,32822710,22974720,55797430,0,0,0,17920,6,1847292123
4170,32831670,23876935,56708605,1,0,0,14848,1,2435646219
4171,32837620,23143276,55980896,8,0,0,10240,11,3556628004
4172,32838970,23399307,56238277,2,0,0,20480,1,4514710498
4173,32849510,23967225,56816735,9,0,0,27136,4,366542430
4174,32854700,23162405,56017105,4,0,0,34816,7,1566268116
4175,32861380,55066815,87928195,2,0,1,3072,1,9150899095
4176,32864260,23229525,56093785,6,0,0,2048,12,4803437568
4177,32864870,24892242,57757112,6,0,0,10752,12,8929788913
4178,32873000,25014318,57887318,9,0,0,124416,4,1632797609
4179,32879090,23009045,55888135,2,0,0,47104,1,4426501373
4180,32891300,24819561,57710861,4,0,0,78848,7,8202420155
4181,32897030,23130573,56027603,0,0,0,7680,6,810632329
4182,32900440,22809632,55710072,7,0,0,11264,1,6584271876
4183,32901650,23866102,56767752,9,0,0,26112,4,2088729935
4184,32905870,55226666,88132536,7,0,1,157184,1,4555984363
4185,32909460,23025971,55935431,9,0,0,9728,4,396727511
4186,32921280,23126637,56047917,5,0,0,2560,12,2942366337
4187,32925180,23060263,55985443,8,0,0,14848,11,6190914161
4188,32935450,24279107,57214557,5,0,0,34304,12,8287532429
4189,32936290,23052764,55989054,5,0,0,11776,12,7959618527
4190,32941580,23148392,56089972,3,0,0,46080,18,8628701450
4191,32948310,24333789,57282099,6,0,0,31744,12,3275555442
4192,32974120,23911202,56885322,1,0,0,32768,1,2845065526
4193,32976569,55182033,88158602,3,0,1,12288,18,4783289207
4194,32985750,55697132,88682882,4,0,1,508928,7,6671269061
4195,33011530,23733164,56744694,4,0,0,7680,7,10030942411
4196,33025040,23065423,56090463,1,0,0,1536,1,4889569659
4197,33038630,23231719,56270349,5,0,0,9728,12,9974627062
4198,33046200,23204580,56250780,5,0,0,40960,12,1558336312
4199,33052100,23096549,56148649,3,0,0,69120,18,4387313892
4200,33075720,23295595,56371315,6,0,0,7680,12,7547564926
4201,33079360,23013778,56093138,1,0,0,8704,1,4541157040
4202,33097410,24589396,57686806,1,0,0,141824,1,1108437375
4203,33100510,23549778,56650288,1,0,0,4608,1,4285844618
4204,33103470,23107929,56211399,4,0,0,17408,7,821348573
4205,33103710,24890053,57993763,1,0,0,50688,1,6775587483
4206,33107330,23763263,56870593,9,0,0,19968,4,4035454982
4207,33115690,23141821,56257511,8,0,0,22016,11,6772394021
4208,33126120,23385667,56511787,0,0,0,10240,6,7681044265
4209,33128180,23446684,56574864,2,0,0,36352,1,76863764
4210,33139600,23421958,56561558,9,0,0,35328,4,6524914207
4211,33143580,23715780,56859360,7,0,0,43520,1,3720357330
4212,33149320,55536174,88685494,8,0,1,4096,11,5777887098
4213,33158680,23114390,56273070,1,0,0,8704,1,7846613597
4214,33161000,55525467,88686467,6,0,1,12800,12,3925355822
4215,33163900,23236040,56399940,3,0,0,13824,18,5438655671
4216,33201660,55815035,89016695,7,0,1,487424,1,1088933491
4217,33205700,23862712,57068412,0,0,0,57856,6,2986839889
4218,33225300,23196034,56421334,2,0,0,9216,1,9919338380
4219,33227020,23310674,56537694,0,0,0,59904,6,4412122309
4220,33229950,23138994,56368944,3,0,0,59392,18,6789267401
4221,33230970,23076571,56307541,1,0,0,3584,1,9549228812
4222,33233720,56224475,89458195,4,0,1,475648,7,1362276123
4223,33277610,23732254,57009864,9,0,0,133120,4,2256676223
4224,33285490,56227438,89512928,6,0,1,15872,12,1496048668
4225,33295950,24926216,58222166,5,0,0,22016,12,559719981
4226,33314760,23345526,56660286,4,0,0,12288,7,7128700476
4227,33331330,24781971,58113301,9,0,0,35328,4,10655107354
4228,33332010,24106764,57438774,3,0,0,9728,18,10101235505
4229,33369550,24635780,58005330,1,0,0,37888,1,3156569914
4230,33381320,23080294,56461614,5,0,0,12800,12,2402727498
4231,33389000,23980129,57369129,4,0,0,30208,7,2933470907
4232,33398000,24868345,58266345,9,0,0,78336,4,8243749855
4233,33400240,23882038,57282278,3,0,0,512,18,489979942
4234,33411900,23837994,57249894,5,0,0,67584,12,375267813
4235,33412320,23266218,56678538,4,0,0,9728,7,6558062045
4236,33412380,56101316,89513696,1,0,1,11776,1,869032548
4237,33412810,23429103,56841913,8,0,0,38912,11,848213717
4238,33420350,23665453,57085803,8,0,0,50176,11,162533576
4239,33432760,56084802,89517562,2,0,1,6144,1,5451674750
4240,33439080,23859711,57298791,5,0,0,20480,12,8765510978
4241,33444660,23096021,56540681,0,0,0,9728,6,1190431519
4242,33445020,56153009,89598029,2,0,1,9728,1,3548328207
4243,33446260,23591106,57037366,3,0,0,85504,18,5672512847
4244,33458700,24467999,57926699,2,0,0,68096,1,7449390897
4245,33463890,23853993,57317883,4,0,0,33280,7,7610098639
4246,33470910,24993823,58464733,4,0,0,39936,7,1967029253
4247,33474550,23346732,56821282,5,0,0,14848,12,9373962589
4248,33499750,24952792,58452542,2,0,0,34816,1,3773922049
4249,33509770,23298674,56808444,0,0,0,23552,6,8045500737
4250,33511510,23052255,56563765,7,0,0,7168,1,1831711053
4251,33514530,56086725,89601255,8,0,1,5120,11,8685258931
4252,33521300,23447973,56969273,6,0,0,12800,12,9067517859
4253,33534580,56067239,89601819,2,0,1,10752,1,2080792929
4254,33534760,23157758,56692518,3,0,0,10240,18,1171265706
4255,33542400,25190012,58732412,1,0,0,7168,1,2640601349
4256,33558370,24247770,57806140,8,0,0,33280,11,5839520670
4257,33563020,56314051,89877071,4,0,1,102912,7,5079366042
4258,33565700,23577813,57143513,8,0,0,512,11,5634371523
4259,33566030,24380348,57946378,1,0,0,64512,1,8708456798
4260,33569350,24771142,58340492,5,0,0,91648,12,1295801890
4261,33570640,23394710,56965350,2,0,0,33280,1,4690588461
4262,33591639,56285455,89877094,5,0,1,22528,12,1680915484
4263,33597520,23545814,57143334,0,0,0,75776,6,5053910287
4264,33612320,23660084,57272404,0,0,0,19968,6,3147697256
4265,33617620,25487483,59105103,7,0,0,15360,1,1029047311
4266,33618090,56259027,89877117,8,0,1,8704,11,2315751923
4267,33624840,25633393,59258233,7,0,0,27136,1,6511731416
4268,33641830,23263974,56905804,1,0,0,15360,1,2048192880
4269,33648840,25075414,58724254,2,0,0,15360,1,8690862641
4270,33651059,56226081,89877140,5,0,1,11776,12,7162757892
4271,33659440,23444627,57104067,0,0,0,44032,6,3680493092
4272,33665650,56211513,89877163,0,0,1,7680,6,2068786709
4273,33668600,23505555,57174155,7,0,0,8192,1,7483471249
4274,33677820,23333471,57011291,5,0,0,4608,12,2009316315
4275,33679760,23477348,57157108,4,0,0,44544,7,6038738400
4276,33687220,24355431,58042651,2,0,0,3584,1,6970323121
4277,33697610,56184747,89882357,0,0,1,26112,6,5718851304
4278,33713290,24064754,57778044,5,0,0,2560,12,886761003
4279,33714780,23467242,57182022,3,0,0,6144,18,2887140932
4280,33716880,24015422,57732302,4,0,0,29696,7,10071756348
4281,33719840,23707160,57427000,0,0,0,19968,6,225680583
4282,33728410,25681757,59410167,3,0,0,55808,18,10052961525
4283,33749120,23438209,57187329,4,0,0,9216,7,9666452969
4284,33766320,23449352,57215672,7,0,0,3584,1,5440459483
4285,33768040,24181934,57949974,9,0,0,6144,4,10495517472
4286,33779480,23598838,57378318,1,0,0,23040,1,1687154490
4287,33781490,24314153,58095643,1,0,0,17920,1,5958624254
4288,33789770,56112198,89901968,6,0,1,27648,12,1350504147
4289,33790240,25075132,58865372,9,0,0,35328,4,6944612644
4290,33811160,56262923,90074083,7,0,1,218112,1,8388969873
4291,33847100,24243060,58090160,8,0,0,114176,11,8289193022
4292,33847190,24320135,58167325,1,0,0,10240,1,1327233421
4293,33849070,23417227,57266297,5,0,0,53760,12,9102421699
4294,33867870,23664990,57532860,3,0,0,36864,18,3429686329
4295,33879250,56205245,90084495,8,0,1,8704,11,5155178869
4296,33881350,56207971,90089321,0,0,1,7680,6,10735433687
4297,33901160,24124793,58025953,3,0,0,67584,18,4527816444
4298,33905841,56184826,90090667,9,0,1,2048,4,9074468656
4299,33924840,23981088,57905928,2,0,0,33792,1,3123213897
4300,33928860,24989894,58918754,4,0,0,12800,7,9020200535
4301,33931640,23463310,57394950,7,0,0,5632,1,4403716571
4302,33950350,23550305,57500655,1,0,0,32256,1,100775041
4303,33963400,23492136,57455536,4,0,0,12800,7,8922330600
4304,33965349,56125882,90091231,3,0,1,10752,18,3909961915
4305,33979280,24176223,58155503,7,0,0,22016,1,5291633520
4306,33979950,23325303,57305253,3,0,0,2048,18,891633581
4307,33981290,23524536,57505826,9,0,0,16896,4,8699405230
4308,33981440,25268502,59249942,2,0,0,69120,1,5375956007
4309,33981470,56110325,90091795,6,0,1,10752,12,1086103683
4310,33982380,23753221,57735601,5,0,0,10752,12,191180298
4311,33983050,23594376,57577426,9,0,0,10240,4,9008072184
4312,33990970,23379898,57370868,4,0,0,5632,7,6895311322
4313,34011150,23825776,57836926,8,0,0,33792,11,1446912224
4314,34021930,23694882,57716812,4,0,0,19456,7,2325103035
4315,34028680,25050628,59079308,4,0,0,14336,7,4087372860
4316,34039070,24256649,58295719,1,0,0,61440,1,6809392113
4317,34043320,23256118,57299438,8,0,0,2048,11,6130937043
4318,34062990,23531857,57594847,0,0,0,16896,6,6633372053
4319,34064500,24135241,58199741,1,0,0,14848,1,5730327377
4320,34067190,23656041,57723231,4,0,0,20992,7,940842908
4321,34070050,23668226,57738276,1,0,0,8704,1,2916138533
4322,34073390,24287895,58361285,4,0,0,23552,7,5971195494
4323,34075660,24201316,58276976,1,0,0,34816,1,7931277457
4324,34090310,24295655,58385965,8,0,0,9728,11,10011198124
4325,34100300,23434027,57534327,2,0,0,4608,1,9312847719
4326,34107430,25355386,59462816,8,0,0,64000,11,1724605960
4327,34111730,24618475,58730205,6,0,0,19456,12,2297570062
4328,34118570,23503240,57621810,1,0,0,22016,1,6834603474
4329,34119340,56031487,90150827,4,0,1,45568,7,1915971288
4330,34120560,25393607,59514167,5,0,0,107008,12,2140798224
4331,34122410,24592883,58715293,3,0,0,77312,18,3895842365
4332,34150240,23474832,57625072,1,0,0,9216,1,6701383171
4333,34150500,56589778,90740278,7,0,1,651776,1,1597621896
4334,34154770,24498571,58653341,8,0,0,22016,11,1543383391
4335,34160969,56589728,90750697,3,0,1,7680,18,2132355824
4336,34183260,24654823,58838083,4,0,0,16384,7,4883255175
4337,34185850,56580685,90766535,2,0,1,1536,1,6081762298
4338,34189780,56579661,90769441,6,0,1,4608,12,8436025232
4339,34208430,56563051,90771481,8,0,1,11264,11,6822830869
4340,34211560,25533297,59744857,0,0,0,137728,6,6291789005
4341,34212130,56616545,90828675,4,0,1,107520,7,6012221744
4342,34212910,23613689,57826599,5,0,0,67072,12,5001788720
4343,34215700,23762596,57978296,8,0,0,28672,11,7950568955
4344,34218440,23677169,57895609,3,0,0,27136,18,8017108897
4345,34243240,23966063,58209303,4,0,0,1024,7,186237327
4346,34244180,23595889,57840069,6,0,0,10240,12,7363451843
4347,34254209,56578012,90832221,3,0,1,5632,18,572363357
4348,34255210,56621813,90877023,4,0,1,95232,7,10613458037
4349,34255310,56628941,90884251,2,0,1,2048,1,24949478
4350,34266620,24425094,58691714,6,0,0,121856,12,10210262362
4351,34267190,23764090,58031280,7,0,0,17408,1,10337451127
4352,34280710,24686460,58967170,8,0,0,45056,11,2610284175
4353,34286880,23815634,58102514,4,0,0,11776,7,8259771123
4354,34295120,25139570,59434690,4,0,0,80384,7,8728655254
4355,34300130,24486981,58787111,3,0,0,11264,18,5605140319
4356,34303400,23919257,58222657,7,0,0,1536,1,2284802700
4357,34317820,56624546,90942366,8,0,1,64512,11,6999499728
4358,34318260,24514808,58833068,8,0,0,90624,11,7575923605
4359,34324740,56621172,90945912,2,0,1,5632,1,8108260974
4360,34332610,23876358,58208968,7,0,0,30208,1,6510294966
4361,34337660,23963386,58301046,3,0,0,17408,18,4745714817
4362,34362690,23682253,58044943,8,0,0,1024,11,8166185631
4363,34376810,23926755,58303565,3,0,0,8192,18,7875940931
4364,34381490,24417162,58798652,7,0,0,23040,1,8992028739
4365,34382050,25375622,59757672,2,0,0,41984,1,1708901404
4366,34388090,25429653,59817743,0,0,0,6144,6,7128905023
4367,34388860,25259522,59648382,4,0,0,15872,7,9668974606
4368,34394730,56598829,90993559,1,0,1,41984,1,934128566
4369,34399270,56596235,90995505,1,0,1,3072,1,2423411105
4370,34416900,24236620,58653520,3,0,0,512,18,7094227152
4371,34420100,25957797,60377897,8,0,0,941056,11,6653680074
4372,34445730,25516773,59962503,7,0,0,24064,1,9421171253
4373,34452029,56543822,90995851,3,0,1,512,18,703692102
4374,34452640,24266420,58719060,8,0,0,12288,11,3849089796
4375,34460410,24169131,58629541,9,0,0,20480,4,10689306005
4376,34461310,25421440,59882750,5,0,0,88576,12,3910279334
4377,34464530,56532627,90997157,2,0,1,2048,1,397867121
4378,34469429,56529354,90998783,5,0,1,2560,12,6374347768
4379,34474280,24041062,58515342,7,0,0,20480,1,9504325533
4380,34489720,24622738,59112458,7,0,0,24064,1,8948877495
4381,34495290,56682001,91177291,4,0,1,318976,7,3061684014
4382,34502669,56745124,91247793,3,0,1,24064,18,6477930351
4383,34508460,25895604,60404064,5,0,0,5120,12,4416181276
4384,34509760,25131959,59641719,5,0,0,41984,12,8687535285
4385,34512060,25942686,60454746,7,0,0,84480,1,5381548466
4386,34517140,24504021,59021161,4,0,0,61440,7,5198779660
4387,34531610,25856496,60388106,5,0,0,10240,12,4071590385
4388,34537189,56710950,91248139,5,0,1,512,12,7234923617
4389,34538420,24600058,59138478,6,0,0,41472,12,8699026222
4390,34560650,24472255,59032905,8,0,0,14336,11,8784397205
4391,34579660,24263594,58843254,5,0,0,16896,12,8365056747
4392,34590529,56662436,91252965,5,0,1,7680,12,9677429911
4393,34598860,24764758,59363618,4,0,0,31744,7,4382262977
4394,34614259,56643212,91257471,5,0,1,7168,12,5968956897
4395,34616970,56880817,91497787,4,0,1,158720,7,6722706251
4396,34619840,25449625,60069465,0,0,0,23040,6,5630131210
4397,34624400,24095151,58719551,8,0,0,1536,11,3459072893
4398,34627520,24585990,59213510,2,0,0,60928,1,8341953353
4399,34634900,25180137,59815037,9,0,0,89088,4,7605612332
4400,34645280,56853275,91498555,4,0,1,11776,7,5690567079
4401,34652939,56968550,91621489,3,0,1,31232,18,7923083229
4402,34653900,57009139,91663039,1,0,1,15360,1,8085653053
4403,34668740,25802409,60471149,5,0,0,53760,12,2505852639
4404,34671140,24998272,59669412,3,0,0,3584,18,2268556756
4405,34685280,24268139,58953419,6,0,0,36864,12,8671915729
4406,34691460,25844677,60536137,4,0,0,37888,7,4726921669
4407,34732030,24483375,59215405,9,0,0,6144,4,3142612205
4408,34737440,57132893,91870333,4,0,1,156160,7,2639695379
4409,34741380,25841228,60582608,5,0,0,39424,12,2014254868
4410,34760290,24538561,59298851,5,0,0,2560,12,1598068068
4411,34768820,24749761,59518581,3,0,0,10240,18,4298858387
4412,34769400,24509136,59278536,4,0,0,61440,7,3028989990
4413,34775250,24617711,59392961,5,0,0,83456,12,6124303946
4414,34779000,24685867,59464867,1,0,0,6656,1,5970596723
4415,34785720,24682602,59468322,1,0,0,11264,1,8071419770
4416,34805830,24294496,59100326,6,0,0,1536,12,10557173821
4417,34826260,25744313,60570573,6,0,0,22016,12,1557016552
4418,34848080,24375870,59223950,7,0,0,8192,1,5930470281
4419,34852710,24496093,59348803,4,0,0,14848,7,3265806343
4420,34885380,24050841,58936221,5,0,0,6656,12,2700495378
4421,34901540,25007264,59908804,8,0,0,42496,11,2626966157
4422,34933830,24066279,59000109,4,0,0,4608,7,4266649875
4423,34947790,25723416,60671206,1,0,0,53760,1,3621613268
4424,34951520,56920263,91871783,4,0,1,6144,7,2198530299
4425,34952740,24588268,59541008,0,0,0,53248,6,2710201483
4426,34976430,24605198,59581628,1,0,0,53248,1,9701209823
4427,34981550,24492023,59473573,0,0,0,5120,6,9104884443
4428,34983590,24346610,59330200,6,0,0,4608,12,7671869700
4429,34984780,24910855,59895635,1,0,0,39936,1,2591451443
4430,34986560,57371379,92357939,7,0,1,491520,1,2495640494
4431,34990330,24712540,59702870,4,0,0,56832,7,996484759
4432,34990390,25734572,60724962,4,0,0,14336,7,6713888035
4433,34991440,24451853,59443293,1,0,0,28160,1,7886778765
4434,34994680,24520758,59515438,1,0,0,4096,1,7080320749
4435,35015930,24839809,59855739,5,0,0,24064,12,5520793240
4436,35026080,57359584,92385664,8,0,1,29696,11,8191396084
4437,35027300,25676377,60703677,8,0,0,106496,11,6939720013
4438,35031009,57429857,92460866,5,0,1,31232,12,3365154321
4439,35040710,24993195,60033905,4,0,0,38912,7,5010898480
4440,35057140,24336000,59393140,1,0,0,512,1,5621239188
4441,35063360,57403100,92466460,2,0,1,18432,1,5625005203
4442,35070940,24531889,59602829,3,0,0,13824,18,6753166956
4443,35074830,24710499,59785329,4,0,0,32768,7,744578277
4444,35082149,57392588,92474737,5,0,1,7168,12,9621623738
4445,35085990,57389925,92475915,0,0,1,13824,6,2728680930
4446,35087240,24510120,59597360,4,0,0,6656,7,8045762481
4447,35090080,57417881,92507961,8,0,1,4608,11,3491289212
4448,35091350,57416634,92507984,0,0,1,1536,6,334898031
4449,35105639,57402368,92508007,3,0,1,512,18,1418257346
4450,35110110,24545895,59656005,1,0,0,2048,1,9516305102
4451,35114800,24840348,59955148,6,0,0,33280,12,10427687894
4452,35117390,25664678,60782068,2,0,0,39936,1,437074984
4453,35119140,25405430,60524570,6,0,0,124928,12,1005007905
4454,35120390,24521508,59641898,8,0,0,512,11,4439909194
4455,35125500,24936922,60062422,1,0,0,26112,1,3919366010
4456,35176360,24867708,60044068,7,0,0,33280,1,290146696
4457,35182080,24800545,59982625,8,0,0,14336,11,6522621432
4458,35188070,57319960,92508030,0,0,1,12800,6,9712735409
4459,35188419,57320406,92508825,5,0,1,17920,12,6393865188
4460,35190440,24625400,59815840,3,0,0,2560,18,5166220112
4461,35194890,25659378,60854268,2,0,0,11264,1,8079797288
4462,35197770,24800628,59998398,5,0,0,24576,12,5115336288
4463,35210900,57723585,92934485,7,0,1,250368,1,8006388982
4464,35218200,24835095,60053295,5,0,0,30208,12,6614893583
4465,35228580,25156383,60384963,4,0,0,4096,7,772327390
4466,35239200,25163281,60402481,9,0,0,47104,4,4316018978
4467,35241680,24727677,59969357,0,0,0,1024,6,4137923270
4468,35241880,24669599,59911479,3,0,0,8704,18,6037723192
4469,35272460,25674178,60946638,8,0,0,81408,11,8992463925
4470,35274000,25153556,60427556,4,0,0,13312,7,3826959722
4471,35278870,57966884,93245754,7,0,1,181760,1,5476134678
4472,35280520,25103172,60383692,8,0,0,18944,11,7617225586
4473,35290650,57955360,93246010,0,0,1,9216,6,10419358464
4474,35293520,25270298,60563818,4,0,0,73216,7,7074958313
4475,35297280,25706722,61004002,0,0,0,29184,6,201795623
4476,35307770,25323587,60631357,1,0,0,69632,1,10356626930
4477,35316930,25093888,60410818,3,0,0,18432,18,929488734
4478,35325090,25080089,60405179,1,0,0,3584,1,156291038
4479,35337690,25272420,60610110,4,0,0,82432,7,398761722
4480,35365680,58018408,93384088,8,0,1,166400,11,2549786553
4481,35369680,25053797,60423477,0,0,0,41472,6,7458761148
4482,35376780,25162344,60539124,1,0,0,9728,1,8243023222
4483,35378920,25107563,60486483,8,0,0,2560,11,9567572331
4484,35390890,58057314,93448204,7,0,1,58368,1,9166598458
4485,35401880,25083800,60485680,3,0,0,47616,18,3568396447
4486,35403610,25137877,60541487,6,0,0,7680,12,2404636164
4487,35404000,25987845,61391845,2,0,0,67072,1,5023453704
4488,35415210,25237854,60653064,4,0,0,71168,7,4239130448
4489,35420520,25008463,60428983,3,0,0,4608,18,1659738088
4490,35420640,58037964,93458604,1,0,1,14848,1,1653830736
4491,35427820,25157151,60584971,0,0,0,7680,6,4519077639
4492,35432720,26222761,61655481,0,0,0,49152,6,402790473
4493,35456460,58344918,93801378,8,0,1,380416,11,919771449
4494,35459369,58344275,93803644,5,0,1,3584,12,3865470056
4495,35465460,25189343,60654803,2,0,0,5632,1,7593875929
4496,35468680,25323418,60792098,7,0,0,16896,1,8912136099
4497,35477000,58468631,93945631,7,0,1,133120,1,1564692764
4498,35485170,25844413,61329583,6,0,0,95744,12,5585931418
4499,35508050,25228791,60736841,7,0,0,38912,1,3753577471
4500,35516510,26464008,61980518,9,0,0,28672,4,8652662793
4501,35521770,25198801,60720571,6,0,0,48640,12,3500868076
4502,35528920,26244178,61773098,3,0,0,46080,18,4389595707
4503,35536010,26854609,62390619,1,0,0,9216,1,3599104307
4504,35543180,58488910,94032090,8,0,1,70144,11,2228897849
4505,35551290,25598262,61149552,4,0,0,28160,7,3469529177
4506,35553470,25233457,60786927,3,0,0,15872,18,7939689388
4507,35563010,25179026,60742036,8,0,0,16896,11,8103242203
4508,35568550,25985986,61554536,5,0,0,138240,12,1598175011
4509,35568580,25137148,60705728,0,0,0,6656,6,5943611245
4510,35592630,25544647,61137277,2,0,0,26624,1,4484749049
4511,35594760,25293499,60888259,1,0,0,9216,1,413341188
4512,35605410,25222372,60827782,1,0,0,28160,1,5334160132
4513,35617460,58438820,94056280,0,0,1,7680,6,3289794063
4514,35622460,25372627,60995087,8,0,0,12800,11,6615130996
4515,35644779,58411524,94056303,5,0,1,7168,12,10630659504
4516,35657270,58399056,94056326,4,0,1,7680,7,2327235137
4517,35658590,25318814,60977404,2,0,0,4096,1,581269976
4518,35661900,25607215,61269115,9,0,0,29696,4,6307801085
4519,35672220,25968254,61640474,4,0,0,100352,7,10353722441
4520,35675230,25829976,61505206,9,0,0,65536,4,853392242
4521,35679390,25442771,61122161,4,0,0,15360,7,3579895012
4522,35686910,26929372,62616282,3,0,0,296960,18,6159022374
4523,35688920,25920152,61609072,0,0,0,3072,6,5868883393
4524,35690190,25592364,61282554,1,0,0,44032,1,8377729948
4525,35711460,58394702,94106162,8,0,1,55296,11,9372137440
4526,35715780,25240727,60956507,7,0,0,7168,1,10547503838
4527,35721590,25401593,61123183,9,0,0,2048,4,7527013519
4528,35726500,25430251,61156751,3,0,0,23552,18,7554388011
4529,35728510,25616241,61344751,0,0,0,512,6,4176069326
4530,35730410,25529486,61259896,1,0,0,26624,1,8744297635
4531,35739070,58367115,94106185,1,0,1,1536,1,3105001784
4532,35741700,25988421,61730121,6,0,0,63488,12,3078847673
4533,35749340,58356868,94106208,6,0,1,5120,12,4474241827
4534,35753940,25840110,61594050,9,0,0,129536,4,8373701853
4535,35768000,58340530,94108530,8,0,1,2048,11,3291415121
4536,35769650,25935560,61705210,0,0,0,97280,6,9013337243
4537,35770240,26211861,61982101,6,0,0,5120,12,1989143447
4538,35774100,58336376,94110476,6,0,1,3072,12,9581809263
4539,35774950,58338432,94113382,6,0,1,4608,12,103977860
4540,35776630,25618514,61395144,9,0,0,10752,4,7102638614
4541,35784560,25504339,61288899,9,0,0,14336,4,778224753
4542,35789630,25423645,61213275,6,0,0,3072,12,7297091947
4543,35794860,25813253,61608113,3,0,0,46080,18,2922261330
4544,35798569,58315889,94114458,5,0,1,13312,12,4971898014
4545,35801520,26013750,61815270,3,0,0,18944,18,4853442338
4546,35804130,58341499,94145629,8,0,1,18944,11,3704229756
4547,35805130,26044632,61849762,9,0,0,67584,4,1841922790
4548,35807670,25623313,61430983,0,0,0,16896,6,8733449582
4549,35822820,25886812,61709632,4,0,0,12800,7,2729624101
4550,35827330,25953435,61780765,6,0,0,25088,12,8148685019
4551,35838240,26045868,61884108,2,0,0,16896,1,5680157979
4552,35875040,58336842,94211882,7,0,1,71168,1,9037565338
4553,35879910,25729965,61609875,6,0,0,2560,12,1903930938
4554,35882790,26088946,61971736,6,0,0,63488,12,8860666631
4555,35892140,25813561,61705701,7,0,0,1536,1,6774346341
4556,35916430,25759117,61675547,2,0,0,22528,1,9804198285
4557,35939780,25480928,61420708,3,0,0,512,18,8959864942
4558,35941840,26209320,62151160,2,0,0,136704,1,1490236178
4559,35943640,58272428,94216068,6,0,1,6656,12,8428308516
4560,35946840,58271174,94218014,4,0,1,3072,7,3105679009
4561,35947070,26266378,62213448,4,0,0,20480,7,831053726
4562,35954240,26542970,62497210,0,0,0,5120,6,10324655275
4563,35956549,58261811,94218360,5,0,1,512,12,7184877742
4564,35963470,25889146,61852616,2,0,0,9216,1,1144745109
4565,35969009,58253537,94222546,3,0,1,6656,18,3830547317
4566,35969180,26213523,62182703,7,0,0,70144,1,4174050524
4567,35976190,25830349,61806539,0,0,0,2048,6,4482107850
4568,35989540,25800296,61789836,6,0,0,29696,12,4284181664
4569,35992390,26319460,62311850,4,0,0,26112,7,6023051473
4570,36011490,26097995,62109485,4,0,0,43008,7,4472804455
4571,36016230,25775665,61791895,3,0,0,6656,18,890752430
4572,36057580,26246291,62303871,1,0,0,51712,1,3609229327
4573,36059460,58163752,94223212,0,0,1,1024,6,6951824696
4574,36071500,25826808,61898308,4,0,0,12800,7,3124113861
4575,36081790,26245246,62327036,0,0,0,47616,6,5207801143
4576,36087060,25773847,61860907,1,0,0,27136,1,3287948129
4577,36088890,25964645,62053535,5,0,0,25088,12,4286982358
4578,36099030,26624642,62723672,1,0,0,60416,1,2340274454
4579,36109689,58118029,94227718,3,0,1,7168,18,3282700686
4580,36138340,26249448,62387788,5,0,0,57344,12,3247702585
4581,36141960,26141117,62283077,9,0,0,32256,4,9522768311
4582,36149160,26263400,62412560,9,0,0,59904,4,4389815289
4583,36149889,58085382,94235271,5,0,1,28672,12,255913103
4584,36151860,26705635,62857495,6,0,0,21504,12,5259613750
4585,36152590,25830470,61983060,6,0,0,3072,12,5122776770
4586,36167300,58071517,94238817,0,0,1,5632,6,5795513402
4587,36177329,58091683,94269012,3,0,1,21504,18,3054928843
4588,36188490,26172706,62361196,9,0,0,28672,4,8807053716
4589,36189380,58096125,94285505,1,0,1,38912,1,10555699183
4590,36191630,58107770,94299400,4,0,1,512,7,3266502691
4591,36197450,26007364,62204814,1,0,0,72192,1,8375333515
4592,36210260,26766588,62976848,5,0,0,8192,12,2498122685
4593,36227760,25925763,62153523,3,0,0,7680,18,4336866663
4594,36230420,26452802,62683222,3,0,0,111616,18,9910578360
4595,36251510,58264412,94515922,8,0,1,165888,11,8444262457
4596,36268290,26019802,62288092,8,0,0,16384,11,8432311705
4597,36273180,26799526,63072706,1,0,0,16896,1,8178023334
4598,36279100,26753009,63032109,9,0,0,5632,4,2098080065
4599,36280590,25876076,62156666,9,0,0,10240,4,9276711067
4600,36287830,26870289,63158119,7,0,0,12800,1,4623245894
4601,36288780,58229408,94518188,6,0,1,3584,12,10393805124
4602,36292650,58374150,94666800,1,0,1,93184,1,3319957399
4603,36294530,26017975,62312505,8,0,0,2048,11,8776157399
4604,36300450,58400402,94700852,2,0,1,12800,1,975142035
4605,36326280,26378961,62705241,3,0,0,72192,18,1977833296
4606,36344350,25862835,62207185,1,0,0,7680,1,5542764293
4607,36346550,26083832,62430382,6,0,0,2560,12,7390573494
4608,36350900,26679470,63030370,4,0,0,29184,7,5639449446
4609,36363060,27200280,63563340,6,0,0,17408,12,8769596092
4610,36364220,26284971,62649191,9,0,0,20992,4,8211363414
4611,36374080,26053167,62427247,9,0,0,48128,4,9681199649
4612,36374470,26402812,62777282,9,0,0,8192,4,2875244052
4613,36375570,27046531,63422101,8,0,0,83456,11,2858468847
4614,36388810,27370901,63759711,2,0,0,50176,1,5410667626
4615,36411220,28013277,64424497,6,0,0,125952,12,3754733318
4616,36421680,58281438,94703118,7,0,1,3584,1,7384807491
4617,36427770,27567205,63994975,7,0,0,50688,1,9059193475
4618,36427900,58290208,94718108,6,0,1,25088,12,9941237802
4619,36430190,58314638,94744828,1,0,1,15872,1,6111285916
4620,36430820,26317536,62748356,3,0,0,14336,18,10362707112
4621,36438500,58333654,94772154,1,0,1,11776,1,10710303957
4622,36441070,27779649,64220719,3,0,0,12800,18,2036172763
4623,36448630,27092044,63540674,1,0,0,243712,1,2230311150
4624,36452510,26998497,63451007,0,0,0,32256,6,8548036697
4625,36453490,26790557,63244047,3,0,0,127488,18,5494073224
4626,36457630,27264125,63721755,2,0,0,84992,1,10687640137
4627,36460360,26158753,62619113,0,0,0,9216,6,10135892090
4628,36465020,27204597,63669617,4,0,0,6144,7,7462750035
4629,36487440,26135440,62622880,1,0,0,12288,1,9530126311
4630,36499570,26235544,62735114,2,0,0,37376,1,913993206
4631,36507000,58266960,94773960,7,0,1,15872,1,5425751350
4632,36522130,26766465,63288595,2,0,0,19456,1,1147112029
4633,36535960,27301545,63837505,4,0,0,26624,7,1298530356
4634,36536470,26207403,62743873,8,0,0,28672,11,7980117934
4635,36544540,27334702,63879242,6,0,0,99328,12,10418534837
4636,36563820,26897506,63461326,7,0,0,33792,1,3405657903
4637,36567280,26508725,63076005,2,0,0,10752,1,8656416036
4638,36568270,58282938,94851208,6,0,1,39936,12,692020861
4639,36570630,27034416,63605046,8,0,0,49664,11,7128999247
4640,36573430,26771557,63344987,7,0,0,94208,1,10514870659
4641,36577460,26863696,63441156,5,0,0,62464,12,9149210770
4642,36580900,26608143,63189043,5,0,0,15360,12,3301826914
4643,36584099,58281671,94865770,3,0,1,11776,18,7995037339
4644,36585710,27948988,64534698,0,0,0,32768,6,7465186701
4645,36586060,27003823,63589883,6,0,0,87040,12,1724663914
4646,36595990,27233380,63829370,0,0,0,76800,6,9577934941
4647,36598180,27755224,64353404,5,0,0,240640,12,8637676469
4648,36598480,27540262,64138742,9,0,0,66560,4,49610012
4649,36600790,27378718,63979508,9,0,0,84480,4,765029740
4650,36602880,58271071,94873951,0,0,1,16384,6,6225323472
4651,36623560,26424203,63047763,1,0,0,3584,1,8625057679
4652,36635270,27060566,63695836,0,0,0,65024,6,6815205267
4653,36637010,26253498,62890508,1,0,0,5632,1,5393607976
4654,36644700,27368878,64013578,9,0,0,48640,4,7875605303
4655,36653910,27111284,63765194,9,0,0,17920,4,4645276344
4656,36657980,26356709,63014689,0,0,0,27136,6,3400638535
4657,36658950,28026775,64685725,9,0,0,3072,4,2560638912
4658,36664020,27378474,64042494,8,0,0,57344,11,7403718783
4659,36680700,27432312,64113012,1,0,0,52224,1,3787981265
4660,36706600,58250948,94957548,8,0,1,33792,11,1970866369
4661,36708060,27212627,63920687,6,0,0,43008,12,4364792485
4662,36723209,58258202,94981411,3,0,1,4096,18,2758132564
4663,36738450,58357478,95095928,4,0,1,12800,7,10706668086
4664,36744840,27736406,64481246,9,0,0,144896,4,3621108255
4665,36755060,27602579,64357639,5,0,0,13824,12,4515499607
4666,36758070,28302866,65060936,4,0,0,13312,7,10655705011
4667,36759399,58336552,95095951,3,0,1,4608,18,874515829
4668,36762720,26867870,63630590,6,0,0,21504,12,6401468727
4669,36767590,26528949,63296539,4,0,0,10240,7,1742094163
4670,36774700,27498698,64273398,1,0,0,17920,1,2187073989
4671,36780090,27655038,64435128,4,0,0,34816,7,10183399778
4672,36781719,58314255,95095974,5,0,1,3072,12,10086998939
4673,36781800,26825788,63607588,6,0,0,5120,12,9911301384
4674,36793900,26672441,63466341,8,0,0,16384,11,1997085131
4675,36798840,27772520,64571360,3,0,0,61440,18,235412856
4676,36801910,26559775,63361685,9,0,0,11776,4,6888465684
4677,36827270,26730743,63558013,1,0,0,56832,1,7849135707
4678,36831750,58264247,95095997,4,0,1,13312,7,2710495040
4679,36841470,27769314,64610784,7,0,0,94208,1,7217126421
4680,36855450,26868200,63723650,7,0,0,6144,1,2973022011
4681,36856179,58263544,95119723,3,0,1,15360,18,7368479055
4682,36858340,26917820,63776160,0,0,0,32256,6,4211545113
4683,36884050,26856514,63740564,0,0,0,13312,6,8982290015
4684,36889020,28350302,65239322,4,0,0,17920,7,5994593696
4685,36891640,26714365,63606005,1,0,0,3072,1,1502548007
4686,36904540,27603116,64507656,5,0,0,54784,12,4225737343
4687,36909210,26699969,63609179,7,0,0,5120,1,5314771258
4688,36913840,26811237,63725077,4,0,0,4608,7,3246298150
4689,36914440,58265685,95180125,2,0,1,37376,1,6932114804
4690,36935500,26830809,63766309,8,0,0,3584,11,10375307005
4691,36940549,58262772,95203321,3,0,1,15872,18,9562784103
4692,36961910,27113664,64075574,5,0,0,25600,12,9171643231
4693,36962680,27888232,64850912,9,0,0,13824,4,380927331
4694,36968140,27918062,64886202,2,0,0,5120,1,7528744946
4695,36969350,27696772,64666122,6,0,0,94720,12,3334536554
4696,36977280,27938585,64915865,3,0,0,97280,18,1808530470
4697,36987630,58225756,95213386,1,0,1,14336,1,2289205943
4698,36988730,27826619,64815349,7,0,0,18432,1,8785520796
4699,36998270,58293771,95292041,7,0,1,34816,1,7418975495
4700,37006620,28416667,65423287,7,0,0,69120,1,6225347932
4701,37008330,27996335,65004665,9,0,0,40448,4,4525022045
4702,37011090,26922886,63933976,8,0,0,15360,11,2628539171
4703,37012910,27979408,64992318,7,0,0,87040,1,5783914039
4704,37031810,58281691,95313501,6,0,1,5120,12,2265051023
4705,37034520,28052508,65087028,2,0,0,512,1,1559557223
4706,37037450,28210163,65247613,2,0,0,27136,1,6093639829
4707,37047640,27787473,64835113,7,0,0,7680,1,9446173101
4708,37049320,28499811,65549131,6,0,0,60928,12,4857628822
4709,37054250,27158877,64213127,4,0,0,10752,7,2836694313
4710,37064430,28022419,65086849,1,0,0,56832,1,8908084375
4711,37067840,27423101,64490941,2,0,0,31744,1,4824914977
4712,37073980,27450703,64524683,9,0,0,55808,4,9225761733
4713,37117900,28033857,65151757,6,0,0,108544,12,601117073
4714,37131520,28212693,65344213,2,0,0,27136,1,3490583165
4715,37153740,27866080,65019820,1,0,0,49664,1,8238410323
4716,37155180,28019064,65174244,6,0,0,73728,12,3708474895
4717,37163940,28946765,66110705,8,0,0,747520,11,3924366545
4718,37174889,58165429,95340318,3,0,1,17920,18,7131564778
4719,37175130,28346187,65521317,3,0,0,40960,18,10612021922
4720,37186680,28643734,65830414,8,0,0,458240,11,4900980538
4721,37189009,58246340,95435349,3,0,1,22528,18,2804247581
4722,37204990,27679629,64884619,1,0,0,90112,1,6291111471
4723,37211620,27713784,64925404,2,0,0,31232,1,100042269
4724,37260320,58187422,95447742,2,0,1,22528,1,131433666
4725,37271010,27270132,64541142,1,0,0,7168,1,10426341361
4726,37273620,27836075,65109695,4,0,0,32768,7,1453941217
4727,37287979,58159786,95447765,5,0,1,2048,12,5462038306
4728,37295230,27421086,64716316,0,0,0,15360,6,6353598020
4729,37307480,27360537,64668017,5,0,0,6144,12,460568323
4730,37312090,27444610,64756700,0,0,0,2048,6,1424930674
4731,37312940,27451240,64764180,9,0,0,2048,4,8088826851
4732,37314590,28215954,65530544,2,0,0,30208,1,4785301514
4733,37315880,27459191,64775071,5,0,0,1536,12,6970492541
4734,37316140,27352680,64668820,9,0,0,2560,4,7052706559
4735,37316900,27637614,64954514,3,0,0,55296,18,2127970305
4736,37317940,28564982,65882922,6,0,0,98304,12,8495430588
4737,37319970,27777562,65097532,5,0,0,29184,12,7295191604
4738,37337500,27691402,65028902,3,0,0,512,18,8241626770
4739,37353840,28483952,65837792,3,0,0,10240,18,1813091695
4740,37355830,28908162,66263992,3,0,0,32768,18,5725158270
4741,37356440,58116583,95473023,2,0,1,20480,1,1306742029
4742,37362040,27479438,64841478,1,0,0,2560,1,5359447280
4743,37364530,29068088,66432618,6,0,0,20992,12,3050921899
4744,37373690,29001177,66374867,3,0,0,337920,18,3681357193
4745,37377260,28783675,66160935,0,0,0,4096,6,8587085498
4746,37380449,58178046,95558495,3,0,1,6144,18,3357962125
4747,37382690,28796098,66178788,5,0,0,33792,12,2639353165
4748,37395320,28728863,66124183,0,0,0,38400,6,863402533
4749,37417380,28082053,65499433,4,0,0,30208,7,9161945338
4750,37418540,27631887,65050427,0,0,0,4608,6,4477083165
4751,37419130,58182015,95601145,7,0,1,14848,1,5019274858
4752,37437720,58213439,95651159,0,0,1,16384,6,9929988262
4753,37452540,28943121,66395661,5,0,0,68096,12,7418457947
4754,37462990,27812104,65275094,4,0,0,14336,7,4182158790
4755,37466760,27488442,64955202,2,0,0,512,1,6730245621
4756,37468380,28952175,66420555,5,0,0,69120,12,7880050928
4757,37474350,28797488,66271838,9,0,0,25600,4,9240181339
4758,37477140,28131718,65608858,5,0,0,12288,12,2939004662
4759,37509480,28931319,66440799,6,0,0,26624,12,4266828832
4760,37517250,28736689,66253939,0,0,0,113664,6,9820925054
4761,37540430,27912258,65452688,7,0,0,11776,1,4335337604
4762,37542989,58109937,95652926,3,0,1,17920,18,2847757574
4763,37546170,58110682,95656852,4,0,1,8704,7,7164386628
4764,37547250,27827673,65374923,9,0,0,48128,4,9390718777
4765,37553810,28299137,65852947,8,0,0,49664,11,2304143040
4766,37556130,27898141,65454271,0,0,0,5120,6,3205648439
4767,37562050,28587295,66149345,1,0,0,31232,1,4177172473
4768,37563900,28615223,66179123,5,0,0,1024,12,1194563942
4769,37569440,27996406,65565846,8,0,0,54784,11,6444315110
4770,37573220,27914561,65487781,0,0,0,2048,6,3864853743
4771,37584379,58084630,95669009,5,0,1,1024,12,1966528541
4772,37586420,28901738,66488158,3,0,0,98816,18,1474295232
4773,37587730,58081433,95669163,4,0,1,8704,7,10142024285
4774,37590690,28086927,65677617,7,0,0,14848,1,8016413474
4775,37592560,28833524,66426084,8,0,0,17920,11,5612958547
4776,37610390,28554624,66165014,8,0,0,13312,11,2295585299
4777,37610840,58080790,95691630,1,0,1,1024,1,4581715568
4778,37624690,27750568,65375258,9,0,0,1024,4,740634388
4779,37653120,28746352,66399472,8,0,0,11264,11,10581367203
4780,37653269,58041008,95694277,5,0,1,18432,12,7268655020
4781,37658700,27911849,65570549,1,0,0,15360,1,9792003353
4782,37682120,28486349,66168469,8,0,0,11264,11,6045570090
4783,37687300,58078243,95765543,0,0,1,24576,6,4323902475
4784,37699690,28412770,66112460,4,0,0,5632,7,7444260808
4785,37708260,27909253,65617513,2,0,0,7168,1,3665738473
4786,37721800,28817455,66539255,2,0,0,29184,1,4715469614
4787,37729699,58184161,95913860,5,0,1,33792,12,1079864001
4788,37744830,27935530,65680360,6,0,0,4608,12,9673980647
4789,37752050,27908851,65660901,9,0,0,2560,4,216162157
4790,37763570,28071079,65834649,2,0,0,13824,1,2959220903
4791,37774950,28364856,66139806,6,0,0,51200,12,8563850112
4792,37781840,28859445,66641285,2,0,0,95744,1,6515552267
4793,37781850,28409175,66191025,3,0,0,38912,18,197368008
4794,37784310,28673631,66457941,4,0,0,55808,7,2749140303
4795,37786549,58134035,95920584,5,0,1,13824,12,5932159318
4796,37790639,58174810,95965449,5,0,1,4608,12,6848145279
4797,37794610,58285778,96080388,1,0,1,43008,1,1904725551
4798,37798670,28360994,66159664,5,0,0,33792,12,7572292102
4799,37800400,28418884,66219284,1,0,0,92672,1,914042687
4800,37806980,58439285,96246265,2,0,1,56832,1,9112754178
4801,37826820,58419468,96246288,7,0,1,8704,1,5640525734
4802,37826899,58431603,96258502,3,0,1,4096,18,10208449144
4803,37828640,28842755,66671395,0,0,0,9728,6,1396965794
4804,37830070,28826682,66656752,7,0,0,50688,1,6013693233
4805,37832580,28716047,66548627,3,0,0,29696,18,4009325865
4806,37841280,28974569,66815849,4,0,0,31232,7,5343787873
4807,37842170,28762025,66604195,0,0,0,26112,6,8589000954
4808,37858040,28537946,66395986,4,0,0,512,7,10513535786
4809,37863910,28925415,66789325,7,0,0,18944,1,4814015961
4810,37865870,28623559,66489429,8,0,0,4096,11,7147669899
4811,37866030,28673404,66539434,0,0,0,512,6,797240956
4812,37869640,29169625,67039265,1,0,0,66560,1,3956414006
4813,37873250,29001604,66874854,1,0,0,32768,1,864239116
4814,37879850,58378675,96258525,6,0,1,5632,12,7188061821
4815,37882790,28613690,66496480,3,0,0,23040,18,8211968152
4816,37907330,28785435,66692765,2,0,0,45056,1,4709162982
4817,37921820,28943027,66864847,3,0,0,24064,18,10359165414
4818,37935620,28799667,66735287,8,0,0,2560,11,4210041229
4819,37938260,28765136,66703396,2,0,0,34816,1,7794461379
4820,37938710,29008703,66947413,7,0,0,1536,1,5361260308
4821,37939810,28843720,66783530,4,0,0,57856,7,7305193604
4822,37944570,29117829,67062399,2,0,0,64512,1,6576730391
4823,37961920,28546702,66508622,7,0,0,10240,1,2803379102
4824,37970680,28930231,66900911,3,0,0,16896,18,9193073736
4825,37971620,28687830,66659450,7,0,0,5120,1,6122316267
4826,37975140,28764203,66739343,1,0,0,3072,1,10520573025
4827,37978740,58292154,96270894,1,0,1,1536,1,3113953400
4828,37985870,29156615,67142485,0,0,0,17920,6,7362372450
4829,37988020,29133469,67121489,2,0,0,175104,1,9565443846
4830,37994510,29398362,67392872,2,0,0,55296,1,1166699262
4831,38006340,58337949,96344289,7,0,1,28672,1,1243640528
4832,38029960,29264362,67294322,4,0,0,6656,7,6862971726
4833,38037330,28620537,66657867,0,0,0,3584,6,7227954448
4834,38042739,58533807,96576546,5,0,1,114176,12,10376706036
4835,38046199,58717252,96763451,5,0,1,96768,12,8357471426
4836,38051850,58721607,96773457,7,0,1,17408,1,3685971360
4837,38068040,29683544,67751584,5,0,0,19456,12,8634867245
4838,38069100,58706193,96775293,7,0,1,8192,1,8003557633
4839,38082780,29177538,67260318,5,0,0,60928,12,10348961773
4840,38084360,29101185,67185545,3,0,0,11776,18,9227536294
4841,38101430,28742447,66843877,0,0,0,17920,6,4416495099
4842,38108970,29111522,67220492,6,0,0,57856,12,5308356618
4843,38112830,29442899,67555729,2,0,0,74752,1,7591844942
4844,38114550,29816372,67930922,6,0,0,93184,12,9226205771
4845,38128470,28914250,67042720,4,0,0,11264,7,2608896571
4846,38134040,29107691,67241731,9,0,0,69632,4,4849882976
4847,38138709,58640770,96779479,5,0,1,6656,12,3468654221
4848,38139080,29257247,67396327,4,0,0,11264,7,3649300508
4849,38141330,28615557,66756887,2,0,0,23040,1,10142216593
4850,38141770,58653239,96795009,0,0,1,4096,6,5247830304
4851,38147060,58657594,96804654,7,0,1,6656,1,10325060512
4852,38149450,29383472,67532922,2,0,0,10752,1,6790363691
4853,38163680,29462105,67625785,5,0,0,147456,12,5866788905
4854,38169320,28966255,67135575,6,0,0,33280,12,4272890439
4855,38177030,28650236,66827266,8,0,0,33280,11,902812850
4856,38179960,58625680,96805640,7,0,1,1536,1,10019568065
4857,38193170,29387664,67580834,8,0,0,26112,11,10122161203
4858,38194270,28931142,67125412,2,0,0,12800,1,3487714798
4859,38194730,29213944,67408674,5,0,0,40448,12,926890388
4860,38195230,29227195,67422425,2,0,0,45056,1,10176024753
4861,38225360,29220230,67445590,8,0,0,19968,11,3523575849
4862,38228690,29210793,67439483,0,0,0,512,6,168594355
4863,38234189,58575637,96809826,5,0,1,6656,12,3855506779
4864,38240260,29976947,68217207,1,0,0,34816,1,5601522559
4865,38244800,29117450,67362250,2,0,0,110592,1,1014160522
4866,38253560,29399016,67652576,7,0,0,4096,1,780261802
4867,38254520,29074011,67328531,1,0,0,19456,1,10130475384
4868,38256040,58612227,96868267,0,0,1,4096,6,4318921089
4869,38257460,58630064,96887524,4,0,1,2560,7,1727669210
4870,38266050,28615159,66881209,2,0,0,1024,1,4476070917
4871,38266950,29259530,67526480,0,0,0,42496,6,348453161
4872,38268800,29107201,67376001,6,0,0,45056,12,6077323225
4873,38269090,28999363,67268453,2,0,0,26624,1,6239076763
4874,38271120,29693700,67964820,0,0,0,102912,6,1396772671
4875,38276650,58615912,96892562,6,0,1,3072,12,4396423735
4876,38280470,30015589,68296059,7,0,0,64512,1,3773182597
4877,38313380,28823622,67137002,6,0,0,4608,12,9962289807
4878,38318390,58574195,96892585,7,0,1,10752,1,4551577593
4879,38323280,29395718,67718998,4,0,0,141824,7,6397051519
4880,38344470,29395345,67739815,1,0,0,10752,1,867416333
4881,38360160,29303850,67664010,2,0,0,25600,1,771044618
4882,38379199,58569627,96948826,3,0,1,29184,18,3168413072
4883,38391680,58623466,97015146,7,0,1,9728,1,8549700667
4884,38392280,29361082,67753362,5,0,0,4608,12,10392501806
4885,38397950,29163894,67561844,6,0,0,19968,12,7477048046
4886,38401610,29531831,67933441,8,0,0,8192,11,955976444
4887,38417360,29021944,67439304,1,0,0,55296,1,6989893990
4888,38420830,29036327,67457157,5,0,0,37888,12,7434240977
4889,38425920,29604441,68030361,9,0,0,512,4,6785264223
4890,38430810,29950665,68381475,2,0,0,133120,1,2975478278
4891,38438280,29206138,67644418,9,0,0,30720,4,3501770021
4892,38447990,29081633,67529623,9,0,0,10240,4,5832000
4893,38454080,58597251,97051331,1,0,1,19968,1,164647548
4894,38462340,29440167,67902507,0,0,0,29696,6,7187465271
4895,38463920,58590957,97054877,2,0,1,5632,1,7242063265
4896,38470880,29180425,67651305,9,0,0,22528,4,7832054539
4897,38471260,29535343,68006603,6,0,0,51200,12,2425236199
4898,38483130,29246031,67729161,8,0,0,33280,11,2882495750
4899,38491730,29594580,68086310,5,0,0,36864,12,7373033945
4900,38522110,29508072,68030182,1,0,0,77312,1,5440163508
4901,38525250,29528998,68054248,8,0,0,10240,11,10448982622
4902,38527720,29107315,67635035,1,0,0,28160,1,10243644254
4903,38539550,29890294,68429844,9,0,0,16384,4,9616996701
4904,38545800,58510703,97056503,2,0,1,2560,1,969895757
4905,38550190,29076242,67626432,3,0,0,2048,18,3611184593
4906,38551210,29104977,67656187,7,0,0,11776,1,9241838686
4907,38552610,29192376,67744986,0,0,0,16896,6,1766765708
4908,38556880,29107941,67664821,5,0,0,2560,12,10580100574
4909,38560369,58497005,97057374,5,0,1,12288,12,9976967258
4910,38565310,29171206,67736516,5,0,0,24064,12,9510863320
4911,38576570,29249017,67825587,8,0,0,8704,11,1530045509
4912,38579310,30098870,68678180,2,0,0,66560,1,3323668078
4913,38580010,29515995,68096005,3,0,0,31744,18,2830135065
4914,38585870,29532833,68118703,9,0,0,23040,4,8652090183
4915,38589850,29186209,67776059,2,0,0,3072,1,10254891384
4916,38594850,29157069,67751919,9,0,0,1024,4,7484544227
4917,38598610,29147023,67745633,7,0,0,2048,1,2872365279
4918,38618560,58843289,97461849,8,0,1,35328,11,6059829760
4919,38620540,29175699,67796239,7,0,0,13824,1,9873439957
4920,38622350,58844225,97466575,6,0,1,12800,12,7264993467
4921,38625120,29185369,67810489,4,0,0,7168,7,253241604
4922,38631480,29552280,68183760,3,0,0,16896,18,9421897134
4923,38646250,29395233,68041483,9,0,0,22528,4,8471757979
4924,38669910,58839860,97509770,6,0,1,31232,12,1208255348
4925,38675590,29562613,68238203,4,0,0,61440,7,2948011489
4926,38694470,29296510,67990980,2,0,0,62976,1,6551935823
4927,38698190,29056131,67754321,0,0,0,3072,6,1975539702
4928,38701600,29268079,67969679,9,0,0,15872,4,1058789011
4929,38709710,29555989,68265699,1,0,0,68096,1,2627786774
4930,38714870,29255924,67970794,3,0,0,3584,18,3422946662
4931,38718160,29316436,68034596,1,0,0,13824,1,4283109070
4932,38718219,58809489,97527708,3,0,1,14336,18,8556066145
4933,38722440,58809774,97532214,6,0,1,7168,12,332926227
4934,38728480,29316614,68045094,5,0,0,11776,12,3444286169
4935,38730870,30006367,68737237,5,0,0,15872,12,1072382299
4936,38733240,58799640,97532880,2,0,1,1024,1,9292513665
4937,38734260,29433300,68167560,2,0,0,34304,1,7181703018
4938,38739240,29786134,68525374,0,0,0,42496,6,5129996208
4939,38756420,29215341,67971761,4,0,0,3072,7,5158356516
4940,38766440,29289391,68055831,3,0,0,5120,18,2132307838
4941,38771650,29630284,68401934,7,0,0,67072,1,8969039671
4942,38775849,58762165,97538014,3,0,1,21504,18,7484656658
4943,38779570,30014022,68793592,1,0,0,92672,1,9250622673
4944,38795880,29423557,68219437,4,0,0,7168,7,7715366408
4945,38818050,29284106,68102156,6,0,0,2048,12,5199842820
4946,38826870,58867666,97694536,7,0,1,16384,1,3104287693
4947,38839240,29437140,68276380,4,0,0,31232,7,1675007449
4948,38850270,59066366,97916636,0,0,1,20480,6,2781629702
4949,38865070,59619185,98484255,8,0,1,166400,11,5333278701
4950,38870400,29533897,68404297,5,0,0,7680,12,5407447781
4951,38891410,30045959,68937369,8,0,0,512,11,2917785233
4952,38892070,29902333,68794403,9,0,0,2560,4,4162089727
4953,38929240,29263266,68192506,0,0,0,4096,6,7938576131
4954,38948340,59576216,98524556,6,0,1,3072,12,311073276
4955,38953990,29811343,68765333,8,0,0,57856,11,490687537
4956,38972110,29327716,68299826,3,0,0,12288,18,1573348455
4957,38972829,59553353,98526182,5,0,1,2560,12,4253609115
4958,38993800,29415512,68409312,4,0,0,16384,7,5051943985
4959,39000700,30064907,69065607,5,0,0,5632,12,3944625802
4960,39008560,29559821,68568381,4,0,0,65024,7,9769730812
4961,39015930,29694479,68710409,7,0,0,38912,1,4623206660
4962,39024330,29485710,68510040,0,0,0,118272,6,1972387448
4963,39026710,29891877,68918587,7,0,0,30208,1,9708378676
4964,39031710,29596309,68628019,5,0,0,21504,12,1022972475
4965,39037550,29474853,68512403,5,0,0,7680,12,3096190672
4966,39043109,59535260,98578369,5,0,1,5632,12,8355749202
4967,39085779,59492613,98578392,5,0,1,3584,12,5394164935
4968,39086190,29876563,68962753,5,0,0,21504,12,10112139793
4969,39087400,29481316,68568716,9,0,0,1024,4,3411288550
4970,39095020,59541945,98636965,1,0,1,2560,1,5822751571
4971,39097760,30111715,69209475,8,0,0,80384,11,6525752345
4972,39101820,59535811,98637631,4,0,1,1024,7,809334279
4973,39144600,29686607,68831207,4,0,0,46080,7,9777396279
4974,39147010,59508766,98655776,0,0,1,5632,6,1472868571
4975,39149570,29508307,68657877,7,0,0,84480,1,6575394590
4976,39153850,29640732,68794582,4,0,0,512,7,9062429294
4977,39155010,30164289,69319299,8,0,0,110080,11,6526805943
4978,39159950,29887346,69047296,8,0,0,30720,11,5221242603
4979,39166670,30209345,69376015,7,0,0,83456,1,7043517635
4980,39169530,29767644,68937174,2,0,0,60928,1,2432133039
4981,39171720,29966762,69138482,9,0,0,129536,4,507102722
4982,39173480,59482319,98655799,7,0,1,10752,1,4222508931
4983,39178230,29722403,68900633,8,0,0,5632,11,3438217016
4984,39180600,29675937,68856537,1,0,0,48640,1,3034444771
4985,39196520,29759658,68956178,7,0,0,17920,1,3498896278
4986,39214740,29841471,69056211,7,0,0,29184,1,5857248429
4987,39215550,59440272,98655822,1,0,1,512,1,5049076325
4988,39224870,29953827,69178697,8,0,0,74752,11,8298979846
4989,39234420,59421425,98655845,1,0,1,1536,1,5132363051
4990,39234860,29803053,69037913,9,0,0,128512,4,9183967136
4991,39241130,30261828,69502958,4,0,0,13824,7,5280342044
4992,39250620,29428675,68679295,3,0,0,3584,18,8707890117
4993,39259530,29957456,69216986,3,0,0,24576,18,6817116570
4994,39267770,29803582,69071352,9,0,0,512,4,8998830825
4995,39282930,30045596,69328526,5,0,0,30208,12,6779120612
4996,39286060,29581568,68867628,2,0,0,34304,1,7669552813
4997,39295910,29889050,69184960,5,0,0,20480,12,1289469537
4998,39300460,29855430,69155890,0,0,0,26624,6,7605292234
4999,39321260,29769240,69090500,8,0,0,8192,11,10008169927
5000,39322570,29825185,69147755,7,0,0,28672,1,4751097281
5001,39334340,29499542,68833882,8,0,0,8704,11,8791843941
5002,39336510,30310805,69647315,6,0,0,152576,12,1907829973
5003,39339680,30315957,69655637,8,0,0,20992,11,6950061196
5004,39357700,29872904,69230604,9,0,0,5632,4,2092361603
5005,39362600,60382108,99744708,6,0,1,428032,12,5567073153
5006,39374380,29854485,69228865,5,0,0,38912,12,7189883428
5007,39392340,30157899,69550239,4,0,0,74752,7,1694168670
5008,39416700,30153709,69570409,5,0,0,66048,12,9618273395
5009,39417110,29914114,69331224,5,0,0,8704,12,1875919575
5010,39419829,60324902,99744731,3,0,1,8704,18,9006287700
5011,39419970,60477780,99897750,6,0,1,101376,12,5013861286
5012,39429540,29801555,69231095,6,0,0,1536,12,464301513
5013,39434340,29704656,69138996,8,0,0,1536,11,10241606663
5014,39434570,30092870,69527440,4,0,0,34816,7,3684369885
5015,39443190,60456186,99899376,0,0,1,2560,6,5594667294
5016,39466190,29808901,69275091,8,0,0,50688,11,1554530424
5017,39474130,29866625,69340755,1,0,0,21504,1,7338430092
5018,39474511,60452084,99926595,9,0,1,4608,4,4148820673
5019,39490700,29740886,69231586,0,0,0,1536,6,10297712839
5020,39491190,30382118,69873308,2,0,0,148992,1,7358470159
5021,39491300,30106977,69598277,4,0,0,512,7,10120074657
5022,39492209,60452691,99944900,3,0,1,12288,18,2531455802
5023,39493610,30409384,69902994,8,0,0,89600,11,6604894087
5024,39499050,30171118,69670168,8,0,0,47616,11,10408757475
5025,39515390,61196532,100711922,8,0,1,322560,11,7331080070
5026,39528200,29956235,69484435,7,0,0,4096,1,7203326147
5027,39537300,30157022,69694322,0,0,0,11264,6,1761685337
5028,39539550,30053213,69592763,7,0,0,73216,1,9451516778
5029,39547240,30050850,69598090,0,0,0,17408,6,2223051447
5030,39547530,61164423,100711953,2,0,1,6144,1,2372048259
5031,39549290,30185893,69735183,4,0,0,38912,7,8626517462
5032,39564700,30394273,69958973,2,0,0,71680,1,6174116937
5033,39569490,30741251,70310741,9,0,0,91648,4,2571303119
5034,39583790,61422238,101006028,8,0,1,143360,11,2552146731
5035,39596640,30314645,69911285,9,0,0,27136,4,1748723928
5036,39613750,29987054,69600804,7,0,0,8192,1,6754483300
5037,39641030,61392391,101033421,1,0,1,25088,1,1904911951
5038,39654020,30446968,70100988,0,0,0,62464,6,7592267618
5039,39660060,30076082,69736142,9,0,0,3072,4,1843038200
5040,39661610,30447380,70108990,7,0,0,13824,1,10381304457
5041,39666580,30793382,70459962,5,0,0,123904,12,9184531370
5042,39696250,30131639,69827889,3,0,0,49664,18,3890562867
5043,39699530,30266353,69965883,7,0,0,512,1,520973470
5044,39711270,30645076,70356346,0,0,0,51712,6,1569337251
5045,39711310,30089397,69800707,8,0,0,9216,11,6518096833
5046,39726420,30433274,70159694,0,0,0,58880,6,1151767049
5047,39728300,61404872,101133172,1,0,1,31744,1,2001540115
5048,39730180,30816849,70547029,3,0,0,47616,18,3029243730
5049,39737250,30249045,69986295,9,0,0,18944,4,1045882407
5050,39738300,30397792,70136092,1,0,0,72704,1,4566802521
5051,39738510,30539043,70277553,5,0,0,91648,12,7174016421
5052,39751790,30213914,69965704,4,0,0,22016,7,2663679467
5053,39764520,30441199,70205719,2,0,0,44032,1,3314074618
5054,39771490,29877728,69649218,1,0,0,6144,1,2930114143
5055,39784180,31036659,70820839,1,0,0,28672,1,6714395045
5056,39785720,30089951,69875671,1,0,0,7680,1,9012288248
5057,39802640,61342434,101145074,6,0,1,45568,12,3105114402
5058,39818510,30506005,70324515,2,0,0,29184,1,8265332259
5059,39826290,61375668,101201958,8,0,1,1024,11,2076325623
5060,39827610,30095295,69922905,7,0,0,3584,1,4625346344
5061,39829060,30241774,70070834,7,0,0,26112,1,7575528372
5062,39841040,30240893,70081933,4,0,0,36352,7,8112529714
5063,39841730,30221125,70062855,4,0,0,33280,7,587274266
5064,39848170,61353811,101201981,1,0,1,3584,1,1743998716
5065,39855580,30249175,70104755,8,0,0,12288,11,548716250
5066,39856550,30056786,69913336,3,0,0,6656,18,10619419821
5067,39864950,30644353,70509303,7,0,0,140800,1,8350286005
5068,39867160,61334844,101202004,0,0,1,5632,6,6148988153
5069,39882560,30355974,70238534,4,0,0,3584,7,78077660
5070,39885330,30430270,70315600,1,0,0,15872,1,8663414234
5071,39891010,30389998,70281008,7,0,0,11264,1,5487003927
5072,39896490,30310188,70206678,5,0,0,3072,12,5752684093
5073,39898090,30619504,70517594,4,0,0,27136,7,4755233193
5074,39901060,30240671,70141731,8,0,0,18432,11,5209403782
5075,39926690,30495497,70422187,2,0,0,71680,1,7527918088
5076,39927280,30404434,70331714,3,0,0,23552,18,1054754387
5077,39928130,61273897,101202027,8,0,1,7680,11,8346482949
5078,39928760,61273290,101202050,2,0,1,9728,1,6820372410
5079,39934560,61905217,101839777,6,0,1,371200,12,3266752706
5080,39935820,61963542,101899362,6,0,1,7168,12,8235851177
5081,39941490,31211748,71153238,0,0,0,231424,6,760273167
5082,39975630,30549974,70525604,2,0,0,19456,1,330037003
5083,39981180,30384861,70366041,1,0,0,31744,1,9870281710
5084,39986670,30392799,70379469,6,0,0,8192,12,8678603375
5085,39992980,30526665,70519645,5,0,0,6656,12,1575740580
5086,39993390,30577698,70571088,7,0,0,15872,1,9457580752
5087,39993940,30671250,70665190,9,0,0,17920,4,5443370749
5088,40004200,30589992,70594192,4,0,0,17920,7,2089664488
5089,40006300,30576823,70583123,7,0,0,39424,1,4734375688
5090,40022620,30647429,70670049,7,0,0,15872,1,7132638339
5091,40032280,30691434,70723714,1,0,0,18432,1,6441924108
5092,40042170,30796441,70838611,5,0,0,27648,12,7583152236
5093,40052580,30870297,70922877,9,0,0,41984,4,4239094792
5094,40054080,61846588,101900668,1,0,1,2048,1,3081981531
5095,40067670,30520584,70588254,4,0,0,512,7,9287589579
5096,40077820,30845548,70923368,8,0,0,1536,11,9004811673
5097,40087360,61824676,101912036,2,0,1,27136,1,6600566504
5098,40089790,30647774,70737564,4,0,0,29696,7,138366807
5099,40104780,30427399,70532179,7,0,0,21504,1,7669926527
5100,40110850,30715160,70826010,6,0,0,16896,12,325160733
5101,40112840,30349173,70462013,9,0,0,6656,4,970734432
5102,40129600,30475652,70605252,0,0,0,11264,6,5152817829
5103,40132049,61860015,101992064,3,0,1,42496,18,6018170612
5104,40134620,30875743,71010363,6,0,0,20480,12,8577643015
5105,40136720,30637160,70773880,5,0,0,30720,12,8433429711
5106,40161380,31102733,71264113,4,0,0,92160,7,5737893986
5107,40176250,30478028,70654278,5,0,0,9728,12,620089507
5108,40205220,61830532,102035752,1,0,1,30720,1,388512428
5109,40211260,30991788,71203048,1,0,0,88064,1,4828013483
5110,40248140,30723126,70971266,4,0,0,24576,7,4055821218
5111,40258120,30683862,70941982,1,0,0,36864,1,1377829076
5112,40263990,61772838,102036828,0,0,1,13312,6,7025038268
5113,40284830,30775442,71060272,1,0,0,16896,1,9517380928
5114,40291610,30944400,71236010,6,0,0,79872,12,2847446015
5115,40294710,30744008,71038718,5,0,0,6144,12,9120793923
5116,40296180,31013845,71310025,8,0,0,9216,11,7729062182
5117,40299600,30673093,70972693,7,0,0,4608,1,6545816310
5118,40301140,30993127,71294267,8,0,0,79360,11,9136732655
5119,40301610,30874583,71176193,1,0,0,75264,1,5458053600
5120,40311620,61803928,102115548,8,0,1,5120,11,4772743670
5121,40312230,31027476,71339706,7,0,0,52224,1,9973430559
5122,40314670,30767127,71081797,6,0,0,4608,12,2227832084
5123,40316980,61798591,102115571,4,0,1,2560,7,4032189710
5124,40329560,30882091,71211651,6,0,0,28160,12,5832883819
5125,40331850,30641334,70973184,2,0,0,1536,1,3901973452
5126,40343190,31037757,71380947,2,0,0,18944,1,4565050862
5127,40365709,61749885,102115594,3,0,1,5120,18,7222062429
5128,40372510,31179559,71552069,3,0,0,85504,18,5486119906
5129,40385230,61786750,102171980,4,0,1,50688,7,8392490203
5130,40385660,30959599,71345259,3,0,0,7680,18,4048791822
5131,40387859,61786195,102174054,5,0,1,3584,12,5643223825
5132,40394960,30902762,71297722,3,0,0,11264,18,4559278542
5133,40404040,30866024,71270064,0,0,0,19456,6,100264398
5134,40409870,31103618,71513488,0,0,0,22016,6,4401162507
5135,40419280,30937301,71356581,1,0,0,10240,1,7697230275
5136,40431360,30871689,71303049,3,0,0,17408,18,5411111077
5137,40433360,30975685,71409045,8,0,0,9216,11,10315057391
5138,40437250,61738221,102175471,4,0,1,5120,7,1153459090
5139,40441620,30863012,71304632,2,0,0,5120,1,2372101205
5140,40446320,31129181,71575501,6,0,0,55296,12,1004111927
5141,40463670,30932378,71396048,5,0,0,10240,12,9443437862
5142,40481220,31009552,71490772,7,0,0,7168,1,2756675058
5143,40512310,30928873,71441183,3,0,0,5120,18,10360596171
5144,40514050,31043906,71557956,9,0,0,18944,4,3816072868
5145,40523560,31076661,71600221,6,0,0,10240,12,5387963608
5146,40558380,31232729,71791109,5,0,0,37376,12,2680941391
5147,40560989,61614636,102175625,5,0,1,8704,12,9834143337
5148,40574550,31004718,71579268,7,0,0,12288,1,5135900189
5149,40576280,31155348,71731628,1,0,0,40960,1,7793967577
5150,40577600,31195358,71772958,9,0,0,8192,4,10662714865
5151,40590250,31282672,71872922,5,0,0,18944,12,9110089510
5152,40593020,31017624,71610644,6,0,0,5120,12,9738930245
5153,40604980,31232938,71837918,3,0,0,66048,18,4246174955
5154,40606300,31768182,72374482,5,0,0,52224,12,6761707247
5155,40609860,31046989,71656849,5,0,0,19456,12,8698473791
5156,40621670,31404219,72025889,8,0,0,68608,11,4393323621
5157,40625580,31339981,71965561,5,0,0,44032,12,2244924344
5158,40627140,31433050,72060190,8,0,0,12800,11,8333768741
5159,40630900,61564026,102194926,7,0,1,7680,1,5691144783
5160,40643390,31431256,72074646,3,0,0,35328,18,1685742171
5161,40655730,31595559,72251289,5,0,0,28672,12,2281506655
5162,40666530,31491095,72157625,9,0,0,60416,4,597205109
5163,40677240,31576100,72253340,6,0,0,6656,12,7081953199
5164,40697410,31407409,72104819,0,0,0,24064,6,9230297818
5165,40699840,61541716,102241556,7,0,1,33792,1,904451131
5166,40701630,31328891,72030521,7,0,0,8192,1,8135572719
5167,40718180,31163547,71881727,2,0,0,7168,1,2318770812
5168,40744300,31072225,71816525,7,0,0,31232,1,4385604973
5169,40747380,31204742,71952122,0,0,0,55296,6,1767117322
5170,40747400,31923640,72671040,0,0,0,28160,6,4445897425
5171,40754280,31360586,72114866,0,0,0,9216,6,8679150878
5172,40775490,31467040,72242530,1,0,0,22528,1,9714681843
5173,40776600,31908899,72685499,4,0,0,38912,7,9904213034
5174,40777940,31505576,72283516,1,0,0,7680,1,1055997113
5175,40778130,31218710,71996840,4,0,0,36352,7,3300872711
5176,40783770,31518446,72302216,9,0,0,58368,4,9836477681
5177,40797260,31958877,72756137,9,0,0,27648,4,5031606877
5178,40801760,31388778,72190538,4,0,0,96256,7,9893864858
5179,40813730,31421913,72235643,2,0,0,74240,1,180710165
5180,40837810,61459250,102297060,0,0,1,1024,6,608747157
5181,40861970,31553765,72415735,6,0,0,55808,12,8912672692
5182,40895310,32028713,72924023,8,0,0,118784,11,7099256573
5183,40898980,61405146,102304126,2,0,1,25600,1,7529024419
5184,40902450,61426815,102329265,2,0,1,14336,1,1836637757
5185,40920660,31385948,72306608,0,0,0,12288,6,6318823697
5186,40931900,31461637,72393537,3,0,0,62464,18,1652577997
5187,40937810,31264451,72202261,8,0,0,38400,11,6708464827
5188,40973610,61561861,102535471,1,0,1,14848,1,6972514169
5189,40984000,31441742,72425742,5,0,0,32768,12,1856179111
5190,41013130,31422784,72435914,1,0,0,15360,1,9702001784
5191,41016400,31264753,72281153,0,0,0,16896,6,2297455311
5192,41024030,31977714,73001744,4,0,0,18944,7,8856772606
5193,41024100,31417788,72441888,1,0,0,19456,1,8713778727
5194,41024519,61550255,102574774,5,0,1,13824,12,9351612881
5195,41033279,61663958,102697237,3,0,1,28160,18,5795468536
5196,41035940,31235064,72271004,7,0,0,12800,1,7097834163
5197,41038180,31360528,72398708,4,0,0,16896,7,416072039
5198,41040540,31477391,72517931,7,0,0,12288,1,3438940185
5199,41052450,61644818,102697268,7,0,1,4608,1,2117305794
5200,41060310,61651395,102711705,7,0,1,1536,1,8448524246
5201,41062690,31291101,72353791,2,0,0,12288,1,3472769980
5202,41084360,31573950,72658310,5,0,0,29184,12,3035468193
5203,41089530,31415131,72504661,5,0,0,12288,12,7283821000
5204,41094620,61654648,102749268,2,0,1,5632,1,800301765
5205,41109110,31967820,73076930,8,0,0,27648,11,8529653796
5206,41110670,31441825,72552495,0,0,0,21504,6,6073756512
5207,41113840,61637149,102750989,0,0,1,17920,6,10219407855
5208,41124360,61634442,102758802,2,0,1,14336,1,9869442689
5209,41142430,31479787,72622217,5,0,0,35840,12,3877028893
5210,41153970,31993431,73147401,7,0,0,34304,1,3757129042
5211,41154490,61604335,102758825,7,0,1,1024,1,9511187445
5212,41165010,61639993,102805003,4,0,1,20992,7,3700635467
5213,41168590,31709759,72878349,9,0,0,5632,4,2392227308
5214,41170410,31609309,72779719,9,0,0,39424,4,950326685
5215,41170990,31625600,72796590,2,0,0,55296,1,6767358164
5216,41183050,31531156,72714206,9,0,0,26112,4,8361643662
5217,41189630,31567778,72757408,5,0,0,4096,12,469173458
5218,41192490,61612536,102805026,0,0,1,3584,6,10716221979
5219,41195150,32560878,73756028,6,0,0,7680,12,7251250284
5220,41197140,31380093,72577233,3,0,0,14848,18,5484166926
5221,41198030,31739786,72937816,1,0,0,14336,1,744140112
5222,41217000,31606998,72823998,3,0,0,14848,18,273373924
5223,41221920,61583129,102805049,8,0,1,13312,11,9083966145
5224,41247820,32143162,73390982,8,0,0,41472,11,727919972
5225,41249050,31627560,72876610,7,0,0,73216,1,621643244
5226,41271610,32436149,73707759,8,0,0,12288,11,7455808607
5227,41273450,32613445,73886895,2,0,0,10752,1,757137780
5228,41274890,31862036,73136926,1,0,0,51200,1,4780537739
5229,41275120,31900552,73175672,0,0,0,1536,6,9270772817
5230,41275970,31578309,72854279,0,0,0,51200,6,8675839743
5231,41278940,31752444,73031384,9,0,0,4096,4,3887107648
5232,41285060,31756225,73041285,7,0,0,12800,1,7558320853
5233,41304940,31672835,72977775,5,0,0,131072,12,3764761375
5234,41307070,32868388,74175458,8,0,0,39936,11,5462030162
5235,41349040,31630988,72980028,0,0,0,7168,6,8734484027
5236,41358050,61447022,102805072,2,0,1,5632,1,2354244594
5237,41363321,61442405,102805726,9,0,1,5632,4,6037826576
5238,41374660,31788244,73162904,8,0,0,11264,11,6259534128
5239,41376469,61429603,102806072,5,0,1,512,12,7384272168
5240,41384230,31636640,73020870,3,0,0,512,18,7258539543
5241,41393800,31657336,73051136,3,0,0,32256,18,9308438103
5242,41400710,33047883,74448593,5,0,0,108032,12,1845465459
5243,41412530,31745776,73158306,7,0,0,10752,1,163166996
5244,41413460,31876494,73289954,5,0,0,27648,12,7548673864
5245,41416270,31649690,73065960,5,0,0,11264,12,7471027727
5246,41442970,31610340,73053310,0,0,0,2048,6,6822890387
5247,41451750,31625515,73077265,8,0,0,1024,11,952213442
5248,41470060,31895012,73365072,9,0,0,138752,4,6115264989
5249,41472960,31762777,73235737,9,0,0,13312,4,6952874430
5250,41473360,31744996,73218356,4,0,0,30720,7,4733540120
5251,41473650,31986038,73459688,3,0,0,48640,18,104064384
5252,41473740,61465949,102939689,1,0,1,32256,1,4758316643
5253,41478200,33100155,74578355,2,0,0,28672,1,2031488617
5254,41486240,31976334,73462574,8,0,0,7168,11,9570221381
5255,41487030,61452682,102939712,4,0,1,3072,7,5129392287
5256,41487420,32390849,73878269,5,0,0,61440,12,2547450594
5257,41491850,32212000,73703850,4,0,0,20992,7,10190418166
5258,41494010,31796123,73290133,0,0,0,512,6,428236525
5259,41520390,33170795,74691185,9,0,0,39936,4,506596712
5260,41530530,31979072,73509602,8,0,0,45568,11,9285835258
5261,41540350,31979259,73519609,9,0,0,32768,4,6044692049
5262,41552860,31858851,73411711,9,0,0,60416,4,7963891070
5263,41555450,32566892,74122342,8,0,0,34816,11,5936526786
5264,41561040,31813937,73374977,2,0,0,8704,1,9050566415
5265,41561550,31809317,73370867,4,0,0,18944,7,3627182961
5266,41573430,61487144,103060574,7,0,1,38400,1,8523073026
5267,41575660,32246338,73821998,8,0,0,16384,11,5670327642
5268,41585510,62406562,103992072,6,0,1,401408,12,8013779770
5269,41585650,31786644,73372294,3,0,0,4608,18,6131637111
5270,41595070,32001866,73596936,6,0,0,128512,12,2651571493
5271,41599600,32059108,73658708,8,0,0,29696,11,614229574
5272,41607460,31918600,73526060,7,0,0,14848,1,3780951377
5273,41609040,32065911,73674951,8,0,0,25600,11,4189139518
5274,41611110,31910246,73521356,3,0,0,5632,18,686679183
5275,41618620,32075044,73693664,2,0,0,43008,1,9646040904
5276,41627730,32136970,73764700,1,0,0,3072,1,3442434745
5277,41633540,32007835,73641375,8,0,0,6144,11,6661594734
5278,41639270,31911114,73550384,0,0,0,22016,6,3267225638
5279,41654190,32331866,73986056,3,0,0,44544,18,3717206063
5280,41654920,32404759,74059679,7,0,0,121344,1,3387630271
5281,41664710,32562051,74226761,0,0,0,73728,6,9243075388
5282,41665340,32218256,73883596,2,0,0,17408,1,3250222432
5283,41667030,31945970,73613000,8,0,0,10752,11,1192028470
5284,41667720,32243194,73910914,6,0,0,19968,12,807383859
5285,41677450,62314645,103992095,4,0,1,6656,7,10070550519
5286,41685100,32312764,73997864,8,0,0,7680,11,5377092204
5287,41686860,32563636,74250496,4,0,0,5632,7,2615683331
5288,41694410,32158928,73853338,8,0,0,30720,11,9621216667
5289,41706850,62302035,104008885,7,0,1,68096,1,7070943765
5290,41707050,31990381,73697431,2,0,0,12288,1,4006983358
5291,41717420,32187387,73904807,1,0,0,19456,1,5050647815
5292,41723370,32340388,74063758,6,0,0,13312,12,4974580754
5293,41724599,62376837,104101436,3,0,1,4608,18,1250567862
5294,41755020,32036823,73791843,7,0,0,5632,1,1406054900
5295,41764750,33196334,74961084,4,0,0,175616,7,10123515388
5296,41773640,32058779,73832419,7,0,0,10240,1,10433592206
5297,41774909,62374675,104149584,5,0,1,12800,12,3123696624
5298,41781180,32541059,74322239,5,0,0,22016,12,6058846996
5299,41784680,62364927,104149607,8,0,1,8704,11,9499438489
5300,41788730,62360900,104149630,0,0,1,12288,6,8514929751
5301,41790100,62359553,104149653,2,0,1,2560,1,5680873854
5302,41803730,32900426,74704156,6,0,0,42496,12,9906753045
5303,41807370,32264411,74071781,6,0,0,8704,12,3043387724
5304,41825190,32028639,73853829,4,0,0,1536,7,5080357047
5305,41825500,32251452,74076952,3,0,0,16896,18,6848158897
5306,41834370,32656973,74491343,9,0,0,22016,4,4157811609
5307,41854760,32596976,74451736,4,0,0,10240,7,4269000364
5308,41860440,33001780,74862220,5,0,0,125952,12,9004251701
5309,41863990,62289476,104153466,4,0,1,8192,7,461002539
5310,41872640,32362747,74235387,6,0,0,24064,12,5955231883
5311,41872820,32586115,74458935,4,0,0,23552,7,9996617484
5312,41874130,32265319,74139449,7,0,0,5632,1,2562033828
5313,41876239,62277250,104153489,5,0,1,8704,12,9954445263
5314,41877610,32602431,74480041,5,0,0,69120,12,450705339
5315,41883810,33304057,75187867,0,0,0,368128,6,2100734357
5316,41894880,33351234,75246114,8,0,0,17408,11,9156097376
5317,41907240,33464839,75372079,6,0,0,18432,12,1708715327
5318,41925960,32302072,74228032,7,0,0,4096,1,2402234600
5319,41926930,33350438,75277368,1,0,0,11776,1,7766536537
5320,41935820,32712021,74647841,6,0,0,7168,12,7063618833
5321,41939810,32430879,74370689,2,0,0,6144,1,5319085989
5322,41941769,62211743,104153512,5,0,1,17408,12,4409681190
5323,41949880,33856366,75806246,8,0,0,41472,11,6792914006
5324,41951160,62213950,104165110,2,0,1,9216,1,6611309086
5325,41952290,32354693,74306983,6,0,0,512,12,2783964171
5326,41957580,32349224,74306804,6,0,0,24576,12,7254538956
5327,41958930,62208577,104167507,2,0,1,18944,1,2037545899
5328,41959190,32294382,74253572,1,0,0,6144,1,8836632039
5329,41967370,33429861,75397231,4,0,0,19968,7,7558928682
5330,41979470,32782311,74761781,7,0,0,14848,1,10525536898
5331,41989780,32494808,74484588,3,0,0,14848,18,1414693356
5332,42011370,34174557,76185927,0,0,0,568320,6,9964939753
5333,42015860,32380317,74396177,0,0,0,1536,6,954376312
5334,42031460,32840680,74872140,1,0,0,32256,1,5829603891
5335,42033010,32294244,74327254,0,0,0,16384,6,7182991019
5336,42039720,62161153,104200873,1,0,1,2048,1,5480326013
5337,42048030,33535718,75583748,7,0,0,49152,1,5935446078
5338,42051190,33021909,75073099,0,0,0,26624,6,932376525
5339,42083110,32897679,74980789,4,0,0,2048,7,4041446933
5340,42084630,33135332,75219962,4,0,0,70144,7,3547059090
5341,42085070,62119349,104204419,0,0,1,5632,6,10434020677
5342,42087510,62189704,104277214,4,0,1,30720,7,2705096518
5343,42112180,33774785,75886965,2,0,0,6656,1,10153785951
5344,42121019,62238628,104359647,3,0,1,32256,18,10382633789
5345,42123490,33265483,75388973,9,0,0,20992,4,986990303
5346,42131300,62229935,104361235,4,0,1,15872,7,9042426070
5347,42160959,62342698,104503657,3,0,1,5120,18,1796880140
5348,42163930,33076803,75240733,7,0,0,68096,1,5455751800
5349,42164250,62456661,104620911,6,0,1,45056,12,2588031743
5350,42169000,33029544,75198544,5,0,0,5120,12,10632333750
5351,42177670,33749107,75926777,2,0,0,126976,1,856493523
5352,42182600,33091149,75273749,8,0,0,90624,11,3438128099
5353,42191430,32839090,75030520,8,0,0,12800,11,5087645077
5354,42192650,62501192,104693842,1,0,1,18944,1,10682729280
5355,42207810,62528423,104736233,8,0,1,31744,11,1033225867
5356,42207870,62555850,104763720,0,0,1,2560,6,7847119254
5357,42213730,33069901,75283631,2,0,0,20480,1,7090609613
5358,42213770,34116475,76330245,4,0,0,12288,7,3907693137
5359,42224690,62539053,104763743,2,0,1,6656,1,10511278517
5360,42237760,62540693,104778453,0,0,1,14336,6,7376623226
5361,42238060,62541999,104780059,2,0,1,10240,1,552789671
5362,42250410,62531344,104781754,4,0,1,4096,7,5830634988
5363,42252840,33113600,75366440,8,0,0,33280,11,4035736125
5364,42253440,32938662,75192102,8,0,0,13824,11,9992744892
5365,42256490,33126064,75382554,2,0,0,34304,1,7037220846
5366,42257479,62588005,104845484,3,0,1,12800,18,6989296148
5367,42287110,33907732,76194842,8,0,0,29184,11,2021595918
5368,42288880,33241031,75529911,7,0,0,107008,1,10138703210
5369,42292840,32695078,74987918,3,0,0,11776,18,3672100993
5370,42304370,33376040,75680410,8,0,0,13824,11,4759688999
5371,42312020,32728447,75040467,5,0,0,512,12,9662150901
5372,42316429,62586196,104902625,3,0,1,33792,18,10146834580
5373,42320690,33248059,75568749,3,0,0,61952,18,3151985913
5374,42326810,33279916,75606726,6,0,0,58880,12,4723470417
5375,42327270,62677638,105004908,1,0,1,15360,1,7696988744
5376,42327580,62679594,105007174,4,0,1,3584,7,7385888163
5377,42359170,62953410,105312580,1,0,1,34816,1,4425901163
5378,42381680,32918408,75300088,1,0,0,12288,1,7442000650
5379,42386800,33962406,76349206,0,0,0,28672,6,3940635481
5380,42389320,33001712,75391032,2,0,0,6656,1,7582653720
5381,42389500,32906821,75296321,3,0,0,29696,18,852526249
5382,42391460,32805501,75196961,1,0,0,15872,1,10317574304
5383,42399750,63197706,105597456,4,0,1,31744,7,2259198582
5384,42400910,63428404,105829314,1,0,1,8704,1,6954561372
5385,42403570,32929849,75333419,3,0,0,4096,18,7965809821
5386,42406440,34141473,76547913,0,0,0,56832,6,970104181
5387,42424420,33019670,75444090,7,0,0,52736,1,9478287076
5388,42449140,33315094,75764234,7,0,0,20480,1,9732797313
5389,42451890,34042440,76494330,8,0,0,105984,11,8390964480
5390,42455590,32831652,75287242,5,0,0,11776,12,2936501387
5391,42465000,63364337,105829337,7,0,1,5632,1,10328682761
5392,42465350,63485086,105950436,8,0,1,4608,11,7433635546
5393,42471190,32978767,75449957,4,0,0,1536,7,5036793855
5394,42484760,33783072,76267832,4,0,0,75264,7,8450569043
5395,42493790,32934209,75427999,1,0,0,20480,1,4386775146
5396,42497600,34068791,76566391,7,0,0,59392,1,2465757731
5397,42506101,63623535,106129636,9,0,1,15360,4,3588021517
5398,42510100,32966555,75476655,8,0,0,17920,11,231139151
5399,42519380,33855456,76374836,6,0,0,80896,12,9125062829
5400,42525480,33011630,75537110,4,0,0,23552,7,5344865793
5401,42528200,33767891,76296091,7,0,0,92672,1,9736625283
5402,42533090,33311690,75844780,3,0,0,3072,18,6018135701
5403,42536400,33074561,75610961,1,0,0,13824,1,153598459
5404,42555481,63574178,106129659,9,0,1,1536,4,8973123776
5405,42555990,63573692,106129682,8,0,1,16384,11,7557702090
5406,42570210,34062128,76632338,5,0,0,19456,12,2988147268
5407,42585310,33725514,76310824,3,0,0,12288,18,1881643742
5408,42592080,32996683,75588763,5,0,0,16384,12,1961666994
5409,42602030,63527675,106129705,8,0,1,1024,11,5080335596
5410,42602050,33738397,76340447,6,0,0,2560,12,4848404732
5411,42607630,33718840,76326470,9,0,0,37376,4,10125628590
5412,42614920,33724724,76339644,3,0,0,30720,18,9796162771
5413,42616900,33832573,76449473,5,0,0,19456,12,8144008152
5414,42618660,33626217,76244877,2,0,0,70144,1,1810607802
5415,42619160,33880099,76499259,1,0,0,8704,1,7338592578
5416,42634209,63495519,106129728,5,0,1,9728,12,742150596
5417,42643840,33284364,75928204,3,0,0,4608,18,7618358598
5418,42656270,33567212,76223482,0,0,0,58368,6,3939458264
5419,42682950,33522725,76205675,1,0,0,1024,1,1678077909
5420,42718330,33125491,75843821,5,0,0,26112,12,7668742953
5421,42721220,33047093,75768313,1,0,0,13312,1,2261836356
5422,42723781,63524736,106248517,9,0,1,15360,4,3783366792
5423,42725760,33479580,76205340,1,0,0,25600,1,1352380061
5424,42726370,33900017,76626387,2,0,0,131072,1,6673911980
5425,42729720,33585339,76315059,0,0,0,13824,6,5407220225
5426,42737690,33992024,76729714,4,0,0,86528,7,10547220930
5427,42739280,63709865,106449145,8,0,1,45056,11,2479992940
5428,42745780,33604385,76350165,6,0,0,3072,12,3047623649
5429,42747410,33450107,76197517,6,0,0,8704,12,6664656123
5430,42747700,33768609,76516309,6,0,0,31744,12,836411337
5431,42752460,33681991,76434451,2,0,0,195584,1,5017689985
5432,42758460,33702432,76460892,3,0,0,37376,18,7228258061
5433,42791570,33734301,76525871,4,0,0,18944,7,10707164212
5434,42792090,34070277,76862367,4,0,0,89600,7,1952923002
5435,42795170,33511084,76306254,6,0,0,33280,12,1785447572
5436,42795400,63660800,106456200,1,0,1,10752,1,341063092
5437,42811570,33631952,76443522,2,0,0,29696,1,5726118186
5438,42825030,33482027,76307057,0,0,0,2560,6,7838507460
5439,42832230,33716026,76548256,7,0,0,1024,1,1360373986
5440,42845700,33674376,76520076,7,0,0,12288,1,188675324
5441,42876290,33790274,76666564,4,0,0,25088,7,10686301715
5442,42876430,33782459,76658889,2,0,0,87040,1,1948738271
5443,42890129,63606021,106496150,3,0,1,13824,18,1232940886
5444,42896100,34033327,76929427,0,0,0,103936,6,3014392632
5445,42897680,63602976,106500656,4,0,1,7168,7,3667248565
5446,42899259,63602063,106501322,5,0,1,1024,12,6136634772
5447,42936790,63821435,106758225,7,0,1,57344,1,4349857301
5448,42937260,63840167,106777427,0,0,1,11264,6,2689455339
5449,42938380,33558196,76496576,4,0,0,5120,7,5766061331
5450,42978360,33483655,76462015,6,0,0,3584,12,3691163534
5451,42980259,63797191,106777450,5,0,1,4608,12,395055390
5452,42984640,33521974,76506614,2,0,0,24064,1,5807878239
5453,43009770,63770730,106780500,4,0,1,28160,7,3678486024
5454,43014679,63797759,106812438,5,0,1,3072,12,8941084185
5455,43027700,33737674,76765374,4,0,0,25088,7,4458809119
5456,43031450,33463543,76494993,8,0,0,2048,11,3135688803
5457,43031690,63783014,106814704,6,0,1,3584,12,4033226976
5458,43041520,63885571,106927091,0,0,1,3072,6,3298953938
5459,43060899,63866215,106927114,3,0,1,6656,18,5538306138
5460,43061060,63870624,106931684,0,0,1,23040,6,1993850074
5461,43064040,33693667,76757707,7,0,0,15360,1,8578930904
5462,43066510,33464064,76530574,3,0,0,15360,18,1172230176
5463,43093530,33600559,76694089,4,0,0,32256,7,9520192567
5464,43096730,33487803,76584533,1,0,0,14848,1,2422427060
5465,43102040,33847810,76949850,0,0,0,29696,6,7562157516
5466,43104970,63880889,106985859,2,0,1,1024,1,1281445314
5467,43119510,63869575,106989085,0,0,1,5120,6,7052432033
5468,43127030,33813749,76940779,2,0,0,35328,1,6389819976
5469,43136260,33543899,76680159,4,0,0,44544,7,3893800122
5470,43141110,33599235,76740345,4,0,0,34816,7,7440698872
5471,43143610,33436376,76579986,5,0,0,44544,12,2535596744
5472,43143880,33540358,76684238,6,0,0,13312,12,10361981676
5473,43155490,33597514,76753004,5,0,0,41472,12,8037217090
5474,43179290,63814941,106994231,2,0,1,8192,1,6998953361
5475,43180430,33405998,76586428,4,0,0,6144,7,6740119982
5476,43182739,63895009,107077748,5,0,1,28672,12,10106025686
5477,43197719,63942125,107139844,3,0,1,14848,18,5617364086
5478,43215210,34064849,77280059,3,0,0,39936,18,7758461530
5479,43217260,33991054,77208314,2,0,0,139264,1,3583682032
5480,43220570,63919297,107139867,2,0,1,2048,1,4281179999
5481,43236600,33853510,77090110,5,0,0,33792,12,2841997215
5482,43263290,33571754,76835044,7,0,0,37888,1,830714914
5483,43277620,63953077,107230697,2,0,1,13824,1,5147331466
5484,43277780,33965291,77243071,4,0,0,22016,7,3323709491
5485,43302500,33863328,77165828,8,0,0,43520,11,6798678475
5486,43310480,33500346,76810826,2,0,0,30208,1,309632619
5487,43319330,34054264,77373594,8,0,0,96768,11,8951145825
5488,43321250,33724190,77045440,0,0,0,3584,6,304559566
5489,43327220,33693986,77021206,7,0,0,62976,1,5698562590
5490,43327410,64051229,107378639,8,0,1,30720,11,2873573193
5491,43333200,34166257,77499457,8,0,0,88576,11,8627127512
5492,43351750,33692567,77044317,2,0,0,75776,1,9212404625
5493,43357830,33515625,76873455,8,0,0,4096,11,4715117312
5494,43367570,33919540,77287110,1,0,0,23040,1,6150461468
5495,43373040,33740851,77113891,0,0,0,77824,6,9298124289
5496,43376380,33776165,77152545,0,0,0,6656,6,10730452339
5497,43389810,63990455,107380265,4,0,1,2560,7,211618576
5498,43389860,64066576,107456436,8,0,1,16896,11,6297645535
5499,43406850,33743644,77150494,3,0,0,70656,18,8428541822
5500,43408410,34350608,77759018,5,0,0,47104,12,1127122762
5501,43414920,33904841,77319761,6,0,0,37376,12,10311855578
5502,43431810,33777619,77209429,8,0,0,3584,11,644738204
5503,43454590,33773269,77227859,2,0,0,8704,1,3422042245
5504,43457520,64583178,108040698,6,0,1,181248,12,8908360577
5505,43466270,33921433,77387703,8,0,0,1536,11,1698967527
5506,43498170,33718146,77216316,8,0,0,22528,11,4028526643
5507,43500690,34077764,77578454,8,0,0,11264,11,10569116222
5508,43504410,33877475,77381885,0,0,0,27136,6,8848125369
5509,43507370,34034787,77542157,4,0,0,22528,7,4991219529
5510,43509120,33878092,77387212,1,0,0,17408,1,2843987952
5511,43518880,64526275,108045155,8,0,1,30720,11,6894524993
5512,43529300,33546294,77075594,0,0,0,22528,6,3385996198
5513,43557880,33852668,77410548,2,0,0,40448,1,9354682247
5514,43563290,33704578,77267868,4,0,0,57856,7,4095885850
5515,43565310,33778777,77344087,3,0,0,28672,18,1457965115
5516,43565860,64545073,108110933,1,0,1,4096,1,8202971169
5517,43568980,33829221,77398201,4,0,0,15872,7,4159003160
5518,43572509,64566288,108138797,3,0,1,33280,18,10351591511
5519,43586240,33630411,77216651,7,0,0,1024,1,2715502759
5520,43587750,34059278,77647028,1,0,0,18432,1,5682239031
5521,43592040,33991915,77583955,4,0,0,17920,7,9912396653
5522,43596790,33825497,77422287,0,0,0,17920,6,4482245690
5523,43606910,33948530,77555440,5,0,0,43520,12,3894351120
5524,43616700,34224557,77841257,6,0,0,27648,12,4133409177
5525,43620780,34171379,77792159,2,0,0,34304,1,2844098974
5526,43633660,34185406,77819066,6,0,0,77824,12,4251074020
5527,43636720,33898550,77535270,1,0,0,45568,1,6648624045
5528,43646760,33770044,77416804,7,0,0,7680,1,5842345109
5529,43646859,64526554,108173413,5,0,1,8192,12,9517862790
5530,43652390,34851883,78504273,4,0,0,329216,7,2954701892
5531,43659100,34122584,77781684,1,0,0,36864,1,6866929111
5532,43675770,34094659,77770429,2,0,0,37376,1,10673824075
5533,43676080,33717262,77393342,2,0,0,18432,1,2126030005
5534,43683110,34320594,78003704,6,0,0,12800,12,1522910306
5535,43683360,33974979,77658339,1,0,0,5120,1,9481548582
5536,43696970,64522021,108218991,6,0,1,26112,12,815298974
5537,43722930,64496233,108219163,4,0,1,14848,7,10377600086
5538,43729130,33772066,77501196,0,0,0,5632,6,9284971209
5539,43747890,34377213,78125103,3,0,0,5632,18,1081694295
5540,43756210,34160547,77916757,8,0,0,40448,11,1692892356
5541,43777759,64503803,108281562,3,0,1,17920,18,237669207
5542,43779039,64502546,108281585,3,0,1,1536,18,3025501365
5543,43784000,34114875,77898875,1,0,0,28160,1,519624447
5544,43794740,64498293,108293033,8,0,1,3584,11,10351672259
5545,43797450,34819464,78616914,2,0,0,30208,1,686745449
5546,43807210,34410143,78217353,5,0,0,115712,12,1780314217
5547,43812860,34212164,78025024,1,0,0,20480,1,9438399502
5548,43825510,33731045,77556555,0,0,0,3584,6,5436698594
5549,43834250,34981931,78816181,4,0,0,218112,7,3144939510
5550,43837590,33983555,77821145,4,0,0,1024,7,9554366737
5551,43841560,34332611,78174171,3,0,0,64000,18,5699713698
5552,43857360,34379672,78237032,2,0,0,64512,1,6165769202
5553,43876510,34685887,78562397,0,0,0,91136,6,7711555415
5554,43893550,34419402,78312952,1,0,0,23040,1,9614850958
5555,43895150,34145406,78040556,7,0,0,37376,1,2419017539
5556,43926670,34377671,78304341,5,0,0,22528,12,357454380
5557,43958710,34922487,78881197,4,0,0,109568,7,10233272547
5558,43966740,34548164,78514904,1,0,0,34816,1,6668627921
5559,43976900,34614629,78591529,9,0,0,8704,4,2206637535
5560,43979009,64314178,108293187,5,0,1,8704,12,8472455158
5561,43990409,64353132,108343541,3,0,1,18432,18,3768718815
5562,43994010,33836135,77830145,4,0,0,16384,7,6318131598
5563,44002430,64341134,108343564,1,0,1,512,1,3206157836
5564,44006150,34695474,78701624,3,0,0,11776,18,2153537021
5565,44007470,34350337,78357807,4,0,0,34304,7,8634105231
5566,44017030,34517576,78534606,6,0,0,60928,12,7252502817
5567,44028070,65490141,109518211,6,0,1,407040,12,398238939
5568,44036800,34218507,78255307,5,0,0,59904,12,4333380773
5569,44037150,65501282,109538432,1,0,1,29696,1,659078324
5570,44045010,65493678,109538688,0,0,1,9216,6,7976369351
5571,44045150,34242307,78287457,0,0,0,41472,6,2111781796
5572,44046460,34801330,78847790,1,0,0,84480,1,5149406972
5573,44047690,34870641,78918331,4,0,0,87552,7,10598861361
5574,44052810,34238258,78291068,0,0,0,11776,6,9705891433
5575,44065920,34903194,78969114,8,0,0,116736,11,9303615622
5576,44069260,34226882,78296142,6,0,0,6656,12,7670018580
5577,44074610,34514244,78588854,1,0,0,512,1,7992920537
5578,44090150,65482181,109572331,2,0,1,28160,1,1239978086
5579,44098560,34175637,78274197,8,0,0,9728,11,7163767457
5580,44108740,34407279,78516019,0,0,0,3584,6,715320358
5581,44110940,34485612,78596552,4,0,0,16384,7,6645759436
5582,44115330,34473345,78588675,7,0,0,23552,1,10026908402
5583,44117610,34197081,78314691,6,0,0,5632,12,9191227408
5584,44123130,65469006,109592136,4,0,1,8192,7,7721216879
5585,44130350,35106783,79237133,4,0,0,69120,7,8261242188
5586,44134990,34686853,78821843,0,0,0,7168,6,6264835227
5587,44151860,34429592,78581452,6,0,0,62464,12,3094819720
5588,44152420,34515533,78667953,5,0,0,2048,12,1079095842
5589,44163900,35439079,79602979,8,0,0,80384,11,6990433828
5590,44167560,34763898,78931458,5,0,0,43008,12,4358435184
5591,44170440,35337863,79508303,0,0,0,28160,6,5353848757
5592,44175290,34540314,78715604,4,0,0,12288,7,10703223539
5593,44183140,34967676,79150816,1,0,0,67584,1,7852709790
5594,44183570,34818133,79001703,2,0,0,37376,1,7262355
5595,44186590,34502088,78688678,8,0,0,55296,11,9833928644
5596,44188690,65403469,109592159,2,0,1,11264,1,2624339004
5597,44192120,34627516,78819636,2,0,0,11264,1,5276345563
5598,44194390,35108413,79302803,9,0,0,53760,4,32335017
5599,44208920,65383262,109592182,7,0,1,7168,1,2890034557
5600,44209790,65441928,109651718,6,0,1,32768,12,4384609462
5601,44222150,65493228,109715378,8,0,1,10240,11,9330857303
5602,44231500,34882454,79113954,4,0,0,6656,7,8108681378
5603,44231530,65483871,109715401,1,0,1,15360,1,8780337372
5604,44232630,34920393,79153023,1,0,0,7168,1,1082070592
5605,44235800,34953978,79189778,0,0,0,10752,6,8249419910
5606,44255960,35009524,79265484,9,0,0,36864,4,9602724872
5607,44261080,35214253,79475333,0,0,0,47104,6,1346939992
5608,44268670,34622923,78891593,8,0,0,33792,11,7584426322
5609,44275010,65440414,109715424,1,0,1,9216,1,1302370199
5610,44275050,35168125,79443175,9,0,0,84480,4,8482411599
5611,44278660,34851541,79130201,4,0,0,53248,7,3946960385
5612,44278990,34696589,78975579,2,0,0,20992,1,6800397854
5613,44286200,35033583,79319783,4,0,0,31744,7,8286043241
5614,44302520,35144578,79447098,7,0,0,12800,1,8238905731
5615,44303950,34807953,79111903,9,0,0,40960,4,9096524349
5616,44313150,34967029,79280179,9,0,0,11264,4,7103057276
5617,44326820,34881678,79208498,8,0,0,6656,11,5847783304
5618,44332580,35504975,79837555,1,0,0,6144,1,3812649076
5619,44333300,34600053,78933353,8,0,0,6144,11,5722744991
5620,44334890,35296273,79631163,7,0,0,40448,1,1010330960
5621,44338030,35055008,79393038,9,0,0,10752,4,7808207708
5622,44350930,35214063,79564993,2,0,0,79872,1,2867480023
5623,44354980,65360467,109715447,1,0,1,10752,1,8721972764
5624,44358280,35124920,79483200,9,0,0,3072,4,5623786055
5625,44358540,34833986,79192526,4,0,0,1536,7,4153428234
5626,44360950,35641122,80002072,1,0,0,4096,1,7822000952
5627,44369580,35362601,79732181,1,0,0,80896,1,6035360727
5628,44369800,34801932,79171732,6,0,0,2560,12,2213961243
5629,44382850,35103517,79486367,9,0,0,1536,4,2770168221
5630,44387460,35425081,79812541,8,0,0,5632,11,3075958230
5631,44388980,35659050,80048030,9,0,0,512,4,4136644176
5632,44396280,35497925,79894205,8,0,0,62976,11,9753689495
5633,44398650,35776997,80175647,2,0,0,20992,1,9568680349
5634,44404130,35516748,79920878,3,0,0,35328,18,2614393945
5635,44424859,65290611,109715470,5,0,1,18432,12,925505308
5636,44430180,35374782,79804962,2,0,0,34304,1,5098655393
5637,44444040,65304754,109748794,1,0,1,1536,1,7073137678
5638,44447330,34571755,79019085,4,0,0,2560,7,2727253166
5639,44450310,35257200,79707510,5,0,0,72704,12,7997546573
5640,44456330,34928063,79384393,6,0,0,19456,12,6012636505
5641,44480790,65268862,109749652,0,0,1,2048,6,3013305789
5642,44481400,35313087,79794487,2,0,0,28160,1,9351737783
5643,44490270,35250046,79740316,8,0,0,26624,11,7449831098
5644,44490550,35358361,79848911,0,0,0,29696,6,6830673053
5645,44499799,65295739,109795538,3,0,1,8192,18,154292274
5646,44503800,35616789,80120589,7,0,0,88576,1,5495600460
5647,44509030,35398348,79907378,4,0,0,26112,7,1086104671
5648,44518660,65332378,109851038,6,0,1,54784,12,7029835733
5649,44520670,65397478,109918148,8,0,1,20480,11,1900057323
5650,44524180,35470852,79995032,7,0,0,45568,1,757395671
5651,44556640,34751334,79307974,3,0,0,16896,18,3095838737
5652,44574820,65390889,109965709,7,0,1,5632,1,5698315223
5653,44616570,34669830,79286400,5,0,0,9728,12,6092029769
5654,44624429,65345146,109969575,5,0,1,6144,12,5459587345
5655,44644909,65353500,109998409,3,0,1,1536,18,10716811909
5656,44674880,35568748,80243628,5,0,0,13824,12,3813856947
5657,44682370,35698232,80380602,5,0,0,64000,12,9553237340
5658,44685750,35121263,79807013,7,0,0,6656,1,1558188558
5659,44690770,35807489,80498259,6,0,0,31744,12,10707974860
5660,44691120,34801009,79492129,6,0,0,2048,12,8203664361
5661,44699260,36029989,80729249,6,0,0,153088,12,8586234319
5662,44705350,35977232,80682582,4,0,0,115200,7,10696100311
5663,44720400,65287764,110008164,0,0,1,25600,6,345114667
5664,44723080,36350017,81073097,8,0,0,48640,11,3351598795
5665,44730030,35831418,80561448,1,0,0,101888,1,2206029310
5666,44732670,35268131,80000801,6,0,0,17920,12,6819133350
5667,44741450,35582044,80323494,1,0,0,37888,1,1028466776
5668,44744410,35130576,79874986,8,0,0,85504,11,2590187282
5669,44747600,35535866,80283466,2,0,0,9728,1,6021670484
5670,44760300,35369406,80129706,2,0,0,10752,1,1183822737
5671,44766440,35132959,79899399,7,0,0,12288,1,5809123783
5672,44772120,65995848,110767968,6,0,1,171008,12,5446754834
5673,44782310,36465371,81247681,3,0,0,38400,18,3166479994
5674,44792710,36103273,80895983,1,0,0,36864,1,2530991825
5675,44795730,35185395,79981125,4,0,0,31232,7,3213276037
5676,44796460,35276803,80073263,0,0,0,2560,6,3042600874
5677,44797320,35944588,80741908,0,0,0,41472,6,1452197048
5678,44798630,65969361,110767991,2,0,1,4608,1,8626490282
5679,44819350,35596669,80416019,0,0,0,8192,6,1712280094
5680,44822050,36023851,80845901,8,0,0,91136,11,529920086
5681,44824910,35411744,80236654,0,0,0,43008,6,198735378
5682,44826880,35980149,80807029,5,0,0,213504,12,4074584213
5683,44829750,36044605,80874355,5,0,0,93184,12,2022145025
5684,44850310,36034418,80884728,8,0,0,8192,11,2986754465
5685,44852250,65915764,110768014,7,0,1,14848,1,1681736994
5686,44853960,36027750,80881710,5,0,0,24064,12,9465510719
5687,44858480,65909557,110768037,7,0,1,29696,1,2880043097
5688,44861229,66101379,110962608,3,0,1,43008,18,8342694703
5689,44864630,35031002,79895632,5,0,0,4608,12,4760788509
5690,44867040,35259344,80126384,3,0,0,18944,18,9893621785
5691,44871970,35653027,80524997,9,0,0,16896,4,5902400536
5692,44882060,36023723,80905783,1,0,0,27648,1,9902028160
5693,44885300,66530750,111416050,6,0,1,286720,12,6647159867
5694,44887940,36187767,81075707,9,0,0,5632,4,7076236924
5695,44888750,36254347,81143097,4,0,0,54784,7,6331060085
5696,44890760,36047891,80938651,5,0,0,100864,12,5260261983
5697,44893680,35193487,80087167,6,0,0,28672,12,4383251664
5698,44898250,36282761,81181011,0,0,0,18432,6,9691966695
5699,44926810,35281008,80207818,4,0,0,18944,7,1443076378
5700,44933850,36354516,81288366,4,0,0,35840,7,3038314628
5701,44937380,36153671,81091051,9,0,0,18432,4,6587654292
5702,44941820,35521616,80463436,6,0,0,24576,12,4092310087
5703,44957670,36419227,81376897,5,0,0,80384,12,9886849064
5704,44968760,35102808,80071568,4,0,0,1024,7,6709620307
5705,44970370,35328744,80299114,6,0,0,5632,12,1739176037
5706,44977250,36634511,81611761,9,0,0,18944,4,6314765480
5707,44977999,66438074,111416073,5,0,1,1024,12,4431722402
5708,44980550,35156370,80136920,2,0,0,1536,1,1075581775
5709,44988390,66755286,111743676,4,0,1,285696,7,7646917321
5710,44996610,35182024,80178634,3,0,0,9728,18,4707022917
5711,45000740,36351619,81352359,2,0,0,100352,1,6907847108
5712,45002280,35401791,80404071,6,0,0,34304,12,8847326152
5713,45004080,66771668,111775748,4,0,1,54272,7,5011820479
5714,45005100,36415879,81420979,7,0,0,24064,1,7520982160
5715,45008000,35606746,80614746,0,0,0,2560,6,1451989055
5716,45021970,35371626,80393596,5,0,0,15360,12,5123694393
5717,45026450,35385405,80411855,6,0,0,4608,12,2548497947
5718,45039880,35116161,80156041,4,0,0,1536,7,1749834480
5719,45042439,66733340,111775779,3,0,1,7680,18,8053647276
5720,45048720,36438180,81486900,0,0,0,64000,6,4618936652
5721,45051170,36865081,81916251,0,0,0,12288,6,484820429
5722,45061730,35748286,80810016,0,0,0,9728,6,10291924346
5723,45089650,35299243,80388893,0,0,0,27136,6,8190134822
5724,45089910,66868235,111958145,4,0,1,212480,7,6963852961
5725,45092870,35874248,80967118,8,0,0,50688,11,5255790078
5726,45101630,36495808,81597438,0,0,0,12288,6,1142347652
5727,45103840,36956084,82059924,3,0,0,109568,18,6548131889
5728,45104100,35305043,80409143,3,0,0,15872,18,478605308
5729,45114160,36593075,81707235,0,0,0,72704,6,1196807269
5730,45125650,36260341,81385991,5,0,0,29696,12,7320328149
5731,45138410,66834869,111973279,1,0,1,16896,1,1498578922
5732,45150060,36715836,81865896,0,0,0,226816,6,7436768521
5733,45151210,66832771,111983981,2,0,1,13312,1,9404615058
5734,45177700,35946007,81123707,5,0,0,22016,12,1423808625
5735,45191980,36580499,81772479,9,0,0,4096,4,3041323508
5736,45200860,35617227,80818087,3,0,0,26112,18,4263225320
5737,45201670,35368026,80569696,4,0,0,10240,7,7910187399
5738,45209130,36677381,81886511,1,0,0,67584,1,3820022135
5739,45211900,36283915,81495815,4,0,0,29184,7,4428923200
5740,45230000,36221953,81451953,6,0,0,27136,12,4348132037
5741,45233760,35925584,81159344,5,0,0,53248,12,5481066932
5742,45243830,36835528,82079358,8,0,0,31744,11,6228865688
5743,45252190,36687929,81940119,7,0,0,43008,1,6441927639
5744,45254120,66760049,112014169,7,0,1,7680,1,183078649
5745,45262100,37256834,82518934,8,0,0,512,11,1592055691
5746,45283250,35598951,80882201,1,0,0,1536,1,8875585568
5747,45285850,37149854,82435704,6,0,0,8192,12,3546267787
5748,45295880,36218753,81514633,7,0,0,2048,1,10657346219
5749,45312030,66707129,112019159,2,0,1,11776,1,9088929927
5750,45323640,66699385,112023025,0,0,1,6144,6,9183328928
5751,45344070,35877988,81222058,2,0,0,28160,1,6375300930
5752,45353800,66715598,112069398,4,0,1,33280,7,8925551132
5753,45353929,66719975,112073904,3,0,1,7168,18,6388639555
5754,45361920,66743058,112104978,8,0,1,11776,11,4886427370
5755,45389320,36811108,82200428,6,0,0,149504,12,4797897416
5756,45394220,36353199,81747419,3,0,0,83968,18,4973855506
5757,45396010,35910498,81306508,6,0,0,9216,12,7738953290
5758,45414930,36813959,82228889,2,0,0,39936,1,4827898563
5759,45415890,35887787,81303677,2,0,0,50176,1,8153973669
5760,45430950,35519104,80950054,4,0,0,14848,7,9566893677
5761,45442030,35747428,81189458,2,0,0,27648,1,3852628261
5762,45444280,66695342,112139622,8,0,1,16384,11,4444150883
5763,45456190,35865570,81321760,1,0,0,24576,1,2758084891
5764,45456780,36836427,82293207,7,0,0,37888,1,1350888630
5765,45458060,66700796,112158856,0,0,1,17408,6,2925352860
5766,45468300,36490119,81958419,1,0,0,22528,1,10208183950
5767,45468470,36249864,81718334,8,0,0,36352,11,9276039500
5768,45475750,37172001,82647751,7,0,0,49664,1,7894982268
5769,45480520,35645862,81126382,9,0,0,8704,4,9681457962
5770,45485290,66690812,112176102,6,0,1,3072,12,2018223162
5771,45510549,66665576,112176125,3,0,1,4608,18,6552908842
5772,45547910,35615825,81163735,4,0,0,14336,7,9154785863
5773,45556910,35712998,81269908,7,0,0,5632,1,4747677766
5774,45570980,66659148,112230128,1,0,1,50176,1,4775894416
5775,45571720,35683940,81255660,1,0,0,26112,1,2034638842
5776,45575760,66654391,112230151,1,0,1,4608,1,6615411628
5777,45577449,66710910,112288359,5,0,1,7168,12,7135513954
5778,45581180,36832996,82414176,1,0,0,8192,1,3250194929
5779,45590740,35483160,81073900,2,0,0,2560,1,2548015995
5780,45612300,35786818,81399118,9,0,0,43008,4,5258560737
5781,45617100,36067781,81684881,4,0,0,53248,7,5278887389
5782,45621360,66672593,112293953,6,0,1,18432,12,3491262325
5783,45635640,36269146,81904786,6,0,0,59904,12,1454120564
5784,45644180,35899210,81543390,1,0,0,32256,1,6731757031
5785,45649550,36838324,82487874,2,0,0,27136,1,2419708410
5786,45650290,36099500,81749790,0,0,0,7680,6,9196921937
5787,45656620,36975976,82632596,6,0,0,105984,12,2396058038
5788,45661480,36762867,82424347,4,0,0,33280,7,7902254988
5789,45667390,66626819,112294209,0,0,1,9216,6,2785534211
5790,45677690,37057503,82735193,0,0,0,58368,6,4984235632
5791,45682200,36534498,82216698,6,0,0,30720,12,1599002759
5792,45693780,35733306,81427086,4,0,0,19968,7,1758961174
5793,45695200,66724949,112420149,2,0,1,16896,1,6669197352
5794,45702110,36210351,81912461,2,0,0,25088,1,9189601239
5795,45705080,36321437,82026517,4,0,0,89600,7,1020677711
5796,45708200,36952210,82660410,2,0,0,41472,1,5542314550
5797,45728890,36244844,81973734,1,0,0,25088,1,4109846381
5798,45730800,36620256,82351056,7,0,0,45056,1,7915371725
5799,45760800,35738782,81499582,8,0,0,12288,11,7029522689
5800,45769770,35997359,81767129,2,0,0,56832,1,2032296117
5801,45776750,36748291,82525041,5,0,0,19968,12,2381673818
5802,45780680,66639835,112420515,7,0,1,4096,1,851106681
5803,45787990,35760107,81548097,1,0,0,8192,1,4386792748
5804,45800379,66620159,112420538,3,0,1,9728,18,9932639555
5805,45802350,37137204,82939554,9,0,0,12800,4,10089985169
5806,45806370,35878690,81685060,3,0,0,512,18,3769407044
5807,45808580,36908806,82717386,1,0,0,47104,1,8510854998
5808,45810410,66610151,112420561,6,0,1,512,12,589559297
5809,45818490,36275617,82094107,5,0,0,17920,12,6588433843
5810,45825410,37068203,82893613,4,0,0,26624,7,1571848387
5811,45834329,66588624,112422953,3,0,1,5120,18,8709310189
5812,45834400,36958160,82792560,1,0,0,20480,1,5792736652
5813,45836600,36496158,82332758,6,0,0,53760,12,10016297801
5814,45840480,35930728,81771208,8,0,0,13312,11,5304845588
5815,45841650,66590156,112431806,2,0,1,6656,1,1424680056
5816,45849270,66583642,112432912,1,0,1,8704,1,2796747597
5817,45854320,36926806,82781126,6,0,0,20992,12,4199985877
5818,45867799,66565136,112432935,5,0,1,11264,12,9971342590
5819,45879740,37158215,83037955,6,0,0,272384,12,5740583632
5820,45883890,36035113,81919003,3,0,0,4096,18,10615877637
5821,45904950,35816862,81721812,6,0,0,11264,12,9343639342
5822,45917480,37011300,82928780,0,0,0,62464,6,5495291462
5823,45941950,36913286,82855236,2,0,0,2560,1,6606578595
5824,45976970,35974562,81951532,1,0,0,19968,1,8802202394
5825,45988060,36752304,82740364,9,0,0,16896,4,9337188492
5826,45989080,66643838,112632918,2,0,1,23552,1,8814466230
5827,45995060,37112835,83107895,2,0,0,54784,1,10625640844
5828,45998290,36758009,82756299,8,0,0,52224,11,10335617660
5829,46001330,36315025,82316355,9,0,0,47104,4,271654199
5830,46012160,36588121,82600281,2,0,0,83456,1,10319793349
5831,46020490,36251402,82271892,9,0,0,28672,4,1155716924
5832,46034270,37056894,83091164,3,0,0,65536,18,1408909066
5833,46047310,66679935,112727245,2,0,1,23040,1,2822496239
5834,46054460,36175552,82230012,7,0,0,3584,1,5328412205
5835,46056130,36798303,82854433,5,0,0,55296,12,10076653192
5836,46065020,36142295,82207315,2,0,0,22528,1,10561506930
5837,46066050,36460106,82526156,3,0,0,3584,18,2865445582
5838,46081150,36256155,82337305,8,0,0,14848,11,5990688841
5839,46092850,36668472,82761322,6,0,0,16384,12,2910184088
5840,46095920,36954070,83049990,5,0,0,39424,12,905707903
5841,46103430,36132065,82235495,3,0,0,17920,18,7522624870
5842,46103480,66654903,112758383,0,0,1,14848,6,2451718005
5843,46112580,36996274,83108854,4,0,0,3072,7,6600649904
5844,46114140,36584575,82698715,0,0,0,77312,6,1829179992
5845,46142830,36211213,82354043,9,0,0,9728,4,1787098918
5846,46147320,66674497,112821817,7,0,1,25600,1,10716285581
5847,46152070,37266003,83418073,2,0,0,41984,1,8557520766
5848,46154250,36364505,82518755,7,0,0,26112,1,4743133288
5849,46155810,66752917,112908727,6,0,1,12800,12,10619474033
5850,46160280,36350496,82510776,7,0,0,54272,1,4344305130
5851,46166260,36656459,82822719,0,0,0,25088,6,10469837724
5852,46179370,37067623,83246993,4,0,0,26112,7,3032403063
5853,46185020,66755601,112940621,7,0,1,4096,1,10337277272
5854,46199310,36928006,83127316,0,0,0,38400,6,6051424079
5855,46204060,37095786,83299846,2,0,0,36352,1,2739779933
5856,46214160,36457817,82671977,0,0,0,37888,6,3674100989
5857,46218590,36989562,83208152,2,0,0,48128,1,1508488426
5858,46246330,36428806,82675136,7,0,0,10240,1,304734746
5859,46262189,66678455,112940644,5,0,1,15872,12,4212292812
5860,46271031,66730792,113001823,9,0,1,14336,4,6612375103
5861,46280320,36835265,83115585,2,0,0,22016,1,103981511
5862,46286230,36174741,82460971,0,0,0,19968,6,1398953751
5863,46289710,66712791,113002501,2,0,1,11776,1,9174452337
5864,46290940,36768635,83059575,1,0,0,18944,1,8180064914
5865,46301610,37187376,83488986,2,0,0,82432,1,7065509367
5866,46304390,36952932,83257322,8,0,0,14848,11,2194570701
5867,46307360,36981387,83288747,5,0,0,16384,12,7976513470
5868,46314660,36221248,82535908,3,0,0,9216,18,9072935664
5869,46317580,36239067,82556647,6,0,0,16384,12,289021217
5870,46328930,66712466,113041396,0,0,1,11264,6,3193320783
5871,46331521,66711181,113042702,9,0,1,2048,4,8655324190
5872,46332150,36739015,83071165,5,0,0,30208,12,5697194301
5873,46338630,36854835,83193465,8,0,0,10240,11,9593792910
5874,46345040,37079764,83424804,3,0,0,22016,18,636779606
5875,46364510,36851869,83216379,3,0,0,8704,18,3750432189
5876,46364740,37309816,83674556,6,0,0,10752,12,10075057282
5877,46376280,36461282,82837562,5,0,0,48640,12,7609372114
5878,46402830,36650950,83053780,7,0,0,8704,1,5095693909
5879,46414739,66628322,113043061,3,0,1,9728,18,6626812644
5880,46428970,36880823,83309793,6,0,0,6656,12,1659695527
5881,46438910,36844822,83283732,2,0,0,16896,1,5241375675
5882,46452240,66685184,113137424,7,0,1,3584,1,1187945818
5883,46453060,36598045,83051105,5,0,0,3584,12,3110590518
5884,46467380,36347672,82815052,0,0,0,62976,6,5783928834
5885,46476950,37019068,83496018,7,0,0,9728,1,4393303688
5886,46480530,36687567,83168097,0,0,0,29696,6,9558279982
5887,46482510,66656220,113138730,1,0,1,2048,1,1275518118
5888,46484251,66655145,113139396,9,0,1,1024,4,10692011853
5889,46485330,36919928,83405258,6,0,0,69632,12,1164522656
5890,46494161,66645901,113140062,9,0,1,1024,4,5974531598
5891,46503559,66636849,113140408,5,0,1,512,12,149692042
5892,46533490,36396873,82930363,3,0,0,5120,18,9887327868
5893,46535280,66649543,113184823,8,0,1,28160,11,10090890485
5894,46545470,66656285,113201755,0,0,1,7168,6,6203501797
5895,46554160,37115335,83669495,1,0,0,115200,1,4804726711
5896,46555650,36882094,83437744,5,0,0,20992,12,9360655762
5897,46561120,36997770,83558890,3,0,0,22528,18,7599149211
5898,46572310,66639986,113212296,8,0,1,21504,11,7868736979
5899,46581600,36480338,83061938,1,0,0,7680,1,4977178874
5900,46597700,37036672,83634372,4,0,0,59392,7,8733122667
5901,46600270,66722798,113323068,0,0,1,8704,6,10316290544
5902,46608510,36533395,83141905,1,0,0,27648,1,397461208
5903,46608790,36669771,83278561,0,0,0,69632,6,6837291328
5904,46610580,36573978,83184558,5,0,0,20480,12,7905008903
5905,46613340,66709882,113323222,0,0,1,8704,6,3835743650
5906,46616770,66743547,113360317,0,0,1,18432,6,6774226375
5907,46621070,36589705,83210775,3,0,0,512,18,4359778131
5908,46630170,37210924,83841094,6,0,0,96256,12,3472677417
5909,46631080,36607934,83239014,7,0,0,37888,1,3733557253
5910,46642300,66720484,113362784,0,0,1,7680,6,5400583149
5911,46645060,37378859,84023919,6,0,0,32768,12,2213074290
5912,46670971,66803873,113474844,9,0,1,1024,4,8972533446
5913,46675600,36701796,83377396,7,0,0,8704,1,5041377315
5914,46675690,66818621,113494311,7,0,1,6144,1,2266686939
5915,46687700,36873085,83560785,2,0,0,6144,1,7156101089
5916,46688810,37482266,84171076,4,0,0,5120,7,3465930123
5917,46697230,66801920,113499150,6,0,1,5120,12,5730455540
5918,46725300,37625389,84350689,6,0,0,60416,12,5996617561
5919,46736060,36646071,83382131,7,0,0,12288,1,853209682
5920,46736830,66789281,113526111,0,0,1,1536,6,1041458292
5921,46739680,36603010,83342690,5,0,0,25600,12,8977241060
5922,46739889,66786568,113526457,3,0,1,512,18,9990771218
5923,46739979,66790664,113530643,5,0,1,6656,12,2732856486
5924,46741600,37019600,83761200,8,0,0,34816,11,1815866243
5925,46747590,36710460,83458050,4,0,0,2048,7,4513069375
5926,46753210,36465688,83218898,8,0,0,8192,11,6550802653
5927,46755021,66775968,113530989,9,0,1,512,4,994956635
5928,46776380,36894854,83671234,0,0,0,5632,6,10603129691
5929,46778980,36937909,83716889,5,0,0,47616,12,5394848528
5930,46791230,36582974,83374204,1,0,0,9216,1,6312061541
5931,46791930,66748832,113540762,7,0,1,20992,1,6759577063
5932,46797049,66782945,113579994,5,0,1,12800,12,8347956928
5933,46808710,36983892,83792602,0,0,0,86016,6,1155468464
5934,46824370,37378452,84202822,2,0,0,33792,1,3522957977
5935,46827170,37800329,84627499,3,0,0,43008,18,10655537502
5936,46833580,36718400,83551980,6,0,0,77312,12,967770631
5937,46841000,66764728,113605728,1,0,1,1536,1,2931499992
5938,46848930,37177383,84026313,7,0,0,7680,1,1394420918
5939,46853840,36652019,83505859,1,0,0,14336,1,8325435124
5940,46860550,37152083,84012633,5,0,0,22528,12,9177724979
5941,46896680,36666156,83562836,7,0,0,6656,1,7154920011
5942,46897300,36666339,83563639,6,0,0,2560,12,579596989
5943,46904220,37857855,84762075,6,0,0,17408,12,1966318702
5944,46916679,66791579,113708258,3,0,1,13824,18,1117647430
5945,46919660,67059434,113979094,6,0,1,54272,12,3881718360
5946,46928300,36913909,83842209,2,0,0,3584,1,3931434107
5947,46928910,37076189,84005099,7,0,0,98304,1,10668614068
5948,46935410,37696480,84631890,2,0,0,14336,1,7416289174
5949,46936980,36765378,83702358,1,0,0,9728,1,3279562265
5950,46949010,37321563,84270573,4,0,0,2048,7,3857760927
5951,46949660,36816711,83766371,7,0,0,16896,1,8191859494
5952,46957210,67037275,113994485,1,0,1,23552,1,8076454542
5953,46977770,67141513,114119283,7,0,1,10240,1,3673741545
5954,46982960,67171266,114154226,7,0,1,24576,1,6863025774
5955,46986530,37475343,84461873,4,0,0,81408,7,7228905491
5956,46990610,37560278,84550888,2,0,0,169472,1,1490329687
5957,47002540,37694287,84696827,7,0,0,31232,1,2265737849
5958,47017249,67141483,114158732,3,0,1,7168,18,4015191183
5959,47035450,36765911,83801361,0,0,0,28672,6,1502571159
5960,47040930,36964816,84005746,7,0,0,2048,1,635840175
5961,47050160,67562108,114612268,4,0,1,93696,7,9973744788
5962,47063530,37152565,84216095,3,0,0,26624,18,4116795070
5963,47072340,36861111,83933451,0,0,0,31232,6,731583080
5964,47072520,36902604,83975124,7,0,0,44032,1,10088154247
5965,47073020,36734448,83807468,5,0,0,19968,12,1160718359
5966,47077920,37784013,84861933,8,0,0,112128,11,3839757534
5967,47085570,36978939,84064509,5,0,0,31744,12,10241868604
5968,47086070,36927842,84013912,3,0,0,4096,18,615355307
5969,47087930,67602502,114690432,1,0,1,5632,1,4566561532
5970,47098480,37564579,84663059,2,0,0,36352,1,2130398623
5971,47106010,37829583,84935593,9,0,0,7168,4,3034776249
5972,47119560,36768678,83888238,0,0,0,1024,6,6220351216
5973,47126160,67564295,114690455,6,0,1,1024,12,10377572768
5974,47135890,36778064,83913954,4,0,0,10752,7,10220619659
5975,47140410,37104969,84245379,3,0,0,74752,18,2830328557
5976,47143070,36977116,84120186,4,0,0,50176,7,1962573456
5977,47144850,37848469,84993319,0,0,0,86528,6,5126216197
5978,47156730,37004316,84161046,1,0,0,83456,1,3762790384
5979,47160460,37243464,84403924,3,0,0,84480,18,3141021699
5980,47161050,67529428,114690478,6,0,1,1536,12,7420842735
5981,47177840,37092086,84269926,4,0,0,13824,7,8721775408
5982,47195820,67494681,114690501,2,0,1,2560,1,6428147640
5983,47201060,67567465,114768525,8,0,1,11776,11,1335330737
5984,47208140,67562971,114771111,7,0,1,4096,1,10014230625
5985,47211670,37885838,85097508,4,0,0,62464,7,9261551671
5986,47216080,36953413,84169493,2,0,0,27648,1,2971384290
5987,47228380,37146931,84375311,5,0,0,27136,12,7564184899
5988,47236610,67535269,114771879,1,0,1,11776,1,2678976153
5989,47237320,37065116,84302436,2,0,0,7680,1,8422191912
5990,47256300,37095504,84351804,8,0,0,3584,11,8760949283
5991,47262959,67616666,114879625,3,0,1,1536,18,5614300291
5992,47263950,36952480,84216430,3,0,0,1024,18,8206258856
5993,47269720,67609928,114879648,0,0,1,6144,6,9910596980
5994,47275489,67604182,114879671,3,0,1,512,18,990645917
5995,47277790,37666682,84944472,2,0,0,18944,1,1354465344
5996,47279870,37758618,85038488,2,0,0,70144,1,5707858730
5997,47291970,37124328,84416298,5,0,0,1536,12,4193693435
5998,47297810,37669122,84966932,4,0,0,26112,7,8507590697
5999,47307280,37191949,84499229,2,0,0,24064,1,6880874917
6000,47317350,37507325,84824675,8,0,0,41472,11,2767476142
6001,47356450,37346016,84702466,5,0,0,18432,12,7254193746
6002,47362530,37074493,84437023,5,0,0,55296,12,4729449874
6003,47382240,37349781,84732021,5,0,0,25600,12,5605237006
6004,47393220,37413157,84806377,0,0,0,86528,6,3059031168
6005,47396569,67536512,114933081,5,0,1,20480,12,5802099133
6006,47405000,37065640,84470640,0,0,0,28672,6,3843259628
6007,47412510,37149437,84561947,1,0,0,27136,1,9688082085
6008,47414690,67519262,114933952,6,0,1,12288,12,6320469397
6009,47414730,67598400,115013130,7,0,1,10240,1,2776759373
6010,47415740,37696790,85112530,4,0,0,26624,7,5745767342
6011,47417300,67677409,115094709,0,0,1,3072,6,8056304012
6012,47424730,67670002,115094732,2,0,1,12288,1,4363466344
6013,47433030,37735294,85168324,5,0,0,64000,12,6423574714
6014,47436840,67657915,115094755,2,0,1,512,1,6641159584
6015,47441470,37296502,84737972,0,0,0,19456,6,9324275658
6016,47466180,37425050,84891230,5,0,0,5632,12,2419632977
6017,47475260,37168812,84644072,1,0,0,5120,1,4643138817
6018,47485080,67659007,115144087,1,0,1,28672,1,8592872900
6019,47497710,67704237,115201947,7,0,1,12800,1,4093435676
6020,47502990,67799169,115302159,0,0,1,1024,6,3938727521
6021,47528860,37468226,84997086,3,0,0,12288,18,5178002837
6022,47535259,67767361,115302620,5,0,1,10240,12,804703298
6023,47538430,68270189,115808619,4,0,1,182784,7,8487152868
6024,47554570,37462515,85017085,3,0,0,65536,18,9579393274
6025,47556530,37269572,84826102,2,0,0,4608,1,6107415762
6026,47557340,37304928,84862268,2,0,0,1024,1,10150588627
6027,47575640,37236376,84812016,2,0,0,18432,1,10610864879
6028,47589400,37618259,85207659,4,0,0,29696,7,665020892
6029,47589850,37284249,84874099,6,0,0,5120,12,7552592851
6030,47591480,37512915,85104395,9,0,0,22528,4,9001156046
6031,47599149,68214709,115813858,5,0,1,7168,12,3280737126
6032,47615310,37662821,85278131,3,0,0,8192,18,1796021260
6033,47623700,37573070,85196770,2,0,0,13824,1,5807414764
6034,47635560,37556967,85192527,6,0,0,79360,12,5614776055
6035,47639550,37585237,85224787,8,0,0,10240,11,4922817420
6036,47683030,68246781,115929811,8,0,1,7680,11,6971106521
6037,47728610,38127498,85856108,0,0,0,79872,6,4493539642
6038,47731650,37483676,85215326,1,0,0,25088,1,7198024154
6039,47743290,37388728,85132018,2,0,0,26624,1,3781506475
6040,47766500,37498442,85264942,2,0,0,49152,1,2391234298
6041,47773720,37339457,85113177,3,0,0,2048,18,3126451081
6042,47804290,68184575,115988865,1,0,1,9728,1,10306585223
6043,47804410,68200728,116005138,8,0,1,1536,11,5154167272
6044,47814720,37519948,85334668,1,0,0,39936,1,3081099613
6045,47815160,68215586,116030746,1,0,1,25600,1,1664152087
6046,47816950,37458662,85275612,6,0,0,9216,12,10323761010
6047,47826440,37727726,85554166,1,0,0,90624,1,3557269024
6048,47827510,68247244,116074754,8,0,1,9216,11,4752610502
6049,47851380,37526087,85377467,5,0,0,102912,12,8008480924
6050,47881540,37497666,85379206,5,0,0,5632,12,4677583633
6051,47887310,37670311,85557621,0,0,0,11264,6,7488363010
6052,47896790,37857469,85754259,0,0,0,147968,6,1349038338
6053,47922270,37855752,85778022,5,0,0,77312,12,5890641103
6054,47923380,68353893,116277273,6,0,1,69632,12,9391664297
6055,47939649,68391319,116330968,5,0,1,12288,12,5700013858
6056,47951340,68385758,116337098,2,0,1,11776,1,2622211333
6057,47988380,37590548,85578928,3,0,0,21504,18,1104970273
6058,48001870,37517313,85519183,3,0,0,49664,18,6821251340
6059,48025060,37883915,85908975,6,0,0,12288,12,5490686804
6060,48026270,68311074,116337344,1,0,1,512,1,7961113987
6061,48037670,37552426,85590096,0,0,0,2048,6,7580849914
6062,48042570,37789179,85831749,2,0,0,58368,1,8469549381
6063,48049200,68388151,116437351,8,0,1,12288,11,3458613840
6064,48065460,37821777,85887237,8,0,0,9216,11,5101309862
6065,48084740,68417140,116501880,1,0,1,5632,1,704441472
6066,48090140,37815060,85905200,0,0,0,58880,6,3892164716
6067,48110160,37697493,85807653,1,0,0,96768,1,7569021795
6068,48113550,37770848,85884398,5,0,0,22528,12,6202450110
6069,48116200,37920715,86036915,5,0,0,20992,12,4293244703
6070,48117009,68397709,116514718,5,0,1,2560,12,4029931451
6071,48143550,37733953,85877503,0,0,0,70144,6,5411302876
6072,48144610,37783726,85928336,3,0,0,15872,18,3484920046
6073,48147600,38185967,86333567,5,0,0,27136,12,4214422935
6074,48160010,38015519,86175529,6,0,0,512,12,6948107668
6075,48170780,68343969,116514749,1,0,1,16896,1,1676873752
6076,48181070,68738257,116919327,6,0,1,25600,12,8213943116
6077,48184140,37908347,86092487,0,0,0,24576,6,7529725612
6078,48185659,68772687,116958346,3,0,1,23552,18,3116838673
6079,48191270,38022578,86213848,5,0,0,29696,12,4440951516
6080,48201290,68759740,116961030,8,0,1,10240,11,41663429
6081,48208540,37756987,85965527,0,0,0,13312,6,7471931171
6082,48208970,37829163,86038133,3,0,0,3584,18,6610282162
6083,48228080,37889702,86117782,4,0,0,82944,7,4570678270
6084,48232160,37754404,85986564,6,0,0,512,12,7010153864
6085,48275500,37964914,86240414,3,0,0,78336,18,3960524279
6086,48281840,68681136,116962976,1,0,1,3072,1,3841855495
6087,48295600,37665848,85961448,0,0,0,15872,6,4817897763
6088,48301021,68704788,117005809,9,0,1,3072,4,10178575820
6089,48312029,68694036,117006065,5,0,1,9216,12,1947834015
6090,48318210,37850555,86168765,0,0,0,36864,6,905743762
6091,48321380,37743915,86065295,1,0,0,13312,1,4447833418
6092,48338970,68667351,117006321,8,0,1,9216,11,9303613381
6093,48359660,37856863,86216523,6,0,0,8704,12,10706363425
6094,48388940,38035674,86424614,3,0,0,119808,18,1671650753
6095,48394100,38212017,86606117,1,0,0,51200,1,8347751329
6096,48445620,38170704,86616324,3,0,0,18944,18,9034867263
6097,48458640,68601815,117060455,2,0,1,9216,1,10475549456
6098,48464300,38605402,87069702,0,0,0,102400,6,4530077577
6099,48484029,68594116,117078145,3,0,1,8704,18,10269427396
6100,48506609,68615655,117122264,3,0,1,17408,18,631026352
6101,48511070,37993908,86504978,5,0,0,60928,12,6167783906
6102,48517000,37833594,86350594,6,0,0,55808,12,7001423740
6103,48524570,37595887,86120457,4,0,0,8704,7,10356425791
6104,48539930,68583320,117123250,1,0,1,1536,1,2405504906
6105,48545140,68583256,117128396,4,0,1,8192,7,5903447130
6106,48550470,68659527,117209997,2,0,1,512,1,4323324921
6107,48556230,68831612,117387842,4,0,1,60416,7,4027280028
6108,48557270,38099284,86656554,3,0,0,8704,18,233214014
6109,48575230,37675617,86250847,0,0,0,4608,6,2248629881
6110,48578150,37744340,86322490,2,0,0,32256,1,5950165221
6111,48597060,68811103,117408163,6,0,1,18944,12,9253222636
6112,48603800,37781764,86385564,1,0,0,8704,1,2821913380
6113,48604270,37827699,86431969,3,0,0,24064,18,359709060
6114,48610790,37872821,86483611,1,0,0,55296,1,10224385304
6115,48640300,38121286,86761586,6,0,0,74240,12,9970420650
6116,48643920,37665203,86309123,1,0,0,14336,1,5590843743
6117,48644300,37808955,86453255,9,0,0,19456,4,9029570716
6118,48683960,68750171,117434131,1,0,1,13824,1,2922860575
6119,48702020,38276220,86978240,6,0,0,253952,12,5594823105
6120,48725620,68794781,117520401,1,0,1,9728,1,7690753423
6121,48736740,68785287,117522027,0,0,1,2560,6,1559162285
6122,48745000,37892829,86637829,1,0,0,9728,1,1985834341
6123,48750890,38328663,87079553,6,0,0,32256,12,4052871781
6124,48751120,38387611,87138731,6,0,0,150016,12,31552453
6125,48767089,68828015,117595104,5,0,1,17408,12,4215403173
6126,48771990,37853624,86625614,6,0,0,26112,12,2842257381
6127,48796780,38345094,87141874,4,0,0,10240,7,2325840234
6128,48835980,68800183,117636163,7,0,1,3584,1,2102348988
6129,48838400,69051112,117889512,1,0,1,51200,1,8157167112
6130,48844220,69047620,117891840,7,0,1,17920,1,3324992950
6131,48847690,37928600,86776290,6,0,0,3584,12,10607095511
6132,48878550,38277722,87156272,8,0,0,41472,11,1507483880
6133,48890940,38147539,87038479,2,0,0,197632,1,2925493078
6134,48896770,38272161,87168931,7,0,0,41472,1,1295316726
6135,48902330,38190662,87092992,5,0,0,44032,12,8670681398
6136,48923190,69083212,118006402,1,0,1,37888,1,1362154341
6137,48929480,38423068,87352548,0,0,0,103936,6,5748075180
6138,48948680,38543919,87492599,5,0,0,1536,12,5419344622
6139,48984240,69022185,118006425,4,0,1,1024,7,6380284869
6140,48993900,38149713,87143613,2,0,0,5632,1,9217063049
6141,49001450,38186248,87187698,6,0,0,61440,12,1148392483
6142,49003179,69003269,118006448,3,0,1,1536,18,6877038588
6143,49022141,69024670,118046811,9,0,1,6144,4,2484465957
6144,49034940,38196294,87231234,5,0,0,16896,12,9463705410
6145,49049880,38246567,87296447,2,0,0,23552,1,2791067955
6146,49055940,38561407,87617347,0,0,0,35840,6,3161292233
6147,49067939,68981266,118049205,3,0,1,17408,18,4589650780
6148,49068630,68993600,118062230,1,0,1,1536,1,2005341829
6149,49073780,38411909,87485689,2,0,0,239616,1,7978491157
6150,49077590,68985595,118063185,0,0,1,7680,6,8567758502
6151,49102670,38398241,87500911,5,0,0,6144,12,1576818559
6152,49111300,38380808,87492108,3,0,0,20992,18,1771982864
6153,49137780,68926481,118064261,7,0,1,13312,1,478673312
6154,49141310,68924257,118065567,7,0,1,2048,1,9894114855
6155,49143290,38411426,87554716,2,0,0,19456,1,5632828348
6156,49145370,38489472,87634842,2,0,0,57344,1,7584092535
6157,49160210,38734580,87894790,2,0,0,207360,1,5928121003
6158,49183890,38567950,87751840,3,0,0,87552,18,9188910968
6159,49183930,38499607,87683537,3,0,0,159744,18,7562825258
6160,49188790,38567019,87755809,0,0,0,12800,6,3232720443
6161,49189580,68949629,118139209,8,0,1,6656,11,8263138558
6162,49190250,68948982,118139232,6,0,1,2048,12,6133857052
6163,49198110,38732255,87930365,1,0,0,4608,1,1531084855
6164,49204020,38879973,88083993,0,0,0,56320,6,7857819668
6165,49212610,38706874,87919484,5,0,0,54272,12,5121271245
6166,49252680,38515039,87767719,3,0,0,6656,18,9955892377
6167,49252800,38711099,87963899,5,0,0,47616,12,4542389647
6168,49265830,38637095,87902925,6,0,0,26624,12,2632327175
6169,49288860,38869719,88158579,5,0,0,68096,12,6594543673
6170,49302900,38625272,87928172,6,0,0,28160,12,6299673551
6171,49376980,38623221,88000201,3,0,0,54784,18,10471597112
6172,49411060,38517470,87928530,6,0,0,1024,12,6033681680
6173,49425700,68713555,118139255,2,0,1,1024,1,9989102818
6174,49465840,38805865,88271705,1,0,0,26112,1,3360513401
6175,49472790,69002736,118475526,4,0,1,40960,7,933459458
6176,49475870,38587929,88063799,1,0,0,53248,1,939694831
6177,49488970,38853358,88342328,2,0,0,29184,1,5712142874
6178,49494590,38623451,88118041,1,0,0,18432,1,10301453975
6179,49502210,38757271,88259481,1,0,0,25088,1,1857948950
6180,49509760,39054198,88563958,4,0,0,18944,7,6882991286
6181,49516640,70440554,119957194,4,0,1,401408,7,1329448584
6182,49519940,38726061,88246001,2,0,0,30208,1,4515123690
6183,49521200,38955651,88476851,5,0,0,145920,12,10683004664
6184,49536100,38875568,88411668,2,0,0,61952,1,9551547650
6185,49536260,70841037,120377297,4,0,1,388608,7,9304046133
6186,49539960,70837360,120377320,6,0,1,10752,12,1047292768
6187,49557340,38920314,88477654,2,0,0,2560,1,7832565003
6188,49562330,38950135,88512465,5,0,0,114176,12,6728457294
6189,49564550,38857772,88422322,0,0,0,18432,6,3530118518
6190,49572800,38755627,88328427,0,0,0,13312,6,4384345667
6191,49577659,70908840,120486499,5,0,1,18944,12,6537547499
6192,49581120,39065814,88646934,3,0,0,12288,18,5044687699
6193,49604590,70881932,120486522,2,0,1,4608,1,9625365526
6194,49608070,38734593,88342663,8,0,0,1024,11,113396600
6195,49614039,70872506,120486545,5,0,1,14336,12,8143850876
6196,49617420,70893894,120511314,7,0,1,12800,1,1399450920
6197,49618200,71111296,120729496,4,0,1,154624,7,1269560026
6198,49632720,38760049,88392769,6,0,0,113152,12,4824865878
6199,49643730,38772953,88416683,9,0,0,16384,4,4488042914
6200,49655720,71081934,120737654,1,0,1,28160,1,319566883
6201,49657710,71095902,120753612,0,0,1,13312,6,7661787523
6202,49672780,39124444,88797224,0,0,0,32256,6,2027573661
6203,49687780,71134972,120822752,2,0,1,7680,1,9893957573
6204,49693870,39260270,88954140,3,0,0,3584,18,6059111588
6205,49701290,39315374,89016664,9,0,0,19456,4,7676228729
6206,49703020,39045242,88748262,9,0,0,44544,4,2530866903
6207,49728110,38821097,88549207,3,0,0,9728,18,10213433121
6208,49738380,38778008,88516388,9,0,0,12800,4,2434572140
6209,49741170,38830767,88571937,2,0,0,26112,1,3016939474
6210,49762120,38878973,88641093,2,0,0,8192,1,10643369775
6211,49804510,71018908,120823418,7,0,1,1024,1,1454396033
6212,49806349,71019975,120826324,5,0,1,4608,12,5889296268
6213,49821150,39031060,88852210,9,0,0,25088,4,1279529814
6214,49822640,39011407,88834047,2,0,0,1536,1,5043623551
6215,49823500,38980151,88803651,1,0,0,20992,1,10574888861
6216,49823890,71006940,120830830,8,0,1,7168,11,2743780430
6217,49845020,39520778,89365798,0,0,0,57856,6,4232338755
6218,49857260,38930113,88787373,3,0,0,46080,18,10175385744
6219,49860260,39150453,89010713,3,0,0,17920,18,8204330862
6220,49872060,39080765,88952825,5,0,0,12800,12,10472538602
6221,49879160,38964871,88844031,1,0,0,8704,1,10336619864
6222,49881280,70952136,120833416,6,0,1,4096,12,1864413543
6223,49896350,39246372,89142722,1,0,0,88576,1,10533802509
6224,49896430,39209675,89106105,3,0,0,60928,18,6695815762
6225,49903370,70962825,120866195,0,0,1,15360,6,3380793390
6226,49912269,70972536,120884805,3,0,1,5120,18,5756666036
6227,49912640,39171215,89083855,2,0,0,8704,1,2336908481
6228,49935369,70949459,120884828,5,0,1,4096,12,10175911549
6229,49939300,39088532,89027832,3,0,0,4608,18,1913137915
6230,49964650,70920768,120885418,8,0,1,5632,11,6777278595
6231,49981670,70926407,120908077,8,0,1,5632,11,9409101658
6232,49989530,39511820,89501350,9,0,0,15872,4,3806145679
6233,49997980,39236100,89234080,0,0,0,14848,6,5942729328
6234,50021850,70887989,120909839,8,0,1,22016,11,1100029267
6235,50030190,39285679,89315869,0,0,0,45568,6,5447189645
6236,50034760,39554607,89589367,0,0,0,4608,6,7278752857
6237,50037890,39222395,89260285,5,0,0,62976,12,9640093237
6238,50038900,39833094,89871994,0,0,0,532992,6,5882916852
6239,50041100,39667976,89709076,5,0,0,95232,12,5086650023
6240,50042970,39839364,89882334,5,0,0,16896,12,6453687933
6241,50047120,39591715,89638835,6,0,0,8192,12,9352880653
6242,50053430,39626607,89680037,9,0,0,4608,4,7379569089
6243,50067520,39414247,89481767,5,0,0,4096,12,4619883787
6244,50069570,39536888,89606458,5,0,0,3584,12,7411801697
6245,50081190,39949936,90031126,6,0,0,250880,12,7719629832
6246,50082600,39872063,89954663,6,0,0,15360,12,700340819
6247,50122870,39827090,89949960,2,0,0,49664,1,10405560432
6248,50152070,70757792,120909862,2,0,1,1024,1,9306445565
6249,50154560,39555015,89709575,2,0,0,1536,1,2712405442
6250,50156120,39719033,89875153,3,0,0,10240,18,3336483509
6251,50157450,39736950,89894400,3,0,0,39424,18,8932870141
6252,50170740,39937802,90108542,5,0,0,26112,12,4215183482
6253,50185780,39708823,89894603,1,0,0,512,1,10224925568
6254,50203690,39673358,89877048,1,0,0,6144,1,4996480225
6255,50205770,39831307,90037077,0,0,0,19456,6,6152310167
6256,50217490,39994397,90211887,0,0,0,62976,6,1324109253
6257,50259490,70652290,120911780,1,0,1,12800,1,3485495315
6258,50266200,70670338,120936538,0,0,1,8704,6,1253625310
6259,50289939,70693996,120983935,3,0,1,18432,18,5365644838
6260,50290510,70751191,121041701,8,0,1,7680,11,1823219596
6261,50290680,39764985,90055665,6,0,0,14848,12,7377156040
6262,50321110,39954873,90275983,7,0,0,53248,1,8075528652
6263,50331980,39887886,90219866,2,0,0,26112,1,5480160018
6264,50344090,39956431,90300521,0,0,0,17920,6,9673792653
6265,50366910,70694540,121061450,2,0,1,12288,1,10557392901
6266,50372160,39987988,90360148,5,0,0,36864,12,1225680440
6267,50373360,70733231,121106591,4,0,1,12288,7,4957869866
6268,50387980,40096853,90484833,5,0,0,45568,12,498333383
6269,50388500,70739791,121128291,6,0,1,8704,12,3941480913
6270,50393310,39901728,90295038,2,0,0,62464,1,7743639051
6271,50395900,39945867,90341767,5,0,0,20992,12,1491634929
6272,50410180,39975761,90385941,1,0,0,18944,1,2124823617
6273,50416250,39986790,90403040,9,0,0,12800,4,4798191634
6274,50416500,40004878,90421378,6,0,0,1536,12,3675899034
6275,50439670,40256881,90696551,5,0,0,22528,12,8199846487
6276,50441100,40045004,90486104,6,0,0,4096,12,1929083422
6277,50454971,70732520,121187491,9,0,1,13824,4,9157179194
6278,50459190,39961697,90420887,7,0,0,34304,1,3403437503
6279,50482240,39866653,90348893,3,0,0,17920,18,10518747471
6280,50527470,39846651,90374121,1,0,0,20480,1,2383080015
6281,50528910,70658604,121187514,4,0,1,3584,7,3359156546
6282,50532880,40205264,90738144,5,0,0,43520,12,2791774519
6283,50532950,40014607,90547557,3,0,0,90112,18,8633795188
6284,50538560,40075981,90614541,0,0,0,28160,6,1651568696
6285,50540820,40016931,90557751,3,0,0,5632,18,5215481112
6286,50557490,39912722,90470212,0,0,0,1536,6,4139585784
6287,50570520,40110689,90681209,9,0,0,39936,4,6966972870
6288,50571770,40066639,90638409,9,0,0,40960,4,245241341
6289,50576620,40219719,90796339,1,0,0,19968,1,935517444
6290,50581099,70747482,121328581,5,0,1,30720,12,7359748846
6291,50599500,39956504,90556004,0,0,0,27648,6,102162261
6292,50600330,40235043,90835373,9,0,0,6144,4,3349626930
6293,50604959,70877740,121482699,5,0,1,10240,12,3755708308
6294,50608460,70875545,121484005,7,0,1,2048,1,10675298226
6295,50619870,40078888,90698758,3,0,0,7168,18,2895352018
6296,50622070,40067586,90689656,4,0,0,27648,7,657045384
6297,50639820,70846131,121485951,1,0,1,3072,1,10328632387
6298,50650170,40100504,90750674,2,0,0,24576,1,10633833318
6299,50654820,40238611,90893431,9,0,0,9728,4,9953909403
6300,50658270,40200690,90858960,6,0,0,4608,12,3818023649
6301,50661040,70925050,121586090,1,0,1,25600,1,6248042524
6302,50674210,70934697,121608907,0,0,1,1536,6,1612088560
6303,50712480,40145053,90857533,9,0,0,58368,4,5548115351
6304,50719070,40253226,90972296,1,0,0,44544,1,1506587607
6305,50722380,40313551,91035931,5,0,0,24576,12,5462195478
6306,50730029,70879224,121609253,5,0,1,512,12,1630814281
6307,50735250,71031134,121766384,4,0,1,49664,7,10161775337
6308,50735500,40328264,91063764,1,0,0,6656,1,6564298381
6309,50735990,40189902,90925892,3,0,0,21504,18,10490501566
6310,50740850,40488814,91229664,1,0,0,14848,1,1930485001
6311,50754899,71015991,121770890,5,0,1,7168,12,1608611079
6312,50762610,40791303,91553913,3,0,0,62976,18,3923449353
6313,50783460,40343174,91126634,5,0,0,6656,12,7373456045
6314,50797160,70974076,121771236,4,0,1,512,7,1360765255
6315,50817810,40478750,91296560,0,0,0,8192,6,6808478813
6316,50818630,40299770,91118400,1,0,0,29696,1,5239825535
6317,50827860,40183615,91011475,2,0,0,24064,1,7714242373
6318,50879430,40286822,91166252,2,0,0,19456,1,7078231102
6319,50880820,40187411,91068231,0,0,0,10240,6,4832078677
6320,50883920,40158492,91042412,9,0,0,3584,4,1958366910
6321,50887160,40358141,91245301,9,0,0,13824,4,978927519
6322,50890870,40291689,91182559,2,0,0,5632,1,302567832
6323,50897120,40506870,91403990,6,0,0,10240,12,5231881642
6324,50898169,70933914,121832083,3,0,1,19456,18,6660908986
6325,50901020,40721896,91622916,3,0,0,4608,18,4650537798
6326,50903450,40372950,91276400,2,0,0,32768,1,8176172858
6327,50907880,40812413,91720293,6,0,0,12288,12,7417754670
6328,50910430,70921999,121832429,1,0,1,512,1,10528215191
6329,50910850,40710616,91621466,9,0,0,83456,4,7038330696
6330,50915660,40183522,91099182,5,0,0,6144,12,8887343151
6331,50922910,40780386,91703296,9,0,0,61952,4,6881640495
6332,50924930,41075344,92000274,6,0,0,301056,12,7777725030
6333,50949620,40297793,91247413,3,0,0,5632,18,3969517975
6334,50953310,40432920,91386230,5,0,0,59392,12,2939610127
6335,50966730,40422799,91389529,3,0,0,10752,18,9800181558
6336,50975130,70866411,121841541,6,0,1,7168,12,6868232748
6337,50975650,40343943,91319593,1,0,0,4096,1,9349067556
6338,50990700,70900980,121891680,0,0,1,14848,6,6599612347
6339,50991710,40504903,91496613,2,0,0,14336,1,4408965043
6340,51000770,40432410,91433180,5,0,0,31232,12,2897574180
6341,51002290,70960339,121962629,7,0,1,12800,1,4640283270
6342,51005570,40441173,91446743,5,0,0,19456,12,4343062719
6343,51046921,70916694,121963615,9,0,1,1536,4,3283117205
6344,51075220,70913594,121988814,2,0,1,3072,1,10593991899
6345,51087790,40302386,91390176,3,0,0,2048,18,1112624892
6346,51090840,40970903,92061743,3,0,0,2048,18,9037324633
6347,51098380,40542562,91640942,5,0,0,4608,12,9461779564
6348,51125020,70932937,122057957,0,0,1,23040,6,9348746561
6349,51126900,40637912,91764812,0,0,0,48640,6,6044250035
6350,51133030,70941635,122074665,0,0,1,512,6,8903948081
6351,51135690,40877734,92013424,2,0,0,2048,1,919336256
6352,51173580,40696730,91870310,5,0,0,166912,12,517763878
6353,51175000,40710222,91885222,2,0,0,44032,1,5099737729
6354,51175390,70899621,122075011,8,0,1,512,11,176060479
6355,51196570,40962741,92159311,3,0,0,50176,18,3029264902
6356,51207810,40431705,91639515,6,0,0,18432,12,10004252332
6357,51208010,40310276,91518286,2,0,0,7680,1,10013599546
6358,51215380,70892135,122107515,6,0,1,27648,12,2714738225
6359,51217430,40466133,91683563,9,0,0,12288,4,10060814544
6360,51220070,40439181,91659251,1,0,0,3072,1,1297511931
6361,51233510,70899560,122133070,4,0,1,30208,7,7735197040
6362,51253640,40481577,91735217,5,0,0,14336,12,10242047975
6363,51257730,40802719,92060449,6,0,0,83968,12,2210508051
6364,51267020,70879168,122146188,1,0,1,6656,1,1439532331
6365,51268550,40756753,92025303,0,0,0,38912,6,3975161105
6366,51279320,40781776,92061096,9,0,0,2048,4,238922322
6367,51282349,71056890,122339239,3,0,1,28160,18,7691462263
6368,51301740,40910166,92211906,5,0,0,32256,12,8577787548
6369,51311770,40559990,91871760,2,0,0,4608,1,10253991117
6370,51341660,40671117,92012777,2,0,0,40960,1,10150433220
6371,51350200,40732774,92082974,1,0,0,24576,1,5343531229
6372,51371940,40767656,92139596,1,0,0,55296,1,7348324125
6373,51381150,70958112,122339262,0,0,1,3072,6,3238885020
6374,51387020,40647822,92034842,3,0,0,31232,18,1678203115
6375,51396110,40956439,92352549,9,0,0,25600,4,1519131791
6376,51406570,41140018,92546588,3,0,0,12800,18,5021243049
6377,51410240,40829141,92239381,5,0,0,84992,12,4205840173
6378,51419530,40860420,92279950,2,0,0,15360,1,130992187
6379,51435210,40871479,92306689,1,0,0,37376,1,9640342509
6380,51461390,40996191,92457581,3,0,0,69632,18,265667941
6381,51466890,40967479,92434369,3,0,0,2560,18,2186988170
6382,51471810,70867475,122339285,6,0,1,10752,12,2991717239
6383,51492490,40852236,92344726,3,0,0,64512,18,7846909007
6384,51496610,70842698,122339308,8,0,1,11776,11,7530017670
6385,51500910,40851818,92352728,0,0,0,512,6,4088956839
6386,51501810,41006128,92507938,5,0,0,31232,12,9230981421
6387,51504280,40752108,92256388,6,0,0,2560,12,6013600115
6388,51515010,41067337,92582347,0,0,0,56832,6,7473256687
6389,51518670,40854060,92372730,5,0,0,10240,12,5951771570
6390,51529900,70845432,122375332,1,0,1,21504,1,4512168929
6391,51551910,40759950,92311860,8,0,0,16896,11,10223118077
6392,51568460,40974205,92542665,3,0,0,82432,18,3474137048
6393,51570240,40815401,92385641,3,0,0,24064,18,7400925
6394,51587590,40975968,92563558,0,0,0,19968,6,10219112404
6395,51589991,71017200,122607191,9,0,1,39936,4,1786422709
6396,51606500,40992043,92598543,9,0,0,2560,4,2298667060
6397,51608320,41077392,92685712,6,0,0,21504,12,3570503612
6398,51614280,70993577,122607857,0,0,1,11264,6,10072779773
6399,51615370,41171867,92787237,5,0,0,133632,12,8362284262
6400,51623919,71044391,122668310,3,0,1,16896,18,1769942749
6401,51652880,41004074,92656954,9,0,0,54272,4,3709370645
6402,51653480,41268990,92922470,3,0,0,36352,18,9108853983
6403,51664410,71167219,122831629,1,0,1,1024,1,7257791800
6404,51680350,71151302,122831652,8,0,1,4096,11,9111301531
6405,51680419,71151256,122831675,3,0,1,512,18,9626290130
6406,51680840,40982354,92663194,2,0,0,9216,1,8112057687
6407,51689580,41122585,92812165,5,0,0,14848,12,9315440045
6408,51705030,41124318,92829348,0,0,0,56320,6,1175405069
6409,51716750,41152143,92868893,9,0,0,66560,4,1274871625
6410,51716840,41337480,93054320,0,0,0,74752,6,5708182168
6411,51719510,41281610,93001120,5,0,0,13824,12,6786676119
6412,51743180,41276729,93019909,7,0,0,10240,1,1397933637
6413,51755130,41118505,92873635,6,0,0,12800,12,10348499453
6414,51755500,41093090,92848590,5,0,0,38912,12,3348566910
6415,51763720,71067978,122831698,0,0,1,6144,6,7905449827
6416,51766170,40865470,92631640,0,0,0,2048,6,6737492502
6417,51773780,41170454,92944234,2,0,0,8704,1,6934229075
6418,51775780,41060931,92836711,3,0,0,24064,18,9563557207
6419,51776900,41157562,92934462,2,0,0,25600,1,3056651662
6420,51783860,41518436,93302296,0,0,0,19456,6,8941023573
6421,51821420,71067618,122889038,2,0,1,15872,1,8662943371
6422,51881750,40987954,92869704,5,0,0,2560,12,1548140929
6423,51893870,41388077,93281947,1,0,0,107520,1,5085889261
6424,51903729,70986615,122890344,3,0,1,2048,18,4418134017
6425,51911960,41218299,93130259,3,0,0,130560,18,3168271952
6426,51917440,41140335,93057775,9,0,0,11264,4,5651079391
6427,51918330,41164272,93082602,6,0,0,81408,12,2227801286
6428,51929910,41207548,93137458,5,0,0,23552,12,5024051754
6429,51937340,40963904,92901244,2,0,0,512,1,5495529701
6430,51947770,41141883,93089653,2,0,0,23040,1,7188594588
6431,51959840,70933090,122892930,1,0,1,4096,1,9404440288
6432,51962720,41333625,93296345,3,0,0,16896,18,955146777
6433,51969820,70924416,122894236,6,0,1,2048,12,2450923760
6434,51972290,41224989,93197279,9,0,0,28672,4,9807899131
6435,51996900,70897682,122894582,1,0,1,512,1,5754572856
6436,52009140,41166298,93175438,5,0,0,35328,12,9614078608
6437,52014670,41351011,93365681,3,0,0,2560,18,6598611010
6438,52023190,70903489,122926679,7,0,1,8192,1,5902332751
6439,52031560,41477407,93508967,5,0,0,97792,12,5810904897
6440,52036260,41054196,93090456,1,0,0,2560,1,6189567122
6441,52038080,41307974,93346054,1,0,0,43008,1,9087091507
6442,52044330,41246844,93291174,1,0,0,30208,1,1796502431
6443,52051370,41165462,93216832,5,0,0,8192,12,8626812524
6444,52058380,41420768,93479148,3,0,0,18432,18,9826674087
6445,52061020,70868624,122929644,2,0,1,5120,1,5690963878
6446,52063870,41513719,93577589,9,0,0,39424,4,4540258525
6447,52071690,41700022,93771712,5,0,0,71680,12,9410805658
6448,52076490,41520622,93597112,0,0,0,64000,6,2243585095
6449,52102650,41448376,93551026,0,0,0,44544,6,10249252177
6450,52107620,70823010,122930630,0,0,1,1536,6,8814148360
6451,52129160,70805656,122934816,2,0,1,6656,1,1216531826
6452,52141800,41479296,93621096,3,0,0,29696,18,92192258
6453,52189160,70757274,122946434,1,0,1,22528,1,6409908389
6454,52191401,70770135,122961536,9,0,1,1024,4,6140250878
6455,52192580,41498966,93691546,1,0,0,29696,1,3108584550
6456,52235720,41650931,93886651,2,0,0,54272,1,4318329175
6457,52249600,41147608,93397208,1,0,0,10240,1,4694435300
6458,52267859,70696715,122964574,3,0,1,11776,18,8822376752
6459,52268130,41255524,93523654,2,0,0,5120,1,7229779536
6460,52268990,70745302,123014292,8,0,1,18432,11,2295219380
6461,52273240,41378608,93651848,9,0,0,13824,4,10099886310
6462,52275980,41325806,93601786,6,0,0,12288,12,8373856927
6463,52282440,41400035,93682475,0,0,0,15360,6,4936034590
6464,52304960,41617282,93922242,5,0,0,116736,12,288326923
6465,52314610,41678869,93993479,2,0,0,60416,1,7307187485
6466,52339739,70676819,123016558,3,0,1,3584,18,7307510206
6467,52341290,41518164,93859454,0,0,0,57344,6,5793257679
6468,52346420,41759719,94106139,5,0,0,108032,12,696092916
6469,52354130,41642804,93996934,2,0,0,11264,1,2045741947
6470,52355680,41841514,94197194,5,0,0,79360,12,4473081222
6471,52361740,41561149,93922889,8,0,0,2048,11,1540477467
6472,52367950,41705250,94073200,9,0,0,50176,4,4061616596
6473,52368900,41953428,94322328,9,0,0,7168,4,6843444861
6474,52385380,41670877,94056257,5,0,0,66560,12,937839448
6475,52387260,70696928,123084188,0,0,1,1024,6,8708244742
6476,52407630,41714271,94121901,1,0,0,3584,1,9526416444
6477,52427170,41892951,94320121,2,0,0,45056,1,3493400691
6478,52437280,41994131,94431411,5,0,0,36352,12,5284957497
6479,52438050,41686436,94124486,8,0,0,2048,11,4631081126
6480,52444170,70640041,123084211,6,0,1,7680,12,3678278260
6481,52447700,70636534,123084234,0,0,1,5632,6,1692245478
6482,52456381,70627876,123084257,9,0,1,8704,4,5152637235
6483,52466299,70617981,123084280,3,0,1,7680,18,9786418314
6484,52478590,41683468,94162058,2,0,0,11776,1,8588565267
6485,52478710,41629705,94108415,1,0,0,7168,1,9369577732
6486,52487710,41997564,94485274,8,0,0,26624,11,8952553317
6487,52489350,70788052,123277402,0,0,1,49664,6,5920648928
6488,52507940,42050006,94557946,0,0,0,28672,6,7322572391
6489,52512740,70828584,123341324,1,0,1,34816,1,2097609350
6490,52518390,42207632,94726022,1,0,0,23040,1,3927857280
6491,52532050,42319135,94851185,5,0,0,126976,12,2439476130
6492,52532960,41629433,94162393,0,0,0,1024,6,5231627823
6493,52542620,42004048,94546668,3,0,0,15872,18,4806808249
6494,52556040,41702137,94258177,3,0,0,3072,18,3294520228
6495,52570310,42161507,94731817,6,0,0,18944,12,1376277327
6496,52572429,70768918,123341347,3,0,1,6656,18,2357692556
6497,52578910,42362836,94941746,0,0,0,14336,6,3202719902
6498,52580720,42290221,94870941,3,0,0,16896,18,6800596096
6499,52585320,42510585,95095905,8,0,0,11264,11,5519680901
6500,52600090,42447332,95047422,5,0,0,216576,12,2757683600
6501,52607300,41813012,94420312,2,0,0,55296,1,3148237541
6502,52620850,42131737,94752587,1,0,0,6144,1,5442152858
6503,52644740,70734584,123379324,7,0,1,8704,1,5100968365
6504,52647820,42070265,94718085,9,0,0,44032,4,3514158378
6505,52649190,42114240,94763430,9,0,0,13312,4,7525178577
6506,52650340,42757164,95407504,9,0,0,48640,4,7140299888
6507,52660420,70718927,123379347,1,0,1,2048,1,7440091218
6508,52668210,70760702,123428912,2,0,1,23040,1,2278471912
6509,52671600,42239892,94911492,5,0,0,78336,12,10188012489
6510,52672440,70756495,123428935,8,0,1,14336,11,6432161307
6511,52690150,70827236,123517386,8,0,1,13824,11,6139536575
6512,52696790,42284598,94981388,0,0,0,75776,6,1175308716
6513,52704460,41844727,94549187,8,0,0,8192,11,4266377448
6514,52734000,42043863,94777863,6,0,0,7168,12,2173450975
6515,52740280,70900570,123640850,0,0,1,512,6,4156778885
6516,52756870,41871621,94628491,1,0,0,19968,1,1390568615
6517,52774540,41980518,94755058,3,0,0,3072,18,7409354355
6518,52774870,42317580,95092450,1,0,0,12800,1,8191264524
6519,52788990,42480652,95269642,2,0,0,5632,1,2207992449
6520,52797970,41957579,94755549,6,0,0,1536,12,4473319139
6521,52798130,42131036,94929166,5,0,0,31232,12,7091206100
6522,52818410,42101217,94919627,5,0,0,26624,12,7164757691
6523,52824050,42248066,95072116,9,0,0,31744,4,1923936935
6524,52833220,42229201,95062421,9,0,0,49152,4,6311601394
6525,52834890,42100250,94935140,2,0,0,5632,1,6388323945
6526,52837930,42717711,95555641,5,0,0,101888,12,9569639793
6527,52847350,42026578,94873928,0,0,0,9728,6,1877176911
6528,52865060,42000679,94865739,6,0,0,47616,12,3838493060
6529,52867320,42824287,95691607,2,0,0,68096,1,3771011716
6530,52868649,70774189,123642838,3,0,1,7680,18,3129878119
6531,52879700,70771678,123651378,6,0,1,3072,12,9908170877
6532,52880250,42252939,95133189,1,0,0,2048,1,434569739
6533,52887210,42232490,95119700,5,0,0,43520,12,9593717363
6534,52901870,70750178,123652048,2,0,1,2048,1,8698741398
6535,52909260,42179267,95088527,8,0,0,53760,11,1789096946
6536,52909980,42376647,95286627,4,0,0,7168,7,9972740963
6537,52912390,42317164,95229554,1,0,0,9728,1,230047423
6538,52921730,43072680,95994410,2,0,0,79360,1,6058170387
6539,52931729,70750721,123682450,5,0,1,20992,12,4726241312
6540,52938460,42296109,95234569,3,0,0,16384,18,9315266440
6541,52940080,41997267,94937347,1,0,0,7168,1,7750679455
6542,52945190,41988211,94933401,0,0,0,13824,6,7611504348
6543,52953560,42481758,95435318,3,0,0,82944,18,6105381260
6544,52969890,42786403,95756293,9,0,0,32256,4,9689081198
6545,52998190,42356410,95354600,0,0,0,1024,6,3157081720
6546,53008820,42152312,95161132,0,0,0,9216,6,2547643182
6547,53011740,42435979,95447719,6,0,0,36352,12,9820846928
6548,53017539,70747679,123765218,3,0,1,26112,18,9673620584
6549,53031160,42619976,95651136,1,0,0,35840,1,9731584660
6550,53035860,42248560,95284420,8,0,0,20480,11,9382782722
6551,53040150,42778364,95818514,7,0,0,20480,1,764985741
6552,53047780,43287993,96335773,5,0,0,135680,12,7378730038
6553,53054999,70963545,124018544,3,0,1,47616,18,10217559001
6554,53055270,42094395,95149665,6,0,0,2560,12,4441579110
6555,53059710,42227408,95287118,3,0,0,1536,18,9900011992
6556,53070320,42263803,95334123,0,0,0,4608,6,8564012272
6557,53071100,71038451,124109551,8,0,1,32768,11,934042898
6558,53071250,43341145,96412395,9,0,0,10752,4,6787084458
6559,53073421,71170657,124244078,9,0,1,40448,4,1657866613
6560,53077530,42562663,95640193,6,0,0,117248,12,2958465107
6561,53088940,42290453,95379393,5,0,0,8192,12,9358350186
6562,53094520,43473845,96568365,5,0,0,17408,12,10321073846
6563,53102540,43100710,96203250,8,0,0,228864,11,6932103219
6564,53105240,43567248,96672488,9,0,0,41472,4,10121898574
6565,53116500,71130484,124246984,0,0,1,4608,6,3201828059
6566,53120060,42234205,95354265,5,0,0,21504,12,761178208
6567,53120740,42192738,95313478,2,0,0,18432,1,4738881652
6568,53154820,43061713,96216533,8,0,0,43520,11,8841028467
6569,53155660,71093590,124249250,0,0,1,3584,6,567677346
6570,53158630,43079321,96237951,5,0,0,51712,12,7115610163
6571,53159110,42506245,95665355,0,0,0,22528,6,9925786578
6572,53168870,42096359,95265229,9,0,0,9216,4,6596301655
6573,53186050,71065466,124251516,6,0,1,3584,12,7704912367
6574,53191810,42218213,95410023,8,0,0,8192,11,5268448823
6575,53196210,43974411,97170621,1,0,0,24576,1,4967759711
6576,53206510,43490458,96696968,6,0,0,20992,12,4213595018
6577,53230650,42849715,96080365,1,0,0,114176,1,979477285
6578,53250710,42487529,95738239,6,0,0,33280,12,8365959082
6579,53254260,42445501,95699761,3,0,0,11776,18,6654676275
6580,53278470,42158150,95436620,8,0,0,4096,11,9415715935
6581,53288730,43055357,96344087,5,0,0,3072,12,10387996780
6582,53302480,42482430,95784910,8,0,0,63488,11,3349584127
6583,53309360,70942310,124251670,6,0,1,8704,12,7271116482
6584,53313060,70981636,124294696,7,0,1,6656,1,9423894777
6585,53327710,70984593,124312303,7,0,1,13824,1,5115955894
6586,53349840,42208632,95558472,3,0,0,9216,18,4543606437
6587,53356240,42571533,95927773,6,0,0,11776,12,5762249996
6588,53372990,42417426,95790416,1,0,0,16896,1,2557869878
6589,53383720,42862522,96246242,6,0,0,27136,12,1283500738
6590,53398150,42367370,95765520,1,0,0,30208,1,942512923
6591,53400720,70988130,124388850,7,0,1,15360,1,7797690329
6592,53403530,44209772,97613302,1,0,0,3072,1,8802792851
6593,53412250,43916225,97328475,5,0,0,7168,12,3668156034
6594,53444160,43043801,96487961,6,0,0,52736,12,1436755722
6595,53457900,42571199,96029099,5,0,0,27648,12,183778291
6596,53459840,42397264,95857104,8,0,0,8192,11,6904675829
6597,53491070,70897803,124388873,8,0,1,2048,11,7734713562
6598,53492810,70896086,124388896,0,0,1,1024,6,8712616040
6599,53504380,42300489,95804869,5,0,0,6656,12,3141158085
6600,53518010,42584732,96102742,3,0,0,15872,18,1474148033
6601,53537690,42560193,96097883,3,0,0,57344,18,3180304294
6602,53547680,42237565,95785245,8,0,0,1024,11,5004019502
6603,53563650,70840158,124403808,8,0,1,24576,11,1363087449
6604,53567380,42235438,95802818,0,0,0,29184,6,8713083975
6605,53585490,70818341,124403831,7,0,1,12800,1,10694266142
6606,53605470,42398443,96003913,8,0,0,24576,11,8302728782
6607,53620610,42299951,95920561,2,0,0,13312,1,4615384108
6608,53620880,43111742,96732622,3,0,0,3584,18,4523716513
6609,53630320,42652296,96282616,6,0,0,31232,12,3220807572
6610,53636810,44199245,97836055,2,0,0,110080,1,1578452313
6611,53639079,70786513,124425592,3,0,1,12288,18,4267743966
6612,53670330,43030397,96700727,8,0,0,2048,11,8396180323
6613,53686020,42447475,96133495,0,0,0,5120,6,6538907751
6614,53688210,71014992,124703202,7,0,1,10240,1,7332806391
6615,53703460,42424620,96128080,9,0,0,24576,4,6460388603
6616,53719620,70983605,124703225,7,0,1,1024,1,10077101267
6617,53723130,42547741,96270871,1,0,0,35328,1,5765773936
6618,53731370,42199234,95930604,3,0,0,9216,18,3144687153
6619,53734180,71304183,125038363,7,0,1,13312,1,3491758090
6620,53735810,43973413,97709223,4,0,0,48128,7,3900528185
6621,53737390,71370048,125107438,6,0,1,15872,12,8414772930
6622,53742810,42479362,96222172,4,0,0,18432,7,6832394938
6623,53743620,43659123,97402743,4,0,0,89600,7,7359770716
6624,53746720,42537167,96283887,3,0,0,4096,18,771924646
6625,53748030,42595098,96343128,1,0,0,24064,1,6722836775
6626,53750240,42508239,96258479,0,0,0,39936,6,10007587843
6627,53750540,42593726,96344266,3,0,0,512,18,3309504435
6628,53753870,42714656,96468526,3,0,0,35328,18,2244333493
6629,53765850,43102394,96868244,5,0,0,144896,12,8874356495
6630,53769570,42865206,96634776,0,0,0,105472,6,4297254329
6631,53777230,71330231,125107461,7,0,1,5632,1,4571729873
6632,53777680,42781606,96559286,8,0,0,7168,11,5443640812
6633,53779500,43323005,97102505,4,0,0,38400,7,10486679206
6634,53781990,43401653,97183643,5,0,0,6144,12,6073943208
6635,53784930,43141467,96926397,2,0,0,30720,1,8471430168
6636,53795180,42699824,96495004,5,0,0,23040,12,1367250832
6637,53831020,71338759,125169779,1,0,1,25088,1,31219539
6638,53836260,43232272,97068532,0,0,0,7680,6,4205109209
6639,53839190,42660673,96499863,6,0,0,15872,12,8007299573
6640,53849120,42602442,96451562,0,0,0,18944,6,10446590507
6641,53850640,42510534,96361174,5,0,0,5632,12,4083660486
6642,53857860,42587907,96445767,0,0,0,19456,6,2141785997
6643,53863470,42909964,96773434,9,0,0,26624,4,5126858880
6644,53878800,42773536,96652336,2,0,0,17408,1,3853370289
6645,53879990,71328397,125208387,0,0,1,2560,6,5209904954
6646,53889030,43126093,97015123,3,0,0,52224,18,10096646382
6647,53892800,42683723,96576523,0,0,0,24576,6,9865939115
6648,53896620,42920722,96817342,2,0,0,18432,1,8163579573
6649,53899690,43013073,96912763,8,0,0,6144,11,6650074916
6650,53900350,42745704,96646054,4,0,0,36352,7,2916333929
6651,53906670,43092518,96999188,1,0,0,73728,1,2643089481
6652,53923400,43342155,97265555,5,0,0,113664,12,4411088897
6653,53927030,71403246,125330276,7,0,1,32256,1,2566099314
6654,53932520,71421104,125353624,2,0,1,1536,1,6022383123
6655,53934750,42634262,96569012,0,0,0,2048,6,10118724062
6656,53939140,71477775,125416915,2,0,1,5632,1,5021462340
6657,53954010,42760250,96714260,8,0,0,7168,11,1417805451
6658,53954200,42933122,96887322,3,0,0,62464,18,2705933688
6659,53956560,42930941,96887501,9,0,0,512,4,10056237927
6660,53960780,44003894,97964674,6,0,0,39936,12,3842463284
6661,53964010,43077973,97041983,1,0,0,12288,1,2975348660
6662,53964690,42708913,96673603,1,0,0,3584,1,8266532944
6663,53972140,43153485,97125625,0,0,0,16384,6,9111865353
6664,53981640,42842433,96824073,1,0,0,22016,1,1695806197
6665,53983680,71465214,125448894,6,0,1,12800,12,4209777491
6666,53983830,42651125,96634955,2,0,0,512,1,7648398268
6667,53991830,42811170,96803000,0,0,0,4096,6,10482839094
6668,53992200,44090608,98082808,1,0,0,1536,1,996229505
6669,53998980,71453140,125452120,8,0,1,5120,11,6110008156
6670,54015790,71737414,125753204,6,0,1,48640,12,9135828832
6671,54021220,44178613,98199833,3,0,0,41984,18,6232529049
6672,54027420,42646986,96674406,2,0,0,2560,1,8349158390
6673,54048500,43129944,97178444,0,0,0,25600,6,8462409528
6674,54058180,42852680,96910860,6,0,0,59904,12,9947074760
6675,54060240,42879262,96939502,1,0,0,13824,1,9599146163
6676,54066420,71687454,125753874,2,0,1,17920,1,1979552765
6677,54073390,42843616,96917006,8,0,0,13824,11,7247335434
6678,54079180,43372795,97451975,9,0,0,90112,4,6867518755
6679,54079360,43203231,97282591,0,0,0,12800,6,4030009901
6680,54083370,43378456,97461826,5,0,0,32256,12,5249115626
6681,54088720,42840452,96929172,4,0,0,5632,7,10052948185
6682,54092070,71847348,125939418,6,0,1,26624,12,1275504492
6683,54097840,44007432,98105272,5,0,0,9728,12,2681960082
6684,54102360,42790179,96892539,0,0,0,16384,6,3560804402
6685,54103570,43453740,97557310,6,0,0,7680,12,2972839199
6686,54105690,44154877,98260567,9,0,0,8704,4,9770129786
6687,54106810,43049323,97156133,4,0,0,43008,7,4034663821
6688,54131490,44147593,98279083,2,0,0,6144,1,657352055
6689,54142460,43578954,97721414,2,0,0,39936,1,8817077270
6690,54143300,43451697,97594997,8,0,0,52224,11,6992958640
6691,54150900,72276709,126427609,6,0,1,9728,12,4827278225
6692,54170510,43167533,97338043,5,0,0,24576,12,1061256166
6693,54172231,72255401,126427632,9,0,1,2560,4,3244429210
6694,54190320,44223682,98414002,3,0,0,95744,18,7519413301
6695,54190530,43034653,97225183,5,0,0,20992,12,8814916133
6696,54212010,43670024,97882034,6,0,0,29184,12,2410250956
6697,54229220,43465293,97694513,9,0,0,212480,4,6333154599
6698,54265070,42842450,97107520,2,0,0,16384,1,8439052507
6699,54271680,43698321,97970001,1,0,0,17408,1,8804710641
6700,54277670,42993391,97271061,1,0,0,15872,1,10041547620
6701,54286680,43127942,97414622,3,0,0,38912,18,5963713805
6702,54289150,42977052,97266202,1,0,0,2048,1,4608444247
6703,54305010,43240460,97545470,0,0,0,20992,6,5625326925
6704,54309840,43182841,97492681,4,0,0,48640,7,1926149000
6705,54320870,43481614,97802484,5,0,0,81408,12,3843456132
6706,54327510,43139042,97466552,1,0,0,15360,1,6505403763
6707,54336311,72153977,126490288,9,0,1,14848,4,9177105187
6708,54341020,43509254,97850274,3,0,0,46592,18,8254830507
6709,54343950,42942373,97286323,3,0,0,1024,18,3142172445
6710,54357250,43120588,97477838,2,0,0,36864,1,4084170464
6711,54372500,72177104,126549604,0,0,1,30208,6,9017335344
6712,54372870,72176757,126549627,7,0,1,512,1,4135336071
6713,54376340,43393182,97769522,5,0,0,28160,12,3673504809
6714,54384750,44190453,98575203,1,0,0,46592,1,9345752463
6715,54388390,43770658,98159048,1,0,0,87040,1,4290377067
6716,54390330,72159328,126549658,6,0,1,6144,12,8472801354
6717,54392990,43608257,98001247,3,0,0,32768,18,1737286568
6718,54396800,43112939,97509739,3,0,0,8192,18,5151870005
6719,54400380,43472739,97873119,9,0,0,67072,4,3284148989
6720,54408200,43681005,98089205,6,0,0,8704,12,1289390351
6721,54408740,72145158,126553898,1,0,1,15360,1,1399465926
6722,54414590,43437111,97851701,0,0,0,4608,6,857730024
6723,54431020,42984561,97415581,2,0,0,3072,1,2163763819
6724,54448080,43059132,97507212,9,0,0,47616,4,3657266504
6725,54452270,42972226,97424496,2,0,0,29184,1,4409834700
6726,54486710,42741772,97228482,0,0,0,10752,6,6992374879
6727,54491530,42847940,97339470,0,0,0,4608,6,5903311692
6728,54494950,72146876,126641826,1,0,1,18944,1,10504857780
6729,54505231,72136618,126641849,9,0,1,3584,4,8402594854
6730,54505720,72143171,126648891,6,0,1,14336,12,1010866163
6731,54516370,43486928,98003298,4,0,0,6656,7,949893272
6732,54518730,72207404,126726134,0,0,1,8704,6,3238207889
6733,54530150,43366489,97896639,6,0,0,1024,12,5174503995
6734,54534130,44240566,98774696,1,0,0,159232,1,3627193708
6735,54546620,43072882,97619502,1,0,0,8704,1,4551602996
6736,54574780,43742398,98317178,8,0,0,30208,11,5247355282
6737,54586070,44312431,98898501,5,0,0,50688,12,8736018769
6738,54590320,43878064,98468384,0,0,0,101888,6,5401478428
6739,54600300,43743353,98343653,1,0,0,46592,1,8927018266
6740,54610670,44087530,98698200,2,0,0,30720,1,9566931185
6741,54630830,43254667,97885497,2,0,0,11264,1,1845670438
6742,54631150,43360090,97991240,4,0,0,69632,7,4894348272
6743,54631810,43117566,97749376,2,0,0,25088,1,9987613010
6744,54651919,72409680,127061599,5,0,1,48128,12,2257773289
6745,54658950,43886121,98545071,1,0,0,11776,1,9356724153
6746,54670750,72394171,127064921,2,0,1,5120,1,565469957
6747,54694260,44217992,98912252,8,0,0,45056,11,3343291932
6748,54705690,44305659,99011349,6,0,0,3584,12,10305959569
6749,54720750,43466268,98187018,6,0,0,56832,12,1493746200
6750,54726351,72338593,127064944,9,0,1,4608,4,5211595485
6751,54734260,44053259,98787519,4,0,0,40448,7,9648162131
6752,54737010,43322252,98059262,3,0,0,7680,18,470253731
6753,54766950,43129354,97896304,2,0,0,17920,1,2814170120
6754,54787300,72277667,127064967,6,0,1,7168,12,8583063094
6755,54787400,72277590,127064990,8,0,1,14848,11,5258128797
6756,54791940,43309841,98101781,4,0,0,4608,7,6821525767
6757,54793400,44318960,99112360,9,0,0,44544,4,565404899
6758,54796450,43252137,98048587,5,0,0,50176,12,7944777985
6759,54803290,44206944,99010234,5,0,0,88576,12,220747867
6760,54816690,43404694,98221384,5,0,0,70656,12,7638778677
6761,54819080,43438812,98257892,0,0,0,19456,6,1066005024
6762,54822260,42955397,97777657,9,0,0,26624,4,2905589671
6763,54823560,43029100,97852660,8,0,0,3072,11,7022996960
6764,54824810,43830943,98655753,6,0,0,56320,12,889740208
6765,54836740,43406390,98243130,3,0,0,27648,18,8835470175
6766,54851860,43382807,98234667,8,0,0,43520,11,4633601134
6767,54857849,72207164,127065013,3,0,1,24064,18,4065851842
6768,54861490,44417812,99279302,2,0,0,65536,1,10671985140
6769,54869250,43300429,98169679,6,0,0,34816,12,8463352534
6770,54893880,43527789,98421669,8,0,0,25088,11,2551302995
6771,54894090,43576813,98470903,3,0,0,8192,18,5863064253
6772,54895050,44440054,99335104,5,0,0,2048,12,5374676737
6773,54900640,44177981,99078621,8,0,0,24576,11,2353917581
6774,54902110,72184211,127086321,0,0,1,1536,6,5425185137
6775,54910150,43668196,98578346,9,0,0,10240,4,2701063601
6776,54922180,43696331,98618511,9,0,0,10240,4,10495284132
6777,54942290,72159365,127101655,0,0,1,28160,6,2786201586
6778,54960080,43632294,98592374,3,0,0,43520,18,5653985310
6779,54964011,72137667,127101678,9,0,1,2048,4,604169801
6780,54967350,72161002,127128352,2,0,1,28672,1,7694971056
6781,54976790,43284112,98260902,2,0,0,1024,1,132990770
6782,54983050,43632318,98615368,1,0,0,40448,1,7826096844
6783,54983810,43652522,98636332,5,0,0,23552,12,4230943438
6784,54986630,43285278,98271908,7,0,0,34304,1,1667948211
6785,54989690,43854967,98844657,7,0,0,3584,1,6877433511
6786,54992150,43720128,98712278,8,0,0,16384,11,9769530914
6787,54999290,43980961,98980251,4,0,0,54272,7,2580019044
6788,55002360,44078000,99080360,4,0,0,5632,7,753311416
6789,55004900,72123475,127128375,8,0,1,11264,11,4183303620
6790,55012530,44640919,99653449,3,0,0,55808,18,9091317997
6791,55023690,43460542,98484232,8,0,0,4096,11,4638298455
6792,55025430,43406282,98431712,9,0,0,32256,4,4840948968
6793,55031350,72167912,127199262,2,0,1,4096,1,7183144937
6794,55032130,43450831,98482961,5,0,0,35840,12,2514641185
6795,55036330,72162955,127199285,8,0,1,1536,11,8723571280
6796,55048010,43678147,98726157,4,0,0,25088,7,9758932584
6797,55052980,43331827,98384807,3,0,0,4096,18,9783473149
6798,55055540,43490640,98546180,4,0,0,512,7,8121955117
6799,55072840,72135861,127208701,2,0,1,17408,1,5329337875
6800,55084660,72124297,127208957,6,0,1,9216,12,2537633707
6801,55084890,44597184,99682074,9,0,0,33792,4,10388477434
6802,55092600,44166711,99259311,5,0,0,65536,12,6499073418
6803,55097950,43374068,98472018,5,0,0,3584,12,2331151508
6804,55106260,43731266,98837526,5,0,0,36352,12,9582993892
6805,55115040,43728437,98843477,1,0,0,19456,1,4167851069
6806,55122940,43822095,98945035,7,0,0,107520,1,8773118960
6807,55138750,43684302,98823052,0,0,0,37888,6,899018886
6808,55146840,43388270,98535110,4,0,0,16896,7,9216542021
6809,55198340,72198189,127396529,8,0,1,60416,11,4142738857
6810,55199570,72305780,127505350,2,0,1,31232,1,3468535326
6811,55200390,43459378,98659768,2,0,0,12800,1,8543101916
6812,55204200,44609835,99814035,8,0,0,153600,11,1910100243
6813,55206590,43831339,99037929,1,0,0,12800,1,2205303185
6814,55214190,44788819,100003009,1,0,0,44032,1,10486654420
6815,55214320,43612107,98826427,3,0,0,9728,18,10211911270
6816,55232490,43801516,99034006,4,0,0,15360,7,1173294851
6817,55236870,43714291,98951161,0,0,0,4608,6,3317399400
6818,55237280,43561079,98798359,3,0,0,18432,18,7394627407
6819,55251130,72308295,127559425,6,0,1,2560,12,8336361992
6820,55256920,43554565,98811485,4,0,0,17920,7,10603800544
6821,55264870,43786977,99051847,3,0,0,21504,18,8609945673
6822,55267200,43958757,99225957,1,0,0,48640,1,286913072
6823,55268110,43600876,98868986,2,0,0,9216,1,842141752
6824,55276680,43576721,98853401,6,0,0,14336,12,9973347551
6825,55285960,72279878,127565838,6,0,1,22528,12,804693876
6826,55288480,44935884,100224364,6,0,0,148992,12,4942848771
6827,55289950,44796357,100086307,6,0,0,79360,12,4977646213
6828,55293300,44545665,99838965,6,0,0,64000,12,6715360285
6829,55303900,44389117,99693017,8,0,0,35840,11,760561284
6830,55324890,43985385,99310275,1,0,0,6656,1,1986764319
6831,55369370,43592099,98961469,2,0,0,8192,1,10441945205
6832,55391920,44073293,99465213,7,0,0,1024,1,10314234280
6833,55401040,44904777,100305817,0,0,0,114688,6,9113849901
6834,55402990,44220282,99623272,2,0,0,206336,1,532762209
6835,55421370,72245818,127667188,0,0,1,1536,6,233984378
6836,55425740,43665565,99091305,9,0,0,10752,4,2859525780
6837,55441740,44023138,99464878,5,0,0,18432,12,1983521978
6838,55451910,43953662,99405572,5,0,0,2560,12,4435349598
6839,55459430,43906305,99365735,7,0,0,26624,1,950159831
6840,55463000,72204649,127667649,0,0,1,10240,6,10532062956
6841,55491490,72324746,127816236,8,0,1,33280,11,8401897902
6842,55496400,72323702,127820102,7,0,1,6144,1,8814081066
6843,55497810,44365826,99863636,4,0,0,80896,7,9063894678
6844,55502500,43445054,98947554,6,0,0,8192,12,972778505
6845,55513590,44827471,100341061,7,0,0,9728,1,1752705271
6846,55523090,44502609,100025699,9,0,0,16896,4,5817323417
6847,55523490,43771029,99294519,4,0,0,20480,7,1255946245
6848,55525630,72308806,127834436,6,0,1,3072,12,895626846
6849,55532260,44103359,99635619,9,0,0,40448,4,3290688035
6850,55534840,45134230,100669070,1,0,0,82944,1,2167684557
6851,55536010,44133530,99669540,2,0,0,52736,1,450885950
6852,55537040,44230172,99767212,3,0,0,31232,18,5207466431
6853,55552470,44192215,99744685,3,0,0,41984,18,9266696337
6854,55588360,43811671,99400031,3,0,0,3072,18,4463601132
6855,55590070,43850982,99441052,3,0,0,27136,18,5895495913
6856,55597960,43826566,99424526,2,0,0,30208,1,8552978514
6857,55608350,44913689,100522039,3,0,0,43008,18,10584862193
6858,55618230,43894319,99512549,4,0,0,13312,7,6608141791
6859,55625780,44388640,100014420,0,0,0,37376,6,9007123340
6860,55629240,44385671,100014911,5,0,0,1536,12,9130532051
6861,55640550,72295712,127936262,6,0,1,6656,12,5037629414
6862,55644600,45084704,100729304,0,0,0,47616,6,5505968838
6863,55651200,44216983,99868183,9,0,0,14848,4,3951893944
6864,55652280,44237945,99890225,4,0,0,3072,7,9912456559
6865,55676730,44502215,100178945,2,0,0,130560,1,4980992806
6866,55679680,43790617,99470297,9,0,0,10752,4,2462372577
6867,55681090,43807950,99489040,5,0,0,61440,12,8233438009
6868,55682540,43814947,99497487,6,0,0,27648,12,5074327843
6869,55683640,72318115,128001755,8,0,1,1536,11,9573319284
6870,55693010,43850616,99543626,9,0,0,12800,4,1552619610
6871,55693610,44557343,100250953,1,0,0,10752,1,7569342579
6872,55699440,44327925,100027365,9,0,0,4608,4,6147297260
6873,55704280,45216254,100920534,7,0,0,154112,1,4167502324
6874,55720990,72280788,128001778,1,0,1,1536,1,1904646828
6875,55721740,43914682,99636422,2,0,0,2560,1,2704212040
6876,55726110,45196943,100923053,9,0,0,8192,4,10249380357
6877,55726320,44002494,99728814,9,0,0,22528,4,3761581023
6878,55727760,43943995,99671755,0,0,0,7168,6,158457481
6879,55753030,44360300,100113330,4,0,0,48128,7,5474898303
6880,55755440,44061894,99817334,3,0,0,10752,18,8845082472
6881,55765490,44481361,100246851,7,0,0,73728,1,5260830793
6882,55775980,44212775,99988755,5,0,0,65536,12,10273458860
6883,55777760,44528556,100306316,6,0,0,1536,12,504234153
6884,55779000,45227005,101006005,0,0,0,43008,6,4930716370
6885,55800450,44156588,99957038,1,0,0,37376,1,6229279006
6886,55804299,72198381,128002680,5,0,1,5632,12,3520313356
6887,55819010,44436178,100255188,5,0,0,13824,12,5086801060
6888,55821120,44068146,99889266,8,0,0,69120,11,10458176456
6889,55844680,44045880,99890560,2,0,0,1024,1,3831704297
6890,55846530,44698486,100545016,7,0,0,8192,1,2187119179
6891,55853820,45448393,101302213,6,0,0,93184,12,9287497814
6892,55868350,72336266,128204616,1,0,1,48128,1,4430507915
6893,55874570,44142548,100017118,3,0,0,7168,18,9266287333
6894,55875050,44542981,100418031,8,0,0,28160,11,5234817483
6895,55877390,44441117,100318507,9,0,0,39936,4,3198544048
6896,55881670,44389180,100270850,2,0,0,5120,1,3325306440
6897,55887020,45341669,101228689,5,0,0,86016,12,5136197236
6898,55888240,44078549,99966789,3,0,0,7680,18,139911247
6899,55892380,72374761,128267141,6,0,1,1536,12,9479917415
6900,55909380,44433888,100343268,9,0,0,7168,4,4935609531
6901,55916820,44558763,100475583,1,0,0,50688,1,9739084242
6902,55932330,44748619,100680949,4,0,0,38912,7,6436746319
6903,55935840,72331324,128267164,7,0,1,6144,1,3764170631
6904,55939330,44159313,100098643,5,0,0,24064,12,7605001441
6905,55940330,45627703,101568033,0,0,0,118784,6,4327764539
6906,55942000,45017530,100959530,7,0,0,27648,1,7440724501
6907,55942550,72324637,128267187,2,0,1,10752,1,6545705259
6908,55953470,44315781,100269251,3,0,0,46080,18,6177118760
6909,55956890,72310320,128267210,0,0,1,3072,6,4619660865
6910,55962950,72482705,128445655,4,0,1,7168,7,2143386967
6911,55971370,44794747,100766117,2,0,0,2560,1,8190909655
6912,55978400,72938491,128916891,1,0,1,132096,1,5311723178
6913,55984650,44263004,100247654,6,0,0,2560,12,9500627762
6914,55986670,45689360,101676030,3,0,0,51712,18,7458091016
6915,55987070,45841408,101828478,7,0,0,30720,1,7262946284
6916,55996100,44551747,100547847,0,0,0,9216,6,1993076656
6917,56020890,72944705,128965595,4,0,1,7680,7,6083695827
6918,56037730,44521463,100559193,1,0,0,21504,1,6779985138
6919,56058550,44483947,100542497,1,0,0,22016,1,5257694407
6920,56067520,45017847,101085367,5,0,0,25088,12,245723867
6921,56068480,44630120,100698600,4,0,0,57856,7,7806835300
6922,56084700,45117235,101201935,4,0,0,19968,7,5041796377
6923,56097150,44776405,100873555,1,0,0,24576,1,1537821598
6924,56103140,44608751,100711891,5,0,0,43520,12,1683851725
6925,56107570,44753615,100861185,4,0,0,42496,7,8198701463
6926,56115420,45199007,101314427,8,0,0,20480,11,8603158295
6927,56125120,44665044,100790164,4,0,0,78848,7,7827473953
6928,56126370,44361063,100487433,6,0,0,2048,12,1232644079
6929,56148810,72913914,129062724,8,0,1,7168,11,5732392466
6930,56150520,72912227,129062747,8,0,1,1024,11,9654639885
6931,56150930,45786870,101937800,4,0,0,75264,7,7510486942
6932,56167030,72979662,129146692,0,0,1,19456,6,3390651477
6933,56170400,44316386,100486786,3,0,0,1024,18,501728949
6934,56171050,45011331,101182381,0,0,0,122368,6,9655446439
6935,56177910,44688134,100866044,0,0,0,15872,6,2970901069
6936,56196040,44755043,100951083,9,0,0,57344,4,2559500895
6937,56219610,44602821,100822431,2,0,0,17920,1,10697443589
6938,56236310,45030356,101266666,2,0,0,72704,1,559699260
6939,56243690,45000801,101244491,7,0,0,5632,1,1234188254
6940,56252520,44892531,101145051,7,0,0,38912,1,3831406961
6941,56254880,44547895,100802775,5,0,0,18944,12,4612746527
6942,56265770,44717204,100982974,1,0,0,38400,1,7739209521
6943,56276620,73164470,129441090,4,0,1,6656,7,1835385965
6944,56292820,44829698,101122518,1,0,0,121856,1,5634288461
6945,56294600,73146513,129441113,6,0,1,11264,12,3019327507
6946,56300680,45055193,101355873,4,0,0,8192,7,7202984005
6947,56302420,45167373,101469793,7,0,0,111616,1,247591657
6948,56302641,73234289,129536930,9,0,1,10240,4,9562444693
6949,56339439,73201997,129541436,3,0,1,7168,18,6079338653
6950,56349900,73349159,129699059,8,0,1,3584,11,8407650547
6951,56351720,73347362,129699082,0,0,1,5120,6,69604876
6952,56372000,73347115,129719115,6,0,1,8192,12,3287724318
6953,56387220,44596245,100983465,2,0,0,1536,1,157156549
6954,56391390,45870946,102262336,6,0,0,40960,12,2641987040
6955,56413560,73323817,129737377,8,0,1,19456,11,6137999920
6956,56414330,44718819,101133149,5,0,0,34816,12,5244068392
6957,56419740,44900638,101320378,1,0,0,19456,1,6787800944
6958,56432960,73342347,129775307,0,0,1,1536,6,10342152049
6959,56443290,44799462,101242752,1,0,0,46080,1,4474453475
6960,56449210,44746610,101195820,2,0,0,44032,1,3857830658
6961,56451990,44884947,101336937,0,0,0,54272,6,3500036925
6962,56465140,44541691,101006831,0,0,0,2560,6,5520787781
6963,56465150,46203002,102668152,9,0,0,77824,4,10142667233
6964,56480640,44914432,101395072,5,0,0,512,12,5905433782
6965,56481880,44826284,101308164,7,0,0,19456,1,4166873276
6966,56486470,44875278,101361748,7,0,0,1536,1,6465343420
6967,56486650,44858112,101344762,4,0,0,22528,7,3735312545
6968,56500100,45292231,101792331,7,0,0,35840,1,8889116975
6969,56518940,45105131,101624071,5,0,0,117760,12,1286493773
6970,56521740,44868634,101390374,7,0,0,18944,1,6579582422
6971,56530450,73245203,129775653,4,0,1,512,7,5967887904
6972,56535980,46290567,102826547,3,0,0,66048,18,10069742079
6973,56540680,45091370,101632050,9,0,0,26112,4,8100906284
6974,56541510,45585807,102127317,9,0,0,38400,4,2641405503
6975,56559580,44972238,101531818,7,0,0,56832,1,4406934549
6976,56562880,44921802,101484682,0,0,0,17408,6,5941056942
6977,56562990,73215249,129778239,8,0,1,4096,11,5425566801
6978,56570200,44846773,101416973,1,0,0,4608,1,8553879441
6979,56584080,44892912,101476992,4,0,0,23552,7,629428322
6980,56589800,73188785,129778585,1,0,1,512,1,6023409499
6981,56591370,45295052,101886422,7,0,0,24576,1,5743527396
6982,56601190,45353314,101954504,6,0,0,25088,12,8755987421
6983,56614560,44864795,101479355,7,0,0,7680,1,8450429828
6984,56614990,44958994,101573984,6,0,0,19456,12,7299600062
6985,56623050,73157161,129780211,6,0,1,2560,12,6328152074
6986,56623510,45036741,101660251,3,0,0,80896,18,2068399324
6987,56627160,73154677,129781837,1,0,1,2560,1,9975880183
6988,56629670,45266603,101896273,1,0,0,32256,1,10021788503
6989,56638460,73151546,129790006,1,0,1,2560,1,810035282
6990,56644660,45174435,101819095,4,0,0,32768,7,1491601333
6991,56644750,45468724,102113474,4,0,0,147456,7,6902028841
6992,56664460,45509571,102174031,7,0,0,6656,1,8891383125
6993,56668010,44965467,101633477,9,0,0,4608,4,9449740205
6994,56669130,45341692,102010822,7,0,0,11264,1,8540935799
6995,56674120,46518829,103192949,2,0,0,25088,1,7725717471
6996,56685870,73104159,129790029,2,0,1,2048,1,2799432201
6997,56686680,45117793,101804473,6,0,0,3072,12,2877066113
6998,56688740,73101312,129790052,0,0,1,3584,6,2408173062
6999,56694090,45057513,101751603,8,0,0,63488,11,6125426462
7000,56696420,73126742,129823162,2,0,1,16384,1,7278397447
7001,56711480,45585557,102297037,6,0,0,15360,12,3888446031
7002,56717170,45045771,101762941,3,0,0,20992,18,2137541065
7003,56725580,45634622,102360202,8,0,0,40960,11,9806025048
7004,56733340,45558994,102292334,7,0,0,61440,1,3101536484
7005,56738620,45653419,102392039,5,0,0,31744,12,4744214577
7006,56752470,45363055,102115525,1,0,0,6656,1,2430991916
7007,56756150,45409136,102165286,2,0,0,23552,1,118863945
7008,56775510,45022267,101797777,5,0,0,16384,12,9938219114
7009,56781560,45096792,101878352,9,0,0,41472,4,6698528524
7010,56786829,73057654,129844483,3,0,1,7168,18,1631520073
7011,56792330,45379627,102171957,9,0,0,10752,4,4792045348
7012,56792860,45121983,101914843,1,0,0,8704,1,3779679695
7013,56793510,45269764,102063274,8,0,0,27136,11,2890122336
7014,56794370,45338898,102133268,4,0,0,19456,7,4987355120
7015,56796660,73089921,129886581,4,0,1,18944,7,7091038626
7016,56803870,45559631,102363501,7,0,0,10752,1,579179889
7017,56806040,45156788,101962828,7,0,0,6656,1,962021580
7018,56807990,45465601,102273591,1,0,0,36864,1,4551671729
7019,56810050,45599328,102409378,3,0,0,56832,18,1210847672
7020,56824200,45818792,102642992,0,0,0,24576,6,8743102418
7021,56838150,45910448,102748598,0,0,0,67584,6,3307540171
7022,56849720,46502391,103352111,9,0,0,188416,4,1767457974
7023,56856560,45570331,102426891,9,0,0,9216,4,10269855374
7024,56858590,45919489,102778079,1,0,0,48128,1,680889345
7025,56862920,45744699,102607619,7,0,0,66560,1,6977705229
7026,56863130,45278725,102141855,8,0,0,24064,11,10446565268
7027,56865600,45438503,102304103,4,0,0,23040,7,8491972490
7028,56876440,73010164,129886604,8,0,1,10240,11,5362911337
7029,56877620,45739249,102616869,4,0,0,26624,7,10580282631
7030,56881990,45796325,102678315,9,0,0,33280,4,7044228953
7031,56886240,46152230,103038470,5,0,0,6656,12,9745697235
7032,56890910,46553009,103443919,7,0,0,27648,1,1242035419
7033,56891570,46048096,102939666,8,0,0,59392,11,8782266697
7034,56893740,46027807,102921547,9,0,0,27648,4,9065405222
7035,56899720,45797494,102697214,8,0,0,61952,11,10333108228
7036,56900110,46755677,103655787,6,0,0,55808,12,6481981383
7037,56903600,45808066,102711666,0,0,0,512,6,8663508043
7038,56915920,45601391,102517311,3,0,0,2560,18,4610840097
7039,56924630,45699906,102624536,3,0,0,25088,18,267591870
7040,56926940,45706555,102633495,0,0,0,21504,6,7726171015
7041,56934169,72980339,129914508,3,0,1,2048,18,9289371311
7042,56936730,45822049,102758779,8,0,0,20480,11,5291479052
7043,56937760,45773727,102711487,8,0,0,46592,11,9944657524
7044,56941310,72980926,129922236,4,0,1,24064,7,2169839186
7045,56955910,72970926,129926836,2,0,1,8192,1,1525889966
7046,56956530,45652204,102608734,7,0,0,3584,1,8645098368
7047,56964180,45785065,102749245,0,0,0,2048,6,3169902965
7048,56991590,72989367,129980957,0,0,1,3072,6,9488496695
7049,57000870,45542674,102543544,4,0,0,14848,7,6693185662
7050,57004110,45936093,102940203,5,0,0,1536,12,6379678959
7051,57026560,45388175,102414735,1,0,0,4608,1,4913981882
7052,57027250,46090351,103117601,7,0,0,54272,1,2952281085
7053,57043389,72937591,129980980,3,0,1,5632,18,639914286
7054,57046550,45758430,102804980,3,0,0,47616,18,8215365780
7055,57060240,45456268,102516508,9,0,0,3584,4,1086500358
7056,57072860,72972180,130045040,2,0,1,30208,1,363459762
7057,57082029,72967837,130049866,3,0,1,7680,18,6547941407
7058,57083570,46190949,103274519,7,0,0,72704,1,9298692804
7059,57096440,45816660,102913100,7,0,0,39936,1,4500759198
7060,57097050,46380566,103477616,4,0,0,28160,7,2103156728
7061,57107020,45450853,102557873,8,0,0,7680,11,10537346245
7062,57109600,45516675,102626275,3,0,0,5632,18,10149762428
7063,57115050,45665548,102780598,3,0,0,8192,18,6523910982
7064,57115770,46301731,103417501,4,0,0,55296,7,4775759133
7065,57129331,73025418,130154749,9,0,1,20480,4,7104263811
7066,57130480,45659969,102790449,3,0,0,32256,18,9534498448
7067,57131650,73035976,130167626,6,0,1,512,12,6399955571
7068,57134100,45960678,103094778,8,0,0,21504,11,705488061
7069,57146571,73021078,130167649,9,0,1,13312,4,4345737397
7070,57156990,45883219,103040209,1,0,0,5632,1,8874444253
7071,57171330,45723275,102894605,0,0,0,49152,6,1489754412
7072,57184600,46403851,103588451,5,0,0,110080,12,4808001875
7073,57202850,46024258,103227108,5,0,0,31232,12,5814209712
7074,57214930,46510700,103725630,8,0,0,48640,11,10080872957
7075,57226300,72941372,130167672,8,0,1,7168,11,3916770788
7076,57231970,46203494,103435464,1,0,0,58880,1,6291492561
7077,57232760,45944901,103177661,2,0,0,18944,1,10104653977
7078,57235650,46135620,103371270,8,0,0,13824,11,3697077379
7079,57241450,45591991,102833441,9,0,0,9728,4,1783301215
7080,57249340,46305548,103554888,6,0,0,27136,12,4725081571
7081,57253960,72973429,130227389,7,0,1,14848,1,8443792690
7082,57265590,46603746,103869336,6,0,0,86016,12,10337769394
7083,57267961,73115306,130383267,9,0,1,23552,4,10135822749
7084,57276599,73174250,130450849,3,0,1,18432,18,9432227858
7085,57277910,46402211,103680121,8,0,0,14848,11,8573636556
7086,57312730,45869322,103182052,4,0,0,14336,7,1524283533
7087,57319160,45852706,103171866,5,0,0,20480,12,8975821215
7088,57321640,73292051,130613691,7,0,1,37888,1,730684594
7089,57326260,45820669,103146929,3,0,0,47616,18,7401993477
7090,57328930,46342869,103671799,4,0,0,8192,7,8113009965
7091,57353160,46167009,103520169,3,0,0,7680,18,3736962942
7092,57359020,46187577,103546597,8,0,0,40960,11,9157758884
7093,57368550,46674866,104043416,3,0,0,9216,18,396659677
7094,57376070,46328470,103704540,1,0,0,6144,1,3546914341
7095,57377680,46450376,103828056,0,0,0,101376,6,7707655193
7096,57389640,46602409,103992049,0,0,0,80384,6,3993431169
7097,57397670,46549070,103946740,5,0,0,15360,12,3653710910
7098,57398360,46240392,103638752,0,0,0,81408,6,1195173200
7099,57398780,46060384,103459164,9,0,0,9216,4,144580014
7100,57403510,45830173,103233683,3,0,0,21504,18,1409764930
7101,57420870,45977544,103398414,0,0,0,35840,6,1282955697
7102,57451920,73264983,130716903,0,0,1,9728,6,5515826345
7103,57455950,45676448,103132398,1,0,0,31744,1,2398239051
7104,57460140,45817054,103277194,5,0,0,8704,12,5460152518
7105,57464480,46686912,104151392,3,0,0,5632,18,7210791666
7106,57471130,46660000,104131130,1,0,0,47104,1,9718664944
7107,57474420,46365921,103840341,2,0,0,17408,1,2874112864
7108,57477990,46135935,103613925,9,0,0,73216,4,10510344929
7109,57486770,45867080,103353850,8,0,0,5632,11,7677292440
7110,57487250,46211538,103698788,5,0,0,25088,12,1740773956
7111,57488790,46472013,103960803,7,0,0,46080,1,3646911239
7112,57496350,46544235,104040585,3,0,0,15872,18,691395490
7113,57535720,73185348,130721068,4,0,1,6144,7,10115072754
7114,57538410,73185564,130723974,4,0,1,4608,7,2689549984
7115,57551330,46908882,104460212,8,0,0,61952,11,6235343518
7116,57555191,73237393,130792584,9,0,1,15872,4,3224657372
7117,57556130,46593431,104149561,7,0,0,60416,1,1150161487
7118,57560310,46650414,104210724,7,0,0,3072,1,6687253212
7119,57563880,46626341,104190221,0,0,0,64512,6,8856715041
7120,57566640,46874026,104440666,0,0,0,160256,6,3272290115
7121,57576530,46088663,103665193,0,0,0,24064,6,8553668044
7122,57615020,46677731,104292751,3,0,0,17920,18,8708056056
7123,57615900,73227373,130843273,7,0,1,15360,1,719884113
7124,57616120,45975474,103591594,9,0,0,10240,4,7825675054
7125,57619850,46892745,104512595,7,0,0,17408,1,167806953
7126,57620620,46388242,104008862,4,0,0,50176,7,6515368319
7127,57621360,46047912,103669272,6,0,0,13312,12,7208236916
7128,57638630,46036944,103675574,6,0,0,12288,12,8405381262
7129,57639440,46883216,104522656,2,0,0,18944,1,191673117
7130,57646850,73209403,130856253,6,0,1,10752,12,6749717379
7131,57682190,46285344,103967534,4,0,0,22016,7,1692771982
7132,57689460,46092828,103782288,8,0,0,6656,11,5214454500
7133,57708060,46233977,103942037,4,0,0,99328,7,6199302095
7134,57710590,73210883,130921473,6,0,1,1024,12,2191005086
7135,57711580,45946258,103657838,0,0,0,6656,6,2816867439
7136,57717850,73415139,131132989,6,0,1,37376,12,7981438167
7137,57718250,73431211,131149461,7,0,1,9216,1,1398986823
7138,57728950,46182800,103911750,6,0,0,4608,12,3860195822
7139,57741710,46168613,103910323,1,0,0,40448,1,2428714390
7140,57764970,46015267,103780237,0,0,0,29184,6,1263589839
7141,57773860,46787379,104561239,2,0,0,25600,1,9929981840
7142,57783421,73366063,131149484,9,0,1,3584,4,974662698
7143,57785950,46655363,104441313,1,0,0,2048,1,849505915
7144,57815869,73363870,131179739,3,0,1,17920,18,5542949392
7145,57818880,46663039,104481919,2,0,0,71168,1,5999505386
7146,57823430,47398996,105222426,8,0,0,38912,11,9441638194
7147,57831540,46039847,103871387,3,0,0,6656,18,1643343046
7148,57835110,46841682,104676792,1,0,0,35840,1,7796390547
7149,57836640,73396607,131233247,4,0,1,9216,7,5276073746
7150,57843390,46273365,104116755,9,0,0,37888,4,3398784932
7151,57845300,46319779,104165079,1,0,0,37888,1,9613496568
7152,57847250,46665992,104513242,1,0,0,2048,1,915837208
7153,57850850,73399314,131250164,2,0,1,13312,1,8791405582
7154,57858820,46715808,104574628,2,0,0,19456,1,6805117650
7155,57889540,73468404,131357944,0,0,1,5632,6,8851305572
7156,57896590,46987191,104883781,6,0,0,68096,12,9614860049
7157,57909060,46426985,104336045,6,0,0,61952,12,4604008271
7158,57913510,46097361,104010871,0,0,0,4608,6,1943808596
7159,57923590,46840107,104763697,9,0,0,17920,4,4710101406
7160,57957170,46779040,104736210,6,0,0,12800,12,9227931643
7161,57983670,46710149,104693819,1,0,0,55808,1,6679888904
7162,57990200,47333383,105323583,3,0,0,9728,18,2363703360
7163,58000520,47672413,105672933,1,0,0,33792,1,1084686082
7164,58031240,46476028,104507268,6,0,0,11776,12,7842961567
7165,58031750,46121693,104153443,7,0,0,6656,1,2311201230
7166,58046640,46879685,104926325,4,0,0,25600,7,8842249133
7167,58064790,46452063,104516853,6,0,0,11776,12,8711503212
7168,58072670,46790332,104863002,1,0,0,43008,1,4391367030
7169,58073950,46706086,104780036,6,0,0,5120,12,5056090611
7170,58083170,46420456,104503626,2,0,0,71168,1,1976116225
7171,58087360,46466056,104553416,6,0,0,94208,12,5082824745
7172,58089770,47021768,105111538,0,0,0,30208,6,1753560941
7173,58101570,46564279,104665849,3,0,0,101888,18,10693016906
7174,58120620,46444074,104564694,2,0,0,11264,1,6205334691
7175,58122250,73286641,131408891,1,0,1,14336,1,2514180120
7176,58128950,73298715,131427665,2,0,1,2560,1,3179870659
7177,58139030,46591830,104730860,6,0,0,112128,12,4710133796
7178,58141510,46590777,104732287,7,0,0,4608,1,2722471058
7179,58145780,46682030,104827810,0,0,0,85504,6,9526487271
7180,58147220,47117222,105264442,0,0,0,30720,6,2255731900
7181,58158070,73297068,131455138,8,0,1,7680,11,256529257
7182,58173950,46604480,104778430,2,0,0,48128,1,3645354610
7183,58179050,46775457,104954507,1,0,0,1024,1,7882060498
7184,58195090,73410847,131605937,2,0,1,4608,1,304018753
7185,58198220,73407748,131605968,1,0,1,6656,1,3201218628
7186,58199880,46538248,104738128,0,0,0,6144,6,3761499515
7187,58210450,46486223,104696673,6,0,0,9216,12,3225609861
7188,58217790,47586947,105804737,7,0,0,26112,1,5181155675
7189,58222250,46535964,104758214,9,0,0,29696,4,9770011065
7190,58229970,46615491,104845461,9,0,0,57856,4,9071674885
7191,58236270,46815731,105052001,7,0,0,82944,1,1092900717
7192,58239330,46950298,105189628,0,0,0,3072,6,8088966056
7193,58279329,73682465,131961794,3,0,1,30720,18,3529246660
7194,58281209,73681251,131962460,3,0,1,1024,18,8925682134
7195,58289490,73735774,132025264,4,0,1,25600,7,2339658013
7196,58293310,46678652,104971962,9,0,0,512,4,7239612480
7197,58312120,46685453,104997573,6,0,0,8704,12,3454533215
7198,58315160,46637344,104952504,6,0,0,18432,12,6267190349
7199,58318790,47622396,105941186,1,0,0,75264,1,9779970818
7200,58338860,73724068,132062928,2,0,1,4096,1,6575045270
7201,58350540,46499335,104849875,9,0,0,14336,4,9589086621
7202,58352870,73710081,132062951,7,0,1,3072,1,6847526150
7203,58354220,47775385,106129605,7,0,0,98304,1,4843966795
7204,58363520,46522468,104885988,3,0,0,7168,18,7820568765
7205,58366600,46711127,105077727,2,0,0,28672,1,267295089
7206,58401570,46958349,105359919,1,0,0,19968,1,7070898283
7207,58412190,46721579,105133769,8,0,0,42496,11,7534842204
7208,58413550,73649424,132062974,8,0,1,3072,11,8500617465
7209,58419720,46468475,104888195,4,0,0,7168,7,5555546283
7210,58431061,73631936,132062997,9,0,1,1536,4,5936111843
7211,58443140,46956465,105399605,6,0,0,102400,12,8479484835
7212,58449530,47852301,106301831,0,0,0,52736,6,7326264792
7213,58465720,46704902,105170622,9,0,0,30208,4,6972935456
7214,58466730,73695752,132162482,0,0,1,39424,6,8325899217
7215,58500460,73662045,132162505,4,0,1,10240,7,2101202694
7216,58501010,46772971,105273981,1,0,0,31232,1,9611570801
7217,58515390,46420078,104935468,0,0,0,9216,6,1282278906
7218,58516950,46729713,105246663,8,0,0,15872,11,7651715340
7219,58530010,46535609,105065619,8,0,0,37888,11,6075867997
7220,58548930,48016650,106565580,4,0,0,19968,7,9075751729
7221,58551700,47277583,105829283,2,0,0,30720,1,3812759720
7222,58564240,46645961,105210201,8,0,0,20992,11,1895621263
7223,58564890,47290564,105855454,9,0,0,41984,4,1589276226
7224,58565870,47300005,105865875,6,0,0,14848,12,5893591326
7225,58582150,46994759,105576909,4,0,0,100864,7,8646982867
7226,58588280,46839199,105427479,3,0,0,80384,18,3237857003
7227,58588310,47033941,105622251,3,0,0,1536,18,6387833969
7228,58604090,46649192,105253282,3,0,0,9216,18,2909449150
7229,58625620,46428432,105054052,4,0,0,6656,7,4963023832
7230,58627700,47005927,105633627,6,0,0,3584,12,4072334448
7231,58632090,47534476,106166566,0,0,0,108032,6,10170782536
7232,58634240,48119615,106753855,7,0,0,44032,1,1906640640
7233,58640120,46938528,105578648,6,0,0,5632,12,751092505
7234,58641890,46648970,105290860,5,0,0,36864,12,8897245415
7235,58663660,47156232,105819892,2,0,0,49664,1,3001356912
7236,58664780,46473076,105137856,0,0,0,13312,6,3445665153
7237,58674970,46815380,105490350,2,0,0,35840,1,7337718995
7238,58677990,73494854,132172844,2,0,1,6656,1,6343755059
7239,58697720,47262255,105959975,1,0,0,31232,1,5168208325
7240,58699460,46743977,105443437,6,0,0,34304,12,6427093938
7241,58711620,47276793,105988413,2,0,0,50688,1,2506780479
7242,58712530,46623434,105335964,2,0,0,39424,1,1298165183
7243,58712539,73463531,132176070,3,0,1,5120,18,2735330645
7244,58714040,46780742,105494782,7,0,0,3072,1,2183368377
7245,58716460,46897549,105614009,2,0,0,28672,1,3581619466
7246,58742990,46736137,105479127,3,0,0,15360,18,6609216999
7247,58744160,46688802,105432962,2,0,0,17920,1,7568675438
7248,58754090,46366708,105120798,7,0,0,17920,1,3849424442
7249,58760110,46964627,105724737,3,0,0,42496,18,3951677744
7250,58764009,73412407,132176416,3,0,1,512,18,1219694960
7251,58767300,46957928,105725228,9,0,0,1536,4,71358132
7252,58772300,48095754,106868054,7,0,0,22528,1,5856122163
7253,58775210,46875452,105650662,9,0,0,30720,4,3685720460
7254,58794550,46810700,105605250,0,0,0,22528,6,2213932479
7255,58809420,46899774,105709194,1,0,0,84480,1,2161861918
7256,58810010,46639534,105449544,1,0,0,19968,1,8395771186
7257,58819319,73359683,132179002,3,0,1,4096,18,813031712
7258,58846220,73442228,132288448,8,0,1,19968,11,1980552929
7259,58848330,73447808,132296138,8,0,1,1024,11,2415883312
7260,58864970,47363689,106228659,0,0,0,21504,6,229051289
7261,58884230,46851446,105735676,2,0,0,6144,1,4785203616
7262,58884380,47513131,106397511,8,0,0,27648,11,5393762715
7263,58887750,46795681,105683431,1,0,0,20992,1,5385610597
7264,58892210,47496854,106389064,0,0,0,282624,6,9093715034
7265,58924190,47026223,105950413,3,0,0,30208,18,954572892
7266,58943860,73352301,132296161,4,0,1,15872,7,5349774463
7267,58960150,46819494,105779644,7,0,0,14336,1,1457538213
7268,58960640,46767419,105728059,4,0,0,9216,7,6047760390
7269,58962500,46834258,105796758,7,0,0,33792,1,6396378846
7270,58964270,46712742,105677012,6,0,0,13312,12,3409869760
7271,58964840,46621081,105585921,8,0,0,16896,11,2759355921
7272,59000880,47098750,106099630,2,0,0,49664,1,659757138
7273,59003870,46969076,105972946,9,0,0,42496,4,3185878246
7274,59012550,46855498,105868048,7,0,0,1536,1,3123079523
7275,59039690,47208804,106248494,4,0,0,65024,7,631961667
7276,59071340,47059971,106131311,4,0,0,5120,7,1706836279
7277,59087900,47343977,106431877,3,0,0,76288,18,8311745705
7278,59092070,73280433,132372503,1,0,1,13312,1,5956452828
7279,59107480,47788053,106895533,1,0,0,90112,1,7338318743
7280,59118480,47103604,106222084,1,0,0,5120,1,3584670748
7281,59129120,47279490,106408610,1,0,0,36352,1,6869714723
7282,59129920,47425624,106555544,1,0,0,20992,1,2415980401
7283,59137190,46718755,105855945,3,0,0,1536,18,4966864042
7284,59145880,48042526,107188406,3,0,0,159232,18,5596084439
7285,59153730,46899157,106052887,3,0,0,32768,18,2673032853
7286,59162010,47058491,106220501,6,0,0,55296,12,9522136463
7287,59185960,73213819,132399779,0,0,1,15360,6,3793626602
7288,59191100,73211265,132402365,8,0,1,4096,11,10454312844
7289,59204490,46979665,106184155,1,0,0,37888,1,8359108240
7290,59210710,73224242,132434952,6,0,1,20992,12,7200758301
7291,59227070,47322055,106549125,9,0,0,10240,4,4759274791
7292,59229580,46688651,105918231,2,0,0,75776,1,5360695194
7293,59230410,73209368,132439778,4,0,1,7680,7,8342678644
7294,59243000,73197342,132440342,0,0,1,10752,6,9320157438
7295,59248660,73217289,132465949,7,0,1,11264,1,6705169317
7296,59251100,73935414,133186514,7,0,1,226816,1,1937980202
7297,59260610,73930090,133190700,2,0,1,6656,1,9266012007
7298,59268890,47187287,106456177,1,0,0,21504,1,1378620837
7299,59274820,48138258,107413078,4,0,0,37376,7,9365974624
7300,59277090,47239771,106516861,4,0,0,17408,7,8732983146
7301,59290390,73923089,133213479,6,0,1,512,12,8402303243
7302,59293030,73966390,133259420,8,0,1,1024,11,4950829704
7303,59294570,47367460,106662030,3,0,0,55808,18,807287315
7304,59298420,47278260,106576680,4,0,0,8704,7,1522050919
7305,59340440,47730466,107070906,4,0,0,140288,7,3794924081
7306,59342050,47435354,106777404,8,0,0,53248,11,6039380126
7307,59342999,73959569,133302568,3,0,1,27648,18,5294302400
7308,59371720,47477737,106849457,0,0,0,90624,6,767360925
7309,59374280,73928311,133302591,1,0,1,7680,1,1453424606
7310,59376810,47314945,106691755,1,0,0,37376,1,9526930379
7311,59381570,47347329,106728899,3,0,0,3584,18,2279662523
7312,59384840,47542228,106927068,0,0,0,103424,6,9147814429
7313,59390750,46858414,106249164,7,0,0,2048,1,10326008390
7314,59393730,47537931,106931661,0,0,0,14848,6,8451957842
7315,59397430,47742391,107139821,6,0,0,41984,12,9823490569
7316,59408600,48300655,107709255,2,0,0,155136,1,10089888437
7317,59409800,48050403,107460203,9,0,0,12288,4,1803685114
7318,59411630,74959412,134371042,7,0,1,414208,1,7872220804
7319,59411890,47944634,107356524,9,0,0,33792,4,9636497859
7320,59414480,48435913,107850393,6,0,0,82432,12,3513903753
7321,59416770,74973225,134389995,4,0,1,16896,7,7525635174
7322,59419150,47315159,106734309,1,0,0,7168,1,7505140736
7323,59425020,48031393,107456413,6,0,0,70656,12,1397493474
7324,59427939,74962079,134390018,3,0,1,10240,18,4726190941
7325,59435610,48299953,107735563,6,0,0,11264,12,8413848004
7326,59458620,48185693,107644313,7,0,0,73216,1,5059437261
7327,59496090,48281687,107777777,4,0,0,38400,7,2674898725
7328,59497430,46943699,106441129,6,0,0,15872,12,9019317372
7329,59521430,47803841,107325271,9,0,0,150528,4,1744008935
7330,59535060,47943262,107478322,0,0,0,59392,6,3429173992
7331,59540850,47320317,106861167,0,0,0,29184,6,3506480073
7332,59551170,48070812,107621982,1,0,0,41472,1,4653350814
7333,59552450,47475689,107028139,0,0,0,19456,6,992830510
7334,59557140,47635813,107192953,1,0,0,14848,1,8026077219
7335,59558740,48050583,107609323,3,0,0,178176,18,9004913330
7336,59578570,48147088,107725658,8,0,0,53760,11,2202214900
7337,59586010,47490090,107076100,6,0,0,13312,12,6211852441
7338,59596300,74809707,134406007,4,0,1,3072,7,154413321
7339,59604701,74801329,134406030,9,0,1,8192,4,3809265679
7340,59607850,47757745,107365595,0,0,0,29696,6,4625351549
7341,59614640,74800728,134415368,0,0,1,8192,6,1502779372
7342,59622360,47723203,107345563,3,0,0,55808,18,10500520192
7343,59659380,47353643,107013023,4,0,0,15872,7,9234129886
7344,59674461,74779838,134454299,9,0,1,23040,4,5127456837
7345,59679800,47524252,107204052,8,0,0,36352,11,8294427985
7346,59682210,74804297,134486507,8,0,1,24576,11,6329633099
7347,59690690,48180520,107871210,0,0,0,49664,6,9605698734
7348,59702520,74786253,134488773,2,0,1,3584,1,6776978695
7349,59727120,47344901,107072021,9,0,0,3584,4,5713459722
7350,59730610,48169476,107900086,6,0,0,26624,12,3350230708
7351,59751930,48140021,107891951,1,0,0,50688,1,2864419702
7352,59766670,47962451,107729121,6,0,0,11264,12,10247184036
7353,59770150,48448818,108218968,8,0,0,34816,11,4511173671
7354,59781890,47728443,107510333,8,0,0,79360,11,9342077955
7355,59783720,48577027,108360747,6,0,0,56320,12,2021676776
7356,59784890,47701240,107486130,1,0,0,16896,1,2238858751
7357,59805360,74721672,134527032,6,0,1,13824,12,1613086246
7358,59807290,48290291,108097581,0,0,0,123904,6,7658450761
7359,59815090,48010164,107825254,1,0,0,104960,1,3289489559
7360,59823430,47711159,107534589,6,0,0,45056,12,7993935536
7361,59829110,47707374,107536484,4,0,0,6144,7,1982311311
7362,59833050,47899058,107732108,3,0,0,9728,18,1214948239
7363,59840561,74688737,134529298,9,0,1,3584,4,3638865445
7364,59851280,48116059,107967339,0,0,0,35328,6,2011048349
7365,59852160,48286614,108138774,1,0,0,49152,1,639183085
7366,59854000,47807964,107661964,4,0,0,57856,7,3783604364
7367,59863560,47884974,107748534,2,0,0,42496,1,3606949911
7368,59864010,74668194,134532204,6,0,1,4608,12,5312827297
7369,59866360,48630919,108497279,2,0,0,32768,1,6718365949
7370,59874491,74663975,134538466,9,0,1,4608,4,4019740903
7371,59879410,48502341,108381751,4,0,0,16384,7,3717332059
7372,59883880,74654740,134538620,1,0,1,8704,1,1113418825
7373,59890800,48757601,108648401,1,0,0,184832,1,9710636582
7374,59891750,47874304,107766054,6,0,0,18432,12,5201040835
7375,59893270,47620099,107513369,4,0,0,5120,7,1465118346
7376,59898940,48223808,108122748,9,0,0,2048,4,4045371739
7377,59901040,74661429,134562469,8,0,1,12800,11,7620854750
7378,59906350,48128842,108035192,1,0,0,8704,1,1090067244
7379,59908630,48372909,108281539,8,0,0,107520,11,6656821705
7380,59926250,47924478,107850728,4,0,0,1024,7,8456777634
7381,59938120,48172790,108110910,9,0,0,20992,4,604275509
7382,59944170,48286074,108230244,2,0,0,25600,1,8115341545
7383,59945270,47926431,107871701,3,0,0,1536,18,493422479
7384,59945970,48421352,108367322,6,0,0,21504,12,8351982191
7385,59956600,48501466,108458066,0,0,0,16896,6,2514571342
7386,59957280,48199629,108156909,6,0,0,6144,12,6895796724
7387,59964460,47948416,107912876,3,0,0,14848,18,530473047
7388,59977789,74587378,134565167,3,0,1,20992,18,2179071710
7389,59991310,48006392,107997702,6,0,0,28160,12,1781857131
7390,59993190,48157589,108150779,6,0,0,34816,12,5795359102
7391,60002240,48341278,108343518,1,0,0,98816,1,4727442032
7392,60006020,47850035,107856055,8,0,0,17408,11,1424054663
7393,60006670,48756758,108763428,3,0,0,13312,18,2728255254
7394,60015320,74549870,134565190,2,0,1,4608,1,6149246205
7395,60015490,48192847,108208337,1,0,0,51200,1,1054345100
7396,60024880,49072568,109097448,9,0,0,92160,4,10329056961
7397,60035530,48132756,108168286,1,0,0,25088,1,6152412350
7398,60038010,48763728,108801738,1,0,0,43008,1,1596000719
7399,60041290,47991227,108032517,2,0,0,71680,1,2236169450
7400,60044370,47861199,107905569,4,0,0,17920,7,10538476140
7401,60044580,49186946,109231526,3,0,0,20480,18,10670521131
7402,60059561,74515915,134575476,9,0,1,1024,4,6917283799
7403,60062920,49369936,109432856,4,0,0,29184,7,7466564874
7404,60071990,47968685,108040675,6,0,0,17920,12,9889575004
7405,60087700,48488392,108576092,9,0,0,18944,4,1831474959
7406,60115310,47757818,107873128,1,0,0,4608,1,9305680243
7407,60123821,74453601,134577422,9,0,1,3072,4,3862946506
7408,60141300,47777513,107918813,8,0,0,6656,11,7289001054
7409,60145560,74432528,134578088,6,0,1,1024,12,8746166354
7410,60147040,49429682,109576722,9,0,0,14336,4,7129285921
7411,60150390,49518736,109669126,1,0,0,26112,1,2531615505
7412,60151820,47952671,108104491,6,0,0,14336,12,4881491478
7413,60180590,48389707,108570297,4,0,0,19968,7,5328080165
7414,60195170,49553601,109748771,8,0,0,45568,11,9907793410
7415,60223480,74952790,135176270,7,0,1,396800,1,6890050194
7416,60238370,47916644,108155014,2,0,0,13824,1,7698391915
7417,60248200,48483023,108731223,2,0,0,68096,1,5857802572
7418,60252620,48630062,108882682,3,0,0,18432,18,5797385517
7419,60253540,47846560,108100100,8,0,0,8192,11,7924478056
7420,60260890,48125834,108386724,8,0,0,1024,11,366736300
7421,60267100,49722379,109989479,3,0,0,38400,18,8445586965
7422,60288380,48542230,108830610,6,0,0,22016,12,5107553660
7423,60311800,74864493,135176293,8,0,1,13312,11,4463812308
7424,60313960,49574460,109888420,4,0,0,26624,7,3100839690
7425,60316620,49784106,110100726,9,0,0,512,4,473031230
7426,60332710,48339510,108672220,3,0,0,72192,18,3746888027
7427,60335670,48790692,109126362,4,0,0,80384,7,9871136470
7428,60347059,74853171,135200230,3,0,1,512,18,2575764434
7429,60351110,48021539,108372649,6,0,0,17408,12,4898312649
7430,60359470,48017266,108376736,8,0,0,13312,11,10386622906
7431,60371630,48387719,108759349,4,0,0,12800,7,7098653195
7432,60379910,48375516,108755426,9,0,0,79360,4,7804234719
7433,60381540,48176325,108557865,0,0,0,54784,6,9508766941
7434,60388730,48761922,109150652,6,0,0,29184,12,5809191751
7435,60389230,74829660,135218890,1,0,1,33280,1,3883825747
7436,60408400,48560430,108968830,1,0,0,2048,1,7393994685
7437,60418200,74820909,135239109,1,0,1,6144,1,9515259651
7438,60421270,48496520,108917790,6,0,0,8704,12,4068077973
7439,60423960,48158526,108582486,3,0,0,1024,18,10513549408
7440,60429800,49746543,110176343,9,0,0,74752,4,1320003094
7441,60432780,48959245,109392025,7,0,0,214016,1,5467564146
7442,60441580,48074140,108515720,6,0,0,15872,12,6545724089
7443,60442380,48884414,109326794,1,0,0,57344,1,6086749789
7444,60496060,74743072,135239132,4,0,1,4096,7,5672089426
7445,60496410,48403930,108900340,3,0,0,45568,18,2450527701
7446,60508829,74730326,135239155,3,0,1,3584,18,3640702669
7447,60520421,74718757,135239178,9,0,1,9728,4,3790306173
7448,60553070,48007719,108560789,5,0,0,8192,12,1756536111
7449,60554530,48896021,109450551,0,0,0,29184,6,9172150089
7450,60555910,48957418,109513328,7,0,0,7680,1,2696237202
7451,60564110,48476633,109040743,1,0,0,70144,1,8161044816
7452,60584540,48233624,108818164,8,0,0,19968,11,8946541250
7453,60589500,49120349,109709849,7,0,0,96256,1,2184221805
7454,60592740,48826654,109419394,2,0,0,22528,1,6653931186
7455,60592830,48912447,109505277,4,0,0,31232,7,7084635722
7456,60602960,48312155,108915115,5,0,0,17408,12,7309264370
7457,60612520,48328291,108940811,3,0,0,22016,18,8611380509
7458,60612680,48069870,108682550,2,0,0,12800,1,5105281693
7459,60619510,74633983,135253493,1,0,1,4608,1,1908083862
7460,60624400,49027295,109651695,8,0,0,19968,11,3075474481
7461,60643070,48194500,108837570,1,0,0,4608,1,9788828895
7462,60651060,74604699,135255759,6,0,1,3584,12,7233199718
7463,60664790,48123821,108788611,8,0,0,13312,11,2479509991
7464,60673070,48396267,109069337,0,0,0,68096,6,9604661354
7465,60678990,49637769,110316759,1,0,0,90624,1,294133307
7466,60680160,49054704,109734864,8,0,0,21504,11,8717716263
7467,60685630,47964542,108650172,8,0,0,5632,11,1660094603
7468,60687580,48096952,108784532,9,0,0,24576,4,5728921445
7469,60725830,74550161,135275991,4,0,1,15872,7,8293132067
7470,60726570,48321996,109048566,4,0,0,25600,7,9165194627
7471,60739370,74557817,135297187,1,0,1,22016,1,10287814418
7472,60749510,48062547,108812057,3,0,0,33792,18,861638293
7473,60750600,48351239,109101839,7,0,0,14336,1,3786443675
7474,60758950,49092065,109851015,1,0,0,81408,1,3761274910
7475,60766040,48443053,109209093,4,0,0,143360,7,361767883
7476,60767540,48087725,108855265,0,0,0,3584,6,10446100
7477,60773490,74572951,135346441,4,0,1,29184,7,8673289990
7478,60839340,48385923,109225263,7,0,0,13824,1,3530100392
7479,60873140,48772448,109645588,2,0,0,13312,1,3337843884
7480,60904271,74465194,135369465,9,0,1,27136,4,1602321008
7481,60914940,48334529,109249469,6,0,0,36352,12,6271223768
7482,60920230,48329730,109249960,4,0,0,1536,7,1662140762
7483,60924790,48986327,109911117,9,0,0,13824,4,7546185351
7484,60949880,48944959,109894839,4,0,0,20992,7,8672159513
7485,60962170,48253816,109215986,8,0,0,512,11,5819601786
7486,60972590,48013407,108985997,9,0,0,3584,4,3185883384
7487,60976410,74393823,135370233,6,0,1,11776,12,10537667037
7488,60992700,48218444,109211144,9,0,0,6656,4,8633493823
7489,60996050,48416457,109412507,0,0,0,54272,6,5482370768
7490,61004530,48265408,109269938,4,0,0,41472,7,4846095459
7491,61008080,49529170,110537250,3,0,0,29696,18,961409567
7492,61022810,48252767,109275577,3,0,0,18432,18,8840618107
7493,61029470,48262281,109291751,3,0,0,37888,18,3827885777
7494,61030090,74351652,135381742,7,0,1,38400,1,545504165
7495,61039840,49697735,110737575,4,0,0,53760,7,4712954845
7496,61043030,74370882,135413912,7,0,1,53248,1,6618517889
7497,61043680,49042906,110086586,7,0,0,204800,1,5851603131
7498,61057730,49069674,110127404,7,0,0,25088,1,4874750297
7499,61076800,74481919,135558719,2,0,1,82432,1,484832208
7500,61095859,74551374,135647233,3,0,1,4096,18,2040000159
7501,61106570,74545225,135651795,0,0,1,23040,6,5642483392
7502,61107391,74547879,135655270,9,0,1,9728,4,9857743645
7503,61114070,48281878,109395948,4,0,0,12800,7,9294059931
7504,61121170,74617521,135738691,6,0,1,1536,12,9324049586
7505,61128630,48295311,109423941,1,0,0,14848,1,8814826885
7506,61137310,48573030,109710340,3,0,0,1536,18,8158221646
7507,61137440,48680735,109818175,1,0,0,59392,1,10283801801
7508,61152450,48355346,109507796,4,0,0,8192,7,8314427326
7509,61169980,48402328,109572308,9,0,0,39936,4,5712598631
7510,61171990,48769621,109941611,4,0,0,33280,7,5586236136
7511,61173890,48541465,109715355,1,0,0,16384,1,6196667352
7512,61213271,74525443,135738714,9,0,1,3584,4,4835418697
7513,61219290,49727451,110946741,9,0,0,38400,4,3503381234
7514,61224930,48367183,109592113,6,0,0,28672,12,9808785132
7515,61225400,48681482,109906882,4,0,0,39424,7,3598516401
7516,61233260,49055864,110289124,4,0,0,80384,7,4466499781
7517,61237500,74508592,135746092,4,0,1,4096,7,3055261294
7518,61250160,48681288,109931448,1,0,0,34304,1,10624703057
7519,61250551,74654825,135905376,9,0,1,2048,4,8467558742
7520,61251710,48848837,110100547,6,0,0,31744,12,778741026
7521,61254710,48359354,109614064,0,0,0,5632,6,7097248175
7522,61258110,48422388,109680498,7,0,0,30720,1,1298321487
7523,61259990,49875120,111135110,7,0,0,78848,1,1479290333
7524,61261280,48884380,110145660,7,0,0,39424,1,5468621631
7525,61266060,48841420,110107480,7,0,0,13824,1,3848624877
7526,61288890,48686248,109975138,9,0,0,5120,4,4311073532
7527,61296780,48794072,110090852,1,0,0,5120,1,7864224077
7528,61306550,74598849,135905399,8,0,1,3584,11,10178673421
7529,61309030,49095554,110404584,0,0,0,13824,6,10602036747
7530,61309129,74600224,135909353,3,0,1,7680,18,8315742164
7531,61318530,49144781,110463311,0,0,0,95232,6,10341464148
7532,61325700,48859870,110185570,4,0,0,30208,7,4322138831
7533,61327730,49004675,110332405,9,0,0,34304,4,5167824277
7534,61330290,74579086,135909376,6,0,1,16384,12,1183128109
7535,61339350,49428595,110767945,8,0,0,89600,11,3056864235
7536,61362030,48959900,110321930,4,0,0,16896,7,7689492702
7537,61377120,48449068,109826188,1,0,0,15360,1,2502444930
7538,61420160,74489239,135909399,6,0,1,1024,12,8023540772
7539,61438360,48566515,110004875,4,0,0,13312,7,5866483987
7540,61442460,48646801,110089261,8,0,0,8704,11,2098678198
7541,61454860,48976256,110431116,6,0,0,70656,12,253154971
7542,61455910,49164294,110620204,6,0,0,30720,12,1674144526
7543,61460110,48643135,110103245,4,0,0,8192,7,532769561
7544,61471721,74437701,135909422,9,0,1,2560,4,7766261672
7545,61491640,48741098,110232738,7,0,0,61952,1,10388014677
7546,61501690,48698723,110200413,6,0,0,48640,12,5334470223
7547,61554680,48936780,110491460,0,0,0,50688,6,4120706972
7548,61563010,74346435,135909445,6,0,1,4608,12,5442331167
7549,61566550,74390310,135956860,6,0,1,36352,12,5795307283
7550,61567360,48774280,110341640,0,0,0,30208,6,4645749422
7551,61578210,48968930,110547140,6,0,0,19968,12,3916387388
7552,61583500,49441368,111024868,3,0,0,3584,18,2253649636
7553,61589820,74553253,136143073,2,0,1,24576,1,10048350885
7554,61619430,49253686,110873116,3,0,0,60416,18,10032926356
7555,61623220,49219467,110842687,8,0,0,101888,11,1087698697
7556,61625210,48502685,110127895,9,0,0,1536,4,2516635026
7557,61626870,74527003,136153873,0,0,1,2048,6,5764766563
7558,61638740,74517399,136156139,8,0,1,3584,11,6910825148
7559,61661789,74578555,136240344,3,0,1,8704,18,4717637513
7560,61702230,48801088,110503318,1,0,0,7168,1,4334233531
7561,61715400,48825617,110541017,7,0,0,12288,1,9864756980
7562,61725600,74612058,136337658,2,0,1,17408,1,7316615458
7563,61727530,49521298,111248828,1,0,0,82944,1,7844076834
7564,61736911,74600770,136337681,9,0,1,512,4,8672575354
7565,61744540,74593164,136337704,4,0,1,6144,7,7295323467
7566,61745150,74609595,136354745,6,0,1,2048,12,9901248402
7567,61771460,49762158,111533618,9,0,0,86016,4,4697773033
7568,61782990,49260153,111043143,1,0,0,59904,1,9837788872
7569,61787230,74960268,136747498,7,0,1,166400,1,1265831956
7570,61790750,75073430,136864180,4,0,1,19456,7,899082765
7571,61809300,49578757,111388057,1,0,0,24064,1,5582460971
7572,61828970,48781851,110610821,6,0,0,99328,12,9095754707
7573,61831910,49898304,111730214,5,0,0,147456,12,1196608846
7574,61835540,75028663,136864203,2,0,1,512,1,1169917906
7575,61842950,75032383,136875333,0,0,1,16896,6,10112020937
7576,61848480,48627513,110475993,7,0,0,39424,1,4588651198
7577,61848950,49451135,111300085,1,0,0,11776,1,577581914
7578,61849610,49972794,111822404,4,0,0,7168,7,4232168507
7579,61850330,49739322,111589652,1,0,0,7680,1,1780989512
7580,61853050,48843939,110696989,8,0,0,36352,11,10605090321
7581,61854689,75117030,136971719,3,0,1,11776,18,3240603791
7582,61854820,75116922,136971742,6,0,1,22528,12,5811660290
7583,61864670,75107095,136971765,2,0,1,2048,1,5809937546
7584,61866440,75105348,136971788,1,0,1,3072,1,6187010116
7585,61872930,48591028,110463958,3,0,0,2048,18,3190911195
7586,61877200,75138391,137015591,6,0,1,33280,12,2796500244
7587,61885580,48771145,110656725,0,0,0,16384,6,4588052003
7588,61891930,75124035,137015965,0,0,1,11776,6,3483065040
7589,61902900,49595408,111498308,9,0,0,269824,4,207940285
7590,61909720,48974495,110884215,7,0,0,36352,1,246683715
7591,61926130,49370344,111296474,6,0,0,79360,12,3407588450
7592,61929230,75941959,137871189,7,0,1,414208,1,2940912595
7593,61940420,49991923,111932343,1,0,0,12800,1,6822193469
7594,61940511,76000396,137940907,9,0,1,28160,4,4527761225
7595,61971810,48948666,110920476,0,0,0,1536,6,10292567746
7596,61978860,49236056,111214916,9,0,0,185856,4,9132574673
7597,61986720,75954210,137940930,8,0,1,12800,11,3812499321
7598,61987520,49566401,111553921,1,0,0,66560,1,10423941375
7599,61990630,49390072,111380702,7,0,0,189440,1,8768181318
7600,62004940,75959067,137964007,1,0,1,4096,1,1617793598
7601,62016660,75955408,137972068,6,0,1,2560,12,5879097948
7602,62026770,75992988,138019758,1,0,1,20992,1,4632313845
7603,62042200,75979476,138021676,1,0,1,22528,1,6336063383
7604,62050120,49169499,111219619,3,0,0,15360,18,407785818
7605,62059370,75962329,138021699,7,0,1,3072,1,5023257518
7606,62065420,49079697,111145117,4,0,0,32768,7,6949820051
7607,62066370,50099529,112165899,0,0,0,23040,6,5383414876
7608,62109350,49306677,111416027,0,0,0,12288,6,3730727207
7609,62117000,49437256,111554256,4,0,0,1024,7,2848971174
7610,62166490,49245770,111412260,4,0,0,79360,7,3089762904
7611,62175810,48903872,111079682,4,0,0,27648,7,1706523284
7612,62178390,49383556,111561946,4,0,0,11264,7,6541979538
7613,62179290,49041600,111220890,8,0,0,4096,11,2400098151
7614,62213530,49293857,111507387,1,0,0,29696,1,4133378247
7615,62221310,75800412,138021722,2,0,1,8704,1,7065462887
7616,62226780,49022383,111249163,0,0,0,1024,6,1457888941
7617,62228439,75793306,138021745,5,0,1,1024,12,2018969515
7618,62229660,49981367,112211027,5,0,0,110080,12,7272941678
7619,62231150,49372372,111603522,1,0,0,15360,1,10693837329
7620,62244320,49373556,111617876,6,0,0,11776,12,4273037637
7621,62269010,49318279,111587289,4,0,0,70144,7,7275285405
7622,62269040,49289451,111558491,8,0,0,13824,11,4618691733
7623,62270230,50008843,112279073,4,0,0,4608,7,4610024538
7624,62284910,50130201,112415111,4,0,0,51712,7,9319718422
7625,62301100,49474625,111775725,8,0,0,512,11,553990194
7626,62306200,49467763,111773963,7,0,0,99328,1,246466600
7627,62308260,49595422,111903682,9,0,0,15872,4,9672223895
7628,62312230,49585866,111898096,0,0,0,69120,6,10424926050
7629,62322900,49420753,111743653,7,0,0,44032,1,5351852235
7630,62360390,49769939,112130329,8,0,0,16896,11,2322328617
7631,62366610,49408936,111775546,1,0,0,5120,1,1267964151
7632,62367270,49292119,111659389,1,0,0,8704,1,4384057479
7633,62368539,75653229,138021768,3,0,1,3072,18,2052052423
7634,62378010,49587022,111965032,9,0,0,22528,4,8731232631
7635,62393780,49605320,111999100,3,0,0,15360,18,6405944743
7636,62394180,49512645,111906825,5,0,0,10240,12,7046143245
7637,62396200,50051161,112447361,9,0,0,10240,4,3545545559
7638,62400290,75632444,138032734,6,0,1,6144,12,1895165769
7639,62410200,49497116,111907316,0,0,0,1536,6,976594575
7640,62419660,49816266,112235926,1,0,0,17408,1,842438409
7641,62425300,75607457,138032757,1,0,1,5120,1,9155097933
7642,62427370,49373159,111800529,7,0,0,15872,1,4874387952
7643,62435610,49432534,111868144,8,0,0,3584,11,4017562868
7644,62435720,75597068,138032788,1,0,1,8192,1,2557567737
7645,62476890,49472005,111948895,4,0,0,19456,7,8439103222
7646,62478690,49479432,111958122,4,0,0,30208,7,8438866091
7647,62480320,49624635,112104955,3,0,0,92160,18,5468187379
7648,62484560,49978243,112462803,6,0,0,49664,12,6401008787
7649,62486060,49744045,112230105,9,0,0,17408,4,3074441695
7650,62489440,49568677,112058117,8,0,0,11264,11,7098522628
7651,62513050,75519777,138032827,1,0,1,11776,1,7663074290
7652,62530770,49628063,112158833,6,0,0,62976,12,5502191442
7653,62533270,49844370,112377640,6,0,0,62976,12,5266489601
7654,62535770,49450351,111986121,9,0,0,1536,4,10633143190
7655,62569240,49570359,112139599,6,0,0,23040,12,1866055395
7656,62574360,49971717,112546077,1,0,0,79872,1,4135753453
7657,62576690,49676339,112253029,7,0,0,52736,1,1890152800
7658,62582370,49691027,112273397,8,0,0,6144,11,8214612282
7659,62583200,49811833,112395033,9,0,0,3072,4,3338909681
7660,62585400,49639378,112224778,7,0,0,45056,1,9586810796
7661,62616130,49559949,112176079,0,0,0,28160,6,5808075373
7662,62623650,75419654,138043304,6,0,1,1536,12,10640509163
7663,62637370,49787189,112424559,3,0,0,3072,18,4050389225
7664,62637810,49782682,112420492,8,0,0,1024,11,3206823271
7665,62644790,75399078,138043868,6,0,1,10752,12,9464987455
7666,62651010,50076212,112727222,9,0,0,161792,4,214510315
7667,62652910,50005869,112658779,0,0,0,17408,6,7446774917
7668,62696210,49723916,112420126,7,0,0,16384,1,8206048464
7669,62721730,49571775,112293505,8,0,0,4096,11,4674792025
7670,62725220,75344165,138069385,8,0,1,1536,11,6821051434
7671,62728030,49925422,112653452,7,0,0,16384,1,5749424732
7672,62747210,49873269,112620479,0,0,0,37888,6,3943862073
7673,62762040,75307368,138069408,6,0,1,13312,12,1756058181
7674,62764449,75333837,138098286,3,0,1,512,18,1064791576
7675,62783130,50046510,112829640,0,0,0,25600,6,6820979139
7676,62784990,75323507,138108497,1,0,1,5120,1,6013091252
7677,62796960,75325311,138122271,7,0,1,6144,1,4270300011
7678,62802030,49513286,112315316,8,0,0,4096,11,1684688081
7679,62806450,49626439,112432889,3,0,0,3072,18,5711483722
7680,62809500,75312802,138122302,1,0,1,6144,1,5520355007
7681,62810470,49695214,112505684,1,0,0,19456,1,10054749310
7682,62821230,49686193,112507423,3,0,0,5632,18,2234958223
7683,62839350,49767200,112606550,8,0,0,1536,11,6168922018
7684,62842130,50131099,112973229,1,0,0,59392,1,10097273941
7685,62860160,49695774,112555934,3,0,0,16896,18,409829804
7686,62862080,49698999,112561079,7,0,0,14336,1,9993620795
7687,62873410,49948384,112821794,4,0,0,141824,7,1356486427
7688,62875010,49755366,112630376,4,0,0,6144,7,9505174036
7689,62886380,49739582,112625962,0,0,0,17920,6,6229279759
7690,62894880,49738015,112632895,7,0,0,8192,1,3160731891
7691,62896630,49593069,112489699,9,0,0,10240,4,604116856
7692,62898670,49937857,112836527,9,0,0,22528,4,5359557719
7693,62909560,49576996,112486556,4,0,0,2048,7,2388694955
7694,62916490,49731367,112647857,9,0,0,5632,4,3796372818
7695,62916690,75205635,138122325,8,0,1,20480,11,871835405
7696,62922140,50153374,113075514,4,0,0,16384,7,8319162385
7697,62923080,49957976,112881056,4,0,0,20480,7,6253438788
7698,62945770,49783370,112729140,1,0,0,6144,1,10614461682
7699,62954620,50052584,113007204,6,0,0,15360,12,9461828671
7700,62957490,49670991,112628481,6,0,0,8192,12,524930183
7701,62978680,49863486,112842166,1,0,0,18432,1,9802768487
7702,62992580,49882213,112874793,4,0,0,107008,7,6776935575
7703,63002630,49921473,112924103,4,0,0,28160,7,5586657100
7704,63006170,49995630,113001800,0,0,0,93696,6,3642836875
7705,63006809,75174920,138181729,3,0,1,10752,18,1371802115
7706,63009860,49884913,112894773,7,0,0,15872,1,2744498869
7707,63013130,75175509,138188639,2,0,1,5120,1,129182834
7708,63019820,50604349,113624169,1,0,0,46080,1,5377859118
7709,63020620,50171870,113192490,0,0,0,25088,6,5573592802
7710,63022440,75166222,138188662,7,0,1,512,1,9228413625
7711,63052070,75136615,138188685,2,0,1,2560,1,5183272576
7712,63052260,75144271,138196531,1,0,1,38400,1,5919655540
7713,63055990,75180619,138236609,4,0,1,3584,7,1798177107
7714,63059590,49698770,112758360,4,0,0,33792,7,2280166873
7715,63066300,50118500,113184800,1,0,0,91136,1,2274569305
7716,63067590,50292704,113360294,9,0,0,11776,4,10120768903
7717,63079830,75166726,138246556,7,0,1,25088,1,5820893923
7718,63081970,49696589,112778559,1,0,0,21504,1,189084333
7719,63082430,49858168,112940598,4,0,0,22528,7,9351126279
7720,63082940,49860535,112943475,1,0,0,9216,1,2434769557
7721,63087951,75241115,138329066,9,0,1,14848,4,4286676949
7722,63090770,75238319,138329089,7,0,1,512,1,2924432174
7723,63092580,49816124,112908704,0,0,0,40448,6,3622017499
7724,63097260,50170965,113268225,8,0,0,7680,11,6130894508
7725,63106719,75222393,138329112,3,0,1,8192,18,5343460807
7726,63113140,75405776,138518916,0,0,1,59904,6,5789877171
7727,63115070,50238989,113354059,7,0,0,24064,1,3181889812
7728,63117570,50693655,113811225,3,0,0,57856,18,4463762020
7729,63123670,49931049,113054719,4,0,0,13312,7,1860260208
7730,63135750,49797961,112933711,1,0,0,29184,1,4048677896
7731,63149730,49866615,113016345,7,0,0,2048,1,5249394620
7732,63160140,49842338,113002478,6,0,0,2048,12,4809810079
7733,63167700,50084993,113252693,7,0,0,17920,1,10191482949
7734,63193360,50066075,113259435,7,0,0,20992,1,1721886991
7735,63194260,49909905,113104165,3,0,0,3072,18,990661763
7736,63195360,50452232,113647592,8,0,0,76800,11,1331188239
7737,63210760,49847276,113058036,7,0,0,4608,1,3895164173
7738,63215050,49997223,113212273,1,0,0,30208,1,9915675239
7739,63231850,49925159,113157009,9,0,0,34816,4,10759704
7740,63252840,49981502,113234342,4,0,0,16384,7,5697128306
7741,63264180,50001674,113265854,7,0,0,20992,1,7462263879
7742,63270330,50730418,114000748,1,0,0,20480,1,9274010698
7743,63276060,50504551,113780611,6,0,0,124416,12,9923966481
7744,63281630,50205443,113487073,0,0,0,38400,6,5982403749
7745,63283000,49826665,113109665,6,0,0,8704,12,1853906785
7746,63286540,50018683,113305223,8,0,0,43008,11,2940697252
7747,63288720,49857589,113146309,8,0,0,18432,11,3874788292
7748,63303530,75243258,138546788,7,0,1,20480,1,4033410479
7749,63312680,50352407,113665087,3,0,0,57344,18,2438419358
7750,63313680,50946813,114260493,7,0,0,25600,1,1704233073
7751,63320950,50219789,113540739,3,0,0,15360,18,2740212576
7752,63325840,50118362,113444202,1,0,0,43008,1,1378362257
7753,63328440,49742059,113070499,0,0,0,7680,6,8914629368
7754,63338480,50169459,113507939,0,0,0,20480,6,4626804671
7755,63340250,50679116,114019366,7,0,0,23040,1,288999117
7756,63347810,49876095,113223905,6,0,0,4096,12,7558715073
7757,63369260,49977444,113346704,3,0,0,26112,18,1652192635
7758,63379170,50342706,113721876,7,0,0,6144,1,3401122729
7759,63382600,75264770,138647370,1,0,1,1024,1,808021947
7760,63394080,75257548,138651628,0,0,1,5120,6,7140769710
7761,63406330,50711994,114118324,1,0,0,14848,1,8829546188
7762,63411200,50296232,113707432,1,0,0,84480,1,8354101600
7763,63428110,50484113,113912223,4,0,0,1536,7,979588816
7764,63442560,50569763,114012323,7,0,0,26112,1,568957669
7765,63447840,75222905,138670745,7,0,1,3072,1,6110542288
7766,63450230,50509071,113959301,1,0,0,27648,1,6713105643
7767,63451790,49979285,113431075,0,0,0,27136,6,2245881274
7768,63460150,75222246,138682396,2,0,1,14848,1,5838203035
7769,63461531,75220896,138682427,9,0,1,2048,4,10472064391
7770,63498110,50169496,113667606,6,0,0,8192,12,2184067262
7771,63499550,49829407,113328957,3,0,0,1024,18,3381627402
7772,63517000,49885911,113402911,0,0,0,15360,6,9438922720
7773,63537460,50196955,113734415,4,0,0,20480,7,851017121
7774,63545260,50136409,113681669,4,0,0,46080,7,161480949
7775,63554510,51163805,114718315,0,0,0,30208,6,4727837285
7776,63564561,75173703,138738264,9,0,1,6656,4,5524342212
7777,63570060,50149921,113719981,1,0,0,38400,1,5777303044
7778,63593210,75189088,138782298,4,0,1,14848,7,2901208100
7779,63598700,51001094,114599794,3,0,0,50176,18,10534381924
7780,63608590,49948387,113556977,8,0,0,11264,11,4671769018
7781,63609710,50361158,113970868,6,0,0,37888,12,10007284872
7782,63617940,49935582,113553522,4,0,0,18944,7,978425860
7783,63625810,49728896,113354706,9,0,0,2048,4,1760955219
7784,63627720,75156844,138784564,6,0,1,3584,12,3814044195
7785,63645270,50489877,114135147,9,0,0,29184,4,8029618073
7786,63645920,50896597,114542517,8,0,0,77312,11,7545068177
7787,63648930,49799287,113448217,8,0,0,6656,11,9500783098
7788,63665100,50546362,114211462,3,0,0,52224,18,4260806763
7789,63674590,50633718,114308308,7,0,0,126976,1,2413356950
7790,63678140,50045007,113723147,3,0,0,4096,18,1255896428
7791,63680130,75107660,138787790,0,0,1,5120,6,3616674015
7792,63683030,50864502,114547532,2,0,0,16384,1,7311754597
7793,63696840,50011395,113708235,4,0,0,2560,7,9154117031
7794,63697810,51129458,114827268,3,0,0,34816,18,2049763632
7795,63744810,50697220,114442030,9,0,0,40448,4,3151650690
7796,63750030,50033100,113783130,0,0,0,8192,6,3573824573
7797,63750760,49783708,113534468,8,0,0,2560,11,5623853969
7798,63778940,50004837,113783777,9,0,0,2048,4,9913599223
7799,63783070,49957637,113740707,9,0,0,12288,4,7751098531
7800,63794810,74994926,138789736,8,0,1,3072,11,6168300058
7801,63794920,50770762,114565682,0,0,0,41984,6,3257712576
7802,63803300,50081938,113885238,3,0,0,9216,18,6183697660
7803,63809240,74985642,138794882,4,0,1,8192,7,6356475557
7804,63816970,74979858,138796828,6,0,1,3072,12,4933856605
7805,63826350,51239609,115065959,0,0,0,137728,6,2851131767
7806,63828420,50157751,113986171,3,0,0,20480,18,3174963468
7807,63851320,50569451,114420771,4,0,0,66560,7,2784199277
7808,63852590,74945383,138797973,1,0,1,512,1,2546066105
7809,63861400,50176004,114037404,9,0,0,23552,4,7644429292
7810,63874400,74928962,138803362,1,0,1,17408,1,3593839128
7811,63882330,51306460,115188790,4,0,0,56320,7,9096643678
7812,63906950,74980171,138887121,2,0,1,19456,1,8511669515
7813,63911860,50038994,113950854,9,0,0,48128,4,4234857752
7814,63913160,49876760,113789920,0,0,0,11264,6,10500925247
7815,63922290,50012952,113935242,6,0,0,27136,12,8616075748
7816,63923820,50766589,114690409,7,0,0,14848,1,2514827413
7817,63928750,50142500,114071250,7,0,0,10752,1,925409840
7818,63931690,50777398,114709088,9,0,0,60928,4,8744458827
7819,63937170,74957698,138894868,0,0,1,17920,6,2398093760
7820,63941710,49971628,113913338,3,0,0,3584,18,5489818091
7821,63955790,49955942,113911732,6,0,0,29696,12,5880983444
7822,63975440,50395408,114370848,1,0,0,40960,1,5621082837
7823,63982630,50082812,114065442,9,0,0,16896,4,1447303481
7824,63983770,50191477,114175247,3,0,0,4096,18,6015297412
7825,63995410,50428816,114424226,9,0,0,11264,4,5356176043
7826,64008270,50131580,114139850,8,0,0,15360,11,6713229509
7827,64014480,50627254,114641734,4,0,0,63488,7,3325041048
7828,64019650,50796987,114816637,3,0,0,55296,18,8373518879
7829,64020280,74883625,138903905,2,0,1,14336,1,9175287040
7830,64030780,49963682,113994462,7,0,0,27136,1,4866773307
7831,64032430,74924517,138956947,6,0,1,13312,12,3555468463
7832,64033690,50435660,114469350,8,0,0,5632,11,7624679386
7833,64041080,74915890,138956970,1,0,1,1536,1,4137907648
7834,64049280,50436439,114485719,8,0,0,14336,11,4676345650
7835,64059290,51275240,115334530,7,0,0,3072,1,2033979766
7836,64068370,74888623,138956993,8,0,1,5632,11,7834751495
7837,64077260,49963229,114040489,7,0,0,1024,1,6425814582
7838,64079500,50043699,114123199,9,0,0,9216,4,5623587093
7839,64094630,50637727,114732357,4,0,0,27648,7,1033151346
7840,64098520,50454339,114552859,3,0,0,17408,18,7543154694
7841,64111790,50275907,114387697,6,0,0,16384,12,1816884537
7842,64118230,74869040,138987270,2,0,1,12288,1,10523047723
7843,64122200,50991766,115113966,1,0,0,62976,1,9555974530
7844,64128110,50045866,114173976,0,0,0,13824,6,7052914891
7845,64132450,49969430,114101880,0,0,0,1024,6,9070897161
7846,64134590,50626862,114761452,1,0,0,36864,1,2456679861
7847,64144220,50073017,114217237,4,0,0,8192,7,10645383816
7848,64149449,74997013,139146462,3,0,1,35840,18,1287738698
7849,64162140,51329862,115492002,1,0,0,4608,1,8653755482
7850,64162860,50304751,114467611,4,0,0,67584,7,3295466520
7851,64165330,50495771,114661101,3,0,0,63488,18,8895144292
7852,64175330,50545800,114721130,1,0,0,4608,1,4303338487
7853,64182040,51063112,115245152,0,0,0,116224,6,626882863
7854,64186440,51462287,115648727,3,0,0,27648,18,1868010571
7855,64198420,50159925,114358345,3,0,0,46080,18,6698008315
7856,64207780,50658750,114866530,9,0,0,32768,4,10208737225
7857,64220590,50792517,115013107,6,0,0,83968,12,206191176
7858,64224160,51331176,115555336,1,0,0,2048,1,2280085172
7859,64245170,74906231,139151401,7,0,1,6656,1,9203408793
7860,64249910,50844776,115094686,6,0,0,94208,12,5886833884
7861,64269130,75021177,139290307,6,0,1,27648,12,4178286832
7862,64276590,50643018,114919608,6,0,0,16384,12,2645676530
7863,64304250,51469463,115773713,9,0,0,109056,4,4684945959
7864,64316030,51168727,115484757,2,0,0,218624,1,9132225895
7865,64329420,50356442,114685862,8,0,0,64000,11,1729110807
7866,64341250,50505073,114846323,6,0,0,62464,12,6224670378
7867,64354060,50771325,115125385,4,0,0,37376,7,7739280337
7868,64366109,74924221,139290330,5,0,1,2560,12,7343964273
7869,64373340,50288728,114662068,1,0,0,3072,1,8487982944
7870,64395159,74895194,139290353,3,0,1,22016,18,2892911239
7871,64403800,74886584,139290384,1,0,1,17408,1,7847980948
7872,64433070,50441985,114875055,4,0,0,20992,7,2293730450
7873,64467790,74886500,139354290,2,0,1,17920,1,8998054189
7874,64485231,74951795,139437026,9,0,1,25600,4,2672848947
7875,64488780,74948269,139437049,7,0,1,8192,1,5234103709
7876,64499330,50871082,115370412,6,0,0,49664,12,10244940225
7877,64516210,50974365,115490575,7,0,0,14848,1,1610909313
7878,64540840,50178130,114718970,7,0,0,2048,1,2437046202
7879,64542760,51264227,115806987,1,0,0,74752,1,4914559792
7880,64543640,50368908,114912548,1,0,0,3072,1,10424772613
7881,64547950,50753508,115301458,4,0,0,35840,7,6027631485
7882,64553210,50635759,115188969,4,0,0,512,7,6565441863
7883,64558600,50731915,115290515,5,0,0,44032,12,5468496218
7884,64564690,50314912,114879602,3,0,0,14848,18,4497261088
7885,64568220,74868852,139437072,0,0,1,9728,6,6978083345
7886,64576490,50186389,114762879,0,0,0,4608,6,2914451309
7887,64583670,50971019,115554689,9,0,0,63488,4,5826587890
7888,64587390,50898638,115486028,8,0,0,4096,11,8095137527
7889,64591410,50909975,115501385,4,0,0,30720,7,1559061641
7890,64610500,74826595,139437095,7,0,1,3584,1,8039941958
7891,64617010,51222171,115839181,4,0,0,70144,7,3594635210
7892,64617050,74820068,139437118,0,0,1,3584,6,6524137657
7893,64625490,51074653,115700143,2,0,0,103936,1,560840348
7894,64633090,50324450,114957540,9,0,0,38912,4,3932938501
7895,64638740,51335169,115973909,6,0,0,36352,12,9712524344
7896,64645040,74792101,139437141,0,0,1,3072,6,8360196864
7897,64660900,50900855,115561755,9,0,0,20992,4,7738508231
7898,64670400,51227975,115898375,0,0,0,105984,6,5425964557
7899,64672280,51061782,115734062,4,0,0,26624,7,4104423756
7900,64675420,51108768,115784188,9,0,0,34304,4,3561125252
7901,64678320,50698378,115376698,9,0,0,12288,4,5167027629
7902,64684920,51303922,115988842,7,0,0,4608,1,516972978
7903,64686420,74755447,139441867,8,0,1,4096,11,8149386927
7904,64695890,50839424,115535314,8,0,0,64000,11,5083619098
7905,64715120,50299593,115014713,4,0,0,5120,7,10516002579
7906,64717321,74748300,139465621,9,0,1,5120,4,10457141218
7907,64730210,51395414,116125624,7,0,0,144896,1,12408096
7908,64745240,50649196,115394436,6,0,0,19456,12,5750768491
7909,64764030,50891116,115655146,8,0,0,20992,11,10197240371
7910,64777610,51185200,115962810,4,0,0,1536,7,6819449296
7911,64814320,51051740,115866060,8,0,0,11776,11,5014274363
7912,64829560,74637511,139467071,4,0,1,14848,7,7871009587
7913,64841300,50674483,115515783,1,0,0,12288,1,2272531039
7914,64850130,50404094,115254224,2,0,0,20992,1,3198817495
7915,64855560,50656456,115512016,3,0,0,34816,18,1710903206
7916,64856180,51358250,116214430,1,0,0,11776,1,6576298166
7917,64856900,51104730,115961630,2,0,0,95744,1,10409800788
7918,64857520,50449700,115307220,2,0,0,3584,1,4712893941
7919,64862990,74695546,139558536,4,0,1,17920,7,1228978319
7920,64871430,50476972,115348402,7,0,0,13312,1,7577462858
7921,64873280,50372363,115245643,8,0,0,1536,11,8743445557
7922,64874830,50498101,115372931,4,0,0,8192,7,5374854700
7923,64881740,51097344,115979084,6,0,0,10752,12,3467466802
7924,64892610,74723499,139616109,0,0,1,11776,6,8975989933
7925,64892680,74723452,139616132,6,0,1,7168,12,3517740228
7926,64896660,50842885,115739545,9,0,0,17920,4,960773329
7927,64898190,51233853,116132043,3,0,0,20992,18,8513314497
7928,64913550,50789268,115702818,7,0,0,8704,1,2879764589
7929,64918030,51365114,116283144,8,0,0,6656,11,6407625588
7930,64933300,74682855,139616155,1,0,1,5120,1,2404113373
7931,64936870,51301139,116238009,6,0,0,77312,12,7554324314
7932,64951330,50634639,115585969,8,0,0,68096,11,6198096582
7933,64951620,50971472,115923092,0,0,0,9216,6,4941707504
7934,64962469,74653709,139616178,3,0,1,2560,18,9777364560
7935,64968200,50698274,115666474,2,0,0,15360,1,2432703352
7936,64975450,74786188,139761638,8,0,1,26112,11,2270958723
7937,64986200,51146646,116132846,8,0,0,2560,11,10556614746
7938,64995310,51440694,116436004,2,0,0,29184,1,633651579
7939,65006910,74824113,139831023,2,0,1,19456,1,9430995816
7940,65012950,50849499,115862449,4,0,0,20480,7,2157225446
7941,65037040,51227129,116264169,2,0,0,46080,1,5383012624
7942,65038270,50571590,115609860,6,0,0,8192,12,831090460
7943,65050620,50611151,115661771,1,0,0,13312,1,3952334140
7944,65059250,74874509,139933759,4,0,1,5120,7,8714918975
7945,65070420,51316758,116387178,9,0,0,140288,4,6498504546
7946,65079020,74866365,139945385,0,0,1,12288,6,4455434257
7947,65083080,50954860,116037940,3,0,0,18432,18,3479952778
7948,65087220,50499708,115586928,8,0,0,3072,11,5508212734
7949,65112970,50555209,115668179,9,0,0,4096,4,6244625723
7950,65115670,74980372,140096042,4,0,1,5632,7,1909383252
7951,65126660,51555992,116682652,1,0,0,12288,1,1351446649
7952,65143030,51434287,116577317,2,0,0,48640,1,745457857
7953,65149020,74981587,140130607,8,0,1,17408,11,7513882149
7954,65150990,51015172,116166162,4,0,0,44032,7,7237221344
7955,65156360,75048183,140204543,4,0,1,22016,7,1134043155
7956,65158780,51553402,116712182,9,0,0,94208,4,2685736611
7957,65171120,51078978,116250098,8,0,0,1024,11,4832096475
7958,65185600,50734661,115920261,2,0,0,13824,1,868988861
7959,65190040,51589999,116780039,9,0,0,4096,4,7725035708
7960,65194030,51233059,116427089,3,0,0,61952,18,2635305354
7961,65207410,50708616,115916026,4,0,0,57856,7,366972492
7962,65214340,75030185,140244525,2,0,1,19456,1,6608325951
7963,65217810,75209742,140427552,7,0,1,24064,1,4399548944
7964,65226540,52020171,117246711,7,0,0,59392,1,8858980735
7965,65229600,75201178,140430778,2,0,1,5120,1,280460292
7966,65234740,51505959,116740699,8,0,0,19456,11,10536950124
7967,65237640,51972334,117209974,8,0,0,137728,11,6981135990
7968,65251070,51145268,116396338,0,0,0,6656,6,7872538527
7969,65252890,50885751,116138641,8,0,0,18944,11,468264208
7970,65259740,75191425,140451165,8,0,1,24576,11,8185792548
7971,65259870,51346901,116606771,8,0,0,10752,11,10005526044
7972,65281830,51049115,116330945,4,0,0,41472,7,4594478851
7973,65286200,50642843,115929043,4,0,0,19456,7,9530499591
7974,65305790,52032351,117338141,6,0,0,8704,12,4551211937
7975,65323190,51583451,116906641,9,0,0,23552,4,8199030871
7976,65329310,51716404,117045714,3,0,0,41472,18,3748737295
7977,65356710,50980365,116337075,1,0,0,19968,1,8750927181
7978,65362250,75158273,140520523,1,0,1,8192,1,9303206479
7979,65370110,51131747,116501857,6,0,0,27136,12,7633960183
7980,65371510,50876514,116248024,0,0,0,32768,6,1813206558
7981,65379320,50870443,116249763,6,0,0,5632,12,1185543847
7982,65379600,52101423,117481023,2,0,0,49152,1,7007580317
7983,65382740,51164819,116547559,9,0,0,4608,4,8451411185
7984,65383650,50926176,116309826,6,0,0,22528,12,7865449084
7985,65393290,50905840,116299130,4,0,0,9216,7,7848136510
7986,65396790,51144546,116541336,7,0,0,2048,1,4075123536
7987,65397200,51117495,116514695,2,0,0,41984,1,4969736408
7988,65398920,75166919,140565839,8,0,1,8704,11,5304812274
7989,65410380,51374206,116784586,7,0,0,14848,1,7238982671
7990,65418030,51852260,117270290,2,0,0,77312,1,4584463994
7991,65427350,51093662,116521012,0,0,0,20480,6,1614521077
7992,65436840,51235158,116671998,1,0,0,93184,1,8451053255
7993,65452100,51074255,116526355,8,0,0,17408,11,2239674536
7994,65453120,52493302,117946422,3,0,0,48128,18,8719110572
7995,65454190,51229265,116683455,3,0,0,2560,18,7597699727
7996,65460820,75143092,140603912,2,0,1,19968,1,8063049174
7997,65463030,51180553,116643583,6,0,0,42496,12,2008833000
7998,65472190,51412061,116884251,2,0,0,9728,1,4220707596
7999,65472500,51068189,116540689,3,0,0,8192,18,9487046642
8000,65482990,51397939,116880929,1,0,0,185856,1,5261875144
8001,65497830,75106105,140603935,7,0,1,9216,1,9998840069
8002,65500010,51092396,116592406,7,0,0,7680,1,5174849961
8003,65503550,75200515,140704065,6,0,1,33792,12,8155108535
8004,65505209,75198879,140704088,3,0,1,7168,18,10545180191
8005,65515470,52490909,118006379,1,0,0,55296,1,6635232324
8006,65524240,75234592,140758832,6,0,1,1024,12,1469032735
8007,65524450,51704142,117228592,9,0,0,60928,4,1918182895
8008,65534410,51783046,117317456,4,0,0,58368,7,5864359887
8009,65535840,51143045,116678885,3,0,0,22528,18,8024799740
8010,65542730,52509618,118052348,1,0,0,10240,1,352932279
8011,65569000,51317614,116886614,7,0,0,7680,1,9164024656
8012,65589320,51218800,116808120,2,0,0,11264,1,3542123095
8013,65608640,51857384,117466024,7,0,0,29184,1,10020608739
8014,65624540,51961223,117585763,0,0,0,22528,6,9519519226
8015,65634040,51247224,116881264,3,0,0,1024,18,5366497988
8016,65642920,51135848,116778768,8,0,0,78848,11,2657965158
8017,65649710,51784398,117434108,6,0,0,73728,12,9543324827
8018,65657570,51147095,116804665,6,0,0,26624,12,10371551840
8019,65660250,51343790,117004040,3,0,0,8192,18,5087819094
8020,65660790,51397427,117058217,0,0,0,40960,6,7237395170
8021,65689530,51268793,116958323,8,0,0,75776,11,2089255115
8022,65692610,51689603,117382213,3,0,0,54784,18,6296773419
8023,65717260,75045118,140762378,8,0,1,5632,11,772536142
8024,65724980,51026513,116751493,2,0,0,7168,1,4530811646
8025,65734790,75088437,140823227,4,0,1,37888,7,3910426654
8026,65756100,75175000,140931100,2,0,1,1024,1,6487808896
8027,65761370,75169753,140931123,4,0,1,4096,7,10593472385
8028,65764960,51298014,117062974,2,0,0,8192,1,2942681377
8029,65770260,51019052,116789312,8,0,0,14336,11,8807046205
8030,65770850,51969218,117740068,0,0,0,8192,6,4100302802
8031,65773100,51035199,116808299,2,0,0,512,1,6678580764
8032,65773329,75168358,140941687,3,0,1,9216,18,3440969629
8033,65806480,75142808,140949288,4,0,1,7680,7,7579805407
8034,65806960,51752384,117559344,3,0,0,70656,18,1119596036
8035,65813810,51150195,116964005,6,0,0,2560,12,5005046730
8036,65818020,51349967,117167987,9,0,0,74752,4,8809863771
8037,65831090,51201965,117033055,1,0,0,53760,1,4212488301
8038,65832880,51270992,117103872,1,0,0,31744,1,8824674589
8039,65845910,51053205,116899115,7,0,0,5120,1,9286079279
8040,65846370,51279516,117125886,7,0,0,2048,1,659688764
8041,65853690,51122615,116976305,6,0,0,15360,12,4210182444
8042,65868990,51408700,117277690,2,0,0,9216,1,6023745903
8043,65871280,52007703,117878983,7,0,0,14848,1,4856577997
8044,65872740,51187692,117060432,1,0,0,7168,1,4750288258
8045,65879600,51449423,117329023,0,0,0,37888,6,4965366935
8046,65908030,51812683,117720713,1,0,0,107008,1,4559321679
8047,65914090,51153587,117067677,7,0,0,15360,1,1852920767
8048,65916330,51540779,117457109,2,0,0,67584,1,5854925308
8049,65922180,75039166,140961346,1,0,1,20480,1,4296360939
8050,65926060,51564469,117490529,0,0,0,4096,6,8432739930
8051,65936810,51993792,117930602,6,0,0,49152,12,8722272912
8052,65947130,51326303,117273433,8,0,0,10240,11,4477671821
8053,65964440,51614436,117578876,4,0,0,41984,7,9718451446
8054,65964710,51698448,117663158,6,0,0,25600,12,4609232059
8055,65996960,52049828,118046788,9,0,0,78336,4,3404553019
8056,66039860,51734886,117774746,1,0,0,19456,1,340925120
8057,66051110,51787868,117838978,1,0,0,64512,1,9185771753
8058,66054090,51934771,117988861,3,0,0,10240,18,2240878363
8059,66059790,51728551,117788341,3,0,0,44544,18,7254452487
8060,66063560,51889593,117953153,5,0,0,22016,12,2384050592
8061,66068630,74981463,141050093,7,0,1,16896,1,1756925383
8062,66072030,51740894,117812924,4,0,0,52224,7,7221301212
8063,66075290,52217973,118293263,4,0,0,44032,7,5937036118
8064,66098240,52097681,118195921,8,0,0,29696,11,1151065511
8065,66108920,74952867,141061787,7,0,1,5120,1,385659980
8066,66122510,52064340,118186850,4,0,0,10752,7,2405154261
8067,66131660,51146209,117277869,0,0,0,512,6,7243162514
8068,66142320,74920773,141063093,4,0,1,2048,7,7914897847
8069,66155630,52124194,118279824,3,0,0,28672,18,8655946398
8070,66167850,51197648,117365498,4,0,0,39936,7,7003790384
8071,66196630,51684256,117880886,7,0,0,6144,1,8747457803
8072,66201120,51673316,117874436,7,0,0,53248,1,2648119122
8073,66210300,51272930,117483230,6,0,0,7168,12,10027859851
8074,66217731,74882967,141100698,9,0,1,12288,4,7134711240
8075,66223210,74877511,141100721,7,0,1,18944,1,7858179161
8076,66230820,51908366,118139186,0,0,0,66048,6,9993249714
8077,66250340,74912686,141163026,8,0,1,24064,11,4353168190
8078,66273890,52375272,118649162,1,0,0,41472,1,8085103261
8079,66275180,52139250,118414430,2,0,0,49664,1,3505449871
8080,66293820,51142674,117436494,8,0,0,7680,11,9709978377
8081,66301860,74897115,141198975,7,0,1,9216,1,1185227012
8082,66307970,51460825,117768795,4,0,0,94208,7,2304065644
8083,66309660,51374216,117683876,3,0,0,43008,18,8958791458
8084,66327410,52051509,118378919,7,0,0,38400,1,8409791917
8085,66335560,51726647,118062207,4,0,0,29184,7,9016914385
8086,66368580,51735221,118103801,2,0,0,25088,1,6068263159
8087,66373910,51349322,117723232,1,0,0,8192,1,1014799275
8088,66382170,51588563,117970733,0,0,0,17920,6,5793372235
8089,66388000,51634897,118022897,1,0,0,36352,1,1154386947
8090,66407660,51450529,117858189,0,0,0,62976,6,2820915405
8091,66421120,51468369,117889489,6,0,0,28160,12,3848332325
8092,66431580,52043915,118475495,9,0,0,59392,4,7460441961
8093,66435080,74778605,141213685,1,0,1,13312,1,8056952940
8094,66437630,51156382,117594012,4,0,0,2048,7,9535958142
8095,66438970,51353508,117792478,7,0,0,7680,1,4838015442
8096,66440050,51571748,118011798,3,0,0,5120,18,5653025341
8097,66449680,51732733,118182413,6,0,0,18432,12,1144538568
8098,66451840,51502116,117953956,2,0,0,2560,1,3910004793
8099,66455560,51649044,118104604,6,0,0,2560,12,5453724784
8100,66471470,51538745,118010215,3,0,0,12288,18,2496061493
8101,66478990,51617144,118096134,1,0,0,57344,1,1944464309
8102,66494430,74731196,141225626,0,0,1,14336,6,2870750358
8103,66499860,52073022,118572882,8,0,0,42496,11,4602008202
8104,66501239,74824340,141325579,3,0,1,8192,18,1511383665
8105,66501871,74823731,141325602,9,0,1,9728,4,10617844892
8106,66519710,51649865,118169575,0,0,0,70656,6,7495532087
8107,66519770,74805855,141325625,0,0,1,8704,6,1240441193
8108,66533200,51643574,118176774,1,0,0,23552,1,10215261573
8109,66540310,51642594,118182904,4,0,0,1536,7,811663389
8110,66563350,74762306,141325656,0,0,1,4608,6,8757592371
8111,66564260,51484922,118049182,8,0,0,7680,11,18525466
8112,66569300,51888076,118457376,3,0,0,9728,18,1744607131
8113,66573780,52180646,118754426,7,0,0,84480,1,4652634677
8114,66577220,52310666,118887886,0,0,0,45056,6,969062555
8115,66587300,51776596,118363896,8,0,0,10240,11,7454606353
8116,66597180,51606564,118203744,9,0,0,25600,4,7467915511
8117,66621530,51726246,118347776,7,0,0,58880,1,2831694537
8118,66641100,51566162,118207262,9,0,0,7168,4,10309515964
8119,66657710,74667969,141325679,4,0,1,3072,7,6751791946
8120,66657760,52631213,119288973,4,0,0,41984,7,1173055419
8121,66659470,52354852,119014322,7,0,0,55808,1,10698913104
8122,66665250,51605815,118271065,4,0,0,54784,7,8413447978
8123,66682240,51671277,118353517,4,0,0,512,7,10025538362
8124,66711040,74620673,141331713,1,0,1,18944,1,3717600890
8125,66718740,51581878,118300618,0,0,0,24064,6,106035247
8126,66728520,52383848,119112368,7,0,0,58880,1,3084092773
8127,66729820,51822104,118551924,0,0,0,25600,6,4250615776
8128,66741550,74591546,141333096,1,0,1,14848,1,7471729276
8129,66749590,51570693,118320283,9,0,0,25088,4,4718318915
8130,66752790,52847454,119600244,3,0,0,28672,18,6871544472
8131,66756600,51668617,118425217,1,0,0,35328,1,6406224241
8132,66766370,51828581,118594951,2,0,0,16896,1,5178710340
8133,66767830,52454034,119221864,0,0,0,84480,6,8247913464
8134,66768390,52418202,119186592,0,0,0,49152,6,8579588234
8135,66769440,51721202,118490642,3,0,0,22528,18,4640183240
8136,66772510,51460645,118233155,8,0,0,20992,11,1103432337
8137,66772810,51737890,118510700,1,0,0,1536,1,7295103689
8138,66784060,51907293,118691353,3,0,0,29696,18,3110691604
8139,66803710,53153461,119957171,2,0,0,97280,1,10564038654
8140,66810110,52781375,119591485,4,0,0,66048,7,1449711762
8141,66817530,51636859,118454389,3,0,0,24064,18,7058518795
8142,66827850,74563558,141391408,8,0,1,2560,11,4612158288
8143,66833140,51726763,118559903,7,0,0,26112,1,866352452
8144,66839770,52029038,118868808,4,0,0,111616,7,3987347161
8145,66848550,74579529,141428079,8,0,1,27648,11,9356108250
8146,66853840,52616379,119470219,0,0,0,57344,6,4841175706
8147,66854110,52047448,118901558,9,0,0,512,4,10638388162
8148,66866150,51571811,118437961,0,0,0,22016,6,9483987254
8149,66880560,52167197,119047757,9,0,0,14848,4,6868490674
8150,66881540,52105744,118987284,1,0,0,11264,1,512943117
8151,66899350,51935427,118834777,3,0,0,43008,18,8090685159
8152,66901130,51423856,118324986,2,0,0,15360,1,8694439217
8153,66906900,52136310,119043210,0,0,0,58368,6,6381021971
8154,66929890,51773705,118703595,1,0,0,6656,1,7638245883
8155,66931120,51839009,118770129,9,0,0,37376,4,8131779865
8156,66934660,53211722,120146382,4,0,0,35840,7,6286345912
8157,66935310,51821947,118757257,2,0,0,9216,1,5867317520
8158,66936250,74581223,141517473,1,0,1,3072,1,2215141149
8159,66936460,51764613,118701073,8,0,0,6144,11,10484726842
8160,66939190,51869769,118808959,9,0,0,76800,4,9435517265
8161,66952160,51822209,118774369,9,0,0,1024,4,8390363699
8162,66956680,74563335,141520015,8,0,1,5120,11,6177370666
8163,66958130,52454500,119412630,2,0,0,39936,1,5143121023
8164,66960820,74559218,141520038,7,0,1,26624,1,7338956453
8165,66974440,51986697,118961137,5,0,0,60928,12,10175005258
8166,66981590,52214511,119196101,0,0,0,17408,6,5368197269
8167,66982720,51537027,118519747,5,0,0,512,12,5520719153
8168,66999490,53545819,120545309,0,0,0,13312,6,5667646873
8169,67057830,52645323,119703153,7,0,0,17920,1,3707087309
8170,67096120,52675175,119771295,9,0,0,16384,4,4183172774
8171,67105810,53213186,120318996,1,0,0,13312,1,5802205599
8172,67107900,51702798,118810698,1,0,0,5632,1,10524933655
8173,67109340,51957109,119066449,9,0,0,4608,4,4872112179
8174,67112380,52325747,119438127,5,0,0,35328,12,10046864745
8175,67117970,52421799,119539769,9,0,0,1536,4,210566817
8176,67118570,51755565,118874135,0,0,0,17408,6,1842621272
8177,67123350,51839214,118962564,3,0,0,4608,18,4088015942
8178,67125870,51815509,118941379,7,0,0,3584,1,7120911667
8179,67130380,74551643,141682023,8,0,1,21504,11,7459101442
8180,67138260,52151672,119289932,4,0,0,3072,7,3841806635
8181,67138810,52542001,119680811,4,0,0,24064,7,2216524061
8182,67139620,52088039,119227659,8,0,0,18944,11,10472904504
8183,67164980,74519629,141684609,4,0,1,4096,7,7946880168
8184,67196410,51886388,119082798,0,0,0,2560,6,3180084052
8185,67212240,53274236,120486476,4,0,0,38912,7,5539293568
8186,67235710,51846285,119081995,5,0,0,48128,12,9173374243
8187,67239230,51455105,118694335,8,0,0,6656,11,9882839334
8188,67250520,52313549,119564069,1,0,0,30208,1,9583854627
8189,67264540,52003304,119267844,1,0,0,31232,1,7614727399
8190,67266540,74419695,141686235,4,0,1,2560,7,8884304898
8191,67269270,74443584,141712854,2,0,1,35328,1,8120603618
8192,67276080,51998027,119274107,5,0,0,20480,12,1052871780
8193,67287520,51696309,118983829,4,0,0,19456,7,5274364198
8194,67326320,51910277,119236597,9,0,0,25088,4,9517476692
8195,67327060,51844533,119171593,5,0,0,18432,12,789144901
8196,67331610,52383141,119714751,3,0,0,16384,18,10459439007
8197,67341620,74442810,141784430,2,0,1,3072,1,3785211
8198,67354920,52532154,119887074,7,0,0,44032,1,2833110915
8199,67381350,51752437,119133787,8,0,0,3072,11,4722319483
8200,67383300,52061566,119444866,1,0,0,22016,1,8667484234
8201,67409000,52324978,119733978,0,0,0,9728,6,3028705597
8202,67422170,52426389,119848559,3,0,0,4608,18,4952013363
8203,67426650,51831022,119257672,6,0,0,24064,12,4625394633
8204,67428530,74379709,141808239,1,0,1,13824,1,811190891
8205,67431890,51968549,119400439,9,0,0,72704,4,6186965501
8206,67445450,51610475,119055925,7,0,0,20480,1,6159689748
8207,67447661,74360601,141808262,9,0,1,8704,4,1577831243
8208,67454899,74437659,141892558,3,0,1,3072,18,8007232785
8209,67456660,51970680,119427340,8,0,0,40960,11,91743748
8210,67461820,52585862,120047682,2,0,0,292864,1,8171889626
8211,67463130,52184909,119648039,9,0,0,125440,4,3141835283
8212,67466330,53299785,120766115,4,0,0,40960,7,7210008236
8213,67468730,51807428,119276158,9,0,0,6656,4,7599497707
8214,67470230,51778126,119248356,1,0,0,2560,1,10104068637
8215,67471280,52436599,119907879,3,0,0,36352,18,6972864602
8216,67478710,52789000,120267710,6,0,0,100864,12,1635687569
8217,67490850,52262147,119752997,6,0,0,30208,12,1659006326
8218,67494400,52365595,119859995,4,0,0,20480,7,289477421
8219,67501490,52196180,119697670,8,0,0,20480,11,2334810679
8220,67508650,52575503,120084153,1,0,0,19968,1,2407498018
8221,67514330,74385285,141899615,2,0,1,2048,1,8362211855
8222,67536221,74363699,141899920,9,0,1,2048,4,5005065829
8223,67546240,53361814,120908054,7,0,0,69120,1,10491615274
8224,67586580,51864104,119450684,5,0,0,11776,12,2542207224
8225,67597870,52682126,120279996,2,0,0,16384,1,9561961093
8226,67598140,52470648,120068788,5,0,0,68608,12,4240711259
8227,67616400,74328345,141944745,6,0,1,2560,12,4245593594
8228,67627350,51787487,119414837,9,0,0,7168,4,5782155209
8229,67634350,53551223,121185573,0,0,0,134656,6,3811127305
8230,67640230,53440142,121080372,5,0,0,54272,12,3614934203
8231,67674540,74274071,141948611,8,0,1,6144,11,2167539340
8232,67677790,52102363,119780153,5,0,0,23552,12,1461806661
8233,67683370,52693896,120377266,9,0,0,19456,4,4628276899
8234,67687340,51759733,119447073,7,0,0,7168,1,6506026377
8235,67715990,51993738,119709728,2,0,0,21504,1,6280532220
8236,67719280,52082561,119801841,5,0,0,4608,12,4026281421
8237,67723350,52472773,120196123,1,0,0,37376,1,1865779018
8238,67740910,52630405,120371315,0,0,0,27136,6,1231665178
8239,67742230,52344808,120087038,2,0,0,512,1,4933352290
8240,67747930,74240039,141987969,0,0,1,6144,6,2475683419
8241,67753230,52036298,119789528,6,0,0,13824,12,7809057014
8242,67753250,52705054,120458304,1,0,0,60416,1,4552691355
8243,67753320,52143460,119896780,7,0,0,24576,1,10006413024
8244,67761440,52339480,120100920,5,0,0,11264,12,10062392664
8245,67769590,74218402,141987992,8,0,1,10752,11,9016307363
8246,67786960,52682622,120469582,4,0,0,2048,7,3080626472
8247,67792499,74195516,141988015,3,0,1,512,18,2664671011
8248,67802250,52125258,119927508,6,0,0,15872,12,510766701
8249,67807761,74180277,141988038,9,0,1,11264,4,10354095607
8250,67815530,52421425,120236955,5,0,0,70656,12,4653298509
8251,67822380,52255666,120078046,2,0,0,28672,1,8480934302
8252,67848280,52557033,120405313,4,0,0,10240,7,2569598018
8253,67864520,74221080,142085600,8,0,1,6656,11,3995534177
8254,67866790,52422433,120289223,9,0,0,30208,4,4534240175
8255,67872920,74237727,142110647,8,0,1,10240,11,7763314006
8256,67873570,52048265,119921835,1,0,0,4096,1,8275591881
8257,67875610,52658240,120533850,5,0,0,14848,12,10655419848
8258,67885490,74527363,142412853,4,0,1,9728,7,1021757298
8259,67917530,52735326,120652856,6,0,0,2560,12,5091726017
8260,67917981,74972823,142890804,9,0,1,35840,4,7547634457
8261,67919240,52517836,120437076,3,0,0,94720,18,2231799673
8262,67923410,52124451,120047861,4,0,0,512,7,4364209140
8263,67929710,52155246,120084956,8,0,0,2560,11,3704401417
8264,67933920,52135367,120069287,2,0,0,1536,1,3407175649
8265,67934930,52554844,120489774,1,0,0,2048,1,8487061323
8266,67951460,52644111,120595571,8,0,0,46080,11,1837855313
8267,67956380,52904933,120861313,5,0,0,68608,12,8404429946
8268,67967540,52119319,120086859,8,0,0,6144,11,286509920
8269,67983400,53230454,121213854,5,0,0,6656,12,2959064234
8270,67995171,74895656,142890827,9,0,1,2560,4,425270157
8271,68016310,52713163,120729473,3,0,0,96256,18,9496441495
8272,68019560,74871290,142890850,1,0,1,10240,1,80546436
8273,68042000,74877031,142919031,4,0,1,4096,7,8807029441
8274,68043160,52246554,120289714,6,0,0,1536,12,5634618424
8275,68043270,52841512,120884782,1,0,0,60928,1,1811819084
8276,68048830,52586534,120635364,7,0,0,68608,1,4282331642
8277,68061240,52208053,120269293,1,0,0,5120,1,6617615070
8278,68062790,52674841,120737631,8,0,0,26624,11,2362146860
8279,68064360,52329036,120393396,1,0,0,8704,1,1179667421
8280,68077260,52397337,120474597,1,0,0,16384,1,1700542941
8281,68089750,53318831,121408581,8,0,0,41472,11,3759847553
8282,68103350,52365585,120468935,0,0,0,34816,6,2137340763
8283,68107580,52560983,120668563,2,0,0,40960,1,6611096838
8284,68116630,52383752,120500382,0,0,0,11776,6,6064891264
8285,68132350,74878571,143010921,7,0,1,5120,1,3857467148
8286,68146980,52682281,120829261,3,0,0,7680,18,7729461808
8287,68156310,52281101,120437411,8,0,0,1024,11,5299274496
8288,68172820,52693352,120866172,6,0,0,15872,12,5057122142
8289,68179550,52369222,120548772,9,0,0,11264,4,1407784487
8290,68183190,74827754,143010944,4,0,1,8192,7,8462456640
8291,68187850,52899261,121087111,4,0,0,22016,7,5708371583
8292,68191710,52484021,120675731,5,0,0,22016,12,4800579053
8293,68200340,52588845,120789185,9,0,0,7680,4,10077603980
8294,68204420,52549169,120753589,0,0,0,52224,6,9550796156
8295,68210380,53362595,121572975,7,0,0,75776,1,7854514740
8296,68211390,52850037,121061427,1,0,0,59904,1,259371580
8297,68217250,52692566,120909816,3,0,0,5632,18,8517328055
8298,68222420,52889997,121112417,0,0,0,8192,6,6030471561
8299,68227490,53133967,121361457,5,0,0,48128,12,4923187374
8300,68236390,52735281,120971671,3,0,0,37376,18,6868573095
8301,68237330,53429247,121666577,5,0,0,51712,12,10070331455
8302,68241690,53288373,121530063,9,0,0,96256,4,10437114613
8303,68242840,53124724,121367564,4,0,0,19968,7,3956798010
8304,68265970,52823660,121089630,2,0,0,8192,1,8701609340
8305,68278119,74821180,143099299,3,0,1,5632,18,7199046144
8306,68281280,74839351,143120631,0,0,1,8192,6,5172269569
8307,68286141,74834513,143120654,9,0,1,512,4,2673156534
8308,68293900,74826777,143120677,1,0,1,1024,1,9632675426
8309,68294180,52634487,120928667,6,0,0,35840,12,4523523647
8310,68303140,74817560,143120700,6,0,1,2048,12,10437204265
8311,68304680,52998806,121303486,7,0,0,54784,1,5725177393
8312,68313280,53136825,121450105,0,0,0,27136,6,3028509266
8313,68316260,52595497,120911757,7,0,0,6144,1,723455743
8314,68321810,52865658,121187468,0,0,0,6144,6,8111371441
8315,68350060,53148516,121498576,5,0,0,36352,12,2860187357
8316,68358190,52853613,121211803,8,0,0,34816,11,3643965446
8317,68359180,53680313,122039493,6,0,0,16384,12,9718735762
8318,68365860,52870445,121236305,4,0,0,8704,7,10429829229
8319,68398600,52634649,121033249,0,0,0,26624,6,8162961860
8320,68401440,52705128,121106568,4,0,0,34304,7,6080256979
8321,68412101,74708622,143120723,9,0,1,5632,4,443023103
8322,68424120,74739840,143163960,2,0,1,23552,1,215648689
8323,68427890,53206817,121634707,8,0,0,47104,11,7027559459
8324,68433510,52797984,121231494,2,0,0,4608,1,2403866125
8325,68436030,75126042,143562072,7,0,1,8704,1,8518298407
8326,68439510,52947046,121386556,0,0,0,8704,6,3174755627
8327,68444090,52619723,121063813,4,0,0,7680,7,3579388461
8328,68444470,52700052,121144522,2,0,0,32768,1,8333906633
8329,68448300,52861784,121310084,5,0,0,16384,12,10106508147
8330,68449960,53835071,122285031,9,0,0,77824,4,5359525938
8331,68458510,53397154,121855664,9,0,0,28160,4,6444519728
8332,68470110,54047355,122517465,7,0,0,406016,1,8484343929
8333,68472530,53422761,121895291,8,0,0,11776,11,3577480100
8334,68485570,75590050,144075620,2,0,1,1024,1,9972745055
8335,68496880,53153918,121650798,7,0,0,52736,1,10517776223
8336,68505500,53577919,122083419,9,0,0,8192,4,1128651697
8337,68506540,53230494,121737034,5,0,0,11264,12,2803619111
8338,68509380,75573010,144082390,0,0,1,13312,6,7984656730
8339,68540090,53166430,121706520,4,0,0,11264,7,1669282232
8340,68542290,52868186,121410476,2,0,0,6144,1,5288833978
8341,68550310,52559580,121109890,6,0,0,10752,12,5484162006
8342,68556150,53028346,121584496,5,0,0,15872,12,7758951201
8343,68561910,54194217,122756127,9,0,0,278528,4,4179552899
8344,68570830,53186066,121756896,9,0,0,4608,4,5120562349
8345,68618530,53092225,121710755,5,0,0,13824,12,3299681391
8346,68624970,52680099,121305069,8,0,0,5120,11,5846205933
8347,68635580,75588236,144223816,4,0,1,13824,7,2611474182
8348,68657770,75566069,144223839,7,0,1,4096,1,4041192115
8349,68664950,52866384,121531334,9,0,0,4096,4,5464356308
8350,68667540,54164058,122831598,0,0,0,176640,6,3119201207
8351,68677190,53898445,122575635,5,0,0,5632,12,5797167269
8352,68684450,53460809,122145259,4,0,0,14336,7,7031949377
8353,68691870,75531992,144223862,2,0,1,5632,1,8493786419
8354,68701500,53619886,122321386,6,0,0,39936,12,7304584396
8355,68712830,75511055,144223885,1,0,1,6144,1,7210776155
8356,68718810,53172847,121891657,0,0,0,57344,6,5582043410
8357,68736060,75494267,144230327,6,0,1,3072,12,3790207797
8358,68741690,53003276,121744966,5,0,0,18432,12,2675197930
8359,68743410,53827655,122571065,6,0,0,83968,12,8777322888
8360,68749700,53603983,122353683,1,0,0,47104,1,7253243965
8361,68768690,75461660,144230350,8,0,1,14848,11,2886932573
8362,68770470,53286835,122057305,7,0,0,19456,1,2735953556
8363,68776900,53211891,121988791,7,0,0,7168,1,9848170549
8364,68787509,75724290,144511799,3,0,1,3072,18,6590086938
8365,68815260,53136166,121951426,2,0,0,73728,1,9874176710
8366,68818120,53040063,121858183,8,0,0,8192,11,6292594161
8367,68820100,53054062,121874162,8,0,0,2048,11,4881108524
8368,68833100,54113311,122946411,6,0,0,28672,12,4218649726
8369,68835100,53122188,121957288,7,0,0,6144,1,4410753268
8370,68839860,53524757,122364617,0,0,0,10752,6,4808656209
8371,68844900,54313791,123158691,0,0,0,47616,6,3780740936
8372,68848320,53231665,122079985,4,0,0,8192,7,10369306756
8373,68856760,52898709,121755469,7,0,0,13824,1,10463717709
8374,68872250,53260797,122133047,4,0,0,61440,7,3781934086
8375,68874680,75637142,144511822,0,0,1,3072,6,6954634308
8376,68885950,54348540,123234490,1,0,0,11776,1,9599448721
8377,68899810,53761842,122661652,9,0,0,63488,4,2962036512
8378,68911490,53923998,122835488,3,0,0,1024,18,3849802552
8379,68922909,75588936,144511845,3,0,1,3072,18,1866816079
8380,68924790,53136979,122061769,3,0,0,3584,18,6143563343
8381,68927810,52887324,121815134,7,0,0,12800,1,3903937000
8382,68932830,75579038,144511868,4,0,1,4096,7,6887397621
8383,68933340,75600905,144534245,2,0,1,13312,1,3066863563
8384,68951720,53346611,122298331,7,0,0,15872,1,4324593177
8385,68951850,54425088,123376938,3,0,0,116736,18,6600662347
8386,68952721,75586562,144539283,9,0,1,13824,4,2935204357
8387,68957730,53146705,122104435,1,0,0,21504,1,6295095070
8388,68959171,75580135,144539306,9,0,1,11776,4,7563017975
8389,68969770,75771747,144741517,1,0,1,4096,1,8883656151
8390,68987910,52874996,121862906,5,0,0,13312,12,3204133081
8391,68991551,75758700,144750251,9,0,1,3072,4,5673760949
8392,68996700,54392899,123389599,2,0,0,30208,1,6931771674
8393,69011820,53533638,122545458,4,0,0,84992,7,7535506183
8394,69012280,53357976,122370256,4,0,0,18432,7,6735267343
8395,69018590,54814880,123833470,3,0,0,83968,18,8905397798
8396,69019280,75730994,144750274,1,0,1,4608,1,3408139856
8397,69020790,54424548,123445338,1,0,0,53760,1,468580799
8398,69022710,54560809,123583519,5,0,0,64512,12,5415992313
8399,69026389,75723908,144750297,3,0,1,2048,18,448767406
8400,69032939,76021537,145054476,5,0,1,22528,12,7999125437
8401,69043680,54500346,123544026,9,0,0,38912,4,7123528073
8402,69058079,76028683,145086762,5,0,1,3584,12,9121559029
8403,69087400,76043220,145130620,2,0,1,3072,1,6001728024
8404,69088350,76043256,145131606,6,0,1,1536,12,2948332630
8405,69088370,53431169,122519539,5,0,0,3072,12,1716855998
8406,69103660,76029572,145133232,4,0,1,2560,7,4608082289
8407,69105280,53489137,122594417,4,0,0,31744,7,8075225906
8408,69105430,53252207,122357637,8,0,0,10240,11,617630905
8409,69111210,53227827,122339037,8,0,0,57856,11,2084635794
8410,69115120,54559484,123674604,4,0,0,68096,7,2736560019
8411,69118880,54786630,123905510,1,0,0,34304,1,7215535481
8412,69119380,53235106,122354486,0,0,0,2560,6,1343209933
8413,69126380,53495223,122621603,0,0,0,34816,6,5663091623
8414,69127140,53163062,122290202,4,0,0,16896,7,8894798176
8415,69135990,53437906,122573896,2,0,0,9216,1,4148443680
8416,69144580,53630001,122774581,8,0,0,41472,11,10439347297
8417,69146130,53522157,122668287,2,0,0,20480,1,3741664670
8418,69156610,53143447,122300057,4,0,0,512,7,8178796914
8419,69170420,53168796,122339216,3,0,0,512,18,4186477034
8420,69171750,54043443,123215193,6,0,0,46592,12,3191006911
8421,69173420,54897950,124071370,3,0,0,7168,18,5611582625
8422,69175420,76258849,145434269,7,0,1,101888,1,4232011862
8423,69177320,55008908,124186228,6,0,0,90624,12,3221801862
8424,69177560,54772556,123950116,8,0,0,57344,11,8868972002
8425,69183280,54245609,123428889,5,0,0,105472,12,10507971124
8426,69192360,76260394,145452754,0,0,1,5120,6,2058321817
8427,69205210,54136091,123341301,7,0,0,91648,1,951161137
8428,69219290,53542632,122761922,9,0,0,18944,4,8648758150
8429,69227960,54423395,123651355,5,0,0,19968,12,8737517173
8430,69232910,76219867,145452777,2,0,1,2560,1,5233930126
8431,69237650,54367960,123605610,8,0,0,69632,11,733884261
8432,69238410,53280170,122518580,1,0,0,3584,1,6912404322
8433,69242960,53662859,122905819,4,0,0,30720,7,8774763784
8434,69248920,53599539,122848459,2,0,0,42496,1,1556962147
8435,69266060,53893278,123159338,1,0,0,2048,1,7351942815
8436,69266220,55042761,124308981,1,0,0,3072,1,184408760
8437,69276380,53807785,123084165,8,0,0,81408,11,6190888609
8438,69284840,53584889,122869729,7,0,0,24576,1,800816891
8439,69288080,53638576,122926656,3,0,0,14336,18,427376411
8440,69290730,53544423,122835153,2,0,0,11264,1,1929451609
8441,69292520,76160280,145452800,8,0,1,2560,11,3950001029
8442,69296750,55098253,124395003,2,0,0,19968,1,3826999038
8443,69303300,53473644,122776944,1,0,0,7680,1,9637341367
8444,69327110,53535100,122862210,6,0,0,45056,12,5832105413
8445,69334200,53645106,122979306,5,0,0,12800,12,205594611
8446,69365720,53680897,123046617,9,0,0,3584,4,6467293716
8447,69366910,53410837,122777747,1,0,0,2560,1,9696546034
8448,69368000,55135859,124503859,6,0,0,37376,12,659536560
8449,69379859,76073143,145453002,3,0,1,4608,18,4926797978
8450,69396790,53237965,122634755,3,0,0,11776,18,1395120239
8451,69417840,54264587,123682427,3,0,0,25600,18,8606642032
8452,69420550,53537845,122958395,9,0,0,14336,4,3788937621
8453,69420630,55002888,124423518,1,0,0,64512,1,4756443048
8454,69425610,53764493,123190103,6,0,0,16384,12,1699225442
8455,69436470,53473525,122909995,7,0,0,4096,1,8514063172
8456,69440940,53604562,123045502,2,0,0,86528,1,6820266909
8457,69444940,54260824,123705764,0,0,0,51712,6,6692569242
8458,69447250,55062770,124510020,1,0,0,7680,1,8644964894
8459,69449110,55312594,124761704,0,0,0,57856,6,4782636197
8460,69454900,75999242,145454142,7,0,1,13824,1,8607221038
8461,69477830,53721822,123199652,9,0,0,11776,4,10390838974
8462,69481880,53650266,123132146,2,0,0,12288,1,1984174845
8463,69485020,53770215,123255235,2,0,0,3584,1,7164871263
8464,69491690,55838563,125330253,0,0,0,9216,6,9836907180
8465,69495930,53991614,123487544,2,0,0,6656,1,9482882487
8466,69499590,54504369,124003959,8,0,0,176640,11,3206865948
8467,69501960,55201219,124703179,6,0,0,47616,12,6503819460
8468,69531220,76031211,145562431,0,0,1,5120,6,10194933794
8469,69533860,53912749,123446609,2,0,0,4096,1,9831872472
8470,69535080,53844221,123379301,4,0,0,7680,7,7846824434
8471,69540060,76028657,145568717,4,0,1,10240,7,5935806918
8472,69544990,53583389,123128379,3,0,0,14848,18,2239419360
8473,69551620,55480952,125032572,1,0,0,22528,1,2417063741
8474,69557070,54552458,124109528,1,0,0,4096,1,10652843170
8475,69567920,53714377,123282297,9,0,0,9728,4,3901677804
8476,69567960,76000780,145568740,7,0,1,9728,1,2387129534
8477,69586890,55953736,125540626,0,0,0,44544,6,7110065594
8478,69592320,53494119,123086439,4,0,0,2048,7,5442154157
8479,69592530,75976233,145568763,7,0,1,16384,1,5817644842
8480,69594040,54891053,124485093,6,0,0,41984,12,4704169920
8481,69613160,54495097,124108257,8,0,0,61952,11,2461171319
8482,69624330,53652862,123277192,3,0,0,11776,18,7823394374
8483,69633120,75935666,145568786,6,0,1,10240,12,2617246960
8484,69658880,55249313,124908193,4,0,0,92160,7,10500274887
8485,69671300,54358888,124030188,1,0,0,6144,1,669079472
8486,69684950,55926784,125611734,0,0,0,1024,6,16441005
8487,69685170,53567113,123252283,7,0,0,29184,1,3511976769
8488,69690010,54513290,124203300,2,0,0,17920,1,4513754533
8489,69697409,75871400,145568809,5,0,1,3072,12,9052530034
8490,69702680,75866152,145568832,6,0,1,6656,12,4894817142
8491,69705580,54312941,124018521,7,0,0,36352,1,4835446057
8492,69706261,75862594,145568855,9,0,1,3584,4,6923471277
8493,69726600,53755375,123481975,1,0,0,10752,1,7057626744
8494,69737540,53575814,123313354,1,0,0,18432,1,9550677281
8495,69740440,53776923,123517363,8,0,0,8704,11,6843081760
8496,69743120,53706640,123449760,9,0,0,10240,4,1696682800
8497,69747790,54341568,124089358,7,0,0,34304,1,483082021
8498,69756770,53964962,123721732,7,0,0,10752,1,8292940580
8499,69763420,53877407,123640827,6,0,0,11264,12,3872412110
8500,69781370,54607457,124388827,9,0,0,118784,4,8081931980
8501,69783110,54111925,123895035,6,0,0,61952,12,9665015942
8502,69792610,55960571,125753181,1,0,0,37888,1,276586136
8503,69820140,75749444,145569584,4,0,1,4096,7,9818472633
8504,69820430,54687219,124507649,2,0,0,5120,1,4488059294
8505,69833680,53772265,123605945,0,0,0,1024,6,6169314798
8506,69841980,54001052,123843032,4,0,0,25600,7,3557479474
8507,69843970,53846015,123689985,8,0,0,12288,11,4012738001
8508,69847710,54504902,124352612,3,0,0,36864,18,9578726780
8509,69848500,75721750,145570250,8,0,1,1024,11,4329604977
8510,69849050,54158372,124007422,7,0,0,11264,1,5714727549
8511,69851350,75781083,145632433,6,0,1,29696,12,1788405242
8512,69855680,54342137,124197817,2,0,0,12288,1,9311535956
8513,69856230,55962577,125818807,9,0,0,11776,4,5735175335
8514,69859020,55456055,125315075,0,0,0,55808,6,5315463161
8515,69861830,55307926,125169756,3,0,0,33792,18,1325912568
8516,69869890,53632883,123502773,6,0,0,40448,12,9705335775
8517,69871520,53893675,123765195,0,0,0,2048,6,2367614460
8518,69879270,54524515,124403785,1,0,0,17920,1,4651373470
8519,69916900,75772597,145689497,8,0,1,7680,11,8400063456
8520,69918020,54735333,124653353,6,0,0,55296,12,7220251314
8521,69926900,55212091,125138991,0,0,0,9728,6,5744415729
8522,69929600,53722627,123652227,7,0,0,512,1,773503087
8523,69960460,75729060,145689520,2,0,1,2560,1,6079340022
8524,69977570,53786978,123764548,9,0,0,35328,4,5886459431
8525,69996930,53655095,123652025,8,0,0,2048,11,6618481152
8526,70025840,75667778,145693618,2,0,1,7168,1,7803022049
8527,70026710,53705903,123732613,7,0,0,13312,1,8689444219
8528,70030620,55916176,125946796,0,0,0,21504,6,3636350872
8529,70045090,54724593,124769683,4,0,0,26112,7,8258581292
8530,70058750,53647193,123705943,9,0,0,512,4,1947041529
8531,70061490,53547910,123609400,3,0,0,11264,18,1639880056
8532,70078000,56024583,126102583,8,0,0,13312,11,9606037156
8533,70085810,75611034,145696844,0,0,1,5120,6,8702579105
8534,70099120,53773485,123872605,3,0,0,11776,18,3336747628
8535,70113640,55401356,125514996,7,0,0,40448,1,4462035949
8536,70119870,53939936,124059806,4,0,0,41472,7,506791909
8537,70129840,53705369,123835209,0,0,0,5632,6,2013975902
8538,70139160,54202197,124341357,6,0,0,49664,12,126620463
8539,70165290,53862995,124028285,8,0,0,5120,11,9859768752
8540,70184310,75520831,145705141,7,0,1,512,1,3050438104
8541,70188640,75711486,145900126,2,0,1,6656,1,7480537394
8542,70195710,54603066,124798776,3,0,0,51200,18,1393466270
8543,70203700,53949618,124153318,1,0,0,47616,1,3666779636
8544,70203810,53856487,124060297,7,0,0,1536,1,1602233770
8545,70213260,53811859,124025119,4,0,0,21504,7,6583930338
8546,70218640,75823454,146042094,2,0,1,17920,1,2345767024
8547,70253480,54977097,125230577,8,0,0,24576,11,7446210191
8548,70262010,54720215,124982225,7,0,0,109056,1,5926960533
8549,70277600,53878081,124155681,3,0,0,7680,18,10464379009
8550,70286019,75807829,146093848,3,0,1,512,18,3238599367
8551,70289100,53900739,124189839,4,0,0,11776,7,2273468607
8552,70295660,53823898,124119558,4,0,0,32768,7,839306297
8553,70299240,54270356,124569596,3,0,0,18432,18,9874712541
8554,70302710,55997721,126300431,6,0,0,92672,12,4389815293
8555,70304170,55075969,125380139,2,0,0,41984,1,8012570496
8556,70311990,53898665,124210655,0,0,0,24064,6,1287500089
8557,70329060,53697642,124026702,7,0,0,5120,1,8628934254
8558,70341060,53782109,124123169,4,0,0,11776,7,7995269725
8559,70343070,56080102,126423172,8,0,0,2048,11,2969167794
8560,70360000,54146066,124506066,2,0,0,7168,1,4622016441
8561,70369050,53823308,124192358,1,0,0,8192,1,10104031051
8562,70377341,76274761,146652102,9,0,1,36352,4,5764166146
8563,70381840,54110608,124492448,0,0,0,24064,6,10283265538
8564,70388000,54719415,125107415,1,0,0,70144,1,8692742010
8565,70425230,53887050,124312280,8,0,0,10752,11,7115035121
8566,70439150,53868872,124308022,3,0,0,38912,18,10612095513
8567,70447830,53773244,124221074,4,0,0,24064,7,8862300909
8568,70452250,55090739,125542989,0,0,0,7680,6,5446742450
8569,70462090,76190035,146652125,8,0,1,1536,11,10640867679
8570,70481590,54262463,124744053,0,0,0,57856,6,6756831093
8571,70493460,54921181,125414641,1,0,0,12288,1,513103330
8572,70523830,53634370,124158200,0,0,0,8192,6,2222499332
8573,70543800,55003435,125547235,2,0,0,12800,1,2361135816
8574,70546030,76106118,146652148,1,0,1,5120,1,7628506877
8575,70552740,55228659,125781399,8,0,0,6656,11,8885718940
8576,70554980,54447708,125002688,8,0,0,11776,11,9815290685
8577,70563330,53663206,124226536,3,0,0,3584,18,5393210193
8578,70576499,76096778,146673277,5,0,1,2560,12,6722517483
8579,70605080,76085036,146690116,4,0,1,15360,7,10339767902
8580,70624510,54289345,124913855,3,0,0,8704,18,4527464976
8581,70628871,76061268,146690139,9,0,1,512,4,9511920101
8582,70630410,76059752,146690162,1,0,1,1536,1,8965651331
8583,70638780,55091689,125730469,7,0,0,68608,1,201094626
8584,70649900,54703701,125353601,8,0,0,51712,11,1644656630
8585,70661030,53737272,124398302,9,0,0,10752,4,5785364097
8586,70670000,55312902,125982902,6,0,0,110592,12,5723543903
8587,70681840,54196511,124878351,6,0,0,94208,12,7794353974
8588,70683330,76006855,146690185,0,0,1,4096,6,1875544404
8589,70685469,76049135,146734604,5,0,1,5632,12,10351933582
8590,70697110,53728459,124425569,7,0,0,6656,1,4431388927
8591,70705100,76029527,146734627,0,0,1,9216,6,5483155684
8592,70706590,55820271,126526861,7,0,0,23040,1,2754269061
8593,70722060,76019789,146741849,4,0,1,4096,7,6527623187
8594,70741870,54041275,124783145,3,0,0,8192,18,5003206603
8595,70743100,55483439,126226539,7,0,0,132096,1,8032921454
8596,70743610,55035738,125779348,9,0,0,2560,4,7597742379
8597,70759150,54528735,125287885,9,0,0,12800,4,1603209157
8598,70763240,55176155,125939395,4,0,0,198656,7,2201047426
8599,70787990,75992967,146780957,6,0,1,1024,12,8505636924
8600,70790250,54537172,125327422,0,0,0,40448,6,10448214436
8601,70821040,55498290,126319330,3,0,0,61952,18,6167081518
8602,70821280,54058810,124880090,8,0,0,5632,11,587868564
8603,70831570,54176757,125008327,0,0,0,18432,6,3161890140
8604,70852760,75928220,146780980,7,0,1,4096,1,3341366957
8605,70859590,53921036,124780626,0,0,0,35840,6,7778855412
8606,70869250,54049776,124919026,2,0,0,16896,1,1737072731
8607,70904730,75903353,146808083,4,0,1,6656,7,10363258567
8608,70913570,53635284,124548854,2,0,0,2048,1,7159299986
8609,70932120,53992077,124924197,0,0,0,16896,6,9976299371
8610,70941860,54169836,125111696,9,0,0,13824,4,2581243254
8611,70946140,54446970,125393110,3,0,0,42496,18,4149677688
8612,70957260,54041817,124999077,0,0,0,20480,6,5897717441
8613,70959750,53487771,124447521,0,0,0,7680,6,2431382340
8614,70960550,55670466,126631016,4,0,0,113664,7,2122247997
8615,70963340,75844766,146808106,0,0,1,2560,6,7506394471
8616,70981750,54458689,125440439,9,0,0,23040,4,2754033884
8617,70983380,53849753,124833133,6,0,0,9216,12,1696469285
8618,71004810,54594305,125599115,0,0,0,42496,6,8030209753
8619,71005330,54292718,125298048,8,0,0,33280,11,1396228832
8620,71006440,55472212,126478652,4,0,0,130048,7,10116963361
8621,71019830,55621973,126641803,6,0,0,35328,12,7921598042
8622,71024640,54502391,125527031,7,0,0,39424,1,5533151906
8623,71029870,54711744,125741614,6,0,0,9728,12,1186270167
8624,71032971,75783940,146816911,9,0,1,28160,4,1991430878
8625,71038210,54245752,125283962,2,0,0,18432,1,3806923402
8626,71038550,54715301,125753851,9,0,0,2048,4,2486522315
8627,71040571,75787813,146828384,9,0,1,3072,4,8203798602
8628,71044470,54381389,125425859,9,0,0,25600,4,7047540177
8629,71045230,53865950,124911180,0,0,0,9728,6,5421100146
8630,71046300,75782107,146828407,8,0,1,2560,11,4238099466
8631,71062090,54579806,125641896,0,0,0,16384,6,3080311003
8632,71065100,55994269,127059369,2,0,0,613376,1,9658574774
8633,71065250,75763180,146828430,1,0,1,1536,1,10169293881
8634,71079030,54165795,125244825,0,0,0,7680,6,6263370068
8635,71094530,54643918,125738448,8,0,0,26112,11,6335049297
8636,71109300,75719161,146828461,7,0,1,20480,1,2640743916
8637,71110370,75744220,146854590,6,0,1,34816,12,6276632693
8638,71112150,54122991,125235141,8,0,0,6144,11,6923011184
8639,71121030,53904655,125025685,6,0,0,13824,12,8555626798
8640,71142880,54668744,125811624,3,0,0,1536,18,7405080526
8641,71166530,75701234,146867764,2,0,1,1536,1,5829355488
8642,71166910,55265113,126432023,6,0,0,14336,12,9550315032
8643,71174420,75693375,146867795,0,0,1,6656,6,2161328260
8644,71179050,55907248,127086298,9,0,0,6144,4,4755676315
8645,71192170,54949257,126141427,1,0,0,62976,1,2531442332
8646,71192190,54804174,125996364,7,0,0,20480,1,7534420682
8647,71200220,55486799,126687019,6,0,0,104960,12,395520351
8648,71206730,54125441,125332171,2,0,0,6144,1,9203888539
8649,71210490,54729731,125940221,0,0,0,2560,6,8982333655
8650,71225300,55352404,126577704,8,0,0,35840,11,4155918374
8651,71237330,54773373,126010703,2,0,0,32768,1,6540157452
8652,71248120,75645367,146893487,6,0,1,4096,12,5325274896
8653,71265980,54583383,125849363,3,0,0,59392,18,6970343963
8654,71274510,54226953,125501463,4,0,0,27136,7,8145896533
8655,71289910,54448717,125738627,4,0,0,512,7,5529188247
8656,71304580,54473965,125778545,9,0,0,80896,4,1494282464
8657,71310230,75587359,146897589,2,0,1,1024,1,8790064437
8658,71312070,55802469,127114539,8,0,0,18432,11,7756017041
8659,71334790,75562822,146897612,0,0,1,9216,6,8635445936
8660,71351410,75568267,146919677,6,0,1,15872,12,4699295954
8661,71365830,55762499,127128329,4,0,0,40960,7,4925423019
8662,71374280,55477560,126851840,8,0,0,108032,11,2439632445
8663,71395190,54463149,125858339,6,0,0,8192,12,9975238976
8664,71398050,55342646,126740696,4,0,0,43008,7,9805259216
8665,71399280,54549879,125949159,4,0,0,7680,7,8718886786
8666,71408679,77781008,149189687,5,0,1,500224,12,8074967189
8667,71432030,77870079,149302109,4,0,1,10752,7,1573344927
8668,71445899,77912053,149357952,3,0,1,36864,18,1776456848
8669,71445980,54205708,125651688,9,0,0,12800,4,8136285025
8670,71485660,55903624,127389284,6,0,0,12800,12,10380427175
8671,71513740,54881119,126394859,2,0,0,50688,1,8237664214
8672,71515070,55738502,127253572,4,0,0,66560,7,1922861709
8673,71526550,77860635,149387185,4,0,1,10752,7,3209901543
8674,71527170,54730679,126257849,3,0,0,50688,18,3345703408
8675,71528620,56580170,128108790,8,0,0,57344,11,9450143646
8676,71529820,54656448,126186268,2,0,0,18432,1,2047309847
8677,71538290,54640912,126179202,6,0,0,123904,12,10221749585
8678,71545210,55938543,127483753,7,0,0,10752,1,7866005146
8679,71546699,77899807,149446506,3,0,1,3072,18,7625266632
8680,71552920,54627709,126180629,7,0,0,4608,1,4907985923
8681,71582130,54690042,126272172,4,0,0,13312,7,2928315427
8682,71587120,55854732,127441852,4,0,0,11776,7,9180466827
8683,71588550,56582392,128170942,7,0,0,95232,1,7980262941
8684,71592930,54926888,126519818,2,0,0,31232,1,2733980757
8685,71597070,77878498,149475568,1,0,1,1024,1,3228261200
8686,71620450,55087519,126707969,3,0,0,21504,18,9841224673
8687,71637870,54352231,125990101,6,0,0,23552,12,10209146252
8688,71651340,55457560,127108900,3,0,0,18944,18,4889615325
8689,71656970,54853309,126510279,9,0,0,65536,4,5381079575
8690,71662270,55399306,127061576,2,0,0,7168,1,5665345502
8691,71682270,54142945,125825215,7,0,0,2560,1,9609277613
8692,71685100,54850372,126535472,8,0,0,28160,11,10491891790
8693,71688790,55462118,127150908,9,0,0,4608,4,5544644599
8694,71708440,77767151,149475591,1,0,1,8192,1,3872782237
8695,71715740,54620172,126335912,2,0,0,35840,1,3454094623
8696,71751290,54628102,126379392,9,0,0,74240,4,3748635133
8697,71757010,54733255,126490265,8,0,0,2048,11,6155361544
8698,71763999,77859395,149623394,5,0,1,55808,12,7361592314
8699,71777970,55945483,127723453,6,0,0,75264,12,3847583548
8700,71789830,54632695,126422525,0,0,0,81408,6,2992177501
8701,71802060,55583301,127385361,3,0,0,228352,18,10566205841
8702,71805700,54591990,126397690,4,0,0,9216,7,6543764347
8703,71813300,54611143,126424443,0,0,0,4096,6,8677296484
8704,71823570,54501399,126324969,6,0,0,18432,12,8889435982
8705,71830650,77860406,149691056,7,0,1,10752,1,9884192616
8706,71836400,55751285,127587685,8,0,0,28672,11,9703500394
8707,71845100,54643403,126488503,9,0,0,32256,4,2730735598
8708,71856000,77835079,149691079,2,0,1,9216,1,2832455315
8709,71864520,54836874,126701394,5,0,0,47104,12,6804442681
8710,71868350,55636977,127505327,2,0,0,36352,1,3306940139
8711,71890230,77812337,149702567,4,0,1,16384,7,8364046591
8712,71907270,55998682,127905952,2,0,0,40960,1,713620095
8713,71911720,55491228,127402948,2,0,0,20992,1,5196542926
8714,71912420,77790170,149702590,0,0,1,4096,6,10154693936
8715,71913190,54576428,126489618,7,0,0,3584,1,3699245585
8716,71932390,77771482,149703872,0,0,1,5632,6,4371180544
8717,71937019,78105091,150042110,5,0,1,128000,12,9074562996
8718,71944539,78184327,150128866,3,0,1,3072,18,6975270840
8719,71959380,56331646,128291026,0,0,0,8192,6,9160747937
8720,71962870,54827480,126790350,3,0,0,26112,18,927011864
8721,71978960,54771275,126750235,0,0,0,31232,6,9286365011
8722,71981960,54561202,126543162,8,0,0,11264,11,1963882905
8723,71983460,78155280,150138740,0,0,1,5120,6,9691827666
8724,71993170,54546537,126539707,6,0,0,13824,12,6083622810
8725,71996029,78142742,150138771,3,0,1,12288,18,375063224
8726,72002950,54424636,126427586,2,0,0,10240,1,5850775766
8727,72017820,78143796,150161616,4,0,1,4096,7,7926176754
8728,72019110,54541992,126561102,3,0,0,7168,18,7243475550
8729,72030340,54519241,126549581,2,0,0,20992,1,6390724925
8730,72098119,78071636,150169755,3,0,1,2048,18,1036930399
8731,72109500,55047467,127156967,7,0,0,1024,1,5471544359
8732,72111460,54597000,126708460,3,0,0,1536,18,9153585194
8733,72115110,55776889,127891999,6,0,0,32768,12,4229763046
8734,72120110,78895202,151015312,4,0,1,83456,7,717893918
8735,72123430,78893828,151017258,4,0,1,3072,7,3357485569
8736,72125080,56393121,128518201,9,0,0,83968,4,10333356076
8737,72138160,78879444,151017604,6,0,1,512,12,8746745741
8738,72140030,54586081,126726111,0,0,0,57856,6,1862554950
8739,72142020,54640351,126782371,3,0,0,16384,18,4870788918
8740,72144370,54709677,126854047,2,0,0,7168,1,10604488251
8741,72144580,54957052,127101632,3,0,0,50176,18,2438554384
8742,72150641,78867936,151018577,9,0,1,12800,4,6431343171
8743,72154250,55838567,127992817,3,0,0,17408,18,10507963279
8744,72154430,54573131,126727561,3,0,0,4608,18,2967691274
8745,72156230,79085105,151241335,0,0,1,24064,6,10173663634
8746,72157920,54639317,126797237,0,0,0,22528,6,7682742226
8747,72179730,54885168,127064898,5,0,0,10752,12,8697594372
8748,72180580,54621516,126802096,5,0,0,15872,12,7633865515
8749,72185010,56384504,128569514,0,0,0,17408,6,5625955736
8750,72193779,79060526,151254305,3,0,1,1536,18,10680788837
8751,72196000,54907105,127103105,9,0,0,4608,4,1679991135
8752,72216870,54556719,126773589,2,0,0,60416,1,682851434
8753,72217590,54559766,126777356,0,0,0,12288,6,4381420760
8754,72231180,79032967,151264147,7,0,1,25088,1,956246689
8755,72235020,55899891,128134911,7,0,0,26624,1,9015496149
8756,72246540,54561297,126807837,6,0,0,3072,12,6607363123
8757,72252479,79108875,151361354,3,0,1,39424,18,9166669744
8758,72255780,54828623,127084403,8,0,0,18432,11,6214271447
8759,72256590,54942649,127199239,6,0,0,4608,12,9162395169
8760,72263540,54953526,127217066,8,0,0,1024,11,2751078029
8761,72263569,79189198,151452767,3,0,1,25088,18,5740348946
8762,72274350,79201056,151475406,6,0,1,27648,12,5714713905
8763,72275260,55146106,127421366,7,0,0,2560,1,5132166168
8764,72279240,55762089,128041329,3,0,0,123904,18,4971299655
8765,72279560,54918252,127197812,0,0,0,29696,6,2376170597
8766,72289750,55973578,128263328,0,0,0,85504,6,4025986069
8767,72302580,54813246,127115826,6,0,0,4096,12,815387374
8768,72308250,54495437,126803687,4,0,0,5120,7,8657472580
8769,72314710,54540452,126855162,2,0,0,3584,1,6028508963
8770,72321350,79154079,151475429,7,0,1,9728,1,2305353827
8771,72321440,55075066,127396506,8,0,0,22016,11,2619654513
8772,72322380,79271115,151593495,4,0,1,33280,7,7844162200
8773,72328740,55944109,128272849,9,0,0,18432,4,1546031759
8774,72335880,55053895,127389775,9,0,0,1536,4,3511881307
8775,72340560,54738204,127078764,8,0,0,45056,11,3600514303
8776,72346460,54788958,127135418,9,0,0,23040,4,8657448062
8777,72346550,55244613,127591163,4,0,0,1024,7,8487107131
8778,72349690,54826595,127176285,4,0,0,8192,7,8074016484
8779,72356620,55403737,127760357,7,0,0,47104,1,4418479831
8780,72369470,55867783,128237253,6,0,0,94208,12,8776052010
8781,72397720,55983525,128381245,9,0,0,36352,4,1038763445
8782,72405650,79285164,151690814,7,0,1,3584,1,3259233139
8783,72405660,54810062,127215722,0,0,0,19968,6,7906235709
8784,72426590,55943556,128370146,2,0,0,147456,1,1032339601
8785,72457320,54692161,127149481,3,0,0,46080,18,9890540491
8786,72469770,55010684,127480454,9,0,0,76800,4,8220907255
8787,72479670,55939084,128418754,3,0,0,95744,18,3493278567
8788,72485830,56078357,128564187,2,0,0,54784,1,3155594882
8789,72505450,54988778,127494228,3,0,0,34304,18,9011965045
8790,72521940,54755072,127277012,7,0,0,13312,1,1627286593
8791,72539050,55342942,127881992,4,0,0,101376,7,5341069862
8792,72547540,55286044,127833584,2,0,0,23040,1,7078246231
8793,72559369,79601340,152160709,5,0,1,141312,12,8454210024
8794,72589800,79622279,152212079,8,0,1,17408,11,9690174447
8795,72593910,54996918,127590828,6,0,0,10240,12,6381407245
8796,72597330,54814221,127411551,2,0,0,28160,1,6870484497
8797,72600950,54977976,127578926,4,0,0,40448,7,4103448030
8798,72601810,55866082,128467892,3,0,0,42496,18,9360795295
8799,72620320,55194578,127814898,8,0,0,2048,11,1661253859
8800,72623400,55641667,128265067,9,0,0,5632,4,2780499501
8801,72629780,56167075,128796855,4,0,0,65024,7,6811056276
8802,72633410,55193131,127826541,3,0,0,15360,18,8805906949
8803,72633440,56015176,128648616,4,0,0,39936,7,677132919
8804,72633840,54970762,127604602,4,0,0,44032,7,190708672
8805,72641760,54864237,127505997,8,0,0,2048,11,8868667094
8806,72641890,55470675,128112565,3,0,0,12288,18,8114874984
8807,72647460,55145024,127792484,9,0,0,3584,4,3713103993
8808,72688340,55204150,127892490,9,0,0,1536,4,3154832898
8809,72690540,56439475,129130015,8,0,0,25088,11,1999697616
8810,72696440,79527697,152224137,1,0,1,11776,1,5237854886
8811,72698910,56974473,129673383,2,0,0,24064,1,3018873595
8812,72700389,79573246,152273635,3,0,1,9216,18,2431267635
8813,72705000,55346180,128051180,8,0,0,32256,11,7450731825
8814,72719061,79554597,152273658,9,0,1,26112,4,8642338816
8815,72724840,54975658,127700498,4,0,0,15360,7,8285376371
8816,72727730,55551538,128279268,3,0,0,20992,18,5370044134
8817,72730670,55205569,127936239,6,0,0,99328,12,7127222255
8818,72733440,54916720,127650160,9,0,0,2560,4,1507268004
8819,72734540,55379296,128113836,3,0,0,4096,18,9218091580
8820,72739790,55351505,128091295,6,0,0,131584,12,2854170978
8821,72749410,79626620,152376030,7,0,1,32256,1,1335341137
8822,72759409,79674119,152433528,5,0,1,160256,12,312866103
8823,72763170,54962810,127725980,3,0,0,8192,18,8432975577
8824,72764310,55683708,128448018,8,0,0,7680,11,2840364488
8825,72771520,56202989,128974509,8,0,0,11776,11,6645999839
8826,72782020,54957545,127739565,7,0,0,7168,1,268863501
8827,72804010,79629541,152433551,7,0,1,7680,1,8890181542
8828,72804040,55628621,128432661,2,0,0,45568,1,4404452115
8829,72805780,79627794,152433574,7,0,1,13312,1,4046754304
8830,72821340,55319522,128140862,3,0,0,19456,18,2795377422
8831,72836820,55885772,128722592,8,0,0,39424,11,9111796398
8832,72838140,55428978,128267118,8,0,0,6656,11,1841147517
8833,72838410,79595195,152433605,4,0,1,512,7,9004326131
8834,72840440,57015321,129855761,0,0,0,27648,6,4835064762
8835,72858810,55871137,128729947,2,0,0,24064,1,7523642992
8836,72870000,56739993,129609993,7,0,0,74240,1,10480621160
8837,72880130,55242465,128122595,4,0,0,28672,7,9903759175
8838,72891450,54926102,127817552,5,0,0,3584,12,2501846054
8839,72900220,55275389,128175609,9,0,0,5120,4,9394569612
8840,72904230,79529398,152433628,0,0,1,3072,6,6352764584
8841,72929330,79504321,152433651,8,0,1,3072,11,752832050
8842,72934530,79499144,152433674,6,0,1,1024,12,2064456472
8843,72934730,79498967,152433697,6,0,1,10752,12,5009198341
8844,72940420,55737453,128677873,3,0,0,49664,18,7379599948
8845,72945510,55437006,128382516,6,0,0,4096,12,938721267
8846,72952460,55945259,128897719,3,0,0,24064,18,10013911215
8847,72956520,54936929,127893449,4,0,0,3072,7,2641743097
8848,72962420,55039312,128001732,3,0,0,29184,18,9383372929
8849,72969220,54760839,127730059,8,0,0,13312,11,598720561
8850,72976720,55010770,127987490,0,0,0,40960,6,3577319703
8851,72980130,79465024,152445154,4,0,1,24064,7,4876780421
8852,72981670,55627565,128609235,2,0,0,31232,1,1980914627
8853,73025679,79452522,152478201,5,0,1,80384,12,8589885281
8854,73044580,55410325,128454905,3,0,0,22528,18,146790259
8855,73052180,79426044,152478224,7,0,1,7168,1,4278765585
8856,73093540,55352092,128445632,8,0,0,42496,11,4639121894
8857,73105520,54834673,127940193,8,0,0,12800,11,2301099972
8858,73112990,79365257,152478247,0,0,1,8704,6,949215547
8859,73122950,55934892,129057842,2,0,0,102912,1,9653300026
8860,73142250,79336028,152478278,7,0,1,12800,1,970701115
8861,73143000,55246559,128389559,0,0,0,23040,6,4995252314
8862,73147200,55448200,128595400,6,0,0,22528,12,707236104
8863,73153030,79325279,152478309,6,0,1,21504,12,427683202
8864,73171860,56965972,130137832,8,0,0,58880,11,6712531098
8865,73177670,55642943,128820613,3,0,0,45568,18,4345914515
8866,73181300,55558498,128739798,7,0,0,32256,1,10468736833
8867,73183250,55497454,128680704,8,0,0,9216,11,5906887154
8868,73195390,55694974,128890364,3,0,0,34304,18,8743287772
8869,73207111,79271229,152478340,9,0,1,14336,4,3687391283
8870,73227350,55406088,128633438,6,0,0,79360,12,5505434826
8871,73244150,55411205,128655355,8,0,0,22016,11,10608270317
8872,73259190,55219192,128478382,9,0,0,2560,4,4798481918
8873,73260219,80707496,153967715,5,0,1,131584,12,5122818593
8874,73262190,80948186,154210376,0,0,1,18432,6,781387910
8875,73272840,55563872,128836712,9,0,0,52736,4,10031734753
8876,73280950,55307151,128588101,0,0,0,60928,6,444764455
8877,73300650,55579239,128879889,2,0,0,26112,1,2873095024
8878,73312440,55871672,129184112,0,0,0,10240,6,5125152210
8879,73320460,55153087,128473547,2,0,0,18432,1,3954415229
8880,73323430,55548480,128871910,3,0,0,78336,18,8519017662
8881,73343650,55636180,128979830,6,0,0,8192,12,9615843998
8882,73350390,80860009,154210399,1,0,1,2560,1,374937843
8883,73387470,56908768,130296238,7,0,0,28160,1,6290175198
8884,73406550,55340447,128746997,6,0,0,23552,12,1681166624
8885,73419140,80791282,154210422,2,0,1,19456,1,251844282
8886,73419279,81376276,154795555,5,0,1,174080,12,9380842861
8887,73422639,81928731,155351370,5,0,1,372224,12,4756166689
8888,73425420,55237290,128662710,4,0,0,24064,7,4181482784
8889,73426440,55934091,129360531,7,0,0,60416,1,4825752023
8890,73438900,81937092,155375992,6,0,1,10240,12,10544330520
8891,73457099,81934834,155391933,3,0,1,3584,18,8770638683
8892,73460010,55022512,128482522,0,0,0,1024,6,10567413516
8893,73461209,82006116,155467325,5,0,1,119296,12,2483584296
8894,73462149,82490327,155952476,5,0,1,274944,12,7969688202
8895,73466950,55595751,129062701,2,0,0,15872,1,702619350
8896,73490610,55447988,128938598,4,0,0,71168,7,1596957185
8897,73528580,55571437,129100017,4,0,0,67584,7,10538681689
8898,73534440,55101985,128636425,8,0,0,9728,11,4343654005
8899,73551010,55140013,128691023,9,0,0,33792,4,9992810074
8900,73553240,55949071,129502311,1,0,0,14336,1,157587449
8901,73554840,55222049,128776889,4,0,0,33280,7,8196117515
8902,73558210,55358658,128916868,9,0,0,28160,4,5660019748
8903,73566860,82385639,155952499,4,0,1,14848,7,6425141924
8904,73581350,55360703,128942053,9,0,0,11264,4,2643440470
8905,73584650,55556308,129140958,8,0,0,35840,11,5224974772
8906,73587620,55356016,128943636,4,0,0,5120,7,7816488963
8907,73594850,82357672,155952522,7,0,1,2048,1,8041431903
8908,73595240,82404448,155999688,4,0,1,6656,7,4271119053
8909,73628660,55178046,128806706,9,0,0,32256,4,8336101718
8910,73640201,82365492,156005693,9,0,1,16384,4,10396938386
8911,73646960,82358756,156005716,2,0,1,6144,1,9634015680
8912,73660590,56289520,129950110,8,0,0,76288,11,4240052583
8913,73684190,55065482,128749672,6,0,0,8704,12,2656581757
8914,73684870,82320869,156005739,7,0,1,7680,1,3007398981
8915,73710790,82321710,156032500,7,0,1,1536,1,2645286738
8916,73724370,55616384,129340754,7,0,0,51200,1,1980833957
8917,73740580,54951402,128691982,6,0,0,3072,12,8174749183
8918,73748140,55374208,129122348,3,0,0,73216,18,4241848120
8919,73769640,55454566,129224206,2,0,0,9216,1,3262757213
8920,73780740,55216563,128997303,0,0,0,4608,6,3883340481
8921,73781610,55701950,129483560,7,0,0,34816,1,6361815968
8922,73784950,55396019,129180969,3,0,0,67072,18,9010508507
8923,73791720,55978181,129769901,3,0,0,19456,18,3064136929
8924,73811360,82221163,156032523,7,0,1,7168,1,808067736
8925,73817170,56796498,130613668,3,0,0,58368,18,4243437949
8926,73828230,82204316,156032546,7,0,1,3072,1,7846292268
8927,73829910,55565288,129395198,9,0,0,91648,4,5858382552
8928,73832490,55608398,129440888,3,0,0,47104,18,8095827996
8929,73834580,56542604,130377184,7,0,0,20480,1,7510063350
8930,73851240,55228162,129079402,9,0,0,26112,4,2751971107
8931,73854441,82178128,156032569,9,0,1,12288,4,5454155231
8932,73861650,55656382,129518032,7,0,0,25600,1,5949013773
8933,73861900,55443707,129305607,3,0,0,41472,18,10133328854
8934,73873150,55415016,129288166,3,0,0,48640,18,3639216939
8935,73877110,55580854,129457964,7,0,0,39424,1,2171611703
8936,73879990,55546523,129426513,2,0,0,38912,1,6244192757
8937,73913480,55343364,129256844,7,0,0,41984,1,1636738428
8938,73917990,82136028,156054018,0,0,1,22016,6,7835497185
8939,73924800,55761242,129686042,0,0,0,41472,6,4573731558
8940,73931550,82124238,156055788,2,0,1,18432,1,499608416
8941,73941930,55590716,129532646,8,0,0,6144,11,3677809294
8942,73961440,56558273,130519713,4,0,0,64512,7,3043093116
8943,73961460,56734462,130695922,4,0,0,100352,7,4791151568
8944,73965490,57059434,131024924,4,0,0,339456,7,2683010781
8945,73976940,55714117,129691057,8,0,0,16384,11,2188245385
8946,73980430,82075381,156055811,1,0,1,9216,1,3343110956
8947,73983150,56799916,130783066,0,0,0,144384,6,2702614587
8948,73985880,55285174,129271054,9,0,0,11264,4,9300355006
8949,73987450,55453617,129441067,8,0,0,512,11,5842172178
8950,73987600,55661381,129648981,9,0,0,35840,4,1431898815
8951,73991550,55798433,129789983,0,0,0,25600,6,963105195
8952,74011980,55751970,129763950,8,0,0,26112,11,2049471310
8953,74012090,82043744,156055834,6,0,1,1536,12,7782314633
8954,74021400,55823060,129844460,4,0,0,55808,7,1528595610
8955,74053429,82555580,156609009,5,0,1,389632,12,2144666618
8956,74082961,82571323,156654284,9,0,1,16896,4,9421757728
8957,74095560,55778632,129874192,4,0,0,60416,7,907420674
8958,74110390,55458106,129568496,7,0,0,11776,1,3617994646
8959,74117050,82542060,156659110,4,0,1,7680,7,2497410206
8960,74118080,55920844,130038924,4,0,0,89088,7,9057106554
8961,74118500,82544476,156662976,6,0,1,6144,12,1616514668
8962,74119200,55624679,129743879,9,0,0,20480,4,4611055301
8963,74136370,82537465,156673835,8,0,1,1024,11,1914241845
8964,74173710,55712848,129886558,9,0,0,18944,4,2408595429
8965,74191690,82529717,156721407,2,0,1,41472,1,8028870988
8966,74194590,55874487,130069077,4,0,0,8192,7,3814402218
8967,74208710,55490326,129699036,3,0,0,26112,18,10317554788
8968,74212490,55840436,130052926,7,0,0,8192,1,2917141481
8969,74217650,55692524,129910174,9,0,0,5632,4,4185268600
8970,74228180,55490912,129719092,0,0,0,3072,6,1340014867
8971,74230210,82492823,156723033,1,0,1,2560,1,2484920255
8972,74248400,55732759,129981159,2,0,0,512,1,5106548313
8973,74255440,55546446,129801886,3,0,0,20480,18,9752138558
8974,74269790,55888570,130158360,7,0,0,11776,1,6147692206
8975,74276200,55685367,129961567,4,0,0,9216,7,815257236
8976,74278490,55875277,130153767,2,0,0,52224,1,4890930947
8977,74284570,55758121,130042691,0,0,0,12288,6,6523514492
8978,74284720,82657265,156941985,6,0,1,8192,12,10118316325
8979,74289510,55691424,129980934,2,0,0,63488,1,5004088931
8980,74296180,55551134,129847314,7,0,0,9216,1,1094870147
8981,74324680,82617328,156942008,0,0,1,59904,6,2106440056
8982,74332550,55850354,130182904,0,0,0,40448,6,8332569289
8983,74345230,55613506,129958736,6,0,0,24064,12,7613000200
8984,74358990,55652767,130011757,6,0,0,17920,12,1955164504
8985,74371840,82628292,157000132,6,0,1,31744,12,10061112054
8986,74378870,56121164,130500034,8,0,0,34304,11,2957968212
8987,74394350,82621116,157015466,2,0,1,13312,1,1288179401
8988,74397990,56019886,130417876,9,0,0,78336,4,5667704894
8989,74398710,55523503,129922213,6,0,0,5632,12,1923556470
8990,74403000,55697937,130100937,3,0,0,22016,18,3000895877
8991,74409100,55597174,130006274,8,0,0,31232,11,1770041747
8992,74419750,55913427,130333177,7,0,0,59392,1,6878684965
8993,74441530,55509851,129951381,2,0,0,4096,1,9617398148
8994,74451850,55532789,129984639,4,0,0,10752,7,4855823674
8995,74458300,56608079,131066379,8,0,0,33280,11,4905009568
8996,74458470,82567049,157025519,7,0,1,27136,1,7603957616
8997,74472810,82552732,157025542,1,0,1,9728,1,6322278879
8998,74474030,55799599,130273629,7,0,0,16896,1,4550619031
8999,74474239,82557597,157031836,5,0,1,11264,12,8280008170
9000,74485599,82546260,157031859,3,0,1,13312,18,4527822435
9001,74488950,55742091,130231041,3,0,0,8192,18,10022744494
9002,74489850,55677737,130167587,7,0,0,30208,1,679754039
9003,74505540,56674168,131179708,2,0,0,44032,1,9823612823
9004,74516060,55790122,130306182,6,0,0,11264,12,1564506669
9005,74548940,55542985,130091925,4,0,0,18944,7,3529200692
9006,74565720,55589006,130154726,3,0,0,3072,18,1465143250
9007,74578200,82501776,157079976,4,0,1,27136,7,4205470530
9008,74595330,82484669,157079999,1,0,1,6656,1,7278899811
9009,74600320,56023534,130623854,6,0,0,33280,12,1934675501
9010,74602210,56511225,131113435,2,0,0,83456,1,3142324858
9011,74607870,56226123,130833993,6,0,0,31232,12,7721577327
9012,74625410,56400161,131025571,7,0,0,2048,1,2315304670
9013,74632960,55806663,130439623,2,0,0,19456,1,8327737461
9014,74633320,55936694,130570014,4,0,0,49152,7,10349621686
9015,74648810,55615277,130264087,7,0,0,40448,1,4826671432
9016,74651760,55903255,130555015,2,0,0,105984,1,10154686801
9017,74670480,56738388,131408868,6,0,0,56320,12,4750168524
9018,74676990,82413195,157090185,1,0,1,26624,1,10597186527
9019,74681100,56460203,131141303,6,0,0,9216,12,5032966093
9020,74684399,82957822,157642221,5,0,1,608768,12,6318883362
9021,74688710,56606305,131295015,8,0,0,95744,11,10149948643
9022,74692040,82977783,157669823,4,0,1,33792,7,7420905398
9023,74700399,82989610,157690009,3,0,1,11264,18,1567245735
9024,74700951,82989542,157690493,9,0,1,10240,4,6929639338
9025,74717461,83019978,157737439,9,0,1,19456,4,8297546212
9026,74722300,55930785,130653085,7,0,0,13824,1,9074908608
9027,74723420,55541192,130264612,0,0,0,1024,6,2135620202
9028,74728870,55853179,130582049,3,0,0,39424,18,2546080735
9029,74733210,83008636,157741846,6,0,1,6656,12,10722606431
9030,74733800,56593811,131327611,2,0,0,46592,1,10378327399
9031,74747070,56680564,131427634,8,0,0,61440,11,68890758
9032,74747700,55969172,130716872,3,0,0,50176,18,2233455883
9033,74751860,82992572,157744432,2,0,1,4096,1,6169179364
9034,74759930,56161520,130921450,2,0,0,56832,1,6969540141
9035,74762640,56061814,130824454,3,0,0,27648,18,8229483885
9036,74770180,56259938,131030118,7,0,0,14848,1,2653571407
9037,74775090,82974834,157749924,8,0,1,17920,11,682176669
9038,74778000,83021948,157799948,4,0,1,3072,7,1560688767
9039,74783480,55570186,130353666,3,0,0,15872,18,4039267645
9040,74784020,83037144,157821164,4,0,1,5120,7,4939236202
9041,74804680,83016507,157821187,8,0,1,5120,11,7753753489
9042,74841259,83111344,157952603,5,0,1,142336,12,2760437441
9043,74852730,56351877,131204607,3,0,0,58368,18,4868544505
9044,74855030,56502891,131357921,7,0,0,33280,1,6710505274
9045,74855760,83102658,157958418,7,0,1,7168,1,10247969484
9046,74867860,55780788,130648648,0,0,0,11776,6,1803877213
9047,74869790,56208811,131078601,8,0,0,9216,11,3567646466
9048,74871160,56182069,131053229,4,0,0,75776,7,7269446682
9049,74873780,56830035,131703815,2,0,0,70144,1,7316092557
9050,74882100,83077304,157959404,1,0,1,1536,1,2285668199
9051,74883610,55639090,130522700,4,0,0,9728,7,10159108925
9052,74902930,83057780,157960710,1,0,1,2048,1,6990826645
9053,74903450,55685486,130588936,2,0,0,22528,1,9303162226
9054,74917820,83073997,157991817,7,0,1,7168,1,4299034339
9055,74930460,56623263,131553723,8,0,0,156160,11,2250406994
9056,74951570,55441106,130392676,0,0,0,15872,6,3536665589
9057,74960190,83031650,157991840,0,0,1,7680,6,3527563163
9058,74991660,56169703,131161363,8,0,0,38912,11,8043229571
9059,75004680,56071082,131075762,8,0,0,30720,11,2069445765
9060,75036490,56311268,131347758,8,0,0,66048,11,1021048256
9061,75037570,55745831,130783401,8,0,0,1024,11,8171050304
9062,75038740,56210130,131248870,3,0,0,51200,18,7117434435
9063,75059850,56160692,131220542,4,0,0,52224,7,2775436876
9064,75068450,55987766,131056216,0,0,0,9728,6,9627308055
9065,75102940,55985044,131087984,7,0,0,30720,1,245277722
9066,75105100,56611553,131716653,4,0,0,26112,7,9596861255
9067,75118110,55583451,130701561,7,0,0,18432,1,5785940170
9068,75131300,56311466,131442766,4,0,0,27648,7,2028682923
9069,75145730,55690938,130836668,4,0,0,8704,7,2173226545
9070,75149900,82856610,158006510,1,0,1,19968,1,5694415868
9071,75154520,55647499,130802019,4,0,0,22016,7,695143657
9072,75156320,56702306,131858626,3,0,0,32256,18,8187297733
9073,75166150,55997740,131163890,4,0,0,8192,7,6082726266
9074,75187200,56204485,131391685,6,0,0,34304,12,6663640718
9075,75217750,56403872,131621622,9,0,0,13312,4,6158065560
9076,75227150,55922288,131149438,0,0,0,26624,6,10515862564
9077,75246480,56377973,131624453,3,0,0,9216,18,5082350525
9078,75261980,56689285,131951265,0,0,0,40960,6,7956428524
9079,75277110,56157209,131434319,3,0,0,15360,18,3378384999
9080,75283920,82746096,158030016,8,0,1,5120,11,9133217169
9081,75286490,82760422,158046912,2,0,1,16384,1,414005251
9082,75287730,56280703,131568433,9,0,0,9728,4,8953584482
9083,75293170,82818019,158111189,1,0,1,30720,1,4912290052
9084,75313870,56485743,131799613,7,0,0,54784,1,6569554788
9085,75315860,82795352,158111212,4,0,1,13824,7,611730720
9086,75320490,55812476,131132966,4,0,0,64000,7,5430148849
9087,75330700,56275214,131605914,2,0,0,94720,1,10372971438
9088,75349530,55816739,131166269,8,0,0,7680,11,10055927315
9089,75370140,56505223,131875363,6,0,0,19968,12,8865608837
9090,75400591,82711701,158112292,9,0,1,3584,4,3153661139
9091,75413420,55812761,131226181,8,0,0,18432,11,6361068835
9092,75418649,82712959,158131608,5,0,1,27136,12,2795572427
9093,75424320,55881638,131305958,0,0,0,35840,6,10116907827
9094,75435679,83215320,158650999,5,0,1,162816,12,8667423661
9095,75441930,83234620,158676550,6,0,1,3072,12,6575318311
9096,75444290,55788934,131233224,4,0,0,23040,7,2878320634
9097,75458280,83248758,158707038,2,0,1,6656,1,6129003833
9098,75473320,55665152,131138472,7,0,0,17920,1,4174089927
9099,75475110,56649295,132124405,8,0,0,53760,11,810439566
9100,75475520,55905690,131381210,4,0,0,47616,7,3127374323
9101,75491040,55768813,131259853,8,0,0,1536,11,9467242129
9102,75505910,55744231,131250141,3,0,0,4096,18,1596287190
9103,75514690,83192371,158707061,0,0,1,5120,6,880765888
9104,75521800,56326975,131848775,9,0,0,60416,4,4415793427
9105,75522130,56242977,131765107,6,0,0,10752,12,5389371797
9106,75524901,83182561,158707462,9,0,1,5632,4,9413487111
9107,75539660,56480541,132020201,7,0,0,14336,1,5853627054
9108,75539830,56748587,132288417,7,0,0,12800,1,2492263641
9109,75563090,56145584,131708674,8,0,0,15872,11,8007406498
9110,75563550,55795977,131359527,2,0,0,5120,1,7254334855
9111,75571380,55994066,131565446,6,0,0,38400,12,5739173996
9112,75577740,56039795,131617535,0,0,0,37888,6,8110230991
9113,75589539,83147719,158737258,5,0,1,3072,12,7133382334
9114,75605190,56199461,131804651,3,0,0,10240,18,9865229747
9115,75615010,83123426,158738436,0,0,1,13824,6,1001291826
9116,75659620,55835848,131495468,7,0,0,3072,1,4255689016
9117,75672081,83155519,158827600,9,0,1,44032,4,7577015677
9118,75678270,83234566,158912836,8,0,1,24064,11,9537699860
9119,75678930,56148787,131827717,9,0,0,20992,4,5358716078
9120,75682830,56052494,131735324,9,0,0,17408,4,3698866732
9121,75684540,55997880,131682420,0,0,0,49664,6,10066268017
9122,75698490,56455609,132154099,0,0,0,60416,6,8997988415
9123,75716420,56063617,131780037,4,0,0,30720,7,9865707998
9124,75717690,55859341,131577031,7,0,0,12800,1,5589074459
9125,75724210,56525895,132250105,3,0,0,152576,18,8258856098
9126,75759760,55669800,131429560,3,0,0,6144,18,10606035776
9127,75771100,56336902,132108002,7,0,0,73728,1,5881815214
9128,75771890,55679719,131451609,3,0,0,1536,18,10065696331
9129,75794930,56175895,131970825,7,0,0,19456,1,2401567428
9130,75795620,55871645,131667265,6,0,0,18432,12,10536847964
9131,75803470,56094983,131898453,4,0,0,14336,7,7429067809
9132,75808230,55952737,131760967,8,0,0,14336,11,9113196034
9133,75828650,56187160,132015810,2,0,0,26624,1,8041384697
9134,75864200,56108676,131972876,9,0,0,6656,4,7147833372
9135,75876280,56131395,132007675,2,0,0,68608,1,3086792778
9136,75890740,56625769,132516509,3,0,0,3072,18,7345860313
9137,75892010,56020187,131912197,4,0,0,25600,7,1964797450
9138,75895770,83021751,158917521,0,0,1,9728,6,1616822167
9139,75900040,56052184,131952224,8,0,0,3072,11,1533952242
9140,75905040,56180467,132085507,6,0,0,53760,12,6330372060
9141,75908160,56522556,132430716,0,0,0,5120,6,9963349163
9142,75932289,83169740,159102029,5,0,1,50688,12,5602958436
9143,75936950,56791059,132728009,4,0,0,215552,7,9067252564
9144,75940740,55951315,131892055,9,0,0,11776,4,4527608453
9145,75967390,56982075,132949465,2,0,0,18432,1,7142263489
9146,75992980,56163482,132156462,3,0,0,7680,18,9554737644
9147,76000050,83174298,159174348,6,0,1,18432,12,4694403886
9148,76002340,55799168,131801508,0,0,0,6144,6,7315553104
9149,76024950,56781426,132806376,1,0,0,39936,1,776654797
9150,76035080,56097780,132132860,6,0,0,27648,12,359683375
9151,76056870,83130320,159187190,0,0,1,8704,6,7268617539
9152,76062740,83154874,159217614,1,0,1,29696,1,10608430783
9153,76065240,56219254,132284494,8,0,0,86016,11,7562146844
9154,76067951,83215724,159283675,9,0,1,12288,4,9892240193
9155,76080770,56223393,132304163,2,0,0,19456,1,539394733
9156,76092020,83202476,159294496,2,0,1,2560,1,4374107365
9157,76108100,56307568,132415668,6,0,0,6144,12,9871037366
9158,76110410,56215147,132325557,7,0,0,7680,1,3624985462
9159,76129330,56072793,132202123,8,0,0,18944,11,8988594066
9160,76129930,55784441,131914371,3,0,0,5632,18,932177726
9161,76131200,55931705,132062905,4,0,0,44544,7,1235328358
9162,76132130,56025135,132157265,8,0,0,2560,11,820607391
9163,76140760,55928344,132069104,8,0,0,19968,11,2995246040
9164,76141820,55879496,132021316,4,0,0,3584,7,4491122218
9165,76143340,83240214,159383554,4,0,1,14336,7,4194067586
9166,76153370,56006102,132159472,7,0,0,7168,1,6252714821
9167,76171940,56343610,132515550,4,0,0,40448,7,8738705513
9168,76188300,83195277,159383577,2,0,1,9728,1,1201794442
9169,76192700,83346166,159538866,1,0,1,14336,1,8199197492
9170,76213510,56246141,132459651,9,0,0,14336,4,1115213702
9171,76226910,83311979,159538889,6,0,1,10752,12,4795301924
9172,76228070,56024554,132252624,8,0,0,8192,11,9932867094
9173,76242810,83296102,159538912,6,0,1,6144,12,2827611341
9174,76251780,56044335,132296115,2,0,0,25088,1,6620097385
9175,76264190,55898269,132162459,3,0,0,9728,18,5461513246
9176,76290680,83248255,159538935,4,0,1,17920,7,2934510058
9177,76310010,56013184,132323194,7,0,0,56320,1,3997920446
9178,76329320,83257489,159586809,1,0,1,28160,1,1421838026
9179,76338050,83248782,159586832,8,0,1,512,11,9431855630
9180,76377780,55920432,132298212,7,0,0,6656,1,7732285923
9181,76389291,83221001,159610292,9,0,1,29696,4,10642747764
9182,76391510,83241689,159633199,8,0,1,5120,11,5098128646
9183,76395770,55791171,132186941,0,0,0,5632,6,9407364098
9184,76398000,56057260,132455260,7,0,0,9728,1,6718451218
9185,76404860,55853403,132258263,6,0,0,18432,12,2383546104
9186,76407180,56155749,132562929,4,0,0,37376,7,796405517
9187,76410160,56156692,132566852,8,0,0,12800,11,4688426807
9188,76415190,56330470,132745660,2,0,0,57856,1,4918802721
9189,76436830,55925532,132362362,6,0,0,23552,12,4218536468
9190,76440400,56392675,132833075,0,0,0,87552,6,5588636892
9191,76455430,83177792,159633222,0,0,1,5120,6,671262053
9192,76478530,83154723,159633253,7,0,1,4096,1,6227115601
9193,76479300,56113356,132592656,2,0,0,65536,1,1382172228
9194,76486200,56307985,132794185,8,0,0,14848,11,6297212578
9195,76486380,56044237,132530617,9,0,0,2560,4,1978958206
9196,76501410,56481222,132982632,2,0,0,51712,1,9670501675
9197,76502840,55922942,132425782,8,0,0,19968,11,2306860838
9198,76513200,57098086,133611286,6,0,0,23040,12,8561020980
9199,76518860,83120765,159639625,6,0,1,44032,12,3190929118
9200,76524850,56515121,133039971,7,0,0,30208,1,490002365
9201,76550870,55932962,132483832,8,0,0,43008,11,7545029427
9202,76550900,56519069,133069969,6,0,0,15360,12,5759851928
9203,76555551,83088900,159644451,9,0,1,7680,4,2780466651
9204,76570740,56642716,133213456,3,0,0,61440,18,6571134726
9205,76578190,83158667,159736857,1,0,1,19968,1,10546222807
9206,76584190,56168182,132752372,3,0,0,18432,18,9975762426
9207,76606360,55993183,132599543,0,0,0,22528,6,1484348605
9208,76612100,56544991,133157091,7,0,0,43008,1,9740179788
9209,76612250,56874509,133486759,2,0,0,34304,1,6987416359
9210,76615500,56549258,133164758,3,0,0,25088,18,4433916630
9211,76619000,83168781,159787781,6,0,1,4096,12,6899725
9212,76620060,56339671,132959731,3,0,0,32768,18,9718993787
9213,76625110,56037200,132662310,3,0,0,40960,18,471963271
9214,76626610,56955412,133582022,7,0,0,87552,1,3551715547
9215,76646560,55990383,132636943,0,0,0,13824,6,5934189411
9216,76646980,56650862,133297842,3,0,0,65024,18,10242474089
9217,76648810,83205633,159854443,0,0,1,2048,6,6645632032
9218,76660370,83217074,159877444,8,0,1,26624,11,6354358503
9219,76661790,56277645,132939435,3,0,0,60416,18,4140750844
9220,76675200,83536830,160212030,8,0,1,94208,11,3145255149
9221,76680370,56382088,133062458,0,0,0,73728,6,4709404877
9222,76695400,56388975,133084375,0,0,0,13824,6,8362563836
9223,76703270,83508783,160212053,7,0,1,512,1,9928967458
9224,76734590,56524807,133259397,6,0,0,47104,12,1311604063
9225,76735420,83477020,160212440,6,0,1,6656,12,6541667706
9226,76740500,56380009,133120509,3,0,0,10240,18,4955027779
9227,76783350,56982050,133765400,2,0,0,35328,1,4448261727
9228,76793690,56321247,133114937,7,0,0,16384,1,9178858718
9229,76807240,56879924,133687164,0,0,0,110592,6,8489769875
9230,76810340,56133486,132943826,0,0,0,14336,6,3484292067
9231,76833990,56161145,132995135,6,0,0,40960,12,10344968080
9232,76838760,56075197,132913957,0,0,0,7168,6,369359215
9233,76839100,56580388,133419488,2,0,0,16896,1,4232426381
9234,76842850,56632452,133475302,4,0,0,2560,7,10133473519
9235,76849070,56117783,132966853,4,0,0,19456,7,4618654812
9236,76873160,56302073,133175233,8,0,0,34304,11,8266224028
9237,76874340,56269624,133143964,3,0,0,41472,18,4276896098
9238,76875350,57020353,133895703,4,0,0,110080,7,4271721883
9239,76889800,56190332,133080132,9,0,0,33280,4,2745832038
9240,76893160,56169789,133062949,8,0,0,1536,11,1835284704
9241,76898310,56191236,133089546,6,0,0,16896,12,10551834433
9242,76908090,56092216,133000306,3,0,0,16896,18,5473508586
9243,76932770,56312244,133245014,4,0,0,103424,7,10057636754
9244,76939780,83274926,160214706,0,0,1,3584,6,1479601804
9245,76946240,56658003,133604243,8,0,0,60416,11,4542129629
9246,76965140,83264413,160229553,4,0,1,2048,7,1916006095
9247,76965630,56472320,133437950,7,0,0,13312,1,1554078784
9248,77011259,83238528,160249787,5,0,1,22016,12,8792730870
9249,77011300,83249957,160261257,4,0,1,17920,7,10539878712
9250,77017810,56003876,133021686,0,0,0,20480,6,8843770036
9251,77022860,56443716,133466576,4,0,0,35328,7,4574451828
9252,77025110,56252897,133278007,3,0,0,60928,18,10086975915
9253,77028501,83259534,160288035,9,0,1,15360,4,2605650594
9254,77033900,56141988,133175888,4,0,0,2048,7,8749531856
9255,77042140,83264372,160306512,4,0,1,18944,7,4142958047
9256,77048650,56771490,133820140,4,0,0,1024,7,4937357709
9257,77059649,83246886,160306535,5,0,1,19456,12,8490796824
9258,77064210,56520799,133585009,3,0,0,9728,18,6945026207
9259,77068210,56517602,133585812,9,0,0,2560,4,1701948454
9260,77070760,56280683,133351443,3,0,0,26624,18,6321994661
9261,77084170,56218375,133302545,2,0,0,15360,1,10718415917
9262,77084370,56919289,134003659,4,0,0,32768,7,9818325938
9263,77093570,56885863,133979433,7,0,0,40960,1,3251478813
9264,77105880,83238772,160344652,0,0,1,1536,6,4252941074
9265,77121081,83224237,160345318,9,0,1,11264,4,6802449587
9266,77128260,56672343,133800603,7,0,0,23040,1,10142811777
9267,77149500,56193808,133343308,2,0,0,29696,1,4239743213
9268,77151910,56662686,133814596,7,0,0,18944,1,8944680982
9269,77165230,56160679,133325909,3,0,0,3584,18,56811277
9270,77179581,83166083,160345664,9,0,1,512,4,2197548910
9271,77204390,56197382,133401772,0,0,0,19456,6,4308912864
9272,77204630,56312706,133517336,6,0,0,15360,12,8705929416
9273,77213200,56827797,134040997,4,0,0,72192,7,4000805747
9274,77214220,56540393,133754613,3,0,0,115200,18,757478612
9275,77243830,83106660,160350490,2,0,1,7680,1,6097675929
9276,77258640,56454131,133712771,7,0,0,83968,1,4313864266
9277,77262720,56572019,133834739,3,0,0,44544,18,4951486148
9278,77264470,83143409,160407879,1,0,1,1536,1,10346788829
9279,77274121,83134014,160408135,9,0,1,9216,4,9980079441
9280,77301150,56599880,133901030,8,0,0,17408,11,4054043142
9281,77301220,56480606,133781826,0,0,0,4608,6,410206122
9282,77324610,56077497,133402107,7,0,0,1024,1,2930560865
9283,77337220,83074139,160411359,0,0,1,25600,6,5244448740
9284,77348190,56597990,133946180,2,0,0,33280,1,4619508124
9285,77354500,56137242,133491742,9,0,0,11264,4,5403249951
9286,77375820,56404579,133780399,3,0,0,49152,18,7345655223
9287,77376500,56696398,134072898,2,0,0,61952,1,10301807713
9288,77414140,56716392,134130532,8,0,0,45568,11,10037096766
9289,77414530,56508381,133922911,2,0,0,2048,1,3838026033
9290,77432520,56621479,134053999,3,0,0,22528,18,6213862178
9291,77447340,56599764,134047104,0,0,0,19968,6,6978930668
9292,77463680,56445017,133908697,7,0,0,25088,1,5233197272
9293,77475670,82944700,160420370,2,0,1,2560,1,4516505689
9294,77480290,82940746,160421036,0,0,1,1024,6,9916594318
9295,77488270,82934072,160422342,1,0,1,2048,1,4491764783
9296,77497100,56857805,134354905,8,0,0,153600,11,8922497097
9297,77504040,56514938,134018978,9,0,0,50176,4,7011992994
9298,77508130,56106767,133614897,9,0,0,11776,4,8740495931
9299,77516650,56573109,134089759,4,0,0,7680,7,578736874
9300,77522200,56193870,133716070,0,0,0,10752,6,9214031483
9301,77524550,56668709,134193259,4,0,0,17408,7,5003812442
9302,77528070,83041969,160570039,2,0,1,30720,1,6000274408
9303,77529660,56463992,133993652,4,0,0,46592,7,5504108303
9304,77534500,83344955,160879455,8,0,1,49664,11,8049065510
9305,77534600,56879688,134414288,7,0,0,23552,1,7022967640
9306,77553380,56836584,134389964,9,0,0,39936,4,6539377659
9307,77560510,56872777,134433287,8,0,0,14336,11,6721006586
9308,77573670,56607423,134181093,0,0,0,71168,6,9069662505
9309,77579170,83301911,160881081,4,0,1,2560,7,7044621364
9310,77598120,56964318,134562438,0,0,0,69120,6,2642834907
9311,77601950,56485446,134087396,3,0,0,30720,18,6327406177
9312,77603210,56582742,134185952,0,0,0,15872,6,6063381529
9313,77607290,56609917,134217207,4,0,0,2048,7,5211369373
9314,77609970,56616748,134226718,9,0,0,11264,4,3842019322
9315,77617270,56340635,133957905,7,0,0,18944,1,10547043740
9316,77626020,83354682,160980702,4,0,1,15360,7,1271699818
9317,77626500,57323896,134950396,2,0,0,49152,1,3166756267
9318,77628700,83360871,160989571,2,0,1,14336,1,3215151080
9319,77660890,56480273,134141163,8,0,0,34816,11,9223340995
9320,77686000,83962898,161648898,8,0,1,333824,11,9544782949
9321,77696230,57346739,135042969,2,0,0,512,1,2293754335
9322,77696991,83961774,161658765,9,0,1,13312,4,9548103816
9323,77698290,56556988,134255278,7,0,0,9216,1,9127529439
9324,77708431,83952600,161661031,9,0,1,3584,4,7954088283
9325,77710240,56667533,134377773,7,0,0,22016,1,6621295346
9326,77710920,83958813,161669733,7,0,1,11264,1,9654890704
9327,77716700,56519693,134236393,6,0,0,1024,12,8092238097
9328,77722990,83950289,161673279,4,0,1,5632,7,5492737135
9329,77723190,56644374,134367564,2,0,0,41472,1,4746416304
9330,77738180,56716096,134454276,9,0,0,66048,4,6352192061
9331,77740361,84065147,161805508,9,0,1,17408,4,5774168526
9332,77744660,56684236,134428896,0,0,0,30208,6,567028715
9333,77761670,57273181,135034851,8,0,0,45568,11,3058692489
9334,77768420,84037111,161805531,4,0,1,6656,7,10109093765
9335,77769340,56601679,134371019,5,0,0,11264,12,1079897852
9336,77791680,56612409,134404089,2,0,0,46080,1,1839590012
9337,77800740,84004814,161805554,0,0,1,15360,6,10173030568
9338,77807660,56647910,134455570,5,0,0,4096,12,1247320221
9339,77815720,57321891,135137611,1,0,0,41984,1,449268950
9340,77819090,56586894,134405984,9,0,0,6144,4,6728835296
9341,77826170,56644829,134470999,3,0,0,30208,18,8806840607
9342,77831350,56809092,134640442,6,0,0,65024,12,2901993755
9343,77832870,56761815,134594685,8,0,0,33280,11,9789356510
9344,77847140,83958437,161805577,7,0,1,6656,1,8552510230
9345,77849860,56715284,134565144,6,0,0,8704,12,1641947662
9346,77852460,83953140,161805600,1,0,1,6656,1,5226837698
9347,77854310,83984275,161838585,8,0,1,51200,11,9269771568
9348,77856870,56756390,134613260,7,0,0,3072,1,10461702018
9349,77866690,56813188,134679878,6,0,0,18944,12,9352868210
9350,77878600,84028099,161906699,8,0,1,88064,11,4892141025
9351,77900150,57407693,135307843,8,0,0,6144,11,8349316315
9352,77908890,57044961,134953851,9,0,0,11264,4,6270735935
9353,77909440,57109892,135019332,5,0,0,54784,12,6553871920
9354,77911100,56768957,134680057,7,0,0,512,1,4002521446
9355,77925250,56913264,134838514,5,0,0,6656,12,6507887364
9356,77926890,84011858,161938748,7,0,1,7680,1,5873243110
9357,77929180,56799442,134728622,3,0,0,7168,18,6506096373
9358,77950710,56984687,134935397,4,0,0,112128,7,8485019981
9359,77956040,56759981,134716021,9,0,0,15872,4,7184916331
9360,77961190,56893593,134854783,0,0,0,47616,6,9575718932
9361,77965470,56767387,134732857,5,0,0,13824,12,2150418975
9362,77966870,57005724,134972594,9,0,0,61440,4,6410901148
9363,77977490,57222717,135200207,6,0,0,30208,12,8486484770
9364,77978410,57061924,135040334,7,0,0,17920,1,1559523687
9365,77981930,83986261,161968191,7,0,1,24576,1,3345720947
9366,77996100,56715062,134711162,0,0,0,40960,6,8538308156
9367,78004340,56976264,134980604,7,0,0,11776,1,7476346250
9368,78021390,83946824,161968214,8,0,1,13312,11,1937625765
9369,78039830,57199256,135239086,8,0,0,66048,11,1887016181
9370,78044221,83924016,161968237,9,0,1,10240,4,2439163528
9371,78052350,56924643,134976993,6,0,0,14336,12,3844320545
9372,78059960,83998356,162058316,2,0,1,26624,1,469793692
9373,78061000,83998766,162059766,7,0,1,1024,1,2957609236
9374,78062090,56730153,134792243,9,0,0,21504,4,3049656214
9375,78069310,57206658,135275968,8,0,0,29696,11,6392315828
9376,78080100,57203603,135283703,6,0,0,4608,12,6319907387
9377,78087840,56716577,134804417,5,0,0,4096,12,8547567818
9378,78094260,57145721,135239981,2,0,0,2560,1,6437838213
9379,78099440,84762339,162861779,8,0,1,243200,11,8856511523
9380,78110640,57229025,135339665,5,0,0,40960,12,1267193680
9381,78121940,84740505,162862445,8,0,1,1024,11,864439369
9382,78125620,57076349,135201969,2,0,0,5632,1,9113520781
9383,78125640,56966889,135092529,2,0,0,26624,1,10519590311
9384,78127050,56997746,135124796,8,0,0,58880,11,492575383
9385,78134620,57269937,135404557,9,0,0,19968,4,5129765564
9386,78136010,56760279,134896289,4,0,0,6144,7,10501108557
9387,78136979,84884735,163021714,5,0,1,135168,12,10176351492
9388,78139110,57727657,135866767,5,0,0,15360,12,4000795995
9389,78139950,84981054,163121004,6,0,1,4096,12,4584365965
9390,78147220,56920515,135067735,2,0,0,5120,1,8453929050
9391,78148360,57042620,135190980,9,0,0,48128,4,6334667544
9392,78156070,56991704,135147774,6,0,0,33280,12,2547489945
9393,78160300,57356691,135516991,7,0,0,45056,1,7013050266
9394,78162230,84979747,163141977,2,0,1,4096,1,6226929484
9395,78194690,85015457,163210147,0,0,1,52224,6,1894628158
9396,78198930,56977317,135176247,6,0,0,48640,12,3488784300
9397,78212740,57033036,135245776,7,0,0,18944,1,6161827665
9398,78219469,85800959,164020428,5,0,1,537600,12,7393474612
9399,78220890,57337773,135558663,4,0,0,8704,7,2443701381
9400,78222080,57750031,135972111,8,0,0,41472,11,9853450193
9401,78228590,57185299,135413889,7,0,0,12800,1,9841568469
9402,78236350,85804075,164040425,4,0,1,7680,7,180788535
9403,78257180,57481488,135738668,2,0,0,67072,1,6373462642
9404,78259650,57655122,135914772,0,0,0,17408,6,8481264504
9405,78264270,57636060,135900330,3,0,0,110080,18,4590084623
9406,78268460,85815666,164084126,2,0,1,2560,1,1727306122
9407,78272420,57632925,135905345,5,0,0,16384,12,5290641755
9408,78293650,57142051,135435701,2,0,0,25088,1,6562826104
9409,78308050,85776099,164084149,7,0,1,7680,1,7204572094
9410,78328599,85945157,164273756,5,0,1,175104,12,1528008545
9411,78331750,57133334,135465084,0,0,0,25088,6,2991605559
9412,78356580,57495321,135851901,2,0,0,72192,1,5893064467
9413,78358340,57434909,135793249,3,0,0,13824,18,25612479
9414,78365230,57219928,135585158,7,0,0,1024,1,6737020646
9415,78368800,57216023,135584823,2,0,0,33280,1,10628512663
9416,78391779,85920171,164311950,3,0,1,46080,18,2367146384
9417,78401019,86163406,164564425,5,0,1,227840,12,8658750512
9418,78434960,57248323,135683283,6,0,0,43520,12,4349167840
9419,78441211,86127773,164568984,9,0,1,12800,4,9409493797
9420,78444490,57417574,135862064,9,0,0,33280,4,4883124457
9421,78445130,57202080,135647210,9,0,0,19456,4,1922615616
9422,78455330,57262783,135718113,2,0,0,51200,1,9753830051
9423,78457960,57798186,136256146,7,0,0,37888,1,10708550870
9424,78479550,57756848,136236398,2,0,0,13824,1,9078011483
9425,78496240,57950374,136446614,0,0,0,50688,6,9396603757
9426,78523510,86054732,164578242,7,0,1,19968,1,3588125744
9427,78524170,86081900,164606070,1,0,1,4608,1,8240952221
9428,78527280,57704883,136232163,3,0,0,73216,18,10541575826
9429,78528550,57792214,136320764,4,0,0,4608,7,3947537428
9430,78530060,57254983,135785043,8,0,0,2560,11,374737373
9431,78537510,56983826,135521336,6,0,0,10752,12,3839166309
9432,78552580,86054873,164607453,6,0,1,14848,12,3963413965
9433,78553370,57147876,135701246,4,0,0,58880,7,9617719807
9434,78562320,57183749,135746069,6,0,0,24064,12,1531579627
9435,78565149,86049508,164614657,3,0,1,3072,18,10363920221
9436,78565150,57644682,136209832,8,0,0,167936,11,8467888710
9437,78574260,57531787,136106047,0,0,0,57856,6,7974320366
9438,78577690,86046927,164624617,6,0,1,6656,12,4476055206
9439,78581290,57683069,136264359,7,0,0,23552,1,9867711902
9440,78587940,57321382,135909322,3,0,0,12800,18,4971259322
9441,78589920,57439323,136029243,5,0,0,15360,12,6941147809
9442,78627130,57710505,136337635,8,0,0,55296,11,7818744592
9443,78627950,57303397,135931347,4,0,0,54272,7,5058569875
9444,78632240,57447613,136079853,9,0,0,15872,4,217437441
9445,78635960,86061142,164697102,8,0,1,34304,11,4714245051
9446,78638280,57902253,136540533,5,0,0,28672,12,3522836554
9447,78642060,57940463,136582523,6,0,0,29184,12,6493271209
9448,78646310,86106179,164752489,2,0,1,16896,1,3230257682
9449,78657750,58313946,136971696,5,0,0,276992,12,7036713674
9450,78659660,57741837,136401497,9,0,0,37376,4,4702309902
9451,78675000,57633550,136308550,3,0,0,62976,18,10706966380
9452,78696910,57973303,136670213,9,0,0,18432,4,7867182319
9453,78700580,86051932,164752512,1,0,1,10752,1,8802835634
9454,78711170,57719977,136431147,3,0,0,64000,18,4026617857
9455,78715040,57604297,136319337,0,0,0,35328,6,5968409740
9456,78748030,58046527,136794557,0,0,0,72704,6,10634824820
9457,78767720,57472601,136240321,9,0,0,12800,4,5485073598
9458,78774570,85979244,164753814,7,0,1,18432,1,4155892561
9459,78789520,58268455,137057975,9,0,0,50688,4,10899033
9460,78791860,85986963,164778823,2,0,1,15360,1,3837285083
9461,78793220,85987025,164780245,2,0,1,1024,1,1547589428
9462,78798990,57901625,136700615,0,0,0,27648,6,2862132479
9463,78800020,57569903,136369923,6,0,0,7680,12,3380216813
9464,78801760,85978831,164780591,4,0,1,512,7,4978991849
9465,78833499,86053382,164886881,5,0,1,99328,12,8727810938
9466,78837510,57517204,136354714,2,0,0,48128,1,8804613204
9467,78875640,58166868,137042508,3,0,0,87040,18,9563622257
9468,78879400,86024438,164903838,2,0,1,7168,1,5021515316
9469,78893260,86016723,164909983,6,0,1,19968,12,2227657977
9470,78902680,57667765,136570445,3,0,0,19968,18,1792083733
9471,78913769,86047022,164960791,3,0,1,9728,18,1232236801
9472,78918800,58464922,137383722,0,0,0,83968,6,6282280405
9473,78923960,86036854,164960814,4,0,1,2048,7,9364941259
9474,78923970,57561929,136485899,4,0,0,46080,7,7067771375
9475,78943840,57861215,136805055,0,0,0,29696,6,3945483374
9476,78946770,58032685,136979455,6,0,0,25088,12,2324016269
9477,78956340,86004497,164960837,2,0,1,2048,1,6482362128
9478,78960850,57283729,136244579,9,0,0,13824,4,96011387
9479,78971840,57395720,136367560,4,0,0,41984,7,9835985182
9480,78974720,58283591,137258311,5,0,0,46080,12,8217226058
9481,78974990,57556428,136531418,7,0,0,33792,1,1973856459
9482,78976370,58107298,137083668,5,0,0,46592,12,4785939356
9483,78979250,58036684,137015934,9,0,0,1024,4,6019609083
9484,78986560,57993698,136980258,5,0,0,2560,12,3678032129
9485,79023710,57991858,137015568,5,0,0,104448,12,5420063510
9486,79028270,58480534,137508804,6,0,0,54784,12,5433658725
9487,79059430,85901430,164960860,6,0,1,7168,12,6404723384
9488,79072299,86343553,165415852,5,0,1,253440,12,2210407678
9489,79083350,58270513,137353863,0,0,0,51712,6,8690113876
9490,79099109,86323707,165422816,3,0,1,10752,18,10338675826
9491,79107991,86379409,165487400,9,0,1,4096,4,9058826609
9492,79112409,86375014,165487423,3,0,1,2048,18,5192735364
9493,79124770,57630581,136755351,8,0,0,4096,11,9758097350
9494,79127890,57855823,136983713,4,0,0,11264,7,7627908291
9495,79134950,58331037,137465987,7,0,0,126464,1,10310825224
9496,79138730,57308539,136447269,9,0,0,2048,4,5333936259
9497,79140320,57723837,136864157,8,0,0,95232,11,1343896669
9498,79143440,86344006,165487446,7,0,1,4608,1,6819461782
9499,79147870,57971228,137119098,6,0,0,39424,12,1294773877
9500,79149710,58163033,137312743,0,0,0,58368,6,7710729066
9501,79155620,58654188,137809808,4,0,0,86016,7,9905721660
9502,79159340,58545250,137704590,7,0,0,35840,1,1441551189
9503,79165320,57630664,136795984,8,0,0,4608,11,5452535406
9504,79172770,57991544,137164314,4,0,0,73216,7,4897971067
9505,79181440,57697816,136879256,6,0,0,12800,12,7833093093
9506,79191700,86315791,165507491,4,0,1,17408,7,5173359486
9507,79240060,57967112,137207172,5,0,0,45056,12,2875415387
9508,79243150,58283389,137526539,9,0,0,57856,4,937095524
9509,79245320,86262194,165507514,4,0,1,10752,7,3166852218
9510,79247540,57627762,136875302,9,0,0,36352,4,8967509763
9511,79253699,86363978,165617677,5,0,1,86528,12,2208702461
9512,79253820,57830027,137083847,9,0,0,512,4,220782318
9513,79259860,86377089,165636949,7,0,1,2048,1,9601166029
9514,79265670,58754065,138019735,0,0,0,29184,6,9985428594
9515,79267760,57901413,137169173,7,0,0,15872,1,7598507462
9516,79268160,58475492,137743652,5,0,0,30208,12,811402361
9517,79270220,86366752,165636972,1,0,1,7680,1,9808330996
9518,79270440,57797910,137068350,8,0,0,25600,11,1588981024
9519,79273250,58081424,137354674,8,0,0,2560,11,1568131568
9520,79286500,57974486,137260986,7,0,0,8704,1,5077262930
9521,79297540,57873528,137171068,9,0,0,6144,4,8492408360
9522,79333430,58311652,137645082,2,0,0,31232,1,6625734568
9523,79343570,86404977,165748547,4,0,1,65024,7,3719735728
9524,79348730,58078702,137427432,6,0,0,51200,12,4767885047
9525,79360220,57915008,137275228,6,0,0,39424,12,10675732399
9526,79369590,57956303,137325893,4,0,0,12288,7,3669298641
9527,79372810,57910132,137282942,0,0,0,14848,6,4461338886
9528,79374300,57963784,137338084,8,0,0,39936,11,2219588807
9529,79374500,58474564,137849064,0,0,0,14848,6,10027240562
9530,79375760,57946366,137322126,0,0,0,30720,6,10625472779
9531,79378009,86370561,165748570,5,0,1,1024,12,4026957188
9532,79378180,58710070,138088250,6,0,0,23552,12,10253718928
9533,79384750,86363843,165748593,2,0,1,8192,1,10038315009
9534,79393240,86371789,165765029,1,0,1,2560,1,6061197139
9535,79398660,57879711,137278371,3,0,0,10240,18,4767962428
9536,79405091,86362204,165767295,9,0,1,3584,4,5779478883
9537,79405100,57858093,137263193,9,0,0,7168,4,7352174876
9538,79412460,86355501,165767961,0,0,1,1024,6,8212461900
9539,79414600,58064514,137479114,0,0,0,43008,6,8460488996
9540,79427680,57929045,137356725,9,0,0,6656,4,9310178051
9541,79436090,58574730,138010820,9,0,0,118784,4,7568884169
9542,79442540,59149404,138591944,9,0,0,27648,4,2083414382
9543,79445210,58092139,137537349,2,0,0,21504,1,7540826953
9544,79462570,58134115,137596685,4,0,0,20480,7,3746834980
9545,79497810,58401644,137899454,5,0,0,66560,12,279744844
9546,79526590,57963178,137489768,6,0,0,32256,12,8363477989
9547,79529010,58492643,138021653,6,0,0,6144,12,4454468496
9548,79544690,57986084,137530774,2,0,0,13824,1,4215776995
9549,79546850,86222596,165769446,7,0,1,15360,1,696935089
9550,79550970,86219142,165770112,1,0,1,1024,1,5302680157
9551,79570610,86200373,165770983,2,0,1,12288,1,6820462272
9552,79570640,58617976,138188616,7,0,0,22528,1,1176154539
9553,79577120,58604586,138181706,5,0,0,168960,12,1928292680
9554,79586180,57893737,137479917,4,0,0,2560,7,10473251158
9555,79586900,58230575,137817475,8,0,0,25088,11,5389229576
9556,79592650,58476712,138069362,3,0,0,82944,18,3228898274
9557,79596940,59124826,138721766,2,0,0,59392,1,8130570352
9558,79611680,86165812,165777492,6,0,1,7680,12,9431423612
9559,79612210,57934119,137546329,8,0,0,2048,11,3850033664
9560,79618240,86159598,165777838,0,0,1,512,6,6420866819
9561,79623400,57949417,137572817,7,0,0,7680,1,3726371134
9562,79636400,58207696,137844096,7,0,0,55296,1,44409301
9563,79636600,58304284,137940884,8,0,0,50176,11,2601079950
9564,79643060,58562550,138205610,0,0,0,29696,6,896308663
9565,79651520,86127304,165778824,2,0,1,1536,1,5855628509
9566,79652030,58650072,138302102,2,0,0,17408,1,5523440478
9567,79660090,86208132,165868222,7,0,1,22528,1,10716074938
9568,79664620,58619236,138283856,9,0,0,8704,4,4138438572
9569,79666540,86297367,165963907,0,0,1,512,6,6040745679
9570,79675260,58446988,138122248,8,0,0,45056,11,6415908455
9571,79692070,86271860,165963930,4,0,1,3584,7,4704745693
9572,79699240,58168584,137867824,5,0,0,32256,12,5532973130
9573,79701680,86262273,165963953,8,0,1,4096,11,8513793400
9574,79709861,86254115,165963976,9,0,1,512,4,397244570
9575,79710290,58741847,138452137,4,0,0,12800,7,8553370010
9576,79715410,58393064,138108474,0,0,0,25088,6,2767117806
9577,79726400,58613009,138339409,7,0,0,7168,1,6238518298
9578,79743690,58463519,138207209,7,0,0,5120,1,907905043
9579,79752400,58322499,138074899,8,0,0,17920,11,8269231626
9580,79752900,86211099,165963999,6,0,1,4096,12,8026548665
9581,79755460,58277251,138032711,1,0,0,35840,1,9239054038
9582,79759079,86204943,165964022,3,0,1,3072,18,4187539145
9583,79763550,58565493,138329043,3,0,0,36864,18,621322055
9584,79766880,86234126,166001006,1,0,1,27648,1,5342832263
9585,79781550,59175374,138956924,1,0,0,75776,1,10179876182
9586,79790830,58405678,138196508,9,0,0,25600,4,896613084
9587,79798530,58595905,138394435,6,0,0,28160,12,6424759881
9588,79804100,86873950,166678050,4,0,1,1024,7,2960041867
9589,79809760,59076043,138885803,3,0,0,54784,18,10566002475
9590,79811740,58434793,138246533,4,0,0,14336,7,2300274398
9591,79812040,58728439,138540479,4,0,0,48128,7,8968058806
9592,79824429,86854389,166678818,3,0,1,11776,18,3984963007
9593,79836770,59393263,139230033,4,0,0,67072,7,5972718629
9594,79843400,58422230,138265630,1,0,0,5120,1,7675349998
9595,79866050,86961193,166827243,0,0,1,27136,6,6907989769
9596,79867300,86969378,166836678,0,0,1,26624,6,328061654
9597,79874690,58511079,138385769,8,0,0,15360,11,9058082797
9598,79888750,58374338,138263088,1,0,0,12288,1,3570589714
9599,79893370,86944934,166838304,1,0,1,2560,1,6097578737
9600,79906660,58775713,138682373,9,0,0,33792,4,6235279059
9601,79914740,58533474,138448214,7,0,0,10752,1,3328514667
9602,79925630,58653159,138578789,6,0,0,21504,12,442796486
9603,79928670,58422354,138351024,9,0,0,6144,4,2172872129
9604,79955980,86895034,166851014,4,0,1,9728,7,1613365206
9605,79961410,58685937,138647347,0,0,0,88064,6,5210323094
9606,79971220,58536215,138507435,5,0,0,35328,12,6909609519
9607,79971970,58456477,138428447,2,0,0,3072,1,6533658867
9608,79978330,58919748,138898078,6,0,0,9728,12,10658160431
9609,79991590,58272457,138264047,5,0,0,3072,12,817777771
9610,79998750,87171352,167170102,0,0,1,5120,6,1642711904
9611,80012410,58297423,138309833,0,0,0,3072,6,5102671869
9612,80018270,87151855,167170125,2,0,1,5120,1,3221494202
9613,80025310,58374391,138399701,4,0,0,5632,7,9635676394
9614,80037980,87150200,167188180,4,0,1,29184,7,4923617600
9615,80042020,59027576,139069596,9,0,0,26624,4,290713625
9616,80044250,58469698,138513948,5,0,0,6144,12,5006553090
9617,80046470,59312991,139359461,0,0,0,16896,6,2525738870
9618,80047940,59389063,139437003,8,0,0,92672,11,2407933808
9619,80048399,87140607,167189006,5,0,1,17408,12,1254958499
9620,80052130,58961811,139013941,5,0,0,22528,12,9594089123
9621,80055830,87133199,167189029,1,0,1,4608,1,3642277103
9622,80057350,58794903,138852253,4,0,0,47616,7,1950826436
9623,80062250,87126802,167189052,6,0,1,8704,12,1980398483
9624,80068080,59636188,139704268,2,0,0,33792,1,8976102989
9625,80074330,58583428,138657758,5,0,0,6144,12,5223525800
9626,80076040,87113035,167189075,7,0,1,1024,1,3506707564
9627,80082670,58568935,138651605,3,0,0,13824,18,2052833448
9628,80106450,58549413,138655863,7,0,0,13824,1,7506778735
9629,80110010,59681312,139791322,3,0,0,9216,18,5887242326
9630,80110390,59505696,139616086,9,0,0,168960,4,9092766308
9631,80111540,87091565,167203105,6,0,1,36352,12,8586108030
9632,80115880,58479484,138595364,3,0,0,3584,18,901544339
9633,80116760,87086368,167203128,7,0,1,10240,1,9684638394
9634,80129100,87074059,167203159,2,0,1,4608,1,9108095967
9635,80132030,58929431,139061461,6,0,0,66560,12,10718847949
9636,80140890,87124636,167265526,2,0,1,18432,1,8739835778
9637,80147810,59001015,139148825,0,0,0,7680,6,6703666127
9638,80159140,58987299,139146439,2,0,0,67072,1,1714796517
9639,80162320,60130749,140293069,7,0,0,14848,1,5591545922
9640,80180060,58682556,138862616,9,0,0,33792,4,1435109255
9641,80180720,58489853,138670573,3,0,0,41984,18,2232326654
9642,80188640,87076909,167265549,2,0,1,6144,1,3235355618
9643,80190330,58575596,138765926,8,0,0,43008,11,4417316720
9644,80208240,87057332,167265572,6,0,1,10752,12,1101846639
9645,80208880,59802594,140011474,6,0,0,62976,12,7727791450
9646,80211280,59192458,139403738,7,0,0,56320,1,6976288478
9647,80211900,59024823,139236723,7,0,0,16384,1,6543548860
9648,80221819,87043776,167265595,5,0,1,4608,12,1729999624
9649,80229250,59035959,139265209,7,0,0,88576,1,4507791974
9650,80237010,59221077,139458087,1,0,0,38912,1,7861632440
9651,80241310,60003192,140244502,8,0,0,131072,11,6101203218
9652,80244110,58723514,138967624,7,0,0,34816,1,8444166635
9653,80254950,87010676,167265626,1,0,1,14848,1,3329386206
9654,80265610,60185532,140451142,1,0,0,44544,1,4816790593
9655,80267040,86998625,167265665,1,0,1,15360,1,48698012
9656,80267560,58719192,138986752,8,0,0,12288,11,7448880677
9657,80277860,58911521,139189381,6,0,0,1024,12,3290837236
9658,80282980,60380821,140663801,1,0,0,38912,1,546114133
9659,80287720,59350968,139638688,5,0,0,62976,12,1480072354
9660,80293450,58783189,139076639,0,0,0,23040,6,5385882190
9661,80295970,58971290,139267260,9,0,0,6656,4,6014213421
9662,80312320,58974977,139287297,8,0,0,43520,11,7786256560
9663,80312549,86980695,167293244,5,0,1,9728,12,10141927978
9664,80319329,86973938,167293267,5,0,1,16384,12,2240051742
9665,80344240,58929774,139274014,0,0,0,5632,6,689676151
9666,80350030,59004237,139354267,6,0,0,107520,12,3631625259
9667,80354110,60460462,140814572,1,0,0,76288,1,5993131313
9668,80360750,59194171,139554921,8,0,0,12800,11,1746911998
9669,80382060,87163317,167545377,4,0,1,28672,7,10096516652
9670,80392750,87152650,167545400,0,0,1,5632,6,1321319721
9671,80399470,59066128,139465598,2,0,0,24576,1,3078697251
9672,80410520,87134903,167545423,8,0,1,4096,11,6195912594
9673,80427420,87118026,167545446,7,0,1,6144,1,3343310164
9674,80434840,87110629,167545469,0,0,1,15872,6,4312729391
9675,80440540,87125457,167565997,2,0,1,29696,1,129173493
9676,80454140,59538123,139992263,9,0,0,55808,4,5840319142
9677,80456470,58985374,139441844,7,0,0,15360,1,6415234251
9678,80466800,60532299,140999099,8,0,0,49664,11,8646347278
9679,80482590,59343543,139826133,0,0,0,114176,6,6532131654
9680,80492370,59127107,139619477,5,0,0,10752,12,8888913454
9681,80510049,87055971,167566020,5,0,1,9728,12,3025427767
9682,80526201,87057539,167583740,9,0,1,9216,4,998060564
9683,80526640,59261851,139788491,9,0,0,6144,4,6956264657
9684,80528260,59512923,140041183,0,0,0,1536,6,573477539
9685,80541870,58638678,139180548,0,0,0,512,6,5698366892
9686,80547480,58724795,139272275,5,0,0,16384,12,961608006
9687,80548560,58992525,139541085,1,0,0,24064,1,3799359094
9688,80561630,58905418,139467048,7,0,0,4608,1,7263638143
9689,80592490,58948774,139541264,0,0,0,512,6,9821814817
9690,80595040,58768816,139363856,6,0,0,9216,12,5019367415
9691,80618430,58671854,139290284,6,0,0,9728,12,6975576308
9692,80622540,59508044,140130584,9,0,0,2560,4,9829654168
9693,80622780,86960983,167583763,2,0,1,3584,1,1291437114
9694,80624870,59118743,139743613,7,0,0,73728,1,9471075774
9695,80649160,58907763,139556923,8,0,0,1536,11,3416392138
9696,80653650,59633757,140287407,6,0,0,44032,12,5394698582
9697,80661760,59386466,140048226,2,0,0,23040,1,6954988028
9698,80670790,86951042,167621832,7,0,1,15872,1,5491977294
9699,80678769,86943086,167621855,3,0,1,512,18,970592404
9700,80703950,58764236,139468186,4,0,0,3584,7,1954879626
9701,80709100,86912778,167621878,1,0,1,512,1,5291860433
9702,80710410,59129840,139840250,5,0,0,30208,12,8784765046
9703,80724240,59529668,140253908,8,0,0,30720,11,7887686023
9704,80729930,59165177,139895107,2,0,0,58880,1,3535781457
9705,80742390,59445883,140188273,0,0,0,7168,6,1615955168
9706,80745070,58969517,139714587,9,0,0,2560,4,1332449410
9707,80764930,58892019,139656949,9,0,0,1536,4,8175445327
9708,80766790,59737370,140504160,9,0,0,77312,4,6117680644
9709,80783529,86838372,167621901,3,0,1,2560,18,10460793554
9710,80791570,58990167,139781737,1,0,0,60416,1,1626101740
9711,80801820,59101110,139902930,8,0,0,25600,11,6339365310
9712,80804840,59796530,140601370,9,0,0,105472,4,8412275860
9713,80828190,59044105,139872295,5,0,0,9216,12,2450629058
9714,80829671,86820371,167650042,9,0,1,30208,4,1684689680
9715,80830670,59821252,140651922,5,0,0,102400,12,5679436153
9716,80831740,58999260,139831000,0,0,0,15872,6,1167411279
9717,80846300,59945005,140791305,9,0,0,31744,4,9576037602
9718,80846500,59194192,140040692,2,0,0,6656,1,6525006391
9719,80847810,59248209,140096019,0,0,0,33792,6,9043303390
9720,80850240,59354280,140204520,7,0,0,53248,1,5239357035
9721,80851260,59465683,140316943,4,0,0,46592,7,1433029726
9722,80851460,60311535,141162995,5,0,0,55296,12,8168796967
9723,80853070,86819047,167672117,7,0,1,29696,1,974487039
9724,80856980,59650479,140507459,6,0,0,10752,12,962054937
9725,80866730,59263051,140129781,1,0,0,44032,1,3303464711
9726,80866990,87168085,168035075,6,0,1,3584,12,1096412437
9727,80875530,87306916,168182446,2,0,1,20480,1,6404186020
9728,80884321,87615805,168500126,9,0,1,10752,4,1024009332
9729,80888300,59565696,140453996,8,0,0,9216,11,73641113
9730,80905590,60144480,141050070,2,0,0,1024,1,2110990469
9731,80908410,60025232,140933642,0,0,0,8192,6,5113639646
9732,80913840,59498866,140412706,7,0,0,58368,1,10709331838
9733,80920460,87579689,168500149,0,0,1,4096,6,5746417070
9734,80939750,59959666,140899416,7,0,0,24064,1,1733673813
9735,80961290,59642599,140603889,4,0,0,8192,7,1910516364
9736,80972570,59066071,140038641,2,0,0,89088,1,10058484229
9737,80974450,59637620,140612070,6,0,0,26624,12,4062890577
9738,80979411,87872093,168851504,9,0,1,39936,4,2447729709
9739,80983200,58803396,139786596,4,0,0,15872,7,4861316976
9740,81000850,60355959,141356809,6,0,0,60928,12,2381336616
9741,81004560,59111782,140116342,8,0,0,5120,11,5749373935
9742,81007340,87844187,168851527,7,0,1,3072,1,8934131210
9743,81020850,59253118,140273968,0,0,0,64000,6,8344692057
9744,81024380,60034472,141058852,4,0,0,28672,7,1771645503
9745,81035750,59266974,140302724,8,0,0,28160,11,6586876108
9746,81044640,87902922,168947562,1,0,1,30720,1,10727382416
9747,81051910,60142651,141194561,2,0,0,103424,1,5705089057
9748,81067770,59960166,141027936,0,0,0,93184,6,3590540754
9749,81076170,59247348,140323518,4,0,0,21504,7,2308695299
9750,81076860,59261959,140338819,1,0,0,17920,1,10348943656
9751,81086121,88003156,169089277,9,0,1,35840,4,741568565
9752,81094370,59589026,140683396,0,0,0,1024,6,2590775891
9753,81117060,60456844,141573904,1,0,0,171008,1,3225911132
9754,81119580,88056916,169176496,1,0,1,6656,1,4906512675
9755,81179950,60202653,141382603,8,0,0,71168,11,10694295311
9756,81187770,87990672,169178442,7,0,1,3072,1,10365295630
9757,81188569,87991499,169180068,5,0,1,2560,12,7591696469
9758,81189870,59507909,140697779,5,0,0,27136,12,7036508004
9759,81191580,59739497,140931077,8,0,0,80896,11,7740301119
9760,81216200,59767744,140983944,6,0,0,28160,12,3739351988
9761,81242970,87951142,169194112,8,0,1,13312,11,7795327488
9762,81246150,60466681,141712831,7,0,0,66560,1,7230351910
9763,81247380,59369721,140617101,0,0,0,16384,6,3018402602
9764,81251560,59036962,140288522,0,0,0,3584,6,3254334913
9765,81256400,59704923,140961323,3,0,0,37888,18,8120801391
9766,81261610,60234601,141496211,6,0,0,221696,12,498400523
9767,81279050,59394515,140673565,9,0,0,2048,4,394503596
9768,81282070,59536904,140818974,4,0,0,8192,7,865493151
9769,81283450,88015831,169299281,8,0,1,2560,11,356183158
9770,81287260,59557282,140844542,8,0,0,17408,11,3188810779
9771,81296519,88021604,169318123,3,0,1,30208,18,9660393470
9772,81309180,59919316,141228496,2,0,0,3072,1,8721895773
9773,81328870,59133690,140462560,6,0,0,4096,12,1910313391
9774,81330660,88219112,169549772,7,0,1,12288,1,841292007
9775,81342900,59745208,141088108,9,0,0,39936,4,2729582039
9776,81348500,59951063,141299563,1,0,0,20992,1,10243264442
9777,81364980,60357101,141722081,3,0,0,30208,18,5456780073
9778,81365320,60358656,141723976,8,0,0,6144,11,7778760057
9779,81369940,60051960,141421900,7,0,0,16384,1,9854363952
9780,81372920,59840742,141213662,1,0,0,48128,1,3193491923
9781,81378490,59671245,141049735,1,0,0,44544,1,5937964930
9782,81385470,59735778,141121248,4,0,0,50176,7,5353873925
9783,81396480,59307562,140704042,2,0,0,20480,1,4756594679
9784,81414340,88261970,169676310,1,0,1,16384,1,7264941989
9785,81424150,60468385,141892535,6,0,0,54272,12,10684855361
9786,81429090,59473001,140902091,3,0,0,8704,18,3685116733
9787,81430050,59242868,140672918,2,0,0,4608,1,10159907793
9788,81436530,60439446,141875976,0,0,0,96256,6,962791666
9789,81439970,88243718,169683688,8,0,1,15872,11,2765138927
9790,81446030,59219978,140666008,9,0,0,7168,4,1208681979
9791,81447470,88258774,169706244,8,0,1,30208,11,4405330017
9792,81452419,88321847,169774266,3,0,1,2560,18,7873411071
9793,81464520,88528985,169993505,0,0,1,100864,6,6074788728
9794,81466780,59758823,141225603,7,0,0,32768,1,2609827459
9795,81477200,59883688,141360888,9,0,0,13312,4,3672258017
9796,81481310,59232157,140713467,3,0,0,14336,18,10555781844
9797,81484800,60414792,141899592,2,0,0,22528,1,5838133344
9798,81502890,59168601,140671491,6,0,0,17920,12,7869266622
9799,81507480,59235465,140742945,9,0,0,4096,4,7745093352
9800,81507580,59637741,141145321,9,0,0,55296,4,8167405991
9801,81511240,59304603,140815843,9,0,0,4096,4,3943910094
9802,81515580,88509332,170024912,6,0,1,2048,12,3291533431
9803,81518890,59581785,141100675,4,0,0,27136,7,9999795184
9804,81520440,60698455,142218895,8,0,0,47616,11,2737250860
9805,81523619,88501316,170024935,5,0,1,8704,12,9218116009
9806,81530670,59346924,140877594,7,0,0,3584,1,3756828415
9807,81542930,60436234,141979164,3,0,0,16896,18,6237344093
9808,81544510,59850665,141395175,0,0,0,12288,6,2477582259
9809,81551750,59675771,141227521,2,0,0,6144,1,5492482617
9810,81552230,61144126,142696356,3,0,0,62464,18,3529649967
9811,81554120,60789253,142343373,4,0,0,91648,7,1061924124
9812,81564480,60105612,141670092,9,0,0,41984,4,4406423423
9813,81566120,88491654,170057774,6,0,1,2560,12,3829717014
9814,81584979,88513403,170098382,5,0,1,33280,12,5378197479
9815,81599540,59476377,141075917,4,0,0,4096,7,1769253051
9816,81600020,59598932,141198952,8,0,0,14336,11,3876139062
9817,81607370,59680343,141287713,3,0,0,512,18,5123821438
9818,81607690,88612997,170220687,0,0,1,32768,6,8521429135
9819,81609070,59364811,140973881,3,0,0,9216,18,9978932677
9820,81658650,88579527,170238177,0,0,1,14336,6,9549478877
9821,81660500,59660197,141320697,3,0,0,7680,18,8187305220
9822,81664440,60849162,142513602,0,0,0,15872,6,3603228484
9823,81684020,59707365,141391385,6,0,0,21504,12,10564096310
9824,81684650,59957909,141642559,6,0,0,58368,12,1297802426
9825,81686910,61109017,142795927,6,0,0,53760,12,2814242667
9826,81689010,59891024,141580034,1,0,0,10240,1,9980028047
9827,81699450,59818000,141517450,6,0,0,69632,12,7774248840
9828,81704690,59620866,141325556,6,0,0,15872,12,4405478174
9829,81726660,59658150,141384810,9,0,0,7168,4,5521091117
9830,81729820,61232493,142962313,8,0,0,24064,11,4641605728
9831,81730670,59298225,141028895,6,0,0,3072,12,9213901674
9832,81733850,88566487,170300337,8,0,1,16896,11,10229321403
9833,81735890,88564470,170300360,2,0,1,9728,1,507713093
9834,81739710,88561476,170301186,6,0,1,10240,12,432623521
9835,81742570,60191144,141933714,1,0,0,25088,1,6998554267
9836,81746839,88634137,170380976,3,0,1,17408,18,3770109502
9837,81747560,60397775,142145335,3,0,0,14848,18,9471497913
9838,81747960,59398164,141146124,1,0,0,2560,1,4816615430
9839,81748990,60210137,141959127,9,0,0,24576,4,8074782664
9840,81766220,59822627,141588847,2,0,0,17920,1,2246325548
9841,81773630,59441950,141215580,1,0,0,6144,1,4271712243
9842,81788350,59731642,141519992,7,0,0,8192,1,849438534
9843,81796550,60712193,142508743,6,0,0,63488,12,2023440462
9844,81798020,60266838,142064858,1,0,0,11776,1,7621793417
9845,81802070,60451199,142253269,9,0,0,56320,4,10500294781
9846,81804550,60169443,141973993,3,0,0,44544,18,632998946
9847,81806020,59770871,141576891,9,0,0,9728,4,8722698703
9848,81807430,61279000,143086430,0,0,0,8192,6,8632569453
9849,81809410,59841596,141651006,2,0,0,27648,1,2253757733
9850,81814540,88566459,170380999,6,0,1,13312,12,7302893860
9851,81824850,60227326,142052176,4,0,0,81920,7,8095417297
9852,81828020,59693757,141521777,6,0,0,5632,12,1085745578
9853,81835780,61428682,143264462,3,0,0,5632,18,1889545850
9854,81840630,60119768,141960398,9,0,0,4096,4,2947007771
9855,81844130,59832849,141676979,9,0,0,22528,4,9316686947
9856,81866880,59890932,141757812,7,0,0,38912,1,2291794691
9857,81873380,60052667,141926047,2,0,0,23040,1,2855330441
9858,81877150,88503872,170381022,7,0,1,13824,1,3599306849
9859,81879130,59921084,141800214,4,0,0,27136,7,5148514984
9860,81881180,59945836,141827016,3,0,0,3072,18,6512028586
9861,81884310,60351768,142236078,7,0,0,56320,1,4867435934
9862,81890069,88540471,170430540,5,0,1,10240,12,1345272350
9863,81899910,88532256,170432166,8,0,1,2560,11,705960239
9864,81951450,60307146,142258596,9,0,0,17408,4,9817694288
9865,81952540,60035406,141987946,6,0,0,21504,12,9160651745
9866,81960780,60132870,142093650,2,0,0,23552,1,8780934133
9867,81963019,88569934,170532953,3,0,1,35328,18,5466618105
9868,81967980,88603733,170571713,1,0,1,3584,1,10206658354
9869,81976410,60419902,142396312,3,0,0,24064,18,5265933764
9870,81978010,60209088,142187098,3,0,0,54784,18,3951323430
9871,81985780,59595837,141581617,6,0,0,5120,12,10403068950
9872,81986540,59692022,141678562,2,0,0,5120,1,10358057411
9873,81995620,88580599,170576219,4,0,1,7168,7,4344363022
9874,82001870,60137267,142139137,5,0,0,9216,12,3163639059
9875,82011910,60303516,142315426,2,0,0,55296,1,6892229467
9876,82017340,60390921,142408261,7,0,0,32256,1,8703765140
9877,82018160,88842014,170860174,0,0,1,60928,6,927087680
9878,82028620,60412778,142441398,4,0,0,44032,7,5625030457
9879,82035240,61326513,143361753,6,0,0,21504,12,7163184470
9880,82036270,88829764,170866034,2,0,1,18944,1,1306565688
9881,82039290,60226068,142265358,4,0,0,20480,7,5581213162
9882,82057260,60201827,142259087,7,0,0,1536,1,7027247920
9883,82061560,59529026,141590586,9,0,0,5632,4,1498458420
9884,82069960,59738256,141808216,1,0,0,7168,1,2472472388
9885,82075270,59508094,141583364,0,0,0,5632,6,6261881867
9886,82078509,88835446,170913955,5,0,1,9216,12,5880798101
9887,82080799,88858151,170938950,5,0,1,14848,12,8102577673
9888,82087900,59569369,141657269,1,0,0,20480,1,8032717238
9889,82091420,60336539,142427959,4,0,0,32768,7,2242025903
9890,82091429,88949277,171040706,5,0,1,38912,12,6267702027
9891,82129470,60444328,142573798,3,0,0,41472,18,8395646114
9892,82146920,60414219,142561139,3,0,0,51712,18,9062554619
9893,82152269,89085108,171237377,3,0,1,9728,18,7714576601
9894,82153250,61361660,143514910,3,0,0,56832,18,9050943071
9895,82160580,60462128,142622708,4,0,0,53760,7,3410518218
9896,82183180,60652257,142835437,7,0,0,5632,1,4280633000
9897,82190600,60189888,142380488,2,0,0,12288,1,6672983905
9898,82203330,59737895,141941225,3,0,0,24576,18,888248611
9899,82240560,60473713,142714273,0,0,0,26112,6,1144210298
9900,82240950,59565059,141806009,2,0,0,18944,1,5909764286
9901,82250809,89042907,171293716,3,0,1,13312,18,9955867770
9902,82254720,60491636,142746356,8,0,0,58368,11,6430163663
9903,82255680,59877853,142133533,0,0,0,26112,6,1813256942
9904,82277410,59703961,141981371,3,0,0,7168,18,2707328000
9905,82284999,89111625,171396624,3,0,1,30208,18,5666050248
9906,82300389,90171689,172472078,5,0,1,538112,12,9128268401
9907,82306010,61318867,143624877,7,0,0,40960,1,391727673
9908,82317510,60693388,143010898,7,0,0,102912,1,7802731318
9909,82317710,59743537,142061247,2,0,0,29696,1,568193300
9910,82319790,59621770,141941560,0,0,0,1024,6,4194964462
9911,82329270,60561511,142890781,6,0,0,26624,12,6606158427
9912,82329580,60754331,143083911,3,0,0,22528,18,8009071260
9913,82347040,60770417,143117457,8,0,0,53248,11,4839978622
9914,82365190,59988658,142353848,6,0,0,34304,12,8985511654
9915,82374120,60652759,143026879,2,0,0,52224,1,10542723360
9916,82379659,90147172,172526831,3,0,1,31232,18,10024867500
9917,82384410,60241129,142625539,8,0,0,9216,11,5485833718
9918,82391141,90135713,172526854,9,0,1,20992,4,2166527307
9919,82407020,61173053,143580073,1,0,0,23040,1,3452995972
9920,82426130,60546814,142972944,8,0,0,34816,11,10000759693
9921,82433270,90093607,172526877,6,0,1,7168,12,4312590101
9922,82442590,60336934,142779524,6,0,0,36864,12,9962964382
9923,82473439,90415876,172889315,5,0,1,279040,12,2695163632
9924,82477340,61598257,144075597,3,0,0,180736,18,3101825710
9925,82491090,61228089,143719179,2,0,0,31744,1,2488576878
9926,82501070,59794506,142295576,4,0,0,10752,7,6325925075
9927,82506540,61700492,144207032,4,0,0,71680,7,9870057052
9928,82513130,60975058,143488188,8,0,0,8192,11,7682425213
9929,82518280,90384240,172902520,0,0,1,2048,6,2168550733
9930,82524180,60961489,143485669,4,0,0,34304,7,8611246076
9931,82530810,60060015,142590825,9,0,0,55808,4,4576519037
9932,82543700,60730301,143274001,0,0,0,31232,6,7924364086
9933,82553210,60401748,142954958,0,0,0,67072,6,9025100991
9934,82555640,60338509,142894149,8,0,0,10752,11,544854979
9935,82560731,90341812,172902543,9,0,1,1536,4,2730582358
9936,82569750,90332816,172902566,2,0,1,3072,1,6067182049
9937,82572250,59839310,142411560,2,0,0,10752,1,5265841971
9938,82595000,60133549,142728549,0,0,0,26624,6,2078864382
9939,82596350,60383169,142979519,7,0,0,21504,1,1617695647
9940,82603340,60655928,143259268,4,0,0,38912,7,10694632819
9941,82610480,60272166,142882646,0,0,0,43008,6,5674470291
9942,82620280,60691541,143311821,1,0,0,18944,1,7220924238
9943,82622910,90282668,172905578,4,0,1,6656,7,6710150824
9944,82623840,59765117,142388957,0,0,0,27136,6,3209745467
9945,82639790,59716421,142356211,8,0,0,7680,11,10485446307
9946,82643830,60453231,143097061,3,0,0,34816,18,434419925
9947,82664600,90259779,172924379,2,0,1,23040,1,10560320045
9948,82668200,60387094,143055294,7,0,0,93184,1,3733213857
9949,82676600,60192919,142869519,2,0,0,44544,1,4374983907
9950,82682900,60752421,143435321,6,0,0,1024,12,1390793843
9951,82685870,60240513,142926383,3,0,0,16896,18,141005033
9952,82695400,90232614,172928014,4,0,1,1536,7,3662003117
9953,82698880,60101282,142800162,7,0,0,13824,1,1721878782
9954,82706820,59994863,142701683,2,0,0,17408,1,5820568889
9955,82717870,60359154,143077024,7,0,0,22016,1,842513319
9956,82721860,60443995,143165855,3,0,0,6144,18,8950399168
9957,82722690,90214281,172936971,6,0,1,13312,12,6032544846
9958,82725080,90216239,172941319,0,0,1,1536,6,2146546830
9959,82725269,90238979,172964248,3,0,1,20480,18,5233696470
9960,82728990,60518399,143247389,3,0,0,105472,18,8285607204
9961,82737410,59939891,142677301,0,0,0,19456,6,5084707846
9962,82738860,59902302,142641162,6,0,0,51200,12,8260596024
9963,82756650,60901909,143658559,1,0,0,46080,1,6714751745
9964,82759140,59760601,142519741,7,0,0,10240,1,7082177186
9965,82761830,60754858,143516688,8,0,0,4608,11,2241466747
9966,82763100,60913723,143676823,3,0,0,11776,18,9433067704
9967,82790600,60621940,143412540,4,0,0,2048,7,9752542409
9968,82793490,60607130,143400620,1,0,0,127488,1,9858373951
9969,82794930,60369007,143163937,3,0,0,49152,18,8472363949
9970,82796100,60863574,143659674,8,0,0,3584,11,9669456528
9971,82802940,60459783,143262723,7,0,0,11264,1,7844893793
9972,82804710,90159561,172964271,6,0,1,5632,12,3591494878
9973,82818190,60397040,143215230,7,0,0,32768,1,10558369516
9974,82819910,60279358,143099268,1,0,0,7168,1,2001881220
9975,82844619,90139390,172984009,5,0,1,36864,12,8262497194
9976,82845500,90141198,172986698,8,0,1,6144,11,604368639
9977,82847100,60301838,143148938,6,0,0,16896,12,3704092769
9978,82859710,60210583,143070293,3,0,0,49152,18,8544719583
9979,82893450,60896311,143789761,6,0,0,13312,12,9919663279
9980,82893940,60207270,143101210,3,0,0,6144,18,4035139624
9981,82895910,60533437,143429347,3,0,0,53760,18,7476508258
9982,82902870,61053856,143956726,2,0,0,34304,1,7640626122
9983,82905860,60546799,143452659,3,0,0,41472,18,9222828307
9984,82925170,90070310,172995480,1,0,1,1536,1,493795274
9985,82925989,90124909,173050898,5,0,1,15360,12,2721508883
9986,82940230,60203537,143143767,3,0,0,45056,18,7935258103
9987,82940460,60557111,143497571,1,0,0,30720,1,1504241929
9988,82940780,60616169,143556949,1,0,0,37888,1,6476530276
9989,82942760,60764155,143706915,7,0,0,58880,1,3349496345
9990,82943000,60468893,143411893,2,0,0,12800,1,6299576884
9991,82950370,60170238,143120608,2,0,0,10240,1,8151361230
9992,82952040,61179091,144131131,4,0,0,20480,7,582033590
9993,82954400,61140025,144094425,7,0,0,39424,1,1053043952
9994,82956240,61356687,144312927,3,0,0,216576,18,6937152645
9995,82967649,90083272,173050921,3,0,1,8704,18,2679807535
9996,82967650,61042537,144010187,9,0,0,6656,4,9666837529
9997,82973750,61482812,144456562,3,0,0,292352,18,2136291114
9998,82987030,61257602,144244632,3,0,0,32768,18,2977896867
9999,82993520,61230273,144223793,7,0,0,37888,1,10733947804
10000,83035640,90020943,173056583,4,0,1,3584,7,5169947834
10001,83041800,60519384,143561184,8,0,0,13824,11,88598952
10002,83055290,60613923,143669213,7,0,0,31232,1,3276508953
10003,83057790,60347542,143405332,4,0,0,1024,7,5358571969
10004,83059510,60612846,143672356,8,0,0,10240,11,7257775950
10005,83068850,60446411,143515261,3,0,0,1024,18,4215528825
10006,83080290,61044578,144124868,0,0,0,99840,6,9499844526
10007,83088550,60541053,143629603,7,0,0,3584,1,9509938580
10008,83094510,61444750,144539260,4,0,0,16384,7,2762677651
10009,83104930,60875259,143980189,3,0,0,54784,18,6461568539
10010,83106440,60328546,143434986,8,0,0,18432,11,1865151991
10011,83113680,61459118,144572798,3,0,0,73728,18,9148646388
10012,83121290,60507198,143628488,6,0,0,11776,12,7654775957
10013,83132050,61399809,144531859,7,0,0,65536,1,7523956991
10014,83149690,89906916,173056606,8,0,1,3584,11,367017710
10015,83153780,61320277,144474057,6,0,0,57344,12,3285456277
10016,83155210,89933647,173088857,7,0,1,17920,1,29896926
10017,83169859,89931595,173101454,5,0,1,28160,12,8262311052
10018,83179830,60765035,143944865,4,0,0,25088,7,2668104791
10019,83180280,60590884,143771164,1,0,0,23040,1,8754481468
10020,83185930,89918110,173104040,1,0,1,4096,1,10160700401
10021,83215510,61368911,144584421,3,0,0,15360,18,8807352907
10022,83240490,61100852,144341342,0,0,0,93184,6,9547421365
10023,83243520,89861084,173104604,6,0,1,10752,12,5110859806
10024,83244720,89866145,173110865,2,0,1,29696,1,8373622620
10025,83245180,61841559,145086739,1,0,0,29696,1,8093200520
10026,83256930,89872971,173129901,7,0,1,6656,1,2989006563
10027,83307539,89822385,173129924,5,0,1,8704,12,3549626673
10028,83308270,60903956,144212226,7,0,0,8192,1,9342788412
10029,83309710,60875459,144185169,0,0,0,31744,6,3757019117
10030,83314780,61041561,144356341,6,0,0,49152,12,6039051032
10031,83321380,61190396,144511776,3,0,0,14848,18,3654459869
10032,83327410,89805732,173133142,8,0,1,18944,11,2883786509
10033,83332570,89801238,173133808,4,0,1,1024,7,10310834058
10034,83333880,61151455,144485335,6,0,0,7168,12,3528827832
10035,83337840,60559726,143897566,6,0,0,13312,12,7907692585
10036,83340280,61549091,144889371,3,0,0,4608,18,7761992566
10037,83343620,60866087,144209707,0,0,0,8704,6,779119480
10038,83344660,61922284,145266944,6,0,0,63488,12,2443177262
10039,83357481,89791502,173148983,9,0,1,27136,4,7502728633
10040,83361990,89928266,173290256,0,0,1,2048,6,10454676637
10041,83381921,89910097,173292018,9,0,1,6144,4,9429806516
10042,83393370,60378129,143771499,9,0,0,1024,4,6275073250
10043,83402000,61675668,145077668,1,0,0,52224,1,4498116123
10044,83405520,60676847,144082367,2,0,0,22016,1,7684371938
10045,83406510,60601626,144008136,8,0,0,91648,11,7716012148
10046,83409329,89882712,173292041,3,0,1,3584,18,4879246587
10047,83413499,89878754,173292253,3,0,1,8192,18,2976634533
10048,83417530,61155619,144573149,8,0,0,1024,11,5711476268
10049,83426830,61854928,145281758,3,0,0,5120,18,4712920758
10050,83429740,90010115,173439855,2,0,1,30208,1,2144177709
10051,83434870,61065932,144500802,3,0,0,50688,18,5933490431
10052,83447480,89992398,173439878,0,0,1,5632,6,7806819981
10053,83455260,60775044,144230304,6,0,0,20992,12,9433164255
10054,83472390,61961856,145434246,8,0,0,69632,11,8513615917
10055,83473130,61938754,145411884,7,0,0,11776,1,3031094631
10056,83485400,60535106,144020506,7,0,0,33792,1,3135417511
10057,83499740,61121995,144621735,8,0,0,5632,11,6701359452
10058,83500180,89939721,173439901,4,0,1,1536,7,9036914669
10059,83521460,60342403,143863863,7,0,0,23040,1,7826360457
10060,83565960,60983197,144549157,1,0,0,32256,1,9893317473
10061,83585160,61930683,145515843,8,0,0,44032,11,572275871
10062,83585830,60589628,144175458,4,0,0,145408,7,3363512841
10063,83606410,60640082,144246492,3,0,0,3584,18,836210098
10064,83607160,60754508,144361668,6,0,0,17408,12,9688730104
10065,83612900,61886166,145499066,3,0,0,47104,18,3516999991
10066,83618200,60932111,144550311,3,0,0,2048,18,7115618744
10067,83619300,61683095,145302395,1,0,0,13312,1,4581870148
10068,83629780,61324905,144954685,0,0,0,17408,6,7028751101
10069,83682780,60920523,144603303,0,0,0,5632,6,7134902867
10070,83694081,89745843,173439924,9,0,1,3072,4,3301988075
10071,83701300,89738647,173439947,0,0,1,13312,6,1618021140
10072,83703030,62174578,145877608,6,0,0,28672,12,4596806304
10073,83704580,61134241,144838821,6,0,0,107008,12,7347000562
10074,83707910,62281076,145988986,3,0,0,46080,18,4946028109
10075,83712120,61007937,144720057,4,0,0,100352,7,7912348248
10076,83724210,60783011,144507221,8,0,0,20992,11,10537297647
10077,83728100,60755028,144483128,2,0,0,29696,1,6958003383
10078,83745870,89694100,173439970,8,0,1,2048,11,9814219633
10079,83758040,60609423,144367463,0,0,0,18944,6,5735063383
10080,83770889,90368243,174139132,3,0,1,159744,18,2438317844
10081,83781510,90359888,174141398,1,0,1,3584,1,5232101586
10082,83787279,91120350,174907629,3,0,1,178176,18,1981687018
10083,83790040,61662939,145452979,4,0,0,512,7,492322851
10084,83808830,61433945,145242775,2,0,0,126976,1,193585841
10085,83814660,60734988,144549648,6,0,0,1536,12,8599888724
10086,83817430,60716792,144534222,9,0,0,7680,4,1736449418
10087,83829820,61995339,145825159,5,0,0,19456,12,2779575666
10088,83834050,61746552,145580602,2,0,0,27648,1,6187748117
10089,83859650,91062241,174921891,2,0,1,8704,1,9546822800
10090,83865570,62093239,145958809,7,0,0,48640,1,2817362180
10091,83874960,62914155,146789115,8,0,0,26624,11,795353208
10092,83875780,62782475,146658255,4,0,0,19968,7,1464080535
10093,83878150,62856431,146734581,1,0,0,92672,1,2470140342
10094,83888020,62966539,146854559,2,0,0,54272,1,4012236393
10095,83898220,61554511,145452731,7,0,0,17408,1,4706867264
10096,83906190,61429635,145335825,5,0,0,2048,12,98814835
10097,83907000,62011003,145918003,7,0,0,3072,1,10114550052
10098,83912900,62592217,146505117,7,0,0,759808,1,10090443728
10099,83920150,91001764,174921914,8,0,1,3584,11,5288417628
10100,83923400,61401330,145324730,1,0,0,30208,1,408732329
10101,83939830,61468443,145408273,8,0,0,134656,11,6459616534
10102,83942460,60979381,144921841,4,0,0,4608,7,6487159818
10103,83950610,61917967,145868577,8,0,0,14848,11,5436178659
10104,83952990,60660643,144613633,5,0,0,3072,12,8937698689
10105,83953110,61163447,145116557,7,0,0,24576,1,1715821845
10106,83955330,61566620,145521950,7,0,0,19968,1,6788584940
10107,83968930,90953758,174922688,6,0,1,17920,12,2750004034
10108,83973360,61303926,145277286,7,0,0,10752,1,5116253232
10109,83981640,61587054,145568694,0,0,0,20480,6,7407664872
10110,83982130,90942504,174924634,8,0,1,3072,11,2264810254
10111,83997010,61612536,145609546,0,0,0,26624,6,7991432842
10112,83997970,90930850,174928820,6,0,1,6656,12,4352215488
10113,84002000,62650079,146652079,5,0,0,1024,12,6478500674
10114,84002480,61678859,145681339,2,0,0,89088,1,7752857844
10115,84022140,60862062,144884202,8,0,0,24064,11,851316113
10116,84036670,61123497,145160167,8,0,0,35328,11,3492689679
10117,84043380,61686517,145729897,8,0,0,20480,11,2590290781
10118,84053910,62829235,146883145,0,0,0,49664,6,1018066061
10119,84070040,90903430,174973470,4,0,1,22528,7,9594887816
10120,84073760,60676468,144750228,1,0,0,24064,1,9460387228
10121,84085630,61525343,145610973,6,0,0,4608,12,6922990547
10122,84086390,60783059,144869449,4,0,0,3584,7,10103270025
10123,84089800,61184187,145273987,8,0,0,23040,11,1372161252
10124,84093191,91065093,175158284,9,0,1,22528,4,7064380817
10125,84095130,60832141,144927271,1,0,0,10752,1,1562661769
10126,84114960,62458779,146573739,3,0,0,69120,18,9939272640
10127,84123100,61425237,145548337,8,0,0,86528,11,6324457651
10128,84129180,60710132,144839312,3,0,0,1536,18,3346988870
10129,84151250,62036912,146188162,4,0,0,4096,7,890504983
10130,84152550,60901903,145054453,8,0,0,3584,11,9616192396
10131,84161610,61285786,145447396,3,0,0,43008,18,7393830998
10132,84169290,61393110,145562400,2,0,0,46080,1,5417725064
10133,84170320,61581689,145752009,1,0,0,35840,1,251149031
10134,84183430,63314015,147497445,3,0,0,53248,18,5102976690
10135,84192060,62796587,146988647,6,0,0,48128,12,7771173750
10136,84192080,61568225,145760305,5,0,0,20992,12,6311953713
10137,84217730,62610631,146828361,9,0,0,30720,4,10683660606
10138,84218320,62562598,146780918,7,0,0,35840,1,734333994
10139,84219130,61819954,146039084,8,0,0,1536,11,4932556487
10140,84223800,62464078,146687878,7,0,0,27648,1,8276001840
10141,84247670,62425584,146673254,5,0,0,49152,12,10177737650
10142,84268590,61933063,146201653,3,0,0,3072,18,7846032159
10143,84270260,62332876,146603136,5,0,0,60416,12,4840713438
10144,84274750,61066086,145340836,3,0,0,3584,18,3384757397
10145,84278670,61621425,145900095,0,0,0,73728,6,7631604918
10146,84299651,90901796,175201447,9,0,1,4608,4,180051267
10147,84317110,61423956,145741066,4,0,0,5120,7,7860724122
10148,84317150,90884963,175202113,1,0,1,11264,1,1324823487
10149,84318430,61094569,145412999,4,0,0,3584,7,5049350107
10150,84322591,90912028,175234619,9,0,1,5632,4,5946152762
10151,84330940,62434644,146765584,4,0,0,77824,7,1796579974
10152,84332889,90906876,175239765,5,0,1,8192,12,353704231
10153,84339190,61635733,145974923,9,0,0,51712,4,6733287736
10154,84350580,61338894,145689474,8,0,0,26624,11,2668895750
10155,84356570,61449669,145806239,9,0,0,33792,4,1083798814
10156,84361800,63440435,147802235,5,0,0,68096,12,6360929070
10157,84363200,62441873,146805073,7,0,0,39424,1,6512158417
10158,84369920,62468080,146838000,9,0,0,31232,4,8291228397
10159,84372869,91085020,175457889,3,0,1,105472,18,10463121809
10160,84374920,61527642,145902562,3,0,0,3584,18,3390808995
10161,84386969,91755779,176142748,3,0,1,216064,18,9948827277
10162,84393480,91755554,176149034,1,0,1,3072,1,8856060344
10163,84395520,61394262,145789782,7,0,0,25088,1,3258241224
10164,84404150,62406943,146811093,1,0,0,9728,1,9165085446
10165,84408980,63531003,147939983,1,0,0,36864,1,9820391519
10166,84456500,61636611,146093111,7,0,0,40448,1,6540737628
10167,84459570,62498932,146958502,3,0,0,43008,18,4537808070
10168,84462370,62619362,147081732,8,0,0,93184,11,8655853179
10169,84468450,91700941,176169391,8,0,1,22528,11,7184138751
10170,84471540,61708152,146179692,7,0,0,51200,1,3872367283
10171,84477230,62854888,147332118,0,0,0,4608,6,8958562388
10172,84487270,62331708,146818978,3,0,0,6656,18,8768435231
10173,84501370,91759691,176261061,0,0,1,6144,6,3223312089
10174,84503610,62515250,147018860,5,0,0,98304,12,10609352815
10175,84509830,61677061,146186891,8,0,0,23552,11,6189897675
10176,84510410,91750674,176261084,1,0,1,14336,1,7879964591
10177,84513200,61525393,146038593,6,0,0,63488,12,624357600
10178,84514540,61388669,145903209,4,0,0,2048,7,7067097095
10179,84530890,61592185,146123075,5,0,0,20992,12,1137149566
10180,84537200,63559900,148097100,4,0,0,32768,7,9785537677
10181,84546470,61607127,146153597,0,0,0,26112,6,7111719463
10182,84548530,91712577,176261107,7,0,1,10240,1,7366354807
10183,84550770,62870058,147420828,4,0,0,47616,7,7476762376
10184,84555060,61464166,146019226,8,0,0,61440,11,10619317291
10185,84559699,91701431,176261130,5,0,1,10240,12,154754084
10186,84569940,61389204,145959144,8,0,0,1024,11,7354624392
10187,84571320,61972398,146543718,7,0,0,57856,1,4072044586
10188,84594530,62600746,147195276,6,0,0,19968,12,6062457363
10189,84597190,63692910,148290100,9,0,0,22528,4,6684691370
10190,84609190,62132636,146741826,7,0,0,23552,1,2617852869
10191,84613900,64059841,148673741,2,0,0,54272,1,3904504174
10192,84620070,61964635,146584705,1,0,0,19968,1,8377222711
10193,84628439,91632714,176261153,5,0,1,3584,12,87054068
10194,84632920,61571152,146204072,6,0,0,7168,12,3445862254
10195,84633420,63832866,148466286,9,0,0,3584,4,10714930602
10196,84639410,61879146,146518556,6,0,0,44032,12,9141508540
10197,84647400,61969643,146617043,9,0,0,45568,4,1641069348
10198,84647690,61904966,146552656,5,0,0,14336,12,8044181169
10199,84647710,62936038,147583748,3,0,0,66560,18,4210545171
10200,84658980,62707076,147366056,0,0,0,26624,6,5726304503
10201,84660470,62156418,146816888,7,0,0,18944,1,1889836497
10202,84670150,91591026,176261176,7,0,1,2048,1,4683876424
10203,84672309,91825688,176497997,3,0,1,120320,18,6163431637
10204,84684860,61989844,146674704,5,0,0,4608,12,9768522569
10205,84686060,62794585,147480645,0,0,0,53248,6,3077074957
10206,84690740,61351331,146042071,3,0,0,9728,18,6793865234
10207,84698080,61827987,146526067,0,0,0,24576,6,5141455776
10208,84701460,91796883,176498343,1,0,1,512,1,7019525803
10209,84702220,62195346,146897566,5,0,0,13312,12,10191808227
10210,84702710,91801432,176504142,2,0,1,19456,1,8931006611
10211,84714620,61528194,146242814,9,0,0,7168,4,10230051409
10212,84722740,61393916,146116656,1,0,0,5632,1,2492386541
10213,84739860,91862074,176601934,0,0,1,7168,6,4733803940
10214,84742380,61963942,146706322,0,0,0,46592,6,7135312067
10215,84742490,91859467,176601957,7,0,1,1536,1,6159223460
10216,84756900,61821698,146578598,1,0,0,15872,1,5995983256
10217,84757640,61790625,146548265,1,0,0,14848,1,360435096
10218,84764500,61926176,146690676,4,0,0,1536,7,7548038099
10219,84769700,62938121,147707821,7,0,0,25600,1,5856972006
10220,84776340,62091385,146867725,2,0,0,43008,1,7408661720
10221,84783740,61986235,146769975,4,0,0,14336,7,2399699101
10222,84796170,62463074,147259244,1,0,0,17920,1,5088563728
10223,84797310,61840527,146637837,4,0,0,56832,7,8061661052
10224,84813810,61878293,146692103,6,0,0,4608,12,4026649960
10225,84824420,62095234,146919654,2,0,0,64512,1,5390254081
10226,84824790,91785325,176610115,4,0,1,18432,7,10110224288
10227,84854830,62962784,147817614,2,0,0,512,1,7526738758
10228,84855760,61823655,146679415,7,0,0,15360,1,6148032928
10229,84857290,61794454,146651744,7,0,0,45568,1,5752258286
10230,84857910,62113608,146971518,3,0,0,18944,18,9066262989
10231,84868750,61999224,146867974,7,0,0,512,1,1775147136
10232,84888550,61801535,146690085,5,0,0,7168,12,2008264452
10233,84893220,61914840,146808060,3,0,0,9728,18,3185969272
10234,84900380,63024639,147925019,8,0,0,70144,11,1175180246
10235,84923510,62021865,146945375,7,0,0,70144,1,1207983939
10236,84945370,91664768,176610138,2,0,1,5632,1,5175667839
10237,84947370,61673128,146620498,1,0,0,11264,1,2349322758
10238,84951850,91719202,176671052,6,0,1,22528,12,5224043515
10239,84952110,61840928,146793038,2,0,0,12800,1,7589279009
10240,84955490,62132037,147087527,8,0,0,18944,11,9233240556
10241,84960530,91710868,176671398,0,0,1,512,6,6622610716
10242,84963689,91773787,176737476,5,0,1,71680,12,2127993198
10243,84974830,91805170,176780000,4,0,1,8192,7,9907670580
10244,84975000,64018313,148993313,5,0,0,1024,12,421080251
10245,84989490,61903974,146893464,2,0,0,33792,1,7619960851
10246,84993410,91786613,176780023,7,0,1,7168,1,630737360
10247,85004860,62459538,147464398,3,0,0,39424,18,6429340790
10248,85019820,62350939,147370759,6,0,0,15360,12,4282334499
10249,85024940,62946469,147971409,2,0,0,15360,1,4432919115
10250,85027890,62492556,147520446,2,0,0,25600,1,2129133605
10251,85036070,61937890,146973960,1,0,0,6656,1,6631595008
10252,85042140,62285958,147328098,8,0,0,31744,11,4385017137
10253,85050050,62987381,148037431,7,0,0,1536,1,5674706523
10254,85061960,61838015,146899975,2,0,0,7680,1,1236281003
10255,85064000,61966637,147030637,8,0,0,11264,11,7962265299
10256,85077841,91729270,176807111,9,0,1,2560,4,3498896351
10257,85087970,91719164,176807134,6,0,1,12800,12,10560329660
10258,85090390,62966294,148056684,1,0,0,12288,1,1536478976
10259,85092580,62359783,147452363,1,0,0,103424,1,8010433856
10260,85103390,62254531,147357921,6,0,0,56320,12,2741838409
10261,85112880,62450565,147563445,5,0,0,108544,12,1168230645
10262,85112960,61975682,147088642,4,0,0,3584,7,1405103390
10263,85129440,64008210,149137650,2,0,0,20480,1,884763792
10264,85136120,62548099,147684219,3,0,0,110592,18,9293253008
10265,85142260,61884914,147027174,2,0,0,26624,1,6787582394
10266,85142710,62102540,147245250,9,0,0,7680,4,9441723112
10267,85144990,62942095,148087085,8,0,0,28672,11,1967369281
10268,85146710,62659916,147806626,3,0,0,14336,18,5564702953
10269,85150040,91657117,176807157,6,0,1,2048,12,4698193560
10270,85163170,91644010,176807180,2,0,1,5120,1,7358330207
10271,85166970,62676034,147843004,8,0,0,43520,11,5560777594
10272,85171900,64130186,149302086,7,0,0,23552,1,2609159553
10273,85172940,61981080,147154020,0,0,0,16896,6,4035749338
10274,85187160,63255501,148442661,9,0,0,175616,4,3595188245
10275,85187349,92478975,177666324,3,0,1,350720,18,5002896381
10276,85202020,63044276,148246296,3,0,0,29184,18,7878389524
10277,85209730,61809309,147019039,7,0,0,512,1,6108520404
10278,85213919,92464652,177678571,5,0,1,6144,12,1927110676
10279,85216960,92462597,177679557,2,0,1,1536,1,3942598352
10280,85221860,62911501,148133361,1,0,0,4096,1,172800102
10281,85259130,61916976,147176106,4,0,0,9728,7,8777331338
10282,85268920,63293902,148562822,7,0,0,91136,1,120409003
10283,85273840,62055217,147329057,3,0,0,3072,18,7527956794
10284,85281599,92495315,177776914,3,0,1,24064,18,10002733049
10285,85301110,62549701,147850811,9,0,0,512,4,1536976724
10286,85312540,62430271,147742811,3,0,0,79872,18,7353362439
10287,85320610,62697876,148018486,8,0,0,36352,11,6798785266
10288,85324810,62802889,148127699,5,0,0,100352,12,8335959917
10289,85324870,62682517,148007387,3,0,0,96768,18,7701835871
10290,85355410,62426054,147781464,8,0,0,33792,11,1731049688
10291,85356449,92480414,177836863,3,0,1,19968,18,5481357414
10292,85403840,92482091,177885931,2,0,1,512,1,7785869285
10293,85406470,62795101,148201571,2,0,0,98304,1,9215167177
10294,85415380,92470574,177885954,2,0,1,8192,1,2782635707
10295,85418011,92467966,177885977,9,0,1,16896,4,6876832631
10296,85423410,62444424,147867834,1,0,0,19968,1,2089106131
10297,85442630,64002894,149445524,9,0,0,111616,4,7806825380
10298,85460480,92494306,177954786,2,0,1,2048,1,1802615719
10299,85462060,63221075,148683135,6,0,0,8704,12,10080372020
10300,85466689,92488120,177954809,5,0,1,7168,12,1881562107
10301,85472060,92482772,177954832,8,0,1,9216,11,5493115521
10302,85487450,63041912,148529362,6,0,0,14336,12,941360517
10303,85487880,61801525,147289405,2,0,0,11264,1,4201986181
10304,85494290,62677306,148171596,1,0,0,10752,1,8928209384
10305,85504820,62773084,148277904,2,0,0,70656,1,7368270221
10306,85513871,92446863,177960734,9,0,1,8192,4,8199882103
10307,85517260,62229794,147747054,9,0,0,13824,4,2023090370
10308,85530820,62990167,148520987,9,0,0,12800,4,3770970808
10309,85533820,62166178,147699998,0,0,0,51712,6,5647026225
10310,85558660,62830470,148389130,4,0,0,30208,7,7373076563
10311,85564470,62339154,147903624,7,0,0,44032,1,5918553792
10312,85583389,92381531,177964920,5,0,1,6656,12,4610473175
10313,85607670,62524420,148132090,0,0,0,14336,6,2437894645
10314,85610320,62317553,147927873,6,0,0,2048,12,3821071422
10315,85615230,62463096,148078326,6,0,0,1536,12,8917155855
10316,85621560,62546737,148168297,4,0,0,111104,7,9337547165
10317,85626021,92408524,178034545,9,0,1,5120,4,8182663032
10318,85637190,92425369,178062559,2,0,1,10752,1,3774858321
10319,85643510,92420035,178063545,1,0,1,1536,1,2932936227
10320,85643630,62558276,148201906,6,0,0,1024,12,10250082531
10321,85645220,62847856,148493076,3,0,0,18432,18,7225968113
10322,85647901,92416822,178064723,9,0,1,13824,4,4407305341
10323,85658110,92436616,178094726,4,0,1,10240,7,1376932015
10324,85659930,63914822,149574752,8,0,0,31744,11,1209253026
10325,85670680,61952069,147622749,9,0,0,5632,4,101687950
10326,85677270,63087293,148764563,9,0,0,50688,4,4546526077
10327,85682450,62682339,148364789,8,0,0,20992,11,9042230251
10328,85688000,92441450,178129450,4,0,1,24576,7,5627800584
10329,85699700,62531730,148231430,8,0,0,48640,11,3487930890
10330,85711120,62007332,147718452,6,0,0,34816,12,3904020586
10331,85712000,61878635,147590635,3,0,0,22528,18,6263197098
10332,85720220,63049398,148769618,8,0,0,4608,11,6187306809
10333,85728280,62294597,148022877,1,0,0,14336,1,4561808504
10334,85751770,92377703,178129473,0,0,1,3072,6,3075160232
10335,85758810,92466194,178225004,2,0,1,14336,1,352774004
10336,85761150,62086089,147847239,6,0,0,13824,12,6867922531
10337,85768190,63094806,148862996,5,0,0,27648,12,8930867225
10338,85776610,62190072,147966682,4,0,0,87552,7,6003834115
10339,85777990,62110144,147888134,5,0,0,21504,12,7474626224
10340,85783380,62106805,147890185,7,0,0,6656,1,1185331950
10341,85789839,92441474,178231313,3,0,1,26624,18,9141547621
10342,85790340,62246600,148036940,1,0,0,46080,1,201480013
10343,85804510,63878232,149682742,7,0,0,123392,1,4903844431
10344,85809530,63953980,149763510,7,0,0,110080,1,8598900831
10345,85818890,92445482,178264372,6,0,1,17920,12,5435412907
10346,85823589,92781089,178604678,3,0,1,42496,18,238167000
10347,85828480,63284690,149113170,5,0,0,65536,12,5608150489
10348,85830060,62407321,148237381,3,0,0,19456,18,9216934087
10349,85834840,62092386,147927226,3,0,0,7168,18,2895057069
10350,85836170,62873542,148709712,3,0,0,20992,18,3120605185
10351,85836459,94179228,180015687,3,0,1,404992,18,2512650135
10352,85843440,62435423,148278863,5,0,0,3072,12,3253943859
10353,85844210,63069921,148914131,3,0,0,33280,18,779534782
10354,85890590,62465885,148356475,3,0,0,103936,18,5297212463
10355,85898210,63164636,149062846,5,0,0,58368,12,3937996433
10356,85909610,94106100,180015710,6,0,1,25600,12,2990359116
10357,85913570,62703964,148617534,6,0,0,52736,12,4457771777
10358,85917570,62440800,148358370,4,0,0,6144,7,2883321432
10359,85931171,94084562,180015733,9,0,1,14336,4,8614327196
10360,85940681,94112896,180053577,9,0,1,4608,4,3013392715
10361,85947359,94446105,180393464,3,0,1,159744,18,2421310001
10362,85948711,94444776,180393487,9,0,1,7168,4,5806272
10363,85972490,62592695,148565185,1,0,0,7680,1,8949756014
10364,85980060,62398206,148378266,1,0,0,10752,1,7856240918
10365,85980460,63013032,148993492,4,0,0,512,7,9604336055
10366,85985130,94408380,180393510,1,0,1,19968,1,10733462513
10367,85990610,62474561,148465171,5,0,0,27136,12,10539441279
10368,86005180,94403565,180408745,0,0,1,22528,6,10188712704
10369,86005460,63108513,149113973,9,0,0,2560,4,1361852863
10370,86033110,62585071,148618181,6,0,0,2048,12,2699163341
10371,86033200,62434513,148467713,9,0,0,4608,4,8390143528
10372,86037490,62529434,148566924,4,0,0,5632,7,4558057305
10373,86066800,62448139,148514939,0,0,0,33280,6,6336945800
10374,86069180,62387700,148456880,1,0,0,46592,1,6277749026
10375,86078970,62619776,148698746,3,0,0,39936,18,8020582864
10376,86098401,94508209,180606610,9,0,1,12288,4,9650013880
10377,86100820,94557183,180658003,4,0,1,5632,7,10453594379
10378,86118970,62874008,148992978,8,0,0,113152,11,7969916275
10379,86135130,62613966,148749096,4,0,0,29696,7,567129045
10380,86137160,62708834,148845994,7,0,0,56320,1,5204295723
10381,86141580,62360902,148502482,6,0,0,2048,12,3351981114
10382,86151810,94506216,180658026,2,0,1,1024,1,9025415024
10383,86156790,62799111,148955901,5,0,0,30720,12,9127601657
10384,86165590,63013895,149179485,4,0,0,15360,7,9181230512
10385,86171890,63017766,149189656,2,0,0,33280,1,218212091
10386,86173170,62328665,148501835,7,0,0,28672,1,10159424579
10387,86181840,62705274,148887114,3,0,0,7680,18,2749571598
10388,86182640,62688335,148870975,7,0,0,26112,1,8681893865
10389,86185680,94472369,180658049,4,0,1,16896,7,10586447184
10390,86192020,62831782,149023802,8,0,0,85504,11,621629968
10391,86198430,62488125,148686555,5,0,0,9216,12,1901335905
10392,86215260,94452203,180667463,2,0,1,12288,1,4960549763
10393,86221850,62862079,149083929,1,0,0,69120,1,9623421862
10394,86225640,62949142,149174782,5,0,0,53760,12,4241588770
10395,86248220,62455073,148703293,7,0,0,14848,1,2918300809
10396,86261990,62463384,148725374,8,0,0,12800,11,822895833
10397,86270900,62316385,148587285,9,0,0,7168,4,9843386209
10398,86277750,62405564,148683314,1,0,0,512,1,2401009243
10399,86281250,62930425,149211675,3,0,0,26112,18,2258494692
10400,86286730,63026663,149313393,6,0,0,26112,12,8724208649
10401,86302170,62791009,149093179,2,0,0,24576,1,4574157651
10402,86305520,94444247,180749767,4,0,1,11776,7,10439385767
10403,86307560,62778108,149085668,4,0,0,5632,7,8410305065
10404,86320050,62918150,149238200,5,0,0,3584,12,2065165656
10405,86322600,62802628,149125228,6,0,0,36864,12,6156748118
10406,86332711,94432741,180765452,9,0,1,3584,4,6098706338
10407,86335730,63602452,149938182,8,0,0,35840,11,7139911561
10408,86345720,62879284,149225004,5,0,0,3584,12,4914600881
10409,86348700,63126845,149475545,7,0,0,95232,1,1985567598
10410,86354380,62849058,149203438,4,0,0,45056,7,4222447612
10411,86357590,62997529,149355119,1,0,0,2560,1,5986606186
10412,86363840,62673744,149037584,7,0,0,15872,1,323806401
10413,86383800,62403688,148787488,2,0,0,5632,1,3421035981
10414,86387490,62645227,149032717,1,0,0,29184,1,5184413026
10415,86398689,94366802,180765491,5,0,1,13312,12,6689585798
10416,86414050,63151007,149565057,4,0,0,58368,7,923332534
10417,86421760,63111576,149533336,9,0,0,512,4,3768597356
10418,86424430,62847391,149271821,5,0,0,32768,12,7078926412
10419,86431750,63160129,149591879,9,0,0,1024,4,7569995127
10420,86444019,94708775,181152794,3,0,1,352768,18,8134354010
10421,86451350,62546377,148997727,8,0,0,13824,11,10726702779
10422,86456950,62701429,149158379,2,0,0,54784,1,9644733259
10423,86457500,63024666,149482166,6,0,0,21504,12,294595618
10424,86460830,62800579,149261409,7,0,0,11776,1,5576396796
10425,86469300,62786710,149256010,4,0,0,29696,7,9771317117
10426,86476659,94796532,181273191,3,0,1,235008,18,6392287441
10427,86478730,62845614,149324344,1,0,0,35840,1,7120477773
10428,86484240,63338353,149822593,0,0,0,29696,6,9711618257
10429,86507180,94817102,181324282,2,0,1,19968,1,827507159
10430,86512550,94821451,181334001,8,0,1,1024,11,4531778543
10431,86514880,62772293,149287173,1,0,0,35840,1,6996239811
10432,86519530,63619187,150138717,2,0,0,32256,1,3273365923
10433,86520290,62784772,149305062,0,0,0,3072,6,6206147752
10434,86532150,63159420,149691570,2,0,0,1536,1,7532783610
10435,86534140,63753101,150287241,4,0,0,128512,7,10055077117
10436,86540640,62868935,149409575,8,0,0,19968,11,7099781722
10437,86546990,94792293,181339283,4,0,1,27136,7,480386882
10438,86561200,62712048,149273248,9,0,0,4608,4,7796783775
10439,86564020,62926905,149490925,9,0,0,28672,4,5341206389
10440,86565500,63779719,150345219,3,0,0,5120,18,4373791408
10441,86572670,62873813,149446483,6,0,0,3072,12,3480475860
10442,86594980,62938177,149533157,8,0,0,31232,11,1303591262
10443,86601421,94748642,181350063,9,0,1,8192,4,1470281059
10444,86602190,63188065,149790255,0,0,0,39424,6,10480279382
10445,86604790,63040333,149645123,8,0,0,54784,11,1555642125
10446,86610740,94740706,181351446,2,0,1,14848,1,1823013620
10447,86611720,63165073,149776793,4,0,0,43520,7,9911147504
10448,86620110,94745737,181365847,1,0,1,5120,1,7933194401
10449,86625460,63065573,149691033,3,0,0,27136,18,4720430691
10450,86625690,94746992,181372682,6,0,1,16896,12,3775859
10451,86630670,63336285,149966955,2,0,0,44544,1,7621507789
10452,86644150,63134070,149778220,2,0,0,4608,1,1409176630
10453,86649680,63051897,149701577,2,0,0,32768,1,6550870866
10454,86656790,63045754,149702544,4,0,0,3072,7,5131188039
10455,86657000,62838488,149495488,8,0,0,14848,11,92565208
10456,86667020,63172132,149839152,6,0,0,54272,12,103878928
10457,86698220,63213687,149911907,7,0,0,23040,1,1411731028
10458,86708920,63870533,150579453,2,0,0,61952,1,9274383508
10459,86710740,63102782,149813522,7,0,0,76288,1,2640906905
10460,86744150,64208294,150952444,2,0,0,15872,1,5736269474
10461,86746750,63270448,150017198,0,0,0,29184,6,4768263464
10462,86747540,94633514,181381054,0,0,1,13312,6,9210420401
10463,86756540,63190401,149946941,4,0,0,28672,7,9042288491
10464,86763811,94621429,181385240,9,0,1,6656,4,7361875899
10465,86765810,63139054,149904864,3,0,0,45056,18,2378555049
10466,86770330,94617496,181387826,4,0,1,4096,7,2585362011
10467,86829790,62782192,149611982,6,0,0,4608,12,5801471028
10468,86844190,63008252,149852442,7,0,0,4608,1,2448928060
10469,86858890,62984520,149843410,9,0,0,13312,4,9352112236
10470,86861330,63111646,149972976,2,0,0,14848,1,4061937219
10471,86865560,62973771,149839331,1,0,0,512,1,5283386380
10472,86867399,94580339,181447738,3,0,1,67072,18,1398483268
10473,86885230,94566427,181451657,6,0,1,6656,12,7910337101
10474,86889190,64437129,151326319,9,0,0,116224,4,4313961928
10475,86898370,63143717,150042087,4,0,0,24064,7,3838384113
10476,86901270,64266801,151168071,9,0,0,44544,4,8439925918
10477,86905610,63183517,150089127,2,0,0,83968,1,7811633862
10478,86915300,63277498,150192798,4,0,0,3072,7,1169864510
10479,86925470,63302236,150227706,3,0,0,17408,18,885982930
10480,86927060,63222810,150149870,6,0,0,36352,12,3384739796
10481,86936450,94520353,181456803,1,0,1,8192,1,3614814080
10482,86940210,64562119,151502329,6,0,0,40960,12,1788437693
10483,86943380,94518608,181461988,6,0,1,24576,12,4363311918
10484,86947980,63352700,150300680,1,0,0,44032,1,6403349256
10485,86949590,63003770,149953360,4,0,0,20992,7,9878589358
10486,86954570,94534721,181489291,7,0,1,512,1,3018755517
10487,86956630,63077135,150033765,6,0,0,54272,12,727600588
10488,86960090,94530774,181490864,0,0,1,36864,6,5779847049
10489,86966910,63131912,150098822,7,0,0,31744,1,9559261459
10490,86970710,63415582,150386292,4,0,0,57856,7,4193244325
10491,86972420,63156423,150128843,2,0,0,22016,1,9500054826
10492,86976720,63384522,150361242,9,0,0,9216,4,919916057
10493,86982760,63135585,150118345,7,0,0,64000,1,7961085042
10494,86992260,63599961,150592221,3,0,0,17408,18,3047061741
10495,86994390,63127722,150122112,8,0,0,12288,11,10666516257
10496,87001040,63033684,150034724,0,0,0,3072,6,8221937086
10497,87002230,64681664,151683894,1,0,0,54272,1,7710553942
10498,87004670,63440520,150445190,8,0,0,23552,11,8514236436
10499,87029810,63443851,150473661,0,0,0,37376,6,514343569
10500,87031170,63130423,150161593,3,0,0,38400,18,4148436072
10501,87031320,63270007,150301327,4,0,0,2048,7,7881772579
10502,87046680,63700208,150746888,6,0,0,7168,12,3351352636
10503,87049500,63715902,150765402,1,0,0,8192,1,6146547179
10504,87056320,63890766,150947086,5,0,0,23552,12,4655071771
10505,87057840,63651377,150709217,9,0,0,44032,4,9294333576
10506,87068320,63270933,150339253,3,0,0,35840,18,3509182559
10507,87079480,63124937,150204417,1,0,0,23040,1,1589130119
10508,87080510,63539542,150620052,3,0,0,6144,18,7942056430
10509,87082880,63219874,150302754,8,0,0,4608,11,1010899906
10510,87087980,63607798,150695778,6,0,0,91648,12,2619953807
10511,87092940,63846947,150939887,2,0,0,58880,1,3070459934
10512,87094860,63827064,150921924,9,0,0,132608,4,7501932020
10513,87096029,94597910,181693939,3,0,1,136192,18,4444215698
10514,87102599,94644951,181747550,3,0,1,63488,18,5978343442
10515,87123940,94642145,181766085,0,0,1,2560,6,7428161376
10516,87125200,64971723,152096923,4,0,0,708608,7,7745302319
10517,87149240,63947478,151096718,8,0,0,42496,11,4791833739
10518,87155840,63575814,150731654,6,0,0,1024,12,3265022424
10519,87160220,63168090,150328310,5,0,0,7168,12,299397764
10520,87162450,63292698,150455148,2,0,0,13824,1,9040481804
10521,87162810,64195043,151357853,1,0,0,50688,1,1282159318
10522,87166470,64416371,151582841,9,0,0,137728,4,2112679049
10523,87172470,63703446,150875916,1,0,0,11264,1,8555156240
10524,87176510,94590139,181766649,4,0,1,10752,7,1868359595
10525,87200810,65257791,152458601,1,0,0,44032,1,1508580479
10526,87210460,64242284,151452744,3,0,0,117248,18,2618360425
10527,87212920,65060692,152273612,0,0,0,162304,6,6914756418
10528,87216150,64165563,151381713,8,0,0,26112,11,9600658446
10529,87224260,63784622,151008882,9,0,0,58368,4,10077428511
10530,87230580,63881364,151111944,6,0,0,17408,12,248578620
10531,87236450,64165579,151402029,5,0,0,31744,12,1905993941
10532,87264550,64068679,151333229,3,0,0,6656,18,5785412653
10533,87277020,94497243,181774263,0,0,1,6656,6,184284758
10534,87282260,64258594,151540854,4,0,0,97792,7,2656368361
10535,87282390,63665187,150947577,3,0,0,1536,18,5503599367
10536,87299640,94475225,181774865,6,0,1,9728,12,6399153611
10537,87313390,64898666,152212056,8,0,0,168448,11,2614178452
10538,87320650,63957715,151278365,0,0,0,9728,6,8900632438
10539,87321460,64155708,151477168,8,0,0,5632,11,7818407417
10540,87339460,63836537,151175997,2,0,0,8192,1,4642775562
10541,87340570,63777949,151118519,7,0,0,21504,1,784876440
10542,87343080,64517622,151860702,7,0,0,5632,1,5651692565
10543,87364500,64372755,151737255,2,0,0,38400,1,6353276179
10544,87370160,63961018,151331178,0,0,0,15872,6,1069736411
10545,87379390,64374166,151753556,4,0,0,13824,7,8611797476
10546,87390150,64085233,151475383,4,0,0,34304,7,7656575356
10547,87395710,64216840,151612550,9,0,0,62464,4,6024036470
10548,87396080,63843015,151239095,5,0,0,19968,12,1114955718
10549,87396250,64373311,151769561,3,0,0,12800,18,1791348077
10550,87412440,63948891,151361331,6,0,0,10240,12,2345552122
10551,87430520,63860364,151290884,2,0,0,28160,1,6020803562
10552,87432220,64235115,151667335,0,0,0,156160,6,1822301769
10553,87442970,64841631,152284601,5,0,0,35840,12,3627757138
10554,87443190,64669044,152112234,8,0,0,50176,11,238442898
10555,87443450,94332491,181775941,7,0,1,13312,1,6006182616
10556,87443810,94559297,182003107,8,0,1,45568,11,6031333255
10557,87444280,64174088,151618368,7,0,0,4608,1,7632084032
10558,87481301,94524072,182005373,9,0,1,3584,4,1769877741
10559,87482450,94524549,182006999,7,0,1,2560,1,4185334320
10560,87484780,64907091,152391871,8,0,0,28160,11,429584718
10561,87503950,64290802,151794752,8,0,0,16384,11,3840723854
10562,87523000,94487225,182010225,8,0,1,5120,11,4194911861
10563,87527260,94483631,182010891,1,0,1,1024,1,6829522573
10564,87533730,94559026,182092756,8,0,1,37376,11,7039118799
10565,87539200,63916086,151455286,9,0,0,8192,4,5897279018
10566,87541130,64937048,152478178,8,0,0,33280,11,4736422498
10567,87546080,64566957,152113037,1,0,0,2560,1,6011065721
10568,87559120,63799068,151358188,9,0,0,1024,4,10315624508
10569,87582400,64011072,151593472,4,0,0,34816,7,5413047017
10570,87583810,64777947,152361757,0,0,0,176640,6,3234977458
10571,87589340,64541816,152131156,6,0,0,59392,12,4213167870
10572,87592000,64632114,152224114,0,0,0,39424,6,2381880849
10573,87608090,65056707,152664797,6,0,0,50176,12,5253574231
10574,87614880,64880682,152495562,6,0,0,24576,12,7600049033
10575,87617050,64824158,152441208,1,0,0,24576,1,6648033407
10576,87636040,64113281,151749321,1,0,0,31744,1,2320627138
10577,87664010,63952931,151616941,2,0,0,14336,1,1253008300
10578,87664200,64121964,151786164,0,0,0,4096,6,6270051375
10579,87676080,64856078,152532158,6,0,0,31232,12,10380758373
10580,87676610,64706650,152383260,1,0,0,16384,1,8580752902
10581,87697890,64871376,152569266,0,0,0,9728,6,1390786737
10582,87699840,64444755,152144595,2,0,0,44032,1,362969044
10583,87711910,94392629,182104539,1,0,1,16384,1,6954689374
10584,87713350,64682155,152395505,3,0,0,9728,18,10133384076
10585,87728479,94382071,182110550,5,0,1,7680,12,9921568389
10586,87732050,64007568,151739618,6,0,0,7680,12,4963902154
10587,87732539,94416176,182148715,5,0,1,7680,12,9997517716
10588,87762240,64613767,152376007,9,0,0,38400,4,4525705590
10589,87767270,94381468,182148738,0,0,1,512,6,395698419
10590,87786070,63979568,151765638,0,0,0,8192,6,4575406648
10591,87792430,64509533,152301963,5,0,0,50176,12,6661585581
10592,87800480,64849006,152649486,3,0,0,6144,18,3699966607
10593,87812290,64655725,152468015,8,0,0,13824,11,7451062407
10594,87815220,94373282,182188502,6,0,1,8192,12,5197216828
10595,87828950,64915576,152744526,9,0,0,28160,4,10566344045
10596,87835900,64562436,152398336,5,0,0,9216,12,6874337857
10597,87836700,64471214,152307914,2,0,0,19456,1,7888678886
10598,87843590,64317096,152160686,1,0,0,52736,1,5735629071
10599,87847450,94354229,182201679,4,0,1,2048,7,7815396871
10600,87850649,94639175,182489824,3,0,1,110592,18,7700340409
10601,87852990,64433662,152286652,3,0,0,6656,18,4447160649
10602,87855870,94633977,182489847,0,0,1,9728,6,4525677366
10603,87858070,94631800,182489870,0,0,1,2560,6,6648659179
10604,87858330,64586801,152445131,4,0,0,12800,7,3478224797
10605,87870440,64493836,152364276,0,0,0,8192,6,2662693612
10606,87871110,64616925,152488035,9,0,0,31744,4,6755318132
10607,87892520,64523779,152416299,6,0,0,58880,12,10186159323
10608,87903410,64474827,152378237,2,0,0,7168,1,566685008
10609,87907160,64526345,152433505,9,0,0,38912,4,7961031475
10610,87908420,94588662,182497082,7,0,1,8192,1,9739483864
10611,87911820,64509806,152421626,7,0,0,17408,1,4054055486
10612,87919480,64473038,152392518,1,0,0,2048,1,4930082216
10613,87927331,94572977,182500308,9,0,1,5120,4,7401238357
10614,87947630,94616542,182564172,2,0,1,16384,1,1194833552
10615,87949520,64566345,152515865,6,0,0,66560,12,2375788748
10616,87951090,64757064,152708154,5,0,0,37376,12,10540713837
10617,87955179,94614894,182570073,5,0,1,19968,12,1229661871
10618,87963940,64843680,152807620,1,0,0,26112,1,10645045821
10619,87979279,94736656,182715935,3,0,1,56832,18,10524397270
10620,87982640,64481132,152463772,6,0,0,16896,12,2546592200
10621,87983730,64875359,152859089,3,0,0,33792,18,1011368301
10622,87986590,64681974,152668564,8,0,0,12288,11,913141466
10623,87998260,64993014,152991274,5,0,0,73216,12,4402052818
10624,88012740,64815756,152828496,4,0,0,10240,7,4951269043
10625,88021169,94710426,182731595,5,0,1,17408,12,2878204774
10626,88026260,64891308,152917568,7,0,0,35328,1,1443500279
10627,88026390,64491682,152518072,6,0,0,7168,12,10378624863
10628,88030550,65168998,153199548,0,0,0,45056,6,4684089262
10629,88041310,64481309,152522619,5,0,0,14848,12,9908648419
10630,88046970,64496661,152543631,1,0,0,24064,1,5871875634
10631,88056830,94676391,182733221,8,0,1,2560,11,10283678167
10632,88057580,64844308,152901888,9,0,0,4096,4,4882812348
10633,88063740,64977486,153041226,8,0,0,1536,11,5955840415
10634,88068840,65171143,153239983,6,0,0,132608,12,5051753484
10635,88085400,65611109,153696509,7,0,0,95744,1,247478652
10636,88086870,65155320,153242190,3,0,0,7168,18,2788464434
10637,88105010,65074056,153179066,3,0,0,337920,18,9725854393
10638,88105560,94634485,182740045,6,0,1,5120,12,5133736432
10639,88114000,65235398,153349398,6,0,0,62976,12,7479368801
10640,88135290,64859439,152994729,7,0,0,11264,1,3384355508
10641,88156840,64868368,153025208,4,0,0,60928,7,2057860020
10642,88188180,64660590,152848770,5,0,0,20992,12,6383082815
10643,88197130,64676762,152873892,9,0,0,30720,4,6415869283
10644,88204740,64981057,153185797,5,0,0,22016,12,4536211084
10645,88209430,64819077,153028507,4,0,0,10752,7,915327366
10646,88218070,65501315,153719385,8,0,0,27136,11,9770218132
10647,88218090,94598160,182816250,1,0,1,5120,1,2259080254
10648,88229540,94586733,182816273,6,0,1,15872,12,4902779357
10649,88233050,65266355,153499405,5,0,0,66560,12,6687906141
10650,88233910,65051048,153284958,9,0,0,12800,4,6404635554
10651,88240590,65407513,153648103,0,0,0,160256,6,8920665493
10652,88243340,65260456,153503796,6,0,0,14336,12,6424407470
10653,88257010,64987543,153244553,5,0,0,7680,12,202385635
10654,88261509,94598374,182859883,5,0,1,9216,12,1457183360
10655,88266110,65477657,153743767,7,0,0,43520,1,4080146615
10656,88285560,64475293,152760853,8,0,0,1024,11,5104282317
10657,88288360,65538364,153826724,7,0,0,32256,1,3815530353
10658,88289160,65465394,153754554,7,0,0,35328,1,1251751006
10659,88291160,94636693,182927853,2,0,1,32768,1,8163597514
10660,88304360,65362954,153667314,1,0,0,62976,1,4709103852
10661,88310900,65419584,153730484,6,0,0,36352,12,4349174483
10662,88314940,65490320,153805260,1,0,0,134144,1,2052159948
10663,88315670,94613564,182929234,1,0,1,2048,1,245608518
10664,88318750,65234242,153552992,9,0,0,34304,4,79654066
10665,88327460,65080702,153408162,8,0,0,49152,11,10559175841
10666,88341820,65369274,153711094,8,0,0,13312,11,4144395133
10667,88341880,65821425,154163305,3,0,0,516608,18,10463977061
10668,88350900,65113087,153463987,5,0,0,19456,12,4111243272
10669,88351680,64401435,152753115,1,0,0,3584,1,3831763250
10670,88400720,65809633,154210353,0,0,0,137216,6,5059673860
10671,88415960,94587298,183003258,1,0,1,10240,1,386816615
10672,88424170,65282837,153707007,8,0,0,7168,11,5467436511
10673,88430840,65485355,153916195,2,0,0,104960,1,4659762340
10674,88436440,65432782,153869222,7,0,0,52736,1,282634175
10675,88443500,65725022,154168522,7,0,0,3584,1,1583164106
10676,88446300,65933980,154380280,7,0,0,22528,1,4820538369
10677,88447850,65496783,153944633,6,0,0,32768,12,3040519957
10678,88469090,65235710,153704800,4,0,0,27136,7,1620759808
10679,88475720,94549002,183024722,4,0,1,12288,7,3685546783
10680,88479010,65856975,154335985,9,0,0,346624,4,9791193949
10681,88487730,65941353,154429083,7,0,0,55808,1,476083683
10682,88488760,65860063,154348823,9,0,0,39424,4,8873531310
10683,88492910,65441716,153934626,5,0,0,60416,12,5838299674
10684,88505240,65868153,154373393,0,0,0,51200,6,3302945241
10685,88506060,65660076,154166136,7,0,0,9216,1,9659819459
10686,88523700,65702079,154225779,2,0,0,10752,1,2599111460
10687,88529280,65314236,153843516,6,0,0,37888,12,7699143269
10688,88531390,65318389,153849779,9,0,0,20480,4,9914276678
10689,88565350,65840739,154406089,5,0,0,60928,12,2678699250
10690,88579500,65778254,154357754,1,0,0,29184,1,6115248497
10691,88591580,65745208,154336788,5,0,0,2560,12,5610788368
10692,88592900,94431845,183024745,4,0,1,9216,7,10516558885
10693,88613620,65553787,154167407,1,0,0,4096,1,8285669217
10694,88617599,94450683,183068282,3,0,1,22528,18,10272053169
10695,88630990,65824647,154455637,4,0,0,34816,7,6985722129
10696,88640350,94429961,183070311,1,0,1,8192,1,9849344768
10697,88660580,65726922,154387502,9,0,0,7680,4,5034499973
10698,88694309,94399415,183093724,5,0,1,2560,12,10715041496
10699,88706170,65862626,154568796,5,0,0,61952,12,2963734198
10700,88721890,94405712,183127602,2,0,1,14848,1,3304002538
10701,88730120,65741296,154471416,1,0,0,51712,1,6163712065
10702,88742070,65480410,154222480,1,0,0,37376,1,272258862
10703,88746950,65802947,154549897,3,0,0,70656,18,2858821115
10704,88749950,65130593,153880543,6,0,0,3072,12,2376498198
10705,88750090,65063360,153813450,8,0,0,24576,11,327083588
10706,88768910,65643138,154412048,0,0,0,19456,6,1017295106
10707,88770809,94397099,183167908,5,0,1,23040,12,8523784561
10708,88771780,65613359,154385139,6,0,0,15872,12,1992071103
10709,88774380,65436689,154211069,3,0,0,2048,18,4040216203
10710,88777120,65973548,154750668,6,0,0,212480,12,2567988112
10711,88793170,66015223,154808393,2,0,0,7680,1,202500613
10712,88793671,94374583,183168254,9,0,1,512,4,6027392428
10713,88798530,65729816,154528346,5,0,0,46592,12,9171352710
10714,88814820,65682391,154497211,9,0,0,49152,4,7581842194
10715,88825400,65404926,154230326,4,0,0,14848,7,9458336952
10716,88831440,65643595,154475035,2,0,0,11776,1,735803616
10717,88836400,65738066,154574466,0,0,0,5632,6,2985507503
10718,88848700,66095984,154944684,3,0,0,35328,18,312018767
10719,88851270,65760667,154611937,9,0,0,53760,4,50486990
10720,88852480,66442370,155294850,5,0,0,68608,12,2071985203
10721,88860850,94308172,183169022,0,0,1,11776,6,2021470625
10722,88867180,65747432,154614612,2,0,0,8704,1,129284061
10723,88878500,65890622,154769122,0,0,0,29184,6,1132383610
10724,88884460,66049421,154933881,0,0,0,52736,6,10279779088
10725,88886890,65685829,154572719,4,0,0,12800,7,9993913748
10726,88887550,65796152,154683702,3,0,0,50176,18,6787107750
10727,88902530,65953263,154855793,5,0,0,16384,12,6272260863
10728,88914671,94295221,183209892,9,0,1,4096,4,1840952828
10729,88932290,94277756,183210046,7,0,1,8704,1,5463572648
10730,88935870,94282558,183218428,7,0,1,14848,1,2138031482
10731,88942800,65742641,154685441,9,0,0,5632,4,9795630707
10732,88949231,94291535,183240766,9,0,1,22016,4,6680844652
10733,88949850,65843319,154793169,5,0,0,78848,12,5694510127
10734,88963830,65654861,154618691,8,0,0,13312,11,8609396605
10735,88969780,94352750,183322530,6,0,1,2048,12,4077300925
10736,88972380,94350173,183322553,0,0,1,3072,6,2820248903
10737,88986660,65924064,154910724,1,0,0,82432,1,2895905346
10738,89014900,94312231,183327131,6,0,1,36864,12,9152733286
10739,89014990,94312172,183327162,2,0,1,1024,1,7980863647
10740,89019060,65776472,154795532,2,0,0,7680,1,5586239950
10741,89019860,65865725,154885585,9,0,0,58880,4,8230830982
10742,89030060,65636946,154667006,2,0,0,30720,1,8259020853
10743,89040340,65765690,154806030,2,0,0,34304,1,7501464892
10744,89071770,94255415,183327185,6,0,1,512,12,7593232536
10745,89084470,65831737,154916207,0,0,0,17920,6,1326588515
10746,89085950,65757146,154843096,5,0,0,9216,12,1212522738
10747,89102790,66312325,155415115,6,0,0,10240,12,5342476637
10748,89103310,65545838,154649148,3,0,0,36864,18,906195254
10749,89115260,94211948,183327208,2,0,1,4608,1,9892855429
10750,89122570,94432402,183554972,6,0,1,14336,12,10112213031
10751,89128319,94426676,183554995,5,0,1,11776,12,3588089508
10752,89129540,65630667,154760207,4,0,0,31232,7,7418845673
10753,89130140,65891565,155021705,1,0,0,39424,1,8912068087
10754,89146320,65937827,155084147,6,0,0,95232,12,4590876794
10755,89147220,94407798,183555018,2,0,1,2560,1,4748487051
10756,89151400,65766390,154917790,9,0,0,5120,4,9072657745
10757,89151789,94628455,183780244,3,0,1,56832,18,7781540282
10758,89155060,66220909,155375969,2,0,0,80384,1,3510513833
10759,89155530,66365947,155521477,5,0,0,50688,12,872202090
10760,89159980,65785507,154945487,9,0,0,2560,4,5406195428
10761,89167620,66148648,155316268,6,0,0,41472,12,9557257090
10762,89174839,94689499,183864338,5,0,1,39936,12,8915146041
10763,89193620,65900534,155094154,6,0,0,32768,12,439422010
10764,89215000,94650324,183865324,7,0,1,1536,1,2978531596
10765,89215680,66680966,155896646,4,0,0,335872,7,5174991935
10766,89224360,66411807,155636167,6,0,0,32768,12,7557073470
10767,89228340,94644664,183873004,8,0,1,4608,11,863971218
10768,89235120,65995467,155230587,0,0,0,66048,6,5137784020
10769,89235670,94637357,183873027,1,0,1,7168,1,2450636301
10770,89236270,65948812,155185082,8,0,0,3072,11,9234516662
10771,89241760,66075467,155317227,6,0,0,3072,12,9725667064
10772,89256430,65998943,155255373,1,0,0,5120,1,10454948921
10773,89277190,94634959,183912149,7,0,1,2048,1,4798355132
10774,89299770,66417992,155717762,5,0,0,49152,12,7490426499
10775,89305410,65871392,155176802,5,0,0,6144,12,10667356847
10776,89314020,66347816,155661836,8,0,0,43008,11,3442620873
10777,89317440,66068647,155386087,5,0,0,10752,12,1916667503
10778,89317970,94595485,183913455,0,0,1,2048,6,154937664
10779,89328700,94585101,183913801,7,0,1,512,1,2216533200
10780,89337500,65984126,155321626,0,0,0,14336,6,5426371277
10781,89366690,66561179,155927869,3,0,0,102400,18,3416375444
10782,89376090,66627989,156004079,7,0,0,14336,1,9842390979
10783,89376140,65950519,155326659,6,0,0,1024,12,7936638541
10784,89392790,65910819,155303609,2,0,0,28672,1,7627134146
10785,89402050,66021328,155423378,2,0,0,1024,1,3508563608
10786,89421030,94595015,184016045,0,0,1,32256,6,6728457537
10787,89447280,94592817,184040097,0,0,1,32256,6,3680115262
10788,89451170,66034117,155485287,4,0,0,2048,7,10093842007
10789,89459250,66103962,155563212,9,0,0,117248,4,5758443365
10790,89461430,94624007,184085437,2,0,1,9216,1,1849957999
10791,89463370,65967297,155430667,3,0,0,3584,18,4081336844
10792,89476540,94608920,184085460,8,0,1,4096,11,766567086
10793,89482330,66568358,156050688,4,0,0,59392,7,9352962965
10794,89494220,94601971,184096191,8,0,1,8192,11,2064517360
10795,89498640,94604975,184103615,6,0,1,3584,12,3430927833
10796,89510560,66055795,155566355,6,0,0,10240,12,3741198936
10797,89512710,66211315,155724025,0,0,0,20480,6,2819815275
10798,89512750,66486915,155999665,8,0,0,154624,11,1839318518
10799,89518460,66271190,155789650,2,0,0,35328,1,4916994571
10800,89519270,94633212,184152482,1,0,1,23552,1,7575990697
10801,89523230,66416674,155939904,8,0,0,39424,11,9285772413
10802,89523380,66426398,155949778,1,0,0,25600,1,5108799053
10803,89527110,66548924,156076034,9,0,0,35840,4,6688807611
10804,89531640,66239781,155771421,7,0,0,34816,1,3065156093
10805,89534840,66417613,155952453,8,0,0,8704,11,6330456510
10806,89546340,66467534,156013874,5,0,0,26624,12,7474967277
10807,89555809,95036099,184591908,3,0,1,77312,18,1609884936
10808,89557770,95139675,184697445,1,0,1,16384,1,6864361693
10809,89561320,66380635,155941955,9,0,0,6656,4,3589019440
10810,89579800,66474187,156053987,7,0,0,10752,1,3873367301
10811,89583400,95171560,184754960,1,0,1,29184,1,8590640479
10812,89592590,66439887,156032477,9,0,0,60928,4,4749924339
10813,89597140,66458617,156055757,8,0,0,5632,11,10592312176
10814,89617550,66388112,156005662,0,0,0,5120,6,10290254791
10815,89635710,95164435,184800145,7,0,1,1536,1,658640391
10816,89652740,95214779,184867519,4,0,1,23552,7,7154411145
10817,89657910,66480522,156138432,9,0,0,21504,4,1856468724
10818,89659100,66644296,156303396,9,0,0,36352,4,8531500125
10819,89670440,66421284,156091724,1,0,0,512,1,10530451648
10820,89670800,67248792,156919592,3,0,0,621056,18,7763259550
10821,89679000,66466162,156145162,5,0,0,6144,12,6340254309
10822,89697801,95169749,184867550,9,0,1,11776,4,1822244654
10823,89701030,95166543,184867573,6,0,1,13824,12,3923193670
10824,89702489,95201873,184904362,5,0,1,13824,12,9609120843
10825,89705370,66923434,156628804,7,0,0,7168,1,5828021112
10826,89720510,67221452,156941962,1,0,0,46592,1,582687331
10827,89728801,95247522,184976323,9,0,1,19968,4,6524665219
10828,89732770,67194973,156927743,5,0,0,26624,12,10132893914
10829,89732820,67267289,157000109,7,0,0,116224,1,571685818
10830,89733260,66689756,156423016,1,0,0,71168,1,3307544118
10831,89743330,66983353,156726683,4,0,0,4608,7,2952619483
10832,89749470,67270231,157019701,6,0,0,13824,12,4222656234
10833,89759290,66699333,156458623,7,0,0,1024,1,9954518824
10834,89769240,95250938,185020178,1,0,1,1024,1,924765802
10835,89772250,66806129,156578379,1,0,0,53760,1,5122173299
10836,89787840,67176834,156964674,8,0,0,40448,11,7736160814
10837,89799750,66658385,156458135,5,0,0,7680,12,4827368677
10838,89812930,95207914,185020844,1,0,1,1024,1,4168995446
10839,89816010,67215803,157031813,1,0,0,20480,1,4644757098
10840,89817510,66774970,156592480,8,0,0,24064,11,6816118330
10841,89818170,67352522,157170692,2,0,0,44032,1,5795888539
10842,89823460,95231342,185054802,1,0,1,16384,1,10301779156
10843,89833270,66817543,156650813,7,0,0,13824,1,4913215191
10844,89833410,66854101,156687511,9,0,0,6144,4,8777723734
10845,89840120,95214705,185054825,4,0,1,3584,7,1895867102
10846,89841989,95965741,185807730,3,0,1,162304,18,311436369
10847,89842060,95996911,185838971,7,0,1,7680,1,7090159450
10848,89844730,96165002,186009732,1,0,1,40448,1,812279074
10849,89877560,66806772,156684332,7,0,0,10240,1,2153596841
10850,89885490,67066837,156952327,3,0,0,33792,18,5747986340
10851,89892760,67184674,157077434,6,0,0,149504,12,5626501904
10852,89895080,67120363,157015443,7,0,0,50176,1,5351225793
10853,89897470,67128026,157025496,1,0,0,18944,1,963580953
10854,89907060,67344969,157252029,8,0,0,12288,11,5804851320
10855,89915790,67179433,157095223,9,0,0,9216,4,10669213288
10856,89919690,67438187,157357877,1,0,0,5632,1,4392797567
10857,89924360,67165802,157090162,9,0,0,33280,4,3473858855
10858,89925190,67217215,157142405,0,0,0,34816,6,7454320918
10859,89930520,67190178,157120698,8,0,0,83456,11,10220585770
10860,89934631,96446736,186381367,9,0,1,244736,4,6976332093
10861,89951201,96904593,186855794,9,0,1,257536,4,2636727612
10862,89952300,96960415,186912715,0,0,1,22528,6,6617442725
10863,89953730,67126223,157079953,7,0,0,8192,1,2819105890
10864,89990440,67263952,157254392,2,0,0,7680,1,5142140986
10865,89991130,67101262,157092392,9,0,0,7168,4,8502978946
10866,90016170,96905583,186921753,8,0,1,23552,11,1173361501
10867,90027690,67144897,157172587,8,0,0,6144,11,9974553862
10868,90031870,67745919,157777789,2,0,0,25088,1,2076456065
10869,90038640,67203966,157242606,7,0,0,5632,1,9959546922
10870,90046940,67562110,157609050,9,0,0,36864,4,9271303816
10871,90050500,67269122,157319622,2,0,0,30208,1,8103862746
10872,90057460,67513381,157570841,3,0,0,72704,18,1471971353
10873,90093680,67313779,157407459,4,0,0,6656,7,9393830467
10874,90101110,67274346,157375456,5,0,0,34816,12,415468951
10875,90113660,67270867,157384527,5,0,0,29696,12,10612891479
10876,90118160,67571826,157689986,3,0,0,49664,18,7827393255
10877,90122860,67795276,157918136,5,0,0,4096,12,7633303305
10878,90132800,67270519,157403319,6,0,0,512,12,8412691252
10879,90140970,67091034,157232004,2,0,0,15360,1,9205617381
10880,90141669,96806056,186947725,5,0,1,17408,12,8468210661
10881,90144260,67404406,157548666,7,0,0,23040,1,10245010077
10882,90159350,67164975,157324325,2,0,0,15360,1,5725543693
10883,90170760,67304025,157474785,0,0,0,2048,6,10149847832
10884,90175210,96797502,186972712,7,0,1,12288,1,9685208896
10885,90182180,67359443,157541623,0,0,0,48640,6,673571439
10886,90186970,67169168,157356138,2,0,0,13312,1,7734699775
10887,90215999,96757059,186973058,3,0,1,512,18,2045433330
10888,90248430,67092459,157340889,9,0,0,1024,4,1799215434
10889,90259010,67027276,157286286,7,0,0,17920,1,5671455525
10890,90264540,96712704,186977244,7,0,1,6656,1,6530066312
10891,90271170,66991500,157262670,6,0,0,4608,12,590493666
10892,90275390,67322405,157597795,3,0,0,71680,18,2140402982
10893,90283900,96695610,186979510,2,0,1,3584,1,6434789962
10894,90291510,67196281,157487791,6,0,0,23552,12,798063080
10895,90307600,67513541,157821141,1,0,0,59392,1,3122618583
10896,90311750,67587302,157899052,2,0,0,109056,1,399159909
10897,90327700,67497878,157825578,0,0,0,14336,6,267536798
10898,90337490,67454255,157791745,3,0,0,20480,18,1316061334
10899,90341750,67494562,157836312,6,0,0,34816,12,5942301972
10900,90346110,67512264,157858374,0,0,0,15360,6,6909525564
10901,90350320,67498460,157848780,8,0,0,39936,11,1651974831
10902,90360140,67295218,157655358,5,0,0,8704,12,5502871166
10903,90368590,67661403,158029993,4,0,0,71680,7,5383942947
10904,90369640,67494206,157863846,0,0,0,2560,6,2485576026
10905,90371300,67293879,157665179,4,0,0,8192,7,291550191
10906,90377290,96603091,186980381,7,0,1,12288,1,3018760294
10907,90393450,96589837,186983287,2,0,1,4608,1,4690130752
10908,90393800,67216833,157610633,3,0,0,5120,18,10263724845
10909,90394950,67301936,157696886,2,0,0,11776,1,1062805955
10910,90399360,96588753,186988113,0,0,1,7680,6,3320746906
10911,90412710,67289216,157701926,8,0,0,8192,11,3666284033
10912,90415350,67669874,158085224,5,0,0,81408,12,3402621384
10913,90416510,67624137,158040647,1,0,0,34816,1,3183527914
10914,90421950,96566509,186988459,1,0,1,512,1,6361672667
10915,90429810,67478395,157908205,1,0,0,10240,1,2665299981
10916,90434580,67798336,158232916,9,0,0,53248,4,7066429921
10917,90441210,67744880,158186090,4,0,0,20992,7,9900052143
10918,90441630,67750879,158192509,8,0,0,20992,11,3265610278
10919,90444310,67662153,158106463,6,0,0,69632,12,9270162515
10920,90452020,67659146,158111166,3,0,0,15360,18,451425113
10921,90466220,67916912,158383132,4,0,0,4096,7,2082032209
10922,90471680,96545815,187017495,2,0,1,32768,1,3039451428
10923,90484960,96628970,187113930,7,0,1,19456,1,2799303933
10924,90493120,68285705,158778825,9,0,0,24064,4,3093915631
10925,90499710,67643488,158143198,5,0,0,25088,12,5012741816
10926,90502750,67489044,157991794,0,0,0,29184,6,10486267705
10927,90503820,67694546,158198366,2,0,0,13824,1,3061985763
10928,90510870,96603083,187113953,2,0,1,1024,1,2174781931
10929,90525700,67904438,158430138,8,0,0,47104,11,4057606125
10930,90526840,68000230,158527070,5,0,0,31744,12,9130379731
10931,90532930,67630540,158163470,7,0,0,12288,1,2270353038
10932,90534880,67829591,158364471,6,0,0,25088,12,3953125011
10933,90550120,67905157,158455277,8,0,0,82432,11,9610701514
10934,90559520,96554456,187113976,7,0,1,18944,1,6420590957
10935,90571520,67639783,158211303,6,0,0,8192,12,1756356172
10936,90573660,67882888,158456548,2,0,0,4096,1,4942770715
10937,90588380,67463352,158051732,6,0,0,9728,12,3558624116
10938,90588740,68577138,159165878,5,0,0,64000,12,3556775881
10939,90590890,68023986,158614876,6,0,0,46592,12,10681764406
10940,90595039,96518960,187113999,3,0,1,4608,18,6691981026
10941,90610990,68297944,158908934,5,0,0,19456,12,10113806337
10942,90611610,67870792,158482402,0,0,0,6144,6,8051860809
10943,90614460,68157010,158771470,3,0,0,55296,18,8714178791
10944,90634450,67490454,158124904,4,0,0,13824,7,1508671107
10945,90637530,67713261,158350791,5,0,0,3584,12,8845588907
10946,90638820,67683548,158322368,6,0,0,16384,12,4419825104
10947,90646850,67592843,158239693,9,0,0,9216,4,10355401858
10948,90667120,67891587,158558707,8,0,0,62976,11,4351804416
10949,90673850,67741913,158415763,2,0,0,76800,1,1740132424
10950,90679330,67860166,158539496,2,0,0,35328,1,114292680
10951,90692990,68009322,158702312,6,0,0,20992,12,9919687123
10952,90700730,68832942,159533672,9,0,0,492544,4,10711430636
10953,90712460,96426147,187138607,2,0,1,3584,1,8053635720
10954,90723960,96414670,187138630,2,0,1,512,1,2229025757
10955,90724260,68558861,159283121,6,0,0,4096,12,9508224785
10956,90724590,67769733,158494323,8,0,0,3584,11,8542562234
10957,90735761,97403426,188139187,9,0,1,318464,4,959280903
10958,90739370,67942268,158681638,0,0,0,10240,6,144091173
10959,90744570,67944586,158689156,9,0,0,3072,4,6651948233
10960,90752829,97386381,188139210,3,0,1,12800,18,6568771538
10961,90756920,97421543,188178463,7,0,1,4608,1,1891087411
10962,90758130,68268027,159026157,1,0,0,4096,1,2375812951
10963,90766600,68170795,158937395,0,0,0,6656,6,1380628926
10964,90782710,67868266,158650976,3,0,0,13824,18,6774924278
10965,90790620,67916395,158707015,2,0,0,15360,1,9189541748
10966,90795720,68306286,159102006,8,0,0,34816,11,6462275797
10967,90809281,97591560,188400841,9,0,1,64512,4,1920887051
10968,90817250,97693865,188511115,2,0,1,23552,1,8577482244
10969,90840880,68214115,159054995,8,0,0,34816,11,3664616700
10970,90843080,68517028,159360108,1,0,0,45056,1,7171583783
10971,90844940,68179946,159024886,6,0,0,68096,12,309629219
10972,90847980,68713800,159561780,5,0,0,38400,12,6131299854
10973,90849359,97710208,188559567,3,0,1,2048,18,3131205188
10974,90849891,97715962,188565853,9,0,1,5120,4,3746160787
10975,90878500,68260437,159138937,3,0,0,46592,18,2686386737
10976,90879170,97686706,188565876,2,0,1,1536,1,9519454195
10977,90895100,68730074,159625174,9,0,0,39936,4,3930261469
10978,90897860,97668039,188565899,1,0,1,4608,1,4665507486
10979,90898800,67884728,158783528,8,0,0,15360,11,4864982665
10980,90913990,68668093,159582083,2,0,0,66560,1,10716754130
10981,90929490,68161885,159091375,8,0,0,32768,11,10169185887
10982,90931740,68185362,159117102,7,0,0,16896,1,8430632441
10983,90935610,68238715,159174325,4,0,0,27648,7,7702351157
10984,90942030,68599736,159541766,8,0,0,9216,11,9185416533
10985,90943090,68606967,159550057,3,0,0,27136,18,430876621
10986,90965670,67879298,158844968,0,0,0,12288,6,8910773509
10987,90975650,97597471,188573121,8,0,1,512,11,5828449298
10988,90980920,68725531,159706451,8,0,0,9728,11,582819880
10989,90988830,68708675,159697505,1,0,0,169984,1,7553566541
10990,90989640,68842582,159832222,6,0,0,46080,12,3794361284
10991,90991900,67963266,158955166,8,0,0,5632,11,8993243203
10992,91012670,68308437,159321107,4,0,0,24576,7,3062193010
10993,91012690,68370841,159383531,2,0,0,76800,1,8000601545
10994,91013210,68581491,159594701,9,0,0,5120,4,8320753133
10995,91014470,68089129,159103599,5,0,0,1536,12,9557193066
10996,91021900,68866090,159887990,2,0,0,13312,1,4075091793
10997,91025320,68850050,159875370,2,0,0,68608,1,10008082627
10998,91025720,68952009,159977729,1,0,0,238592,1,2293231334
10999,91030760,68579509,159610269,3,0,0,26112,18,9875230135
11000,91035180,68557759,159592939,1,0,0,19968,1,3314970278
11001,91038620,68557820,159596440,2,0,0,5632,1,9508171457
11002,91044150,68755524,159799674,9,0,0,30720,4,8569692178
11003,91052729,97520415,188573144,3,0,1,1536,18,155249997
11004,91059450,68152609,159212059,6,0,0,8192,12,1442470038
11005,91060490,68931957,159992447,3,0,0,12288,18,4970837277
11006,91061070,68272628,159333698,1,0,0,2560,1,9709880837
11007,91063240,68475603,159538843,4,0,0,16896,7,10145285012
11008,91082770,68980601,160063371,9,0,0,152064,4,1419597629
11009,91097300,68503555,159600855,3,0,0,14336,18,8997646136
11010,91101840,68534244,159636084,5,0,0,9216,12,1628546766
11011,91108750,68493540,159602290,5,0,0,4608,12,7435481665
11012,91110470,68171380,159281850,9,0,0,23552,4,4616545954
11013,91125050,68639530,159764580,8,0,0,44544,11,9749328524
11014,91125070,68468048,159593118,9,0,0,512,4,5936416732
11015,91129550,68176626,159306176,6,0,0,4096,12,10152274446
11016,91145040,69142972,160288012,6,0,0,48640,12,1147863034
11017,91146580,97426587,188573167,6,0,1,512,12,5090423158
11018,91168100,69144854,160312954,4,0,0,20992,7,8253540280
11019,91179679,97434099,188613778,3,0,1,38400,18,3897598921
11020,91182090,97431711,188613801,8,0,1,1024,11,7699902579
11021,91206230,97418010,188624240,4,0,1,27136,7,10474101582
11022,91206650,97422979,188629629,2,0,1,19968,1,9235473858
11023,91207470,68431757,159639227,1,0,0,10240,1,1123287045
11024,91219930,68366856,159586786,6,0,0,15360,12,2675989335
11025,91222580,69173395,160395975,9,0,0,45568,4,2528237746
11026,91223090,68389885,159612975,1,0,0,8704,1,9893808484
11027,91225540,68894191,160119731,3,0,0,45056,18,1972323042
11028,91226750,97412134,188638884,2,0,1,512,1,8624888848
11029,91244050,68384111,159628161,0,0,0,9728,6,330778342
11030,91250550,68452914,159703464,0,0,0,19456,6,5837086592
11031,91252580,68380596,159633176,4,0,0,16384,7,1941683087
11032,91267690,68583119,159850809,9,0,0,60928,4,3934602050
11033,91272620,68632390,159905010,8,0,0,45568,11,8483151497
11034,91280430,68717656,159998086,1,0,0,18432,1,2061511774
11035,91286900,68434167,159721067,6,0,0,44544,12,4433157443
11036,91290830,68725219,160016049,6,0,0,58880,12,3329131187
11037,91292020,97348810,188640830,0,0,1,3072,6,136047126
11038,91292360,68813620,160105980,4,0,0,14336,7,7682663706
11039,91318680,68535740,159854420,2,0,0,11776,1,8147759718
11040,91327240,69656917,160984157,4,0,0,11264,7,4069860820
11041,91331200,97339636,188670836,4,0,1,15360,7,7939202980
11042,91343920,97367611,188711531,8,0,1,14336,11,1871083355
11043,91350120,97362691,188712811,0,0,1,14336,6,6119000669
11044,91353910,68902608,160256518,9,0,0,22016,4,9859256481
11045,91358830,68890934,160249764,0,0,0,38400,6,6618809836
11046,91366940,97437389,188804329,1,0,1,33792,1,2139577827
11047,91372100,68404095,159776195,3,0,0,6144,18,9907730938
11048,91377750,68709543,160087293,3,0,0,24064,18,8905102620
11049,91388530,68711422,160099952,5,0,0,41472,12,8287290728
11050,91401510,97402842,188804352,1,0,1,2048,1,3428304296
11051,91403470,68965238,160368708,8,0,0,3072,11,2629620739
11052,91417870,68662068,160079938,9,0,0,54272,4,4689644178
11053,91424870,69297396,160722266,8,0,0,63488,11,3457562800
11054,91436450,68798248,160234698,4,0,0,7168,7,1070677533
11055,91441250,68750632,160191882,9,0,0,1536,4,8945901774
11056,91461150,69128833,160589983,9,0,0,36352,4,5975812317
11057,91462080,68415341,159877421,1,0,0,6656,1,10036169419
11058,91467840,68302272,159770112,2,0,0,1024,1,9668851374
11059,91468500,69660853,161129353,2,0,0,45056,1,6526766783
11060,91468539,97376840,188845379,5,0,1,11264,12,8185780967
11061,91488220,68807950,160296170,6,0,0,26624,12,91794192
11062,91489740,68747850,160237590,5,0,0,1536,12,444295995
11063,91512650,68699357,160212007,8,0,0,30720,11,9744411000
11064,91518630,97346977,188865607,1,0,1,14848,1,2939835777
11065,91520240,97349899,188870139,6,0,1,7168,12,3325767257
11066,91524380,68703053,160227433,4,0,0,16896,7,9358902045
11067,91533740,68657651,160191391,0,0,0,23552,6,8031286089
11068,91542430,97328067,188870497,0,0,1,512,6,5538637860
11069,91545880,68442792,159988672,5,0,0,35840,12,3615639385
11070,91555300,97319717,188875017,2,0,1,7168,1,1766271924
11071,91576940,97300663,188877603,6,0,1,4096,12,474424462
11072,91577690,68933459,160511149,8,0,0,26112,11,3912265279
11073,91579770,68437238,160017008,2,0,0,3072,1,3734412107
11074,91587980,68951011,160538991,1,0,0,12288,1,5629770030
11075,91595910,97571572,189167482,4,0,1,1536,7,9550586709
11076,91607580,97610007,189217587,2,0,1,17920,1,1319200871
11077,91619330,68687159,160306489,9,0,0,33792,4,10593609252
11078,91632259,97585351,189217610,3,0,1,9728,18,8883564934
11079,91632870,69104083,160736953,9,0,0,48128,4,2645142434
11080,91634260,68565675,160199935,2,0,0,11264,1,5455793744
11081,91639000,69635519,161274519,6,0,0,166400,12,4653112663
11082,91674810,97616921,189291731,7,0,1,23040,1,1403235353
11083,91686960,97694015,189380975,8,0,1,5120,11,4988755250
11084,91693860,68956485,160650345,3,0,0,3584,18,6433768999
11085,91694650,68687418,160382068,8,0,0,41472,11,2847134358
11086,91704990,97676008,189380998,1,0,1,512,1,8024066058
11087,91725060,97655961,189381021,1,0,1,11776,1,10236289072
11088,91727430,69086003,160813433,0,0,0,55296,6,57084202
11089,91732310,97648734,189381044,0,0,1,3584,6,9743123640
11090,91740590,68925490,160666080,9,0,0,35840,4,4726792549
11091,91740830,69175425,160916255,0,0,0,28672,6,10600084029
11092,91745721,98205280,189951001,9,0,1,156160,4,9045919523
11093,91774920,68849080,160624000,4,0,0,62976,7,5613299270
11094,91775650,69111767,160887417,0,0,0,9728,6,442362013
11095,91780770,69063511,160844281,4,0,0,38400,7,1164476224
11096,91791480,69189199,160980679,1,0,0,31232,1,8872507221
11097,91795620,69494077,161289697,6,0,0,26112,12,6712061027
11098,91800410,69602821,161403231,1,0,0,39936,1,9450090442
11099,91810790,69251644,161062434,1,0,0,50688,1,8219335930
11100,91811380,69157071,160968451,2,0,0,73216,1,8578640661
11101,91812909,98300809,190113718,5,0,1,30720,12,5988951592
11102,91828870,70124432,161953302,2,0,0,41472,1,3347325014
11103,91858120,68900704,160758824,0,0,0,71680,6,635671096
11104,91858660,69532380,161391040,9,0,0,43520,4,7967702909
11105,91864479,98317053,190181532,3,0,1,12288,18,10403348535
11106,91868950,69427026,161295976,4,0,0,20480,7,16887923
11107,91876510,98305045,190181555,0,0,1,9216,6,1003273983
11108,91890650,69704018,161594668,1,0,0,281088,1,6973529617
11109,91898680,69906805,161805485,5,0,0,388096,12,8298781234
11110,91900600,69552776,161453376,5,0,0,79360,12,664084156
11111,91904040,69587234,161491274,4,0,0,17408,7,7776280509
11112,91905170,69039367,160944537,9,0,0,21504,4,4010932289
11113,91909030,68947377,160856407,2,0,0,6144,1,6235172855
11114,91912971,98560136,190473107,9,0,1,240640,4,3482739226
11115,91920650,69221098,161141748,4,0,0,22528,7,2393820732
11116,91926260,98561036,190487296,1,0,1,9728,1,1085178765
11117,91927210,69558737,161485947,2,0,0,9728,1,7681213303
11118,91933900,69686467,161620367,9,0,0,26112,4,3984204947
11119,91935380,69010740,160946120,6,0,0,5120,12,10313369405
11120,91937460,69178142,161115602,5,0,0,11264,12,8267152626
11121,91947910,69656765,161604675,6,0,0,32768,12,7141741523
11122,91953720,69357679,161311399,3,0,0,48128,18,1894557389
11123,91957490,69949186,161906676,4,0,0,51712,7,875422623
11124,91960800,70027506,161988306,9,0,0,33792,4,6055187164
11125,91965660,68830215,160795875,3,0,0,11264,18,3410094870
11126,91976920,69451138,161428058,6,0,0,81408,12,3334405998
11127,91980050,69449123,161429173,6,0,0,3584,12,5553351434
11128,91986750,69183351,161170101,1,0,0,1024,1,7119865396
11129,91997240,98655723,190652963,6,0,1,47104,12,9354539876
11130,92024070,98628916,190652986,2,0,1,5632,1,49974545
11131,92027290,69084857,161112147,2,0,0,64000,1,5169601485
11132,92038580,69628976,161667556,1,0,0,8704,1,1904149428
11133,92039530,68898432,160937962,4,0,0,71168,7,10071636653
11134,92042089,98610920,190653009,3,0,1,17920,18,9295122712
11135,92058710,68770759,160829469,3,0,0,1024,18,4307203989
11136,92061030,69782570,161843600,4,0,0,16384,7,449085469
11137,92072420,69533838,161606258,2,0,0,5120,1,7264393211
11138,92076680,69931819,162008499,1,0,0,35328,1,9838192639
11139,92083560,70066212,162149772,3,0,0,33280,18,1658875873
11140,92086970,69525418,161612388,4,0,0,15360,7,8891143907
11141,92091130,70101971,162193101,4,0,0,7680,7,7763645186
11142,92092430,68934065,161026495,0,0,0,2560,6,5131514905
11143,92125019,98579711,190704730,3,0,1,9728,18,8380064359
11144,92129540,68762517,160892057,2,0,0,11776,1,2215014079
11145,92149700,69885303,162035003,6,0,0,33792,12,7363483182
11146,92154990,68934235,161089225,6,0,0,6144,12,1434780092
11147,92159250,98550518,190709768,4,0,1,11776,7,2894912203
11148,92167540,68984369,161151909,3,0,0,2048,18,3706159856
11149,92182221,99286393,191468614,9,0,1,360448,4,1211766698
11150,92191880,99326716,191518596,2,0,1,27136,1,3691062976
11151,92192639,99349780,191542419,3,0,1,10752,18,7449014126
11152,92198500,69160207,161358707,5,0,0,11776,12,1376141965
11153,92205350,99375480,191580830,4,0,1,2048,7,8891979005
11154,92208550,68935873,161144423,3,0,0,8704,18,3329587621
11155,92212660,69119696,161332356,5,0,0,30720,12,10283629386
11156,92213520,99367464,191580984,4,0,1,8704,7,7214368285
11157,92214110,69264771,161478881,6,0,0,47616,12,2097681064
11158,92215150,70153346,162368496,9,0,0,17920,4,98237395
11159,92224250,69270947,161495197,2,0,0,12800,1,10005926198
11160,92225810,69055908,161281718,4,0,0,23552,7,6012241113
11161,92226710,99396368,191623078,1,0,1,40960,1,10284778770
11162,92237350,70538430,162775780,5,0,0,29696,12,10367958072
11163,92252270,69395646,161647916,2,0,0,3072,1,3788624021
11164,92272639,99353985,191626624,3,0,1,5632,18,5418342839
11165,92286300,69346570,161632870,4,0,0,40960,7,5901443024
11166,92288700,69360377,161649077,2,0,0,512,1,800129821
11167,92304990,69159360,161464350,0,0,0,32256,6,3725750893
11168,92313090,69141401,161454491,1,0,0,3584,1,1687497130
11169,92315870,69017133,161333003,6,0,0,2048,12,2247323978
11170,92324500,69158460,161482960,2,0,0,13312,1,3428977534
11171,92339600,69307357,161646957,9,0,0,46080,4,501119269
11172,92342300,69306575,161648875,0,0,0,3072,6,4222775851
11173,92350450,99278120,191628570,0,0,1,3072,6,2288651863
11174,92351671,99400726,191752397,9,0,1,88064,4,4722505908
11175,92355420,99407139,191762559,1,0,1,512,1,3719231781
11176,92368040,69470522,161838562,0,0,0,71680,6,984374476
11177,92384380,69114516,161498896,5,0,0,2048,12,10153444290
11178,92393620,69574548,161968168,3,0,0,38400,18,3435337832
11179,92395620,99367195,191762815,2,0,1,9216,1,9054222115
11180,92403880,99423059,191826939,6,0,1,2048,12,5175017238
11181,92413300,69194385,161607685,7,0,0,4608,1,8092325277
11182,92416970,69803588,162220558,3,0,0,7680,18,2887292057
11183,92435040,69505603,161940643,5,0,0,6144,12,3487165935
11184,92436700,70684281,163120981,0,0,0,28672,6,9174049575
11185,92442099,99384863,191826962,3,0,1,11264,18,3502202017
11186,92447320,69431500,161878820,5,0,0,2048,12,3896657293
11187,92462550,69354149,161816699,1,0,0,36352,1,4278692897
11188,92467600,69449730,161917330,4,0,0,34816,7,6479962135
11189,92470090,69580224,162050314,3,0,0,50176,18,7448357796
11190,92472460,69466265,161938725,3,0,0,70144,18,4090768427
11191,92475090,69588911,162064001,5,0,0,13824,12,10731810375
11192,92489349,99475825,191965174,5,0,1,25600,12,4620973905
11193,92489960,69355403,161845363,6,0,0,5632,12,1190836892
11194,92509210,69463824,161973034,1,0,0,3072,1,22309161
11195,92511730,69379167,161890897,9,0,0,27648,4,1183379873
11196,92515339,99460069,191975408,5,0,1,9216,12,6406924592
11197,92516430,99460361,191976791,2,0,1,14848,1,4646453408
11198,92537860,69580866,162118726,2,0,0,5120,1,10484926482
11199,92543779,99494522,192038301,5,0,1,5120,12,7000582856
11200,92556360,69503383,162059743,0,0,0,4608,6,4334800448
11201,92570270,69873213,162443483,2,0,0,49152,1,10491530811
11202,92574220,99528487,192102707,1,0,1,26624,1,4473728758
11203,92587620,70097176,162684796,2,0,0,124928,1,9440167925
11204,92593500,69362945,161956445,3,0,0,10240,18,8165906019
11205,92638220,70082487,162720707,4,0,0,117760,7,2185483857
11206,92638390,99488433,192126823,8,0,1,1536,11,8990362992
11207,92646100,99480795,192126895,6,0,1,10752,12,3973804825
11208,92650130,69678663,162328793,2,0,0,67072,1,2703975896
11209,92658790,69648267,162307057,1,0,0,1024,1,8308165430
11210,92673030,69385263,162058293,0,0,0,26112,6,9865926161
11211,92690840,69730489,162421329,1,0,0,29696,1,7821115007
11212,92699970,70160002,162859972,5,0,0,137216,12,10213327162
11213,92710219,99435910,192146129,3,0,1,5632,18,8404909594
11214,92740700,69334749,162075449,2,0,0,4096,1,6866447690
11215,92748731,100210923,192959654,9,0,1,379392,4,7268009568
11216,92751440,69871690,162623130,3,0,0,100352,18,284074261
11217,92756770,69461425,162218195,9,0,0,73216,4,9626917400
11218,92784530,100178990,192963520,1,0,1,6144,1,8733695758
11219,92799889,100223195,193023084,5,0,1,3584,12,808860148
11220,92806300,100228826,193035126,0,0,1,18944,6,3808199519
11221,92815510,69831199,162646709,9,0,0,77312,4,3618664166
11222,92816180,70142375,162958555,3,0,0,33792,18,7658747979
11223,92836680,69708855,162545535,5,0,0,43008,12,7679331958
11224,92838770,70480767,163319537,4,0,0,71680,7,5506277584
11225,92843560,70268662,163112222,5,0,0,27136,12,1422892567
11226,92844090,69664647,162508737,9,0,0,23040,4,2592958433
11227,92910560,69186292,162096852,4,0,0,15872,7,970334940
11228,92914100,100171637,193085737,7,0,1,16384,1,9697323754
11229,92934460,69831602,162766062,6,0,0,47616,12,3824515696
11230,92949920,69991273,162941193,3,0,0,23552,18,3382214375
11231,92954740,69845975,162800715,6,0,0,30208,12,4284786698
11232,92963110,69489935,162453045,2,0,0,12800,1,1445891231
11233,92963470,69827831,162791301,3,0,0,5120,18,8967218030
11234,92965700,100120571,193086271,7,0,1,6656,1,8367784135
11235,92971890,69810777,162782667,4,0,0,22528,7,2457040625
11236,92974120,69934230,162908350,9,0,0,62976,4,3005183522
11237,92974530,70187290,163161820,1,0,0,65024,1,9419817875
11238,92974600,69772852,162747452,9,0,0,38400,4,7787135966
11239,93000150,70234589,163234739,9,0,0,11264,4,2538895444
11240,93012690,70363913,163376603,9,0,0,15872,4,188947244
11241,93044150,70473744,163517894,9,0,0,69120,4,1360837362
11242,93051110,69348156,162399266,3,0,0,1536,18,5607923301
11243,93076880,69966243,163043123,2,0,0,2048,1,2375558696
11244,93083810,69507667,162591477,2,0,0,12288,1,7811653635
11245,93085350,69800747,162886097,5,0,0,32256,12,8614272232
11246,93104580,69685138,162789718,9,0,0,23040,4,9854811065
11247,93111120,69655589,162766709,0,0,0,2048,6,10024583447
11248,93120160,99967097,193087257,1,0,1,1536,1,9860070404
11249,93122150,69629381,162751531,2,0,0,13312,1,7314477568
11250,93125020,69978911,163103931,3,0,0,163328,18,8605852578
11251,93129220,70220317,163349537,5,0,0,49152,12,754637128
11252,93131760,69816476,162948236,6,0,0,23040,12,3702192735
11253,93139450,69583152,162722602,0,0,0,6144,6,7386877807
11254,93139460,69596269,162735729,6,0,0,43008,12,5428539532
11255,93145680,69645808,162791488,9,0,0,512,4,7486500228
11256,93163650,69389466,162553116,9,0,0,2048,4,6932293523
11257,93207020,70384308,163591328,9,0,0,97280,4,6858799004
11258,93211870,99879893,193091763,0,0,1,7168,6,1257501550
11259,93219280,70192483,163411763,3,0,0,45568,18,2053106164
11260,93221860,70142789,163364649,0,0,0,22528,6,2837814801
11261,93229300,99863027,193092327,8,0,1,10752,11,3225006643
11262,93246260,69770610,163016870,0,0,0,9216,6,9766282123
11263,93268580,99834318,193102898,7,0,1,8704,1,10005224031
11264,93268730,70171741,163440471,4,0,0,3072,7,5755381524
11265,93273410,99843377,193116787,6,0,1,8704,12,3802592413
11266,93276950,69644836,162921786,5,0,0,2048,12,8681194890
11267,93292040,69752151,163044191,5,0,0,512,12,4828749863
11268,93294530,99859110,193153640,0,0,1,5120,6,7593067118
11269,93296480,70314618,163611098,3,0,0,14848,18,541857113
11270,93305019,99848644,193153663,3,0,1,6656,18,7872083841
11271,93306650,69692054,162998704,6,0,0,30720,12,8529051168
11272,93318780,70031716,163350496,6,0,0,3072,12,8913438742
11273,93320240,70438487,163758727,1,0,0,47616,1,6444388430
11274,93321480,69820474,163141954,2,0,0,58880,1,8139648653
11275,93325650,70376720,163702370,4,0,0,153088,7,4097941749
11276,93325690,70627665,163953355,0,0,0,134656,6,24875782
11277,93325730,70452119,163777849,1,0,0,23552,1,3524124693
11278,93356650,99797371,193154021,0,0,1,4096,6,9170312276
11279,93361361,100520595,193881956,9,0,1,381952,4,2910285330
11280,93367270,69858785,163226055,4,0,0,11776,7,316822461
11281,93371860,69831665,163203525,3,0,0,29696,18,489395322
11282,93373640,70095795,163469435,3,0,0,4096,18,4481685290
11283,93380240,69876876,163257116,0,0,0,52736,6,3853724492
11284,93396120,70068734,163464854,3,0,0,27648,18,4043256934
11285,93398700,100483922,193882622,0,0,1,1024,6,9978174730
11286,93404720,70069641,163474361,0,0,0,6144,6,4854396636
11287,93409089,100503717,193912806,3,0,1,10240,18,10163465681
11288,93425960,69698031,163123991,0,0,0,9728,6,4046842475
11289,93433360,70207771,163641131,3,0,0,23040,18,2522730990
11290,93440100,70580305,164020405,6,0,0,46080,12,10406294513
11291,93445880,70769771,164215651,5,0,0,75776,12,7538800091
11292,93446490,70428846,163875336,9,0,0,50688,4,10399587752
11293,93446719,100479864,193926583,5,0,1,29696,12,4232066928
11294,93453550,100503316,193956866,0,0,1,40448,6,9839417530
11295,93465600,70337104,163802704,3,0,0,62976,18,7905745343
11296,93466700,70149257,163615957,9,0,0,15872,4,9921795016
11297,93472260,70387609,163859869,2,0,0,55808,1,1859247420
11298,93477439,100480093,193957532,3,0,1,1024,18,2682662309
11299,93481200,70496358,163977558,7,0,0,79360,1,9333253224
11300,93511540,70364911,163876451,5,0,0,3584,12,3337451576
11301,93517290,70010611,163527901,0,0,0,32768,6,9014838650
11302,93519570,70476913,163996483,6,0,0,29184,12,2468780746
11303,93523290,69853804,163377094,5,0,0,1536,12,4903104066
11304,93535140,70738593,164273733,6,0,0,1536,12,1524429662
11305,93578200,70020795,163598995,5,0,0,25088,12,8653137026
11306,93598590,100398138,193996728,0,0,1,49664,6,9625410624
11307,93601129,100395622,193996751,5,0,1,8192,12,5859856145
11308,93620420,100376354,193996774,6,0,1,8192,12,8490253730
11309,93628280,70455823,164084103,5,0,0,142336,12,8504591580
11310,93630520,100374724,194005244,1,0,1,13824,1,7007067220
11311,93649500,100355767,194005267,6,0,1,6656,12,6028130455
11312,93658190,100357670,194015860,8,0,1,26112,11,9674768975
11313,93664620,70426416,164091036,2,0,0,22528,1,8435581265
11314,93664760,70218110,163882870,3,0,0,20992,18,5291413908
11315,93703180,70012836,163716016,1,0,0,6656,1,57917892
11316,93770620,69935517,163706137,9,0,0,12288,4,6863024982
11317,93783150,70473198,164256348,4,0,0,33792,7,8237456628
11318,93785760,70558168,164343928,1,0,0,65024,1,6016267323
11319,93790990,70039527,163830517,4,0,0,8704,7,2015930709
11320,93810560,100411791,194222351,2,0,1,1536,1,3078135603
11321,93814589,100438149,194252738,5,0,1,33792,12,7046834346
11322,93815880,70639794,164455674,4,0,0,18944,7,4023805204
11323,93822230,70180672,164002902,0,0,0,20992,6,3984451920
11324,93835149,100433098,194268247,3,0,1,1024,18,1801935932
11325,93837380,100431853,194269233,1,0,1,1536,1,62830736
11326,93842570,70545077,164387647,4,0,0,45056,7,2217196014
11327,93843130,70043736,163886866,5,0,0,2560,12,10676861877
11328,93858410,70539088,164397498,9,0,0,32256,4,6110415343
11329,93876350,100393229,194269579,7,0,1,512,1,2404434968
11330,93878100,70232311,164110411,3,0,0,57344,18,3096057105
11331,93889250,100380483,194269733,7,0,1,8704,1,40087355
11332,93893480,70369911,164263391,7,0,0,23040,1,389838953
11333,93904550,70341479,164246029,3,0,0,57856,18,6020423322
11334,93905900,70672311,164578211,0,0,0,30208,6,7995709496
11335,93917330,70514881,164432211,5,0,0,97792,12,771293729
11336,93920390,70524370,164444760,4,0,0,4096,7,1765101891
11337,93921040,70194386,164115426,6,0,0,16384,12,7305209871
11338,93926010,70419189,164345199,9,0,0,4096,4,6026711644
11339,93929100,100351362,194280462,7,0,1,14848,1,2844816109
11340,93943950,70741383,164685333,6,0,0,7680,12,4646993516
11341,93946880,100366072,194312952,8,0,1,13312,11,9523999004
11342,93961960,70311282,164273242,5,0,0,32256,12,4060379612
11343,93962150,70334549,164296699,9,0,0,16896,4,7514704128
11344,93973980,70650614,164624594,0,0,0,31744,6,5127021367
11345,93975050,70526718,164501768,2,0,0,17920,1,329655586
11346,93979050,100694951,194674001,2,0,1,17920,1,8348214596
11347,94005200,70312367,164317567,0,0,0,9216,6,2789460624
11348,94024120,70520936,164545056,0,0,0,8704,6,1892712733
11349,94025510,70441339,164466849,6,0,0,8704,12,6395816040
11350,94035980,70334949,164370929,2,0,0,3072,1,6920528880
11351,94046010,100723071,194769081,7,0,1,32768,1,9721081672
11352,94048760,70394729,164443489,3,0,0,5632,18,8355868422
11353,94075350,70366400,164441750,9,0,0,31232,4,6522067101
11354,94076910,70448850,164525760,0,0,0,20992,6,10356480282
11355,94095260,70459115,164554375,2,0,0,8704,1,8953144712
11356,94099560,100669982,194769542,1,0,1,10240,1,2533893254
11357,94104740,70446960,164551700,7,0,0,20480,1,8662650685
11358,94111420,70546227,164657647,1,0,0,10752,1,6060903330
11359,94121130,100659436,194780566,8,0,1,8704,11,5735003486
11360,94121170,100820986,194942156,0,0,1,36352,6,5847016104
11361,94125490,70728910,164854400,1,0,0,13312,1,10430390057
11362,94128980,70459460,164588440,4,0,0,18432,7,10254647775
11363,94129630,70496882,164626512,4,0,0,6144,7,10478617851
11364,94136120,100806059,194942179,2,0,1,6144,1,6641034126
11365,94136980,70641820,164778800,4,0,0,22528,7,2195890757
11366,94138240,70610771,164749011,1,0,0,66560,1,5503534334
11367,94145160,70999605,165144765,2,0,0,37376,1,10553203193
11368,94145300,70859754,165005054,6,0,0,2048,12,7731890268
11369,94154170,70738792,164892962,4,0,0,7680,7,7137428761
11370,94163310,70790103,164953413,7,0,0,72704,1,5711000377
11371,94176030,70656446,164832476,0,0,0,37376,6,2885310490
11372,94179660,70781108,164960768,0,0,0,24064,6,9742894665
11373,94193750,70558716,164752466,4,0,0,11264,7,9062849606
11374,94195000,100975657,195170657,6,0,1,3072,12,4716428606
11375,94214100,70586571,164800671,2,0,0,17920,1,8603937671
11376,94215950,70592389,164808339,0,0,0,3584,6,9354491001
11377,94225550,70661308,164886858,5,0,0,25600,12,7499305729
11378,94226420,100944583,195171003,1,0,1,512,1,3172305504
11379,94231500,70913608,165145108,6,0,0,1024,12,8990319901
11380,94231990,70646232,164878222,4,0,0,3072,7,2941708506
11381,94247300,70506483,164753783,6,0,0,4096,12,2057863133
11382,94252151,101264983,195517134,9,0,1,92672,4,2285163061
11383,94267290,70662795,164930085,7,0,0,1536,1,9764173701
11384,94277800,70966410,165244210,2,0,0,95744,1,5464851217
11385,94284700,70908293,165192993,1,0,0,67072,1,7481618675
11386,94285630,71221838,165507468,6,0,0,60928,12,3170047512
11387,94287220,101304737,195591957,8,0,1,10752,11,7841299115
11388,94295541,101595596,195891137,9,0,1,105984,4,8221538982
11389,94314270,70971710,165285980,7,0,0,13824,1,9074983499
11390,94316440,70548155,164864595,7,0,0,7680,1,9396583510
11391,94319080,70833360,165152440,2,0,0,22528,1,6930694402
11392,94319780,71153066,165472846,6,0,0,104960,12,5865563051
11393,94322990,101631941,195954931,7,0,1,4096,1,1935596954
11394,94364210,70769144,165133354,9,0,0,53248,4,4139367829
11395,94366560,101588394,195954954,2,0,1,9728,1,4659952963
11396,94395930,70811890,165207820,9,0,0,11776,4,3822159990
11397,94401720,70446621,164848341,0,0,0,1024,6,9582349160
11398,94402690,101552287,195954977,1,0,1,9216,1,5951328950
11399,94407690,70843617,165251307,0,0,0,15360,6,644649281
11400,94415960,70481143,164897103,1,0,0,8704,1,8191272028
11401,94416180,70865565,165281745,1,0,0,45056,1,3268469634
11402,94416400,70700707,165117107,7,0,0,34816,1,10137636550
11403,94422880,71102689,165525569,0,0,0,28672,6,5881905242
11404,94444920,101574318,196019238,1,0,1,14336,1,3133895845
11405,94446820,70933560,165380380,7,0,0,7168,1,7188182048
11406,94449920,70536633,164986553,6,0,0,18432,12,2911314871
11407,94455770,70747386,165203156,1,0,0,33280,1,683947958
11408,94474590,71114241,165588831,5,0,0,14336,12,8660476569
11409,94477330,101541931,196019261,6,0,1,1024,12,9884829988
11410,94481490,70730565,165212055,9,0,0,13824,4,7111857797
11411,94492040,70768839,165260879,6,0,0,3072,12,3228120786
11412,94501040,71107203,165608243,2,0,0,61952,1,7309682999
11413,94548870,70710911,165259781,2,0,0,23040,1,4147441891
11414,94550910,70787503,165338413,6,0,0,3584,12,4838249484
11415,94559380,70738021,165297401,0,0,0,20480,6,134838247
11416,94577330,71666920,166244250,9,0,0,28160,4,9778049286
11417,94585240,101463149,196048389,0,0,1,15360,6,2850526180
11418,94586610,71050316,165636926,1,0,0,62464,1,370899914
11419,94601170,101485089,196086259,2,0,1,7680,1,5141191740
11420,94613170,71422628,166035798,5,0,0,6656,12,3350953526
11421,94618790,101470055,196088845,6,0,1,4096,12,10197086857
11422,94621810,70667760,165289570,5,0,0,7680,12,4318222634
11423,94622310,101468161,196090471,1,0,1,2560,1,5580323566
11424,94637881,101512526,196150407,9,0,1,61952,4,9099169825
11425,94639770,70847607,165487377,6,0,0,47616,12,6968401511
11426,94639920,71146840,165786760,4,0,0,3584,7,8710373365
11427,94643850,71104674,165748524,4,0,0,86528,7,8924349098
11428,94659070,70829803,165488873,4,0,0,4608,7,9775672442
11429,94660790,70954172,165614962,2,0,0,13312,1,4369650068
11430,94661740,101495759,196157499,1,0,1,1024,1,5229472973
11431,94662409,101567261,196229670,3,0,1,46592,18,3923154910
11432,94679050,71042997,165722047,6,0,0,39936,12,206268818
11433,94685850,70824183,165510033,2,0,0,8192,1,8894314200
11434,94691450,70986208,165677658,5,0,0,40448,12,1336097267
11435,94692330,71152392,165844722,3,0,0,88576,18,126243355
11436,94697540,101565975,196263515,2,0,1,26112,1,1233150642
11437,94699231,101564307,196263538,9,0,1,8704,4,6348311260
11438,94712420,71073225,165785645,0,0,0,13312,6,4282030426
11439,94715020,71238077,165953097,1,0,0,59904,1,3590219942
11440,94715530,71040262,165755792,9,0,0,23552,4,9727144062
11441,94718400,70853665,165572065,2,0,0,8704,1,1198820296
11442,94720910,71036005,165756915,5,0,0,3584,12,7140951270
11443,94722430,70846960,165569390,0,0,0,7168,6,2468629485
11444,94739700,101525528,196265228,8,0,1,2048,11,332994944
11445,94743230,71124969,165868199,0,0,0,8192,6,1527577371
11446,94750060,71098117,165848177,0,0,0,11264,6,7941427170
11447,94752840,71464239,166217079,0,0,0,25600,6,1434319828
11448,94758890,71297078,166055968,2,0,0,18432,1,810675189
11449,94765360,71164448,165929808,2,0,0,13824,1,6382016152
11450,94770750,71193134,165963884,0,0,0,35328,6,9090078810
11451,94778270,71112616,165890886,9,0,0,73728,4,8410822795
11452,94786990,71623214,166410204,3,0,0,2048,18,3713091115
11453,94808890,71056782,165865672,6,0,0,57344,12,5550174418
11454,94828900,71221429,166050329,3,0,0,47616,18,2460833562
11455,94836320,71060356,165896676,2,0,0,14848,1,161840706
11456,94841560,71753546,166595106,9,0,0,53248,4,5408499490
11457,94865290,71200069,166065359,7,0,0,30720,1,8338828365
11458,94867450,101398854,196266304,6,0,1,13312,12,4049456268
11459,94887480,71458296,166345776,4,0,0,12288,7,8974587954
11460,94898800,101372606,196271406,2,0,1,4096,1,7273243403
11461,94900260,71285580,166185840,2,0,0,84480,1,8039560962
11462,94901910,71719271,166621181,1,0,0,85504,1,8446453583
11463,94908820,71161554,166070374,6,0,0,16384,12,5946411691
11464,94922029,101380531,196302560,5,0,1,15872,12,7347411887
11465,94927470,101423519,196350989,7,0,1,12800,1,760469107
11466,94945920,71167368,166113288,0,0,0,7680,6,10046762840
11467,94947040,101766182,196713222,7,0,1,32768,1,2938870017
11468,94952420,71122657,166075077,3,0,0,15360,18,7217200395
11469,94968980,72149995,167118975,6,0,0,293376,12,5538715865
11470,94990190,71017960,166008150,0,0,0,7680,6,8199854737
11471,94994170,101719075,196713245,7,0,1,2048,1,10556241952
11472,94998380,72226041,167224421,5,0,0,51200,12,5952788230
11473,95016330,71834661,166850991,3,0,0,27648,18,5025437275
11474,95019920,72510693,167530613,7,0,0,753664,1,9451866822
11475,95025871,101687397,196713268,9,0,1,4096,4,3507682360
11476,95042070,71144417,166186487,9,0,0,2048,4,3064238129
11477,95042430,101670861,196713291,2,0,1,10752,1,4203076924
11478,95052350,70932547,165984897,0,0,0,28160,6,5281916864
11479,95055230,71974155,167029385,6,0,0,445952,12,1519437675
11480,95062080,71355960,166418040,5,0,0,2560,12,9412231709
11481,95071030,72220920,167291950,0,0,0,51200,6,3880890626
11482,95079430,71209400,166288830,0,0,0,28160,6,7004444966
11483,95083570,72046972,167130542,3,0,0,37888,18,9765182640
11484,95123129,101678491,196801620,3,0,1,6656,18,7624974879
11485,95124630,71665581,166790211,7,0,0,4608,1,348858946
11486,95174650,71999710,167174360,6,0,0,13824,12,5869939857
11487,95192780,101609826,196802606,2,0,1,1536,1,2807040718
11488,95198771,101604501,196803272,9,0,1,1024,4,3285425412
11489,95210140,71819424,167029564,2,0,0,512,1,8067753658
11490,95211300,71594388,166805688,3,0,0,13312,18,5937963154
11491,95214500,71986367,167200867,6,0,0,12288,12,2887102934
11492,95222890,72307902,167530792,7,0,0,512,1,5828622855
11493,95227830,72036862,167264692,1,0,0,132096,1,9536363210
11494,95237800,71546540,166784340,4,0,0,13824,7,10124399272
11495,95244940,72048281,167293221,5,0,0,4096,12,4407431658
11496,95248651,101554775,196803426,9,0,1,8704,4,3343318312
11497,95252070,101631306,196883376,0,0,1,2048,6,1055317927
11498,95258710,71924588,167183298,6,0,0,12288,12,6307648448
11499,95271531,101615071,196886602,9,0,1,5120,4,8230196810
11500,95297090,71882441,167179531,3,0,0,16896,18,1777691330
11501,95300250,71854651,167154901,4,0,0,79872,7,1864959298
11502,95309850,71882836,167192686,5,0,0,11776,12,7526396462
11503,95310430,101576518,196886948,8,0,1,512,11,9276455340
11504,95331760,72213586,167545346,7,0,0,19456,1,1648686033
11505,95334130,71835949,167170079,9,0,0,41984,4,7678125243
11506,95346370,101541346,196887716,2,0,1,11776,1,8683810817
11507,95349450,72199162,167548612,6,0,0,10240,12,7520697994
11508,95356470,71395807,166752277,6,0,0,7680,12,1258396297
11509,95366080,72219110,167585190,1,0,0,4608,1,9940254693
11510,95384550,71190034,166574584,3,0,0,11264,18,8204613122
11511,95387091,102451556,197838647,9,0,1,49152,4,5455343335
11512,95395880,71793103,167188983,2,0,0,2560,1,7833441713
11513,95397360,72142035,167539395,7,0,0,28160,1,6233023264
11514,95402200,72163595,167565795,1,0,0,56320,1,8422488268
11515,95425890,71731374,167157264,1,0,0,7680,1,5778486225
11516,95433060,71770014,167203074,0,0,0,7168,6,1766251192
11517,95447740,71749360,167197100,3,0,0,2048,18,1062687477
11518,95454591,102384312,197838903,9,0,1,9216,4,6648355157
11519,95457980,71813324,167271304,6,0,0,18432,12,2759022566
11520,95459700,71728457,167188157,9,0,0,15872,4,4262556745
11521,95471980,72157315,167629295,0,0,0,2048,6,26839947
11522,95477959,102362250,197840209,5,0,1,2048,12,6883911119
11523,95486340,71710113,167196453,1,0,0,12288,1,1357234117
11524,95487170,71789157,167276327,1,0,0,16384,1,3937665053
11525,95492590,102401399,197893989,8,0,1,3584,11,2561812710
11526,95493260,71807690,167300950,2,0,0,25088,1,136068298
11527,95501190,71707608,167208798,4,0,0,18432,7,2435275653
11528,95506861,102387692,197894553,9,0,1,10752,4,4683972467
11529,95509320,102498106,198007426,2,0,1,9728,1,2127805528
11530,95514980,102853865,198368845,2,0,1,55296,1,8937473791
11531,95520200,71745295,167265495,6,0,0,2560,12,8969785848
11532,95534730,72048987,167583717,7,0,0,10240,1,26061279
11533,95536950,102831918,198368868,0,0,1,4096,6,1260652234
11534,95544289,102914751,198459040,3,0,1,8192,18,8242927861
11535,95546860,72074949,167621809,6,0,0,18432,12,5399589341
11536,95559450,72574851,168134301,6,0,0,35840,12,7444537474
11537,95560970,72005004,167565974,4,0,0,512,7,4087853108
11538,95586170,102873555,198459725,4,0,1,1536,7,7203619709
11539,95589030,72392875,167981905,4,0,0,16896,7,2246808253
11540,95606160,72277494,167883654,4,0,0,47104,7,1730047758
11541,95612400,72146231,167758631,9,0,0,27136,4,805290922
11542,95614330,102887855,198502185,6,0,1,3072,12,1372742747
11543,95624400,102877808,198502208,1,0,1,5120,1,5764228206
11544,95625680,72611994,168237674,9,0,0,27648,4,7762329761
11545,95629980,72017340,167647320,3,0,0,30208,18,5053002256
11546,95632350,72079166,167711516,1,0,0,58368,1,5394471128
11547,95633680,71994968,167628648,9,0,0,22016,4,5282979978
11548,95685320,71951018,167636338,5,0,0,23040,12,5536947524
11549,95688640,71891934,167580574,0,0,0,31232,6,5305526118
11550,95698320,71917203,167615523,0,0,0,16384,6,698903844
11551,95702920,102799311,198502231,1,0,1,1536,1,2714936194
11552,95704130,72330922,168035052,5,0,0,94208,12,4409184595
11553,95713970,71944051,167658021,5,0,0,26112,12,8174163492
11554,95729320,71881188,167610508,4,0,0,19968,7,5902467908
11555,95730870,72498357,168229227,0,0,0,44032,6,9759980
11556,95734090,102782851,198516941,0,0,1,17408,6,658211207
11557,95735920,71868481,167604401,1,0,0,62976,1,6331029405
11558,95736360,72029002,167765362,5,0,0,22016,12,9859221618
11559,95748170,71822865,167571035,5,0,0,16384,12,2436457387
11560,95773150,71941376,167714526,6,0,0,4608,12,7962058237
11561,95786110,102732048,198518158,8,0,1,7680,11,7817851025
11562,95794480,102725624,198520104,0,0,1,3072,6,8810232906
11563,95833440,72666663,168500103,7,0,0,77312,1,5302773583
11564,95837220,71908013,167745233,6,0,0,31744,12,10593402758
11565,95838950,71854759,167693709,7,0,0,25600,1,9706330164
11566,95843290,71794787,167638077,6,0,0,5632,12,2599486881
11567,95850530,72108532,167959062,5,0,0,33280,12,5748495362
11568,95857430,72978272,168835702,4,0,0,40448,7,5552311239
11569,95867750,102653481,198521231,8,0,1,11264,11,5447792010
11570,95872830,71743340,167616170,5,0,0,2048,12,7709302046
11571,95875240,72061500,167936740,6,0,0,31744,12,10080842959
11572,95877160,71772859,167650019,6,0,0,8704,12,2832080716
11573,95888620,72381624,168270244,6,0,0,25088,12,10503914440
11574,95891849,102630765,198522614,3,0,1,14848,18,856268310
11575,95902410,102788856,198691266,2,0,1,512,1,8395301706
11576,95913840,71799259,167713099,0,0,0,5120,6,9537039882
11577,95920580,72626282,168546862,9,0,0,84992,4,8099456823
11578,95922690,72200668,168123358,5,0,0,88576,12,6823288432
11579,95922740,72583048,168505788,7,0,0,18432,1,7257921587
11580,95926740,72594203,168520943,6,0,0,49664,12,10466760639
11581,95934549,102756740,198691289,3,0,1,6656,18,7764250289
11582,95948870,72266918,168215788,0,0,0,9216,6,772612453
11583,95952200,71972307,167924507,9,0,0,29184,4,6671361866
11584,95970920,72005745,167976665,2,0,0,7680,1,8679249516
11585,95972780,72424154,168396934,2,0,0,76800,1,4433945693
11586,95978010,72118222,168096232,5,0,0,5632,12,2288564146
11587,95994920,71892400,167887320,5,0,0,5632,12,5662283519
11588,96003680,72849126,168852806,9,0,0,4096,4,7624289464
11589,96004060,71823891,167827951,1,0,0,47104,1,7195491244
11590,96017130,71957172,167974302,4,0,0,7680,7,3500400643
11591,96019140,102672172,198691312,6,0,1,3072,12,7355576251
11592,96024310,71938675,167962985,4,0,0,12800,7,8231204195
11593,96033280,72526587,168559867,4,0,0,37888,7,7166571482
11594,96033431,102672926,198706357,9,0,1,11264,4,2384616141
11595,96036690,72946815,168983505,3,0,0,12288,18,4436680620
11596,96052790,72720383,168773173,5,0,0,54272,12,10675209808
11597,96064429,102641951,198706380,5,0,1,8192,12,9070869346
11598,96068599,102705320,198773919,3,0,1,21504,18,5534183965
11599,96089210,72790750,168879960,1,0,0,10240,1,3784714747
11600,96090420,72594022,168684442,3,0,0,55296,18,2156015544
11601,96096160,72653879,168750039,2,0,0,73728,1,6342649553
11602,96101040,72146544,168247584,0,0,0,6144,6,5160106777
11603,96104740,72193591,168298331,6,0,0,4096,12,4212692310
11604,96118190,72173180,168291370,9,0,0,2560,4,7780315111
11605,96125540,102648402,198773942,0,0,1,1024,6,7328147865
11606,96135100,72517535,168652635,5,0,0,73728,12,5495156431
11607,96175650,72454498,168630148,0,0,0,28672,6,3384923480
11608,96178780,72034177,168212957,3,0,0,17408,18,9143196488
11609,96189870,72424116,168613986,1,0,0,11264,1,2713382961
11610,96200640,72967749,169168389,1,0,0,134144,1,3896034926
11611,96217430,72846716,169064146,9,0,0,74240,4,560855014
11612,96225880,72437230,168663110,4,0,0,34304,7,6016298940
11613,96235340,72191564,168426904,9,0,0,50176,4,2791267185
11614,96242230,72234294,168476524,7,0,0,51712,1,4389816682
11615,96244220,73035265,169279485,2,0,0,277504,1,5368769874
11616,96247240,73043032,169290272,6,0,0,35328,12,1416287702
11617,96260310,72496304,168756614,7,0,0,21504,1,9379767352
11618,96269020,72531786,168800806,1,0,0,3584,1,5454347708
11619,96283860,72170122,168453982,3,0,0,6144,18,10478699864
11620,96350710,73141571,169492281,9,0,0,67584,4,5368617414
11621,96353630,72658412,169012042,0,0,0,34304,6,8764980969
11622,96355230,72575410,168930640,5,0,0,5120,12,3174823096
11623,96361380,73109951,169471331,9,0,0,192000,4,7744281816
11624,96379630,73023795,169403425,9,0,0,275968,4,1328624320
11625,96380520,102398772,198779292,6,0,1,6144,12,5617112239
11626,96392250,72335302,168727552,6,0,0,46592,12,5450872905
11627,96398000,72719487,169117487,7,0,0,59392,1,9664227649
11628,96399070,73116586,169515656,9,0,0,41472,4,10191458794
11629,96399140,72452341,168851481,2,0,0,51712,1,2631221590
11630,96407999,102397726,198805725,5,0,1,8192,12,5119074580
11631,96412860,72781229,169194089,1,0,0,42496,1,7998724434
11632,96429480,73141219,169570699,4,0,0,68608,7,4161222609
11633,96431200,72635465,169066665,1,0,0,8192,1,2647696822
11634,96435090,73082937,169518027,4,0,0,7680,7,958357491
11635,96442220,103032485,199474705,7,0,1,13824,1,4895250693
11636,96451460,72371895,168823355,3,0,0,44032,18,1195805245
11637,96452170,72845769,169297939,9,0,0,25088,4,743897869
11638,96457380,103092587,199549967,8,0,1,16384,11,2096833857
11639,96458580,72715292,169173872,1,0,0,17920,1,8567222641
11640,96462380,103091773,199554153,7,0,1,6656,1,9382281865
11641,96465050,103098901,199563951,6,0,1,33792,12,377072185
11642,96468370,73235621,169703991,9,0,0,66560,4,4991437692
11643,96479360,73196927,169676287,4,0,0,79872,7,1096624266
11644,96488949,103077566,199566515,3,0,1,1536,18,5549612962
11645,96499351,103071990,199571341,9,0,1,7680,4,472085638
11646,96531080,103089496,199620576,6,0,1,12288,12,3789926006
11647,96537670,72405618,168943288,6,0,0,16384,12,1356544698
11648,96549750,73459869,170009619,6,0,0,30208,12,5194724784
11649,96564580,73087348,169651928,6,0,0,204800,12,4331342177
11650,96566300,73207943,169774243,5,0,0,57344,12,7271298131
11651,96572580,73240223,169812803,0,0,0,25600,6,4771448588
11652,96578930,72400808,168979738,6,0,0,24064,12,3660483301
11653,96598640,73158092,169756732,9,0,0,60928,4,4479682025
11654,96607470,73300932,169908402,3,0,0,70144,18,5183236592
11655,96620900,72506594,169127494,9,0,0,32768,4,106488312
11656,96639109,103077808,199716917,5,0,1,6656,12,7751061008
11657,96640910,72322995,168963905,5,0,0,5120,12,3292127304
11658,96643040,103073900,199716940,6,0,1,8192,12,1599323575
11659,96645720,72825946,169471666,3,0,0,1024,18,10007218345
11660,96649830,72310516,168960346,9,0,0,1536,4,356083261
11661,96650630,73349762,170000392,0,0,0,22528,6,6099144670
11662,96651370,73269379,169920749,2,0,0,40448,1,1100938453
11663,96652370,72869744,169522114,3,0,0,13312,18,5062042018
11664,96677210,72821490,169498700,1,0,0,20992,1,6646673816
11665,96688770,72810273,169499043,7,0,0,1024,1,7376513603
11666,96697760,103019203,199716963,6,0,1,8704,12,9178964311
11667,96730400,72338628,169069028,4,0,0,7680,7,2752392268
11668,96736740,103030500,199767240,1,0,1,1536,1,4193839450
11669,96777520,73145280,169922800,1,0,0,6656,1,6326028469
11670,96781800,72721197,169502997,4,0,0,6144,7,10397414365
11671,96804940,73293411,170098351,9,0,0,1024,4,6619175935
11672,96819500,72593308,169412808,5,0,0,30720,12,6581316874
11673,96828790,72720959,169549749,9,0,0,90624,4,10149585206
11674,96842940,72878459,169721399,4,0,0,49664,7,7633349104
11675,96849670,73494265,170343935,1,0,0,38912,1,1195401402
11676,96862000,73595786,170457786,0,0,0,6656,6,429901047
11677,96867880,72633214,169501094,2,0,0,6656,1,10312734486
11678,96874220,73000440,169874660,9,0,0,126976,4,276989612
11679,96883600,73666700,170550300,0,0,0,41984,6,8281636048
11680,96917241,102855696,199772937,9,0,1,18944,4,3905027503
11681,96920710,73805492,170726202,5,0,0,8192,12,10449455630
11682,96948361,102957491,199905852,9,0,1,17408,4,9276554069
11683,96960000,73949437,170909437,3,0,0,45056,18,6324366321
11684,96962800,102995461,199958261,8,0,1,3072,11,8830575273
11685,96964720,73222244,170186964,7,0,0,27136,1,4588202449
11686,96974190,73309355,170283545,9,0,0,22016,4,2439504291
11687,96976480,72910527,169887007,9,0,0,40448,4,10668274802
11688,97006820,72731325,169738145,5,0,0,48128,12,8960438294
11689,97007550,72698671,169706221,5,0,0,3072,12,319342521
11690,97017340,73363613,170380953,8,0,0,102400,11,4936436271
11691,97025680,72562849,169588529,5,0,0,9728,12,3787206703
11692,97034270,102927406,199961676,8,0,1,8192,11,8169833701
11693,97042420,72539041,169581461,7,0,0,23040,1,7553973340
11694,97049710,72673748,169723458,0,0,0,6656,6,7701590610
11695,97050621,103054252,200104873,9,0,1,2560,4,3416088553
11696,97056570,73220244,170276814,5,0,0,83968,12,5642110376
11697,97069120,73389469,170458589,5,0,0,2560,12,10590063847
11698,97069780,103035116,200104896,7,0,1,5632,1,7219336898
11699,97085130,72705035,169790165,7,0,0,9728,1,9649081445
11700,97088810,72716170,169804980,3,0,0,16896,18,6552457788
11701,97096660,103008259,200104919,8,0,1,9728,11,7744752034
11702,97099409,103025391,200124800,3,0,1,13312,18,5334896996
11703,97120500,72700433,169820933,1,0,0,19968,1,1626186059
11704,97122180,103049861,200172041,2,0,1,12800,1,2042848457
11705,97124000,72869482,169993482,2,0,0,85504,1,7448615293
11706,97124390,72559275,169683665,3,0,0,24064,18,5266704499
11707,97140140,74068895,171209035,9,0,0,14336,4,5950679807
11708,97156330,72548932,169705262,1,0,0,4096,1,658757233
11709,97159230,73906434,171065664,5,0,0,19968,12,3243271688
11710,97168940,72612874,169781814,0,0,0,16896,6,5020414057
11711,97173430,72757037,169930467,1,0,0,25088,1,6219000204
11712,97178350,72919666,170098016,0,0,0,28160,6,4382552016
11713,97181840,73510764,170692604,1,0,0,25600,1,8864054208
11714,97190620,72740970,169931590,5,0,0,3584,12,5345406218
11715,97199680,72767727,169967407,4,0,0,11264,7,8658775066
11716,97204140,73691546,170895686,4,0,0,31232,7,3181440235
11717,97209700,72879660,170089360,0,0,0,69120,6,6243473158
11718,97211020,102963607,200174627,6,0,1,4096,12,8620823319
11719,97236300,72577002,169813302,2,0,0,1536,1,408170798
11720,97275500,73013840,170289340,1,0,0,18944,1,2233724212
11721,97299630,72648256,169947886,9,0,0,2560,4,3811259731
11722,97310590,74068516,171379106,3,0,0,35840,18,2298897866
11723,97334630,72690259,170024889,4,0,0,41984,7,5121703290
11724,97345000,103048391,200393391,7,0,1,30208,1,5181880074
11725,97355220,103038529,200393749,2,0,1,6144,1,8760788236
11726,97363920,73445120,170809040,2,0,0,35328,1,5217048059
11727,97370690,72736250,170106940,5,0,0,3072,12,2378103569
11728,97377490,72791368,170168858,3,0,0,27648,18,10244584102
11729,97382220,103059662,200441882,2,0,1,3072,1,8387306178
11730,97391430,72738894,170130324,2,0,0,2560,1,1513138935
11731,97404870,72652881,170057751,9,0,0,32768,4,455387497
11732,97405879,103036669,200442548,5,0,1,11264,12,2418644446
11733,97416770,103077776,200494546,1,0,1,22016,1,1387248770
11734,97417890,72784336,170202226,2,0,0,7168,1,9650504188
11735,97423579,103342681,200766260,5,0,1,39424,12,1065003720
11736,97437390,72630887,170068277,3,0,0,23040,18,701526880
11737,97450610,72844681,170295291,4,0,0,19456,7,5968077160
11738,97467240,72864800,170332040,5,0,0,93184,12,691002115
11739,97470221,103308767,200778988,9,0,1,1024,4,9446961362
11740,97471860,72877870,170349730,8,0,0,18944,11,2706762783
11741,97475650,103303361,200779011,2,0,1,8192,1,6558240575
11742,97510921,103289304,200800225,9,0,1,4096,4,2908087705
11743,97513659,103286589,200800248,3,0,1,10240,18,1251049612
11744,97527920,73648638,171176558,7,0,0,134144,1,8186911660
11745,97544830,103321312,200866142,2,0,1,512,1,9325417439
11746,97545020,72871512,170416532,1,0,0,15360,1,5890409819
11747,97548380,74108659,171657039,9,0,0,12288,4,2919554578
11748,97581830,73102951,170684781,5,0,0,100864,12,89689839
11749,97584790,103281813,200866603,4,0,1,10240,7,6918728321
11750,97595670,103299400,200895070,8,0,1,6656,11,4136794882
11751,97600170,72700136,170300306,9,0,0,16384,4,2158584992
11752,97602710,73934599,171537309,5,0,0,23040,12,10729346285
11753,97618700,103276393,200895093,1,0,1,1024,1,2508829463
11754,97620240,73728979,171349219,5,0,0,125952,12,5769008400
11755,97622860,73115723,170738583,3,0,0,4096,18,7282735694
11756,97628670,103266446,200895116,6,0,1,2048,12,583239299
11757,97635330,72665833,170301163,4,0,0,2560,7,5190188918
11758,97670810,72954635,170625445,2,0,0,4608,1,4884531571
11759,97673770,73747661,171421431,1,0,0,16896,1,10042669282
11760,97685610,73893330,171578940,5,0,0,65024,12,7480134633
11761,97689380,74179068,171868448,9,0,0,121344,4,9291953347
11762,97690080,73132422,170822502,9,0,0,26112,4,1501228839
11763,97692650,73587663,171280313,7,0,0,90624,1,6390934578
11764,97696810,103234893,200931703,2,0,1,14336,1,3084623861
11765,97708490,73334423,171042913,4,0,0,7168,7,4774437385
11766,97713810,72697646,170411456,9,0,0,13824,4,3795113820
11767,97727840,103521966,201249806,6,0,1,55296,12,5393094633
11768,97784440,73325338,171109778,3,0,0,76288,18,768597471
11769,97784800,73266716,171051516,1,0,0,28160,1,1967335010
11770,97833900,74128495,171962395,5,0,0,16896,12,4300269324
11771,97838340,103640062,201478402,2,0,1,6656,1,9468202755
11772,97842400,73022165,170864565,9,0,0,14336,4,5685467098
11773,97845930,73862061,171707991,2,0,0,22528,1,10256327871
11774,97848549,103688757,201537306,3,0,1,6656,18,4926267963
11775,97852140,73267489,171119629,0,0,0,32256,6,3946239279
11776,97859740,72662320,170522060,7,0,0,6656,1,7799649225
11777,97865370,72902427,170767797,9,0,0,3072,4,2895869251
11778,97869830,72833017,170702847,2,0,0,27648,1,1392518331
11779,97872300,103866641,201738941,4,0,1,8704,7,4117979348
11780,97883180,74234045,172117225,2,0,0,140800,1,8576886032
11781,97906150,72908373,170814523,5,0,0,17920,12,4949754782
11782,97907450,73972253,171879703,7,0,0,36864,1,6085319403
11783,97912090,73398730,171310820,5,0,0,19456,12,5802191448
11784,97924960,73115723,171040683,9,0,0,211968,4,7402212670
11785,97935060,103847557,201782617,6,0,1,20480,12,1589328670
11786,97939290,73541160,171480450,5,0,0,63488,12,3370784013
11787,97951130,72909021,170860151,7,0,0,53248,1,1976152774
11788,97954619,103828664,201783283,5,0,1,1024,12,4097844329
11789,97958180,103855199,201813379,1,0,1,10752,1,2618121137
11790,97973070,103841295,201814365,1,0,1,1536,1,7133465708
11791,97981590,73455393,171436983,1,0,0,12800,1,3428155737
11792,97988620,74007755,171996375,5,0,0,24064,12,8644860910
11793,97999400,73653872,171653272,9,0,0,61952,4,4898910792
11794,98007670,74344266,172351936,0,0,0,30208,6,5808413402
11795,98057810,73338791,171396601,1,0,0,57344,1,7523300498
11796,98078369,103736355,201814724,3,0,1,9728,18,7329217513
11797,98082170,72861600,170943770,2,0,0,13824,1,3177132053
11798,98096811,103778797,201875608,9,0,1,3584,4,6374115845
11799,98102810,103796712,201899522,1,0,1,3072,1,7960830840
11800,98115860,73177833,171293693,6,0,0,28672,12,906720811
11801,98142570,73582760,171725330,6,0,0,56832,12,1106086969
11802,98178120,74108626,172286746,6,0,0,367104,12,6988168301
11803,98180230,73451693,171631923,7,0,0,14848,1,4815813602
11804,98189850,73697208,171887058,0,0,0,24064,6,4016392773
11805,98196610,74354579,172551189,9,0,0,72192,4,9989959060
11806,98205970,73144364,171350334,6,0,0,3584,12,8069607836
11807,98214770,73553647,171768417,7,0,0,28160,1,3712095936
11808,98216590,73342515,171559105,5,0,0,47104,12,9223245093
11809,98236570,73658467,171895037,2,0,0,26112,1,8268165160
11810,98287049,103612496,201899545,3,0,1,1024,18,10556115610
11811,98287270,73199443,171486713,7,0,0,20480,1,10282409554
11812,98302090,103601401,201903491,6,0,1,8192,12,1779179137
11813,98310730,74298255,172608985,5,0,0,36352,12,4155223547
11814,98317910,103585604,201903514,7,0,1,512,1,6287077277
11815,98319770,103583767,201903537,2,0,1,25600,1,219094605
11816,98326770,72969153,171295923,7,0,0,7168,1,9879094983
11817,98329000,73273071,171602071,0,0,0,30720,6,8666238257
11818,98351821,103686230,202038051,9,0,1,28160,4,9427790899
11819,98366290,74196021,172562311,7,0,0,28672,1,7250083559
11820,98369370,73554837,171924207,7,0,0,14336,1,5687204810
11821,98371049,103696540,202067589,5,0,1,24576,12,3982609216
11822,98376260,74235868,172612128,3,0,0,10240,18,9237744878
11823,98403260,73208549,171611809,5,0,0,5120,12,7893064330
11824,98428810,103794169,202222979,7,0,1,22528,1,4130985082
11825,98432200,73693004,172125204,7,0,0,26112,1,4718406211
11826,98435930,73896281,172332211,3,0,0,104960,18,6211568422
11827,98445570,73385883,171831453,7,0,0,73728,1,2412432266
11828,98458630,73121925,171580555,0,0,0,1024,6,10367698965
11829,98520950,74211179,172732129,4,0,0,24064,7,9041655035
11830,98527160,73227978,171755138,6,0,0,12800,12,1629149115
11831,98534830,103688172,202223002,1,0,1,512,1,489206828
11832,98540810,73185323,171726133,0,0,0,2560,6,9633950486
11833,98553220,73518113,172071333,2,0,0,16896,1,1008092667
11834,98586410,73203095,171789505,6,0,0,11776,12,5736024156
11835,98606240,73693968,172300208,6,0,0,14336,12,105799078
11836,98616720,103609119,202225839,8,0,1,7680,11,4459113678
11837,98639210,73257254,171896464,2,0,0,4608,1,8422300090
11838,98653990,73403442,172057432,0,0,0,135680,6,9725404732
11839,98655170,73640647,172295817,1,0,0,29696,1,7676435921
11840,98657720,73684989,172342709,1,0,0,25088,1,4987109351
11841,98672620,74378255,173050875,5,0,0,38400,12,1456755934
11842,98682830,103689912,202372742,7,0,1,2048,1,8189386426
11843,98690490,73678005,172368495,3,0,0,54272,18,4964531001
11844,98701410,73281535,171982945,0,0,0,9216,6,4034502503
11845,98701790,73218026,171919816,6,0,0,6656,12,374469783
11846,98705880,73193423,171899303,7,0,0,9216,1,10557681271
11847,98717920,74572134,173290054,1,0,0,78848,1,8808654970
11848,98718580,73996944,172715524,1,0,0,146944,1,10703692941
11849,98721090,73407881,172128971,6,0,0,12288,12,8066628271
11850,98729520,73695379,172424899,6,0,0,18432,12,5435390956
11851,98730920,74095545,172826465,3,0,0,260608,18,9059631832
11852,98734910,74134992,172869902,3,0,0,45568,18,3301127409
11853,98747340,73427531,172174871,5,0,0,53248,12,9336705574
11854,98752680,73582362,172335042,9,0,0,9216,4,5408233354
11855,98755490,103617275,202372765,1,0,1,1536,1,9255696592
11856,98758380,74835885,173594265,4,0,0,19968,7,7329561583
11857,98759040,74889723,173648763,5,0,0,63488,12,4568687381
11858,98770180,74166768,172936948,6,0,0,29184,12,8545173438
11859,98802720,103570068,202372788,2,0,1,15360,1,7016728265
11860,98812770,74346973,173159743,7,0,0,7680,1,1742978009
11861,98826050,73700267,172526317,5,0,0,118272,12,10321220180
11862,98827670,73542564,172370234,6,0,0,5632,12,5894296940
11863,98828050,73803016,172631066,1,0,0,33280,1,6674539647
11864,98862580,103978069,202840649,6,0,1,37376,12,10115179709
11865,98869680,74890198,173759878,2,0,0,17920,1,2126164502
11866,98873120,73701407,172574527,6,0,0,8192,12,2880593631
11867,98899430,104158781,203058211,2,0,1,42496,1,1356604037
11868,98901040,74933739,173834779,2,0,0,7680,1,9224318219
11869,98904900,75014554,173919454,3,0,0,50176,18,2315884030
11870,98937970,73588838,172526808,6,0,0,1536,12,4492517158
11871,98947180,73787156,172734336,9,0,0,7168,4,8466960675
11872,98984660,73568892,172553552,9,0,0,7680,4,9081552829
11873,98989720,73866275,172855995,1,0,0,73728,1,2987101966
11874,98992460,73950100,172942560,6,0,0,3072,12,1904687644
11875,99014940,73818568,172833508,0,0,0,23040,6,7459075678
11876,99061320,73663454,172724774,7,0,0,23552,1,1762300938
11877,99066700,74432922,173499622,5,0,0,27648,12,10333120721
11878,99070840,73646735,172717575,2,0,0,6656,1,10616133767
11879,99080640,73995709,173076349,7,0,0,30208,1,10683590658
11880,99086100,104057144,203143244,1,0,1,4096,1,8139223209
11881,99089540,104113879,203203419,4,0,1,7680,7,7839736208
11882,99106890,73782402,172889292,2,0,0,22016,1,5867448132
11883,99111790,73852427,172964217,2,0,0,63488,1,248624753
11884,99126040,104091153,203217193,1,0,1,22528,1,7448783045
11885,99140240,73758154,172898394,7,0,0,29696,1,4051562866
11886,99169260,104097633,203266893,8,0,1,6656,11,5323223900
11887,99174380,73809606,172983986,7,0,0,14336,1,8684162389
11888,99194150,73688411,172882561,1,0,0,41472,1,9698926221
11889,99195750,73706723,172902473,3,0,0,13312,18,6220655827
11890,99197100,74432296,173629396,2,0,0,49152,1,3446702275
11891,99204700,74012085,173216785,0,0,0,90624,6,3773992947
11892,99213990,73764482,172978472,6,0,0,10752,12,3777961647
11893,99221790,73857390,173079180,7,0,0,9216,1,3637210576
11894,99222220,75081172,174303392,5,0,0,66048,12,2205413774
11895,99224180,73924780,173148960,7,0,0,25088,1,994393150
11896,99225419,104041497,203266916,5,0,1,2560,12,9123196504
11897,99228230,73913063,173141293,6,0,0,9216,12,8770016584
11898,99238430,74968903,174207333,0,0,0,10752,6,9052636397
11899,99242770,74049225,173291995,0,0,0,5632,6,5982942221
11900,99244271,104036294,203280565,9,0,1,12800,4,2550687372
11901,99254140,104026448,203280588,8,0,1,4096,11,10048827231
11902,99273290,104067753,203341043,6,0,1,55296,12,271697164
11903,99277010,73779550,173056560,0,0,0,18432,6,180305272
11904,99282591,104196859,203479450,9,0,1,9216,4,196068249
11905,99288730,74013420,173302150,7,0,0,22016,1,7888567245
11906,99295710,74075455,173371165,7,0,0,45568,1,8770747707
11907,99309110,73820768,173129878,0,0,0,8704,6,5136497815
11908,99309640,74591516,173901156,9,0,0,173056,4,5575233688
11909,99314090,74337504,173651594,2,0,0,9216,1,842328233
11910,99320280,73896684,173216964,7,0,0,512,1,8088247140
11911,99344090,73958551,173302641,7,0,0,1536,1,10317560561
11912,99374210,104264932,203639142,4,0,1,31232,7,2209428332
11913,99378760,73928925,173307685,6,0,0,3584,12,6842915676
11914,99427560,104303843,203731403,1,0,1,512,1,8266237841
11915,99430490,73810457,173240947,3,0,0,27648,18,1731547161
11916,99445100,74092247,173537347,9,0,0,35328,4,1940398400
11917,99447700,74241147,173688847,2,0,0,29184,1,7304624699
11918,99463960,73975872,173439832,6,0,0,59392,12,8683236792
11919,99473420,73700851,173174271,5,0,0,15360,12,7565772463
11920,99486770,104244656,203731426,8,0,1,1024,11,3500056621
11921,99498699,104292664,203791363,3,0,1,25088,18,1047446396
11922,99511870,104359399,203871269,1,0,1,4608,1,4617882564
11923,99514630,74030640,173545270,7,0,0,1024,1,7622603002
11924,99516430,74862664,174379094,3,0,0,20992,18,10672744966
11925,99543220,73924575,173467795,5,0,0,6656,12,2153233528
11926,99546739,104329724,203876463,5,0,1,20992,12,3730103985
11927,99551930,104346787,203898717,8,0,1,1536,11,8984394773
11928,99558000,73732233,173290233,5,0,0,512,12,9695355321
11929,99590850,74241566,173832416,0,0,0,23552,6,7282551341
11930,99591910,74004718,173596628,6,0,0,7680,12,6685130012
11931,99593200,74178557,173771757,5,0,0,38912,12,3770587199
11932,99595480,74209247,173804727,2,0,0,47104,1,7170584813
11933,99614430,73629928,173244358,9,0,0,4096,4,2717897109
11934,99620090,104279293,203899383,6,0,1,11264,12,5419542372
11935,99638610,74346707,173985317,9,0,0,24064,4,9854221514
11936,99646720,104299657,203946377,1,0,1,5632,1,3493522135
11937,99660180,74868896,174529076,0,0,0,93696,6,7636664257
11938,99666670,73921488,173588158,2,0,0,59392,1,642367849
11939,99677130,73825635,173502765,0,0,0,10240,6,1507435130
11940,99694650,74982657,174677307,1,0,0,109056,1,8926000375
11941,99702850,74747692,174450542,1,0,0,29696,1,2741136983
11942,99706941,104240102,203947043,9,0,1,11264,4,3239646501
11943,99711190,74218895,173930085,2,0,0,34816,1,8926753355
11944,99716910,74127096,173844006,0,0,0,30208,6,8528985247
11945,99719200,73934913,173654113,9,0,0,8192,4,7009665246
11946,99727090,74098119,173825209,9,0,0,64000,4,1707065372
11947,99734410,74055942,173790352,0,0,0,60928,6,7140322659
11948,99757791,104304209,204062000,9,0,1,9728,4,370591898
11949,99767390,74177078,173944468,0,0,0,47104,6,7355269715
11950,99772970,74183244,173956214,0,0,0,32768,6,7757881538
11951,99773559,104288472,204062031,3,0,1,6144,18,9805298242
11952,99777890,74168317,173946207,9,0,0,5632,4,2649901416
11953,99809830,74301448,174111278,9,0,0,2048,4,855090501
11954,99825320,74880534,174705854,1,0,0,53760,1,10253800044
11955,99847270,104418488,204265758,4,0,1,23552,7,5071228866
11956,99847850,74207749,174055599,6,0,0,56832,12,3269397457
11957,99857100,104409004,204266104,6,0,1,512,12,6738055174
11958,99861810,74140687,174002497,9,0,0,6656,4,2752477566
11959,99868400,74217821,174086221,7,0,0,27648,1,7590337230
11960,99869058,73936628,173805686,6,0,0,3072,12,5017143527
11961,99901630,74002513,173904143,7,0,0,9728,1,7300654476
11962,99911560,74987279,174898839,5,0,0,72192,12,6622747759
11963,99918400,74266868,174185268,0,0,0,62464,6,5693232486
11964,99929980,73667139,173597119,1,0,0,1536,1,677673756
11965,99934310,74625348,174559658,5,0,0,3584,12,5184281041
11966,99941380,104447731,204389111,2,0,1,17920,1,4907237412
11967,99955170,75061808,175016978,2,0,0,24064,1,3094200933
11968,99963030,74348965,174311995,7,0,0,28160,1,1912640459
11969,99968770,74109004,174077774,6,0,0,72704,12,3148514151
11970,99978170,104484206,204462376,7,0,1,8192,1,5960121427
11971,99979010,74234453,174213463,6,0,0,9728,12,163632560
11972,99989680,74917926,174907606,7,0,0,28672,1,9089156014
11973,99997760,75268381,175266141,1,0,0,3584,1,1853448124
11974,100001120,74165093,174166213,7,0,0,15872,1,921395945
11975,100034150,74154729,174188879,3,0,0,11776,18,4520984515
11976,100035281,104427118,204462399,9,0,1,5120,4,6728535222
11977,100043280,73805125,173848405,5,0,0,14336,12,5360129406
11978,100046630,74157404,174204034,4,0,0,49664,7,4757624893
11979,100050440,75269544,175319984,2,0,0,176640,1,7118895920
11980,100064390,74034741,174099131,0,0,0,6656,6,4148542080
11981,100067440,74143036,174210476,1,0,0,10240,1,9178526251
11982,100072040,74066910,174138950,9,0,0,7168,4,369892166
11983,100081490,104380940,204462430,8,0,1,13312,11,3110769582
11984,100087120,75323161,175410281,6,0,0,48640,12,1496391553
11985,100112580,74572706,174685286,7,0,0,26112,1,3904199905
11986,100133010,104380898,204513908,1,0,1,10240,1,3965041416
11987,100134600,74192908,174327508,6,0,0,4608,12,10233998493
11988,100136210,104558210,204694420,6,0,1,17408,12,2307624148
11989,100137310,74135108,174272418,5,0,0,11776,12,40226963
11990,100157570,74110711,174268281,3,0,0,11264,18,8746248478
11991,100159670,74166411,174326081,2,0,0,44544,1,1425039834
11992,100168440,74471257,174639697,6,0,0,37888,12,6291105247
11993,100179680,104605633,204785313,1,0,1,3072,1,5730193138
11994,100195230,74187943,174383173,6,0,0,13312,12,9190161839
11995,100221490,74037436,174258926,0,0,0,28160,6,10628496488
11996,100224400,75143224,175367624,7,0,0,128000,1,2255022554
11997,100238460,74846361,175084821,7,0,0,3584,1,3025126036
11998,100247870,74486292,174734162,0,0,0,24576,6,76219818
11999,100249920,74240714,174490634,1,0,0,30208,1,3519606824
12000,100265761,104705508,204971269,9,0,1,13824,4,5433829061
12001,100276630,74155877,174432507,5,0,0,75264,12,806718952
12002,100280500,74031986,174312486,2,0,0,1536,1,9368893199
12003,100283920,104688335,204972255,8,0,1,1536,11,4978575459
12004,100288040,74549843,174837883,6,0,0,137728,12,4642348188
12005,100304970,74249396,174554366,1,0,0,21504,1,10601891517
12006,100310920,74309680,174620600,3,0,0,20992,18,9192323527
12007,100322940,74598928,174921868,0,0,0,16896,6,5938257131
12008,100332690,75179042,175511732,1,0,0,176640,1,2237760827
12009,100339020,74435880,174774900,6,0,0,34304,12,3052075881
12010,100344200,74224808,174569008,0,0,0,5632,6,295803453
12011,100347240,74807793,175155033,7,0,0,27136,1,241049648
12012,100349370,74797372,175146742,9,0,0,108544,4,2727680871
12013,100352470,74620977,174973447,0,0,0,61952,6,6045700887
12014,100358140,74725566,175083706,3,0,0,62976,18,5745238239
12015,100381240,74495556,174876796,9,0,0,105472,4,9525673431
12016,100386520,74225441,174611961,2,0,0,35840,1,2652862893
12017,100388380,75143210,175531590,1,0,0,64512,1,8660603723
12018,100389370,74452436,174841806,3,0,0,12800,18,3435262314
12019,100402730,75170947,175573677,5,0,0,33280,12,3525423280
12020,100407800,74857218,175265018,6,0,0,23040,12,1257644683
12021,100408820,75049046,175457866,7,0,0,37376,1,3208663953
12022,100416790,74537758,174954548,5,0,0,16896,12,1258707799
12023,100418690,74375620,174794310,9,0,0,6144,4,4706417049
12024,100423890,74834085,175257975,6,0,0,34304,12,1272933040
12025,100429800,74965638,175395438,8,0,0,47616,11,1021903421
12026,100437500,74407137,174844637,5,0,0,9216,12,1252184271
12027,100457670,74979067,175436737,0,0,0,26112,6,3249261214
12028,100462320,74545260,175007580,0,0,0,14336,6,6671701633
12029,100465070,75046841,175511911,1,0,0,512,1,5212927221
12030,100465240,75161570,175626810,9,0,0,115200,4,6786723668
12031,100473130,104500111,204973241,2,0,1,1536,1,1402165745
12032,100473640,104586385,205060025,7,0,1,7680,1,1697128465
12033,100479490,75158762,175638252,9,0,0,25088,4,7730001923
12034,100493470,74887437,175380907,6,0,0,43520,12,9547262151
12035,100496821,104563227,205060048,9,0,1,4608,4,9246993812
12036,100497640,74722883,175220523,6,0,0,7168,12,5527486427
12037,100500550,74604585,175105135,5,0,0,20480,12,4054543635
12038,100502900,104557171,205060071,8,0,1,3584,11,10518895338
12039,100514390,74674880,175189270,5,0,0,60928,12,591451946
12040,100529470,75611516,176140986,3,0,0,271360,18,885214227
12041,100533150,75011122,175544272,0,0,0,26112,6,6086236491
12042,100534190,75016969,175551159,0,0,0,22528,6,3223568101
12043,100554290,104505804,205060094,8,0,1,10752,11,10383360686
12044,100559249,104500868,205060117,3,0,1,1536,18,9817015678
12045,100561890,104529401,205091291,2,0,1,14336,1,5541296213
12046,100589360,105142390,205731750,2,0,1,26624,1,2839095928
12047,100639700,75032949,175672649,1,0,0,77824,1,7377084621
12048,100640280,74776443,175416723,0,0,0,15872,6,8688765713
12049,100644300,74784458,175428758,1,0,0,39424,1,7917689719
12050,100651010,105287806,205938816,1,0,1,6144,1,2323645620
12051,100660000,74495680,175155680,6,0,0,2048,12,3217352252
12052,100661820,105300987,205962807,6,0,1,16384,12,8826283795
12053,100672400,75268557,175940957,4,0,0,28672,7,8530922722
12054,100677340,74971574,175648914,1,0,0,20480,1,10226882575
12055,100686849,105325899,206012748,3,0,1,3584,18,6594571066
12056,100690930,74872584,175563514,0,0,0,40448,6,7961044470
12057,100691370,74939215,175630585,3,0,0,12288,18,6189485185
12058,100695220,74745752,175440972,2,0,0,13824,1,6279566259
12059,100697630,75563408,176261038,7,0,0,16384,1,5480912444
12060,100710190,74873362,175583552,6,0,0,32256,12,2305789
12061,100712690,75314373,176027063,6,0,0,7680,12,10348783098
12062,100733350,105284570,206017920,8,0,1,18432,11,7634605071
12063,100741420,74705035,175446455,5,0,0,17920,12,2427574951
12064,100750400,75125327,175875727,3,0,0,16384,18,6477688926
12065,100756449,105385627,206142076,5,0,1,35328,12,953077912
12066,100764920,75220877,175985797,6,0,0,28672,12,3406186076
12067,100810520,74725773,175536293,2,0,0,15360,1,4408290330
12068,100823470,74588394,175411864,2,0,0,5120,1,442720110
12069,100826270,75191403,176017673,0,0,0,20480,6,5567314752
12070,100830949,106272059,207103008,3,0,1,165888,18,6195939666
12071,100844450,106323831,207168281,6,0,1,512,12,9076965694
12072,100853680,74738007,175591687,5,0,0,26624,12,3251430771
12073,100854720,75061031,175915751,9,0,0,9728,4,4877487209
12074,100867600,74853541,175721141,6,0,0,17408,12,6442504521
12075,100880590,75506078,176386668,7,0,0,14848,1,3759778110
12076,100881830,74760821,175642651,0,0,0,14336,6,6461787521
12077,100882200,75433505,176315705,5,0,0,28160,12,5376196409
12078,100886860,74957323,175844183,2,0,0,34816,1,10678156283
12079,100889980,75259031,176149011,0,0,0,20480,6,2410788500
12080,100902990,75094686,175997676,7,0,0,38912,1,3945990242
12081,100912770,75343253,176256023,1,0,0,201728,1,7761095956
12082,100919960,75237677,176157637,0,0,0,28160,6,2220835384
12083,100920560,74758040,175678600,2,0,0,19456,1,5791712292
12084,100931020,75629482,176560502,6,0,0,176128,12,9160772649
12085,100932370,75236990,176169360,9,0,0,38400,4,9273106219
12086,100939220,75650477,176589697,0,0,0,95744,6,9559878096
12087,100957430,74952575,175910005,0,0,0,47104,6,5919451547
12088,100968230,75329489,176297719,5,0,0,44032,12,2972025763
12089,100969340,75663597,176632937,6,0,0,74752,12,7975905103
12090,100972210,106199297,207171507,7,0,1,5120,1,9255502202
12091,100994300,74918380,175912680,5,0,0,8704,12,8815710687
12092,100999240,106214632,207213872,6,0,1,27648,12,4456684353
12093,101004940,75179419,176184359,5,0,0,10752,12,6843434013
12094,101014010,106263766,207277776,6,0,1,3584,12,4031602760
12095,101020549,106257250,207277799,5,0,1,3072,12,10396565576
12096,101023210,75756767,176779977,2,0,0,49152,1,2191678730
12097,101039370,76057678,177097048,1,0,0,159744,1,8685079569
12098,101044090,106233732,207277822,8,0,1,2560,11,1914195976
12099,101045510,75324670,176370180,3,0,0,18432,18,4377360994
12100,101054229,108140364,209194593,3,0,1,267776,18,4157361566
12101,101075820,74846411,175922231,2,0,0,19456,1,1209997736
12102,101084000,75246400,176330400,9,0,0,48128,4,1598199193
12103,101100350,75042375,176142725,0,0,0,5632,6,1624750405
12104,101111390,108333496,209444886,6,0,1,12800,12,6752526193
12105,101111610,75270511,176382121,7,0,0,31232,1,481504389
12106,101121660,75307993,176429653,1,0,0,67584,1,3472787412
12107,101125540,75523037,176648577,1,0,0,4096,1,1778902633
12108,101132330,75037708,176170038,2,0,0,2048,1,1876898787
12109,101172281,108272628,209444909,9,0,1,3072,4,9520180462
12110,101175360,75630449,176805809,9,0,0,55808,4,2119103343
12111,101180669,108264263,209444932,3,0,1,12288,18,3247376741
12112,101184560,75552893,176737453,5,0,0,78848,12,8280189736
12113,101191330,75963748,177155078,9,0,0,39936,4,4899109363
12114,101198520,108246435,209444955,2,0,1,8192,1,67319461
12115,101201470,75563508,176764978,7,0,0,57344,1,650083658
12116,101202100,75723758,176925858,5,0,0,16384,12,7319062226
12117,101202600,76175087,177377687,5,0,0,26624,12,8891713601
12118,101229010,75078092,176307102,7,0,0,30720,1,2598454051
12119,101237620,76090279,177327899,2,0,0,17408,1,4737217070
12120,101262660,75347432,176610092,9,0,0,26624,4,1893673990
12121,101268790,75478693,176747483,2,0,0,32768,1,9820513462
12122,101275700,108188535,209464235,4,0,1,14848,7,5560241030
12123,101288260,75760093,177048353,0,0,0,56320,6,4470284205
12124,101294570,75494212,176788782,9,0,0,28672,4,1937197513
12125,101316560,75595524,176912084,0,0,0,32768,6,4994888695
12126,101325210,76134938,177460148,2,0,0,39936,1,8680473584
12127,101335450,75566627,176902077,9,0,0,67584,4,7941708115
12128,101368210,75228686,176596896,2,0,0,23552,1,5833797408
12129,101382390,75824133,177206523,2,0,0,21504,1,5265672932
12130,101398240,75544811,176943051,0,0,0,26112,6,1189101812
12131,101411250,75397669,176808919,2,0,0,5632,1,1567728437
12132,101432120,108032138,209464258,7,0,1,19456,1,798337425
12133,101446680,75209889,176656569,6,0,0,5120,12,4136673625
12134,101447330,75190466,176637796,7,0,0,15872,1,2092526710
12135,101459770,75946905,177406675,7,0,0,10752,1,10492530429
12136,101463190,75138721,176601911,5,0,0,16384,12,9581137653
12137,101478820,75835929,177314749,9,0,0,68096,4,5014037453
12138,101498569,108039725,209538294,5,0,1,512,12,6693060157
12139,101502830,75140078,176642908,0,0,0,1536,6,7712933303
12140,101507910,75618223,177126133,7,0,0,60928,1,9520124227
12141,101540010,75380833,176920843,7,0,0,28672,1,4043071862
12142,101544630,75621489,177166119,5,0,0,19968,12,1045732341
12143,101559330,75930501,177489831,3,0,0,16384,18,5314511887
12144,101590330,75343348,176933678,6,0,0,3584,12,7837952560
12145,101591280,75439227,177030507,5,0,0,64512,12,3849675641
12146,101595670,75211418,176807088,0,0,0,4096,6,2398201264
12147,101599580,75392496,176992076,7,0,0,68096,1,8390207137
12148,101600730,75676251,177276981,2,0,0,11776,1,10133057730
12149,101604910,75717662,177322572,1,0,0,25600,1,4851993880
12150,101607820,75423022,177030842,0,0,0,1024,6,1843657392
12151,101616130,75489209,177105339,3,0,0,27136,18,671799106
12152,101619970,76039086,177659056,7,0,0,59904,1,9360463922
12153,101628730,75512262,177140992,7,0,0,48640,1,5859646764
12154,101631020,76009761,177640781,5,0,0,112640,12,5359443773
12155,101635360,75793384,177428744,7,0,0,35328,1,8212296047
12156,101637460,75954377,177591837,2,0,0,40448,1,5939253759
12157,101646320,107891997,209538317,7,0,1,6144,1,9195215059
12158,101647330,75495557,177142887,8,0,0,6144,11,6839325038
12159,101658900,75334291,176993191,7,0,0,3584,1,2552123820
12160,101659260,75577951,177237211,3,0,0,4608,18,10735921789
12161,101661560,76205256,177866816,3,0,0,29184,18,8622148668
12162,101687780,107853391,209541171,7,0,1,5632,1,9793551729
12163,101691250,75317411,177008661,3,0,0,23552,18,2970298063
12164,101695580,75910850,177606430,1,0,0,1024,1,1068653947
12165,101704360,75455585,177159945,1,0,0,15872,1,8395451662
12166,101704920,75644326,177349246,3,0,0,8704,18,8437895390
12167,101707420,107858000,209565420,4,0,1,28672,7,7617442639
12168,101709350,75844822,177554172,1,0,0,76288,1,6320601679
12169,101718040,75861450,177579490,6,0,0,66560,12,1726852766
12170,101720940,75386606,177107546,7,0,0,7168,1,4575899853
12171,101722440,75794870,177517310,9,0,0,90112,4,2968233092
12172,101730050,75863058,177593108,1,0,0,4096,1,593360931
12173,101730710,75648861,177379571,3,0,0,2560,18,3497383497
12174,101737430,107838356,209575786,1,0,1,18944,1,4831718686
12175,101738350,75792555,177530905,0,0,0,44544,6,276054274
12176,101741360,75658232,177399592,3,0,0,11776,18,8083684383
12177,101755630,107820179,209575809,1,0,1,2048,1,765970645
12178,101758130,107817702,209575832,7,0,1,11264,1,535401956
12179,101767340,75908551,177675891,5,0,0,21504,12,6912047355
12180,101797720,75687096,177484816,3,0,0,54272,18,3203803556
12181,101807350,75798729,177606079,0,0,0,42496,6,1027525747
12182,101815110,76516246,178331356,6,0,0,39936,12,5853347378
12183,101819990,75930949,177750939,5,0,0,106496,12,1600621136
12184,101823041,107827584,209650625,9,0,1,2560,4,9867605616
12185,101825220,75841081,177666301,5,0,0,1536,12,7432297464
12186,101830260,107842103,209672363,7,0,1,9216,1,2899569071
12187,101832830,76600505,178433335,1,0,0,29696,1,2256518441
12188,101840381,107852487,209692868,9,0,1,25600,4,7627046998
12189,101858220,75969621,177827841,1,0,0,55296,1,8319744737
12190,101862180,75572720,177434900,7,0,0,5120,1,6632431982
12191,101864530,107828361,209692891,7,0,1,15872,1,9078285592
12192,101868100,107826241,209694341,6,0,1,8192,12,5521082673
12193,101873320,76012588,177885908,0,0,0,40960,6,6429230201
12194,101877340,75893182,177770522,1,0,0,41472,1,3623329374
12195,101895550,75544896,177440446,2,0,0,3584,1,7206420018
12196,101896619,107837391,209734010,3,0,1,108544,18,3194154989
12197,101901320,75657867,177559187,7,0,0,16384,1,7049568680
12198,101903470,76131052,178034522,2,0,0,26112,1,7564677233
12199,101904600,75761210,177665810,0,0,0,6656,6,10266329748
12200,101911370,75752389,177663759,1,0,0,15360,1,588584056
12201,101914641,107834703,209749344,9,0,1,2560,4,5885948559
12202,101918380,75875806,177794186,5,0,0,49664,12,9131872403
12203,101924760,76119012,178043772,7,0,0,30208,1,6947398310
12204,101925960,107823407,209749367,2,0,1,2560,1,8050912482
12205,101942990,76201491,178144481,7,0,0,22528,1,2075391133
12206,101952210,107797180,209749390,4,0,1,3072,7,5746822805
12207,101962730,75809063,177771793,3,0,0,4096,18,6437033910
12208,101967670,76565138,178532808,1,0,0,20480,1,7284107099
12209,101968810,107788325,209757135,8,0,1,4096,11,1351836418
12210,101972340,76054203,178026543,1,0,0,166912,1,7347236097
12211,101977291,107781790,209759081,9,0,1,3072,4,5764147268
12212,101995870,75801147,177797017,3,0,0,9216,18,10214884085
12213,102003531,107756318,209759849,9,0,1,11776,4,9595513010
12214,102009710,76308964,178318674,7,0,0,96768,1,3403470916
12215,102043540,76203493,178247033,0,0,0,1536,6,4131992349
12216,102053640,76075787,178129427,6,0,0,39936,12,2153977434
12217,102058290,75896473,177954763,6,0,0,59392,12,3904003530
12218,102062560,76032143,178094703,2,0,0,45568,1,6544019365
12219,102070690,76149432,178220122,9,0,0,142336,4,5058102895
12220,102078629,107699634,209778263,5,0,1,5632,12,3515816175
12221,102085989,109466415,211552404,3,0,1,680960,18,301819549
12222,102086490,76160052,178246542,9,0,0,29184,4,10361768749
12223,102089769,109472041,211561810,5,0,1,15360,12,2711099933
12224,102112200,76384626,178496826,2,0,0,109568,1,10085269543
12225,102113300,76117990,178231290,3,0,0,18944,18,4679118712
12226,102114470,76002766,178117236,9,0,0,4608,4,3292449807
12227,102120390,109460373,211580763,2,0,1,10240,1,5514276952
12228,102127450,76097531,178224981,1,0,0,15872,1,3528999164
12229,102130920,76215903,178346823,3,0,0,50688,18,5538883445
12230,102144980,76515752,178660732,3,0,0,72704,18,8313153749
12231,102151780,109429006,211580786,2,0,1,6656,1,7458279747
12232,102160990,76158175,178319165,2,0,0,1536,1,8431186524
12233,102162120,75953689,178115809,6,0,0,69120,12,1843228439
12234,102165529,109415280,211580809,5,0,1,8704,12,6724283497
12235,102181650,76053430,178235080,1,0,0,12288,1,1506406917
12236,102217311,109363521,211580832,9,0,1,1024,4,7200541728
12237,102244550,76386371,178630921,0,0,0,29184,6,4732148737
12238,102245340,76544770,178790110,3,0,0,42496,18,5787920018
12239,102247950,76014471,178262421,7,0,0,16896,1,1280192975
12240,102248870,76289733,178538603,1,0,0,18944,1,8813137090
12241,102263930,75868842,178132772,1,0,0,10752,1,6854212157
12242,102266370,76003483,178269853,6,0,0,11264,12,6808447359
12243,102273200,109307655,211580855,4,0,1,4608,7,5091375196
12244,102276280,76269834,178546114,0,0,0,5120,6,1509110001
12245,102321530,76198133,178519663,6,0,0,1024,12,613411724
12246,102323220,76029406,178352626,9,0,0,18944,4,8710968583
12247,102345600,76511796,178857396,3,0,0,22528,18,3988849975
12248,102356500,109225197,211581697,1,0,1,18432,1,7688383857
12249,102362420,76769456,179131876,8,0,0,48640,11,329430071
12250,102368730,76612044,178980774,7,0,0,23040,1,2862506286
12251,102369330,76325041,178694371,7,0,0,24576,1,10751498
12252,102377700,75847795,178225495,9,0,0,1536,4,8347010543
12253,102378980,76237874,178616854,0,0,0,12800,6,3793257391
12254,102401010,76045279,178446289,7,0,0,512,1,2599190096
12255,102410099,109417940,211828039,3,0,1,176128,18,9927465625
12256,102411150,76809165,179220315,2,0,0,17408,1,8640015529
12257,102434030,75845672,178279702,3,0,0,5120,18,9366864855
12258,102457920,76573273,179031193,6,0,0,62976,12,4128791601
12259,102469880,76709481,179179361,9,0,0,39424,4,2657448278
12260,102480800,76061422,178542222,2,0,0,11776,1,2467862813
12261,102481090,76139949,178621039,0,0,0,1024,6,7467379099
12262,102496580,76269370,178765950,7,0,0,53248,1,3394516893
12263,102497000,76231558,178728558,7,0,0,112128,1,4745549076
12264,102498640,76093070,178591710,9,0,0,20992,4,2256375342
12265,102498650,76905464,179404114,3,0,0,215040,18,9857585274
12266,102505200,76064782,178569982,2,0,0,17920,1,1066746314
12267,102507360,76097295,178604655,0,0,0,21504,6,8689796218
12268,102535510,76513982,179049492,2,0,0,42496,1,1969551951
12269,102538950,76786687,179325637,7,0,0,14336,1,7794368291
12270,102539980,76593502,179133482,7,0,0,2560,1,3075308416
12271,102542300,76271224,178813524,9,0,0,7168,4,3748047363
12272,102554310,76452007,179006317,0,0,0,22016,6,1084071058
12273,102562010,76050921,178612931,6,0,0,14336,12,3606893295
12274,102575769,109337259,211913028,3,0,1,28672,18,3704613368
12275,102577739,109342645,211920384,3,0,1,6656,18,5479862936
12276,102592020,75934525,178526545,4,0,0,16896,7,3564864574
12277,102606210,76388852,178995062,5,0,0,18944,12,1608561918
12278,102607530,76867448,179474978,1,0,0,62464,1,638939093
12279,102609610,76557716,179167326,0,0,0,39936,6,3883200432
12280,102631619,109335571,211967190,3,0,1,10240,18,146542900
12281,102633070,109336990,211970060,6,0,1,17920,12,2336191870
12282,102640330,76764119,179404449,2,0,0,1024,1,1991366733
12283,102683550,76050023,178733573,6,0,0,16384,12,214715097
12284,102688560,76766290,179454850,1,0,0,3584,1,4468264635
12285,102728010,109289625,212017635,2,0,1,10752,1,56900046
12286,102753720,75995975,178749695,1,0,0,33792,1,6835105890
12287,102779490,76307513,179087003,7,0,0,16896,1,417075348
12288,102781420,75957956,178739376,7,0,0,18944,1,1245863350
12289,102784120,76285461,179069581,7,0,0,27648,1,158864149
12290,102784300,76852357,179636657,9,0,0,107008,4,6342578880
12291,102793940,76017377,178811317,0,0,0,29184,6,4858177818
12292,102796860,109220798,212017658,4,0,1,7168,7,3270336945
12293,102797580,76389604,179187184,2,0,0,25600,1,10329986284
12294,102802640,77196465,179999105,9,0,0,507904,4,4954677079
12295,102809490,75958043,178767533,6,0,0,5120,12,10094948953
12296,102816500,76376207,179192707,3,0,0,17920,18,4873326318
12297,102830900,76400708,179231608,2,0,0,512,1,5398584607
12298,102845950,76894789,179740739,1,0,0,54272,1,1386991653
12299,102848300,76095824,178944124,9,0,0,22528,4,2635336658
12300,102855870,76237792,179093662,3,0,0,3072,18,2441931711
12301,102874520,76207312,179081832,0,0,0,27648,6,3206655105
12302,102877780,109178925,212056705,0,0,1,8192,6,4669657815
12303,102887730,76244949,179132679,9,0,0,2560,4,6923555910
12304,102889060,76227973,179117033,1,0,0,46080,1,1810985274
12305,102894040,109251467,212145507,6,0,1,52736,12,757509288
12306,102894819,109256077,212150896,3,0,1,17408,18,1259044506
12307,102895280,109281185,212176465,6,0,1,6656,12,1932493327
12308,102897040,76607445,179504485,4,0,0,96768,7,4913280897
12309,102900320,76370517,179270837,9,0,0,9216,4,5652397905
12310,102925630,76336435,179262065,8,0,0,5632,11,1166462068
12311,102928900,109249831,212178731,8,0,1,3584,11,2360354773
12312,102934660,76137128,179071788,4,0,0,7168,7,7389315656
12313,102951831,109253965,212205796,9,0,1,14848,4,2034014682
12314,102954590,76499145,179453735,4,0,0,65536,7,6113619636
12315,102958090,76266148,179224238,3,0,0,12800,18,9223128486
12316,102987080,109218739,212205819,2,0,1,8192,1,5928764557
12317,102990479,109215363,212205842,3,0,1,3072,18,5636527986
12318,102992809,109213056,212205865,5,0,1,5120,12,1911889531
12319,102995600,77108914,180104514,2,0,0,38400,1,2935335916
12320,103008819,109197069,212205888,5,0,1,7168,12,9654067872
12321,103013480,109304775,212318255,7,0,1,16384,1,5531018115
12322,103017800,76551794,179569594,0,0,0,49664,6,28944947
12323,103035400,110307531,213342931,8,0,1,373760,11,9847091907
12324,103073320,76942344,180015664,4,0,0,54272,7,8959051553
12325,103091770,76556766,179648536,0,0,0,38912,6,5899080465
12326,103118100,110224854,213342954,2,0,1,8192,1,3030107386
12327,103121329,110222639,213343968,3,0,1,2048,18,1875897205
12328,103124900,77263682,180388582,7,0,0,413696,1,3436530426
12329,103125990,110218964,213344954,7,0,1,1536,1,1204869348
12330,103144759,110232905,213377664,5,0,1,27648,12,1046269375
12331,103144940,110280672,213425612,6,0,1,19968,12,3833764713
12332,103152180,76536763,179688943,9,0,0,16384,4,641083020
12333,103157430,76392813,179550243,3,0,0,50688,18,6974075251
12334,103170189,110287476,213457665,3,0,1,12288,18,6404120008
12335,103181090,77015854,180196944,7,0,0,5632,1,3601081384
12336,103188290,76220238,179408528,6,0,0,13312,12,6553827727
12337,103218379,110275791,213494170,3,0,1,48128,18,9695220794
12338,103220870,76313906,179534776,7,0,0,14848,1,10185830991
12339,103224390,110311782,213536172,0,0,1,7168,6,6046785865
12340,103255700,76346085,179601785,1,0,0,20992,1,10538339560
12341,103258380,76271849,179530229,7,0,0,58368,1,6008669329
12342,103265650,76819048,180084698,0,0,0,30208,6,2057074549
12343,103271460,76760364,180031824,2,0,0,52736,1,6928882599
12344,103289100,76898750,180187850,3,0,0,9216,18,5238332602
12345,103293300,76901905,180195205,9,0,0,24064,4,7805948265
12346,103299170,76832862,180132032,4,0,0,59392,7,6954818446
12347,103299420,110236775,213536195,6,0,1,12800,12,2136273704
12348,103300920,76774551,180075471,1,0,0,37376,1,4254308806
12349,103301020,76752534,180053554,9,0,0,29184,4,9397933779
12350,103308499,110227719,213536218,5,0,1,11264,12,9907278117
12351,103320730,76483984,179804714,3,0,0,20992,18,6387749007
12352,103321990,76742062,180064052,4,0,0,34304,7,3342669433
12353,103336900,76848119,180185019,7,0,0,158208,1,10199154886
12354,103360750,110198961,213559711,2,0,1,11776,1,7553809604
12355,103370790,110193803,213564593,6,0,1,6144,12,3489331055
12356,103394290,76650349,180044639,6,0,0,41984,12,5175736687
12357,103404430,77202157,180606587,2,0,0,261120,1,8435572574
12358,103417130,110163332,213580462,4,0,1,9216,7,108869054
12359,103422450,77060331,180482781,8,0,0,39936,11,4701678899
12360,103424600,110155885,213580485,6,0,1,1024,12,403086372
12361,103432430,76765317,180197747,9,0,0,2560,4,2168854598
12362,103438820,76954621,180393441,0,0,0,15872,6,6135828608
12363,103453690,77204290,180657980,3,0,0,151040,18,8548713699
12364,103464690,76735911,180200601,0,0,0,1536,6,8932159449
12365,103465700,77241254,180706954,6,0,0,129536,12,5344909218
12366,103472960,77276784,180749744,3,0,0,70144,18,8077117373
12367,103473360,77424859,180898219,3,0,0,46080,18,10491181563
12368,103473500,76789011,180262511,7,0,0,37376,1,9398736324
12369,103477240,76918789,180396029,7,0,0,8192,1,4129174694
12370,103501120,77366223,180867343,0,0,0,72192,6,8504596353
12371,103507130,77221219,180728349,9,0,0,70144,4,5250893344
12372,103507270,77277276,180784546,1,0,0,62464,1,1430567172
12373,103509110,77404722,180913832,1,0,0,22016,1,6867782692
12374,103512380,76956985,180469365,4,0,0,2048,7,3537263075
12375,103513510,77546557,181060067,6,0,0,7168,12,7742661686
12376,103544480,77067457,180611937,6,0,0,17408,12,5512804020
12377,103552339,110028169,213580508,3,0,1,1536,18,9860063083
12378,103561820,77201386,180763206,4,0,0,44032,7,1513910867
12379,103566650,77198763,180765413,1,0,0,7168,1,6946618490
12380,103574510,110006997,213581507,6,0,1,6144,12,8037696523
12381,103580630,77303526,180884156,2,0,0,40448,1,7071759152
12382,103581410,77465016,181046426,2,0,0,178688,1,6573811124
12383,103591670,77075762,180667432,4,0,0,30720,7,8773276210
12384,103619870,77504895,181124765,4,0,0,22528,7,1857967553
12385,103625670,77315948,180941618,4,0,0,11264,7,9083550587
12386,103630130,77215194,180845324,3,0,0,79360,18,8984146636
12387,103631180,77169961,180801141,0,0,0,5632,6,8288166271
12388,103645899,109985145,213631044,3,0,1,22016,18,1179500977
12389,103647359,109990301,213637660,5,0,1,18944,12,2319260658
12390,103670670,77387190,181057860,1,0,0,26624,1,3319539622
12391,103677280,77372445,181049725,9,0,0,10752,4,4050610398
12392,103682460,77470303,181152763,4,0,0,70656,7,152440751
12393,103698370,77256202,180954572,6,0,0,29696,12,1863296551
12394,103699110,109954957,213654067,8,0,1,8704,11,9060001917
12395,103705670,109954139,213659809,1,0,1,2560,1,4126699607
12396,103708070,109956924,213664994,2,0,1,16384,1,6664334231
12397,103713350,109967047,213680397,2,0,1,7680,1,6488735234
12398,103726910,109977744,213704654,4,0,1,5632,7,10545670940
12399,103727850,77480486,181208336,2,0,0,11264,1,8513606327
12400,103735901,110031711,213767612,9,0,1,14848,4,1851254123
12401,103741320,110115732,213857052,0,0,1,20992,6,596372028
12402,103744510,77329988,181074498,4,0,0,2048,7,1487781946
12403,103759720,110097998,213857718,4,0,1,1024,7,2063622606
12404,103779559,110082985,213862544,3,0,1,7680,18,5125967171
12405,103782800,77327903,181110703,7,0,0,58880,1,3898012998
12406,103785730,77481412,181267142,4,0,0,31744,7,3176304534
12407,103800330,77273521,181073851,4,0,0,9216,7,5034672362
12408,103804550,77554398,181358948,1,0,0,14336,1,3669179329
12409,103806100,110057750,213863850,1,0,1,2048,1,8771352176
12410,103809170,77680098,181489268,3,0,0,39936,18,1044667034
12411,103809830,77302144,181111974,4,0,0,4096,7,4285012667
12412,103813330,77377388,181190718,4,0,0,5632,7,4499347194
12413,103817880,77494061,181311941,7,0,0,19456,1,8542381388
12414,103827230,77353828,181181058,7,0,0,9216,1,4188125444
12415,103841480,77289732,181131212,1,0,0,3072,1,3963641518
12416,103847040,77377874,181224914,6,0,0,8192,12,8949624682
12417,103847189,110104682,213951871,3,0,1,16384,18,5544795282
12418,103852750,77417067,181269817,0,0,0,8704,6,10494780964
12419,103865040,77749862,181614902,9,0,0,62976,4,6223996237
12420,103866390,77581325,181447715,7,0,0,9728,1,8388608370
12421,103883220,77403794,181287014,1,0,0,5632,1,5188279805
12422,103895600,77630642,181526242,3,0,0,32768,18,3330230645
12423,103913110,77521699,181434809,0,0,0,14336,6,465836606
12424,103921860,110085017,214006877,7,0,1,36864,1,3790986034
12425,103946450,77686605,181633055,7,0,0,28160,1,5711190733
12426,103960060,77453777,181413837,4,0,0,11776,7,7651193798
12427,103962750,77447476,181410226,1,0,0,13312,1,2170870814
12428,103991030,77324366,181315396,0,0,0,11264,6,1114247622
12429,104011140,78039387,182050527,7,0,0,25088,1,1277395123
12430,104011410,77504825,181516235,9,0,0,43520,4,2324926991
12431,104013380,77536977,181550357,7,0,0,8192,1,5857977667
12432,104025770,77514506,181540276,4,0,0,13312,7,8940584695
12433,104059710,109991338,214051048,8,0,1,7168,11,7214639466
12434,104062530,77397040,181459570,9,0,0,6656,4,10349745138
12435,104077760,77509977,181587737,1,0,0,19968,1,10589351495
12436,104081150,77567216,181648366,7,0,0,50176,1,2917462375
12437,104081180,77748071,181829251,7,0,0,37888,1,4891458981
12438,104083960,78016535,182100495,4,0,0,2560,7,882690734
12439,104093140,77581120,181674260,6,0,0,4608,12,8130162358
12440,104099250,77712604,181811854,3,0,0,4096,18,3922281534
12441,104119241,109935909,214055150,9,0,1,7680,4,8564225080
12442,104127810,77590447,181718257,6,0,0,22016,12,2158884644
12443,104164280,77673886,181838166,9,0,0,29184,4,5935254530
12444,104168370,77683258,181851628,7,0,0,17408,1,2936645502
12445,104171651,109883538,214055189,9,0,1,3072,4,2735716178
12446,104175230,77634492,181809722,6,0,0,59904,12,8931869810
12447,104178070,78050584,182228654,1,0,0,9216,1,7398626735
12448,104179670,109875542,214055212,0,0,1,3584,6,7365399885
12449,104182950,109872285,214055235,0,0,1,14848,6,6279202291
12450,104184380,78210925,182395305,6,0,0,369152,12,3305915543
12451,104193210,77756347,181949557,3,0,0,38400,18,5214945728
12452,104198850,77423608,181622458,7,0,0,7168,1,10359197983
12453,104199690,109950694,214150384,2,0,1,2560,1,2749772292
12454,104204129,110015292,214219421,5,0,1,16896,12,8535892065
12455,104223300,77498568,181721868,9,0,0,11776,4,3111330028
12456,104226700,78294784,182521484,9,0,0,34304,4,7855061404
12457,104227820,77672953,181900773,4,0,0,5632,7,1380843930
12458,104235310,78202542,182437852,7,0,0,9216,1,5200988304
12459,104237050,77609251,181846301,3,0,0,26624,18,4809248677
12460,104245640,77923531,182169171,4,0,0,41472,7,6796407574
12461,104262970,77885722,182148692,5,0,0,53760,12,6522574430
12462,104268310,78547917,182816227,7,0,0,196096,1,7286944888
12463,104273039,109946674,214219713,3,0,1,512,18,8298834306
12464,104288680,78155793,182444473,1,0,0,1024,1,9236820027
12465,104289770,78141328,182431098,7,0,0,9728,1,4860061617
12466,104301450,110240852,214542302,7,0,1,53760,1,9222652667
12467,104320180,77930723,182250903,0,0,0,24064,6,6764056656
12468,104328799,110239381,214568180,3,0,1,3072,18,6470027762
12469,104334420,78100601,182435021,4,0,0,12800,7,1017613713
12470,104340420,78216490,182556910,0,0,0,13824,6,6219633792
12471,104341050,78103088,182444138,6,0,0,1536,12,3443481083
12472,104343690,78123519,182467209,3,0,0,53248,18,5454868329
12473,104353740,77800000,182153740,4,0,0,8704,7,2171982935
12474,104372190,78055921,182428111,0,0,0,36864,6,4998284080
12475,104375820,77734707,182110527,1,0,0,15360,1,7291352602
12476,104379030,78037826,182416856,7,0,0,70656,1,6327366606
12477,104388419,110181067,214569486,5,0,1,2048,12,7690236022
12478,104393760,110263259,214657019,0,0,1,16384,6,10241160034
12479,104400910,110291394,214692304,1,0,1,1536,1,8320301422
12480,104402670,78600565,183003235,9,0,0,74240,4,7389913287
12481,104425380,78114004,182539384,9,0,0,30720,4,1974609317
12482,104462500,110461387,214923887,6,0,1,20992,12,1720911689
12483,104463310,78252602,182715912,4,0,0,133120,7,9314188432
12484,104463430,78400064,182863494,9,0,0,11776,4,9729348262
12485,104464860,110602835,215067695,6,0,1,22528,12,7065975892
12486,104475470,78006664,182482134,3,0,0,32768,18,8119584479
12487,104487160,78564026,183051186,1,0,0,40448,1,7753332888
12488,104503280,78330675,182833955,9,0,0,11264,4,9770978695
12489,104506660,110681301,215187961,2,0,1,1024,1,9125171203
12490,104508020,77961864,182469884,1,0,0,8704,1,1646740316
12491,104515980,78596600,183112580,3,0,0,31744,18,851739302
12492,104516700,77926947,182443647,0,0,0,18944,6,98359099
12493,104520890,78780362,183301252,9,0,0,33792,4,5283593119
12494,104535420,78221028,182756448,1,0,0,53760,1,2887641030
12495,104544730,78034195,182578925,4,0,0,27136,7,8307856978
12496,104548600,110647207,215195807,2,0,1,4096,1,209616776
12497,104549410,78003257,182552667,9,0,0,43520,4,8731025390
12498,104562130,78281676,182843806,0,0,0,32256,6,2575052247
12499,104567700,110640633,215208333,1,0,1,3072,1,2186984413
12500,104575000,78449699,183024699,6,0,0,27136,12,5176600247
12501,104581480,78450932,183032412,7,0,0,25088,1,3412440672
12502,104594530,77991760,182586290,1,0,0,24064,1,10303943836
12503,104613310,77876491,182489801,1,0,0,25088,1,855818352
12504,104614090,110594266,215208356,1,0,1,14336,1,6826302668
12505,104640029,110568350,215208379,5,0,1,12288,12,2401592154
12506,104658820,78008021,182666841,1,0,0,62976,1,9204118515
12507,104667410,78313182,182980592,6,0,0,69632,12,2415018303
12508,104671590,78195873,182867463,7,0,0,12288,1,8867812694
12509,104672630,78975613,183648243,0,0,0,3072,6,1852377342
12510,104679290,78518725,183198015,1,0,0,52736,1,10384532283
12511,104695660,78044362,182740022,1,0,0,15872,1,4848430857
12512,104699190,77859147,182558337,9,0,0,4608,4,2477843202
12513,104718130,110538972,215257102,7,0,1,9216,1,8454481118
12514,104730370,78592137,183322507,9,0,0,69632,4,8630597286
12515,104732690,110668100,215400790,7,0,1,53760,1,7758010274
12516,104735199,110716533,215451732,3,0,1,10240,18,1446754918
12517,104740300,78090200,182830500,7,0,0,46592,1,4728696179
12518,104741300,78118560,182859860,9,0,0,29184,4,4467302420
12519,104742330,78637733,183380063,3,0,0,25600,18,6992887771
12520,104746690,78269718,183016408,9,0,0,10240,4,10550851968
12521,104765540,78296924,183062464,7,0,0,33280,1,8190934777
12522,104766460,78735176,183501636,1,0,0,4608,1,1249193652
12523,104791280,78221985,183013265,7,0,0,32768,1,3754876708
12524,104800090,110651665,215451755,0,0,1,1536,6,1679020350
12525,104818930,110674835,215493765,8,0,1,7168,11,4178091120
12526,104829790,110663998,215493788,6,0,1,13824,12,1851154962
12527,104845040,78282539,183127579,7,0,0,49152,1,6170887471
12528,104853610,78560539,183414149,5,0,0,11776,12,3427036857
12529,104874440,78016905,182891345,1,0,0,15360,1,579075821
12530,104881690,78157149,183038839,7,0,0,20992,1,4036601889
12531,104901080,78378396,183279476,4,0,0,72704,7,9857271721
12532,104909050,78645899,183554949,6,0,0,96256,12,5199688287
12533,104910780,77990825,182901605,6,0,0,8704,12,8581259251
12534,104912430,78678845,183591275,6,0,0,42496,12,8827505060
12535,104928860,110683327,215612187,8,0,1,33792,11,5275746836
12536,104929450,78205035,183134485,5,0,0,3072,12,5106215532
12537,104986690,78787177,183773867,5,0,0,19456,12,4655027152
12538,104987250,78369968,183357218,5,0,0,69632,12,6130396903
12539,105005999,110784090,215790089,3,0,1,512,18,10165390760
12540,105006370,78444665,183451035,0,0,0,34304,6,4784814086
12541,105024080,110768915,215792995,0,0,1,4608,6,3859659332
12542,105026219,110777755,215803974,5,0,1,512,12,3787585948
12543,105042360,78696493,183738853,7,0,0,14336,1,4019183774
12544,105047880,78004421,183052301,5,0,0,3584,12,7990023884
12545,105051010,78017249,183068259,6,0,0,18944,12,2132123746
12546,105052440,77885524,182937964,3,0,0,1536,18,1886370434
12547,105059230,78324132,183383362,5,0,0,10752,12,748317204
12548,105060080,78312160,183372240,0,0,0,36864,6,6442433561
12549,105074540,110729457,215803997,4,0,1,1024,7,1795886312
12550,105090520,110713500,215804020,2,0,1,1536,1,2548472025
12551,105117230,78013359,183130589,4,0,0,9728,7,6517840223
12552,105121500,110682543,215804043,6,0,1,6144,12,2223787908
12553,105127740,78152695,183280435,5,0,0,3072,12,1075887546
12554,105130130,110673936,215804066,0,0,1,512,6,8027503619
12555,105132090,78483723,183615813,4,0,0,65024,7,6326314708
12556,105156740,78271782,183428522,6,0,0,11264,12,9177773828
12557,105177000,78107982,183284982,0,0,0,14848,6,3144505319
12558,105182130,78178855,183360985,8,0,0,12288,11,782171176
12559,105185350,78510778,183696128,4,0,0,29184,7,6032293396
12560,105192550,110611539,215804089,7,0,1,4608,1,9840500592
12561,105199680,78127428,183327108,4,0,0,14848,7,4253732703
12562,105199950,78289441,183489391,5,0,0,43520,12,1988592914
12563,105208150,78296785,183504935,7,0,0,10752,1,5456380950
12564,105211540,78446158,183657698,0,0,0,30208,6,7256212947
12565,105217410,78276060,183493470,7,0,0,13312,1,7053887636
12566,105217470,78073463,183290933,4,0,0,19456,7,3102636183
12567,105226970,78369008,183595978,3,0,0,15360,18,9658437003
12568,105246910,78572687,183819597,6,0,0,14848,12,7936765895
12569,105248160,78643592,183891752,4,0,0,33792,7,3496367381
12570,105260781,110556762,215817543,9,0,1,10752,4,1513455261
12571,105264310,78608671,183872981,6,0,0,20992,12,7573043414
12572,105266809,110646396,215913205,3,0,1,22016,18,9975613728
12573,105269190,79053103,184322293,4,0,0,97792,7,5580806031
12574,105269570,78250223,183519793,6,0,0,1024,12,6555669307
12575,105275400,78365955,183641355,6,0,0,21504,12,10066140491
12576,105299440,78435022,183734462,5,0,0,73216,12,801699700
12577,105327180,78712559,184039739,9,0,0,68096,4,330542416
12578,105336990,78163211,183500201,0,0,0,22016,6,3742545078
12579,105339940,110593582,215933522,4,0,1,3072,7,2304743200
12580,105344530,110630796,215975326,2,0,1,23040,1,5230506024
12581,105348400,110855725,216204125,2,0,1,24064,1,5017991464
12582,105376130,78947278,184323408,6,0,0,3584,12,5378611122
12583,105380760,110924174,216304934,0,0,1,28672,6,5038918809
12584,105387219,110962920,216350139,3,0,1,14336,18,3642311994
12585,105388713,79044969,184433682,6,0,0,44032,12,7113778376
12586,105390261,111189868,216580129,9,0,1,33792,4,7987175473
12587,105396780,78126853,183523633,7,0,0,3584,1,9475263372
12588,105397690,111474181,216871871,6,0,1,20480,12,691588735
12589,105404550,111506996,216911546,0,0,1,1536,6,721346754
12590,105409100,78571101,183980201,5,0,0,29696,12,4402048126
12591,105423340,111488229,216911569,1,0,1,3584,1,1463996170
12592,105433340,78534023,183967363,4,0,0,75776,7,9021115046
12593,105464620,78551402,184016022,4,0,0,54272,7,7733547474
12594,105473299,111438293,216911592,5,0,1,3072,12,10394862154
12595,105481020,78604394,184085414,9,0,0,53248,4,12690087
12596,105482750,78743242,184225992,7,0,0,58880,1,6499814320
12597,105490370,78639978,184130348,1,0,0,63488,1,9402255246
12598,105510720,79081165,184591885,3,0,0,75264,18,7832496255
12599,105522850,78137183,183660033,6,0,0,1024,12,6162590530
12600,105530010,111382102,216912112,8,0,1,5632,11,9408501291
12601,105545230,78800984,184346214,0,0,0,8704,6,5323550424
12602,105571610,78372642,183944252,1,0,0,59904,1,4897763074
12603,105589790,111323948,216913738,4,0,1,2560,7,2938421189
12604,105611430,111304254,216915684,0,0,1,3072,6,156962043
12605,105620550,79024583,184645133,7,0,0,6656,1,2321083077
12606,105622400,78157821,183780221,7,0,0,18432,1,8444032869
12607,105625640,78345490,183971130,6,0,0,12288,12,10580977794
12608,105626740,111290250,216916990,7,0,1,2048,1,4578997367
12609,105637530,78169307,183806837,9,0,0,512,4,9715946449
12610,105646580,78731014,184377594,5,0,0,30208,12,2729723111
12611,105653000,78639474,184292474,3,0,0,39936,18,5739903488
12612,105659860,78836474,184496334,4,0,0,72192,7,8470272122
12613,105661580,78378494,184040074,5,0,0,1024,12,3401888145
12614,105668790,78146014,183814804,6,0,0,20992,12,551896897
12615,105670570,78436022,184106592,5,0,0,2560,12,6567168805
12616,105676550,78966524,184643074,7,0,0,39936,1,1314585772
12617,105676890,78426702,184103592,9,0,0,17920,4,9141988126
12618,105683750,78466034,184149784,5,0,0,3072,12,1324958527
12619,105687320,111230016,216917336,6,0,1,512,12,9102108552
12620,105698310,79101812,184800122,3,0,0,123392,18,3175761445
12621,105700390,78440456,184140846,4,0,0,30720,7,10670020963
12622,105704130,78570199,184274329,9,0,0,75776,4,9985351371
12623,105705740,78492806,184198546,4,0,0,7168,7,6045260464
12624,105732790,78463549,184196339,6,0,0,18944,12,8106529632
12625,105740810,78390653,184131463,7,0,0,3584,1,5486397601
12626,105742920,111174762,216917682,8,0,1,512,11,9282034627
12627,105743120,78697293,184440413,6,0,0,22016,12,10034150682
12628,105749229,111365436,217114665,3,0,1,60928,18,10025036692
12629,105781740,78627499,184409239,4,0,0,13312,7,7570705187
12630,105783080,78775643,184558723,1,0,0,132096,1,3230557252
12631,105799059,111320995,217120054,5,0,1,17408,12,9445236730
12632,105809450,111324148,217133598,2,0,1,14336,1,2381883603
12633,105823900,78341708,184165608,0,0,0,22016,6,8063088569
12634,105825810,78233886,184059696,4,0,0,25088,7,5067230207
12635,105841110,78718572,184559682,4,0,0,3072,7,10110000801
12636,105841880,78526487,184368367,9,0,0,10240,4,4395782420
12637,105844900,78764191,184609091,5,0,0,56320,12,9959417398
12638,105858830,78772045,184630875,1,0,0,11264,1,3381228557
12639,105877140,78271685,184148825,6,0,0,26112,12,10331633474
12640,105896740,78255719,184152459,7,0,0,8704,1,3609649107
12641,105906770,111291581,217198351,0,0,1,12288,6,6363964701
12642,105909350,78429159,184338509,5,0,0,30720,12,4948571782
12643,105913150,111328083,217241233,7,0,1,23552,1,9896647630
12644,105913270,78829462,184742732,4,0,0,15872,7,2397182807
12645,105913360,78712157,184625517,0,0,0,46592,6,3524444935
12646,105917350,78778021,184695371,5,0,0,84480,12,4846540090
12647,105918050,78693248,184611298,7,0,0,7168,1,2210825623
12648,105921580,78919639,184841219,3,0,0,70144,18,8250501238
12649,105925190,78894634,184819824,0,0,0,64512,6,8482358569
12650,105930160,79443555,185373715,0,0,0,30720,6,9376064754
12651,105934040,78718946,184652986,6,0,0,10752,12,2748459659
12652,105935020,79007072,184942092,4,0,0,19968,7,3357046221
12653,105936400,78506064,184442464,5,0,0,6656,12,10542915515
12654,105964030,78903466,184867496,5,0,0,39936,12,10431600207
12655,105964410,78538967,184503377,1,0,0,23040,1,2233402674
12656,106005660,111236555,217242215,2,0,1,512,1,2534689692
12657,106012080,111243948,217256028,2,0,1,14848,1,1997778252
12658,106028670,79163012,185191682,4,0,0,81920,7,10036686134
12659,106038490,78897495,184935985,6,0,0,62976,12,6470347305
12660,106051670,79056131,185107801,1,0,0,32768,1,4666632967
12661,106062430,79301902,185364332,9,0,0,42496,4,9696817160
12662,106066350,78850082,184916432,9,0,0,38912,4,1468742422
12663,106067750,78969792,185037542,3,0,0,47104,18,955612915
12664,106099590,111156784,217256374,1,0,1,512,1,3952020427
12665,106101300,111155740,217257040,8,0,1,1024,11,5270952021
12666,106103640,78370675,184474315,1,0,0,16384,1,2228172793
12667,106103940,78523480,184627420,8,0,0,6144,11,7702363081
12668,106104210,78850123,184954333,3,0,0,12288,18,7563380616
12669,106127370,78727935,184855305,9,0,0,43520,4,6119099742
12670,106130959,111147635,217278594,5,0,1,9216,12,7808112209
12671,106143460,78732560,184876020,0,0,0,27648,6,5895751621
12672,106157120,79008732,185165852,4,0,0,46592,7,7283095076
12673,106158850,78938944,185097794,6,0,0,74752,12,9988304569
12674,106165770,78738569,184904339,9,0,0,6656,4,2603784853
12675,106169220,78672802,184842022,9,0,0,2560,4,8888112320
12676,106174270,111106270,217280540,2,0,1,3072,1,2034227975
12677,106179040,78866504,185045544,3,0,0,23040,18,526725255
12678,106181910,111161871,217343781,6,0,1,43520,12,150197031
12679,106182320,78715421,184897741,6,0,0,16384,12,1999645938
12680,106187920,79052230,185240150,6,0,0,34304,12,298905327
12681,106200600,78924251,185124851,5,0,0,26112,12,484482189
12682,106214610,79007296,185221906,8,0,0,1024,11,5769560595
12683,106222840,78474582,184697422,4,0,0,6656,7,2504760528
12684,106226890,79268032,185494922,4,0,0,107008,7,10581307489
12685,106241230,78746061,184987291,3,0,0,3584,18,1992643676
12686,106243700,78658588,184902288,1,0,0,14848,1,2456400082
12687,106248460,78821291,185069751,8,0,0,15872,11,4630507075
12688,106256480,78860392,185116872,6,0,0,29696,12,7396649188
12689,106265700,78720476,184986176,1,0,0,31232,1,7726055725
12690,106267640,78787139,185054779,4,0,0,30208,7,1398752512
12691,106271090,79333188,185604278,8,0,0,23040,11,8822722054
12692,106275639,111164972,217440611,3,0,1,5120,18,4782286013
12693,106276270,78983651,185259921,6,0,0,44032,12,5113998112
12694,106281650,111161227,217442877,6,0,1,3584,12,5251890693
12695,106289571,111233094,217522665,9,0,1,1024,4,8903401512
12696,106305240,79234652,185539892,4,0,0,26624,7,862490629
12697,106307409,111215279,217522688,3,0,1,3584,18,7278371735
12698,106310110,79087254,185397364,8,0,0,36352,11,273337819
12699,106310830,79425163,185735993,5,0,0,1024,12,6257917212
12700,106323530,78991779,185315309,0,0,0,23040,6,3111072409
12701,106334880,111187831,217522711,1,0,1,2048,1,3201838757
12702,106337250,79466823,185804073,1,0,0,129024,1,2589268173
12703,106354160,79307022,185661182,7,0,0,50688,1,10244411764
12704,106355110,79164841,185519951,0,0,0,9728,6,1132591686
12705,106355940,79283463,185639403,1,0,0,40960,1,2066453575
12706,106361170,79066913,185428083,0,0,0,30208,6,3224416845
12707,106368010,111154724,217522734,7,0,1,7168,1,9303885725
12708,106368560,79442781,185811341,1,0,0,11776,1,1646781526
12709,106375460,78663041,185038501,0,0,0,3072,6,1470484160
12710,106384300,79132664,185516964,6,0,0,49664,12,2250829646
12711,106384670,78860807,185245477,8,0,0,17408,11,4647815119
12712,106392769,111430808,217823577,5,0,1,45056,12,7019247493
12713,106396851,111438772,217835623,9,0,1,13312,4,4813327025
12714,106407940,79566467,185974407,0,0,0,349184,6,9197495046
12715,106410880,79090929,185501809,4,0,0,22528,7,2055606114
12716,106412200,78931801,185344001,5,0,0,16384,12,1551541908
12717,106422731,111431203,217853934,9,0,1,10752,4,7555459227
12718,106426050,111451467,217877517,4,0,1,7168,7,9992536284
12719,106440930,79640419,186081349,0,0,0,25600,6,6831939453
12720,106444480,79557562,186002042,3,0,0,90624,18,10488754575
12721,106461870,79650234,186112104,8,0,0,100864,11,10119757094
12722,106476990,78939611,185416601,7,0,0,10752,1,8444787046
12723,106487710,111529837,218017547,8,0,1,4608,11,9970480521
12724,106491070,79037507,185528577,6,0,0,18432,12,6700554810
12725,106503990,79769302,186273292,6,0,0,2048,12,1509408805
12726,106521030,79163716,185684746,2,0,0,13312,1,4570810878
12727,106524260,78854046,185378306,9,0,0,1536,4,3689270050
12728,106529229,111609525,218138754,5,0,1,20480,12,4662659139
12729,106529650,79012761,185542411,0,0,0,8192,6,5403816838
12730,106532530,78996561,185529091,7,0,0,1024,1,5360476420
12731,106535180,79062055,185597235,8,0,0,23552,11,5493705786
12732,106547750,78826464,185374214,7,0,0,1536,1,6588497947
12733,106550370,79257337,185807707,0,0,0,512,6,9857956862
12734,106554720,79289030,185843750,2,0,0,3584,1,1730665981
12735,106564610,79180483,185745093,3,0,0,3584,18,2689045593
12736,106567760,78860502,185428262,7,0,0,512,1,8962140570
12737,106579870,79175542,185755412,3,0,0,33792,18,5172496513
12738,106581560,79113996,185695556,9,0,0,21504,4,1509811594
12739,106582300,78940638,185522938,4,0,0,9728,7,6118893565
12740,106583520,79478720,186062240,0,0,0,52224,6,5560281061
12741,106614660,79428346,186043006,7,0,0,88576,1,3598731050
12742,106623810,111514967,218138777,2,0,1,512,1,6338012255
12743,106628750,79439285,186068035,8,0,0,18944,11,9912746051
12744,106631410,79010200,185641610,0,0,0,7168,6,8900334508
12745,106633740,79011626,185645366,4,0,0,8704,7,235184912
12746,106634500,111504300,218138800,7,0,1,2560,1,1485867747
12747,106642350,111496473,218138823,1,0,1,13312,1,1618976444
12748,106648890,79109747,185758637,8,0,0,1536,11,7214028476
12749,106666120,79486850,186152970,2,0,0,29184,1,3687716429
12750,106670130,79494563,186164693,9,0,0,38400,4,7830157197
12751,106672010,79156837,185828847,0,0,0,5120,6,7002943
12752,106679890,78848866,185528756,0,0,0,512,6,4878954336
12753,106692790,78996191,185688981,5,0,0,13824,12,5100801820
12754,106699700,78966029,185665729,5,0,0,14848,12,8247477969
12755,106746180,79379573,186125753,7,0,0,30208,1,2829833939
12756,106750170,79323356,186073526,0,0,0,17920,6,8367448923
12757,106767960,111487956,218255916,6,0,1,6656,12,3619952074
12758,106778990,79230719,186009709,7,0,0,25088,1,2590645855
12759,106787260,111468679,218255939,1,0,1,5120,1,4064357044
12760,106789760,111466202,218255962,0,0,1,3584,6,760650981
12761,106797370,79805347,186602717,1,0,0,7168,1,3945578779
12762,106797669,111458316,218255985,5,0,1,5632,12,7539038473
12763,106804210,79003318,185807528,0,0,0,11264,6,1556849416
12764,106806370,79328298,186134668,3,0,0,29184,18,2050328424
12765,106864450,79337633,186202083,3,0,0,24576,18,2465522399
12766,106875560,79493702,186369262,8,0,0,21504,11,4068195897
12767,106883100,79479587,186362687,0,0,0,78336,6,5485091716
12768,106884660,111371348,218256008,1,0,1,2560,1,3397797329
12769,106889630,79364428,186254058,7,0,0,81920,1,1454442838
12770,106900511,79115484,186015995,9,0,0,20480,4,10530977954
12771,106921160,79195023,186116183,4,0,0,13312,7,3074376189
12772,106922060,79506586,186428646,9,0,0,109056,4,1389986774
12773,106923060,79585555,186508615,6,0,0,88576,12,910670836
12774,106926360,79261635,186187995,4,0,0,2560,7,5519307446
12775,106935700,79180818,186116518,4,0,0,1024,7,9256649562
12776,106935980,79718830,186654810,7,0,0,36864,1,4919817807
12777,106936910,111319121,218256031,4,0,1,9216,7,6833386654
12778,106939660,79204395,186144055,5,0,0,18944,12,5399662502
12779,106956960,111326656,218283616,7,0,1,41984,1,10061405958
12780,106968300,79078005,186046305,5,0,0,10752,12,2993328930
12781,106980980,79456893,186437873,2,0,0,30208,1,10588864725
12782,106983220,79551933,186535153,9,0,0,36864,4,148527571
12783,106986350,79352446,186338796,9,0,0,96768,4,4854610604
12784,107015310,79286442,186301752,7,0,0,25088,1,2827453062
12785,107016170,79206119,186222289,8,0,0,8192,11,7255864338
12786,107017370,111310965,218328335,1,0,1,16384,1,10118014955
12787,107027570,111310818,218338388,1,0,1,8704,1,1897525609
12788,107059450,79422154,186481604,0,0,0,57856,6,5917101855
12789,107069070,79609669,186678739,1,0,0,2560,1,2093196953
12790,107086950,79294370,186381320,8,0,0,34304,11,7102449071
12791,107092400,79672744,186765144,6,0,0,32768,12,8162932739
12792,107092510,79459836,186552346,8,0,0,25088,11,10495199122
12793,107096080,79274765,186370845,5,0,0,5120,12,381783226
12794,107103630,79487651,186591281,8,0,0,11264,11,4810344280
12795,107111180,79836522,186947702,9,0,0,43520,4,3735234816
12796,107113080,111225331,218338411,8,0,1,2048,11,4195203171
12797,107118550,79422710,186541260,3,0,0,19968,18,9484138171
12798,107131710,79724061,186855771,3,0,0,96768,18,6550043258
12799,107135040,79465470,186600510,7,0,0,19968,1,6265102950
12800,107150911,79411394,186562305,9,0,0,17408,4,5860906679
12801,107154170,79542989,186697159,3,0,0,45056,18,2098082741
12802,107157370,111199116,218356486,1,0,1,7168,1,9232439152
12803,107176240,79339106,186515346,1,0,0,22016,1,1069381820
12804,107176420,79684389,186860809,8,0,0,16384,11,4512317014
12805,107177120,111209633,218386753,6,0,1,2048,12,2619486013
12806,107178911,111211562,218390473,9,0,1,6144,4,9481661225
12807,107186040,79601555,186787595,9,0,0,11264,4,2528278960
12808,107186480,79676692,186863172,0,0,0,7680,6,332130022
12809,107205140,79885610,187090750,4,0,0,79872,7,1111831589
12810,107230409,111262744,218493153,5,0,1,32256,12,8426779265
12811,107231490,79478404,186709894,6,0,0,19456,12,2376241067
12812,107234760,79774991,187009751,4,0,0,53248,7,1562378820
12813,107255490,111239289,218494779,6,0,1,2560,12,1603441227
12814,107266610,111261090,218527700,1,0,1,20480,1,1488136660
12815,107268860,112293185,219562045,2,0,1,7168,1,2441095512
12816,107276641,79478496,186755137,9,0,0,52736,4,3443711464
12817,107277360,79849009,187126369,4,0,0,37888,7,2880876368
12818,107280351,112282360,219562711,9,0,1,1024,4,6393762367
12819,107284170,79527127,186811297,2,0,0,62464,1,7943835176
12820,107286970,80228367,187515337,3,0,0,52224,18,6183649591
12821,107293160,112270217,219563377,4,0,1,1024,7,6960871967
12822,107298420,112269783,219568203,2,0,1,7680,1,5017982170
12823,107299300,79484840,186784140,5,0,0,37888,12,7692187264
12824,107309280,112335924,219645204,8,0,1,3072,11,7932857106
12825,107310280,79515984,186826264,0,0,0,27136,6,5932261137
12826,107319470,79780062,187099532,7,0,0,21504,1,3686736802
12827,107324900,80027111,187352011,0,0,0,1536,6,2392992622
12828,107364140,79702251,187066391,3,0,0,77824,18,2998680652
12829,107367550,79746357,187113907,3,0,0,47104,18,9604041805
12830,107386210,79547335,186933545,2,0,0,9728,1,1226419466
12831,107387410,79751166,187138576,4,0,0,39936,7,7579888723
12832,107397420,79747186,187144606,3,0,0,10752,18,8882959825
12833,107401680,112310102,219711782,2,0,1,6656,1,5295325450
12834,107406420,79686537,187092957,6,0,0,7168,12,885593658
12835,107407390,80017998,187425388,3,0,0,66048,18,3811697166
12836,107415480,79965927,187381407,3,0,0,53760,18,4112515265
12837,107425750,79689052,187114802,7,0,0,2560,1,4433167927
12838,107427530,79883659,187311189,3,0,0,101888,18,8550441635
12839,107471140,79488688,186959828,3,0,0,1536,18,2697044781
12840,107479500,79712023,187191523,3,0,0,21504,18,8136393792
12841,107481510,80112433,187593943,2,0,0,36864,1,5912070249
12842,107486860,79972361,187459221,5,0,0,46080,12,7200496059
12843,107502870,79719364,187222234,4,0,0,23552,7,3484085441
12844,107508120,79878146,187386266,7,0,0,15872,1,3239364728
12845,107515200,79623921,187139121,6,0,0,1536,12,2580324420
12846,107516490,112215562,219732052,6,0,1,30208,12,1920821241
12847,107522240,80052880,187575120,2,0,0,80384,1,8317058860
12848,107532080,79649210,187181290,4,0,0,2048,7,5627107387
12849,107532450,79817220,187349670,9,0,0,19968,4,2106804847
12850,107555620,79841635,187397255,8,0,0,6144,11,8402846452
12851,107557430,79760334,187317764,0,0,0,21504,6,6674830114
12852,107558840,79834937,187393777,3,0,0,24576,18,2411000072
12853,107561080,79766618,187327698,3,0,0,8192,18,8188262919
12854,107566710,80307205,187873915,8,0,0,46080,11,9635897980
12855,107573790,80073107,187646897,0,0,0,4096,6,8219885052
12856,107573810,80142363,187716173,3,0,0,18944,18,5666727072
12857,107577300,79818060,187395360,1,0,0,5120,1,5434255880
12858,107581240,112314444,219895684,7,0,1,24576,1,4870482194
12859,107586960,80123418,187710378,9,0,0,59392,4,2698477616
12860,107591610,80547554,188139164,1,0,0,42496,1,1095289347
12861,107594020,80073336,187667356,4,0,0,67072,7,9359539176
12862,107600960,79838050,187439010,2,0,0,30720,1,9168468199
12863,107607190,79867423,187474613,3,0,0,4608,18,831128360
12864,107610810,80079345,187690155,0,0,0,74752,6,8738279733
12865,107625410,80213838,187839248,4,0,0,46592,7,9915993576
12866,107625980,112306098,219932078,8,0,1,2048,11,620110196
12867,107648150,79877373,187525523,2,0,0,4096,1,3161712790
12868,107662050,80262820,187924870,9,0,0,29696,4,5859061069
12869,107662079,112475606,220137685,5,0,1,19456,12,8529222353
12870,107663511,112597130,220260641,9,0,1,9728,4,8855532725
12871,107675390,79804124,187479514,4,0,0,5632,7,8388461389
12872,107679520,80145509,187825029,7,0,0,2048,1,2868123765
12873,107683130,79811771,187494901,6,0,0,18432,12,364132517
12874,107692510,79831742,187524252,7,0,0,29184,1,5240744159
12875,107694340,79670664,187365004,5,0,0,29184,12,9712644160
12876,107697290,112563374,220260664,1,0,1,11776,1,7077270423
12877,107711540,112551674,220263214,4,0,1,3584,7,10322607407
12878,107722320,80102062,187824382,0,0,0,49152,6,4960837848
12879,107724540,112711165,220435705,6,0,1,17920,12,1955802536
12880,107749430,79896196,187645626,3,0,0,8192,18,5940850780
12881,107756500,80644318,188400818,0,0,0,345600,6,4867584767
12882,107761880,80341485,188103365,3,0,0,74752,18,3594145714
12883,107770770,80068969,187839739,3,0,0,1536,18,4510881399
12884,107776420,80152373,187928793,3,0,0,12800,18,6662675797
12885,107786540,80129259,187915799,2,0,0,27648,1,9443073476
12886,107787279,112648449,220435728,3,0,1,512,18,8343325685
12887,107794850,80468921,188263771,7,0,0,102400,1,2696349871
12888,107796059,112639692,220435751,3,0,1,3584,18,8991718652
12889,107807470,79937599,187745069,9,0,0,17920,4,9961596357
12890,107814300,80668955,188483255,2,0,0,245760,1,4933254316
12891,107814740,112699989,220514729,4,0,1,28672,7,7358410479
12892,107827440,80700546,188527986,2,0,0,55296,1,929274602
12893,107834750,80283225,188117975,1,0,0,5632,1,9908976082
12894,107844290,79874246,187718536,9,0,0,7680,4,7791167218
12895,107849100,80108515,187957615,9,0,0,20480,4,3952193894
12896,107862890,80354930,188217820,4,0,0,24576,7,9975983999
12897,107863200,80696344,188559544,0,0,0,21504,6,5794208054
12898,107865040,80335419,188200459,2,0,0,11776,1,4267477915
12899,107871990,112767849,220639839,1,0,1,20992,1,2008791387
12900,107889120,81133355,189022475,8,0,0,14336,11,2276605937
12901,107908970,80582732,188491702,3,0,0,27648,18,9370443276
12902,107917580,80828001,188745581,2,0,0,46592,1,2046300069
12903,107922600,80881706,188804306,6,0,0,147968,12,4072847165
12904,107929910,80349167,188279077,0,0,0,25600,6,6301417140
12905,107931590,80641508,188573098,8,0,0,23552,11,8037292093
12906,107931650,81058480,188990130,4,0,0,82944,7,7347679672
12907,107939610,80640644,188580254,8,0,0,9728,11,3549707022
12908,107992070,80914709,188906779,2,0,0,1024,1,2167493683
12909,107999940,80114285,188114225,0,0,0,12288,6,1952412989
12910,108002920,81251479,189254399,4,0,0,62464,7,5375171732
12911,108012970,80824742,188837712,7,0,0,79872,1,3455793385
12912,108017280,80845832,188863112,3,0,0,37376,18,6398654735
12913,108020240,112995111,221015351,1,0,1,8192,1,4781742293
12914,108024410,81128651,189153061,2,0,0,30720,1,5731110052
12915,108026920,80254052,188280972,2,0,0,6144,1,9360314721
12916,108030670,81034371,189065041,0,0,0,5120,6,6708940325
12917,108045230,80363122,188408352,5,0,0,24576,12,897372394
12918,108046820,80519010,188565830,7,0,0,20480,1,7599765240
12919,108047220,80505749,188552969,1,0,0,81920,1,10629476895
12920,108057370,80448083,188505453,0,0,0,45056,6,5076831328
12921,108060490,80904345,188964835,7,0,0,14336,1,1021117
12922,108065380,80445712,188511092,0,0,0,18432,6,1232968576
12923,108081410,112986667,221068077,7,0,1,5120,1,3962558721
12924,108102050,112966050,221068100,1,0,1,5120,1,93834933
12925,108119450,81364288,189483738,5,0,0,30208,12,5438304448
12926,108121720,80489360,188611080,9,0,0,22016,4,10451370848
12927,108126010,81291321,189417331,3,0,0,25600,18,8752190220
12928,108127180,113014189,221141369,4,0,1,11776,7,4806729814
12929,108128370,81012633,189141003,9,0,0,108544,4,2369612214
12930,108130320,81216578,189346898,5,0,0,123392,12,10359527745
12931,108138390,80475365,188613755,3,0,0,8704,18,7154815205
12932,108150750,80764955,188915705,0,0,0,17920,6,3079662053
12933,108160600,80905712,189066312,6,0,0,4096,12,6583233379
12934,108160760,81045549,189206309,4,0,0,18944,7,3409811736
12935,108161300,80799144,188960444,6,0,0,92672,12,8841605414
12936,108163930,80753202,188917132,3,0,0,4608,18,7044108810
12937,108165430,81052134,189217564,2,0,0,36864,1,3357024574
12938,108166010,81206807,189372817,6,0,0,84992,12,7687016437
12939,108175290,81115324,189290614,6,0,0,35328,12,6794722878
12940,108177350,80930558,189107908,7,0,0,106496,1,9438858046
12941,108178390,81388246,189566636,7,0,0,7680,1,6434411372
12942,108188340,80617439,188805779,5,0,0,4608,12,5187518655
12943,108192530,81280554,189473084,1,0,0,133120,1,10043241904
12944,108194680,81509128,189703808,8,0,0,52736,11,2777318482
12945,108196600,80673874,188870474,2,0,0,1024,1,6439913938
12946,108198350,81435760,189634110,6,0,0,111616,12,4390220428
12947,108199479,112944796,221144275,5,0,1,4608,12,1023862989
12948,108209530,81184329,189393859,9,0,0,41984,4,8590715892
12949,108210950,81389129,189600079,8,0,0,68608,11,9251946249
12950,108217400,81308949,189526349,3,0,0,139776,18,5790678358
12951,108233750,81330523,189564273,3,0,0,9728,18,8216893834
12952,108236650,80907028,189143678,5,0,0,8704,12,8845453777
12953,108236900,80928820,189165720,0,0,0,41472,6,9002204052
12954,108242000,80925459,189167459,9,0,0,5632,4,8815154566
12955,108265680,81273753,189539433,4,0,0,18944,7,23358600
12956,108265990,81013837,189279827,8,0,0,32256,11,5416522720
12957,108272820,81402316,189675136,8,0,0,21504,11,9308263114
12958,108274960,112869661,221144621,8,0,1,512,11,9387408381
12959,108277510,112867457,221144967,8,0,1,512,11,2738836911
12960,108280070,80902519,189182589,5,0,0,25088,12,2302920576
12961,108292911,112853042,221145953,9,0,1,1536,4,8278904346
12962,108304030,81364336,189668366,9,0,0,24576,4,2633473131
12963,108306250,81088568,189394818,7,0,0,3072,1,4051949448
12964,108318510,81400751,189719261,1,0,0,39424,1,1529729549
12965,108318960,81337816,189656776,8,0,0,72192,11,9214015902
12966,108326410,81308347,189634757,1,0,0,2048,1,1162399639
12967,108330020,81440235,189770255,8,0,0,47104,11,6957651382
12968,108330830,112843932,221174762,4,0,1,17408,7,5896852817
12969,108334440,81596218,189930658,8,0,0,35840,11,1369930689
12970,108337470,81348484,189685954,1,0,0,18944,1,1956929942
12971,108346220,81436809,189783029,6,0,0,11776,12,10493487372
12972,108355830,81505067,189860897,0,0,0,10752,6,1654685918
12973,108363830,81592830,189956660,0,0,0,10752,6,2818551462
12974,108389450,112785335,221174785,8,0,1,4608,11,6656187695
12975,108409010,81065501,189474511,1,0,0,4608,1,7389661990
12976,108409530,81332876,189742406,8,0,0,25600,11,5243186328
12977,108431060,81600501,190031561,2,0,0,19456,1,9851225288
12978,108442699,113101495,221544194,3,0,1,8192,18,10090109825
12979,108455580,80925372,189380952,7,0,0,26624,1,6339968682
12980,108465720,81327004,189792724,1,0,0,31744,1,4087592206
12981,108484539,113059678,221544217,5,0,1,7680,12,995442583
12982,108487220,81694281,190181501,5,0,0,106496,12,2217467721
12983,108491750,81169105,189660855,8,0,0,13312,11,9850298828
12984,108496030,81529580,190025610,7,0,0,28160,1,4142759389
12985,108501290,80920353,189421643,6,0,0,9216,12,7227156705
12986,108504690,81752596,190257286,9,0,0,43520,4,8166690956
12987,108547750,81347757,189895507,5,0,0,32768,12,4794245347
12988,108575040,81473832,190048872,4,0,0,2560,7,1685009166
12989,108575260,112981662,221556922,8,0,1,30720,11,2926195358
12990,108581220,81654952,190236172,8,0,0,103936,11,8629609540
12991,108585140,113011296,221596436,0,0,1,3072,6,6846579641
12992,108591920,81327795,189919715,7,0,0,66048,1,1227469268
12993,108600050,81228068,189828118,6,0,0,39936,12,9558360331
12994,108626780,81690258,190317038,6,0,0,31744,12,835534502
12995,108645100,112979664,221624764,1,0,1,29184,1,6138660760
12996,108649790,81030369,189680159,8,0,0,16384,11,8211116581
12997,108661600,81749051,190410651,2,0,0,28672,1,7419966434
12998,108663160,81152767,189815927,5,0,0,25600,12,774219701
12999,108672740,81935906,190608646,9,0,0,64512,4,65803376
13000,108682480,112996741,221679221,1,0,1,60416,1,3829025511
13001,108688330,81863307,190551637,6,0,0,84480,12,1925819247
13002,108694780,81388165,190082945,8,0,0,8704,11,5569319274
13003,108698771,113068542,221767313,9,0,1,13824,4,6558143478
13004,108698930,81444438,190143368,3,0,0,46592,18,1124767143
13005,108712000,80956545,189668545,1,0,0,512,1,10723062912
13006,108727220,81644777,190371997,0,0,0,60416,6,9332204399
13007,108746220,81951740,190697960,4,0,0,147456,7,2426959233
13008,108750340,81355952,190106292,3,0,0,29696,18,5562580469
13009,108758280,113009056,221767336,8,0,1,512,11,4728698042
13010,108762561,81386290,190148851,9,0,0,17920,4,991359130
13011,108763579,113011486,221775065,3,0,1,30720,18,9155105864
13012,108774950,81862492,190637442,6,0,0,43008,12,8350585833
13013,108783670,81325609,190109279,5,0,0,9728,12,6933073384
13014,108795730,113532600,222328330,0,0,1,33280,6,891855370
13015,108803220,81617240,190420460,1,0,0,2048,1,9273460435
13016,108828321,81573571,190401892,9,0,0,37376,4,8676131924
13017,108830531,81743125,190573656,9,0,0,72192,4,2593659625
13018,108836170,81517396,190353566,8,0,0,38400,11,9033537029
13019,108844461,81399534,190243995,9,0,0,25600,4,5543348181
13020,108847770,113735593,222583363,0,0,1,8704,6,8091569508
13021,108852349,113761971,222614320,5,0,1,15872,12,959023594
13022,108865970,81115203,189981173,3,0,0,7168,18,5871603590
13023,108899491,113748595,222648086,9,0,1,512,4,6839420550
13024,108899940,81163861,190063801,1,0,0,14336,1,8015441962
13025,108906350,81242680,190149030,4,0,0,512,7,5528828268
13026,108907560,81204246,190111806,4,0,0,8192,7,8522524191
13027,108914600,113733509,222648109,0,0,1,12800,6,3095011430
13028,108914910,82109928,191024838,8,0,0,8704,11,5971162574
13029,108923521,82172224,191095745,9,0,0,71680,4,9003426789
13030,108930330,113756636,222686966,8,0,1,17920,11,7496106013
13031,108941730,113808787,222750517,8,0,1,7680,11,2206457241
13032,108951600,81932306,190883906,3,0,0,65536,18,3047348984
13033,108978590,81826640,190805230,0,0,0,39424,6,2493486839
13034,108994190,81710501,190704691,8,0,0,22016,11,5449421840
13035,109003710,81706035,190709745,6,0,0,16384,12,5770604179
13036,109023050,81593731,190616781,5,0,0,26624,12,7302109358
13037,109026870,81978578,191005448,3,0,0,34816,18,10424010429
13038,109027530,81624131,190651661,8,0,0,46592,11,1762779228
13039,109034120,81753748,190787868,5,0,0,44544,12,2996904359
13040,109066779,113683761,222750540,3,0,1,5632,18,7137401140
13041,109067120,113683443,222750563,6,0,1,3072,12,7748354654
13042,109067310,80967127,190034437,5,0,0,8704,12,1852869415
13043,109071959,113678627,222750586,5,0,1,10752,12,5358068969
13044,109085090,81649817,190734907,4,0,0,82432,7,318373123
13045,109095430,81320314,190415744,7,0,0,11776,1,9499583934
13046,109097861,81526454,190624315,9,0,0,6144,4,8361633930
13047,109107500,81418374,190525874,5,0,0,69632,12,3270095838
13048,109111991,81476976,190588967,9,0,0,50176,4,1928089445
13049,109120600,81700147,190820747,7,0,0,29184,1,4761124503
13050,109127099,113623510,222750609,5,0,1,7168,12,7060981955
13051,109148100,82021343,191169443,2,0,0,25088,1,2529757425
13052,109154460,114124281,223278741,0,0,1,21504,6,8125600950
13053,109154570,81877178,191031748,3,0,0,17408,18,3283332806
13054,109155720,81943324,191099044,3,0,0,10752,18,4042889230
13055,109164660,81457760,190622420,6,0,0,18432,12,8519961424
13056,109172400,114684336,223856736,1,0,1,108032,1,10214641024
13057,109193270,81580995,190774265,5,0,0,120832,12,577328788
13058,109202190,114654569,223856759,2,0,1,12288,1,1867006055
13059,109207710,81818711,191026421,4,0,0,5120,7,2741299464
13060,109228140,81871083,191099223,4,0,0,512,7,6046435083
13061,109231520,81260193,190491713,5,0,0,4608,12,3625682486
13062,109234970,81657539,190892509,3,0,0,28160,18,9054237919
13063,109237490,81756555,190994045,5,0,0,62464,12,6763757395
13064,109249480,81672745,190922225,3,0,0,1024,18,3759155770
13065,109251740,81401192,190652932,8,0,0,4096,11,5992629407
13066,109267750,81469676,190737426,1,0,0,8192,1,9510253332
13067,109274630,81647260,190921890,5,0,0,52736,12,7491129760
13068,109289580,81772657,191062237,1,0,0,28672,1,6396264310
13069,109293000,114592274,223885274,6,0,1,1024,12,6838144830
13070,109294700,81904277,191198977,3,0,0,15360,18,7496168378
13071,109315800,81831860,191147660,2,0,0,15360,1,8829254147
13072,109325730,82044155,191369885,8,0,0,31232,11,3209138434
13073,109334060,81619532,190953592,1,0,0,25600,1,3364347223
13074,109337320,81716158,191053478,2,0,0,39936,1,10096255962
13075,109337820,81455375,190793195,2,0,0,17408,1,8171981121
13076,109340840,81922914,191263754,5,0,0,2048,12,2628162303
13077,109347910,114537387,223885297,7,0,1,7168,1,8424669646
13078,109351250,81929219,191280469,3,0,0,54784,18,1370057608
13079,109365040,82030966,191396006,6,0,0,40448,12,9429431737
13080,109376520,81519600,190896120,0,0,0,11776,6,796316011
13081,109380270,81744083,191124353,7,0,0,14336,1,3287889632
13082,109389020,81994639,191383659,3,0,0,20992,18,2829001684
13083,109396150,81626013,191022163,2,0,0,54784,1,10588238952
13084,109401090,81640197,191041287,1,0,0,31232,1,740283181
13085,109402180,114562176,223964356,8,0,1,3584,11,4987054926
13086,109405730,116156142,225561872,1,0,1,702976,1,4282466910
13087,109405860,81661548,191067408,2,0,0,16896,1,6686209038
13088,109408389,116200366,225608755,3,0,1,9216,18,3446896883
13089,109414050,82256456,191670506,5,0,0,59392,12,263654838
13090,109417900,81938055,191355955,2,0,0,132608,1,4803327699
13091,109422460,82046131,191468591,0,0,0,127488,6,2513556689
13092,109426390,81977002,191403392,7,0,0,13312,1,4012045613
13093,109429910,81853234,191283144,2,0,0,8704,1,7253204498
13094,109435300,116211299,225646599,8,0,1,34816,11,9495063056
13095,109435680,82154958,191590638,2,0,0,25088,1,1784986513
13096,109445510,81914836,191360346,8,0,0,14336,11,2297159325
13097,109458450,116188172,225646622,2,0,1,512,1,7031170744
13098,109465610,82051185,191516795,2,0,0,23552,1,2033386181
13099,109466870,81844027,191310897,3,0,0,31232,18,3496117343
13100,109482090,82054049,191536139,1,0,0,21504,1,9600099055
13101,109491790,116154855,225646645,2,0,1,1536,1,31484412
13102,109502260,82350020,191852280,2,0,0,68096,1,5561365008
13103,109502430,116144238,225646668,2,0,1,30208,1,10658308766
13104,109503480,82308437,191811917,0,0,0,86016,6,7713046241
13105,109509550,82207465,191717015,7,0,0,58368,1,8136226167
13106,109515150,82207972,191723122,6,0,0,19968,12,5570842533
13107,109519690,81857550,191377240,2,0,0,24064,1,10413944620
13108,109529100,81955259,191484359,0,0,0,17920,6,8957552860
13109,109534220,82044715,191578935,1,0,0,69120,1,7889954077
13110,109542670,82129566,191672236,4,0,0,1024,7,3930921342
13111,109546700,82133459,191680159,2,0,0,2560,1,1192014414
13112,109548550,82477841,192026391,1,0,0,100352,1,8988546593
13113,109559030,116087661,225646691,2,0,1,24576,1,1370502937
13114,109560760,82110081,191670841,1,0,0,1024,1,8772447975
13115,109572010,82170360,191742370,2,0,0,13312,1,2358378861
13116,109573530,82078857,191652387,2,0,0,11264,1,9689266871
13117,109577930,81821383,191399313,4,0,0,10752,7,7613215652
13118,109578800,82248116,191826916,6,0,0,49152,12,10124037762
13119,109592700,82056232,191648932,2,0,0,13824,1,2165979770
13120,109617040,116035871,225652911,6,0,1,11264,12,7614351540
13121,109644990,82320363,191965353,5,0,0,512,12,287423414
13122,109658610,82013188,191671798,6,0,0,2048,12,4516030099
13123,109664260,81930533,191594793,2,0,0,4096,1,3435352389
13124,109671210,82101968,191773178,4,0,0,21504,7,9325705905
13125,109673691,115988890,225662581,9,0,1,7680,4,6490212988
13126,109673920,81946391,191620311,1,0,0,1024,1,3389906003
13127,109674560,82411698,192086258,3,0,0,119808,18,9096076639
13128,109685940,82428357,192114297,6,0,0,4096,12,7235993260
13129,109695420,82417606,192113026,4,0,0,33792,7,10526986135
13130,109697670,116011005,225708675,7,0,1,22016,1,9931299288
13131,109718000,82320270,192038270,0,0,0,38912,6,5398287540
13132,109731280,81871777,191603057,2,0,0,3072,1,5809101536
13133,109735040,82364033,192099073,3,0,0,41984,18,5868784465
13134,109735530,82563244,192298774,4,0,0,2560,7,7713090716
13135,109756060,82209091,191965151,6,0,0,23040,12,7456085106
13136,109763420,81974733,191738153,5,0,0,5632,12,7165026030
13137,109789650,82041859,191831509,6,0,0,14848,12,99133578
13138,109799430,82498541,192297971,3,0,0,49664,18,1465759502
13139,109799930,82346176,192146106,8,0,0,62976,11,4782927816
13140,109808360,115900396,225708756,7,0,1,3584,1,8096681621
13141,109813960,82335468,192149428,8,0,0,10752,11,1374247916
13142,109816370,82286314,192102684,8,0,0,11776,11,2804755738
13143,109816640,115919991,225736631,2,0,1,6144,1,6180327147
13144,109832840,82442777,192275617,0,0,0,23552,6,7416603403
13145,109841060,82350637,192191697,2,0,0,59392,1,5497869074
13146,109861790,82616574,192478364,5,0,0,72704,12,3754330040
13147,109863590,82263210,192126800,4,0,0,40960,7,9607349408
13148,109864630,82804801,192669431,3,0,0,43008,18,8971634438
13149,109865440,81996660,191862100,4,0,0,25600,7,4791358818
13150,109870400,115869736,225740136,2,0,1,8192,1,934283074
13151,109876580,82391838,192268418,1,0,0,70144,1,8990944760
13152,109877610,82560447,192438057,0,0,0,17920,6,4394336307
13153,109888480,116114812,226003292,8,0,1,74752,11,3655794238
13154,109900781,82478165,192378946,9,0,0,30208,4,8530815967
13155,109912780,82260798,192173578,6,0,0,19456,12,10672162922
13156,109914750,82506011,192420761,5,0,0,61440,12,5738719173
13157,109929800,82353016,192282816,0,0,0,23552,6,5697113814
13158,109935540,82420001,192355541,4,0,0,8704,7,6321854447
13159,109940590,82546601,192487191,2,0,0,6656,1,1247615553
13160,109969790,82486399,192456189,5,0,0,52224,12,7626817112
13161,109973271,116035513,226008784,9,0,1,17920,4,433494744
13162,109989831,82256906,192246737,9,0,0,41472,4,2786175128
13163,110010580,82306960,192317540,2,0,0,16384,1,5178818878
13164,110034540,82534055,192568595,7,0,0,512,1,8435309980
13165,110036390,116203237,226239627,6,0,1,41472,12,1864686110
13166,110046770,82633627,192680397,1,0,0,23040,1,4051728429
13167,110061930,82269892,192331822,4,0,0,19456,7,752015090
13168,110067930,82244595,192312525,5,0,0,45056,12,5130917651
13169,110074040,82696577,192770617,6,0,0,14848,12,5194404584
13170,110074450,82547874,192622324,2,0,0,58368,1,1030706308
13171,110085761,82733690,192819451,9,0,0,37888,4,7303993248
13172,110098480,82224863,192323343,5,0,0,18944,12,6944992175
13173,110106730,82240402,192347132,1,0,0,1536,1,1621767569
13174,110121980,83138850,193260830,4,0,0,10752,7,4716834549
13175,110145000,82511304,192656304,1,0,0,65536,1,6489213523
13176,110170971,82978232,193149203,9,0,0,48640,4,1348180156
13177,110178300,116294008,226472308,1,0,1,118272,1,1331161821
13178,110200160,116578709,226778869,1,0,1,197632,1,10735399879
13179,110200760,82306869,192507629,3,0,0,15872,18,96083321
13180,110211460,83199389,193410849,7,0,0,114176,1,586427521
13181,110213821,82288294,192502115,9,0,0,9728,4,5460057052
13182,110214200,82636855,192851055,1,0,0,55808,1,546894588
13183,110218640,82559734,192778374,4,0,0,16384,7,9693858745
13184,110221591,82721306,192942897,9,0,0,24576,4,7184312227
13185,110229000,82628942,192857942,2,0,0,22528,1,2721985534
13186,110243800,82557107,192800907,8,0,0,1024,11,5336232723
13187,110248800,82233487,192482287,6,0,0,12800,12,778945885
13188,110250750,82075121,192325871,5,0,0,7680,12,7547736492
13189,110257110,83080038,193337148,8,0,0,21504,11,1740723873
13190,110260070,82374757,192634827,2,0,0,40960,1,9691772899
13191,110263720,82431552,192695272,5,0,0,21504,12,10031678687
13192,110289371,116514043,226803414,9,0,1,6656,4,8026548951
13193,110296080,82498647,192794727,3,0,0,32256,18,7497957662
13194,110309560,82406955,192716515,6,0,0,14848,12,4200953030
13195,110338961,82389613,192728574,9,0,0,9216,4,2208248506
13196,110352160,82561496,192913656,1,0,0,66048,1,1122884485
13197,110353871,82570416,192924287,9,0,0,34816,4,6670972989
13198,110360260,82792554,193152814,6,0,0,11776,12,5406181027
13199,110360380,116443057,226803437,4,0,1,15360,7,8445057688
13200,110375060,82560326,192935386,6,0,0,36352,12,3577413460
13201,110388380,116433556,226821936,0,0,1,10240,6,6211396640
13202,110390640,82690059,193080699,2,0,0,10752,1,9117144628
13203,110393730,116649002,227042732,1,0,1,135680,1,8832493656
13204,110406491,116654082,227060573,9,0,1,15872,4,2349910974
13205,110408150,116687249,227095399,4,0,1,8704,7,1341407360
13206,110408220,83119794,193528014,0,0,0,92160,6,3606578598
13207,110413060,82260294,192673354,2,0,0,12800,1,3452477756
13208,110420130,116786062,227206192,4,0,1,35840,7,8693111148
13209,110434740,117023131,227457871,7,0,1,3584,1,6064237177
13210,110436870,82697490,193134360,4,0,0,47104,7,2890311804
13211,110461670,82414859,192876529,8,0,0,60928,11,3083906706
13212,110462240,82240605,192702845,4,0,0,5120,7,9798378846
13213,110464910,116992984,227457894,6,0,1,3072,12,1802678963
13214,110470190,116991149,227461339,0,0,1,7168,6,181380092
13215,110474140,82594906,193069046,2,0,0,19968,1,6811072788
13216,110474200,83233078,193707278,4,0,0,195072,7,6420287446
13217,110478970,82513259,192992229,5,0,0,18944,12,9431851068
13218,110482540,82671458,193153998,6,0,0,1024,12,2944827143
13219,110511630,82912190,193423820,4,0,0,42496,7,609259357
13220,110518791,82634826,193153617,9,0,0,2560,4,6969118354
13221,110540270,82522669,193062939,2,0,0,23040,1,7372086333
13222,110562550,83002748,193565298,8,0,0,36864,11,5332637983
13223,110580490,82430569,193011059,7,0,0,22528,1,726038357
13224,110580701,82664795,193245496,9,0,0,41472,4,5708946228
13225,110588070,82760021,193348091,8,0,0,35840,11,7376469029
13226,110595360,116873391,227468751,4,0,1,11776,7,6282084438
13227,110604580,82481134,193085714,1,0,0,16384,1,9076026398
13228,110616820,82572471,193189291,1,0,0,1536,1,5507812815
13229,110617350,82645203,193262553,4,0,0,3072,7,3962071710
13230,110617530,116896848,227514378,2,0,1,6656,1,5113948347
13231,110620600,116893801,227514401,7,0,1,12288,1,3624254012
13232,110642040,82362132,193004172,8,0,0,20992,11,7166624115
13233,110650760,82679813,193330573,3,0,0,17408,18,9845706239
13234,110657090,82600441,193257531,7,0,0,39424,1,464869326
13235,110659210,82884427,193543637,2,0,0,51200,1,244122907
13236,110675560,82503206,193178766,7,0,0,9728,1,7578680233
13237,110691630,83089840,193781470,0,0,0,53760,6,7607994492
13238,110706980,82642694,193349674,7,0,0,5120,1,4394209701
13239,110708980,116813446,227522426,0,0,1,23552,6,9487343515
13240,110709540,82446873,193156413,8,0,0,1024,11,900181071
13241,110713690,83074511,193788201,0,0,0,22016,6,9981815027
13242,110721710,82766334,193488044,8,0,0,37888,11,8188092885
13243,110721770,82650113,193371883,5,0,0,44032,12,8926914427
13244,110722500,83175284,193897784,7,0,0,10240,1,6384516078
13245,110723750,82924069,193647819,3,0,0,48128,18,4805450772
13246,110731240,83070873,193802113,0,0,0,1024,6,3416789498
13247,110734100,83030967,193765067,2,0,0,116224,1,10217773018
13248,110735030,83135265,193870295,3,0,0,14336,18,1639830928
13249,110737300,83252362,193989662,2,0,0,73728,1,1125879988
13250,110738441,82851954,193590395,9,0,0,7680,4,7710709682
13251,110742271,82684068,193426339,9,0,0,8192,4,7934088104
13252,110756620,116770555,227527175,8,0,1,3072,11,6491095485
13253,110766170,116761028,227527198,7,0,1,512,1,9742769656
13254,110780780,83035107,193815887,1,0,0,13824,1,341653793
13255,110782020,82763668,193545688,3,0,0,6656,18,4117723183
13256,110789090,82644502,193433592,0,0,0,10240,6,2925263841
13257,110793590,83119193,193912783,8,0,0,49152,11,2292565086
13258,110804940,83319065,194124005,8,0,0,33792,11,736549165
13259,110810770,82766943,193577713,4,0,0,34816,7,846428917
13260,110844120,82999266,193843386,5,0,0,20992,12,4086734143
13261,110847290,83375038,194222328,8,0,0,34816,11,1789895097
13262,110852320,82598856,193451176,7,0,0,1024,1,1886750867
13263,110869890,83382825,194252715,3,0,0,66560,18,4395816675
13264,110880730,83157961,194038691,1,0,0,10240,1,8689354137
13265,110885390,82844242,193729632,3,0,0,26624,18,177530725
13266,110887760,116639461,227527221,2,0,1,3584,1,3120862185
13267,110888130,83626280,194514410,6,0,0,12800,12,284776663
13268,110898390,83106831,194005221,1,0,0,27648,1,10712568353
13269,110898780,83067413,193966193,0,0,0,2048,6,9427157821
13270,110916910,82671122,193588032,4,0,0,33792,7,277549142
13271,110920700,117414268,228334968,1,0,1,182272,1,8352598608
13272,110925220,82796277,193721497,0,0,0,46592,6,5202854014
13273,110950760,83642539,194593299,6,0,0,15360,12,6174510028
13274,110955181,83335034,194290215,9,0,0,17920,4,1447974147
13275,110956480,82841728,193798208,3,0,0,32768,18,5092046902
13276,110959800,117414447,228374247,7,0,1,23552,1,2700051501
13277,110963470,82873497,193836967,7,0,0,24576,1,1477679732
13278,110970730,117415926,228386656,4,0,1,24064,7,2790283429
13279,111010590,83052893,194063483,5,0,0,73216,12,7607604753
13280,111011770,82984935,193996705,7,0,0,23040,1,4917265499
13281,111014600,83785710,194800310,6,0,0,23040,12,8569082126
13282,111034660,117406061,228440721,6,0,1,13312,12,5653420394
13283,111034770,83175209,194209979,7,0,0,17408,1,6620095568
13284,111038590,82900853,193939443,1,0,0,17408,1,1335047829
13285,111044220,117396524,228440744,0,0,1,14336,6,5284252822
13286,111052320,117399702,228452022,0,0,1,3584,6,8630926756
13287,111076490,117375555,228452045,0,0,1,3072,6,5264854878
13288,111085570,82808327,193893897,2,0,0,1024,1,7692252457
13289,111089060,82945989,194035049,7,0,0,11776,1,9895259737
13290,111091120,117360956,228452076,6,0,1,32256,12,6400340796
13291,111096051,83250172,194346223,9,0,0,35840,4,7268781226
13292,111097591,83799537,194897128,9,0,0,48128,4,1507968191
13293,111098731,84061429,195160160,9,0,0,26112,4,3801005629
13294,111111360,83987006,195098366,5,0,0,121856,12,3733547397
13295,111111410,83881004,194992414,3,0,0,11776,18,6448119778
13296,111117340,117389321,228506661,4,0,1,19456,7,4806241640
13297,111120470,117386214,228506684,4,0,1,2560,7,5611058190
13298,111132400,83015639,194148039,2,0,0,4096,1,3258231183
13299,111141230,83026852,194168082,5,0,0,15360,12,7613123002
13300,111144790,82993145,194137935,7,0,0,11264,1,9315704722
13301,111154790,83287785,194442575,7,0,0,160768,1,7334258173
13302,111168370,83219840,194388210,0,0,0,137728,6,6783107363
13303,111184730,83684089,194868819,0,0,0,109568,6,2537200209
13304,111185811,117328182,228513993,9,0,1,15360,4,1167865357
13305,111185900,83126887,194312787,1,0,0,16384,1,7566190828
13306,111188760,84066837,195255597,4,0,0,64512,7,9280025756
13307,111191160,83256126,194447286,2,0,0,15360,1,8532209069
13308,111202100,84389834,195591934,7,0,0,58880,1,2625278495
13309,111204770,84226921,195431691,0,0,0,182272,6,6508090092
13310,111215680,83458298,194673978,4,0,0,8192,7,9149205970
13311,111217390,83609380,194826770,3,0,0,86016,18,6116040008
13312,111218340,83292147,194510487,5,0,0,37888,12,1549694480
13313,111234510,83223838,194458348,6,0,0,21504,12,9101916974
13314,111240230,83235558,194475788,5,0,0,10752,12,484831618
13315,111244000,83781638,195025638,4,0,0,23040,7,3261005459
13316,111252210,83433046,194685256,8,0,0,36864,11,1719309353
13317,111256620,83751035,195007655,4,0,0,12288,7,403567955
13318,111261260,83189921,194451181,8,0,0,6144,11,8903467676
13319,111272140,83118901,194391041,3,0,0,9216,18,5479242894
13320,111294520,83694283,194988803,3,0,0,20992,18,10449271122
13321,111297050,83151507,194448557,7,0,0,4096,1,4609333607
13322,111304330,83089238,194393568,1,0,0,8192,1,3112033226
13323,111307780,83383271,194691051,4,0,0,18944,7,1533950498
13324,111320621,83305204,194625825,9,0,0,27136,4,1778348020
13325,111321890,117630520,228952410,1,0,1,162304,1,8322038809
13326,111332550,83598632,194931182,6,0,0,50688,12,4265019636
13327,111352760,83905676,195258436,1,0,0,9216,1,472455596
13328,111363990,83307469,194671459,8,0,0,133120,11,544766549
13329,111378890,83448527,194827417,3,0,0,2048,18,829002321
13330,111419460,83922499,195341959,8,0,0,33280,11,8524581934
13331,111424200,84105424,195529624,2,0,0,29696,1,7267179620
13332,111436890,83930920,195367810,0,0,0,54272,6,9633873233
13333,111456880,83413834,194870714,7,0,0,6144,1,6196537296
13334,111459650,83320014,194779664,0,0,0,5632,6,5778984292
13335,111463220,83365936,194829156,4,0,0,5632,7,3622605909
13336,111480290,83098326,194578616,6,0,0,23552,12,5708083577
13337,111487740,84315789,195803529,2,0,0,79360,1,2028567887
13338,111492130,117482961,228975091,4,0,1,10240,7,4328012423
13339,111492210,83423505,194915715,6,0,0,60928,12,317402776
13340,111492800,84054600,195547400,2,0,0,23552,1,6857602853
13341,111502479,117485870,228988349,5,0,1,5632,12,8983058031
13342,111504001,83719882,195223883,9,0,0,35328,4,5691521632
13343,111517900,83952840,195470740,3,0,0,86528,18,4371171956
13344,111522530,117471949,228994479,0,0,1,16896,6,3070422134
13345,111522740,83426280,194949020,2,0,0,9728,1,6482756209
13346,111555780,117438722,228994502,2,0,1,4608,1,9926412719
13347,111574380,83956382,195530762,8,0,0,1536,11,5533872868
13348,111577230,83459859,195037089,0,0,0,12288,6,6868728727
13349,111580040,83540033,195120073,2,0,0,71168,1,6994750826
13350,111593690,83541711,195135401,0,0,0,8192,6,3310995813
13351,111601201,84210619,195811820,9,0,0,27136,4,6590078960
13352,111603230,83841123,195444353,9,0,0,29696,4,8709214882
13353,111606610,83120470,194727080,0,0,0,5632,6,9168328233
13354,111606660,83335473,194942133,6,0,0,35840,12,897162778
13355,111608020,84287820,195895840,5,0,0,15360,12,4826433108
13356,111611721,117385124,228996845,9,0,1,2048,4,7552129423
13357,111614600,83621318,195235918,8,0,0,39424,11,4747387253
13358,111615680,83551071,195166751,0,0,0,4096,6,6217171315
13359,111617170,84414438,196031608,7,0,0,40448,1,7281451867
13360,111622680,83694311,195316991,6,0,0,26112,12,4494769197
13361,111623420,83751840,195375260,2,0,0,14848,1,10380135391
13362,111633550,83858585,195492135,9,0,0,70144,4,3904409741
13363,111641020,84021797,195662817,6,0,0,150528,12,4952559756
13364,111647470,83629732,195277202,0,0,0,19968,6,7748084088
13365,111649690,83621405,195271095,1,0,0,41472,1,245071637
13366,111650030,84023285,195673315,4,0,0,9728,7,502465658
13367,111650100,83472180,195122280,3,0,0,7168,18,3923940124
13368,111660650,84479727,196140377,6,0,0,62464,12,1473513629
13369,111663980,83832866,195496846,7,0,0,15360,1,3939806319
13370,111694240,84569252,196263492,8,0,0,60928,11,3855102359
13371,111704430,83912500,195616930,1,0,0,68096,1,338879360
13372,111713010,83957318,195670328,2,0,0,24576,1,7166504543
13373,111723920,117275191,228999111,0,0,1,3584,6,2520035852
13374,111746780,117282846,229029626,2,0,1,8192,1,4557084419
13375,111763690,84538847,196302537,7,0,0,79872,1,9770566661
13376,111777670,117416263,229193933,2,0,1,16896,1,10465161417
13377,111782550,84098869,195881419,4,0,0,228352,7,7240510590
13378,111784750,84183441,195968191,0,0,0,40448,6,10646488489
13379,111792860,83737411,195530271,2,0,0,2048,1,4454384800
13380,111803770,84587536,196391306,9,0,0,68096,4,513876956
13381,111832080,117364439,229196519,7,0,1,4096,1,7278265034
13382,111834990,84232749,196067739,7,0,0,34304,1,1769391732
13383,111837690,84373684,196211374,0,0,0,23040,6,6830522260
13384,111838600,84090959,195929559,1,0,0,110592,1,10720802509
13385,111860280,83893170,195753450,5,0,0,39424,12,1025789634
13386,111867940,83893228,195761168,0,0,0,5632,6,3031226254
13387,111871220,83856330,195727550,6,0,0,17408,12,10074818672
13388,111874061,117426439,229300500,9,0,1,8192,4,2094785780
13389,111884990,84006124,195891114,9,0,0,31744,4,5441090046
13390,111885780,84162586,196048366,1,0,0,41984,1,8313063955
13391,111898950,117905035,229803985,1,0,1,97792,1,10687396639
13392,111907420,84462000,196369420,2,0,0,60416,1,10709168634
13393,111915380,117890231,229805611,6,0,1,2560,12,5340008369
13394,111918340,117889537,229807877,8,0,1,3584,11,4889091489
13395,111922990,84585494,196508484,9,0,0,46080,4,8870170822
13396,111950080,117886001,229836081,2,0,1,24576,1,3284378480
13397,111950900,83722906,195673806,7,0,0,1536,1,7168226614
13398,111962170,83992738,195954908,2,0,0,34816,1,7999803214
13399,111963750,84110720,196074470,8,0,0,22016,11,1584861462
13400,111967360,84005534,195972894,1,0,0,15360,1,4288186018
13401,111992130,84616791,196608921,3,0,0,54784,18,8135618538
13402,111995360,83948917,195944277,6,0,0,41984,12,8780320656
13403,111997120,83768358,195765478,7,0,0,6144,1,6074522146
13404,112001310,84369225,196370535,0,0,0,3584,6,1236031646
13405,112015569,117824058,229839627,5,0,1,5632,12,2561077839
13406,112025590,84124794,196150384,2,0,0,32768,1,5899499575
13407,112027980,117814371,229842351,0,0,1,1024,6,4605142744
13408,112041080,117844970,229886050,7,0,1,19968,1,8712356312
13409,112041730,83977485,196019215,2,0,0,46592,1,2010402486
13410,112044520,117878296,229922816,4,0,1,31232,7,1338040622
13411,112057580,84058856,196116436,8,0,0,45568,11,9452748452
13412,112069281,118008910,230078191,9,0,1,14848,4,4791575815
13413,112071800,84108993,196180793,9,0,0,33792,4,1547276745
13414,112078930,117999463,230078393,4,0,1,10240,7,3527888134
13415,112081180,118068810,230149990,7,0,1,24576,1,634683558
13416,112097010,84654266,196751276,5,0,0,53248,12,5472913000
13417,112105100,84245866,196350966,5,0,0,155136,12,10085643803
13418,112120480,83810982,195931462,3,0,0,6144,18,2020078418
13419,112120730,118029283,230150013,6,0,1,3072,12,4168810211
13420,112126960,84077371,196204331,3,0,0,52736,18,4042145153
13421,112136820,83855697,195992517,3,0,0,11264,18,3805642870
13422,112150930,83838132,195989062,2,0,0,11776,1,3166646317
13423,112156380,84001690,196158070,6,0,0,1536,12,3495544695
13424,112169170,84261122,196430292,6,0,0,71680,12,8610751900
13425,112200020,84586589,196786609,3,0,0,27648,18,2108417333
13426,112201350,84641300,196842650,6,0,0,20992,12,2142289366
13427,112212040,84091635,196303675,2,0,0,3584,1,1971530347
13428,112216610,119228687,231445297,1,0,1,610816,1,755589912
13429,112225960,84897473,197123433,3,0,0,14848,18,9255746608
13430,112230020,84325744,196555764,1,0,0,39936,1,6363551933
13431,112234150,84679223,196913373,3,0,0,43520,18,6727739169
13432,112242900,83832997,196075897,7,0,0,4608,1,1527044915
13433,112247210,84146326,196393536,3,0,0,4608,18,505491272
13434,112251530,84148433,196399963,3,0,0,20992,18,7816239597
13435,112255450,84136659,196392109,1,0,0,2560,1,9722436618
13436,112268470,84724792,196993262,4,0,0,8704,7,9095810200
13437,112277080,84771007,197048087,2,0,0,60928,1,8083660526
13438,112277220,84662802,196940022,9,0,0,7168,4,9626403039
13439,112300951,119144910,231445861,9,0,1,10752,4,5880183371
13440,112303839,119145248,231449087,5,0,1,5120,12,9297185206
13441,112313770,84861779,197175549,0,0,0,24576,6,9930523964
13442,112330880,84246311,196577191,5,0,0,29184,12,3743835814
13443,112331890,85007148,197339038,5,0,0,7680,12,5142277725
13444,112350960,85337551,197688511,7,0,0,100864,1,3065946383
13445,112361750,84315159,196676909,2,0,0,13824,1,3898142065
13446,112364405,84203871,196568276,5,0,0,36352,12,2075894329
13447,112365390,119088203,231453593,7,0,1,7168,1,7908492313
13448,112367270,84149817,196517087,1,0,0,28160,1,3668751144
13449,112382190,84454041,196836231,2,0,0,43520,1,7192990736
13450,112400120,84629201,197029321,8,0,0,118272,11,9104560548
13451,112400921,84334108,196735029,9,0,0,29184,4,4293815136
13452,112405240,84134943,196540183,4,0,0,62464,7,6378137935
13453,112417360,84295839,196713199,3,0,0,32768,18,4862713800
13454,112443290,84170490,196613780,7,0,0,15872,1,3515839723
13455,112445670,84195018,196640688,2,0,0,21504,1,9087314242
13456,112459920,84393059,196852979,5,0,0,1536,12,3548887889
13457,112462830,84263276,196726106,9,0,0,41984,4,4916153530
13458,112475300,84377188,196852488,8,0,0,18432,11,6869854708
13459,112488720,84289442,196778162,6,0,0,80384,12,7251150461
13460,112493510,84024380,196517890,2,0,0,2560,1,6458097369
13461,112506100,84701865,197207965,9,0,0,8704,4,2948542319
13462,112513700,84894022,197407722,0,0,0,54784,6,9495325724
13463,112514060,84239579,196753639,9,0,0,7680,4,4777621836
13464,112515721,84741770,197257491,9,0,0,65536,4,6261727539
13465,112516680,84674539,197191219,4,0,0,39424,7,7724554363
13466,112517130,84473457,196990587,4,0,0,58880,7,2905666580
13467,112518850,84841964,197360814,0,0,0,30208,6,6391066972
13468,112523790,84110323,196634113,4,0,0,6656,7,9541169039
13469,112524930,84826657,197351587,0,0,0,13312,6,971549985
13470,112540720,84795955,197336675,7,0,0,137216,1,5893135121
13471,112542720,84797745,197340465,7,0,0,4608,1,2783908248
13472,112550860,84933047,197483907,4,0,0,19968,7,219233831
13473,112560560,84905534,197466094,0,0,0,19456,6,7121299360
13474,112567700,84719009,197286709,4,0,0,56320,7,7459543646
13475,112587810,84463420,197051230,7,0,0,10240,1,1835744262
13476,112599190,84858963,197458153,4,0,0,20992,7,8437215896
13477,112624530,84722978,197347508,2,0,0,23040,1,9805121871
13478,112628100,118830742,231458842,4,0,1,20992,7,1089649155
13479,112629150,84956026,197585176,3,0,0,20992,18,7759208309
13480,112630730,84736207,197366937,6,0,0,19968,12,8012053387
13481,112632991,85181701,197814692,9,0,0,29696,4,3713124660
13482,112633810,84524409,197158219,7,0,0,51712,1,3963306183
13483,112636620,85168042,197804662,2,0,0,110080,1,2346626450
13484,112638980,118820016,231458996,0,0,1,8704,6,1777779468
13485,112640570,85244298,197884868,6,0,0,41472,12,1469445295
13486,112669660,118826370,231496030,4,0,1,12800,7,4745738568
13487,112722220,84668296,197390516,0,0,0,77312,6,4091951325
13488,112724801,84666206,197391007,9,0,0,1536,4,7133678856
13489,112726780,84542746,197269526,8,0,0,39424,11,4090716596
13490,112734270,85281603,198015873,7,0,0,27648,1,3344641425
13491,112746350,84908107,197654457,5,0,0,137728,12,6585079121
13492,112747910,84546934,197294844,8,0,0,26624,11,6159910600
13493,112753510,84808234,197561744,8,0,0,24576,11,5170554804
13494,112754529,118742167,231496696,5,0,1,1024,12,9254854354
13495,112765430,118756285,231521715,6,0,1,24064,12,3118715958
13496,112768870,84260630,197029500,0,0,0,512,6,1497752363
13497,112772600,84642165,197414765,4,0,0,23040,7,9159462885
13498,112779970,84362470,197142440,1,0,0,11776,1,9440869349
13499,112793970,84665922,197459892,6,0,0,5632,12,7268012251
13500,112796411,118729810,231526221,9,0,1,7168,4,6458046462
13501,112813540,84992081,197805621,7,0,0,3072,1,1054187355
13502,112817961,84839795,197657756,9,0,0,10752,4,6528080874
13503,112828210,85043999,197872209,6,0,0,13312,12,5975636116
13504,112835640,84911643,197747283,5,0,0,43008,12,3363356518
13505,112844780,84741630,197586410,4,0,0,3584,7,56380407
13506,112865120,84839802,197704922,5,0,0,53760,12,3413602217
13507,112870860,84676832,197547692,3,0,0,8704,18,9343027439
13508,112872770,84737373,197610143,0,0,0,18944,6,136891747
13509,112879330,84610996,197490326,8,0,0,20992,11,986713997
13510,112881950,84832355,197714305,1,0,0,30720,1,10450473556
13511,112889200,85223699,198112899,0,0,0,23040,6,2726083925
13512,112893180,84835011,197728191,6,0,0,17920,12,9202843212
13513,112903970,118654053,231558023,2,0,1,46592,1,3136470207
13514,112924481,85102023,198026504,9,0,0,34816,4,10446845560
13515,112941780,85383513,198325293,5,0,0,439808,12,7033565028
13516,112943770,85063633,198007403,7,0,0,145920,1,4968447253
13517,112947030,84881101,197828131,5,0,0,44032,12,2857836223
13518,112951919,118664429,231616348,5,0,1,1536,12,293046164
13519,112969591,118647743,231617334,9,0,1,1536,4,8618310318
13520,112972740,85418860,198391600,8,0,0,14336,11,2846636431
13521,112972760,84786199,197758959,4,0,0,28160,7,2670864410
13522,112973960,85358844,198332804,7,0,0,24576,1,7541556082
13523,112975970,84929700,197905670,6,0,0,5632,12,1459018751
13524,113009969,118608031,231618000,5,0,1,1024,12,5992406476
13525,113017430,85364253,198381683,4,0,0,41984,7,7520917043
13526,113049160,85142106,198191266,8,0,0,13312,11,4429008011
13527,113053810,85127523,198181333,0,0,0,29696,6,6078362787
13528,113053980,85609582,198663562,8,0,0,452096,11,9491775440
13529,113056230,85073489,198129719,3,0,0,10752,18,6074625132
13530,113057090,85306561,198363651,8,0,0,4096,11,2092597376
13531,113063540,85433607,198497147,3,0,0,65024,18,9995303937
13532,113064080,85304742,198368822,2,0,0,16896,1,6909897569
13533,113068550,85705338,198773888,7,0,0,41472,1,7823929151
13534,113069060,85293320,198362380,6,0,0,43008,12,1695283121
13535,113072800,85268919,198341719,6,0,0,29184,12,713258362
13536,113073470,85375790,198449260,7,0,0,19456,1,2385090044
13537,113075710,118544556,231620266,2,0,1,3584,1,6768464086
13538,113077830,118612461,231690291,1,0,1,56320,1,1534526744
13539,113088440,85617559,198705999,3,0,0,48128,18,8010142571
13540,113101460,85415458,198516918,2,0,0,48128,1,1769158076
13541,113111980,85270662,198382642,7,0,0,3072,1,7322816761
13542,113112250,85300513,198412763,4,0,0,19968,7,2516973142
13543,113124580,85775814,198900394,7,0,0,27648,1,3856212309
13544,113125811,85329579,198455390,9,0,0,9728,4,3937197819
13545,113137210,85672945,198810155,8,0,0,8704,11,10127817833
13546,113140630,118549692,231690322,7,0,1,8192,1,6913489252
13547,113150760,85262726,198413486,3,0,0,512,18,8633713409
13548,113152950,85729948,198882898,0,0,0,30720,6,811274117
13549,113165811,85570396,198736207,9,0,0,97792,4,4788677545
13550,113189770,85848731,199038501,1,0,0,23552,1,2131136215
13551,113215861,118474484,231690345,9,0,1,12800,4,5700379859
13552,113222641,85220668,198443309,9,0,0,66560,4,1114404790
13553,113228130,85991709,199219839,6,0,0,72192,12,2240930905
13554,113238820,85263342,198502162,7,0,0,16384,1,6653923731
13555,113246040,85661699,198907739,0,0,0,6656,6,8710084461
13556,113246510,84791355,198037865,7,0,0,512,1,2215135033
13557,113250151,85208858,198459009,9,0,0,11776,4,6971906818
13558,113258750,118432733,231691483,4,0,1,6656,7,4749663617
13559,113268250,85403603,198671853,8,0,0,27136,11,3215681534
13560,113292340,85452478,198744818,7,0,0,28160,1,9225263076
13561,113308891,85368133,198677024,9,0,0,16896,4,1380581779
13562,113308910,85968227,199277137,3,0,0,146944,18,9065503625
13563,113317210,85029056,198346266,5,0,0,14848,12,10440684799
13564,113334970,85371364,198706334,8,0,0,1024,11,1080204816
13565,113346000,85345243,198691243,1,0,0,46592,1,7676354487
13566,113354350,86294305,199648655,0,0,0,64512,6,7433020961
13567,113362789,118335768,231698557,5,0,1,17920,12,8092847814
13568,113403671,85380948,198784619,9,0,0,17408,4,4490869292
13569,113424380,85606922,199031302,3,0,0,57344,18,8532485653
13570,113431849,118280375,231712224,5,0,1,8704,12,6244493649
13571,113436140,118618424,232054564,1,0,1,130048,1,2916312539
13572,113436981,85552402,198989383,9,0,0,34816,4,6266081080
13573,113440701,85365001,198805702,9,0,0,69120,4,505961683
13574,113441980,84907273,198349253,8,0,0,9728,11,2693363545
13575,113451290,85001113,198452403,3,0,0,10240,18,8430306902
13576,113467250,85371480,198838730,3,0,0,38400,18,4781424614
13577,113493200,85314264,198807464,4,0,0,5632,7,9386250244
13578,113501610,85922632,199424242,5,0,0,13312,12,4351150712
13579,113505210,86389976,199895186,7,0,0,44032,1,4394528022
13580,113506840,85922417,199429257,8,0,0,16384,11,6557969754
13581,113537040,118828865,232365905,1,0,1,171520,1,9024326685
13582,113537360,85640608,199177968,4,0,0,32256,7,8443652486
13583,113538029,118901600,232439629,5,0,1,21504,12,802614711
13584,113545840,85342243,198888083,6,0,0,7680,12,6923723101
13585,113549450,85429302,198978752,5,0,0,17920,12,4858504213
13586,113561250,85199971,198761221,1,0,0,53760,1,8706106661
13587,113574111,85728288,199302399,9,0,0,7680,4,7522724039
13588,113588720,85986235,199574955,0,0,0,4096,6,5790837816
13589,113606110,85318014,198924124,8,0,0,3584,11,2645743241
13590,113609030,86326083,199935113,8,0,0,8192,11,6842007130
13591,113615941,86100953,199716894,9,0,0,59904,4,8528330245
13592,113621240,85884350,199505590,6,0,0,28160,12,141647384
13593,113622950,85916105,199539055,3,0,0,36352,18,4210813589
13594,113632920,118810499,232443419,6,0,1,12288,12,7435063800
13595,113635590,85410880,199046470,6,0,0,25600,12,8233464994
13596,113646890,85255983,198902873,8,0,0,2560,11,5122647017
13597,113660961,118782481,232443442,9,0,1,4608,4,5296103437
13598,113664250,118779215,232443465,4,0,1,7680,7,4266486045
13599,113671050,85440676,199111726,2,0,0,31232,1,3802178547
13600,113672580,85947973,199620553,2,0,0,80896,1,2430893291
13601,113677941,118765547,232443488,9,0,1,16384,4,9217737697
13602,113683900,118759611,232443511,8,0,1,1536,11,1653188228
13603,113686170,85173563,198859733,8,0,0,5632,11,10135016644
13604,113686490,86007247,199693737,0,0,0,22528,6,5639683075
13605,113686870,85320756,199007626,5,0,0,29184,12,394112929
13606,113688970,86192777,199881747,7,0,0,262656,1,6010154989
13607,113689680,85412507,199102187,0,0,0,22528,6,8683759968
13608,113694270,85148383,198842653,8,0,0,12800,11,1887678082
13609,113699010,85590216,199289226,5,0,0,15360,12,7871098791
13610,113700310,85655545,199355855,5,0,0,67072,12,5932141993
13611,113703330,85747299,199450629,4,0,0,4608,7,1795166238
13612,113708121,85591915,199300036,9,0,0,24064,4,2798668017
13613,113710080,85069189,198779269,0,0,0,17408,6,7790263976
13614,113711260,85872585,199583845,5,0,0,15872,12,1901625234
13615,113711890,118731652,232443542,6,0,1,7168,12,3686230105
13616,113714840,85569675,199284515,7,0,0,14848,1,3363835923
13617,113731010,118789580,232520590,4,0,1,12288,7,5411480630
13618,113751560,85763881,199515441,6,0,0,32256,12,3998015937
13619,113754310,86350540,200104850,8,0,0,136704,11,4618619676
13620,113777499,118760239,232537738,5,0,1,15360,12,129928935
13621,113779740,86443192,200222932,6,0,0,38912,12,1253206610
13622,113784670,85874928,199659598,2,0,0,35840,1,4065032096
13623,113788249,118756041,232544290,5,0,1,18432,12,1470183201
13624,113794430,85275104,199069534,7,0,0,21504,1,4997501236
13625,113794890,86246578,200041468,1,0,0,67584,1,10336272112
13626,113800560,85757240,199557800,3,0,0,10752,18,4557464039
13627,113823070,85610413,199433483,1,0,0,3584,1,5742641775
13628,113825860,85671127,199496987,3,0,0,50688,18,2182663770
13629,113830491,118715105,232545596,9,0,1,2048,4,936379169
13630,113834060,118712407,232546467,0,0,1,12288,6,10512449634
13631,113848560,85349260,199197820,6,0,0,17408,12,5911752844
13632,113850790,118698583,232549373,6,0,1,4608,12,2825272127
13633,113860320,86320331,200180651,1,0,0,4096,1,2182385270
13634,113862420,85151178,199013598,4,0,0,3072,7,7981448152
13635,113909531,86153644,200063175,9,0,0,71168,4,5515508080
13636,113913380,85785239,199698619,5,0,0,14336,12,8546562035
13637,113914850,85874793,199789643,8,0,0,46080,11,456012098
13638,113917400,118633599,232550999,7,0,1,2560,1,3047408557
13639,113923090,86560802,200483892,8,0,0,67072,11,6987131209
13640,113930050,85695689,199625739,3,0,0,7168,18,8585756677
13641,113936010,118615348,232551358,0,0,1,9728,6,3974776471
13642,113950531,86154567,200105098,9,0,0,512,4,4629859190
13643,113951040,86040385,199991425,0,0,0,68608,6,2143681793
13644,113951950,85805456,199757406,4,0,0,13312,7,2080151247
13645,113955690,85411642,199367332,6,0,0,1536,12,1293247402
13646,113957230,118639164,232596394,1,0,1,42496,1,5633753415
13647,113975560,86407333,200382893,5,0,0,166400,12,9264027733
13648,113994640,85285328,199279968,1,0,0,9216,1,1592128309
13649,114006970,86196697,200203667,1,0,0,48128,1,8903896356
13650,114015151,85705111,199720262,9,0,0,10752,4,5006489148
13651,114018670,85213672,199232342,3,0,0,40960,18,153087173
13652,114036860,85255821,199292681,7,0,0,11264,1,535831767
13653,114038960,118562623,232601583,8,0,1,5120,11,9639236209
13654,114045120,86374290,200419410,2,0,0,27648,1,4544095585
13655,114047270,86718967,200766237,5,0,0,143360,12,1842533244
13656,114050540,86528773,200579313,1,0,0,65536,1,6657518239
13657,114060670,86097595,200158265,3,0,0,52736,18,8787729165
13658,114061700,86492919,200554619,6,0,0,110080,12,10387750996
13659,114062660,86344528,200407188,3,0,0,44032,18,10115505339
13660,114077800,86226148,200303948,3,0,0,9216,18,6779999117
13661,114087730,85533961,199621691,7,0,0,3584,1,9753190328
13662,114088860,85811653,199900513,4,0,0,17408,7,9899629920
13663,114093920,86507416,200601336,8,0,0,6656,11,8359339339
13664,114095130,86495305,200590435,8,0,0,24576,11,1323697518
13665,114107350,118507109,232614459,1,0,1,11264,1,6888454123
13666,114112840,86011937,200124777,4,0,0,64512,7,2699448283
13667,114146090,118471275,232617365,8,0,1,4608,11,9398394089
13668,114147230,86435694,200582924,4,0,0,11776,7,10470414699
13669,114148170,118471141,232619311,4,0,1,3072,7,3536721130
13670,114156430,86566104,200722534,1,0,0,37376,1,3899722248
13671,114160180,86488330,200648510,6,0,0,27648,12,2348392778
13672,114183841,118444731,232628572,9,0,1,7168,4,10257768722
13673,114197430,85555897,199753327,2,0,0,87040,1,3548604311
13674,114203810,86775888,200979698,2,0,0,37888,1,7688731350
13675,114203860,86596334,200800194,6,0,0,1024,12,427704174
13676,114204530,118465349,232669879,0,0,1,31232,6,2762366139
13677,114225700,85468528,199694228,8,0,0,1536,11,3240842145
13678,114227910,86663214,200891124,6,0,0,78336,12,575364357
13679,114237910,87552074,201789984,7,0,0,14848,1,10087747831
13680,114239680,85718558,199958238,5,0,0,9216,12,452430290
13681,114252580,86405313,200657893,8,0,0,30720,11,9319588413
13682,114257750,86172153,200429903,5,0,0,13312,12,3122149710
13683,114259400,85866203,200125603,4,0,0,2560,7,6570984068
13684,114265901,85635415,199901316,9,0,0,2560,4,7330267372
13685,114271230,87467688,201738918,9,0,0,49664,4,4578768348
13686,114276870,87598715,201875585,3,0,0,55808,18,2888703
13687,114279630,86722453,201002083,1,0,0,26112,1,155687233
13688,114281860,86830028,201111888,9,0,0,39424,4,8802993723
13689,114297730,85707422,200005152,8,0,0,15872,11,9296884902
13690,114322140,86501667,200823807,4,0,0,28160,7,5824697981
13691,114334810,85804597,200139407,6,0,0,32256,12,6981893548
13692,114347930,85780504,200128434,2,0,0,9216,1,6681839799
13693,114348540,85862505,200211045,8,0,0,1024,11,2213652474
13694,114363920,85940604,200304524,2,0,0,1024,1,10407641747
13695,114367499,118306496,232673995,3,0,1,3072,18,1724305921
13696,114371470,85577650,199949120,9,0,0,512,4,10584201262
13697,114382160,86214390,200596550,8,0,0,19968,11,9883710510
13698,114382460,86409701,200792161,1,0,0,19968,1,7327430773
13699,114397520,85995848,200393368,2,0,0,34304,1,32219616
13700,114398200,86652834,201051034,9,0,0,45568,4,4090247688
13701,114404990,85724099,200129089,4,0,0,2048,7,5029643021
13702,114405770,86439645,200845415,2,0,0,21504,1,4258868585
13703,114409980,118279810,232689790,8,0,1,7680,11,9836889455
13704,114440540,86780516,201221056,8,0,0,12288,11,3466585419
13705,114465730,85773605,200239335,7,0,0,53760,1,87595453
13706,114467020,85530257,199997277,5,0,0,13312,12,5715508983
13707,114484560,86483571,200968131,7,0,0,49664,1,6723834660
13708,114489450,86221673,200711123,6,0,0,26624,12,9767361143
13709,114490820,86758963,201249783,7,0,0,94208,1,929433997
13710,114491130,86560707,201051837,3,0,0,2560,18,3765977678
13711,114493060,86292994,200786054,5,0,0,23040,12,3885290218
13712,114498200,86597607,201095807,6,0,0,44544,12,3323882583
13713,114512410,85766779,200279189,8,0,0,26112,11,1992912057
13714,114516450,85978073,200494523,5,0,0,34816,12,3648391601
13715,114528000,86940778,201468778,9,0,0,5632,4,924818448
13716,114537650,85856076,200393726,7,0,0,1024,1,9841702635
13717,114538010,85672700,200210710,0,0,0,23040,6,3745775632
13718,114546170,85864785,200410955,1,0,0,12288,1,3314768369
13719,114557970,86077799,200635769,4,0,0,12288,7,8451023066
13720,114564030,118125783,232689813,6,0,1,18432,12,1280919897
13721,114579180,86636370,201215550,4,0,0,126464,7,435600538
13722,114584780,118185040,232769820,1,0,1,27136,1,7459864545
13723,114585750,86186016,200771766,0,0,0,7680,6,8149523864
13724,114594120,86571833,201165953,0,0,0,26624,6,1688598391
13725,114606760,86193091,200799851,3,0,0,2560,18,5744765029
13726,114614360,86462262,201076622,4,0,0,52224,7,2167240125
13727,114624870,85687802,200312672,0,0,0,2560,6,5752914067
13728,114626740,86691193,201317933,3,0,0,59392,18,7193491286
13729,114636960,118154324,232791284,2,0,1,4608,1,10198012592
13730,114646590,85814742,200461332,0,0,0,16384,6,5147444413
13731,114654860,118262252,232917112,0,0,1,38400,6,7214354909
13732,114679180,118364408,233043588,0,0,1,2560,6,6067883623
13733,114684640,86268312,200952952,0,0,0,67584,6,212454814
13734,114684910,86084493,200769403,7,0,0,10240,1,1572269962
13735,114687770,86952638,201640408,9,0,0,109056,4,5570659682
13736,114691331,118571838,233263169,9,0,1,41984,4,10082252463
13737,114698690,118594095,233292785,2,0,1,19968,1,9278466971
13738,114714960,87300683,202015643,6,0,0,61952,12,8571432924
13739,114720020,86553700,201273720,8,0,0,8704,11,8014972156
13740,114725340,85833982,200559322,4,0,0,15360,7,8093459255
13741,114738499,118658127,233396626,5,0,1,19968,12,284450669
13742,114742300,86773141,201515441,2,0,0,98304,1,1346354965
13743,114747630,87328632,202076262,5,0,0,18432,12,2488620271
13744,114764130,87383222,202147352,2,0,0,24064,1,8987551749
13745,114764640,86229464,200994104,5,0,0,22528,12,2592738719
13746,114771890,86027158,200799048,6,0,0,22528,12,8931409808
13747,114776100,86659278,201435378,0,0,0,18944,6,6631765032
13748,114781740,85815457,200597197,8,0,0,2048,11,952739529
13749,114789531,118607761,233397292,9,0,1,1024,4,1636483858
13750,114797990,118602848,233400838,4,0,1,5632,7,628494859
13751,114804130,118668497,233472627,6,0,1,512,12,8149942483
13752,114827490,86022104,200849594,8,0,0,6656,11,9437460151
13753,114829030,86925869,201754899,8,0,0,14848,11,2336892017
13754,114834430,86173604,201008034,1,0,0,19456,1,4771496333
13755,114838880,118635373,233474253,4,0,1,2560,7,439365368
13756,114844090,85963921,200808011,3,0,0,4608,18,6227299701
13757,114860880,86462692,201323572,9,0,0,18432,4,8157503021
13758,114860900,86488556,201349456,4,0,0,18432,7,8272430354
13759,114860960,86034087,200895047,7,0,0,12800,1,2319482592
13760,114874650,85904315,200778965,4,0,0,23552,7,9788424865
13761,114876649,118600510,233477159,5,0,1,4608,12,5445472106
13762,114884810,86046870,200931680,5,0,0,12800,12,1536819928
13763,114885880,86599586,201485466,8,0,0,22016,11,8420998706
13764,114891040,87393130,202284170,4,0,0,73728,7,3329029317
13765,114900350,86756640,201656990,0,0,0,40960,6,6270905357
13766,114914190,86303099,201217289,1,0,0,5632,1,5068685870
13767,114918330,119098078,234016408,0,0,1,132608,6,9001469343
13768,114923870,86221709,201145579,0,0,0,512,6,3104781114
13769,114942500,86736041,201678541,3,0,0,70656,18,9499141566
13770,114964720,86022489,200987209,9,0,0,24576,4,8342185607
13771,114967930,87559388,202527318,9,0,0,72704,4,6202402527
13772,114977960,86137094,201115054,2,0,0,9728,1,5878101922
13773,115001100,86269945,201271045,1,0,0,69632,1,3576363978
13774,115003100,119013331,234016431,4,0,1,3072,7,6499373660
13775,115004340,119012114,234016454,2,0,1,1024,1,8616207068
13776,115013560,86098507,201112067,4,0,0,512,7,2582688791
13777,115024080,86399022,201423102,4,0,0,39424,7,3042621145
13778,115042570,86494713,201537283,5,0,0,15872,12,710027301
13779,115046310,86785806,201832116,0,0,0,27136,6,5051924303
13780,115053600,118962877,234016477,8,0,1,8704,11,8904877182
13781,115070400,86788158,201858558,4,0,0,22016,7,1725572578
13782,115079350,86958678,202038028,3,0,0,16896,18,6149232228
13783,115081350,86680904,201762254,6,0,0,24064,12,879661643
13784,115081790,119924239,235006029,0,0,1,428032,6,6390206035
13785,115087490,86945367,202032857,6,0,0,53248,12,2967797434
13786,115093780,86656572,201750352,6,0,0,37376,12,4716087999
13787,115100900,86817994,201918894,1,0,0,15360,1,2683302243
13788,115100990,86341278,201442268,9,0,0,13824,4,2309327592
13789,115108420,86494762,201603182,7,0,0,92160,1,3415871078
13790,115138530,86838934,201977464,3,0,0,183296,18,8489101353
13791,115140761,119871859,235012620,9,0,1,2560,4,10681286054
13792,115147710,86688017,201835727,6,0,0,11776,12,7221671256
13793,115150420,119866999,235017419,6,0,1,12800,12,2393334297
13794,115152190,86918268,202070458,2,0,0,7680,1,49059668
13795,115153700,87632815,202786515,0,0,0,14336,6,7334918903
13796,115162800,87701284,202864084,8,0,0,48640,11,2296210765
13797,115170410,86368167,201538577,6,0,0,4096,12,6265501741
13798,115186110,86290868,201476978,4,0,0,5632,7,1730118385
13799,115196140,86929921,202126061,8,0,0,4608,11,1451248505
13800,115206940,86218681,201425621,1,0,0,8192,1,6469033111
13801,115228970,87329322,202558292,3,0,0,7168,18,1837436958
13802,115237280,87690504,202927784,4,0,0,108544,7,4626108909
13803,115242290,85903110,201145400,0,0,0,4608,6,2030942182
13804,115263200,120452926,235716126,1,0,1,302592,1,8226122609
13805,115263769,120495572,235759341,5,0,1,17408,12,10001028336
13806,115264410,87999629,203264039,0,0,0,50176,6,4044032446
13807,115275380,87097331,202372711,5,0,0,24576,12,9367474643
13808,115298490,86233934,201532424,6,0,0,36864,12,5069389010
13809,115300270,86380010,201680280,1,0,0,5632,1,7902377549
13810,115300580,86693934,201994514,0,0,0,46080,6,5320352844
13811,115327450,87686076,203013526,1,0,0,104448,1,9527318576
13812,115331390,88005083,203336473,2,0,0,69120,1,1548597202
13813,115335340,87793608,203128948,1,0,0,140288,1,8565263184
13814,115335900,87334927,202670827,2,0,0,20992,1,1788253226
13815,115351630,86970066,202321696,8,0,0,7168,11,8756954986
13816,115358540,85922816,201281356,7,0,0,6656,1,10184546290
13817,115381010,120380238,235761248,7,0,1,3584,1,6602025579
13818,115385380,86259107,201644487,4,0,0,13312,7,1280959379
13819,115399931,120362623,235762554,9,0,1,2048,4,9973735747
13820,115402069,120362111,235764180,3,0,1,2560,18,1825846239
13821,115406020,88177034,203583054,3,0,0,120832,18,9662863190
13822,115412260,86682722,202094982,4,0,0,14336,7,9158030285
13823,115425060,86478408,201903468,8,0,0,12800,11,4621048455
13824,115425350,86474149,201899499,2,0,0,78336,1,2584849325
13825,115425600,87281882,202707482,4,0,0,107520,7,7874695266
13826,115428790,120336056,235764846,8,0,1,1024,11,9213097029
13827,115429120,86793836,202222956,6,0,0,80384,12,8752435787
13828,115430830,86414760,201845590,2,0,0,11776,1,4692899509
13829,115431880,120338957,235770837,2,0,1,22528,1,7952929071
13830,115431930,87033108,202465038,4,0,0,24576,7,4321860563
13831,115434590,120349965,235784555,6,0,1,512,12,3238939863
13832,115449280,86618286,202067566,2,0,0,13312,1,7692819818
13833,115453080,86468497,201921577,3,0,0,8704,18,8394494409
13834,115466900,86549702,202016602,2,0,0,3072,1,9188311880
13835,115467600,86256163,201723763,6,0,0,12288,12,5581142309
13836,115467800,86441844,201909644,2,0,0,19968,1,7068749923
13837,115475950,86504501,201980451,4,0,0,9728,7,8218265226
13838,115476010,87839380,203315390,8,0,0,46080,11,7051679543
13839,115476770,86709801,202186571,5,0,0,22016,12,10174274154
13840,115502690,86493251,201995941,6,0,0,4608,12,6457356499
13841,115517260,86659148,202176408,1,0,0,13312,1,10497313344
13842,115530350,86305712,201836062,0,0,0,1024,6,227207044
13843,115536390,88194990,203731380,9,0,0,102400,4,6187417245
13844,115550530,86574104,202124634,5,0,0,51200,12,9436304694
13845,115568630,86748771,202317401,1,0,0,6656,1,6639715443
13846,115568670,86345521,201914191,0,0,0,14848,6,6149408031
13847,115569740,86468802,202038542,7,0,0,1536,1,2725930882
13848,115572520,88021895,203594415,6,0,0,24064,12,8390477890
13849,115573550,86526410,202099960,1,0,0,2560,1,4889122925
13850,115577200,120208021,235785221,4,0,1,1024,7,10193904590
13851,115578000,88478486,204056486,4,0,0,80384,7,9884556234
13852,115581790,88289456,203871246,6,0,0,15872,12,9179379678
13853,115595610,86757532,202353142,9,0,0,23552,4,7757898803
13854,115596410,89030548,204626958,1,0,0,4096,1,4327657956
13855,115605640,86754233,202359873,7,0,0,22016,1,4102025276
13856,115606520,86791907,202398427,8,0,0,6144,11,3501163716
13857,115606880,88628743,204235623,8,0,0,1536,11,10651908322
13858,115619890,86830466,202450356,4,0,0,14336,7,1317769822
13859,115636830,86460515,202097345,0,0,0,7680,6,9349702843
13860,115648090,86603558,202251648,7,0,0,5632,1,4205453778
13861,115651730,87177462,202829192,4,0,0,47104,7,5069707193
13862,115653650,86343094,201996744,9,0,0,2560,4,2190405288
13863,115670300,86464052,202134352,9,0,0,27136,4,6927908310
13864,115674260,86816612,202490872,8,0,0,5632,11,8700082008
13865,115679710,87185801,202865511,1,0,0,4608,1,10260549340
13866,115680110,88196330,203876440,5,0,0,16896,12,7375763222
13867,115685280,120104793,235790073,7,0,1,7680,1,5642346128
13868,115694810,86751155,202445965,1,0,0,17408,1,6086119465
13869,115707730,87435491,203143221,8,0,0,14336,11,8088821812
13870,115716590,87364420,203081010,9,0,0,74752,4,1225033139
13871,115756100,86633548,202389648,4,0,0,5120,7,127032555
13872,115760260,120030786,235791046,0,0,1,12800,6,4970590787
13873,115761720,86849182,202610902,0,0,0,45568,6,1719680288
13874,115768160,86618543,202386703,9,0,0,28160,4,1280589475
13875,115772750,120034532,235807282,6,0,1,17408,12,9905807785
13876,115773230,88978707,204751937,1,0,0,62976,1,1428640766
13877,115780570,86860792,202641362,8,0,0,57856,11,10460939177
13878,115788300,120177461,235965761,1,0,1,181760,1,6984963734
13879,115789000,89124422,204913422,4,0,0,54784,7,3362789567
13880,115801090,87975786,203776876,1,0,0,12800,1,1424666698
13881,115808340,87356790,203165130,2,0,0,38912,1,9195133463
13882,115811890,86732192,202544082,4,0,0,11776,7,4064336615
13883,115811920,120238264,236050184,2,0,1,41984,1,9786470294
13884,115812580,87245608,203058188,0,0,0,72704,6,2076841768
13885,115818450,86488190,202306640,1,0,0,10240,1,2098595859
13886,115850870,86514330,202365200,3,0,0,17408,18,7266759050
13887,115851220,86630262,202481482,7,0,0,23040,1,5723874686
13888,115864870,86807852,202672722,0,0,0,6144,6,3855414374
13889,115867780,86971887,202839667,8,0,0,34304,11,3622704037
13890,115868450,87217731,203086181,3,0,0,16896,18,5742307569
13891,115871490,87105750,202977240,1,0,0,23552,1,6717317103
13892,115875190,86906934,202782124,6,0,0,127488,12,2858748359
13893,115879009,120210988,236089997,5,0,1,7680,12,1764067084
13894,115913960,88459554,204373514,4,0,0,54784,7,1712271257
13895,115914400,88381996,204296396,8,0,0,59904,11,360835082
13896,115916200,87300970,203217170,4,0,0,45056,7,8112645843
13897,115923890,89136112,205060002,3,0,0,49664,18,6212141759
13898,115926960,87276436,203203396,8,0,0,109056,11,6737584079
13899,115929610,87319118,203248728,4,0,0,103424,7,6311279955
13900,115932600,120223946,236156546,1,0,1,8704,1,9265906768
13901,115937360,87467614,203404974,4,0,0,123392,7,1668330629
13902,115955390,87712776,203668166,2,0,0,30208,1,10483073020
13903,115955540,88076423,204031963,9,0,0,9216,4,2936501559
13904,115961600,120194969,236156569,4,0,1,23040,7,138402283
13905,115965970,86755912,202721882,9,0,0,8192,4,2824944021
13906,115968550,87505238,203473788,6,0,0,50688,12,5784541899
13907,115984530,87373059,203357589,7,0,0,9728,1,9378669106
13908,116007050,88244171,204251221,5,0,0,512,12,5733069362
13909,116011590,86929523,202941113,6,0,0,4096,12,4099161183
13910,116026930,86767564,202794494,5,0,0,26112,12,9468301943
13911,116037590,88063865,204101455,8,0,0,27648,11,181788772
13912,116044040,87591550,203635590,8,0,0,1024,11,115401818
13913,116051900,87086930,203138830,2,0,0,12288,1,4128361098
13914,116062870,86580699,202643569,2,0,0,7168,1,6125572673
13915,116081550,89262792,205344342,0,0,0,73216,6,2914855135
13916,116087210,120113173,236200383,2,0,1,5120,1,8840030093
13917,116095980,86843862,202939842,0,0,0,9728,6,5018817836
13918,116104840,87174423,203279263,0,0,0,40448,6,6142846370
13919,116109490,88621185,204730675,7,0,0,28672,1,5193763352
13920,116118160,86818695,202936855,9,0,0,29696,4,6282378886
13921,116136660,87206902,203343562,3,0,0,8192,18,1569410366
13922,116137581,120062825,236200406,9,0,1,10240,4,713769886
13923,116141010,86895003,203036013,1,0,0,73728,1,9370936126
13924,116142780,120057649,236200429,0,0,1,3584,6,1645698185
13925,116146310,87350956,203497266,9,0,0,5632,4,2841725670
13926,116147750,87467163,203614913,3,0,0,2048,18,2101493590
13927,116148651,87465615,203614266,9,0,0,61952,4,8718221526
13928,116153960,120046492,236200452,7,0,1,1024,1,9611881444
13929,116154050,87259870,203413920,3,0,0,25600,18,1602506228
13930,116189820,87601520,203791340,0,0,0,19968,6,7155571175
13931,116194010,86941053,203135063,4,0,0,19968,7,5982885184
13932,116197330,120004076,236201406,4,0,1,2048,7,8071691912
13933,116201200,87827932,204029132,4,0,0,15360,7,4276456680
13934,116209960,86630666,202840626,2,0,0,3072,1,361624371
13935,116215590,89279002,205494592,0,0,0,32768,6,1999803585
13936,116229300,119972772,236202072,7,0,1,1024,1,2384331762
13937,116231389,119973269,236204658,5,0,1,4096,12,3417576909
13938,116252070,120009591,236261661,8,0,1,12800,11,7557913958
13939,116255680,120171410,236427090,6,0,1,33792,12,3407101807
13940,116260270,86909875,203170145,3,0,0,16384,18,9556800948
13941,116266890,120160223,236427113,7,0,1,3072,1,728111289
13942,116268250,120158886,236427136,2,0,1,5632,1,5300422989
13943,116269070,88669997,204939067,1,0,0,34304,1,9753029665
13944,116269300,87748398,204017698,4,0,0,11776,7,10360666903
13945,116279029,120150805,236429834,5,0,1,7680,12,9181943272
13946,116294100,87548718,203842818,8,0,0,78848,11,7276725464
13947,116297259,120132598,236429857,5,0,1,8192,12,2332001805
13948,116299230,86854021,203153251,0,0,0,32768,6,7687370883
13949,116314190,87167623,203481813,5,0,0,7680,12,8943097743
13950,116325541,86941329,203266870,9,0,0,9216,4,9692377261
13951,116327640,87683772,204011412,1,0,0,157184,1,3439370788
13952,116327861,120103914,236431775,9,0,1,7680,4,7515586422
13953,116327880,87686207,204014087,3,0,0,8704,18,9800168140
13954,116335720,87005300,203341020,6,0,0,14848,12,2259089442
13955,116336080,87303039,203639119,2,0,0,6144,1,6535519412
13956,116340540,86939994,203280534,0,0,0,4096,6,8316802249
13957,116347580,87809578,204157158,8,0,0,79872,11,3679535790
13958,116361640,87269520,203631160,8,0,0,53248,11,5561466220
13959,116363141,120068657,236431798,9,0,1,7680,4,8019403619
13960,116369100,87394941,203764041,7,0,0,44544,1,10622202295
13961,116370330,88136184,204506514,6,0,0,22528,12,8763644995
13962,116370770,87108657,203479427,7,0,0,18432,1,9364237236
13963,116371830,88090523,204462353,9,0,0,147968,4,7639324770
13964,116377010,88304820,204681830,6,0,0,146944,12,2743264005
13965,116393280,87241967,203635247,0,0,0,13312,6,3973880419
13966,116425060,87471962,203897022,2,0,0,9728,1,490244334
13967,116428800,88119482,204548282,9,0,0,76800,4,8192651942
13968,116441000,87722421,204163421,6,0,0,20480,12,2258074560
13969,116447780,88634980,205082760,3,0,0,74240,18,8838079497
13970,116461560,87955686,204417246,5,0,0,74240,12,2087665590
13971,116462510,88222330,204684840,2,0,0,6656,1,7307881671
13972,116464030,88122534,204586564,1,0,0,69632,1,8054684107
13973,116465750,120008677,236474427,4,0,1,32768,7,4869378758
13974,116465790,87627210,204093000,0,0,0,97280,6,8467516562
13975,116473600,89066901,205540501,8,0,0,30208,11,3986188464
13976,116478760,87211337,203690097,9,0,0,13824,4,6391562905
13977,116480030,88320852,204800882,0,0,0,36352,6,6638924029
13978,116481350,88285915,204767265,9,0,0,5120,4,5297580608
13979,116489500,88666184,205155684,4,0,0,5632,7,32515131
13980,116497450,120071676,236569126,0,0,1,45568,6,7803840918
13981,116513970,88355515,204869485,8,0,0,8704,11,9694258736
13982,116535070,87989789,204524859,3,0,0,35840,18,6881216906
13983,116539920,88181996,204721916,2,0,0,40448,1,9504018918
13984,116549250,87136612,203685862,9,0,0,2560,4,3754553440
13985,116564730,88000579,204565309,6,0,0,55808,12,8615376637
13986,116565180,87185266,203750446,8,0,0,17920,11,2421656163
13987,116574270,88158456,204732726,7,0,0,6656,1,8925527771
13988,116574820,87487157,204061977,7,0,0,17920,1,1527902026
13989,116576320,89072012,205648332,5,0,0,54272,12,7094710933
13990,116577220,87195093,203772313,8,0,0,3584,11,5630650815
13991,116578690,88304110,204882800,3,0,0,6656,18,6606484726
13992,116600020,87665302,204265322,3,0,0,9216,18,7559183779
13993,116601280,87892240,204493520,1,0,0,85504,1,9987919234
13994,116609720,88405068,205014788,6,0,0,28160,12,223110546
13995,116611820,87338809,203950629,3,0,0,6656,18,4746858336
13996,116627300,87397129,204024429,4,0,0,22016,7,10135583285
13997,116634470,119990985,236625455,6,0,1,22528,12,4608913907
13998,116640031,119985447,236625478,9,0,1,5632,4,9398271550
13999,116644170,87659113,204303283,2,0,0,22528,1,6366321328
14000,116651310,87848317,204499627,6,0,0,19968,12,3294631379
14001,116667190,88323827,204991017,4,0,0,1536,7,6261689655
14002,116680520,88267158,204947678,4,0,0,11776,7,1404383493
14003,116692950,87231949,203924899,6,0,0,512,12,2976873139
14004,116714550,89240559,205955109,9,0,0,10240,4,4341406188
14005,116716420,120033095,236749515,7,0,1,16384,1,10525480530
14006,116727490,89394027,206121517,1,0,0,87552,1,3202366590
14007,116727600,87476695,204204295,4,0,0,17920,7,1419504517
14008,116732750,87502382,204235132,8,0,0,35840,11,6925548132
14009,116740710,88408376,205149086,6,0,0,64512,12,6462009495
14010,116744440,88253462,204997902,5,0,0,7168,12,1155033821
14011,116747880,88379989,205127869,6,0,0,32768,12,2320289549
14012,116752990,88618675,205371665,4,0,0,89600,7,9781366984
14013,116759340,88723194,205482534,3,0,0,116224,18,9306478857
14014,116775869,119974381,236750250,5,0,1,2560,12,9341729759
14015,116794920,88014721,204809641,2,0,0,28672,1,8667464469
14016,116800200,88871565,205671765,7,0,0,68608,1,2386532736
14017,116808840,87705029,204513869,7,0,0,24064,1,3017841798
14018,116809850,87975440,204785290,9,0,0,3584,4,4658808422
14019,116823580,87643865,204467445,9,0,0,16384,4,10406949951
14020,116844130,87538290,204382420,4,0,0,14848,7,2875018884
14021,116864020,88551746,205415766,8,0,0,9728,11,2979697348
14022,116864950,88706930,205571880,4,0,0,102912,7,7268891613
14023,116899180,120000108,236899288,8,0,1,28672,11,551122413
14024,116900090,88675401,205575491,6,0,0,11776,12,4359050957
14025,116908350,88006031,204914381,8,0,0,3072,11,8228535518
14026,116916350,119982961,236899311,4,0,1,512,7,4269933772
14027,116924220,119975114,236899334,8,0,1,3584,11,2104537310
14028,116924520,89332083,206256603,2,0,0,65536,1,5102101889
14029,116930510,119987526,236918036,8,0,1,29696,11,290625618
14030,116933640,87840057,204773697,0,0,0,1024,6,7338397018
14031,116935660,120088349,237024009,7,0,1,44032,1,4008255779
14032,116946350,88216868,205163218,2,0,0,6656,1,10270960383
14033,116947050,120138224,237085274,7,0,1,16384,1,2998093167
14034,116950170,120244764,237194934,0,0,1,28672,6,10666046901
14035,116956750,88567270,205524020,1,0,0,25088,1,1294054854
14036,116958650,87724139,204682789,2,0,0,3072,1,1166937986
14037,116985600,87629333,204614933,5,0,0,13312,12,241798503
14038,116987770,87796405,204784175,0,0,0,33280,6,2392991812
14039,116991050,120230653,237221703,8,0,1,21504,11,9760950140
14040,117022930,87947040,204969970,3,0,0,1536,18,5764735551
14041,117030640,120254576,237285216,4,0,1,17408,7,10336602778
14042,117034990,88184193,205219183,5,0,0,74240,12,2093580055
14043,117059100,120226139,237285239,4,0,1,18944,7,10392672354
14044,117070360,87547404,204617764,1,0,0,9216,1,8821779754
14045,117071260,88413325,205484585,7,0,0,6656,1,8056203790
14046,117072420,87514791,204587211,6,0,0,2048,12,8040984736
14047,117081790,89263519,206345309,6,0,0,63488,12,7591351911
14048,117087290,120422576,237509866,1,0,1,67584,1,794728649
14049,117089470,87765085,204854555,1,0,0,10240,1,5645256552
14050,117097510,87893016,204990526,5,0,0,28672,12,7557675350
14051,117097950,87932333,205030283,6,0,0,27136,12,1101439866
14052,117106300,88192010,205298310,0,0,0,83456,6,10540444507
14053,117115950,120439753,237555703,2,0,1,10240,1,7568466560
14054,117127980,88784715,205912695,1,0,0,308736,1,5510095505
14055,117133730,87637207,204770937,6,0,0,2048,12,2089995838
14056,117134940,120673020,237807960,1,0,1,63488,1,5553931503
14057,117147521,120660462,237807983,9,0,1,1536,4,484245901
14058,117150770,88294426,205445196,8,0,0,85504,11,1583495874
14059,117156340,120724189,237880529,7,0,1,12800,1,418341385
14060,117170910,88069703,205240613,4,0,0,30720,7,5572096349
14061,117174940,88540673,205715613,4,0,0,51200,7,1689643503
14062,117177600,88206903,205384503,0,0,0,11776,6,10347066737
14063,117204180,89170956,206375136,9,0,0,68608,4,607686503
14064,117205671,120688343,237894014,9,0,1,8192,4,3422089831
14065,117212181,120683930,237896111,9,0,1,2048,4,4132055195
14066,117220180,87868375,205088555,1,0,0,18944,1,8492495784
14067,117222710,88860651,206083361,5,0,0,138752,12,1267928560
14068,117227730,120668404,237896134,4,0,1,16384,7,7979485451
14069,117230130,89240866,206470996,7,0,0,60928,1,2410580101
14070,117250220,88688394,205938614,1,0,0,84992,1,507590167
14071,117258170,87895775,205153945,7,0,0,15872,1,1619940992
14072,117264660,120719732,237984392,4,0,1,3584,7,9370529466
14073,117275410,88687374,205962784,6,0,0,25088,12,2775743945
14074,117285100,120744982,238030082,0,0,1,14848,6,4804358563
14075,117286280,88239947,205526227,3,0,0,7168,18,987333091
14076,117292110,88239148,205531258,8,0,0,16384,11,1961107484
14077,117294380,88977424,206271804,1,0,0,38400,1,2618749664
14078,117308430,88676704,205985134,9,0,0,33280,4,2759992830
14079,117322900,88071471,205394371,7,0,0,11776,1,4338140729
14080,117332810,88605983,205938793,0,0,0,512,6,42079987
14081,117349270,87972064,205321334,4,0,0,3072,7,248400254
14082,117374710,120655395,238030105,6,0,1,6656,12,7876286964
14083,117382460,88349267,205731727,1,0,0,22016,1,3585185038
14084,117390150,88300225,205690375,6,0,0,59904,12,9158413902
14085,117394640,88747413,206142053,0,0,0,16384,6,6220775432
14086,117402120,87978772,205380892,7,0,0,30208,1,7180512378
14087,117411090,88104452,205515542,8,0,0,56320,11,5723078256
14088,117412130,88678430,206090560,9,0,0,23552,4,699104715
14089,117416090,88031009,205447099,9,0,0,6144,4,1306844590
14090,117417770,120612358,238030128,6,0,1,1536,12,289339294
14091,117419250,87741917,205161167,3,0,0,17920,18,9641709652
14092,117420030,88096323,205516353,0,0,0,2560,6,5442826092
14093,117421290,88250810,205672100,4,0,0,1024,7,977170052
14094,117427550,89160106,206587656,0,0,0,7680,6,5100553689
14095,117440360,89280106,206720466,9,0,0,54272,4,7328652454
14096,117445320,88678412,206123732,4,0,0,7168,7,10278572399
14097,117478170,88473796,205951966,8,0,0,8704,11,9211867699
14098,117487910,89303332,206791242,4,0,0,79872,7,1155502071
14099,117494380,88546682,206041062,4,0,0,59392,7,2307182486
14100,117494640,87890518,205385158,5,0,0,2048,12,3971344838
14101,117494790,120582150,238076940,0,0,1,22528,6,643274290
14102,117506210,88242108,205748318,7,0,0,33792,1,2302796331
14103,117508160,120660956,238169116,6,0,1,7168,12,10700815343
14104,117513400,87899379,205412779,4,0,0,6656,7,5829846823
14105,117533490,88415801,205949291,9,0,0,34304,4,3513957972
14106,117539480,88669630,206209110,9,0,0,89600,4,7090124237
14107,117551230,88668667,206219897,4,0,0,35328,7,7954764591
14108,117551470,88605917,206157387,2,0,0,50176,1,5212026515
14109,117555310,88581728,206137038,7,0,0,19456,1,837374014
14110,117585660,120586778,238172438,6,0,1,512,12,10002017771
14111,117599390,120573071,238172461,0,0,1,10240,6,5720266136
14112,117606510,87891849,205498359,9,0,0,12288,4,4696602049
14113,117607230,88084572,205691802,4,0,0,4608,7,2925908057
14114,117607410,88117586,205724996,1,0,0,30720,1,2762417027
14115,117609790,120650652,238260442,0,0,1,35840,6,6121703695
14116,117621360,87961174,205582534,5,0,0,23040,12,4876036517
14117,117624050,89301403,206925453,0,0,0,13312,6,4330962414
14118,117641711,120620357,238262068,9,0,1,2560,4,6282918523
14119,117648500,88169964,205818464,1,0,0,15872,1,792272989
14120,117648600,88446218,206094818,1,0,0,6656,1,8749273784
14121,117658710,88333623,205992333,2,0,0,23552,1,3299994173
14122,117664420,88721503,206385923,4,0,0,35328,7,4717977145
14123,117667000,88569612,206236612,6,0,0,54784,12,6523664233
14124,117681730,121009171,238690901,1,0,1,80384,1,10372830272
14125,117683790,88642144,206325934,2,0,0,49664,1,5288908915
14126,117684140,88446947,206131087,0,0,0,24064,6,1806466369
14127,117689370,121125480,238814850,7,0,1,32768,1,9438771361
14128,117690330,88620449,206310779,3,0,0,45056,18,1023834225
14129,117702050,89162182,206864232,0,0,0,46080,6,798539229
14130,117706770,121108541,238815311,8,0,1,10240,11,8208003776
14131,117707710,89248810,206956520,6,0,0,101888,12,1451943935
14132,117719190,88577838,206297028,8,0,0,66560,11,6850728890
14133,117720410,88031148,205751558,3,0,0,4096,18,2990569579
14134,117720500,89329240,207049740,0,0,0,88064,6,698555196
14135,117722300,88836908,206559208,7,0,0,33792,1,10383163030
14136,117725130,121103901,238829031,6,0,1,2048,12,1413731646
14137,117734930,121115688,238850618,0,0,1,12800,6,10480304305
14138,117748450,121137500,238885950,7,0,1,16896,1,8107926811
14139,117756450,121138582,238895032,7,0,1,6144,1,4450421434
14140,117790290,121106368,238896658,1,0,1,2560,1,8124466511
14141,117805670,88636724,206442394,9,0,0,24576,4,2073423767
14142,117838690,88959283,206797973,8,0,0,22016,11,7564471067
14143,117845060,88799839,206644899,8,0,0,152576,11,2005812085
14144,117863250,121058155,238921405,6,0,1,20992,12,10484967910
14145,117885770,88296017,206181787,3,0,0,23040,18,10227318565
14146,117895780,89257814,207153594,2,0,0,150528,1,4935930150
14147,117904830,88492995,206397825,9,0,0,15872,4,2767663570
14148,117918270,88174497,206092767,5,0,0,7168,12,972243793
14149,117919120,88669339,206588459,5,0,0,2560,12,5473454105
14150,117925630,89297198,207222828,4,0,0,3584,7,2471234811
14151,117931440,89466864,207398304,3,0,0,2560,18,4169678816
14152,117936290,121098723,239035013,2,0,1,17920,1,3548964810
14153,117952240,88455459,206407699,4,0,0,13824,7,939191650
14154,117954330,89323423,207277753,4,0,0,9728,7,10113838365
14155,117959050,88567387,206526437,9,0,0,30208,4,6656559938
14156,117968100,88289930,206258030,5,0,0,4608,12,1426335556
14157,117969300,88290781,206260081,0,0,0,6656,6,1117965989
14158,117973730,121098959,239072689,4,0,1,30208,7,2550349903
14159,117974210,121139896,239114106,8,0,1,2048,11,331026973
14160,117977980,89557211,207535191,0,0,0,25088,6,652572141
14161,117978870,88700344,206679214,2,0,0,3072,1,7051535566
14162,117981920,88421544,206403464,0,0,0,18432,6,6183626248
14163,117983290,88469111,206452401,0,0,0,32768,6,7861239390
14164,117991180,121122949,239114129,6,0,1,10240,12,9536333811
14165,118001780,88406722,206408502,5,0,0,2560,12,1202542009
14166,118004540,88559371,206563911,4,0,0,15360,7,7328535427
14167,118004700,88388266,206392966,0,0,0,23040,6,4580911426
14168,118014370,88584018,206598388,8,0,0,12800,11,7056414783
14169,118015060,121843507,239858567,7,0,1,18432,1,5949946360
14170,118020550,88561048,206581598,5,0,0,54784,12,10060872774
14171,118026510,88629496,206656006,2,0,0,36352,1,2014219818
14172,118029760,88487450,206517210,2,0,0,59904,1,8887684283
14173,118032700,122118102,240150802,0,0,1,23552,6,2473922900
14174,118048280,89054705,207102985,3,0,0,10240,18,4498548591
14175,118060010,88693616,206753626,0,0,0,27136,6,1423455024
14176,118063360,88858014,206921374,5,0,0,153600,12,5295265357
14177,118065360,89470478,207535838,9,0,0,2048,4,7070302967
14178,118075670,89567362,207643032,4,0,0,193536,7,4897610472
14179,118078640,89422763,207501403,8,0,0,249856,11,5999970807
14180,118105310,88639557,206744867,7,0,0,1536,1,10263417879
14181,118108420,88981902,207090322,4,0,0,46080,7,6562371151
14182,118128280,88632857,206761137,5,0,0,24576,12,1800104656
14183,118128670,89242767,207371437,1,0,0,56320,1,5223607809
14184,118149490,88725061,206874551,7,0,0,33792,1,5072028405
14185,118158440,88575695,206734135,1,0,0,26624,1,7145469445
14186,118159810,88797989,206957799,6,0,0,4096,12,926378896
14187,118161750,89217198,207378948,3,0,0,24576,18,5573478008
14188,118161760,122273961,240435721,8,0,1,28160,11,7496684558
14189,118184100,89090666,207274766,3,0,0,55296,18,5342605890
14190,118184450,89364359,207548809,9,0,0,1024,4,4553185832
14191,118195270,89332254,207527524,0,0,0,45056,6,4003447129
14192,118217759,122217985,240435744,5,0,1,1024,12,10023996821
14193,118218390,89037610,207256000,2,0,0,59392,1,3288416288
14194,118226750,88930143,207156893,3,0,0,10752,18,5339298284
14195,118231690,88589265,206820955,8,0,0,53248,11,4416685132
14196,118263600,89122102,207385702,9,0,0,15360,4,5770999079
14197,118267110,89661939,207929049,3,0,0,15360,18,8981139427
14198,118267240,122168527,240435767,7,0,1,16384,1,6157093341
14199,118277120,89383788,207660908,1,0,0,25088,1,7994262478
14200,118285650,89384346,207669996,1,0,0,14848,1,7482748628
14201,118289490,89603712,207893202,3,0,0,472576,18,269332167
14202,118291399,122144391,240435790,5,0,1,2560,12,9068821838
14203,118295440,122140373,240435813,7,0,1,512,1,8070685584
14204,118304920,88872281,207177201,1,0,0,2560,1,5340339873
14205,118310690,89370863,207681553,7,0,0,4096,1,3039683181
14206,118317840,89687872,208005712,4,0,0,55808,7,373198662
14207,118324020,88965236,207289256,0,0,0,27136,6,1665985440
14208,118326770,89840895,208167665,2,0,0,45568,1,4779723059
14209,118327690,122588535,240916225,0,0,1,104960,6,10548558923
14210,118330400,122621488,240951888,1,0,1,512,1,10253300437
14211,118334270,88966581,207300851,9,0,0,27136,4,1955232279
14212,118334550,88825642,207160192,5,0,0,10752,12,10325919594
14213,118343830,89984301,208328131,1,0,0,48640,1,5544588606
14214,118355250,88858599,207213849,6,0,0,22016,12,5732927146
14215,118360830,88951759,207312589,6,0,0,15360,12,3292652380
14216,118366110,122585801,240951911,8,0,1,11264,11,10501113850
14217,118375000,88882895,207257895,7,0,0,6144,1,7069336240
14218,118389780,88891185,207280965,1,0,0,10240,1,4002612444
14219,118390440,89530607,207921047,9,0,0,14336,4,3485953337
14220,118415590,88676315,207091905,8,0,0,5120,11,7696930294
14221,118425720,122565047,240990767,7,0,1,1024,1,6796120473
14222,118429549,122561241,240990790,5,0,1,1024,12,3307321381
14223,118451950,122538863,240990813,7,0,1,14848,1,9183390650
14224,118452340,89053610,207505950,4,0,0,14848,7,5937449612
14225,118466610,89542557,208009167,1,0,0,11264,1,6584233697
14226,118469000,89044773,207513773,3,0,0,25600,18,1658851561
14227,118474370,122516466,240990836,7,0,1,7168,1,10681065909
14228,118502609,122491098,240993707,5,0,1,1024,12,10507578720
14229,118502700,122491571,240994271,1,0,1,10752,1,1869499100
14230,118504910,122490027,240994937,2,0,1,1024,1,5235264455
14231,118507640,89433981,207941621,3,0,0,13312,18,7164527125
14232,118511100,89431012,207942112,6,0,0,1536,12,2746166575
14233,118514990,89160998,207675988,6,0,0,6656,12,8120024133
14234,118517130,89505163,208022293,9,0,0,23040,4,7955979785
14235,118529470,89457304,207986774,0,0,0,129536,6,3940705911
14236,118533730,89390616,207924346,2,0,0,10752,1,10550521845
14237,118534640,89759074,208293714,6,0,0,38400,12,1206586347
14238,118538130,88842869,207380999,2,0,0,6656,1,7993303964
14239,118538679,122487976,241026655,3,0,1,7680,18,1503704012
14240,118552920,89962863,208515783,4,0,0,56320,7,10638160958
14241,118553380,122490660,241044040,4,0,1,15872,7,7770298741
14242,118571410,89345246,207916656,1,0,0,38912,1,533513794
14243,118576910,89360632,207937542,6,0,0,18432,12,7615876396
14244,118590710,89314059,207904769,1,0,0,37888,1,2597007862
14245,118591190,89158001,207749191,6,0,0,62976,12,1111357723
14246,118592750,89056412,207649162,7,0,0,15872,1,3891331949
14247,118594510,89559248,208153758,0,0,0,172544,6,8405199097
14248,118595890,89076157,207672047,5,0,0,6656,12,9078710167
14249,118615330,89398852,208014182,7,0,0,16384,1,4966974050
14250,118624130,88915475,207539605,4,0,0,12288,7,4826115775
14251,118632700,88930849,207563549,4,0,0,13824,7,6702339070
14252,118636820,89295083,207931903,4,0,0,3584,7,3437877112
14253,118640660,89450236,208090896,0,0,0,16896,6,10456388137
14254,118648070,122401762,241049832,1,0,1,3072,1,7150943181
14255,118663260,88981043,207644303,6,0,0,4096,12,6008972468
14256,118665260,89265528,207930788,8,0,0,5632,11,1768613023
14257,118669140,89393707,208062847,4,0,0,81920,7,574893327
14258,118670160,89765370,208435530,4,0,0,41472,7,10317382882
14259,118675120,88978121,207653241,8,0,0,13312,11,2869214132
14260,118676100,89656003,208332103,6,0,0,11264,12,5107503698
14261,118693280,90148724,208842004,9,0,0,43008,4,5648578921
14262,118702380,88988452,207690832,4,0,0,7168,7,1667786156
14263,118717100,89271569,207988669,1,0,0,6144,1,4964000012
14264,118720580,89518798,208239378,0,0,0,74240,6,1330715824
14265,118726870,89373253,208100123,5,0,0,30208,12,860061859
14266,118757401,122388893,241146294,9,0,1,21504,4,4728284132
14267,118785589,122361051,241146640,5,0,1,512,12,1283776172
14268,118787090,89290517,208077607,6,0,0,19456,12,10508646534
14269,118792300,90651760,209444060,7,0,0,818688,1,9941290486
14270,118795580,89766703,208562283,7,0,0,47616,1,6300878646
14271,118796130,89900644,208696774,7,0,0,66560,1,9198701394
14272,118803800,89770870,208574670,3,0,0,13312,18,10570720825
14273,118809440,89598760,208408200,9,0,0,27648,4,5450801995
14274,118809650,89407085,208216735,2,0,0,45056,1,2669808605
14275,118817030,89130253,207947283,1,0,0,16896,1,5036324980
14276,118819080,89462911,208281991,8,0,0,123392,11,2456123035
14277,118821710,122326006,241147716,8,0,1,13312,11,8312282753
14278,118829579,122375359,241204938,5,0,1,9728,12,5302678302
14279,118843691,122405377,241249068,9,0,1,15360,4,9569241423
14280,118849270,90331549,209180819,9,0,0,54272,4,5811932207
14281,118852480,89823417,208675897,9,0,0,1024,4,6489358393
14282,118871380,91524992,210396372,8,0,0,678400,11,4122299766
14283,118885680,90208618,209094298,5,0,0,13312,12,9310365689
14284,118900860,122398970,241299830,7,0,1,2048,1,5819119187
14285,118915560,89697035,208612595,4,0,0,14848,7,9372001959
14286,118931010,122478741,241409751,1,0,1,2560,1,5409782004
14287,118943470,89530602,208474072,0,0,0,6144,6,8569884358
14288,118962570,90688032,209650602,8,0,0,207360,11,524536686
14289,118976230,90145542,209121772,6,0,0,1536,12,4528328936
14290,118980980,89643962,208624942,0,0,0,40448,6,8038834684
14291,118985570,90555578,209541148,2,0,0,9216,1,2718670643
14292,118989600,90721784,209711384,3,0,0,55808,18,1306524472
14293,118997500,90536536,209534036,7,0,0,204288,1,5018935664
14294,118999230,91469976,210469206,5,0,0,89088,12,2885872708
14295,119004840,122504600,241509440,4,0,1,34816,7,3315017664
14296,119010920,90683398,209694318,0,0,0,4608,6,1082053669
14297,119018940,123575181,242594121,0,0,1,163328,6,3808364512
14298,119025230,89845127,208870357,2,0,0,4608,1,2432791214
14299,119026800,89817879,208844679,0,0,0,8704,6,3819327497
14300,119030781,123622377,242653158,9,0,1,7680,4,5019537581
14301,119042210,90630122,209672332,0,0,0,71168,6,3975646953
14302,119043070,90679303,209722373,6,0,0,15360,12,3608868100
14303,119054940,90673384,209728324,6,0,0,19456,12,911028311
14304,119055940,90624090,209680030,6,0,0,25088,12,9234398146
14305,119082160,90382052,209464212,6,0,0,29696,12,7387948349
14306,119093941,123607981,242701922,9,0,1,24576,4,3159098506
14307,119103970,90446896,209550866,5,0,0,31744,12,2480794801
14308,119127150,90319544,209446694,1,0,0,5632,1,2357732127
14309,119138150,89799761,208937911,2,0,0,23552,1,2625087913
14310,119145220,90049350,209194570,0,0,0,45056,6,7818720682
14311,119153160,90318609,209471769,7,0,0,24576,1,4310999026
14312,119180150,90407249,209587399,7,0,0,37888,1,8254141141
14313,119181800,90273341,209455141,5,0,0,27648,12,7819862041
14314,119189120,90255743,209444863,9,0,0,2560,4,1793420796
14315,119196560,90496285,209692845,8,0,0,41984,11,5952633813
14316,119213380,89904033,209117413,7,0,0,13824,1,3246147120
14317,119214530,90323741,209538271,8,0,0,13824,11,8891162971
14318,119231160,124164001,243395161,0,0,1,361984,6,7666154096
14319,119235921,124199454,243435375,9,0,1,1024,4,9951857479
14320,119247000,124188398,243435398,8,0,1,9216,11,5050353568
14321,119248970,90484993,209733963,7,0,0,18432,1,6201126607
14322,119250610,90462513,209713123,6,0,0,5632,12,5884444480
14323,119252410,89911850,209164260,8,0,0,38912,11,2691411585
14324,119257940,90572890,209830830,3,0,0,15360,18,3527655782
14325,119264010,90502492,209766502,3,0,0,12800,18,332690316
14326,119264990,90310757,209575747,6,0,0,33792,12,3347514029
14327,119284990,90464331,209749321,3,0,0,50176,18,51381154
14328,119294380,90271017,209565397,7,0,0,47616,1,8251973235
14329,119299240,90418430,209717670,0,0,0,14848,6,4956396584
14330,119327550,90513808,209841358,3,0,0,9216,18,6786015881
14331,119334460,91063807,210398267,5,0,0,6144,12,8869548144
14332,119338890,124098592,243437482,1,0,1,6656,1,7792603609
14333,119345680,91129188,210474868,8,0,0,14848,11,8032735330
14334,119347410,91216555,210563965,8,0,0,9216,11,4126734712
14335,119354620,90495822,209850442,0,0,0,11264,6,3910275018
14336,119359090,91274817,210633907,5,0,0,36864,12,7585535562
14337,119403510,90451228,209854738,0,0,0,10240,6,7677785804
14338,119422810,91170545,210593355,0,0,0,41472,6,3597783398
14339,119422820,90394320,209817140,5,0,0,39424,12,4626524981
14340,119438109,124085278,243523387,5,0,1,27136,12,4870270190
14341,119461070,124110654,243571724,1,0,1,7168,1,4013838982
14342,119468460,90356422,209824882,8,0,0,17920,11,1802794235
14343,119470460,90615260,210085720,7,0,0,16384,1,8896911786
14344,119471620,90445404,209917024,0,0,0,72192,6,8780675334
14345,119472160,90695568,210167728,3,0,0,10752,18,1149839335
14346,119476930,124094817,243571747,7,0,1,15872,1,9533802858
14347,119485460,90372265,209857725,7,0,0,9728,1,71318735
14348,119498430,90943609,210442039,2,0,0,33792,1,4747334857
14349,119500420,90918930,210419350,3,0,0,69120,18,9167014210
14350,119503560,90419259,209922819,5,0,0,18944,12,7748316644
14351,119505830,91265364,210771194,8,0,0,11264,11,9575652195
14352,119523340,124048430,243571770,0,0,1,2560,6,8148955814
14353,119557660,91443083,211000743,3,0,0,15360,18,2432395610
14354,119579900,91072163,210652063,5,0,0,10752,12,712391772
14355,119581660,123990133,243571793,1,0,1,11776,1,1527000327
14356,119588560,91393941,210982501,8,0,0,102912,11,3959782451
14357,119588660,90955564,210544224,9,0,0,112640,4,6811773980
14358,119589500,90839701,210429201,3,0,0,32256,18,40425720
14359,119594401,124059851,243654252,9,0,1,39936,4,26698105
14360,119598910,91207592,210806502,0,0,0,23040,6,2815063294
14361,119612760,90482508,210095268,0,0,0,12800,6,10271812189
14362,119617190,90814530,210431720,9,0,0,8192,4,1666589743
14363,119617920,91713841,211331761,8,0,0,84992,11,1647105987
14364,119626010,90260268,209886278,7,0,0,3072,1,7998565927
14365,119635430,90976402,210611832,5,0,0,29696,12,2194008602
14366,119636010,90834311,210470321,3,0,0,3584,18,5956845062
14367,119642810,90995644,210638454,5,0,0,14848,12,8916766646
14368,119646420,91341096,210987516,3,0,0,16384,18,4569049904
14369,119646720,124107790,243754510,1,0,1,9216,1,2402252730
14370,119654039,124398178,244052217,5,0,1,35328,12,7959124001
14371,119680680,91436194,211116874,7,0,0,81408,1,6211463934
14372,119685190,90875944,210561134,7,0,0,17920,1,4424533436
14373,119693090,91070726,210763816,5,0,0,108032,12,653662662
14374,119705330,91158649,210863979,9,0,0,47104,4,5070372585
14375,119707760,124551016,244258776,7,0,1,24576,1,9740015489
14376,119713050,91009100,210722150,2,0,0,38400,1,2528450439
14377,119728310,91778895,211507205,0,0,0,349696,6,4380358217
14378,119736200,90956633,210692833,0,0,0,7680,6,2622338021
14379,119756450,91478391,211234841,8,0,0,194048,11,1705267955
14380,119775650,91300779,211076429,5,0,0,45056,12,2579880168
14381,119777070,90778581,210555651,0,0,0,37376,6,6779366612
14382,119793530,90805932,210599462,9,0,0,19968,4,6229824202
14383,119793870,90786810,210580680,0,0,0,54784,6,179133124
14384,119805900,90696759,210502659,5,0,0,91136,12,9246171681
14385,119813930,91002290,210816220,8,0,0,18944,11,1360988891
14386,119828549,124430250,244258799,3,0,1,5632,18,8394231973
14387,119830020,90772741,210602761,8,0,0,10752,11,2540824358
14388,119842510,91431556,211274066,8,0,0,47616,11,5787436440
14389,119850670,90796231,210646901,4,0,0,27648,7,8572803629
14390,119861020,90647434,210508454,5,0,0,18944,12,453661089
14391,119874120,91181171,211055291,5,0,0,6656,12,3310821693
14392,119878870,124456888,244335758,8,0,1,41472,11,4899320099
14393,119881670,90944144,210825814,8,0,0,20480,11,5028020078
14394,119881900,90627981,210509881,4,0,0,4608,7,3319583649
14395,119889200,90729379,210618579,7,0,0,22016,1,6534953277
14396,119890930,90799540,210690470,7,0,0,30208,1,8406548898
14397,119895760,91045823,210941583,5,0,0,130048,12,6095040804
14398,119922010,91094832,211016842,5,0,0,52736,12,7630215594
14399,119936710,90827597,210764307,8,0,0,1536,11,3959593015
14400,119936720,124506502,244443222,1,0,1,10240,1,3446948334
14401,119956640,124536751,244493391,0,0,1,38400,6,6185453237
14402,119958910,91068619,211027529,6,0,0,512,12,6422090208
14403,119963470,91786482,211749952,7,0,0,51200,1,417794071
14404,119968650,91597239,211565889,0,0,0,13312,6,6523161430
14405,119972240,91020626,210992866,6,0,0,13824,12,7045587352
14406,119996259,124497155,244493414,3,0,1,3584,18,4443580522
14407,119998100,124515359,244513459,6,0,1,28672,12,7148731839
14408,120004960,90805465,210810425,3,0,0,12800,18,9576269232
14409,120010440,90858577,210869017,2,0,0,1536,1,3110719110
14410,120085430,91269066,211354496,3,0,0,24576,18,1484988348
14411,120085500,91808282,211893782,8,0,0,12800,11,8387495002
14412,120091720,124474098,244565818,6,0,1,7680,12,4361973818
14413,120092900,124749637,244842537,1,0,1,43008,1,9125942097
14414,120092940,91189261,211282201,4,0,0,26624,7,1757637527
14415,120094430,90702705,210797135,4,0,0,6656,7,6371430421
14416,120106230,90889810,210996040,6,0,0,6656,12,3812607131
14417,120107770,90886211,210993981,2,0,0,3584,1,5081070618
14418,120108240,124941118,245049358,6,0,1,3072,12,1109138432
14419,120116070,90872561,210988631,3,0,0,3584,18,1371623680
14420,120116400,91143135,211259535,0,0,0,10752,6,1052749514
14421,120140640,90727886,210868526,2,0,0,14848,1,8285449389
14422,120192970,124879763,245072733,8,0,1,4096,11,5788985498
14423,120194230,90756892,210951122,1,0,0,31232,1,8177407580
14424,120196230,91168281,211364511,1,0,0,32768,1,9785221107
14425,120210640,91045596,211256236,5,0,0,70144,12,6871734479
14426,120211919,124861480,245073399,5,0,1,1024,12,7871752155
14427,120217930,91799682,212017612,4,0,0,17920,7,3104352597
14428,120219550,91086292,211305842,6,0,0,67072,12,7011435695
14429,120225000,90935297,211160297,0,0,0,19968,6,573473608
14430,120234350,91144979,211379329,2,0,0,15872,1,2134678517
14431,120242250,90874803,211117053,5,0,0,512,12,3562536768
14432,120242270,91319517,211561787,2,0,0,30720,1,2609231090
14433,120253380,91297730,211551110,6,0,0,114176,12,5899449318
14434,120288700,91095463,211384163,6,0,0,12800,12,2563920685
14435,120316559,124761346,245077905,5,0,1,7168,12,7972599894
14436,120321430,91287265,211608695,2,0,0,34816,1,7901569287
14437,120324160,124847084,245171244,0,0,1,47104,6,7894848546
14438,120334920,124836347,245171267,1,0,1,1536,1,4509193679
14439,120365890,90919493,211285383,0,0,0,6656,6,5484573328
14440,120377410,90905906,211283316,1,0,0,3584,1,8074100815
14441,120381590,91170791,211552381,6,0,0,4096,12,406801438
14442,120389530,90957455,211346985,6,0,0,2048,12,3320084323
14443,120403241,124768049,245171290,9,0,1,11264,4,2347207137
14444,120404270,90940953,211345223,6,0,0,34304,12,9214386989
14445,120412560,91102312,211514872,4,0,0,25088,7,9528444774
14446,120423880,90910868,211334748,0,0,0,9728,6,3002859416
14447,120431450,91149290,211580740,7,0,0,48640,1,270068139
14448,120443610,90941824,211385434,0,0,0,4096,6,7733506620
14449,120445898,90900440,211346338,4,0,0,3584,7,1765381274
14450,120446990,91134668,211581658,4,0,0,2560,7,7618196214
14451,120458770,124743344,245202114,0,0,1,7168,6,6338935444
14452,120461800,91054499,211516299,5,0,0,4608,12,69966440
14453,120463680,124738457,245202137,1,0,1,2048,1,1969258660
14454,120483950,124718210,245202160,8,0,1,10752,11,5372322594
14455,120487280,91144682,211631962,2,0,0,76288,1,2813078625
14456,120495690,91287839,211783529,0,0,0,68096,6,4125301824
14457,120505560,91228769,211734329,0,0,0,57856,6,10656357868
14458,120513350,91407011,211920361,7,0,0,17920,1,4429043776
14459,120517480,91238267,211755747,7,0,0,18944,1,2998943422
14460,120534860,91547160,212082020,5,0,0,11264,12,7980783860
14461,120536720,91433301,211970021,7,0,0,9216,1,5598992945
14462,120543190,124749225,245292415,4,0,1,8192,7,624151037
14463,120548190,91575126,212123316,2,0,0,40448,1,8037723166
14464,120552680,91493172,212045852,1,0,0,30720,1,7575405294
14465,120563220,91721708,212284928,3,0,0,23552,18,8589955034
14466,120563940,91640094,212204034,7,0,0,82432,1,4888488412
14467,120586380,91357218,211943598,2,0,0,12288,1,228121377
14468,120595610,124696828,245292438,1,0,1,12800,1,5686179978
14469,120607020,91186686,211793706,1,0,0,31744,1,5691908343
14470,120610570,91787632,212398202,1,0,0,31232,1,8073584568
14471,120611840,91407245,212019085,3,0,0,4608,18,6149781286
14472,120618520,125131038,245749558,8,0,1,74752,11,3110123551
14473,120620430,91391699,212012129,1,0,0,25600,1,4375363828
14474,120630469,125119112,245749581,3,0,1,5632,18,8097353476
14475,120647320,125106059,245753379,6,0,1,3584,12,939883929
14476,120655830,91519018,212174848,7,0,0,22016,1,10411761496
14477,120667060,91336599,212003659,6,0,0,53248,12,4043485272
14478,120669750,91176057,211845807,2,0,0,32256,1,4972564609
14479,120671240,91112624,211783864,5,0,0,1024,12,5464124862
14480,120672170,91294997,211967167,3,0,0,8192,18,9468580871
14481,120689940,91129546,211819486,0,0,0,1536,6,1409161053
14482,120690380,91584006,212274386,5,0,0,81920,12,8975131003
14483,120708840,91142138,211850978,7,0,0,16896,1,7151193697
14484,120710670,91801989,212512659,1,0,0,46080,1,7243449414
14485,120713510,91251138,211964648,1,0,0,51200,1,9925628571
14486,120717320,91600912,212318232,6,0,0,57856,12,8260645902
14487,120718370,125038330,245756700,2,0,1,16896,1,1467304057
14488,120721730,91282576,212004306,1,0,0,2048,1,3427552262
14489,120730790,91206503,211937293,1,0,0,47616,1,5014079174
14490,120752550,91453223,212205773,2,0,0,5632,1,8283339955
14491,120757989,125187374,245945363,3,0,1,2048,18,2227970171
14492,120761410,91892205,212653615,6,0,0,64000,12,10274622065
14493,120771471,125173915,245945386,9,0,1,2048,4,7598991570
14494,120777740,125198736,245976476,7,0,1,10240,1,2160213189
14495,120781660,91451116,212232776,8,0,0,15360,11,1133232194
14496,120806030,91362087,212168117,2,0,0,43008,1,8585874290
14497,120815979,125160520,245976499,5,0,1,11264,12,7919485599
14498,120820010,91547997,212368007,7,0,0,13312,1,66454689
14499,120839760,91871137,212710897,0,0,0,95744,6,10100375976
14500,120857700,91823797,212681497,6,0,0,10240,12,7911370668
14501,120870410,125264645,246135055,6,0,1,34304,12,8417735366
14502,120871510,91256821,212128331,6,0,0,16384,12,9171739418
14503,120877850,91645627,212523477,2,0,0,20480,1,881868054
14504,120883471,125342809,246226280,9,0,1,5120,4,2788099047
14505,120905720,125375738,246281458,0,0,1,31744,6,5674811034
14506,120906610,91727482,212634092,4,0,0,54272,7,4991922638
14507,120913170,125479624,246392794,2,0,1,2048,1,4197048669
14508,120920110,91557349,212477459,0,0,0,135168,6,5468389573
14509,120932850,91292149,212224999,4,0,0,12800,7,6078436552
14510,120964950,91533638,212498588,3,0,0,52736,18,1532526582
14511,120966630,91626783,212593413,3,0,0,22016,18,7181346626
14512,120973720,91385308,212359028,5,0,0,10752,12,2668638976
14513,120978680,91116453,212095133,6,0,0,5120,12,8417284485
14514,120991290,91491207,212482497,3,0,0,4608,18,1253339230
14515,120999980,91481090,212481070,8,0,0,11776,11,8943792021
14516,121014670,91928309,212942979,8,0,0,27136,11,4334798101
14517,121015930,91789696,212805626,5,0,0,149504,12,3051983826
14518,121023760,91902146,212925906,2,0,0,98816,1,727718100
14519,121035790,91930396,212966186,3,0,0,44032,18,9920199645
14520,121036620,91399632,212436252,2,0,0,512,1,6207106498
14521,121039050,91395128,212434178,6,0,0,44544,12,7947377922
14522,121056090,125372040,246428130,8,0,1,15360,11,6103597920
14523,121061890,91872798,212934688,7,0,0,15360,1,2876657078
14524,121062590,91595416,212658006,8,0,0,14336,11,3625321339
14525,121067390,91497954,212565344,7,0,0,35328,1,10720273137
14526,121079360,91437854,212517214,3,0,0,14848,18,1029330851
14527,121080080,91997422,213077502,6,0,0,24576,12,10256898342
14528,121098840,91905139,213003979,2,0,0,22528,1,2924131079
14529,121099290,91336783,212436073,0,0,0,6144,6,2343725171
14530,121116470,91880622,212997092,5,0,0,78848,12,2503865271
14531,121116960,91813025,212929985,0,0,0,13312,6,5419506207
14532,121126560,91936898,213063458,7,0,0,76288,1,10632350026
14533,121143850,91609759,212753609,2,0,0,20480,1,3032780365
14534,121148240,91946748,213094988,3,0,0,22016,18,10240871608
14535,121150690,91693750,212844440,3,0,0,21504,18,2726276592
14536,121151560,91975077,213126637,1,0,0,2048,1,4804324920
14537,121151730,91595616,212747346,2,0,0,57344,1,1455845895
14538,121172240,91637190,212809430,8,0,0,10752,11,1404308792
14539,121189850,91478475,212668325,6,0,0,33792,12,10150276769
14540,121217290,125238361,246455651,0,0,1,23040,6,4114126223
14541,121219260,125236414,246455674,4,0,1,5632,7,405937349
14542,121221061,125234636,246455697,9,0,1,1024,4,6442855749
14543,121227850,125227870,246455720,0,0,1,512,6,7209269374
14544,121250850,125205789,246456639,7,0,1,6144,1,3293815344
14545,121258180,91921914,213180094,0,0,0,25600,6,5091778548
14546,121264180,91453119,212717299,1,0,0,5632,1,9527863201
14547,121275750,91988029,213263779,6,0,0,22528,12,6876198674
14548,121295350,125213548,246508898,1,0,1,2560,1,236915509
14549,121300800,91871471,213172271,4,0,0,74752,7,9278449374
14550,121304310,91705316,213009626,6,0,0,18432,12,4088346334
14551,121323350,125209897,246533247,4,0,1,15872,7,412266040
14552,121337351,125280973,246618324,9,0,1,4608,4,6759943928
14553,121339170,91381489,212720659,1,0,0,1536,1,2383471293
14554,121340610,125356451,246697061,0,0,1,25088,6,1100870758
14555,121360170,91526222,212886392,2,0,0,5120,1,593074768
14556,121362330,91661211,213023541,8,0,0,45568,11,10369420935
14557,121363570,91532205,212895775,6,0,0,30720,12,4890024137
14558,121370330,91655574,213025904,0,0,0,7680,6,3093611865
14559,121370550,91838546,213209096,7,0,0,26624,1,10389609905
14560,121377640,92158509,213536149,1,0,0,66560,1,9889646309
14561,121385070,91743794,213128864,3,0,0,7168,18,4703546595
14562,121387090,125744141,247131231,2,0,1,11264,1,10536386373
14563,121389890,91953018,213342908,1,0,0,63488,1,8566109937
14564,121391520,92322540,213714060,6,0,0,22016,12,2763480052
14565,121398930,91786491,213185421,7,0,0,17408,1,8284273606
14566,121401630,92178809,213580439,0,0,0,14848,6,9827139278
14567,121418950,91973182,213392132,3,0,0,16896,18,7135874867
14568,121430670,91892380,213323050,7,0,0,98816,1,8227397767
14569,121445400,126106341,247551741,4,0,1,18432,7,3036447132
14570,121447880,92284143,213732023,0,0,0,58880,6,4730730608
14571,121470630,91805185,213275815,3,0,0,32256,18,10538932107
14572,121476350,92039496,213515846,4,0,0,23552,7,8077835289
14573,121478510,126077430,247555940,0,0,1,17920,6,9512941347
14574,121481220,91621372,213102592,0,0,0,3584,6,7200237160
14575,121481260,91874050,213355310,5,0,0,33280,12,4940492805
14576,121495620,91637594,213133214,3,0,0,512,18,10150415259
14577,121498750,126190102,247688852,4,0,1,7680,7,10221326998
14578,121504939,126193421,247698360,5,0,1,7680,12,8654985977
14579,121519570,91938072,213457642,4,0,0,59392,7,4825379415
14580,121540040,126158343,247698383,1,0,1,11776,1,3056276505
14581,121559680,91660326,213220006,4,0,0,3584,7,1805192149
14582,121579080,91992147,213571227,4,0,0,17920,7,9774318415
14583,121579150,92060405,213639555,4,0,0,6144,7,9125448223
14584,121585040,91828752,213413792,6,0,0,43008,12,5030137181
14585,121585250,126120078,247705328,1,0,1,14848,1,6343783190
14586,121589750,91733791,213323541,1,0,0,1536,1,4031418032
14587,121598780,92428955,214027735,3,0,0,41472,18,107023066
14588,121616140,91742157,213358297,8,0,0,9728,11,806287587
14589,121624430,91802840,213427270,3,0,0,2560,18,7863830716
14590,121631690,91927974,213559664,7,0,0,66560,1,10617794943
14591,121637790,92413235,214051025,3,0,0,17920,18,8220993291
14592,121638850,92143763,213782613,1,0,0,47616,1,1423432236
14593,121640460,92267437,213907897,2,0,0,42496,1,1406288545
14594,121646210,91938360,213584570,4,0,0,9728,7,3629968772
14595,121653750,92865410,214519160,3,0,0,11264,18,9808024921
14596,121665160,92039471,213704631,8,0,0,43520,11,1763617601
14597,121673930,91978542,213652472,1,0,0,4608,1,4471006859
14598,121685080,92360462,214045542,4,0,0,58368,7,3615970584
14599,121694320,92563406,214257726,2,0,0,51200,1,8636361485
14600,121696730,91969988,213666718,8,0,0,512,11,10481886389
14601,121697770,126044140,247741910,8,0,1,17920,11,5781879856
14602,121702530,92413138,214115668,7,0,0,9216,1,5272207596
14603,121705960,91833401,213539361,3,0,0,10240,18,322081202
14604,121716020,92732974,214448994,1,0,0,11264,1,9555972853
14605,121720170,93000128,214720298,0,0,0,85504,6,8992103673
14606,121725250,91839320,213564570,2,0,0,15872,1,6611061745
14607,121725860,92636896,214362756,8,0,0,36864,11,8907624202
14608,121740470,91966859,213707329,4,0,0,8704,7,1587631337
14609,121741390,92060489,213801879,4,0,0,27136,7,9648156268
14610,121742580,92551822,214294402,3,0,0,37888,18,10350043387
14611,121760310,91877327,213637637,9,0,0,19968,4,5167830986
14612,121761880,92217327,213979207,2,0,0,43520,1,10654409399
14613,121768360,93085013,214853373,8,0,0,10240,11,6903740492
14614,121770790,92080973,213851763,3,0,0,1536,18,47086709
14615,121777549,126023607,247801156,5,0,1,13824,12,5016325061
14616,121782930,126018572,247801502,7,0,1,512,1,6197058541
14617,121785600,92300080,214085680,7,0,0,1536,1,4036321258
14618,121794759,126215110,248009869,5,0,1,67072,12,814278864
14619,121814830,92391744,214206574,0,0,0,29184,6,3888941742
14620,121818080,92119261,213937341,2,0,0,16896,1,9321554563
14621,121818130,92282510,214100640,1,0,0,17920,1,736012269
14622,121818320,92610128,214428448,9,0,0,53248,4,7024244517
14623,121819969,126189923,248009892,5,0,1,14848,12,3940041826
14624,121838350,91987409,213825759,2,0,0,9728,1,2867552383
14625,121843970,92237498,214081468,1,0,0,35840,1,5751718959
14626,121844770,91836905,213681675,8,0,0,2560,11,352890555
14627,121881180,92342181,214223361,8,0,0,4608,11,127065260
14628,121898100,92061526,213959626,5,0,0,8704,12,7473979215
14629,121898640,92665521,214564161,5,0,0,19968,12,430933752
14630,121905200,92283722,214188922,1,0,0,14336,1,650199584
14631,121908420,92941810,214850230,7,0,0,63488,1,6287626676
14632,121944860,92557154,214502014,8,0,0,76800,11,1435197996
14633,121946270,92527178,214473448,4,0,0,10240,7,10723348864
14634,121947480,92379376,214326856,0,0,0,7168,6,6702726176
14635,121953290,93207583,215160873,9,0,0,262656,4,7873616982
14636,121984460,91996798,213981258,5,0,0,6656,12,5958888916
14637,121988910,126132399,248121309,2,0,1,1024,1,8147635043
14638,121995500,92059627,214055127,1,0,0,13312,1,7974429325
14639,121996580,92544086,214540666,4,0,0,32768,7,3997832352
14640,121996790,92755575,214752365,4,0,0,45056,7,4435725884
14641,122019350,92145823,214165173,1,0,0,16896,1,5238080832
14642,122043210,92022423,214065633,6,0,0,22016,12,3815464619
14643,122052080,92604916,214656996,4,0,0,20992,7,4160672391
14644,122060370,126088651,248149021,2,0,1,5120,1,686617945
14645,122062190,92256097,214318287,8,0,0,4096,11,4639253845
14646,122068380,92479714,214548094,9,0,0,11264,4,1994728476
14647,122076330,92228580,214304910,9,0,0,24576,4,2079694035
14648,122090978,126692565,248783543,8,0,1,252928,11,382741242
14649,122093250,126824114,248917364,8,0,1,86016,11,2551084476
14650,122100610,92210849,214311459,4,0,0,15360,7,522207394
14651,122101340,93094444,215195784,3,0,0,25600,18,2331730869
14652,122106240,92039067,214145307,6,0,0,5120,12,5261613469
14653,122107960,126945903,249053863,0,0,1,45568,6,3544312595
14654,122126840,126927046,249053886,7,0,1,3584,1,8649848491
14655,122136530,92627402,214763932,8,0,0,37888,11,10492963052
14656,122139420,92928252,215067672,3,0,0,93184,18,2477740309
14657,122142100,92077298,214219398,2,0,0,1024,1,2750352154
14658,122143540,92507037,214650577,3,0,0,72192,18,3467666205
14659,122145240,126908669,249053909,7,0,1,5632,1,10314470028
14660,122150450,93106450,215256900,3,0,0,52736,18,5412123878
14661,122158860,93334882,215493742,9,0,0,137728,4,4961393903
14662,122165270,93167225,215332495,6,0,0,30720,12,9617642233
14663,122182590,126882776,249065366,4,0,1,12288,7,7316883372
14664,122183220,93213156,215396376,1,0,0,87040,1,9852238571
14665,122183421,126881968,249065389,9,0,1,5120,4,7970493177
14666,122185280,92443278,214628558,4,0,0,49664,7,9680532076
14667,122187360,92399160,214586520,1,0,0,48128,1,2583088301
14668,122188380,92631772,214820152,1,0,0,28672,1,8612060685
14669,122194260,127121695,249315955,8,0,1,148480,11,2278865816
14670,122201819,127189977,249391796,5,0,1,27648,12,5750895389
14671,122202970,92824057,215027027,7,0,0,60928,1,1196880966
14672,122211880,92346174,214558054,0,0,0,29696,6,2561921893
14673,122222070,92245906,214467976,4,0,0,32256,7,6834072225
14674,122226030,92740036,214966066,0,0,0,118272,6,3887247083
14675,122227340,93067584,215294924,1,0,0,122880,1,3277944373
14676,122235980,127228684,249464664,2,0,1,22528,1,4571345936
14677,122245250,93280314,215525564,6,0,0,10752,12,5760972029
14678,122249410,92644499,214893909,7,0,0,10752,1,1850462618
14679,122262210,92402571,214664781,1,0,0,2048,1,10362831020
14680,122264760,127199927,249464687,2,0,1,1536,1,4007867513
14681,122265640,127199070,249464710,4,0,1,1536,7,9144558030
14682,122274380,93319179,215593559,2,0,0,38400,1,3516055449
14683,122281370,92943481,215224851,7,0,0,9728,1,5820904064
14684,122289220,92690308,214979528,9,0,0,22528,4,9321052625
14685,122291770,127185011,249476781,4,0,1,10752,7,6034459112
14686,122303540,92599390,214902930,1,0,0,24576,1,10518484199
14687,122306980,92933829,215240809,9,0,0,35840,4,2345876489
14688,122314270,92872085,215186355,4,0,0,31744,7,726836139
14689,122341140,92739682,215080822,3,0,0,43008,18,7570338483
14690,122351140,92870724,215221864,6,0,0,20992,12,5478034809
14691,122373380,92599261,214972641,0,0,0,21504,6,9177427552
14692,122378620,127141950,249520570,4,0,1,24064,7,1184848506
14693,122380170,92876909,215257079,9,0,0,512,4,3892303946
14694,122391100,92785552,215176652,1,0,0,51712,1,6961074339
14695,122404580,92375252,214779832,0,0,0,9216,6,6043577170
14696,122406080,92503165,214909245,2,0,0,5632,1,950549158
14697,122410440,92990327,215400767,4,0,0,14336,7,7775782782
14698,122420070,92447091,214867161,3,0,0,5632,18,677888629
14699,122429360,92341402,214770762,6,0,0,9216,12,6676808710
14700,122433600,92556207,214989807,0,0,0,13824,6,3855814753
14701,122445550,92593691,215039241,7,0,0,37888,1,2504101333
14702,122479500,127045723,249525223,8,0,1,7680,11,9785597272
14703,122483460,92861694,215345154,9,0,0,41472,4,9117357434
14704,122491320,92718330,215209650,2,0,0,4096,1,1372194268
14705,122505000,92932320,215437320,0,0,0,25600,6,221305997
14706,122506770,92816342,215323112,5,0,0,61952,12,5317657548
14707,122513600,92716266,215229866,4,0,0,16384,7,8342189101
14708,122524250,92684060,215208310,1,0,0,40960,1,5127826508
14709,122529550,127019118,249548668,2,0,1,27648,1,1449672412
14710,122537570,93266381,215803951,8,0,0,35840,11,5079198943
14711,122541200,92760923,215302123,8,0,0,23552,11,9235691318
14712,122543750,93566259,216110009,5,0,0,34816,12,8089427440
14713,122547760,92479914,215027674,1,0,0,2048,1,8307872145
14714,122562880,92954674,215517554,8,0,0,14848,11,7539572917
14715,122571540,92643905,215215445,1,0,0,18944,1,2689908844
14716,122582440,92675005,215257445,6,0,0,1024,12,8932225681
14717,122582560,92869149,215451709,7,0,0,38400,1,9717132618
14718,122590740,92390215,214980955,3,0,0,4608,18,3117800384
14719,122599970,126948721,249548691,1,0,1,1024,1,6340725000
14720,122605710,92764115,215369825,0,0,0,80896,6,3886906511
14721,122612970,92689504,215302474,0,0,0,1024,6,5859655805
14722,122614610,93572886,216187496,0,0,0,28672,6,9123259119
14723,122615070,93628292,216243362,9,0,0,14848,4,2877604611
14724,122630380,92557558,215187938,1,0,0,5120,1,7086703639
14725,122635210,92669003,215304213,4,0,0,5632,7,1825392450
14726,122664420,92857845,215522265,9,0,0,15360,4,7615336407
14727,122666740,92915088,215581828,3,0,0,17920,18,4873925503
14728,122671190,92856581,215527771,2,0,0,7168,1,8755055138
14729,122682790,92892908,215575698,6,0,0,80384,12,10297943394
14730,122693600,126855114,249548714,4,0,1,1024,7,4371597201
14731,122696359,126865807,249562166,5,0,1,5120,12,6503567095
14732,122700610,92836700,215537310,3,0,0,31232,18,3589101864
14733,122701940,126860482,249562422,4,0,1,9216,7,1852261216
14734,122706510,92869835,215576345,5,0,0,2048,12,7699844079
14735,122707620,92912149,215619769,0,0,0,19968,6,10094155331
14736,122729100,92675613,215404713,4,0,0,12800,7,9130786808
14737,122739660,92773347,215513007,9,0,0,62976,4,10620604525
14738,122744530,126829264,249573794,0,0,1,8192,6,4752662550
14739,122748250,93138505,215886755,5,0,0,52224,12,1106635766
14740,122750670,93348708,216099378,4,0,0,115200,7,8369220796
14741,122754810,92868102,215622912,5,0,0,10240,12,4487326112
14742,122756470,93457688,216214158,9,0,0,1024,4,10420947094
14743,122772880,92961291,215734171,1,0,0,124416,1,10047761798
14744,122776750,126819681,249596431,0,0,1,23040,6,4378239990
14745,122808520,92862288,215670808,5,0,0,13824,12,7198369706
14746,122809820,92968835,215778655,7,0,0,32256,1,8104214375
14747,122818710,92948467,215767177,2,0,0,27648,1,6350551087
14748,122819840,93143177,215963017,7,0,0,17408,1,3632257043
14749,122831660,126825098,249656758,1,0,1,19456,1,8544049090
14750,122839060,93465851,216304911,8,0,0,89088,11,4240736458
14751,122841850,93738256,216580106,1,0,0,37888,1,4998228996
14752,122853820,93406678,216260498,8,0,0,43008,11,5790351167
14753,122865060,126804687,249669747,1,0,1,9216,1,9961301857
14754,122866720,93273556,216140276,7,0,0,48640,1,3081927255
14755,122867890,126803803,249671693,7,0,1,3072,1,10219151728
14756,122872220,93465748,216337968,0,0,0,28160,6,1685080939
14757,122882690,93284753,216167443,1,0,0,89088,1,3274029185
14758,122884310,126868279,249752589,6,0,1,9728,12,4593534163
14759,122892680,93638350,216531030,5,0,0,177664,12,10501198233
14760,122911780,93774150,216685930,4,0,0,76288,7,4115623879
14761,122915050,92977032,215892082,2,0,0,17408,1,6968508441
14762,122933880,93191553,216125433,8,0,0,13312,11,1341939993
14763,122960670,94135323,217095993,9,0,0,16384,4,10127369970
14764,122982750,93247917,216230667,8,0,0,11776,11,5370015469
14765,123011540,94243238,217254778,5,0,0,14848,12,2163907353
14766,123017210,93831060,216848270,3,0,0,114176,18,5929630578
14767,123021950,93183469,216205419,9,0,0,3072,4,3263699761
14768,123035950,92604657,215640607,7,0,0,1536,1,8967891049
14769,123039690,92698872,215738562,5,0,0,14336,12,9530238622
14770,123051050,93991238,217042288,1,0,0,66048,1,9073512724
14771,123052720,93600225,216652945,1,0,0,120832,1,584070877
14772,123056539,126696073,249752612,5,0,1,4096,12,7330298606
14773,123061090,93891641,216952731,0,0,0,14336,6,6355226865
14774,123065590,126687045,249752635,6,0,1,2048,12,5971882584
14775,123075700,94165510,217241210,0,0,0,14336,6,6625793293
14776,123087790,92805875,215893665,1,0,0,5120,1,1079422936
14777,123112070,93447398,216559468,5,0,0,53760,12,8063440709
14778,123113570,93251227,216364797,5,0,0,12288,12,7555226057
14779,123116910,93972628,217089538,6,0,0,13312,12,8070200668
14780,123123820,94398822,217522642,7,0,0,66560,1,4897190746
14781,123135380,94238399,217373779,0,0,0,69632,6,9488111116
14782,123135580,93068880,216204460,8,0,0,1024,11,8250456463
14783,123138220,126951908,250090128,4,0,1,27648,7,2073457630
14784,123140230,93459677,216599907,4,0,0,7168,7,3580999869
14785,123141850,126948301,250090151,0,0,1,13824,6,4025081349
14786,123154220,92910035,216064255,0,0,0,41472,6,7168300350
14787,123155550,92670255,215825805,5,0,0,5120,12,9671522077
14788,123156530,93320345,216476875,3,0,0,52736,18,9581905066
14789,123166130,93077411,216243541,2,0,0,512,1,9433038594
14790,123166460,93271407,216437867,8,0,0,37376,11,1589761425
14791,123166900,126923282,250090182,4,0,1,4608,7,3076942034
14792,123167860,127106723,250274583,0,0,1,43008,6,2107339856
14793,123171669,127107924,250279593,5,0,1,1536,12,7264666670
14794,123203370,93257414,216460784,0,0,0,43520,6,4552097538
14795,123218740,93518177,216736917,7,0,0,51712,1,7699722682
14796,123237990,93710350,216948340,1,0,0,19968,1,8901265840
14797,123252760,93462989,216715749,7,0,0,97792,1,10268713131
14798,123254250,93314289,216568539,5,0,0,29696,12,1586240939
14799,123268550,93394113,216662663,6,0,0,11776,12,6459011031
14800,123282100,93457774,216739874,4,0,0,1536,7,3726043658
14801,123289630,93253435,216543065,6,0,0,39424,12,7585079213
14802,123296780,93295632,216592412,1,0,0,7680,1,7373907977
14803,123300230,92810582,216110812,3,0,0,2560,18,966653528
14804,123309660,94172821,217482481,7,0,0,72192,1,17237374
14805,123315980,93123782,216439762,6,0,0,6144,12,8584046228
14806,123325780,94512986,217838766,5,0,0,10240,12,8219133275
14807,123326290,127054045,250380335,7,0,1,22016,1,6868326493
14808,123330680,92873422,216204102,7,0,0,18432,1,6892959602
14809,123337710,93252114,216589824,2,0,0,31744,1,1673224773
14810,123352080,93559443,216911523,3,0,0,69120,18,5917180056
14811,123375400,127289391,250664791,2,0,1,40960,1,5609978845
14812,123386790,127278024,250664814,8,0,1,8704,11,5098910940
14813,123392760,93420699,216813459,6,0,0,100864,12,3475577984
14814,123415180,93301894,216717074,1,0,0,512,1,5995771042
14815,123419730,93574461,216994191,9,0,0,31232,4,8626596607
14816,123426550,92999906,216426456,3,0,0,16384,18,6676562802
14817,123428960,93230092,216659052,9,0,0,19968,4,4031196759
14818,123434020,93171618,216605638,5,0,0,15872,12,1651450921
14819,123437570,127429847,250867417,1,0,1,48128,1,8107921738
14820,123446890,93559024,217005914,2,0,0,38400,1,9375702676
14821,123448760,93729421,217178181,7,0,0,25088,1,7521512156
14822,123453380,93717134,217170514,7,0,0,117760,1,3016101311
14823,123453570,94182577,217636147,7,0,0,111616,1,5747617794
14824,123454920,93416928,216871848,6,0,0,57344,12,5014270389
14825,123456320,93525601,216981921,5,0,0,72192,12,8042152058
14826,123461740,93480493,216942233,6,0,0,28160,12,3631599724
14827,123465120,93579999,217045119,7,0,0,9216,1,2169570787
14828,123472270,93746540,217218810,4,0,0,67072,7,5357836605
14829,123485700,127448554,250934254,1,0,1,43008,1,9280956165
14830,123495500,93221216,216716716,8,0,0,3072,11,9498066622
14831,123510930,93599699,217110629,1,0,0,4096,1,6731683221
14832,123515120,94301472,217816592,8,0,0,22528,11,10404958988
14833,123516280,94484194,218000474,5,0,0,108032,12,5382544221
14834,123519200,93679128,217198328,8,0,0,66048,11,3208081431
14835,123533690,127493220,251026910,8,0,1,512,11,9515868026
14836,123534550,93543419,217077969,1,0,0,2048,1,9842163941
14837,123543810,127484406,251028216,4,0,1,2048,7,5217277930
14838,123574510,94542202,218116712,4,0,0,49664,7,8466333162
14839,123578610,93482367,217060977,4,0,0,17408,7,6403942404
14840,123603080,94583354,218186434,7,0,0,12800,1,1451203967
14841,123611859,127418303,251030162,5,0,1,3072,12,6622875476
14842,123614020,93369328,216983348,0,0,0,4608,6,4879752901
14843,123614740,127421478,251036218,0,0,1,28672,6,10574959064
14844,123621710,127465247,251086957,8,0,1,2560,11,8700919534
14845,123627670,127459310,251086980,2,0,1,6144,1,4206784246
14846,123628140,93614052,217242192,5,0,0,3072,12,4215315736
14847,123632640,93659938,217292578,0,0,0,17920,6,9425950449
14848,123632970,93083925,216716895,3,0,0,512,18,1532271696
14849,123634210,94713351,218347561,7,0,0,5632,1,4413745146
14850,123641700,94696665,218338365,8,0,0,21504,11,4450366268
14851,123649550,93584594,217234144,8,0,0,8192,11,5219463926
14852,123652191,127434812,251087003,9,0,1,1024,4,905118969
14853,123656130,93670163,217326293,3,0,0,24064,18,9745565536
14854,123665940,93677818,217343758,8,0,0,33792,11,9490151480
14855,123672970,93623687,217296657,5,0,0,13312,12,775030380
14856,123673810,93557815,217231625,1,0,0,41984,1,2023412084
14857,123679550,93998786,217678336,3,0,0,75264,18,4982703460
14858,123681560,93364674,217046234,3,0,0,3584,18,179012405
14859,123687826,93695881,217383707,0,0,0,16896,6,4902290788
14860,123688710,94698020,218386730,9,0,0,23552,4,152353307
14861,123689060,127413745,251102805,0,0,1,8192,6,8774082830
14862,123690340,127412488,251102828,8,0,1,3072,11,6993844775
14863,123691110,94778227,218469337,0,0,0,41472,6,356501859
14864,123692690,93953776,217646466,2,0,0,33792,1,8366512918
14865,123701771,127401080,251102851,9,0,1,3072,4,4897949239
14866,123703440,93671922,217375362,7,0,0,5120,1,669203230
14867,123703850,93830763,217534613,0,0,0,38912,6,1318824649
14868,123708660,93414039,217122699,2,0,0,1536,1,9943481774
14869,123715560,94094145,217809705,9,0,0,17920,4,890443749
14870,123719421,127388936,251108357,9,0,1,5120,4,3013758017
14871,123725270,93627270,217352540,6,0,0,28672,12,5283975877
14872,123729000,93807196,217536196,5,0,0,5120,12,9661630105
14873,123745920,93632616,217378536,7,0,0,5120,1,8316045975
14874,123747360,93489459,217236819,1,0,0,8704,1,2348523581
14875,123762770,94836198,218598968,9,0,0,29696,4,1635608044
14876,123776040,94733222,218509262,3,0,0,3584,18,8155760143
14877,123791940,93705072,217497012,1,0,0,47616,1,10063064863
14878,123792240,127316140,251108380,1,0,1,1536,1,1125706310
14879,123801770,93887087,217688857,3,0,0,8192,18,557557283
14880,123811810,93869045,217680855,9,0,0,8192,4,261193585
14881,123813160,94943581,218756741,0,0,0,46080,6,8997513737
14882,123827700,93549253,217376953,9,0,0,5120,4,3056957059
14883,123828100,93439102,217267202,6,0,0,1536,12,2466743747
14884,123834530,94018166,217852696,1,0,0,20480,1,9876380214
14885,123834950,93588451,217423401,5,0,0,2048,12,7740466158
14886,123835690,127379200,251214890,4,0,1,12288,7,2059874804
14887,123851170,93835168,217686338,6,0,0,17920,12,9225219911
14888,123852880,127483771,251336651,2,0,1,13824,1,622117397
14889,123855630,94069198,217924828,7,0,0,50176,1,5480941016
14890,123864500,93790881,217655381,7,0,0,29184,1,5895308902
14891,123867170,93635169,217502339,1,0,0,17408,1,1675182391
14892,123874950,93718149,217593099,8,0,0,6144,11,5979665570
14893,123888180,94794226,218682406,5,0,0,71680,12,7511854111
14894,123889390,95439592,219328982,3,0,0,15360,18,6481620222
14895,123890910,93661311,217552221,4,0,0,9216,7,2545477800
14896,123906370,94894059,218800429,7,0,0,77312,1,2176183835
14897,123907290,95113964,219021254,2,0,0,15872,1,4332509154
14898,123912310,127429167,251341477,0,0,1,7680,6,1406721994
14899,123918520,93882715,217801235,7,0,0,75264,1,4872998298
14900,123936000,127441540,251377540,4,0,1,4096,7,5828858411
14901,123941980,127491311,251433291,6,0,1,28672,12,8149445761
14902,123946630,95019129,218965759,8,0,0,49152,11,10048076286
14903,123949120,93925774,217874894,7,0,0,12288,1,3114623837
14904,123950880,94305013,218255893,2,0,0,28672,1,3787250000
14905,123963100,93815180,217778280,3,0,0,28672,18,7696842080
14906,123969590,95321255,219290845,0,0,0,74240,6,1335979349
14907,123972910,94073551,218046461,9,0,0,20480,4,1526712727
14908,123983640,93454451,217438091,3,0,0,22528,18,2354056880
14909,123991880,93843720,217835600,4,0,0,36864,7,7379798471
14910,124006020,95190200,219196220,7,0,0,44544,1,2305638108
14911,124014830,127575040,251589870,6,0,1,36864,12,4174255369
14912,124031850,95123392,219155242,9,0,0,53248,4,5477228332
14913,124036670,93980854,218017524,7,0,0,34816,1,8553206761
14914,124066540,127535708,251602248,1,0,1,5632,1,663289764
14915,124068620,127554972,251623592,0,0,1,4096,6,4291181251
14916,124070470,93689567,217760037,0,0,0,3072,6,9958044081
14917,124084670,94905791,218990461,9,0,0,3072,4,3205543547
14918,124085000,94243312,218328312,8,0,0,60416,11,5641207527
14919,124086340,95017129,219103469,8,0,0,32768,11,2005680469
14920,124092050,93754383,217846433,2,0,0,25088,1,6620183734
14921,124093950,94007607,218101557,0,0,0,18432,6,9085538140
14922,124097020,127560938,251657958,7,0,1,6144,1,660138685
14923,124104660,94034071,218138731,6,0,0,72192,12,1235238680
14924,124121860,95357421,219479281,2,0,0,19968,1,3789767283
14925,124124620,94207170,218331790,3,0,0,11264,18,7299733332
14926,124126760,94556293,218683053,0,0,0,2048,6,9467889743
14927,124139680,94692605,218832285,0,0,0,24576,6,5947804232
14928,124140470,94038392,218178862,9,0,0,3072,4,6092328554
14929,124142640,93948731,218091371,8,0,0,46592,11,9847812244
14930,124144470,94948992,219093462,0,0,0,23040,6,7096840214
14931,124145070,93928709,218073779,3,0,0,29184,18,9042005909
14932,124160470,94249688,218410158,7,0,0,15360,1,8166318350
14933,124161820,94750139,218911959,3,0,0,7680,18,2644420914
14934,124175300,93972282,218147582,7,0,0,28672,1,8983437277
14935,124190650,95974212,220164862,6,0,0,54784,12,2309825216
14936,124195810,93608412,217804222,3,0,0,9728,18,1304785591
14937,124196690,93952107,218148797,2,0,0,2048,1,9833230214
14938,124213650,93882268,218095918,2,0,0,14848,1,2072219059
14939,124215800,94031334,218247134,6,0,0,86528,12,9706215081
14940,124219810,95244304,219464114,2,0,0,53760,1,999826930
14941,124224860,93815338,218040198,0,0,0,74240,6,6098766178
14942,124242480,127415509,251657989,1,0,1,10752,1,2272161578
14943,124252500,95368243,219620743,3,0,0,31744,18,1501259087
14944,124260330,94171758,218432088,1,0,0,512,1,933612844
14945,124288200,127479734,251767934,1,0,1,44544,1,4300283189
14946,124289930,127586140,251876070,4,0,1,7680,7,6719655465
14947,124298540,94117027,218415567,3,0,0,11776,18,5275734220
14948,124303970,93962567,218266537,3,0,0,21504,18,761533294
14949,124305460,95626595,219932055,6,0,0,119296,12,625898705
14950,124328290,93678603,218006893,9,0,0,20992,4,5195764140
14951,124332240,93716428,218048668,2,0,0,7168,1,8759021373
14952,124336340,94043191,218379531,8,0,0,31744,11,8056783256
14953,124339900,94402778,218742678,9,0,0,78848,4,8849270955
14954,124351160,95323733,219674893,0,0,0,54784,6,6130177022
14955,124359510,95431987,219791497,0,0,0,59904,6,10389989105
14956,124367860,127514121,251881981,7,0,1,4096,1,5520669787
14957,124377560,127507188,251884748,0,0,1,6144,6,245049463
14958,124379219,127510675,251889894,3,0,1,20480,18,121838964
14959,124379680,127681598,252061278,2,0,1,24576,1,4400540644
14960,124382840,94328298,218711138,7,0,0,64000,1,9225389204
14961,124394300,93826447,218220747,5,0,0,14848,12,5514135998
14962,124405260,127656041,252061301,6,0,1,18432,12,7546898454
14963,124410560,93945775,218356335,2,0,0,9216,1,4248854628
14964,124415800,95540691,219956491,4,0,0,19968,7,9601937909
14965,124419330,94084605,218503935,4,0,0,7168,7,5490685911
14966,124422850,93930654,218353504,2,0,0,15872,1,6361911006
14967,124437110,96137139,220574249,4,0,0,15872,7,2530385666
14968,124444360,94665528,219109888,7,0,0,20992,1,8982705715
14969,124448190,95575764,220023954,3,0,0,86016,18,246176986
14970,124452270,94385127,218837397,4,0,0,1024,7,2600425298
14971,124456260,94347624,218803884,1,0,0,11264,1,8389593304
14972,124457130,94595055,219052185,6,0,0,28672,12,4638794660
14973,124474430,94186113,218660543,1,0,0,26624,1,6317822341
14974,124498970,94854688,219353658,7,0,0,73216,1,5831782051
14975,124500070,96244597,220744667,1,0,0,155648,1,433628524
14976,124503940,95546736,220050676,7,0,0,62976,1,472056225
14977,124505469,127638463,252143932,5,0,1,8192,12,4666576819
14978,124514870,93877616,218392486,2,0,0,1536,1,1673191422
14979,124526370,95127819,219654189,0,0,0,8704,6,10243390914
14980,124532280,95902287,220434567,0,0,0,44544,6,9765620249
14981,124538510,94600477,219138987,0,0,0,15872,6,7409438718
14982,124539610,95842312,220381922,2,0,0,46592,1,3202435662
14983,124541880,96064310,220606190,5,0,0,70144,12,10072286803
14984,124543040,93894319,218437359,0,0,0,7680,6,10068569292
14985,124550860,94956131,219506991,6,0,0,5632,12,6508272586
14986,124582540,94712384,219294924,8,0,0,13312,11,1448450680
14987,124586400,94570581,219156981,6,0,0,5632,12,4619368634
14988,124601009,127545189,252146198,5,0,1,3584,12,3790221771
14989,124605660,94592299,219197959,6,0,0,5632,12,4831948124
14990,124612219,127554732,252166951,5,0,1,2560,12,4732526312
14991,124614760,94884668,219499428,6,0,0,66048,12,9070896779
14992,124629460,95320924,219950384,8,0,0,33280,11,6435577229
14993,124664880,94344189,219009069,1,0,0,38400,1,9242642562
14994,124689420,94342853,219032273,7,0,0,8192,1,1910053018
14995,124703850,96793631,221497481,8,0,0,1055232,11,7902362913
14996,124703990,94554478,219258468,5,0,0,24064,12,3596357684
14997,124712840,94106355,218819195,6,0,0,50176,12,7770429994
14998,124732580,127528374,252260954,0,0,1,14336,6,10306021384
14999,124745540,95129506,219875046,0,0,0,17408,6,1788631599
15000,124756700,127504277,252260977,1,0,1,3072,1,10598520732
15001,124764850,94666733,219431583,9,0,0,27136,4,8495457054
15002,124777520,95193571,219971091,8,0,0,4608,11,7716263116
15003,124785550,94963289,219748839,8,0,0,10240,11,1860617547
15004,124789690,94732924,219522614,6,0,0,51200,12,8026315772
15005,124797920,127466823,252264743,6,0,1,7168,12,4340890617
15006,124798790,94574859,219373649,1,0,0,65536,1,8594110330
15007,124823661,127447306,252270967,9,0,1,512,4,5692347829
15008,124826690,127444300,252270990,2,0,1,1536,1,9753613768
15009,124830120,94304008,219134128,2,0,0,10240,1,6723125970
15010,124838960,94608751,219447711,3,0,0,14848,18,5477137780
15011,124858330,94742376,219600706,2,0,0,40960,1,3235290050
15012,124863530,127410062,252273592,2,0,1,18944,1,9951949428
15013,124867930,94779161,219647091,8,0,0,1536,11,947184542
15014,124868260,95209146,220077406,0,0,0,31744,6,3716809574
15015,124883370,127441188,252324558,0,0,1,5120,6,6740486902
15016,124890020,94122036,219012056,6,0,0,9728,12,4725755521
15017,124895900,94639819,219535719,2,0,0,8704,1,5562015820
15018,124906130,94517162,219423292,7,0,0,14336,1,6908540387
15019,124919630,96676783,221596413,7,0,0,129536,1,10178237061
15020,124920080,94409705,219329785,1,0,0,2560,1,6337723364
15021,124926400,94684648,219611048,7,0,0,25600,1,5761640053
15022,124929390,95331228,220260618,6,0,0,17920,12,8395339181
15023,124931910,94963751,219895661,0,0,0,67584,6,10046256243
15024,124936830,96711224,221648054,1,0,0,27136,1,5990266907
15025,124952910,96165718,221118628,7,0,0,9216,1,5379523436
15026,124973710,94853846,219827556,0,0,0,118272,6,1590999095
15027,124976750,95090953,220067703,2,0,0,55808,1,6355164817
15028,124978530,95335827,220314357,9,0,0,42496,4,7518230932
15029,124979250,94623975,219603225,2,0,0,8192,1,9969603667
15030,124989820,94950401,219940221,6,0,0,26624,12,433401901
15031,124992930,94976734,219969664,3,0,0,19968,18,7694144363
15032,124997440,94964690,219962130,1,0,0,18432,1,969902294
15033,124997930,95111275,220109205,1,0,0,15360,1,6220373654
15034,125006390,127337581,252343971,4,0,1,18944,7,4023903053
15035,125012840,96531331,221544171,9,0,0,133120,4,9956654220
15036,125022500,94683301,219705801,3,0,0,1536,18,6009443731
15037,125038530,96634397,221672927,7,0,0,31744,1,5699608413
15038,125041520,96515379,221556899,7,0,0,18944,1,5451136867
15039,125048490,95445098,220493588,8,0,0,20992,11,2213128122
15040,125055450,95471853,220527303,8,0,0,33280,11,3496922587
15041,125056010,96552617,221608627,2,0,0,39936,1,8319871352
15042,125060730,127283264,252343994,2,0,1,6656,1,8291933664
15043,125061530,95257842,220319372,1,0,0,16384,1,1574956332
15044,125074740,95292963,220367703,2,0,0,46080,1,5415260834
15045,125079830,95183353,220263183,7,0,0,8192,1,1300550520
15046,125090000,96849197,221939197,0,0,0,62976,6,10480461376
15047,125131010,96644024,221775034,8,0,0,19968,11,6224254203
15048,125137200,96672979,221810179,5,0,0,38912,12,3916905078
15049,125141490,95149467,220290957,1,0,0,32256,1,8354269891
15050,125142530,127238388,252380918,2,0,1,512,1,7786736955
15051,125146130,94563076,219709206,9,0,0,9728,4,3831832637
15052,125158730,96806973,221965703,6,0,0,61440,12,951912888
15053,125173000,94812168,219985168,5,0,0,512,12,4533957380
15054,125182120,95007444,220189564,3,0,0,27136,18,8082753498
15055,125186610,96958511,222145121,3,0,0,89600,18,5671325521
15056,125190470,127192074,252382544,7,0,1,2560,1,8651032414
15057,125199210,95458809,220658019,0,0,0,42496,6,7825469833
15058,125203410,94632075,219835485,9,0,0,6144,4,4721412428
15059,125206010,127183237,252389247,8,0,1,18432,11,2908676156
15060,125206070,95184775,220390845,0,0,0,29184,6,6378536519
15061,125213210,95325192,220538402,8,0,0,36352,11,2820725834
15062,125213440,95129118,220342558,6,0,0,54272,12,7385065120
15063,125238240,94862193,220100433,1,0,0,21504,1,5785073185
15064,125240630,127148963,252389593,6,0,1,512,12,1598916120
15065,125253720,127136437,252390157,1,0,1,10752,1,1589441210
15066,125255330,127139169,252394499,1,0,1,2560,1,10164931865
15067,125256240,94707317,219963557,3,0,0,4608,18,1232076547
15068,125257150,94997985,220255135,9,0,0,41472,4,4864473359
15069,125266800,94706186,219972986,1,0,0,6144,1,6004334989
15070,125278870,95127415,220406285,1,0,0,18432,1,3035468289
15071,125281160,97024013,222305173,5,0,0,167936,12,6124178317
15072,125285530,95201639,220487169,5,0,0,82944,12,7158475454
15073,125288159,127109645,252397804,5,0,1,6656,12,2470808943
15074,125307740,94723725,220031465,6,0,0,24576,12,8868516442
15075,125334740,127123109,252457849,6,0,1,10240,12,8409588360
15076,125348050,95149954,220498004,6,0,0,6144,12,4813044774
15077,125353560,95211933,220565493,0,0,0,6144,6,3132339340
15078,125368370,95412026,220780396,2,0,0,15872,1,9780433884
15079,125375480,95721954,221097434,0,0,0,512,6,5047060445
15080,125379890,94918734,220298624,3,0,0,25088,18,7800847196
15081,125395890,95004756,220400646,9,0,0,19968,4,10589541264
15082,125397920,96930387,222328307,8,0,0,59904,11,232382955
15083,125408370,95053504,220461874,9,0,0,17408,4,6487073627
15084,125409190,127048682,252457872,1,0,1,2560,1,554769497
15085,125410120,95010852,220420972,2,0,0,48128,1,8603100179
15086,125415200,95436013,220851213,7,0,0,60416,1,8924151423
15087,125420810,96941877,222362687,9,0,0,49152,4,9748552172
15088,125430880,95743859,221174739,5,0,0,33280,12,10078579929
15089,125432480,95482826,220915306,0,0,0,18944,6,7328187065
15090,125441970,97068732,222510702,7,0,0,3584,1,10416439924
15091,125445820,97217623,222663443,7,0,0,25600,1,1200457017
15092,125449750,94985932,220435682,9,0,0,3584,4,10484921069
15093,125450480,95521451,220971931,1,0,0,58880,1,2992728917
15094,125469101,127055580,252524681,9,0,1,23040,4,5684157707
15095,125481260,94961066,220442326,0,0,0,21504,6,9628303946
15096,125483310,95468763,220952073,1,0,0,57856,1,991045825
15097,125494670,95145146,220639816,5,0,0,25600,12,7882581803
15098,125504670,97143377,222648047,5,0,0,110592,12,5748936685
15099,125505201,127125839,252631040,9,0,1,8704,4,3936456999
15100,125508720,95381072,220889792,5,0,0,32256,12,5492739813
15101,125513340,97036204,222549544,3,0,0,64000,18,841627092
15102,125529400,95974188,221503588,9,0,0,19968,4,2029781910
15103,125533480,97229678,222763158,6,0,0,37376,12,6116474047
15104,125557260,97296108,222853368,8,0,0,39936,11,333180437
15105,125559860,95060361,220620221,3,0,0,25600,18,4701137154
15106,125566670,96096562,221663232,8,0,0,13312,11,6638035683
15107,125571460,95241042,220812502,6,0,0,9216,12,3264478710
15108,125579930,95971174,221551104,4,0,0,22528,7,1230203170
15109,125581560,95224562,220806122,3,0,0,15872,18,897241869
15110,125609550,95139999,220749549,5,0,0,11776,12,4863971892
15111,125611280,127019783,252631063,4,0,1,7168,7,10156757244
15112,125612951,127135157,252748108,9,0,1,34816,4,1126180713
15113,125623830,97544750,223168580,3,0,0,13312,18,9798304275
15114,125639110,95114830,220753940,7,0,0,14336,1,5168105843
15115,125641991,127163741,252805732,9,0,1,4608,4,7865429267
15116,125654820,95984943,221639763,6,0,0,49152,12,10646808489
15117,125658490,96108800,221767290,1,0,0,199680,1,9671268074
15118,125674331,127131424,252805755,9,0,1,2048,4,9317390295
15119,125680550,127125236,252805786,8,0,1,4608,11,1757279494
15120,125684900,95974253,221659153,0,0,0,36352,6,3537419747
15121,125688180,95265788,220953968,0,0,0,6144,6,1499326471
15122,125711280,97953575,223664855,7,0,0,53248,1,9486843334
15123,125719770,97043879,222763649,6,0,0,1536,12,10671514223
15124,125725190,96300284,222025474,5,0,0,196096,12,7937651401
15125,125736390,96041194,221777584,8,0,0,8192,11,1550712372
15126,125744310,97616767,223361077,3,0,0,77312,18,4072545216
15127,125786180,96009055,221795235,7,0,0,57856,1,3550754951
15128,125786190,95281864,221068054,5,0,0,36352,12,3459705139
15129,125800360,97932608,223732968,5,0,0,19968,12,9235611118
15130,125811730,94946445,220758175,6,0,0,13824,12,3497997713
15131,125813820,94932118,220745938,9,0,0,4096,4,8815793806
15132,125816150,127073531,252889681,0,0,1,26624,6,4620545289
15133,125823640,95273615,221097255,2,0,0,24064,1,5151265466
15134,125835770,96278503,222114273,3,0,0,38912,18,10487761128
15135,125836820,95777446,221614266,1,0,0,18432,1,8057688645
15136,125837659,127056717,252894376,5,0,1,6144,12,9757334382
15137,125844300,95834898,221679198,3,0,0,20480,18,1903884599
15138,125849530,95839542,221689072,4,0,0,32256,7,6740425108
15139,125858960,127062911,252921871,8,0,1,12288,11,9542868624
15140,125865180,127157476,253022656,0,0,1,3072,6,10721740020
15141,125871400,98062334,223933734,5,0,0,50688,12,4644338616
15142,125871970,97980500,223852470,0,0,0,58880,6,2615819950
15143,125876970,95747771,221624741,3,0,0,34304,18,5767258624
15144,125880359,127180576,253060935,5,0,1,40448,12,3145244039
15145,125885470,98155894,224041364,7,0,0,187904,1,3979402846
15146,125888040,127188564,253076604,1,0,1,9216,1,4517930190
15147,125888090,96183629,222071719,8,0,0,11776,11,1308481743
15148,125888510,95976487,221864997,4,0,0,75776,7,5518641849
15149,125897840,96170268,222068108,3,0,0,16896,18,4968502044
15150,125921160,97151847,223073007,8,0,0,21504,11,10641926744
15151,125930181,127223569,253153750,9,0,1,32768,4,2424963421
15152,125936710,95832209,221768919,3,0,0,5120,18,10727829342
15153,125937930,127264000,253201930,7,0,1,12288,1,4399927760
15154,125939430,127263806,253203236,8,0,1,2048,11,3653517976
15155,125940050,95931678,221871728,8,0,0,22016,11,8813417098
15156,125947570,96362462,222310032,4,0,0,15872,7,10403963114
15157,125965420,96151649,222117069,2,0,0,3584,1,5177102045
15158,125966870,97257927,223224797,4,0,0,17408,7,3858907715
15159,125973560,127236401,253209961,1,0,1,6656,1,2577090937
15160,125982070,96465851,222447921,8,0,0,119296,11,2722551145
15161,125987240,96075697,222062937,0,0,0,122880,6,856945254
15162,125991350,127231661,253223011,8,0,1,18944,11,1439982569
15163,125993890,98119638,224113528,8,0,0,75264,11,5034126345
15164,126000670,96613627,222614297,0,0,0,71680,6,3722290512
15165,126005380,96577960,222583340,3,0,0,82944,18,7335349582
15166,126006880,95699547,221706427,2,0,0,56832,1,2060690533
15167,126044950,127234133,253279083,4,0,1,59392,7,813185056
15168,126056150,96466173,222522323,4,0,0,23040,7,10555440676
15169,126061490,127315213,253376703,4,0,1,16384,7,4496946144
15170,126123150,96402160,222525310,3,0,0,9728,18,5405498056
15171,126125710,127253899,253379609,7,0,1,4608,1,8190776808
15172,126131361,127253049,253384410,9,0,1,4608,4,5038432667
15173,126137580,96031120,222168700,7,0,0,77312,1,4482674754
15174,126141090,96368497,222509587,5,0,0,41984,12,4132957775
15175,126144030,95950176,222094206,2,0,0,73728,1,8138573846
15176,126146460,96350312,222496772,5,0,0,160256,12,4037673294
15177,126155350,96437084,222592434,7,0,0,29696,1,6149655536
15178,126177540,127296199,253473739,6,0,1,19456,12,9953210955
15179,126181990,97214568,223396558,2,0,0,38400,1,6614116449
15180,126182770,95614368,221797138,0,0,0,6144,6,116902292
15181,126200340,95742840,221943180,8,0,0,7168,11,4827656590
15182,126210380,127323581,253533961,1,0,1,4096,1,9833188721
15183,126214280,95880885,222095165,4,0,0,3072,7,10345791314
15184,126228990,96326068,222555058,5,0,0,16384,12,4538986997
15185,126234800,127398278,253633078,8,0,1,18944,11,9304515938
15186,126235030,96571330,222806360,5,0,0,59904,12,5429832798
15187,126245450,95635143,221880593,0,0,0,7168,6,10203122755
15188,126248630,96438313,222686943,7,0,0,24064,1,8358073548
15189,126254130,97887711,224141841,5,0,0,60416,12,10325381909
15190,126266400,96764222,223030622,6,0,0,1024,12,8042878255
15191,126269160,97485983,223755143,3,0,0,72704,18,997931325
15192,126274060,127381769,253655829,0,0,1,9216,6,3192504291
15193,126274760,96396974,222671734,0,0,0,27136,6,4957720620
15194,126274870,95895101,222169971,7,0,0,4096,1,2005799004
15195,126287590,97361010,223648600,4,0,0,498688,7,2112364327
15196,126292710,127436110,253728820,4,0,1,30208,7,2212333345
15197,126294260,96103140,222397400,9,0,0,7680,4,8047492501
15198,126299310,127469909,253769219,7,0,1,2560,1,1773520507
15199,126308740,97944009,224252749,7,0,0,113152,1,7489249496
15200,126312720,96202560,222515280,1,0,0,4608,1,6358688999
15201,126313180,95585693,221898873,0,0,0,512,6,6235625929
15202,126325090,96581009,222906099,1,0,0,81408,1,7506623313
15203,126337170,98326425,224663595,5,0,0,174592,12,1706220008
15204,126337970,97521472,223859442,7,0,0,8704,1,9145067877
15205,126362460,95838047,222200507,6,0,0,3072,12,9127501068
15206,126362930,127406312,253769242,8,0,1,2048,11,8605224469
15207,126382540,96312413,222694953,0,0,0,26112,6,549349933
15208,126387820,96678612,223066432,4,0,0,39424,7,5484217780
15209,126389420,96995415,223384835,5,0,0,33280,12,1828783781
15210,126396110,95975960,222372070,9,0,0,30720,4,8908123011
15211,126401309,127413989,253815298,5,0,1,10240,12,7983004073
15212,126406150,96764325,223170475,7,0,0,6144,1,2943585525
15213,126407560,96248060,222655620,8,0,0,24576,11,459899781
15214,126410790,96268798,222679588,0,0,0,8192,6,3312155490
15215,126422340,96526500,222948840,0,0,0,22016,6,10156123776
15216,126423540,98267407,224690947,8,0,0,30208,11,5615470537
15217,126427640,96086213,222513853,1,0,0,10240,1,7051640810
15218,126428210,96101803,222530013,5,0,0,15360,12,3690949590
15219,126441130,96116915,222558045,7,0,0,9728,1,5435129379
15220,126446540,96303954,222750494,8,0,0,109568,11,9495746279
15221,126450970,97256767,223707737,9,0,0,28160,4,1079950983
15222,126462510,127372036,253834546,6,0,1,4096,12,2269483882
15223,126463530,97235604,223699134,9,0,0,86016,4,9326941315
15224,126469790,127513774,253983564,8,0,1,30208,11,4919677540
15225,126471280,97305258,223776538,8,0,0,70144,11,9961863323
15226,126479820,96328435,222808255,9,0,0,6144,4,3825235095
15227,126486810,97496944,223983754,5,0,0,50688,12,96661780
15228,126491050,96610548,223101598,5,0,0,33792,12,6246619440
15229,126499870,127840327,254340197,0,0,1,50176,6,1091174458
15230,126505700,96827276,223332976,6,0,0,6656,12,7409681727
15231,126507750,96329604,222837354,6,0,0,31744,12,2379838733
15232,126522540,96027495,222550035,7,0,0,1536,1,1876787162
15233,126524661,127909435,254434096,9,0,1,24576,4,705907859
15234,126527610,96636891,223164501,9,0,0,10752,4,6928133589
15235,126549650,96480637,223030287,1,0,0,11264,1,6055184172
15236,126554020,96407405,222961425,7,0,0,8192,1,950961197
15237,126566900,127953809,254520709,7,0,1,3072,1,1174653719
15238,126572580,97303889,223876469,4,0,0,55808,7,583965835
15239,126577960,96330970,222908930,7,0,0,9216,1,4313232940
15240,126593110,96180662,222773772,6,0,0,512,12,3086811153
15241,126593870,127926862,254520732,0,0,1,7680,6,1322288465
15242,126596310,96900323,223496633,9,0,0,29184,4,7682478371
15243,126609260,96819615,223428875,9,0,0,30720,4,9311668078
15244,126626050,96748622,223374672,1,0,0,44544,1,7255400126
15245,126626540,96534662,223161202,4,0,0,68096,7,4608672010
15246,126640080,127880675,254520755,6,0,1,11776,12,10278512888
15247,126643660,96583500,223227160,9,0,0,7680,4,9381980985
15248,126654990,96675935,223330925,6,0,0,48128,12,4415131948
15249,126655190,127960423,254615613,1,0,1,17408,1,7429938530
15250,126659770,128018356,254678126,0,0,1,38400,6,5096054956
15251,126666260,98091869,224758129,5,0,0,2560,12,3178677017
15252,126670520,128161851,254832371,0,0,1,44544,6,154550244
15253,126671290,97623157,224294447,2,0,0,2048,1,9051988345
15254,126687900,97605900,224293800,7,0,0,134656,1,3756942730
15255,126690180,96977974,223668154,6,0,0,10752,12,3886105707
15256,126704740,97443208,224147948,5,0,0,19968,12,2268039684
15257,126713760,128231770,254945530,1,0,1,16896,1,7898892402
15258,126731480,97232853,223964333,5,0,0,100352,12,6871985778
15259,126737710,97349408,224087118,3,0,0,73728,18,313099454
15260,126737890,97051307,223789197,3,0,0,41472,18,109030043
15261,126756830,97077677,223834507,2,0,0,95232,1,3507981370
15262,126761501,128280371,255041872,9,0,1,18944,4,4945572201
15263,126762110,96467518,223229628,7,0,0,5120,1,4457676365
15264,126762790,96552788,223315578,6,0,0,52736,12,10388515117
15265,126776540,98161715,224938255,7,0,0,83456,1,445287846
15266,126796940,96924392,223721332,4,0,0,44544,7,10728010531
15267,126804280,96207486,223011766,8,0,0,6144,11,6053419879
15268,126815750,96621321,223437071,5,0,0,24576,12,7026704881
15269,126820940,128220955,255041895,8,0,1,1536,11,8282389726
15270,126827340,96617710,223445050,3,0,0,26112,18,10003641609
15271,126836870,97062802,223899672,5,0,0,47104,12,1991721618
15272,126837720,96607509,223445229,6,0,0,512,12,6291390549
15273,126849950,96822953,223672903,6,0,0,1024,12,7388206857
15274,126858130,97232443,224090573,4,0,0,11264,7,1634794338
15275,126861710,96538329,223400039,7,0,0,6656,1,8860630641
15276,126862940,97021196,223884136,5,0,0,25088,12,1834526283
15277,126868240,96804328,223672568,9,0,0,10752,4,975660663
15278,126894390,96832136,223726526,6,0,0,11264,12,9956100996
15279,126894900,97497924,224392824,3,0,0,61952,18,495304885
15280,126901140,97447646,224348786,1,0,0,94720,1,177801040
15281,126910800,97568203,224479003,5,0,0,2048,12,3245265514
15282,126917890,97000377,223918267,3,0,0,60928,18,7609770431
15283,126918210,97503216,224421426,4,0,0,89088,7,10561633822
15284,126929170,128126811,255055981,7,0,1,7680,1,4498524766
15285,126940790,128166063,255106853,8,0,1,2560,11,8936202761
15286,126962640,98075017,225037657,5,0,0,15360,12,11305475
15287,126963560,129794429,256757989,4,0,1,403968,7,5070958735
15288,126978020,96878685,223856705,4,0,0,13824,7,10223563923
15289,127008390,97056241,224064631,1,0,0,76288,1,7402507601
15290,127010590,96794854,223805444,4,0,0,53248,7,3170514575
15291,127013040,129744972,256758012,2,0,1,5120,1,788058902
15292,127031990,96637279,223669269,5,0,0,3584,12,9308973536
15293,127046680,96921599,223968279,3,0,0,12800,18,8380646076
15294,127048640,130189090,257237730,4,0,1,286208,7,10089423927
15295,127050070,97115240,224165310,6,0,0,50176,12,4340838462
15296,127064749,130243570,257308319,5,0,1,512,12,2605084057
15297,127075700,97047710,224123410,3,0,0,11776,18,1462250235
15298,127079100,96647761,223726861,5,0,0,1024,12,5152636223
15299,127083050,97085715,224168765,6,0,0,11264,12,2303868731
15300,127112780,97343838,224456618,1,0,0,76288,1,9636076395
15301,127126010,96759241,223885251,5,0,0,3584,12,4055741572
15302,127126271,130182071,257308342,9,0,1,13824,4,7988992538
15303,127138120,96584951,223723071,2,0,0,5632,1,6039182641
15304,127138760,130415550,257554310,4,0,1,101888,7,7878951851
15305,127146690,97227235,224373925,4,0,0,82432,7,3809437896
15306,127149890,96834199,223984089,7,0,0,1024,1,1743902956
15307,127160790,130422159,257582949,7,0,1,3584,1,3973035910
15308,127169430,130453844,257623274,8,0,1,15360,11,335598924
15309,127170790,97597210,224768000,3,0,0,15360,18,7807021159
15310,127188480,130434817,257623297,8,0,1,16384,11,9370281095
15311,127202710,97103483,224306193,7,0,0,23040,1,4389570704
15312,127203440,96965660,224169100,3,0,0,1024,18,7846360012
15313,127209449,130413871,257623320,5,0,1,4608,12,1472798270
15314,127210810,96972665,224183475,8,0,0,47104,11,5718802323
15315,127210970,97004375,224215345,8,0,0,23040,11,6735980994
15316,127226519,130475815,257702334,5,0,1,64000,12,5861552798
15317,127227260,96981042,224208302,4,0,0,81408,7,5002651129
15318,127229350,96890449,224119799,6,0,0,20480,12,6712545119
15319,127267559,130451222,257718781,5,0,1,22016,12,6143299504
15320,127295320,97575792,224871112,8,0,0,37376,11,7276153973
15321,127309060,97702280,225011340,8,0,0,57856,11,3413605898
15322,127330380,97663301,224993681,8,0,0,104448,11,10623861925
15323,127332620,97176681,224509301,2,0,0,1536,1,4453241329
15324,127334980,97248117,224583097,9,0,0,6656,4,10314118788
15325,127339890,96810109,224149999,3,0,0,6656,18,9943376795
15326,127343310,131099199,258442509,0,0,1,421376,6,8760547366
15327,127347170,97263206,224610376,4,0,0,1536,7,6162095804
15328,127353960,97355597,224709557,8,0,0,58880,11,8101179280
15329,127360420,98078019,225438439,9,0,0,411136,4,9863692165
15330,127375350,97103006,224478356,1,0,0,39936,1,8202285092
15331,127381380,97478321,224859701,7,0,0,66048,1,3253072132
15332,127386510,96912640,224299150,9,0,0,15360,4,3346898933
15333,127387390,97856484,225243874,1,0,0,35328,1,1082777077
15334,127390740,97040092,224430832,8,0,0,27648,11,3072725470
15335,127412910,97020441,224433351,7,0,0,8192,1,6970196173
15336,127414210,131028322,258442532,6,0,1,5632,12,2508381417
15337,127415040,97705927,225120967,9,0,0,20992,4,10465990858
15338,127416440,96977811,224394251,1,0,0,4608,1,2714008237
15339,127419240,97161806,224581046,5,0,0,17920,12,9629409102
15340,127429100,98095385,225524485,9,0,0,5120,4,7336841489
15341,127434840,97375482,224810322,8,0,0,57856,11,843438908
15342,127453590,97110815,224564405,2,0,0,26112,1,6862622665
15343,127469920,96952465,224422385,9,0,0,3072,4,4342431565
15344,127483380,97251888,224735268,5,0,0,19968,12,3193459152
15345,127500450,97163792,224664242,4,0,0,2048,7,5795166016
15346,127509370,97383784,224893154,4,0,0,35840,7,5997130101
15347,127526060,97940083,225466143,6,0,0,9728,12,9557931508
15348,127540730,97477809,225018539,6,0,0,23552,12,6544100141
15349,127559810,97685187,225244997,9,0,0,3584,4,10050372215
15350,127561300,97465732,225027032,5,0,0,2048,12,7903426255
15351,127588570,96964924,224553494,7,0,0,38400,1,4235696202
15352,127589190,96999037,224588227,8,0,0,2048,11,397647753
15353,127597630,97715518,225313148,8,0,0,33280,11,5917007317
15354,127599010,96859971,224458981,7,0,0,7680,1,5029945311
15355,127602700,97865494,225468194,8,0,0,6656,11,3950792945
15356,127603220,130846816,258450036,7,0,1,29184,1,888442057
15357,127615720,97346114,224961834,2,0,0,77312,1,8852444188
15358,127619580,98117028,225736608,2,0,0,13824,1,790727155
15359,127624060,97832810,225456870,4,0,0,60416,7,5892221817
15360,127630220,96979665,224609885,4,0,0,53760,7,9973883558
15361,127641050,98005526,225646576,4,0,0,60416,7,4592272322
15362,127649590,97442585,225092175,1,0,0,18944,1,6149176071
15363,127657670,130910727,258568397,4,0,1,111616,7,6456305986
15364,127658340,97368045,225026385,2,0,0,9216,1,5423824617
15365,127670040,98476195,226146235,6,0,0,43520,12,7961395423
15366,127673480,97888369,225561849,4,0,0,110080,7,3465230507
15367,127674220,97558867,225233087,7,0,0,7680,1,5792435827
15368,127685600,97510428,225196028,9,0,0,53760,4,1056772140
15369,127722010,97160201,224882211,6,0,0,36352,12,4437547685
15370,127726840,98634162,226361002,5,0,0,12800,12,87014906
15371,127731170,97298537,225029707,7,0,0,8704,1,2286477160
15372,127734690,98596572,226331262,7,0,0,32768,1,3078442733
15373,127759310,130847918,258607228,6,0,1,28160,12,6296871405
15374,127764060,96927534,224691594,9,0,0,2048,4,9760291590
15375,127768380,97318000,225086380,2,0,0,61440,1,423450244
15376,127777670,97245884,225023554,2,0,0,16384,1,10409314445
15377,127779460,130828229,258607689,2,0,1,10240,1,9463330170
15378,127779850,97377031,225156881,5,0,0,10752,12,7826622824
15379,127786280,130826146,258612426,2,0,1,18432,1,4150480082
15380,127793070,97500617,225293687,3,0,0,25088,18,8527483482
15381,127794740,97104416,224899156,5,0,0,13824,12,2631156102
15382,127796900,97261822,225058722,2,0,0,16896,1,2959092754
15383,127798070,97697002,225495072,2,0,0,65024,1,5693087484
15384,127805260,130809440,258614700,7,0,1,9728,1,506825274
15385,127818810,97360815,225179625,6,0,0,49664,12,2888350670
15386,127821690,97653547,225475237,3,0,0,23040,18,2019427609
15387,127836120,130778926,258615046,1,0,1,512,1,9591725243
15388,127853690,97285099,225138789,2,0,0,10240,1,10221840539
15389,127856580,97646479,225503059,4,0,0,26112,7,1878303794
15390,127857720,97804838,225662558,3,0,0,18432,18,7355172946
15391,127866350,97742382,225608732,4,0,0,44544,7,5638051633
15392,127887240,97312867,225200107,9,0,0,13312,4,9980062560
15393,127888940,97163258,225052198,7,0,0,24064,1,5392387466
15394,127894660,97403106,225297766,3,0,0,13312,18,6060044965
15395,127899190,130744603,258643793,1,0,1,51712,1,4601800185
15396,127911800,97551356,225463156,1,0,0,15360,1,5845396215
15397,127913670,130760904,258674574,6,0,1,19456,12,7559398396
15398,127921410,98042222,225963632,6,0,0,65536,12,8499061095
15399,127923790,130818572,258742362,7,0,1,12288,1,6952046749
15400,127931230,97696915,225628145,4,0,0,7168,7,1003668478
15401,127932339,130878180,258810519,5,0,1,16384,12,3197228647
15402,127939480,97755257,225694737,5,0,0,26624,12,2574426288
15403,127940890,98599401,226540291,3,0,0,83968,18,9659313525
15404,127941350,131271208,259212558,0,0,1,288256,6,6772983506
15405,127981880,131237203,259219083,7,0,1,7680,1,270590518
15406,127984280,98564770,226549050,2,0,0,28672,1,622826954
15407,127989090,97469363,225458453,7,0,0,5120,1,4287318155
15408,127999940,97675182,225675122,2,0,0,7168,1,6245845156
15409,128009920,131219816,259229736,6,0,1,25088,12,5112160661
15410,128016410,97565513,225581923,3,0,0,1024,18,4908587949
15411,128030060,97492834,225522894,5,0,0,65024,12,3205275042
15412,128033200,97675444,225708644,5,0,0,45568,12,563756650
15413,128046800,97579138,225625938,1,0,0,56320,1,4290552488
15414,128047409,131227538,259274947,5,0,1,1536,12,6857077640
15415,128063500,131215313,259278813,0,0,1,6144,6,96805602
15416,128072690,131212882,259285572,0,0,1,23040,6,1845533652
15417,128076550,131212248,259288798,2,0,1,5120,1,3436535923
15418,128077500,97642777,225720277,4,0,0,6144,7,4953708479
15419,128083800,131208250,259292050,6,0,1,15360,12,5719675862
15420,128083860,131213042,259296902,8,0,1,7680,11,3798872985
15421,128083910,97892313,225976223,7,0,0,8192,1,6146369747
15422,128093330,97707048,225800378,3,0,0,45056,18,3659354151
15423,128100250,98712905,226813155,3,0,0,21504,18,7920025866
15424,128123130,131186153,259309283,8,0,1,11264,11,8049405909
15425,128131950,97899156,226031106,6,0,0,49664,12,699896373
15426,128143530,97702578,225846108,8,0,0,43520,11,7574859555
15427,128148540,97517184,225665724,9,0,0,10240,4,8585974556
15428,128154990,97434107,225589097,2,0,0,5120,1,335058209
15429,128155480,131153826,259309306,6,0,1,5632,12,470039222
15430,128160140,98591352,226751492,9,0,0,161792,4,709997802
15431,128175380,98427602,226602982,1,0,0,33792,1,9982816781
15432,128198899,131110430,259309329,5,0,1,3072,12,8216984803
15433,128199630,97800534,226000164,7,0,0,12288,1,2031724809
15434,128209890,97574502,225784392,9,0,0,2048,4,2900674064
15435,128212450,97651635,225864085,2,0,0,32256,1,3682956937
15436,128217140,131100791,259317931,7,0,1,19456,1,6282332022
15437,128219390,97931672,226151062,5,0,0,11776,12,3600672762
15438,128220110,97656318,225876428,1,0,0,4096,1,10210431653
15439,128222140,98121945,226344085,7,0,0,41984,1,2045778046
15440,128226260,98130819,226357079,7,0,0,5120,1,2704669501
15441,128243410,97646038,225889448,3,0,0,20480,18,6267385735
15442,128256550,98026283,226282833,9,0,0,6656,4,8870993845
15443,128258051,131155144,259413195,9,0,1,10752,4,4266348866
15444,128274930,98132856,226407786,5,0,0,128512,12,4335169201
15445,128276970,98155666,226432636,3,0,0,53760,18,5515354200
15446,128280690,97926464,226207154,4,0,0,11264,7,690535286
15447,128281090,97999692,226280782,1,0,0,41984,1,3844323317
15448,128281280,98671290,226952570,9,0,0,173568,4,4248486684
15449,128288530,131126191,259414721,0,0,1,2048,6,8359873366
15450,128295790,98551070,226846860,5,0,0,9216,12,6503813608
15451,128308490,98206194,226514684,5,0,0,31232,12,9485748815
15452,128314820,131148903,259463723,6,0,1,51200,12,6000201432
15453,128316110,98348106,226664216,9,0,0,51712,4,9147536927
15454,128346601,131122676,259469277,9,0,1,25088,4,2294788092
15455,128355410,98412017,226767427,4,0,0,52224,7,4342618262
15456,128359650,97957370,226317020,9,0,0,112128,4,10666465567
15457,128361640,97906327,226267967,5,0,0,21504,12,9204497218
15458,128362080,98667518,227029598,3,0,0,64000,18,10392683206
15459,128368500,98619886,226988386,4,0,0,7680,7,3366327292
15460,128374480,131123412,259497892,8,0,1,7680,11,5016855814
15461,128389311,131130117,259519428,9,0,1,4096,4,9423202036
15462,128394020,98384818,226778838,5,0,0,37376,12,4097835880
15463,128413330,98058955,226472285,2,0,0,53248,1,4542779280
15464,128414660,98249891,226664551,9,0,0,1024,4,10108517988
15465,128417510,97998723,226416233,6,0,0,27648,12,10073296270
15466,128433550,98692498,227126048,1,0,0,20480,1,10407139288
15467,128440420,97915076,226355496,1,0,0,37376,1,1476467647
15468,128448260,97872995,226321255,6,0,0,13824,12,9917496390
15469,128452820,131107396,259560216,6,0,1,32256,12,10088308353
15470,128453891,131107605,259561496,9,0,1,14336,4,4879644693
15471,128455110,98043741,226498851,1,0,0,87040,1,10441332788
15472,128457030,98043560,226500590,4,0,0,5632,7,5099893401
15473,128506380,98064268,226570648,8,0,0,5120,11,7371968455
15474,128512780,97992365,226505145,7,0,0,14848,1,7689268162
15475,128519060,98034225,226553285,3,0,0,13824,18,8520132406
15476,128522730,98037130,226559860,4,0,0,21504,7,1076982061
15477,128531540,98050207,226581747,7,0,0,36352,1,5430785420
15478,128533640,98626283,227159923,8,0,0,111104,11,3162514006
15479,128542560,131024845,259567405,0,0,1,1024,6,649138937
15480,128558420,98133102,226691522,1,0,0,74752,1,3238285639
15481,128577890,98482660,227060550,7,0,0,21504,1,6061980972
15482,128583390,98305443,226888833,2,0,0,23040,1,3467883654
15483,128586130,98369739,226955869,6,0,0,10752,12,2951887710
15484,128586890,98216501,226803391,5,0,0,37888,12,5285497250
15485,128587000,98404373,226991373,6,0,0,9728,12,7991481647
15486,128604770,98380606,226985376,5,0,0,96768,12,2326930946
15487,128632031,130963760,259595791,9,0,1,12800,4,9233540006
15488,128664020,97977786,226641806,2,0,0,6656,1,4475720322
15489,128676030,98130550,226806580,8,0,0,10240,11,8483168386
15490,128682000,130920307,259602307,6,0,1,23040,12,10036826023
15491,128691150,98543745,227234895,6,0,0,35840,12,255883713
15492,128695120,98120398,226815518,9,0,0,7680,4,1312568261
15493,128707360,98326473,227033833,2,0,0,13824,1,5328685445
15494,128711070,98711253,227422323,4,0,0,28672,7,1395218891
15495,128716090,131236418,259952508,4,0,1,90112,7,4232824736
15496,128723950,98442080,227166030,8,0,0,19968,11,6601360430
15497,128726030,98590204,227316234,9,0,0,44032,4,10688085640
15498,128726110,98489863,227215973,2,0,0,16896,1,2264156144
15499,128739570,98349543,227089113,8,0,0,72704,11,4674103947
15500,128744780,98552550,227297330,9,0,0,22016,4,6292232203
15501,128756390,98035434,226791824,3,0,0,34816,18,818710168
15502,128756660,98229363,226986023,6,0,0,2048,12,420655388
15503,128773841,131211262,259985103,9,0,1,10240,4,6281239885
15504,128775690,98692738,227468428,5,0,0,21504,12,8857781856
15505,128776210,98218940,226995150,6,0,0,4096,12,1518753933
15506,128776460,98259135,227035595,7,0,0,512,1,6061286776
15507,128790720,131194406,259985126,0,0,1,2048,6,8624637899
15508,128793580,98541602,227335182,3,0,0,38400,18,9876664879
15509,128808130,98311655,227119785,7,0,0,43008,1,5232113276
15510,128824310,98690045,227514355,2,0,0,146432,1,8469466161
15511,128838740,98682860,227521600,8,0,0,23552,11,1954922914
15512,128838800,98171275,227010075,8,0,0,26624,11,1661195933
15513,128845370,98250006,227095376,6,0,0,20480,12,1027090016
15514,128864100,98171316,227035416,4,0,0,5120,7,8509836643
15515,128866350,98970572,227836922,3,0,0,52224,18,2289290988
15516,128872710,131112439,259985149,0,0,1,2048,6,4183285793
15517,128874070,131218144,260092214,2,0,1,33792,1,4548698546
15518,128890400,131224293,260114693,8,0,1,4096,11,4024057067
15519,128897360,99044870,227942230,8,0,0,46080,11,2966908744
15520,128902990,98698159,227601149,6,0,0,3584,12,6984027296
15521,128906130,98539078,227445208,5,0,0,15872,12,910786940
15522,128927310,98749831,227677141,8,0,0,85504,11,1612657452
15523,128928570,99335927,228264497,8,0,0,390656,11,2488653034
15524,128929950,98854229,227784179,4,0,0,48640,7,6211292305
15525,128934280,131203228,260137508,0,0,1,2048,6,8392854722
15526,128937140,98627887,227565027,9,0,0,5632,4,9065685341
15527,128946450,99360704,228307154,2,0,0,12800,1,1739044425
15528,128964160,98597233,227561393,5,0,0,56832,12,314264385
15529,128964551,131172980,260137531,9,0,1,6656,4,10334739568
15530,128971290,98555862,227527152,2,0,0,512,1,10094075354
15531,128986420,98471428,227457848,3,0,0,17920,18,5953997514
15532,128989110,98537863,227526973,2,0,0,14848,1,3828871386
15533,128991690,98814950,227806640,5,0,0,13824,12,8885841088
15534,128992040,131145514,260137554,1,0,1,5120,1,6352183338
15535,128994990,98527413,227522403,5,0,0,2560,12,5713338678
15536,128999330,98846195,227845525,6,0,0,28160,12,10469580927
15537,129016050,131121527,260137577,0,0,1,512,6,8415686659
15538,129018540,98518102,227536642,3,0,0,4608,18,1369107557
15539,129031480,98408383,227439863,6,0,0,51200,12,10073770239
15540,129036440,98884360,227920800,3,0,0,8192,18,116772449
15541,129041300,98678358,227719658,4,0,0,11776,7,4858048472
15542,129048200,98922825,227971025,7,0,0,35328,1,1643172211
15543,129071320,98491968,227563288,5,0,0,6144,12,3561653985
15544,129072140,98642670,227714810,9,0,0,26112,4,6217928668
15545,129080850,98603682,227684532,3,0,0,3072,18,414375909
15546,129089770,131075016,260164786,6,0,1,16384,12,10027332373
15547,129092110,98728877,227820987,8,0,0,40448,11,7376802520
15548,129093140,131073912,260167052,0,0,1,3584,6,6929871329
15549,129112761,131086296,260199057,9,0,1,1024,4,4759508046
15550,129124150,98915686,228039836,6,0,0,71168,12,9175563945
15551,129126820,99243325,228370145,2,0,0,39424,1,3879589614
15552,129132040,98629852,227761892,9,0,0,3072,4,5656250814
15553,129144700,131452550,260597250,4,0,1,140800,7,9760191552
15554,129160800,99197310,228358110,1,0,0,57856,1,8090893106
15555,129162820,98623722,227786542,6,0,0,7680,12,2192650170
15556,129171830,99225945,228397775,5,0,0,11264,12,4301157785
15557,129178580,98911875,228090455,3,0,0,78336,18,3672089079
15558,129200900,98678666,227879566,4,0,0,32256,7,9268996903
15559,129205340,99246659,228451999,7,0,0,36864,1,4373017951
15560,129220240,99220458,228440698,4,0,0,140800,7,1823444599
15561,129222600,99058300,228280900,2,0,0,53760,1,8138655432
15562,129248080,99232099,228480179,8,0,0,92160,11,9171374479
15563,129254220,99126134,228380354,9,0,0,19968,4,2030650037
15564,129258510,98635444,227893954,7,0,0,3584,1,4576908113
15565,129260200,99043031,228303231,8,0,0,73216,11,3860251280
15566,129267940,98642206,227910146,6,0,0,34816,12,3594510731
15567,129272740,98645541,227918281,1,0,0,26624,1,2866861427
15568,129273320,98704436,227977756,7,0,0,22016,1,8674237329
15569,129276850,98784363,228061213,7,0,0,5632,1,3881094011
15570,129302090,98696804,227998894,7,0,0,62464,1,447083457
15571,129302260,99427239,228729499,0,0,0,217088,6,8989132068
15572,129307750,99297817,228605567,9,0,0,37888,4,99868192
15573,129309260,99243262,228552522,7,0,0,88576,1,10674819935
15574,129312120,99194518,228506638,8,0,0,36352,11,8458410352
15575,129314840,99025611,228340451,3,0,0,17920,18,4142401015
15576,129316430,99241910,228558340,2,0,0,17920,1,314129338
15577,129344530,131367649,260712179,0,0,1,8192,6,5157854847
15578,129344810,98760210,228105020,8,0,0,17920,11,5740617395
15579,129345980,99413274,228759254,7,0,0,8704,1,282993023
15580,129351780,99460717,228812497,9,0,0,90112,4,356269553
15581,129377700,98957245,228334945,3,0,0,91136,18,4848477808
15582,129389990,99204010,228594000,8,0,0,16896,11,1536250567
15583,129399770,131312973,260712743,0,0,1,10752,6,4308428797
15584,129408271,131366804,260775075,9,0,1,10240,4,7290743298
15585,129441700,98944925,228386625,9,0,0,20480,4,215971080
15586,129442920,99109937,228552857,1,0,0,1024,1,3307721417
15587,129445270,131329828,260775098,0,0,1,5120,6,10225030181
15588,129448020,99315469,228763489,7,0,0,13824,1,14361006
15589,129454640,131460814,260915454,0,0,1,48640,6,6144824042
15590,129458790,132203582,261662372,4,0,1,253952,7,9203133991
15591,129460440,132230492,261690932,1,0,1,3584,1,6884668126
15592,129463980,99300780,228764760,6,0,0,4096,12,10295602064
15593,129470590,99517736,228988326,3,0,0,34304,18,2926913242
15594,129472700,99402266,228874966,9,0,0,43520,4,8737519071
15595,129481430,99272942,228754372,7,0,0,52736,1,9664581261
15596,129486990,98887234,228374224,2,0,0,13312,1,620533778
15597,129509480,99258735,228768215,7,0,0,11264,1,10724979538
15598,129521100,132267113,261788213,4,0,1,7168,7,6991025590
15599,129545030,99211549,228756579,5,0,0,7168,12,8528473349
15600,129547050,99314633,228861683,5,0,0,22528,12,7852972215
15601,129553040,132245447,261798487,1,0,1,8192,1,6172786403
15602,129560860,99344820,228905680,8,0,0,11776,11,7703708037
15603,129563820,99174126,228737946,9,0,0,27648,4,3512103903
15604,129575300,132229293,261804593,6,0,1,20992,12,460505941
15605,129575930,99448034,229023964,3,0,0,26624,18,2584427133
15606,129575950,99565549,229141499,5,0,0,15360,12,10434105000
15607,129591600,99304253,228895853,6,0,0,26624,12,115830043
15608,129607490,99386966,228994456,2,0,0,19968,1,5904374452
15609,129643170,99538173,229181343,4,0,0,26112,7,5736702579
15610,129661500,132162047,261823547,2,0,1,9216,1,5850103145
15611,129680500,99456296,229136796,8,0,0,182784,11,5501833226
15612,129680540,99057741,228738281,8,0,0,1024,11,9543747694
15613,129691500,99084621,228776121,4,0,0,512,7,4988549986
15614,129704760,132182674,261887434,0,0,1,15360,6,8076878637
15615,129717560,99298269,229015829,2,0,0,19968,1,39956242
15616,129726690,99211641,228938331,9,0,0,19456,4,1285308753
15617,129732839,132237669,261970508,5,0,1,17408,12,655349866
15618,129739450,99426012,229165462,1,0,0,19456,1,8107855225
15619,129741630,99208447,228950077,5,0,0,16896,12,10416789636
15620,129746140,99313122,229059262,5,0,0,512,12,8294011793
15621,129756110,99572541,229328651,2,0,0,72704,1,1889210425
15622,129772330,132198201,261970531,4,0,1,512,7,6005550669
15623,129795360,99149546,228944906,8,0,0,21504,11,7162063809
15624,129795420,99059376,228854796,7,0,0,86528,1,7634278168
15625,129811270,132185055,261996325,1,0,1,9728,1,387614360
15626,129819320,132177028,261996348,2,0,1,16896,1,1520217892
15627,129822380,99811909,229634289,6,0,0,16896,12,8969707628
15628,129829710,99358345,229188055,2,0,0,18944,1,4639811265
15629,129840420,99458794,229299214,2,0,0,24576,1,1817615961
15630,129844590,99327010,229171600,7,0,0,5120,1,821186182
15631,129856920,99970361,229827281,2,0,0,20480,1,8116140089
15632,129863350,132133021,261996371,2,0,1,3584,1,8192025582
15633,129872330,99414022,229286352,3,0,0,20992,18,10341319913
15634,129881170,99261756,229142926,9,0,0,4608,4,4341424898
15635,129901020,99461824,229362844,5,0,0,30208,12,1810051404
15636,129903050,99249415,229152465,4,0,0,31232,7,5271454878
15637,129911740,99161217,229072957,7,0,0,15360,1,3341913799
15638,129915970,99305274,229221244,1,0,0,77312,1,1260896142
15639,129931310,99694353,229625663,2,0,0,23040,1,1076638721
15640,129933030,100283616,230216646,2,0,0,30720,1,5860254326
15641,129940950,99088653,229029603,7,0,0,18432,1,6486338638
15642,129947830,132055482,262003312,0,0,1,1536,6,10191473197
15643,129950570,132104606,262055176,8,0,1,19456,11,1909503765
15644,129970410,100179557,230149967,4,0,0,156160,7,1640198067
15645,129976750,99594111,229570861,8,0,0,102400,11,6049506859
15646,129990470,99473422,229463892,1,0,0,6656,1,4550246949
15647,129994990,99349128,229344118,9,0,0,50688,4,8425104816
15648,130018110,99611008,229629118,3,0,0,11264,18,4198677459
15649,130020820,132049530,262070350,0,0,1,17920,6,4553557635
15650,130022550,99686833,229709383,4,0,0,23552,7,1632306173
15651,130042250,99332785,229375035,4,0,0,39936,7,7326813711
15652,130046710,99625987,229672697,9,0,0,79360,4,7934885892
15653,130047830,100316819,230364649,7,0,0,30208,1,9961371768
15654,130052450,99138280,229190730,4,0,0,8704,7,2985926639
15655,130065220,99983722,230048942,2,0,0,71680,1,1418010486
15656,130080720,131994071,262074791,8,0,1,4608,11,3276617883
15657,130080930,99272687,229353617,3,0,0,12800,18,2576560613
15658,130080950,100460682,230541632,2,0,0,18944,1,9973936245
15659,130094300,99696057,229790357,3,0,0,2560,18,304238590
15660,130117381,131961264,262078645,9,0,1,17408,4,3359119544
15661,130119710,99498910,229618620,1,0,0,156672,1,5986506596
15662,130120230,99523286,229643516,0,0,0,30208,6,6803793854
15663,130127830,99593509,229721339,2,0,0,33280,1,7491023167
15664,130132240,99822334,229954574,3,0,0,25600,18,211284890
15665,130133840,99613447,229747287,4,0,0,43520,7,10034887635
15666,130143280,99742747,229886027,4,0,0,88576,7,3188198527
15667,130152560,131947968,262100528,4,0,1,5632,7,6101794304
15668,130157460,100507257,230664717,2,0,0,10240,1,7717319518
15669,130162530,99760263,229922793,2,0,0,88576,1,6992283738
15670,130167370,99345927,229513297,6,0,0,11264,12,2346762227
15671,130168080,100103666,230271746,5,0,0,27136,12,8787001263
15672,130171440,99765567,229937007,2,0,0,33792,1,6421001657
15673,130176890,99769861,229946751,3,0,0,14848,18,2778342798
15674,130176990,100667282,230844272,9,0,0,47104,4,8600296477
15675,130187630,99608074,229795704,5,0,0,17408,12,9129723627
15676,130187870,99998683,230186553,8,0,0,79872,11,7217652846
15677,130189990,99597746,229787736,1,0,0,13312,1,3464320305
15678,130200240,131905434,262105674,6,0,1,8192,12,9175834987
15679,130205180,100058275,230263455,2,0,0,28672,1,1860526422
15680,130231600,99589418,229821018,6,0,0,17408,12,325955889
15681,130233310,131872928,262106238,4,0,1,10752,7,7818860229
15682,130244870,99782209,230027079,6,0,0,112128,12,4026297099
15683,130247790,99476848,229724638,1,0,0,10752,1,1065634068
15684,130259070,131892461,262151531,8,0,1,512,11,4807617650
15685,130260410,100088911,230349321,8,0,0,22016,11,1584518529
15686,130285200,131866677,262151877,4,0,1,512,7,6178395974
15687,130285950,99675825,229961775,2,0,0,9216,1,1781321943
15688,130296050,99491865,229787915,4,0,0,512,7,10380277765
15689,130313190,100099503,230412693,7,0,0,8192,1,7436418705
15690,130316240,131835791,262152031,6,0,1,8704,12,5419846593
15691,130318800,99759360,230078160,1,0,0,66048,1,2400412450
15692,130326960,100058904,230385864,6,0,0,62464,12,10088717700
15693,130334620,99743750,230078370,7,0,0,512,1,8858345631
15694,130336290,99721723,230058013,3,0,0,29696,18,4191899868
15695,130352811,131912022,262264833,9,0,1,11264,4,2095042767
15696,130388760,100093934,230482694,4,0,0,3584,7,7812490157
15697,130394920,99707444,230102364,4,0,0,11264,7,3618000189
15698,130395690,100605010,231000700,5,0,0,92672,12,8734771201
15699,130398790,100172195,230570985,4,0,0,8192,7,8528547983
15700,130400960,99786864,230187824,7,0,0,4096,1,6314135941
15701,130403280,100165186,230568466,3,0,0,52224,18,8102990232
15702,130407580,99945843,230353423,2,0,0,11264,1,8040711089
15703,130433440,99916528,230349968,2,0,0,2048,1,176190193
15704,130446640,99777673,230224313,7,0,0,25088,1,1812642467
15705,130450500,99700472,230150972,5,0,0,3072,12,1370201320
15706,130455600,131809256,262264856,1,0,1,10240,1,10247098239
15707,130460680,99780499,230241179,7,0,0,27136,1,4335598559
15708,130464350,100107906,230572256,9,0,0,4096,4,3860947847
15709,130504390,99977189,230481579,2,0,0,16384,1,7529785956
15710,130517141,131747738,262264879,9,0,1,13824,4,4732654525
15711,130534200,100176649,230710849,8,0,0,43520,11,8738000262
15712,130547870,100367561,230915431,5,0,0,164352,12,1011897579
15713,130551190,131744050,262295240,6,0,1,4096,12,9328051320
15714,130552130,100109444,230661574,8,0,0,156160,11,444524308
15715,130558220,100563682,231121902,4,0,0,222208,7,706285911
15716,130564580,99833199,230397779,9,0,0,512,4,4110267982
15717,130574440,131720823,262295263,1,0,1,15360,1,5327897384
15718,130579980,100623477,231203457,9,0,0,100352,4,9511778174
15719,130586640,100080596,230667236,9,0,0,8192,4,10272882652
15720,130602820,100092918,230695738,9,0,0,25088,4,5386867131
15721,130607510,100521591,231129101,2,0,0,23552,1,9173710672
15722,130637120,99686071,230323191,1,0,0,11264,1,4556034606
15723,130644000,100140523,230784523,8,0,0,57344,11,1991419713
15724,130649470,101167612,231817082,4,0,0,59904,7,1898531096
15725,130656770,131642048,262298818,0,0,1,6656,6,4508171836
15726,130657440,100072483,230729923,2,0,0,30720,1,704212467
15727,130659600,100017175,230676775,6,0,0,31232,12,4867158555
15728,130660300,100129862,230790162,6,0,0,18432,12,1655561045
15729,130665130,100254380,230919510,7,0,0,13312,1,10633225419
15730,130676080,132112512,262788592,2,0,1,166400,1,26372063
15731,130676330,132130762,262807092,0,0,1,24064,6,3983184172
15732,130678590,100375585,231054175,1,0,0,20992,1,2692081735
15733,130682690,101007578,231690268,7,0,0,56832,1,9209670885
15734,130701760,100676889,231378649,8,0,0,105472,11,3888863626
15735,130725890,100315445,231041335,9,0,0,9216,4,3812409307
15736,130736310,100184947,230921257,1,0,0,5632,1,5665863605
15737,130744860,100212559,230957419,3,0,0,84480,18,2616607444
15738,130750530,99983160,230733690,2,0,0,12288,1,7389880826
15739,130781120,100432818,231213938,2,0,0,32256,1,3017701083
15740,130796950,100375261,231172211,9,0,0,110080,4,3408981202
15741,130834290,100123776,230958066,9,0,0,2048,4,7303870543
15742,130871580,100100861,230972441,9,0,0,47104,4,3507680167
15743,130881750,100420790,231302540,6,0,0,58368,12,235302801
15744,130884160,132025889,262910049,1,0,1,22528,1,2979342076
15745,130895820,101543786,232439606,6,0,0,188928,12,1179621554
15746,130910570,100417230,231327800,4,0,0,1536,7,2273139693
15747,130915191,131995217,262910408,9,0,1,9728,4,8262735224
15748,130916109,132063192,262979301,3,0,1,11776,18,8511446130
15749,130919480,100219168,231138648,3,0,0,31232,18,9577873152
15750,130920490,100082425,231002915,8,0,0,7168,11,8805055838
15751,130933300,100311178,231244478,4,0,0,26624,7,5183481023
15752,130941720,100280821,231222541,9,0,0,28160,4,8289633407
15753,130944740,100542739,231487479,6,0,0,34304,12,9609246455
15754,130954550,100454233,231408783,1,0,0,30208,1,9031745693
15755,130968390,101545846,232514236,3,0,0,47104,18,7029318624
15756,130974680,100291154,231265834,4,0,0,12800,7,2250632619
15757,130975150,100309583,231284733,2,0,0,60928,1,6922363589
15758,130993320,100482438,231475758,6,0,0,12288,12,9949012461
15759,130994500,100178358,231172858,7,0,0,2048,1,6050672086
15760,131001420,132091605,263093025,2,0,1,26112,1,7939481643
15761,131003730,100541923,231545653,4,0,0,3072,7,7664090621
15762,131010620,132326933,263337553,2,0,1,120320,1,6562867745
15763,131016530,132322941,263339471,1,0,1,6144,1,10236760104
15764,131019200,100519443,231538643,9,0,0,10752,4,2382019029
15765,131021790,100450201,231471991,2,0,0,24576,1,1450126080
15766,131027151,132312678,263339829,9,0,1,8192,4,7082683392
15767,131040770,100377842,231418612,1,0,0,29184,1,6592440009
15768,131045610,100446416,231492026,4,0,0,14848,7,4032902837
15769,131051340,132288512,263339852,1,0,1,10240,1,6774406429
15770,131056280,101689915,232746195,7,0,0,160256,1,4347213571
15771,131061090,100611660,231672750,3,0,0,60416,18,4360340843
15772,131072240,100505442,231577682,2,0,0,5632,1,7479011226
15773,131081760,100357300,231439060,9,0,0,18432,4,5377986662
15774,131086290,100752112,231838402,4,0,0,34816,7,1484461411
15775,131109700,100588826,231698526,9,0,0,23040,4,3882010187
15776,131112590,132227285,263339875,1,0,1,512,1,4488825994
15777,131120250,100552679,231672929,8,0,0,512,11,2106343084
15778,131123051,132332771,263455822,9,0,1,36352,4,5041882802
15779,131148790,100670655,231819445,4,0,0,7680,7,2150996827
15780,131149160,100584196,231733356,9,0,0,6144,4,7366919898
15781,131165651,132492256,263657907,9,0,1,27136,4,9827620264
15782,131178550,100336151,231514701,3,0,0,8704,18,650269607
15783,131189670,100604537,231794207,4,0,0,9728,7,6911747733
15784,131206160,100714011,231920171,9,0,0,18432,4,3814152386
15785,131209070,100308775,231517845,8,0,0,2048,11,2910607683
15786,131220280,100889776,232110056,1,0,0,74752,1,10467280533
15787,131233840,101045504,232279344,0,0,0,42496,6,5436258385
15788,131234510,100456950,231691460,9,0,0,3584,4,3860860159
15789,131234790,100522532,231757322,4,0,0,25088,7,5705226776
15790,131258630,100655902,231914532,1,0,0,31744,1,991096013
15791,131260830,100766898,232027728,4,0,0,8704,7,6271424218
15792,131266080,100815731,232081811,5,0,0,5632,12,6331823300
15793,131293470,100786602,232080072,1,0,0,60416,1,9760193658
15794,131302080,132355850,263657930,6,0,1,10240,12,1017801730
15795,131306340,101489335,232795675,9,0,0,14336,4,10208863758
15796,131308740,100712640,232021380,7,0,0,15872,1,915272342
15797,131309211,132372440,263681651,9,0,1,1536,4,531790330
15798,131309830,101056052,232365882,8,0,0,101888,11,2769142711
15799,131311990,100612724,231924714,4,0,0,12288,7,6323125614
15800,131314080,100938516,232252596,8,0,0,124416,11,10016379975
15801,131329820,100650856,231980676,5,0,0,30720,12,404329867
15802,131359119,132325118,263684237,5,0,1,4096,12,5613062301
15803,131371700,100801711,232173411,6,0,0,99328,12,1954602553
15804,131376100,101393697,232769797,5,0,0,75264,12,3194837815
15805,131377200,132316457,263693657,1,0,1,17408,1,8688885822
15806,131397980,100899951,232297931,8,0,0,60928,11,9881661922
15807,131415160,132295229,263710389,8,0,1,6656,11,5025437662
15808,131421280,101078581,232499861,1,0,0,29696,1,5004746749
15809,131425320,101162454,232587774,6,0,0,33280,12,9506492073
15810,131426710,100353361,231780071,8,0,0,8704,11,1790738830
15811,131428620,100953399,232382019,4,0,0,39424,7,2501473979
15812,131440800,132270895,263711695,1,0,1,2048,1,4940270676
15813,131443490,100765876,232209366,7,0,0,45056,1,2222246160
15814,131446490,100858024,232304514,7,0,0,21504,1,3801913715
15815,131468870,132253831,263722701,8,0,1,5120,11,5466052987
15816,131475910,101875206,233351116,9,0,0,6144,4,4604848950
15817,131478860,101094675,232573535,4,0,0,43520,7,4418969519
15818,131480740,100834413,232315153,3,0,0,512,18,3064901527
15819,131488070,100818651,232306721,8,0,0,7168,11,9009264542
15820,131512110,100857874,232369984,3,0,0,13312,18,10343922855
15821,131519620,132203104,263722724,6,0,1,4608,12,6029321011
15822,131536600,101294483,232831083,1,0,0,3072,1,508987688
15823,131546180,101600862,233147042,6,0,0,14336,12,1965003054
15824,131559130,100749631,232308761,0,0,0,4096,6,2501570942
15825,131559880,132193927,263753807,7,0,1,1024,1,10583896053
15826,131567720,101719747,233287467,6,0,0,15872,12,2827492890
15827,131568340,100621871,232190211,8,0,0,32256,11,3008592911
15828,131572080,102006926,233579006,6,0,0,100864,12,5228523211
15829,131579920,101444723,233024643,5,0,0,92672,12,6083125662
15830,131586050,100893101,232479151,5,0,0,22016,12,7656511806
15831,131594690,100857775,232452465,5,0,0,22528,12,10272477153
15832,131602960,100649971,232252931,7,0,0,1024,1,6346069506
15833,131615150,132140603,263755753,1,0,1,3072,1,4664283715
15834,131618130,101071637,232689767,6,0,0,33280,12,2323423946
15835,131622010,101022799,232644809,6,0,0,17920,12,6555432468
15836,131622030,100850390,232472420,0,0,0,30720,6,3254480033
15837,131630860,102231048,233861908,6,0,0,71680,12,902187259
15838,131636830,100806566,232443396,0,0,0,12288,6,9262491815
15839,131641640,132140464,263782104,6,0,1,23552,12,3294736187
15840,131650810,101130132,232780942,6,0,0,29696,12,3313804971
15841,131656660,101090182,232746842,5,0,0,2048,12,218156509
15842,131659450,100822844,232482294,7,0,0,10240,1,4217439073
15843,131664110,101469782,233133892,7,0,0,82432,1,9746098714
15844,131672340,132340673,264013013,1,0,1,38400,1,3549703033
15845,131687300,132415088,264102388,0,0,1,13824,6,2102407204
15846,131692090,132748566,264440656,1,0,1,59392,1,5288367403
15847,131701940,101089321,232791261,2,0,0,33792,1,7360253458
15848,131704840,101463751,233168591,3,0,0,512,18,1905956525
15849,131705830,102282250,233988080,0,0,0,98304,6,3196859927
15850,131717200,101195282,232912482,4,0,0,35840,7,9263666891
15851,131719630,101370966,233090596,4,0,0,44544,7,195796877
15852,131722530,101077247,232799777,5,0,0,7680,12,3610528533
15853,131723150,101385603,233108753,8,0,0,7168,11,2722846310
15854,131724840,132725837,264450677,6,0,1,13824,12,4260548879
15855,131730160,101106447,232836607,7,0,0,8704,1,2258944327
15856,131734810,132746655,264481465,8,0,1,16896,11,9147843353
15857,131740400,100855428,232595828,5,0,0,1536,12,2270161033
15858,131748711,132803274,264551985,9,0,1,26112,4,681133946
15859,131757750,101467143,233224893,6,0,0,39936,12,8977477804
15860,131762290,101009581,232771871,7,0,0,6656,1,6485240606
15861,131765150,133363618,265128768,2,0,1,163328,1,6080226645
15862,131766130,101043429,232809559,4,0,0,5632,7,8592039747
15863,131774640,102403118,234177758,6,0,0,6656,12,10163388950
15864,131802140,101454475,233256615,3,0,0,49664,18,2078017099
15865,131820620,101436486,233257106,1,0,0,1536,1,6178052717
15866,131825000,101166837,232991837,9,0,0,49152,4,8043963733
15867,131833170,102708566,234541736,1,0,0,34816,1,7245044769
15868,131833390,102564022,234397412,1,0,0,66048,1,1273269501
15869,131843140,101369562,233212702,9,0,0,101376,4,2425401279
15870,131858060,101424548,233282608,3,0,0,39424,18,8509806249
15871,131861240,101204139,233065379,0,0,0,2048,6,4785230181
15872,131879070,101507863,233386933,5,0,0,12800,12,10695197718
15873,131888840,101167323,233056163,2,0,0,2048,1,4145481568
15874,131897340,101271072,233168412,6,0,0,15872,12,1652949929
15875,131903760,101580727,233484487,4,0,0,9216,7,3249693702
15876,131911010,101359563,233270573,5,0,0,7680,12,6751187168
15877,131916440,101124606,233041046,5,0,0,53760,12,3016431894
15878,131931630,101211021,233142651,3,0,0,28672,18,9696039465
15879,131934380,100863034,232797414,5,0,0,5632,12,189105732
15880,131986210,101691750,233677960,6,0,0,81920,12,9535109673
15881,131987710,101402678,233390388,6,0,0,11264,12,1965338953
15882,131988531,133199868,265188399,9,0,1,46080,4,9739395059
15883,131996510,101527336,233523846,6,0,0,125440,12,3069191861
15884,132004710,101536319,233541029,5,0,0,56320,12,3560109194
15885,132006850,101234602,233241452,2,0,0,54272,1,4945654340
15886,132018120,101403071,233421191,3,0,0,7680,18,8940226340
15887,132026700,133161722,265188422,0,0,1,4096,6,200683276
15888,132034610,101604024,233638634,6,0,0,126976,12,6379024040
15889,132050110,133138335,265188445,1,0,1,5120,1,7608558789
15890,132056180,101415982,233472162,4,0,0,11264,7,1350445488
15891,132057920,101291301,233349221,6,0,0,43008,12,5751712018
15892,132060330,100936054,232996384,7,0,0,14848,1,6781403885
15893,132075320,101471660,233546980,7,0,0,19456,1,2468869414
15894,132076000,101574825,233650825,6,0,0,39936,12,165160709
15895,132079240,101746281,233825521,5,0,0,50176,12,10524251307
15896,132084010,101464241,233548251,7,0,0,4096,1,6818188397
15897,132084650,133104205,265188855,4,0,1,31744,7,5090555066
15898,132091570,101353364,233444934,4,0,0,2560,7,10274388400
15899,132097320,101955993,234053313,9,0,0,8704,4,1777542936
15900,132106870,101924348,234031218,6,0,0,18944,12,5023498486
15901,132116700,100926865,233043565,9,0,0,8192,4,6580866261
15902,132125360,101650016,233775376,1,0,0,33280,1,10137631854
15903,132126710,101586573,233713283,9,0,0,25600,4,1285313515
15904,132134800,101340523,233475323,9,0,0,2048,4,435020640
15905,132137180,101288090,233425270,0,0,0,13312,6,2981345910
15906,132142239,133069454,265211693,3,0,1,8192,18,3682600206
15907,132154670,101633833,233788503,0,0,0,43008,6,7536918010
15908,132190210,101398179,233588389,4,0,0,30720,7,10485934556
15909,132212770,101439794,233652564,1,0,0,5632,1,371527349
15910,132254150,101930495,234184645,5,0,0,22528,12,4386708695
15911,132257409,132963992,265221401,3,0,1,15872,18,7558795804
15912,132286040,101603401,233889441,1,0,0,26112,1,2529524838
15913,132306630,101684304,233990934,3,0,0,8704,18,6551372489
15914,132307130,102301561,234608691,3,0,0,15360,18,8940102953
15915,132310110,101069915,233380025,1,0,0,14848,1,6818329875
15916,132313870,101515936,233829806,5,0,0,1024,12,3659410765
15917,132331400,101433813,233765213,3,0,0,153600,18,10539559508
15918,132333680,101608248,233941928,3,0,0,25088,18,6435269460
15919,132351800,102407735,234759535,0,0,0,7168,6,5629449014
15920,132365480,102165625,234531105,4,0,0,75264,7,5448649952
15921,132372280,101502131,233874411,9,0,0,40960,4,4998986650
15922,132383170,101309791,233692961,9,0,0,11264,4,7155730697
15923,132398940,101482514,233881454,0,0,0,23040,6,8027260233
15924,132421460,132812962,265234422,0,0,1,7168,6,2200878558
15925,132435500,101738331,234173831,7,0,0,35840,1,5410409882
15926,132444210,101572175,234016385,6,0,0,83456,12,7798592794
15927,132451770,132782675,265234445,8,0,1,9728,11,4361003221
15928,132460919,132858378,265319297,3,0,1,2048,18,3671402329
15929,132472360,101118392,233590752,4,0,0,7680,7,10384135140
15930,132478530,101558826,234037356,6,0,0,5632,12,2060645698
15931,132480670,132841213,265321883,8,0,1,4096,11,4222406224
15932,132487790,101642760,234130550,6,0,0,41472,12,8744701802
15933,132492430,101600488,234092918,0,0,0,8704,6,3678758759
15934,132505540,101655625,234161165,8,0,0,15360,11,2396203054
15935,132528710,101281500,233810210,5,0,0,71168,12,2448079244
15936,132530310,101507849,234038159,4,0,0,2560,7,5670341848
15937,132538250,102065738,234603988,5,0,0,39936,12,10314668003
15938,132554520,132850368,265404888,8,0,1,2048,11,2201677236
15939,132563280,101460240,234023520,5,0,0,23040,12,159734316
15940,132571730,101268315,233840045,5,0,0,30720,12,8187705452
15941,132573110,101786248,234359358,8,0,0,108032,11,8090598309
15942,132588780,101334332,233923112,1,0,0,8704,1,8524820297
15943,132606350,132800484,265406834,7,0,1,3072,1,1246272090
15944,132608550,102317936,234926486,5,0,0,103424,12,702267513
15945,132610539,132800801,265411340,5,0,1,7168,12,5727317852
15946,132615840,132895444,265511284,8,0,1,1024,11,5060535981
15947,132620190,101329052,233949242,9,0,0,9216,4,4571908319
15948,132629850,101577575,234207425,2,0,0,18944,1,6538028452
15949,132638490,101618106,234256596,2,0,0,49152,1,4405881493
15950,132652150,101716279,234368429,2,0,0,29696,1,10315926965
15951,132656400,101023299,233679699,3,0,0,5632,18,6507596001
15952,132662490,101749320,234411810,6,0,0,20480,12,4480140588
15953,132672940,101416118,234089058,3,0,0,7680,18,9086082712
15954,132679800,101737371,234417171,8,0,0,10240,11,1642228785
15955,132684181,132839736,265523917,9,0,1,6144,4,236163293
15956,132698440,101519236,234217676,4,0,0,8704,7,8682214247
15957,132700490,101346024,234046514,5,0,0,6656,12,8487601721
15958,132707490,101280769,233988259,1,0,0,512,1,3236892488
15959,132712070,101736192,234448262,7,0,0,38400,1,3168646310
15960,132719280,101474468,234193748,1,0,0,15872,1,498475636
15961,132728771,132799652,265528423,9,0,1,7168,4,9118757049
15962,132742390,101554828,234297218,8,0,0,61952,11,2362855156
15963,132743580,101281843,234025423,0,0,0,6144,6,8080413887
15964,132752350,101936872,234689222,1,0,0,80896,1,4479312266
15965,132775960,102035165,234811125,1,0,0,115712,1,7112156716
15966,132785510,101767866,234553376,1,0,0,9216,1,1425651629
15967,132787830,101247779,234035609,3,0,0,14336,18,5387048808
15968,132789680,101509901,234299581,3,0,0,7680,18,52766066
15969,132793600,101438344,234231944,6,0,0,5120,12,2771411315
15970,132796300,101360162,234156462,3,0,0,67584,18,1378055532
15971,132814661,132803390,265618051,9,0,1,20992,4,3684416222
15972,132827020,102114074,234941094,0,0,0,28160,6,414637300
15973,132837830,101927804,234765634,0,0,0,16384,6,10686933000
15974,132842220,101994866,234837086,3,0,0,14848,18,8822181844
15975,132845600,101911728,234757328,2,0,0,56320,1,9446159433
15976,132852600,132788334,265640934,6,0,1,16384,12,6870027364
15977,132861110,102156286,235017396,3,0,0,13824,18,6594685956
15978,132871590,101992039,234863629,7,0,0,87040,1,5309851858
15979,132878580,101953959,234832539,9,0,0,23552,4,4035763586
15980,132885110,132758090,265643200,4,0,1,3584,7,8018631055
15981,132885200,101374071,234259271,0,0,0,8704,6,8271745358
15982,132888829,132754717,265643546,3,0,1,512,18,666505503
15983,132900550,101685265,234585815,4,0,0,4096,7,7063718348
15984,132905360,101642038,234547398,6,0,0,9216,12,5478934638
15985,132907570,101647233,234554803,2,0,0,4608,1,1597048680
15986,132911790,102083978,234995768,6,0,0,31232,12,4085961939
15987,132916620,101403993,234320613,7,0,0,1536,1,6780856594
15988,132930320,101475227,234405547,8,0,0,26624,11,7191060565
15989,132931299,132712593,265643892,5,0,1,512,12,7525522491
15990,132934940,102182971,235117911,7,0,0,182784,1,6803211739
15991,132953230,132692928,265646158,1,0,1,3584,1,1195633815
15992,132957280,101616403,234573683,2,0,0,4608,1,190997977
15993,132957440,102168629,235126069,2,0,0,8704,1,2153428515
15994,132957520,101974971,234932491,8,0,0,6144,11,2435100877
15995,132957950,132689194,265647144,8,0,1,1536,11,5452544698
15996,132961190,102529060,235490250,1,0,0,39936,1,4697091869
15997,132971390,101851565,234822955,1,0,0,20992,1,2396032940
15998,132980060,101570169,234550229,3,0,0,9216,18,8445058658
15999,132987490,132693342,265680832,8,0,1,9728,11,9564184785
16000,133011359,132669819,265681178,5,0,1,512,12,375138695
16001,133021170,101594743,234615913,6,0,0,6656,12,4788399614
16002,133023220,101590642,234613862,4,0,0,16896,7,3613540762
16003,133027371,132654166,265681537,9,0,1,9728,4,6116901209
16004,133029000,102013009,235042009,5,0,0,20992,12,10670699652
16005,133049930,101880666,234930596,8,0,0,4096,11,8548076345
16006,133080400,102678918,235759318,2,0,0,30208,1,315553074
16007,133090700,132787119,265877819,4,0,1,22016,7,6758956302
16008,133125319,132752523,265877842,3,0,1,9216,18,8333258107
16009,133126630,132884937,266011567,6,0,1,6144,12,2525219802
16010,133137300,101407267,234544567,2,0,0,9216,1,7763775643
16011,133143750,102819530,235963280,4,0,0,63488,7,9859357864
16012,133147350,132980796,266128146,6,0,1,19968,12,8601509370
16013,133150180,101498548,234648728,9,0,0,22528,4,9305954898
16014,133155811,132972358,266128169,9,0,1,26624,4,585083782
16015,133161750,101849298,235011048,4,0,0,3072,7,567606072
16016,133167770,101761547,234929317,8,0,0,9216,11,6096548868
16017,133171711,133049009,266220720,9,0,1,59904,4,9699819359
16018,133181200,101787396,234968596,2,0,0,10752,1,5651069409
16019,133184030,102038821,235222851,8,0,0,18432,11,7751843511
16020,133189670,102894969,236084639,7,0,0,36864,1,9698524458
16021,133192690,133028376,266221066,8,0,1,512,11,8781830916
16022,133195150,133536726,266731876,8,0,1,63488,11,44998853
16023,133200990,133535072,266736062,6,0,1,6656,12,1381475794
16024,133208489,133699957,266908446,3,0,1,33792,18,5749059938
16025,133229330,101665621,234894951,9,0,0,67072,4,7620181880
16026,133229560,101735737,234965297,4,0,0,46080,7,5779846705
16027,133242700,102090639,235333339,5,0,0,20992,12,5501605277
16028,133245830,101877564,235123394,6,0,0,17920,12,2532535562
16029,133249580,101770227,235019807,6,0,0,2048,12,6681808526
16030,133271910,102172375,235444285,7,0,0,56320,1,8702156610
16031,133274190,101859858,235134048,1,0,0,26112,1,1526820666
16032,133282910,133779678,267062588,2,0,1,45056,1,1203904353
16033,133306320,101740548,235046868,1,0,0,15872,1,2717676878
16034,133312570,101904634,235217204,5,0,0,87552,12,2012243694
16035,133316680,101968318,235284998,6,0,0,74240,12,8073023485
16036,133318500,101872005,235190505,4,0,0,30720,7,3504162479
16037,133355160,133732847,267088007,8,0,1,9216,11,10566600479
16038,133372470,133842110,267214580,6,0,1,58368,12,9672049293
16039,133377600,102036357,235413957,7,0,0,41984,1,5619714315
16040,133392360,133876705,267269065,8,0,1,15872,11,8490818505
16041,133394620,133959486,267354106,8,0,1,16384,11,10365064069
16042,133405450,102087475,235492925,4,0,0,8704,7,5916361065
16043,133405460,102053916,235459376,9,0,0,12288,4,6178238018
16044,133430029,133924100,267354129,5,0,1,23040,12,3664225387
16045,133438200,102759017,236197217,6,0,0,35840,12,7875646452
16046,133442390,101819965,235262355,8,0,0,38400,11,1352985970
16047,133446460,102977620,236424080,9,0,0,532992,4,4127733831
16048,133469370,133981500,267450870,6,0,1,21504,12,7018522343
16049,133471989,133984387,267456376,5,0,1,3072,12,3730401665
16050,133482990,102454192,235937182,4,0,0,47104,7,3259125479
16051,133484700,102229325,235714025,7,0,0,65024,1,6809148950
16052,133491830,102097042,235588872,4,0,0,11776,7,4366644477
16053,133502020,102192170,235694190,4,0,0,40960,7,7623687369
16054,133511120,101954916,235466036,9,0,0,9216,4,769175946
16055,133512760,102006310,235519070,1,0,0,10752,1,10676245635
16056,133517060,102009870,235526930,0,0,0,16384,6,1704450461
16057,133527680,102091493,235619173,3,0,0,32256,18,5489955383
16058,133539640,102270912,235810552,8,0,0,9728,11,4322355542
16059,133564281,133922607,267486888,9,0,1,1536,4,10319344051
16060,133564530,102020731,235585261,1,0,0,22016,1,6419277493
16061,133570790,101984098,235554888,6,0,0,7168,12,1799848043
16062,133572149,133914762,267486911,3,0,1,9216,18,1466925944
16063,133579140,102196292,235775432,3,0,0,512,18,4068414490
16064,133581230,133905704,267486934,1,0,1,5120,1,9213419320
16065,133588580,102877395,236465975,8,0,0,37376,11,9834574085
16066,133611190,133883285,267494475,0,0,1,6656,6,2631580532
16067,133611320,102369823,235981143,7,0,0,40960,1,4676211639
16068,133615190,102903870,236519060,0,0,0,22528,6,8823042780
16069,133618460,102520724,236139184,0,0,0,109056,6,8386189855
16070,133625630,102530893,236156523,9,0,0,56832,4,3469977578
16071,133642549,133855472,267498021,5,0,1,5632,12,653371452
16072,133651830,102213935,235865765,1,0,0,4096,1,7254402772
16073,133678779,133839395,267518174,5,0,1,25088,12,8409394727
16074,133687350,102221079,235908429,9,0,0,35328,4,542471881
16075,133690629,133845601,267536230,3,0,1,2560,18,9122679232
16076,133694440,102360852,236055292,0,0,0,512,6,2894970824
16077,133696530,102310153,236006683,1,0,0,17408,1,10714724226
16078,133698360,102399148,236097508,3,0,0,24576,18,10505004189
16079,133700720,102907506,236608226,9,0,0,31744,4,8250275497
16080,133709800,102977473,236687273,7,0,0,87040,1,4010955526
16081,133713360,102360024,236073384,5,0,0,21504,12,4255475861
16082,133720640,102479720,236200360,3,0,0,10240,18,10650195847
16083,133722800,102367174,236089974,4,0,0,17408,7,8649874622
16084,133736210,102525428,236261638,4,0,0,59392,7,9939366721
16085,133737080,102206833,235943913,9,0,0,22016,4,1334864336
16086,133742920,133811356,267554276,6,0,1,6144,12,3951553880
16087,133753740,102480307,236234047,7,0,0,33280,1,3038004230
16088,133761530,102304549,236066079,8,0,0,35328,11,10383284552
16089,133762350,103038653,236801003,1,0,0,60928,1,6464767991
16090,133770870,102253713,236024583,1,0,0,2048,1,8251743495
16091,133778200,102276913,236055113,1,0,0,13312,1,4490598350
16092,133792410,133762199,267554609,8,0,1,16896,11,8306471689
16093,133794460,102215688,236010148,8,0,0,8192,11,9071583302
16094,133804020,102888736,236692756,3,0,0,17920,18,3450377154
16095,133820660,102422859,236243519,0,0,0,25600,6,5252092356
16096,133827610,133746592,267574202,8,0,1,9216,11,3204381108
16097,133831510,133743998,267575508,1,0,1,2048,1,5238806124
16098,133838690,133761564,267600254,8,0,1,512,11,10201117357
16099,133843910,103043632,236887542,3,0,0,17408,18,6348054976
16100,133844770,103027548,236872318,2,0,0,233984,1,4274816861
16101,133852670,103598098,237450768,8,0,0,21504,11,6999758298
16102,133863230,103120749,236983979,7,0,0,44544,1,8768070371
16103,133870920,102571509,236442429,3,0,0,34816,18,7919292658
16104,133898150,133705650,267603800,4,0,1,5632,7,918534239
16105,133916910,102708187,236625097,5,0,0,55296,12,5815675317
16106,133925040,102504771,236429811,5,0,0,8704,12,4816149233
16107,133933010,102498742,236431752,1,0,0,6144,1,8228138652
16108,133938660,102488407,236427067,4,0,0,9728,7,1446169458
16109,133964880,103302966,237267846,2,0,0,32256,1,5503542437
16110,133967220,102907016,236874236,2,0,0,2560,1,3198579238
16111,133973190,133634156,267607346,1,0,1,5632,1,3560413034
16112,133976860,103635974,237612834,4,0,0,17920,7,5014948072
16113,133984850,102722437,236707287,3,0,0,47616,18,1015905609
16114,133996520,102749353,236745873,4,0,0,123904,7,8811033481
16115,134003920,102443368,236447288,3,0,0,15872,18,1591192470
16116,134004950,102564153,236569103,5,0,0,23552,12,4004216737
16117,134016410,102691688,236708098,7,0,0,2560,1,4690896029
16118,134022280,102533195,236555475,9,0,0,22528,4,10569083683
16119,134023591,133583909,267607500,9,0,1,8704,4,6015762634
16120,134030540,102900627,236931167,5,0,0,27136,12,3858687503
16121,134033870,134476400,268510270,2,0,1,345088,1,801581755
16122,134034340,102864925,236899265,4,0,0,38400,7,9725567931
16123,134039090,103916256,237955346,4,0,0,26112,7,3340499930
16124,134061299,134448994,268510293,5,0,1,1536,12,989171566
16125,134065030,102839631,236904661,4,0,0,17408,7,9723746933
16126,134067310,102560999,236628309,9,0,0,9216,4,9002406514
16127,134074430,102886593,236961023,1,0,0,95232,1,2045812302
16128,134086680,102538752,236625432,0,0,0,1024,6,2099605747
16129,134095030,103785476,237880506,4,0,0,122880,7,3125493653
16130,134115120,103018945,237134065,9,0,0,60416,4,9941362274
16131,134122640,102876962,236999602,1,0,0,51200,1,5784274185
16132,134122790,102934587,237057377,7,0,0,41984,1,3538246131
16133,134132170,134441454,268573624,4,0,1,16896,7,605781912
16134,134136000,103998750,238134750,3,0,0,82944,18,9190522549
16135,134136280,103195029,237331309,9,0,0,50176,4,10259437958
16136,134141600,102775610,236917210,2,0,0,10752,1,7313246937
16137,134151790,134444119,268595909,0,0,1,9216,6,6902924400
16138,134153630,103045469,237199099,7,0,0,512,1,5569096404
16139,134157320,102850796,237008116,5,0,0,20992,12,7168169074
16140,134174840,102574644,236749484,2,0,0,11776,1,2361240732
16141,134175270,102790456,236965726,7,0,0,15360,1,8664910945
16142,134177640,102704575,236882215,9,0,0,26112,4,4789154497
16143,134195250,102713802,236909052,5,0,0,14336,12,6851667293
16144,134204270,134468700,268672970,8,0,1,9728,11,8102495152
16145,134240910,102632523,236873433,6,0,0,3584,12,6068975186
16146,134243350,102670561,236913911,8,0,0,15872,11,5532652123
16147,134265530,103177193,237442723,4,0,0,21504,7,1455626434
16148,134268710,134573785,268842495,0,0,1,35840,6,8917852801
16149,134273190,102869634,237142824,2,0,0,28672,1,1833912663
16150,134282970,102922764,237205734,2,0,0,19968,1,1363642603
16151,134299230,103268251,237567481,6,0,0,21504,12,5276419776
16152,134321030,104339951,238660981,2,0,0,11264,1,5729032431
16153,134342900,104686607,239029507,7,0,0,52736,1,4128693501
16154,134357340,103437603,237794943,9,0,0,1024,4,4693483229
16155,134359480,103421530,237781010,4,0,0,33280,7,4116808364
16156,134361220,104848730,239209950,1,0,0,32768,1,3203167226
16157,134366170,104484425,238850595,7,0,0,70144,1,223460076
16158,134376420,102791949,237168369,2,0,0,76288,1,5278329292
16159,134387409,134523820,268911229,5,0,1,7168,12,3199843689
16160,134398580,104994964,239393544,3,0,0,31744,18,1053146852
16161,134406130,102511883,236918013,1,0,0,2560,1,9121124503
16162,134416689,134517677,268934366,5,0,1,1536,12,3178591006
16163,134432050,103286364,237718414,5,0,0,13824,12,359435052
16164,134435049,134500623,268935672,3,0,1,2048,18,897350441
16165,134443040,102744852,237187892,3,0,0,64000,18,8692609392
16166,134448700,103646400,238095100,5,0,0,36864,12,10533591061
16167,134452170,105062537,239514707,5,0,0,13824,12,4203999436
16168,134458840,102826345,237285185,7,0,0,56832,1,9973076467
16169,134469000,102750068,237219068,6,0,0,12800,12,8056211604
16170,134469730,103108226,237577956,4,0,0,34304,7,10347914797
16171,134480030,103333982,237814012,3,0,0,18944,18,6031491643
16172,134492800,102722345,237215145,5,0,0,16384,12,3298182523
16173,134493550,103238005,237731555,6,0,0,33280,12,9050864474
16174,134508500,102795925,237304425,9,0,0,1024,4,181516988
16175,134516660,103671110,238187770,7,0,0,7168,1,4841150772
16176,134526690,102904460,237431150,8,0,0,36352,11,585470424
16177,134533280,102712598,237245878,5,0,0,4608,12,6870211420
16178,134534040,103271690,237805730,9,0,0,35328,4,2242373150
16179,134557050,102958291,237515341,7,0,0,6656,1,3397076925
16180,134569540,103339798,237909338,1,0,0,33792,1,8061483199
16181,134571050,103318550,237889600,8,0,0,29696,11,7856738729
16182,134590820,134518077,269108897,0,0,1,74240,6,8641037655
16183,134627140,134744088,269371228,1,0,1,22528,1,10336447106
16184,134634710,102666462,237301172,0,0,0,4096,6,8164190733
16185,134644760,102579038,237223798,3,0,0,4608,18,9940532351
16186,134649410,103297957,237947367,7,0,0,39424,1,7977694199
16187,134652711,134718540,269371251,9,0,1,20480,4,6473930709
16188,134655050,102889041,237544091,0,0,0,70656,6,454314963
16189,134665980,102889700,237555680,9,0,0,20480,4,8269299162
16190,134666540,102543590,237210130,7,0,0,5120,1,5077879692
16191,134676990,134803535,269480525,4,0,1,44544,7,7625879495
16192,134682400,102996010,237678410,0,0,0,13824,6,10184557283
16193,134702430,102925546,237627976,2,0,0,8192,1,5098042946
16194,134704409,134776139,269480548,5,0,1,9728,12,5931268433
16195,134710480,103183511,237893991,3,0,0,14336,18,9738984378
16196,134725550,102796990,237522540,7,0,0,23552,1,8636495948
16197,134728370,103108122,237836492,5,0,0,12288,12,10084656898
16198,134739970,102920375,237660345,1,0,0,23552,1,8640783478
16199,134752280,103416813,238169093,5,0,0,112640,12,9324071023
16200,134752800,134733566,269486366,6,0,1,25088,12,61016524
16201,134753720,104963913,239717633,2,0,0,43520,1,5123174573
16202,134758240,103311946,238070186,0,0,0,90624,6,2490225814
16203,134765680,103275744,238041424,1,0,0,22016,1,1451474214
16204,134770549,134759776,269530325,5,0,1,17408,12,126063521
16205,134771780,103258279,238030059,8,0,0,149504,11,1607659900
16206,134781700,105071383,239853083,7,0,0,7680,1,1479831275
16207,134790950,102696077,237487027,1,0,0,35840,1,8633291152
16208,134805250,103367390,238172640,3,0,0,512,18,9182444832
16209,134809829,134720519,269530348,3,0,1,5632,18,6490170491
16210,134811830,103444445,238256275,9,0,0,9216,4,10453669372
16211,134816680,103490332,238307012,3,0,0,5120,18,5873048309
16212,134821330,103836196,238657526,4,0,0,40448,7,7320925833
16213,134825890,102822098,237647988,8,0,0,6144,11,6823225054
16214,134838400,103592044,238430444,2,0,0,12800,1,2535994875
16215,134840100,103000315,237840415,8,0,0,12800,11,8240643404
16216,134846260,103138109,237984369,0,0,0,27136,6,2385021289
16217,134848390,104264734,239113124,6,0,0,7680,12,3920084179
16218,134859689,134690852,269550541,5,0,1,16896,12,3848790500
16219,134860940,102933668,237794608,2,0,0,40960,1,4438364653
16220,134866770,103028047,237894817,3,0,0,2560,18,5502349700
16221,134874550,103360229,238234779,7,0,0,15360,1,8135857969
16222,134887290,103189627,238076917,4,0,0,22016,7,1089003600
16223,134898830,134651734,269550564,6,0,1,1536,12,2965544763
16224,134901290,102994798,237896088,0,0,0,4096,6,3903315784
16225,134906990,102900947,237807937,5,0,0,7168,12,4575985694
16226,134934380,103664060,238598440,0,0,0,122368,6,6067024783
16227,134937860,103292216,238230076,3,0,0,2048,18,5777527613
16228,134939090,103034531,237973621,3,0,0,59904,18,6641499423
16229,134946721,134603866,269550587,9,0,1,14848,4,10055059417
16230,134949271,134611190,269560461,9,0,1,15872,4,1625708102
16231,134952990,103288898,238241888,9,0,0,12800,4,1842886341
16232,134956850,103215565,238172415,7,0,0,10752,1,216199761
16233,134958340,104303506,239261846,6,0,0,40960,12,9835836355
16234,134970090,105144739,240114829,5,0,0,10752,12,9531522770
16235,134983250,103463129,238446379,9,0,0,52224,4,9771398981
16236,135007230,103390022,238397252,7,0,0,9728,1,1853723663
16237,135023460,103205969,238229429,3,0,0,73728,18,1861475306
16238,135027720,103346523,238374243,9,0,0,78336,4,9591612742
16239,135054400,103251029,238305429,4,0,0,64000,7,7790337331
16240,135075880,103962128,239038008,9,0,0,9728,4,8991403742
16241,135092110,105575463,240667573,4,0,0,10240,7,9308680921
16242,135095100,103085685,238180785,5,0,0,4096,12,782475634
16243,135109750,103501049,238610799,0,0,0,512,6,788354665
16244,135127860,103249994,238377854,8,0,0,11776,11,4142220095
16245,135128470,105064701,240193171,7,0,0,4608,1,5229172969
16246,135140810,103377042,238517852,5,0,0,102400,12,1792151574
16247,135149270,103311568,238460838,2,0,0,33280,1,10316848474
16248,135152430,103482201,238634631,5,0,0,18944,12,5435809480
16249,135153960,134406524,269560484,4,0,1,10752,7,4088689791
16250,135166890,103579941,238746831,8,0,0,62464,11,2766216647
16251,135178580,103244202,238422782,1,0,0,13312,1,8702767803
16252,135178910,103507109,238686019,1,0,0,73216,1,7199959123
16253,135187050,134432814,269619864,4,0,1,6144,7,2584722114
16254,135193550,104172804,239366354,2,0,0,34304,1,45371310
16255,135197120,103505468,238702588,7,0,0,18432,1,4113773173
16256,135197140,103407186,238604326,4,0,0,8704,7,3852611615
16257,135207270,103751708,238958978,4,0,0,7680,7,10657189367
16258,135212490,103318645,238531135,8,0,0,43520,11,135059231
16259,135212930,106214472,241427402,7,0,0,57856,1,1346246304
16260,135218850,103658630,238877480,0,0,0,28672,6,8977095954
16261,135219930,105618936,240838866,4,0,0,34816,7,4906926271
16262,135221130,103792286,239013416,4,0,0,79360,7,346319979
16263,135221211,134398676,269619887,9,0,1,11776,4,5210648077
16264,135234680,103314418,238549098,9,0,0,58880,4,9231470568
16265,135236000,134383910,269619910,0,0,1,2048,6,1882775328
16266,135238280,103575183,238813463,2,0,0,18432,1,7219464610
16267,135256720,104332798,239589518,0,0,0,100864,6,2060505177
16268,135263730,103520899,238784629,0,0,0,7168,6,9046898830
16269,135272970,104404382,239677352,1,0,0,66048,1,121092317
16270,135274380,104060876,239335256,8,0,0,9216,11,604953857
16271,135283130,103862433,239145563,5,0,0,19456,12,6420421560
16272,135296750,103264383,238561133,1,0,0,39424,1,6320300201
16273,135322690,103839120,239161810,8,0,0,53248,11,7766100841
16274,135323960,103844581,239168541,6,0,0,22016,12,5796245209
16275,135325890,103364988,238690878,2,0,0,15872,1,1903985279
16276,135329010,103478814,238807824,3,0,0,46592,18,1845899645
16277,135334350,104165456,239499806,6,0,0,44032,12,7594958854
16278,135336160,103457445,238793605,5,0,0,8192,12,4367516565
16279,135336939,134282994,269619933,3,0,1,1024,18,1129754836
16280,135341220,103414549,238755769,4,0,0,28160,7,6994914087
16281,135344560,106255356,241599916,3,0,0,36352,18,3833143283
16282,135349229,134270735,269619964,5,0,1,27648,12,1041419347
16283,135349530,103378246,238727776,0,0,0,24576,6,8966414861
16284,135356810,103715856,239072666,7,0,0,2048,1,6523141586
16285,135362840,106318506,241681346,3,0,0,38912,18,7343872458
16286,135373530,104527610,239901140,3,0,0,6144,18,7578475226
16287,135382320,106681088,242063408,0,0,0,58880,6,10654572525
16288,135417570,134210240,269627810,8,0,1,4608,11,8931842104
16289,135418850,103328316,238747166,4,0,0,1024,7,1066946581
16290,135438550,104397772,239836322,6,0,0,122880,12,1794476184
16291,135458550,103718750,239177300,5,0,0,28672,12,10473818864
16292,135472700,103413227,238885927,0,0,0,27648,6,609098184
16293,135473810,103847780,239321590,8,0,0,52224,11,7618741282
16294,135479580,134148253,269627833,4,0,1,3584,7,10459239638
16295,135486560,104499536,239986096,8,0,0,31232,11,492301277
16296,135488840,103775993,239264833,5,0,0,9728,12,1914661779
16297,135492670,103395019,238887689,6,0,0,5632,12,2295543426
16298,135508680,134119176,269627856,4,0,1,7168,7,937164149
16299,135511550,104087195,239598745,8,0,0,30208,11,2206201059
16300,135516540,104719010,240235550,8,0,0,21504,11,4807031209
16301,135517190,103522401,239039591,3,0,0,5120,18,8486024768
16302,135519450,103515540,239034990,3,0,0,17920,18,4434220154
16303,135560220,103964870,239525090,3,0,0,18432,18,8365928573
16304,135573340,103721542,239294882,5,0,0,14848,12,4366613543
16305,135573400,103810449,239383849,0,0,0,57344,6,301078541
16306,135574330,106159132,241733462,6,0,0,48640,12,7776080332
16307,135582770,103617173,239199943,8,0,0,74240,11,8395020329
16308,135586420,104056414,239642834,6,0,0,104448,12,7814504226
16309,135589000,106705103,242294103,7,0,0,27136,1,841751238
16310,135595860,107070737,242666597,1,0,0,44032,1,3104290750
16311,135603980,104482780,240086760,4,0,0,26112,7,1881076992
16312,135604510,103717571,239322081,3,0,0,1536,18,6301597287
16313,135616990,103738881,239355871,5,0,0,67584,12,6796248255
16314,135626030,134001849,269627879,4,0,1,4608,7,2695089034
16315,135628240,103485843,239114083,5,0,0,3072,12,3770750048
16316,135644260,106949838,242594098,4,0,0,775680,7,10589462389
16317,135645030,105204308,240849338,7,0,0,25088,1,10363490471
16318,135665610,104713471,240379081,0,0,0,13312,6,2963885231
16319,135665990,133961912,269627902,8,0,1,26112,11,4494201718
16320,135667920,104077796,239745716,0,0,0,57856,6,2056081090
16321,135684130,103586030,239270160,1,0,0,17408,1,6126335144
16322,135690920,103813400,239504320,3,0,0,512,18,2175111970
16323,135700180,133927745,269627925,0,0,1,15872,6,2512953484
16324,135711589,133916359,269627948,3,0,1,1536,18,6913477452
16325,135735640,104054893,239790533,4,0,0,10240,7,2702688061
16326,135736530,103780733,239517263,8,0,0,2048,11,3837021168
16327,135744460,104106260,239850720,7,0,0,43008,1,6258792314
16328,135754210,133873761,269627971,1,0,1,10752,1,8976541669
16329,135759850,104253544,240013394,7,0,0,36352,1,7688519167
16330,135764140,104023250,239787390,2,0,0,19968,1,7000447035
16331,135768670,104068923,239837593,6,0,0,4096,12,7623847172
16332,135773440,104601562,240375002,3,0,0,61440,18,4633598728
16333,135784430,103996853,239781283,2,0,0,26624,1,8723017307
16334,135792790,104180133,239972923,0,0,0,38912,6,8933691452
16335,135831179,133796815,269627994,5,0,1,9216,12,9851382064
16336,135833180,104127864,239961044,1,0,0,82432,1,8798403934
16337,135844010,105182622,241026632,3,0,0,91648,18,7962029619
16338,135844980,104024398,239869378,5,0,0,512,12,10110478122
16339,135858020,103845431,239703451,1,0,0,2560,1,8918528364
16340,135864520,104203466,240067986,6,0,0,47616,12,4082752141
16341,135886330,103865740,239752070,4,0,0,7680,7,6066218759
16342,135896220,104851574,240747794,2,0,0,5120,1,1765588887
16343,135913790,104164983,240078773,2,0,0,35328,1,2729755222
16344,135924900,103997989,239922889,8,0,0,16384,11,6513664365
16345,135932770,105177772,241110542,3,0,0,28160,18,5960830347
16346,135968480,104005714,239974194,5,0,0,4096,12,9898305594
16347,135978520,103768623,239747143,6,0,0,4608,12,7211382912
16348,135983610,133731167,269714777,6,0,1,36352,12,9548891163
16349,135984630,104407890,240392520,2,0,0,44032,1,3680014680
16350,135987370,104307268,240294638,3,0,0,54784,18,8956493576
16351,135988870,103944328,239933198,1,0,0,8192,1,9834161722
16352,135994230,104035505,240029735,6,0,0,9216,12,5837533494
16353,136002030,105192878,241194908,6,0,0,61952,12,4237513135
16354,136006630,133708403,269715033,0,0,1,9216,6,9441832638
16355,136012650,103963907,239976557,5,0,0,7680,12,1342459366
16356,136016540,104322677,240339217,6,0,0,2048,12,729773956
16357,136036000,104095845,240131845,3,0,0,14336,18,8083784820
16358,136059300,103994155,240053455,1,0,0,27648,1,4122108787
16359,136071990,103944235,240016225,2,0,0,9216,1,3871834572
16360,136074570,104432725,240507295,5,0,0,68608,12,796808267
16361,136078040,104256594,240334634,8,0,0,24064,11,8103560860
16362,136078239,133642286,269720525,5,0,1,17920,12,6587541912
16363,136078610,103959210,240037820,3,0,0,16896,18,547825294
16364,136092420,104343278,240435698,0,0,0,99328,6,5420970861
16365,136107580,104769990,240877570,7,0,0,38400,1,2854310249
16366,136109010,104229235,240338245,8,0,0,11776,11,6283961076
16367,136109580,104066398,240175978,4,0,0,4608,7,9573872418
16368,136124770,133881933,270006703,6,0,1,1024,12,8587386524
16369,136125550,104406002,240531552,1,0,0,28672,1,1815742251
16370,136130120,104385310,240515430,5,0,0,26624,12,5694931734
16371,136136170,105022433,241158603,8,0,0,13312,11,910400607
16372,136145950,133865520,270011470,6,0,1,3584,12,2221717472
16373,136153210,104784085,240937295,5,0,0,14848,12,5745266418
16374,136184390,103983107,240167497,4,0,0,2560,7,6594161251
16375,136186880,105209496,241396376,7,0,0,231936,1,4486519059
16376,136189710,104129840,240319550,6,0,0,50176,12,4351810456
16377,136222460,104500661,240723121,5,0,0,31232,12,5865643486
16378,136226970,104763774,240990744,1,0,0,58880,1,3630544110
16379,136228130,105359705,241587835,5,0,0,9728,12,5972335035
16380,136230190,106553100,242783290,8,0,0,63488,11,6516829609
16381,136246020,104667655,240913675,1,0,0,52736,1,2483644830
16382,136256320,104347858,240604178,6,0,0,69632,12,2030497441
16383,136267589,134152846,270420435,3,0,1,4608,18,6410423488
16384,136269360,105569817,241839177,0,0,0,51200,6,6453499485
16385,136271570,104626014,240897584,0,0,0,38400,6,323198093
16386,136282860,104239925,240522785,0,0,0,24064,6,10583848797
16387,136292370,104183135,240475505,7,0,0,57344,1,9244726611
16388,136304970,104306875,240611845,6,0,0,25088,12,9955761991
16389,136309250,134230753,270540003,0,0,1,1536,6,5044825469
16390,136325260,103944938,240270198,6,0,0,18944,12,1046980171
16391,136334400,104927505,241261905,8,0,0,33280,11,6742759217
16392,136338070,134201956,270540026,4,0,1,17408,7,9340868073
16393,136344570,104483665,240828235,2,0,0,18432,1,1889366877
16394,136347210,104446860,240794070,2,0,0,4096,1,4447169926
16395,136351320,104438492,240789812,2,0,0,113152,1,2305727157
16396,136352040,104852875,241204915,4,0,0,32768,7,2781970719
16397,136395960,105515637,241911597,6,0,0,7680,12,4278688195
16398,136396430,104217466,240613896,0,0,0,6656,6,10044326708
16399,136435510,104600996,241036506,2,0,0,32256,1,2693602811
16400,136442311,134186495,270628806,9,0,1,4096,4,103977914
16401,136451350,106377216,242828566,7,0,0,6144,1,8098587353
16402,136474480,104935248,241409728,2,0,0,17408,1,5461940812
16403,136481630,104311169,240792799,5,0,0,9728,12,9750625975
16404,136488610,104463255,240951865,6,0,0,31744,12,9858982697
16405,136490140,134138697,270628837,0,0,1,6144,6,6115834089
16406,136494300,104549717,241044017,3,0,0,24576,18,3978714696
16407,136507531,134170619,270678150,9,0,1,1024,4,2253571449
16408,136526701,134203202,270729903,9,0,1,39424,4,5035989434
16409,136533270,106435093,242968363,4,0,0,77824,7,3373507427
16410,136564880,104320981,240885861,7,0,0,27136,1,6342292190
16411,136572120,105368439,241940559,8,0,0,72192,11,3639817507
16412,136577010,104559101,241136111,0,0,0,45056,6,6415809498
16413,136584020,104255025,240839045,7,0,0,512,1,6113492034
16414,136593390,104640922,241234312,2,0,0,59392,1,10621532674
16415,136600920,104264927,240865847,1,0,0,2560,1,6921131300
16416,136605930,134125599,270731529,4,0,1,2560,7,4373328593
16417,136619610,104874247,241493857,3,0,0,49664,18,4606025255
16418,136624540,105357791,241982331,7,0,0,16896,1,2026031315
16419,136640820,104275374,240916194,7,0,0,8192,1,4572138975
16420,136646540,105450025,242096565,0,0,0,53760,6,4912530018
16421,136648950,105422281,242071231,8,0,0,25600,11,7449142952
16422,136649750,104790178,241439928,4,0,0,32256,7,1076567404
16423,136657470,104410130,241067600,0,0,0,49664,6,7204553872
16424,136660980,104953646,241614626,6,0,0,47104,12,9173129196
16425,136664840,134312742,270977582,0,0,1,53760,6,6521205919
16426,136671630,134308538,270980168,8,0,1,4096,11,6962229948
16427,136673690,104571253,241244943,5,0,0,34816,12,7430962568
16428,136680980,104566638,241247618,1,0,0,8704,1,3447659791
16429,136687210,104901607,241588817,0,0,0,2560,6,2372535460
16430,136693580,104882509,241576089,4,0,0,164864,7,691376331
16431,136697050,105588762,242285812,4,0,0,81920,7,5091147135
16432,136708900,104555836,241264736,8,0,0,9216,11,1826833839
16433,136716430,104762272,241478702,4,0,0,27136,7,611933650
16434,136747360,104468833,241216193,9,0,0,36864,4,4942075954
16435,136792159,134235429,271027588,5,0,1,15872,12,8814345344
16436,136797870,106226354,243024224,2,0,0,10240,1,3932305400
16437,136801990,104782858,241584848,1,0,0,28672,1,1545865488
16438,136810240,104590059,241400299,0,0,0,12800,6,3604917357
16439,136810300,104777714,241588014,6,0,0,512,12,4135827877
16440,136811130,104437915,241249045,1,0,0,4608,1,2980710691
16441,136812430,104617647,241430077,3,0,0,8704,18,9406681506
16442,136836520,104621458,241457978,8,0,0,29696,11,3702455732
16443,136846789,134184025,271030814,3,0,1,5120,18,1031275341
16444,136847640,134184557,271032197,6,0,1,14848,12,1269240960
16445,136850790,104767447,241618237,6,0,0,11776,12,5355733802
16446,136873390,105890533,242763923,2,0,0,49664,1,3917550782
16447,136876110,104724141,241600251,1,0,0,1024,1,6754840245
16448,136879470,104524128,241403598,8,0,0,10752,11,8297579274
16449,136882860,134277844,271160704,6,0,1,39936,12,9412187660
16450,136894170,105179892,242074062,5,0,0,9216,12,5703146898
16451,136902270,104391795,241294065,7,0,0,12800,1,2424479585
16452,136917750,104530077,241447827,1,0,0,23040,1,3154432910
16453,136917970,105883641,242801611,0,0,0,33792,6,1368438715
16454,136922500,104707630,241630130,4,0,0,7680,7,6657811408
16455,136937890,105695878,242633768,0,0,0,130048,6,2786616439
16456,136941740,105920857,242862597,5,0,0,111616,12,3675683990
16457,136948900,105400492,242349392,3,0,0,82944,18,7792873981
16458,136993640,106051979,243045619,7,0,0,70144,1,1583223647
16459,137000010,105667390,242667400,2,0,0,2560,1,7948632830
16460,137004309,134399641,271403950,3,0,1,34816,18,2294917413
16461,137010750,105933870,242944620,3,0,0,147968,18,8400413474
16462,137023870,104380531,241404401,8,0,0,2560,11,6947135639
16463,137024540,104634872,241659412,3,0,0,17920,18,7198527575
16464,137031940,106050743,243082683,3,0,0,10240,18,7490263756
16465,137046470,105702298,242748768,3,0,0,98304,18,843895924
16466,137048340,104797568,241845908,1,0,0,22016,1,1980133568
16467,137066000,104757554,241823554,4,0,0,31232,7,9379162433
16468,137067110,104428494,241495604,6,0,0,5632,12,5469899966
16469,137068230,104931484,241999714,5,0,0,12288,12,4881536828
16470,137073460,104917218,241990678,3,0,0,13312,18,3991617413
16471,137083940,104817848,241901788,4,0,0,34816,7,3948825087
16472,137091090,105109714,242200804,2,0,0,76288,1,4174189338
16473,137095680,104543954,241639634,8,0,0,3584,11,5647139026
16474,137118710,104926735,242045445,1,0,0,27136,1,6553886296
16475,137118730,106001345,243120075,4,0,0,53760,7,7965185753
16476,137152100,105101671,242253771,8,0,0,29184,11,6748071490
16477,137172730,134253784,271426514,8,0,1,21504,11,9117730775
16478,137173860,104795605,241969465,3,0,0,45056,18,7794601892
16479,137181730,104631324,241813054,4,0,0,9728,7,9674377735
16480,137182530,104976920,242159450,5,0,0,12800,12,8961945840
16481,137183290,105125656,242308946,4,0,0,48640,7,7053019192
16482,137214590,105104090,242318680,4,0,0,512,7,7201756969
16483,137214730,106022071,243236801,5,0,0,55296,12,6573525683
16484,137220050,104465063,241685113,3,0,0,12288,18,959372903
16485,137246520,105643891,242890411,1,0,0,58368,1,2961235277
16486,137246830,104708884,241955714,4,0,0,49664,7,5481211804
16487,137249460,106089682,243339142,7,0,0,2048,1,5575153106
16488,137287219,134149013,271436232,5,0,1,16384,12,8752571831
16489,137295550,134221995,271517545,6,0,1,16384,12,6296105166
16490,137305971,134217080,271523051,9,0,1,2048,4,2015197272
16491,137307240,134215834,271523074,4,0,1,2560,7,855753478
16492,137314070,104717048,242031118,4,0,0,13312,7,993938617
16493,137322780,104688524,242011304,0,0,0,16384,6,5740132321
16494,137329590,134193507,271523097,0,0,1,12800,6,8317439579
16495,137330839,134192281,271523120,3,0,1,1024,18,1030202973
16496,137348230,105731310,243079540,0,0,0,22016,6,6526573399
16497,137359750,104646539,242006289,2,0,0,21504,1,3404226346
16498,137360000,105623830,242983830,4,0,0,50688,7,4576390728
16499,137379140,105724524,243103664,5,0,0,45568,12,2963016171
16500,137390040,104625507,242015547,0,0,0,13824,6,951392928
16501,137405280,105667529,243072809,2,0,0,76288,1,85983480
16502,137405360,134136104,271541464,1,0,1,16896,1,6344128181
16503,137414540,105408645,242823185,2,0,0,8704,1,3369959916
16504,137428830,106006522,243435352,2,0,0,39424,1,9607009207
16505,137430430,105816378,243246808,4,0,0,32768,7,2202633513
16506,137441260,105211875,242653135,5,0,0,63488,12,8487197436
16507,137456140,104671949,242128089,1,0,0,30720,1,6059971864
16508,137464830,105253963,242718793,2,0,0,55296,1,5431497710
16509,137472210,105792071,243264281,0,0,0,15360,6,3376212421
16510,137476020,105225879,242701899,7,0,0,113152,1,4073801591
16511,137476490,106088792,243565282,3,0,0,26624,18,528899989
16512,137489270,105337393,242826663,5,0,0,8192,12,6013374707
16513,137500690,106274475,243775165,6,0,0,19968,12,7036650173
16514,137502940,134152174,271655114,8,0,1,39424,11,9343953063
16515,137507430,105495969,243003399,6,0,0,56832,12,8726093347
16516,137518960,105301550,242820510,6,0,0,61952,12,7931441443
16517,137519050,104599656,242118706,7,0,0,6144,1,235523493
16518,137524360,134159418,271683778,6,0,1,11264,12,282064637
16519,137528610,105866528,243395138,3,0,0,26112,18,4994635366
16520,137550300,106095287,243645587,4,0,0,22016,7,8882921418
16521,137555850,105664080,243219930,5,0,0,75264,12,840744635
16522,137558270,105339816,242898086,4,0,0,25088,7,2171161621
16523,137567700,105759728,243327428,4,0,0,6656,7,2406238587
16524,137570250,105799649,243369899,4,0,0,28160,7,3465192940
16525,137578100,105600584,243178684,0,0,0,79872,6,8779062668
16526,137594450,104758085,242352535,6,0,0,10240,12,8046482570
16527,137601749,134082068,271683817,5,0,1,2048,12,6280756572
16528,137606370,105379690,242986060,3,0,0,3584,18,2148174572
16529,137623350,105167607,242790957,0,0,0,25088,6,1596438658
16530,137628200,105163092,242791292,1,0,0,1024,1,7535612486
16531,137632660,134078401,271711061,0,0,1,14848,6,3842575590
16532,137637700,134079046,271716746,4,0,1,4096,7,1638132530
16533,137644430,134072347,271716777,6,0,1,9216,12,6229779909
16534,137647790,105909357,243557147,2,0,0,60416,1,7215873308
16535,137666150,105835945,243502095,5,0,0,79872,12,3049008627
16536,137684420,105188184,242872604,1,0,0,32768,1,4043538784
16537,137692010,105132134,242824144,2,0,0,3072,1,6673555917
16538,137711200,105188313,242899513,4,0,0,4608,7,9982521406
16539,137718110,105302971,243021081,1,0,0,54272,1,2279332365
16540,137734730,105836971,243571701,1,0,0,20992,1,1332209855
16541,137740220,105244725,242984945,3,0,0,3584,18,8068345512
16542,137748580,105448395,243196975,0,0,0,55808,6,674989372
16543,137764750,105325007,243089757,3,0,0,2048,18,5153391080
16544,137765550,133951250,271716800,4,0,1,14848,7,4873614230
16545,137775180,105313922,243089102,0,0,0,20992,6,2777936461
16546,137775850,105228672,243004522,2,0,0,3584,1,8167356009
16547,137786040,105852816,243638856,4,0,0,21504,7,5943023665
16548,137787900,105503414,243291314,1,0,0,75776,1,3198695998
16549,137820050,105229492,243049542,7,0,0,12800,1,3353398573
16550,137825850,133940985,271766835,6,0,1,512,12,6061313389
16551,137830570,106361338,244191908,8,0,0,65024,11,4892353353
16552,137841190,105884703,243725893,5,0,0,59904,12,5927673580
16553,137845280,105282626,243127906,2,0,0,25600,1,7741332042
16554,137858370,105295955,243154325,3,0,0,52736,18,2276305553
16555,137858950,105664414,243523364,1,0,0,12288,1,7891021664
16556,137860860,105271498,243132358,0,0,0,14336,6,5511336868
16557,137867910,105764371,243632281,4,0,0,48128,7,802275079
16558,137870520,133896338,271766858,6,0,1,12288,12,5562798082
16559,137892330,105916273,243808603,2,0,0,2560,1,4924553668
16560,137896170,106119547,244015717,3,0,0,40960,18,3677869244
16561,137907220,133895940,271803160,6,0,1,15872,12,8653143295
16562,137920120,105816560,243736680,1,0,0,35328,1,1347908293
16563,137926300,105580689,243506989,1,0,0,4096,1,747566556
16564,137933250,105741646,243674896,3,0,0,42496,18,494991828
16565,137940860,105562202,243503062,6,0,0,3072,12,5085590751
16566,137948390,105967463,243915853,3,0,0,35840,18,7367849102
16567,137950950,106307795,244258745,1,0,0,73216,1,9835771134
16568,137976650,105841483,243818133,0,0,0,6656,6,4258976618
16569,137981380,105472825,243454205,5,0,0,16384,12,542912504
16570,137982570,105669280,243651850,6,0,0,20480,12,3605162214
16571,137982910,105397483,243380393,6,0,0,25600,12,6531731350
16572,137996290,105542426,243538716,2,0,0,16896,1,1681147021
16573,138006930,106338211,244345141,1,0,0,30720,1,4531427757
16574,138013420,133794246,271807666,8,0,1,7168,11,1910990001
16575,138016160,105802152,243818312,0,0,0,512,6,5887685353
16576,138027670,105392326,243419996,8,0,0,21504,11,6480322699
16577,138037049,133834246,271871295,5,0,1,17408,12,3742480834
16578,138038680,106102170,244140850,3,0,0,71168,18,1562371601
16579,138049380,133825141,271874521,8,0,1,5120,11,2477834058
16580,138054930,105652688,243707618,2,0,0,56320,1,4122897923
16581,138071080,105406656,243477736,2,0,0,37376,1,8819474063
16582,138073900,105680587,243754487,8,0,0,58368,11,6510851326
16583,138082290,105806564,243888854,8,0,0,34816,11,2686709784
16584,138089219,133789808,271879027,3,0,1,7168,18,7921356934
16585,138100220,105877881,243978101,4,0,0,12288,7,1144902887
16586,138109060,106063013,244172073,5,0,0,102400,12,4270627750
16587,138114220,105256950,243371170,7,0,0,4096,1,1282912557
16588,138116310,105758976,243875286,0,0,0,34304,6,7335447941
16589,138120900,106332797,244453697,0,0,0,34304,6,7631147735
16590,138161489,133728766,271890255,3,0,1,35840,18,4610486105
16591,138179700,105474513,243654213,8,0,0,7680,11,7454771807
16592,138184360,105915111,244099471,5,0,0,91136,12,8692806221
16593,138201630,133848234,272049864,6,0,1,28160,12,7393808535
16594,138202300,105741166,243943466,8,0,0,52736,11,1250755553
16595,138203890,106400855,244604745,3,0,0,49152,18,6904454383
16596,138209790,106125945,244335735,4,0,0,28672,7,4578010912
16597,138210750,106569857,244780607,5,0,0,24064,12,4121221539
16598,138212310,105689577,243901887,4,0,0,8192,7,7817701491
16599,138215389,133834498,272049887,3,0,1,5120,18,6260781986
16600,138219710,105460357,243680067,1,0,0,16896,1,10585466275
16601,138222570,105810876,244033446,4,0,0,24576,7,2538887572
16602,138230870,106050728,244281598,3,0,0,74752,18,1133500830
16603,138249620,134386921,272636541,2,0,1,182784,1,4220850963
16604,138253360,134437803,272691163,6,0,1,26624,12,2245925475
16605,138261060,105798801,244059861,8,0,0,16384,11,10720986729
16606,138279240,106113405,244392645,2,0,0,27136,1,10685081292
16607,138279820,106386636,244666456,8,0,0,41472,11,2857658913
16608,138287700,106142996,244430696,3,0,0,48640,18,6426342906
16609,138300700,106538740,244839440,8,0,0,17920,11,1592735711
16610,138305370,134385824,272691194,6,0,1,20992,12,8651829479
16611,138306310,105930104,244236414,5,0,0,123392,12,9643886162
16612,138316780,105979414,244296194,4,0,0,1536,7,5808549379
16613,138333100,106555254,244888354,2,0,0,112128,1,9906143923
16614,138346790,106011441,244358231,0,0,0,16384,6,8147586297
16615,138349680,134341537,272691217,6,0,1,5120,12,5094131825
16616,138350500,106473879,244824379,1,0,0,60416,1,10445371766
16617,138351250,105847545,244198795,4,0,0,22528,7,6949191217
16618,138359630,134739288,273098918,2,0,1,176128,1,5617390867
16619,138359790,106397169,244756959,3,0,0,296960,18,10179340736
16620,138363020,106130348,244493368,7,0,0,25600,1,6523033979
16621,138373470,106069729,244443199,2,0,0,40960,1,6169467302
16622,138376110,134758560,273134670,4,0,1,12800,7,135589911
16623,138382200,134752816,273135016,8,0,1,512,11,5634849710
16624,138390530,106109147,244499677,5,0,0,20480,12,2991454201
16625,138393420,106562745,244956165,0,0,0,87552,6,3878076627
16626,138394280,106195466,244589746,7,0,0,26624,1,1121329947
16627,138396210,106445913,244842123,7,0,0,8704,1,9161248487
16628,138404000,106361718,244765718,5,0,0,28672,12,8162520778
16629,138421050,106351711,244772761,5,0,0,23040,12,4727085548
16630,138445170,106208627,244653797,2,0,0,35328,1,10523955874
16631,138449800,106356148,244805948,2,0,0,30208,1,6386650148
16632,138460410,106063212,244523622,6,0,0,33280,12,556757352
16633,138487880,106472972,244960852,3,0,0,6144,18,5013179645
16634,138500040,106642610,245142650,5,0,0,14848,12,7913909737
16635,138509050,106783342,245292392,6,0,0,38400,12,5376246234
16636,138529750,105578113,244107863,6,0,0,3584,12,2112996239
16637,138549200,106905711,245454911,9,0,0,33792,4,2403811550
16638,138553430,106365257,244918687,0,0,0,24576,6,76199923
16639,138570220,105775256,244345476,2,0,0,1024,1,10127570091
16640,138573610,134562712,273136322,8,0,1,2048,11,10003491462
16641,138580510,134575588,273156098,6,0,1,19968,12,5363112699
16642,138584090,106189162,244773252,8,0,0,1536,11,5338224687
16643,138593960,106587493,245181453,6,0,0,33280,12,4214610081
16644,138599530,106234427,244833957,0,0,0,26624,6,58557940
16645,138602050,105911386,244513436,7,0,0,45056,1,5233779239
16646,138617550,106293626,244911176,1,0,0,48640,1,2806628909
16647,138635279,134520842,273156121,3,0,1,3072,18,3030649800
16648,138652729,134591301,273244030,3,0,1,34816,18,4444227763
16649,138672420,106924307,245596727,0,0,0,112128,6,4401762486
16650,138681740,106341631,245023371,5,0,0,10240,12,9061129550
16651,138688470,107126474,245814944,8,0,0,40448,11,9783959220
16652,138705960,135144937,273850897,2,0,1,435712,1,363948215
16653,138707720,107268733,245976453,8,0,0,101888,11,9114834458
16654,138725230,106931688,245656918,6,0,0,11264,12,1443480345
16655,138739120,106807889,245547009,7,0,0,78848,1,4117744991
16656,138740770,107281896,246022666,8,0,0,52736,11,8271653782
16657,138743340,107428188,246171528,9,0,0,11776,4,8234559189
16658,138748210,135102943,273851153,0,0,1,9216,6,364052042
16659,138755840,107511696,246267536,9,0,0,31232,4,8962136816
16660,138780039,135095701,273875740,3,0,1,1536,18,6780695582
16661,138780110,106016611,244796721,5,0,0,39424,12,4594112857
16662,138795970,106375251,245171221,1,0,0,93696,1,6462931929
16663,138799530,107048197,245847727,0,0,0,107520,6,6743628358
16664,138807241,135073005,273880246,9,0,1,7168,4,10249066630
16665,138808520,106714442,245522962,2,0,0,79360,1,7142028573
16666,138818110,135125033,273943143,8,0,1,53248,11,2221656389
16667,138832200,106612392,245444592,1,0,0,56320,1,3652442679
16668,138836780,106090022,244926802,7,0,0,13824,1,5133226106
16669,138844779,135099350,273944129,5,0,1,1536,12,2300955521
16670,138847500,105937186,244784686,7,0,0,13312,1,7084467075
16671,138852270,105973552,244825822,2,0,0,4608,1,2344508764
16672,138853400,106542740,245396140,4,0,0,32256,7,8089291394
16673,138867970,106779841,245647811,4,0,0,68096,7,10443731020
16674,138868870,106331794,245200664,2,0,0,62976,1,2809663242
16675,138870980,106025353,244896333,6,0,0,26112,12,7041342358
16676,138871590,106332153,245203743,0,0,0,5120,6,5968277222
16677,138876140,106744501,245620641,2,0,0,32256,1,4572255011
16678,138878160,106469300,245347460,9,0,0,20480,4,1664021730
16679,138889710,106851846,245741556,8,0,0,86016,11,2487079372
16680,138895640,106326416,245222056,8,0,0,31744,11,6403451427
16681,138896510,106756922,245653432,5,0,0,16384,12,209876576
16682,138900820,106301271,245202091,7,0,0,4608,1,10294966386
16683,138904079,135044275,273948354,3,0,1,15872,18,10124524776
16684,138912140,135039440,273951580,4,0,1,5120,7,4581675971
16685,138930580,106680210,245610790,3,0,0,46080,18,8349400703
16686,138943550,107188263,246131813,5,0,0,38912,12,1717174214
16687,138944270,107456577,246400847,9,0,0,2560,4,6930707199
16688,138953820,107740276,246694096,9,0,0,4096,4,5482869993
16689,138956490,135125235,274081725,2,0,1,174592,1,8040137602
16690,138964410,106450629,245415039,1,0,0,61952,1,597817423
16691,138971150,106798456,245769606,2,0,0,512,1,8484595031
16692,138974500,107679858,246654358,2,0,0,20992,1,10725058528
16693,138975360,106355230,245330590,3,0,0,44032,18,3203515487
16694,138984510,106478536,245463046,5,0,0,26624,12,6872557377
16695,138986750,106814576,245801326,0,0,0,102400,6,5141708783
16696,138999250,106946090,245945340,2,0,0,61952,1,1723050208
16697,139001630,135139942,274141572,0,0,1,27136,6,2792328324
16698,139003060,106421362,245424422,2,0,0,30720,1,5126785982
16699,139006340,135157598,274163938,8,0,1,1536,11,4456531527
16700,139016899,135147193,274164092,3,0,1,8704,18,4426267773
16701,139017430,106609474,245626904,7,0,0,20480,1,3131980138
16702,139018150,107600151,246618301,5,0,0,241152,12,3462392628
16703,139018328,135173178,274191506,8,0,1,5120,11,5221813571
16704,139020350,107181951,246202301,1,0,0,62464,1,9167552363
16705,139029250,107243998,246273248,5,0,0,4608,12,8123540209
16706,139030230,106827395,245857625,8,0,0,24576,11,7233854418
16707,139032040,107382714,246414754,5,0,0,45568,12,9894229902
16708,139032620,107071809,246104429,1,0,0,35840,1,3326827957
16709,139049970,107590577,246640547,4,0,0,5632,7,1389734909
16710,139051080,106698455,245749535,1,0,0,26112,1,3679329596
16711,139072440,106822644,245895084,3,0,0,23040,18,7815322164
16712,139074540,107446805,246521345,7,0,0,18432,1,10186554524
16713,139107300,107401392,246508692,3,0,0,20992,18,3868438074
16714,139127820,107675578,246803398,2,0,0,49152,1,8685219464
16715,139144850,106657747,245802597,0,0,0,4096,6,1615867033
16716,139148830,106927075,246075905,0,0,0,56320,6,1188270594
16717,139151770,135042322,274194092,4,0,1,4096,7,6930219467
16718,139157710,106595638,245753348,0,0,0,12288,6,4962836612
16719,139162030,107614831,246776861,8,0,0,13312,11,2879766782
16720,139162760,107831895,246994655,9,0,0,36352,4,7168298706
16721,139202670,107797000,246999670,4,0,0,16384,7,3988988903
16722,139219350,107100282,246319632,6,0,0,73216,12,393497813
16723,139219820,106442781,245662601,1,0,0,4608,1,9097121981
16724,139222030,135106539,274328569,2,0,1,111616,1,6910374785
16725,139231170,107166327,246397497,4,0,0,15360,7,10206818771
16726,139232950,107663292,246896242,5,0,0,31232,12,3722974667
16727,139260070,107459216,246719286,1,0,0,15360,1,6084663370
16728,139266280,107126140,246392420,3,0,0,131072,18,10399674034
16729,139267290,107682876,246950166,7,0,0,135680,1,3943598666
16730,139280990,107263812,246544802,7,0,0,27648,1,4197760734
16731,139298800,107881206,247180006,9,0,0,62976,4,4733668526
16732,139306380,135091937,274398317,0,0,1,8192,6,4446642611
16733,139311090,107144538,246455628,2,0,0,27648,1,9368598109
16734,139322450,106654392,245976842,4,0,0,1024,7,3187187585
16735,139370150,107689526,247059676,5,0,0,57344,12,6594310019
16736,139387400,107799337,247186737,6,0,0,22016,12,1125785565
16737,139389540,106961494,246351034,2,0,0,48640,1,3437828122
16738,139391710,135006630,274398340,4,0,1,2560,7,4900189921
16739,139400510,107969075,247369585,7,0,0,40448,1,3600496925
16740,139403450,106932741,246336191,8,0,0,54272,11,9620987308
16741,139404990,106889710,246294700,9,0,0,1024,4,9818078746
16742,139429480,106808839,246238319,4,0,0,28672,7,1097334627
16743,139436330,107633688,247070018,5,0,0,17408,12,5064426273
16744,139438721,134959642,274398363,9,0,1,19968,4,7614581192
16745,139442180,106739518,246181698,0,0,0,14848,6,8447200825
16746,139451180,106941575,246392755,3,0,0,1024,18,9792595828
16747,139465610,108510939,247976549,9,0,0,296960,4,8076608109
16748,139470180,107880928,247351108,9,0,0,184832,4,8104003130
16749,139478090,134921044,274399134,8,0,1,2048,11,497363961
16750,139498250,106645852,246144102,1,0,0,22528,1,222305349
16751,139503211,134913491,274416702,9,0,1,2560,4,8025085270
16752,139504450,106600158,246104608,1,0,0,512,1,8938325418
16753,139512980,107451945,246964925,8,0,0,17920,11,4764415398
16754,139514270,107701348,247215618,0,0,0,26624,6,2804936237
16755,139516800,107220101,246736901,8,0,0,8192,11,6059258372
16756,139542291,134907558,274449849,9,0,1,26624,4,10360523884
16757,139542530,106706238,246248768,5,0,0,3584,12,9872431536
16758,139594650,106757811,246352461,5,0,0,4608,12,7695981890
16759,139598640,107996377,247595017,6,0,0,26624,12,4433603764
16760,139599050,107532158,247131208,5,0,0,96768,12,2683263659
16761,139606380,107058082,246664462,2,0,0,13824,1,9680806647
16762,139610630,107090522,246701152,5,0,0,2048,12,4982922746
16763,139616860,107484841,247101701,0,0,0,51200,6,4220414321
16764,139627070,107003069,246630139,3,0,0,4096,18,10164106638
16765,139631030,106837695,246468725,8,0,0,32256,11,5422423704
16766,139631310,134900019,274531329,4,0,1,22016,7,7479255301
16767,139632940,107560528,247193468,5,0,0,22016,12,8855923153
16768,139634050,106836680,246470730,5,0,0,3584,12,6497457287
16769,139642330,107637481,247279811,6,0,0,29696,12,4031730092
16770,139644100,107759749,247403849,0,0,0,26112,6,7100893257
16771,139645020,107894436,247539456,8,0,0,81920,11,5870336922
16772,139649320,134936825,274586145,4,0,1,44032,7,8535822231
16773,139665480,108831531,248497011,9,0,0,493056,4,8367668308
16774,139668950,107723769,247392719,3,0,0,69120,18,471678351
16775,139674621,134976708,274651329,9,0,1,17408,4,4509410659
16776,139681180,107548813,247229993,1,0,0,47104,1,1085131976
16777,139681230,108440056,248121286,3,0,0,25600,18,5882838540
16778,139701680,134969819,274671499,8,0,1,6144,11,1503872131
16779,139719510,108564354,248283864,7,0,0,192512,1,614649871
16780,139719680,107345011,247064691,1,0,0,16384,1,7208149426
16781,139719880,134951650,274671530,0,0,1,9216,6,1778800817
16782,139726360,135223044,274949404,2,0,1,109568,1,10522185181
16783,139742110,108267736,248009846,4,0,0,62464,7,8972464884
16784,139758760,107268915,247027675,3,0,0,20480,18,7310970160
16785,139760690,108333438,248094128,0,0,0,90112,6,1812917917
16786,139768750,135280210,275048960,6,0,1,44544,12,9974953924
16787,139771420,135443966,275215386,8,0,1,10752,11,10291142335
16788,139782560,107879036,247661596,4,0,0,34816,7,5190824820
16789,139784460,135440931,275225391,6,0,1,6656,12,4946217741
16790,139785050,107932062,247717112,3,0,0,36864,18,6214267868
16791,139786510,107570081,247356591,6,0,0,17920,12,7846369653
16792,139804350,108038579,247842929,9,0,0,27648,4,8548393391
16793,139808070,108330578,248138648,6,0,0,56832,12,7232605645
16794,139808200,107436355,247244555,5,0,0,9216,12,8507191376
16795,139824829,135421736,275246565,5,0,1,34816,12,4065810926
16796,139837630,107247002,247084632,9,0,0,11264,4,8243368512
16797,139842950,107922876,247765826,7,0,0,3584,1,10076958926
16798,139851740,107555564,247407304,6,0,0,11264,12,2776499720
16799,139859550,108715911,248575461,3,0,0,48128,18,4844970131
16800,139860780,107868546,247729326,9,0,0,36352,4,9260078967
16801,139876490,107696939,247573429,5,0,0,37376,12,3495374136
16802,139876530,107613325,247489855,9,0,0,41472,4,9889051747
16803,139888750,107352966,247241716,3,0,0,38400,18,623823361
16804,139889700,108101091,247990791,5,0,0,20480,12,9561713882
16805,139890940,107902933,247793873,5,0,0,25088,12,1055112476
16806,139892240,108431028,248323268,6,0,0,41984,12,731732693
16807,139904610,108405843,248310453,7,0,0,60928,1,5785111302
16808,139908199,135338389,275246588,5,0,1,13312,12,8152306366
16809,139910000,107506469,247416469,8,0,0,23552,11,3576506230
16810,139930210,108672480,248602690,2,0,0,53760,1,10233980145
16811,139930360,107720605,247650965,9,0,0,27136,4,9738530048
16812,139937830,107269653,247207483,4,0,0,18944,7,2831906178
16813,139951770,135307679,275259449,0,0,1,4608,6,7787846011
16814,139956750,108027778,247984528,8,0,0,26112,11,5778578316
16815,139970920,108071170,248042090,5,0,0,29184,12,630102446
16816,139981070,108555611,248536681,4,0,0,117248,7,10226839874
16817,140000610,107371026,247371636,9,0,0,6656,4,7484229442
16818,140012090,108764387,248776477,7,0,0,97792,1,5786156165
16819,140029030,107988240,248017270,5,0,0,15360,12,5469955509
16820,140043600,107693705,247737305,1,0,0,26112,1,4380576753
16821,140049520,108294877,248344397,9,0,0,62464,4,6498953294
16822,140078680,107587931,247666611,2,0,0,16384,1,1754097281
16823,140080840,107276398,247357238,7,0,0,2048,1,9576382449
16824,140089870,107305992,247395862,9,0,0,10240,4,10069422170
16825,140099540,108533905,248633445,1,0,0,100864,1,2457353069
16826,140132760,107128704,247261464,9,0,0,4608,4,1294756692
16827,140176220,108621542,248797762,0,0,0,46592,6,6130802867
16828,140182080,107378091,247560171,3,0,0,1024,18,3432635704
16829,140186201,135089886,275276087,9,0,1,28672,4,1689039688
16830,140199090,108355733,248554823,2,0,0,24064,1,6405290191
16831,140206060,107214837,247420897,9,0,0,10240,4,9902926901
16832,140206950,108710391,248917341,4,0,0,54784,7,878741242
16833,140220400,108526258,248746658,5,0,0,37376,12,9769320822
16834,140224860,135154429,275379289,0,0,1,16384,6,8595858207
16835,140224880,107444874,247669754,2,0,0,10240,1,1724652059
16836,140228710,108444584,248673294,6,0,0,87040,12,7897584736
16837,140241071,135139089,275380160,9,0,1,12288,4,10240038807
16838,140245220,108820123,249065343,6,0,0,20992,12,7367506373
16839,140249231,135132555,275381786,9,0,1,2560,4,7474180730
16840,140249820,108392228,248642048,0,0,0,28160,6,8626215958
16841,140255950,107462277,247718227,0,0,0,3584,6,4097366610
16842,140266350,107367364,247633714,6,0,0,8192,12,1691585584
16843,140270150,108442510,248712660,5,0,0,84992,12,9576595697
16844,140276149,135120385,275396534,5,0,1,11776,12,6327805413
16845,140277660,107483232,247760892,7,0,0,8192,1,8065124463
16846,140307700,107363637,247671337,1,0,0,5120,1,4646411608
16847,140311930,135201180,275513110,4,0,1,26112,7,4990478041
16848,140313100,107385237,247698337,4,0,0,16384,7,6009377407
16849,140314400,108420847,248735247,6,0,0,512,12,8653448449
16850,140331041,135214822,275545863,9,0,1,8704,4,5501939813
16851,140353760,135876437,276230197,2,0,1,334336,1,4765832548
16852,140356680,108765828,249122508,2,0,0,20992,1,5471641517
16853,140359810,108509227,248869037,1,0,0,57856,1,1007640526
16854,140364930,108216326,248581256,1,0,0,18944,1,7555116071
16855,140374560,107774430,248148990,9,0,0,21504,4,8161880601
16856,140384670,135954140,276338810,4,0,1,4608,7,5292270701
16857,140392271,135950246,276342517,9,0,1,18944,4,9518282834
16858,140398380,108572266,248970646,5,0,0,54272,12,2594433425
16859,140404770,108330298,248735068,9,0,0,31232,4,5046783470
16860,140412910,108487716,248900626,8,0,0,28160,11,5112621788
16861,140414380,108612761,249027141,3,0,0,185344,18,10627024294
16862,140418750,107593817,248012567,9,0,0,8704,4,7760407076
16863,140423700,108630140,249053840,5,0,0,87552,12,3096901364
16864,140428660,107896682,248325342,6,0,0,2048,12,8756162551
16865,140456860,107652510,248109370,3,0,0,9216,18,7074106700
16866,140468670,107856025,248324695,5,0,0,4608,12,2650395852
16867,140472380,107344324,247816704,5,0,0,12288,12,10723377480
16868,140472580,107669835,248142415,4,0,0,12288,7,6728266418
16869,140477740,107747445,248225185,7,0,0,84480,1,5644486693
16870,140480990,107865770,248346760,1,0,0,7680,1,2302331689
16871,140483840,107807847,248291687,5,0,0,25600,12,4227785849
16872,140488590,108294930,248783520,9,0,0,23040,4,1914348521
16873,140491230,107541945,248033175,5,0,0,32768,12,2638337114
16874,140493770,108666128,249159898,1,0,0,43008,1,4573335209
16875,140505340,108553584,249058924,9,0,0,16384,4,7132248821
16876,140507950,135936275,276444225,8,0,1,27136,11,6346326961
16877,140512780,135942255,276455035,6,0,1,2560,12,420946127
16878,140521890,108619771,249141661,0,0,0,27648,6,1862523863
16879,140522620,108562136,249084756,9,0,0,63488,4,10008806927
16880,140527640,108316604,248844244,7,0,0,28672,1,2052839016
16881,140528540,108709775,249238315,2,0,0,61440,1,5058154996
16882,140534180,135920878,276455058,1,0,1,16384,1,5423043695
16883,140545300,135927908,276473208,8,0,1,23552,11,1862612346
16884,140564030,107727836,248291866,1,0,0,512,1,6649768341
16885,140566680,108808066,249374746,0,0,0,85504,6,6862588235
16886,140572570,108589691,249162261,5,0,0,7680,12,1089028374
16887,140590960,136111467,276702427,2,0,1,86016,1,4075380699
16888,140595620,108953025,249548645,1,0,0,39424,1,1863492347
16889,140601040,107946428,248547468,8,0,0,35328,11,1499241537
16890,140619210,108691791,249311001,6,0,0,19456,12,4926912453
16891,140624690,108022061,248646751,4,0,0,15360,7,1220843680
16892,140624921,136077529,276702450,9,0,1,6656,4,7639280474
16893,140639640,108819137,249458777,0,0,0,49664,6,5292935053
16894,140652710,108867837,249520547,1,0,0,13824,1,5647891408
16895,140653860,107847074,248500934,9,0,0,12800,4,2876847495
16896,140655160,108269772,248924932,4,0,0,13312,7,7919255107
16897,140656280,107904494,248560774,3,0,0,19456,18,6398453406
16898,140664990,108136383,248801373,8,0,0,11776,11,4404776980
16899,140668880,108722893,249391773,8,0,0,55808,11,3155117305
16900,140672880,108820264,249493144,6,0,0,39424,12,7259299049
16901,140683720,108003021,248686741,8,0,0,44032,11,4401847865
16902,140684450,108422396,249106846,1,0,0,30208,1,9391284152
16903,140695140,107891147,248586287,5,0,0,16384,12,4650290746
16904,140700050,108768714,249468764,5,0,0,12800,12,2979162383
16905,140706870,108018651,248725521,0,0,0,34816,6,7731736461
16906,140715950,107997669,248713619,7,0,0,3072,1,7859126626
16907,140722550,107992340,248714890,5,0,0,4096,12,9434897507
16908,140727160,135975313,276702473,6,0,1,512,12,7079159929
16909,140736141,135966355,276702496,9,0,1,8192,4,1228598742
16910,140747030,108533873,249280903,3,0,0,4608,18,9240964617
16911,140760120,108544930,249305050,8,0,0,28160,11,5039608549
16912,140762020,136339363,277101383,2,0,1,116224,1,8338370169
16913,140774430,108117585,248892015,0,0,0,39936,6,7012404842
16914,140777030,108841912,249618942,1,0,0,49664,1,10174369714
16915,140789110,109235610,250024720,1,0,0,93696,1,6859052089
16916,140806650,108702260,249508910,8,0,0,17408,11,4009973268
16917,140814730,108649911,249464641,6,0,0,10240,12,9120595171
16918,140831340,108048484,248879824,7,0,0,35328,1,2142475095
16919,140844750,108241277,249086027,9,0,0,4096,4,8189223319
16920,140845070,136272146,277117216,0,0,1,4608,6,7289344091
16921,140850330,109355090,250205420,6,0,0,13312,12,3600093892
16922,140853890,109291152,250145042,4,0,0,17920,7,6964889808
16923,140860810,108454959,249315769,5,0,0,1536,12,6878573255
16924,140869400,108379234,249248634,8,0,0,33792,11,8034397561
16925,140877030,109284007,250161037,2,0,0,35328,1,3257489639
16926,140882780,108560842,249443622,6,0,0,66048,12,4709065533
16927,140896330,108377652,249273982,1,0,0,52224,1,7911599756
16928,140903300,109524217,250427517,9,0,0,17920,4,5471411151
16929,140934640,109033329,249967969,1,0,0,84480,1,10498615556
16930,140939470,108454221,249393691,1,0,0,6144,1,1285115396
16931,140940460,108698907,249639367,2,0,0,62976,1,7476071092
16932,140950639,136166600,277117239,5,0,1,10752,12,3078899975
16933,140955810,108879685,249835495,5,0,0,109568,12,6702995220
16934,140956940,136256135,277213075,2,0,1,53248,1,803462293
16935,140994410,108132801,249127211,6,0,0,15360,12,7140111691
16936,141003450,136226903,277230353,8,0,1,10240,11,4708846058
16937,141008570,109043683,250052253,2,0,0,24576,1,9244980246
16938,141010990,108311802,249322792,2,0,0,15872,1,6068813879
16939,141026420,108705821,249732241,2,0,0,44032,1,5993313546
16940,141027610,108172451,249200061,2,0,0,33792,1,7109068339
16941,141029360,108840988,249870348,5,0,0,19456,12,10047102451
16942,141040770,136198259,277239029,0,0,1,10752,6,6145645100
16943,141057550,108279061,249336611,1,0,0,29696,1,10280928137
16944,141060770,108336220,249396990,6,0,0,10752,12,5001879681
16945,141095270,108230977,249326247,4,0,0,11264,7,5962676518
16946,141097800,108438810,249536610,4,0,0,30720,7,3602905665
16947,141104310,108696930,249801240,1,0,0,13312,1,3394971941
16948,141108870,108351669,249460539,5,0,0,2048,12,5457501363
16949,141112880,109551888,250664768,7,0,0,3072,1,8561483767
16950,141118850,108769108,249887958,1,0,0,512,1,8839993589
16951,141128820,109348850,250477670,6,0,0,512,12,8461519865
16952,141130780,109437329,250568109,2,0,0,1536,1,3189095650
16953,141142271,136200641,277342912,9,0,1,57344,4,649756959
16954,141147389,136239889,277387278,3,0,1,22016,18,5709819626
16955,141170330,108249935,249420265,2,0,0,7168,1,10239821934
16956,141172030,136220420,277392450,6,0,1,8192,12,3789481586
16957,141181420,108588527,249769947,0,0,0,52736,6,5990335855
16958,141194230,108267268,249461498,2,0,0,3072,1,7738495805
16959,141223140,136172856,277395996,0,0,1,5632,6,5172090672
16960,141231620,109503150,250734770,9,0,0,19968,4,8446327794
16961,141232450,109359417,250591867,6,0,0,72704,12,3273118804
16962,141241010,136174584,277415594,8,0,1,9216,11,7580233583
16963,141243830,108474694,249718524,2,0,0,52736,1,3233912726
16964,141251210,108208682,249459892,4,0,0,3584,7,4349265511
16965,141281040,108306418,249587458,0,0,0,8192,6,10338934613
16966,141283790,137156401,278440191,2,0,1,294912,1,4702845717
16967,141298960,109268315,250567275,5,0,0,124928,12,6306353112
16968,141310560,108442006,249752566,3,0,0,23552,18,1462210149
16969,141314770,137417046,278731816,2,0,1,174592,1,3528048365
16970,141317840,108744264,250062104,9,0,0,32256,4,573587944
16971,141318200,137423646,278741846,8,0,1,15872,11,1221287216
16972,141331470,108796206,250127676,1,0,0,21504,1,8676333722
16973,141337340,108444283,249781623,9,0,0,37888,4,1217664291
16974,141357700,108504341,249862041,1,0,0,19456,1,1005592422
16975,141362910,137378959,278741869,6,0,1,10240,12,9095870384
16976,141366370,108663521,250029891,5,0,0,16896,12,4487680704
16977,141366700,108604412,249971112,0,0,0,10240,6,2280847694
16978,141372970,108736625,250109595,4,0,0,2560,7,10198588807
16979,141373380,108671354,250044734,3,0,0,48640,18,9213353026
16980,141388480,108720312,250108792,1,0,0,17408,1,3499657356
16981,141402240,108807918,250210158,1,0,0,7168,1,9094942174
16982,141406760,108913801,250320561,6,0,0,10752,12,5996647731
16983,141414970,108512540,249927510,0,0,0,8192,6,528919097
16984,141416370,108579779,249996149,5,0,0,1536,12,298167447
16985,141436970,108212773,249649743,4,0,0,512,7,8924973634
16986,141437230,108410479,249847709,9,0,0,38912,4,2253846492
16987,141438459,137303433,278741892,5,0,1,5632,12,3471684033
16988,141445260,109422134,250867394,9,0,0,110592,4,6486786639
16989,141475690,137266225,278741915,4,0,1,1024,7,3700049534
16990,141479080,108495331,249974411,2,0,0,10752,1,6377829649
16991,141479570,108356260,249835830,5,0,0,1024,12,115576898
16992,141484780,108510870,249995650,0,0,0,69632,6,6273193355
16993,141488990,108872889,250361879,3,0,0,18432,18,1497800201
16994,141490029,137251909,278741938,3,0,1,3584,18,9693838624
16995,141490820,108448279,249939099,0,0,0,34304,6,6236914037
16996,141506510,108631238,250137748,6,0,0,24064,12,9243396679
16997,141510980,108558635,250069615,6,0,0,24576,12,3640735357
16998,141521940,108568165,250090105,9,0,0,56832,4,7484500294
16999,141544330,137327945,278872275,4,0,1,48128,7,6523922354
17000,141547070,108683430,250230500,6,0,0,26112,12,9962298920
17001,141556950,108180300,249737250,9,0,0,1024,4,6488443438
17002,141565621,137371315,278936936,9,0,1,512,4,6165514207
17003,141575690,137371015,278946705,0,0,1,26624,6,3980376776
17004,141583480,108942721,250526201,4,0,0,8192,7,565000019
17005,141602250,108752875,250355125,2,0,0,65536,1,2686495184
17006,141603980,108499485,250103465,2,0,0,43520,1,9684370112
17007,141623470,109076149,250699619,8,0,0,94720,11,931154287
17008,141624870,109354695,250979565,5,0,0,20992,12,759163878
17009,141650100,108588379,250238479,0,0,0,26112,6,3044421987
17010,141662980,108860702,250523682,2,0,0,40960,1,1298110968
17011,141663520,109137769,250801289,6,0,0,18944,12,10611304130
17012,141665510,109415317,251080827,6,0,0,120320,12,4003438003
17013,141684210,108941856,250626066,0,0,0,25600,6,265379620
17014,141690190,108568992,250259182,9,0,0,3072,4,360657507
17015,141703740,109072810,250776550,2,0,0,41472,1,9671383345
17016,141710600,108362166,250072766,0,0,0,10240,6,5384361544
17017,141714050,108729335,250443385,5,0,0,27136,12,7948478437
17018,141736870,108719250,250456120,5,0,0,26624,12,2363082320
17019,141736910,108633386,250370296,8,0,0,8704,11,9348129364
17020,141738150,137348619,279086769,2,0,1,114688,1,6184622867
17021,141738670,108976439,250715109,2,0,0,1536,1,2752729729
17022,141740220,108770959,250511179,7,0,0,20480,1,8001340606
17023,141743950,108825742,250569692,1,0,0,5120,1,1300919546
17024,141749470,108726887,250476357,8,0,0,5632,11,10346472233
17025,141752280,108843861,250596141,5,0,0,8704,12,4137817819
17026,141756131,137366341,279122472,9,0,1,2048,4,2147612942
17027,141757360,108598880,250356240,4,0,0,3584,7,1337653944
17028,141768040,108623025,250391065,0,0,0,6656,6,10706851837
17029,141803120,109389231,251192351,0,0,0,7168,6,605732380
17030,141814090,108454737,250268827,5,0,0,19968,12,10652299247
17031,141830669,137291826,279122495,3,0,1,4096,18,2841538150
17032,141856680,108428638,250285318,4,0,0,8192,7,7184436845
17033,141868120,108776814,250644934,8,0,0,19456,11,970232948
17034,141877360,137245158,279122518,0,0,1,3072,6,2739728950
17035,141877510,109395101,251272611,8,0,0,26624,11,3053462727
17036,141888320,137250172,279138492,0,0,1,4096,6,557603916
17037,141916800,109212507,251129307,6,0,0,68608,12,2090518025
17038,141920970,109013261,250934231,2,0,0,60928,1,163153288
17039,141922660,137218098,279140758,0,0,1,3584,6,6934845410
17040,141925950,109258719,251184669,2,0,0,16384,1,3666807016
17041,141928510,108982755,250911265,6,0,0,49152,12,9922578910
17042,141937330,108630280,250567610,7,0,0,1024,1,10130506875
17043,141944100,109241996,251186096,4,0,0,4608,7,1746540547
17044,141955060,109422457,251377517,5,0,0,114688,12,5639480317
17045,141957960,109030364,250988324,5,0,0,28672,12,4686516083
17046,141962190,108922348,250884538,8,0,0,16384,11,2335207467
17047,141972600,108522598,250495198,1,0,0,39424,1,9735649888
17048,141981900,108778726,250760626,4,0,0,19456,7,3701482885
17049,141990910,109475467,251466377,2,0,0,31744,1,3716857618
17050,142001160,137198495,279199655,4,0,1,46592,7,8843417330
17051,142001880,109100902,251102782,1,0,0,51712,1,10323575865
17052,142014360,109423010,251437370,9,0,0,13312,4,8947046819
17053,142035040,108469876,250504916,1,0,0,19456,1,4754408118
17054,142041510,108487678,250529188,2,0,0,9728,1,5070802281
17055,142047540,137152138,279199678,6,0,1,22528,12,8224615693
17056,142053370,108445595,250498965,4,0,0,12288,7,6052245571
17057,142065850,109349511,251415361,0,0,0,87552,6,319365086
17058,142066459,137133242,279199701,3,0,1,2048,18,5698447076
17059,142070740,109552829,251623569,2,0,0,66048,1,2850746585
17060,142091360,109114081,251205441,8,0,0,24064,11,2888551100
17061,142096990,109332168,251429158,7,0,0,19456,1,7483348755
17062,142101590,109556345,251657935,8,0,0,112640,11,711835964
17063,142105439,137094285,279199724,3,0,1,2560,18,4722791320
17064,142111310,109417655,251528965,0,0,0,20480,6,4049907133
17065,142118240,108596378,250714618,4,0,0,49152,7,4472802523
17066,142118800,108607861,250726661,4,0,0,25088,7,5779717830
17067,142119120,109631246,251750366,8,0,0,72704,11,8611384855
17068,142121270,108472196,250593466,8,0,0,5120,11,3694941601
17069,142129080,108589914,250718994,0,0,0,12288,6,1369617185
17070,142136290,108950644,251086934,0,0,0,19968,6,6947916438
17071,142151470,108870614,251022084,5,0,0,64512,12,7315867447
17072,142170060,108579397,250749457,2,0,0,48128,1,7738658421
17073,142217920,109510271,251728191,2,0,0,161280,1,5854805428
17074,142228690,109591018,251819708,0,0,0,72192,6,1831810477
17075,142229570,108878764,251108334,7,0,0,17920,1,8281749707
17076,142230890,109217165,251448055,2,0,0,5120,1,2119709491
17077,142241530,108637068,250878598,5,0,0,6144,12,3392878468
17078,142243760,109584426,251828186,4,0,0,3072,7,6771282651
17079,142247770,136951989,279199759,0,0,1,33280,6,558654480
17080,142249650,137011214,279260864,4,0,1,23040,7,428187391
17081,142253990,137014408,279268398,0,0,1,512,6,7863602601
17082,142254930,108880508,251135438,8,0,0,19968,11,5611598939
17083,142259420,109161736,251421156,5,0,0,18944,12,321935242
17084,142260020,109621938,251881958,2,0,0,8192,1,6626084097
17085,142268540,136999881,279268421,6,0,1,3072,12,1989602843
17086,142271190,136997254,279268444,0,0,1,15360,6,1089370881
17087,142281130,109033061,251314191,8,0,0,3072,11,5432430158
17088,142289870,109141815,251431685,9,0,0,8192,4,4118041306
17089,142298691,136983417,279282108,9,0,1,7168,4,9585915383
17090,142299350,109268485,251567835,4,0,0,31744,7,1498781758
17091,142304779,136977352,279282131,5,0,1,20992,12,4393298911
17092,142307500,108691068,250998568,9,0,0,512,4,6158527889
17093,142307700,109115507,251423207,0,0,0,6656,6,5429503069
17094,142319380,109069282,251388662,5,0,0,29696,12,3355107676
17095,142319840,136962314,279282154,0,0,1,7168,6,5756992978
17096,142332640,109624270,251956910,6,0,0,20480,12,446459889
17097,142340740,109658623,251999363,4,0,0,18944,7,9223759921
17098,142352210,109960134,252312344,9,0,0,14848,4,5794228823
17099,142352920,109814008,252166928,5,0,0,66560,12,1153943623
17100,142353010,108945883,251298893,4,0,0,47104,7,3328019984
17101,142359319,136922858,279282177,5,0,1,7168,12,2663124746
17102,142366280,110028196,252394476,1,0,0,3584,1,3894388058
17103,142370110,109184675,251554785,7,0,0,6656,1,2820338655
17104,142370370,109146849,251517219,8,0,0,60928,11,759354029
17105,142382280,137566018,279948298,2,0,1,161280,1,8825004931
17106,142394330,108832395,251226725,7,0,0,14336,1,8292297899
17107,142397350,109042227,251439577,1,0,0,7168,1,10660551291
17108,142398010,137552874,279950884,8,0,1,4096,11,8226817126
17109,142409170,109047488,251456658,4,0,0,28160,7,139170643
17110,142426220,137614285,280040505,6,0,1,2048,12,117170596
17111,142432470,108907467,251339937,6,0,0,9216,12,8828736686
17112,142432890,137608909,280041799,2,0,1,37888,1,3118327214
17113,142437900,109084802,251522702,9,0,0,17920,4,5684043567
17114,142440200,108808612,251248812,8,0,0,15872,11,9348253075
17115,142444749,137734779,280179528,5,0,1,19968,12,2856180799
17116,142450180,108996292,251446472,0,0,0,22528,6,2515498506
17117,142453410,109762909,252216319,5,0,0,12288,12,8142633978
17118,142454200,109078228,251532428,2,0,0,11264,1,4220072325
17119,142457570,109586190,252043760,4,0,0,79360,7,9703225750
17120,142483880,109424502,251908382,2,0,0,9216,1,6767482364
17121,142498720,109085755,251584475,0,0,0,33280,6,9995723829
17122,142507341,137683886,280191227,9,0,1,6144,4,1478486116
17123,142531800,109295419,251827219,8,0,0,24576,11,103964926
17124,142535790,108897478,251433268,4,0,0,5120,7,5394745541
17125,142543580,109860822,252404402,5,0,0,2560,12,8723170289
17126,142568729,137628676,280197405,5,0,1,7680,12,6052001471
17127,142568820,137629891,280198711,0,0,1,2048,6,608987645
17128,142573910,109487345,252061255,7,0,0,57344,1,2077781790
17129,142575660,137749934,280325594,6,0,1,27136,12,4832173195
17130,142615790,109921573,252537363,9,0,0,32256,4,2560979206
17131,142622330,109863942,252486272,5,0,0,12288,12,7961731932
17132,142628090,138109836,280737926,2,0,1,78848,1,4861118707
17133,142651370,109692578,252343948,8,0,0,55808,11,6231417101
17134,142655620,109106652,251762272,1,0,0,17920,1,9806487147
17135,142665430,138123342,280788772,2,0,1,30720,1,4981026635
17136,142672700,108706891,251379591,8,0,0,6656,11,3875536802
17137,142689580,109521389,252210969,4,0,0,105472,7,1442093458
17138,142690170,138098625,280788795,4,0,1,10752,7,10211806297
17139,142704080,109926929,252631009,2,0,0,240128,1,10025214493
17140,142720310,109948239,252668549,4,0,0,97792,7,1800134172
17141,142749610,110203116,252952726,7,0,0,14336,1,4819008524
17142,142758990,108904326,251663316,7,0,0,17408,1,193932147
17143,142763350,109223529,251986879,0,0,0,3584,6,1153362544
17144,142763480,109315347,252078827,8,0,0,27648,11,6212846629
17145,142771720,109352818,252124538,5,0,0,24576,12,2829421921
17146,142788150,138011790,280799940,6,0,1,512,12,4503371840
17147,142791480,138008806,280800286,8,0,1,512,11,5603499901
17148,142794340,109563674,252358014,1,0,0,31232,1,10091681603
17149,142799390,109508407,252307797,1,0,0,74240,1,7956692552
17150,142803500,109996703,252800203,9,0,0,71680,4,2694737588
17151,142829290,110239468,253068758,2,0,0,25600,1,3986085591
17152,142864050,110567732,253431782,7,0,0,44032,1,6260571327
17153,142872409,137928953,280801362,3,0,1,13312,18,8378095958
17154,142883570,109612338,252495908,7,0,0,19456,1,4300612075
17155,142894760,109621451,252516211,4,0,0,66560,7,9138307667
17156,142901170,137916099,280817269,2,0,1,13824,1,10418480274
17157,142914231,138115880,281030111,9,0,1,14848,4,8328902434
17158,142916570,109782476,252699046,0,0,0,68608,6,9419500548
17159,142916830,108837459,251754289,9,0,0,12800,4,9114727349
17160,142927920,138102214,281030134,0,0,1,512,6,2135556570
17161,142936370,138093787,281030157,4,0,1,512,7,8296031439
17162,142941280,108913918,251855198,9,0,0,1024,4,4804600581
17163,142948420,109312511,252260931,4,0,0,23040,7,2643697536
17164,142962430,109713942,252676372,1,0,0,25600,1,4581053922
17165,142964610,109813730,252778340,0,0,0,61952,6,6222785203
17166,142980041,138290063,281270104,9,0,1,43520,4,385847862
17167,143007390,138465970,281473360,0,0,1,5120,6,652761940
17168,143023700,110292996,253316696,7,0,0,10240,1,4378558468
17169,143029510,109867960,252897470,0,0,0,8192,6,10448016625
17170,143032330,109525492,252557822,3,0,0,67072,18,6264387452
17171,143041390,138482652,281524042,4,0,1,5120,7,5221893240
17172,143064290,110033131,253097421,9,0,0,34816,4,1007766466
17173,143071420,109255501,252326921,8,0,0,7680,11,8299947444
17174,143110910,108820620,251931530,8,0,0,12800,11,507691751
17175,143114450,109343376,252457826,1,0,0,47104,1,8482009197
17176,143121490,109611056,252732546,8,0,0,54784,11,9876311105
17177,143129260,108980707,252109967,4,0,0,4096,7,4944059808
17178,143132660,109394852,252527512,2,0,0,9216,1,6153359825
17179,143150830,109173705,252324535,8,0,0,39936,11,7614444586
17180,143155930,138368135,281524065,6,0,1,1024,12,3004244707
17181,143159590,138364498,281524088,4,0,1,5632,7,8007976915
17182,143167900,110407781,253575681,2,0,0,14336,1,2911477508
17183,143172740,138351371,281524111,0,0,1,2048,6,941656731
17184,143184290,138339844,281524134,8,0,1,8704,11,7050149062
17185,143193240,109516476,252709716,9,0,0,30720,4,4759368921
17186,143200480,109027129,252227609,9,0,0,17920,4,268492700
17187,143205400,108929383,252134783,7,0,0,4608,1,2451765298
17188,143217890,109053054,252270944,1,0,0,14336,1,730445024
17189,143233761,138677691,281911452,9,0,1,36864,4,8695080480
17190,143244791,138715269,281960060,9,0,1,13312,4,3493611974
17191,143245060,110483737,253728797,9,0,0,76800,4,911964654
17192,143248720,138711363,281960083,4,0,1,2560,7,1726689643
17193,143253800,109822781,253076581,9,0,0,25600,4,4242209360
17194,143303050,108909502,252212552,2,0,0,5120,1,2637367966
17195,143305390,109219268,252524658,7,0,0,27648,1,4461524653
17196,143328230,109732682,253060912,9,0,0,116224,4,8383507453
17197,143328740,109815893,253144633,2,0,0,54272,1,907485294
17198,143332030,138628076,281960106,0,0,1,5632,6,1672264168
17199,143333640,110481635,253815275,8,0,0,102400,11,9311366542
17200,143349640,138610489,281960129,4,0,1,5120,7,6281346070
17201,143355180,109010487,252365667,7,0,0,11264,1,8740922308
17202,143363660,109011409,252375069,8,0,0,18432,11,4441368440
17203,143370040,138590112,281960152,4,0,1,512,7,8083183889
17204,143370911,138589264,281960175,9,0,1,2048,4,2673451312
17205,143386591,138573607,281960198,9,0,1,4096,4,7001656628
17206,143387300,109764064,253151364,2,0,0,22016,1,5758368275
17207,143396589,138668893,282065482,3,0,1,18944,18,3192189123
17208,143433910,109740739,253174649,1,0,0,21504,1,10484537185
17209,143436630,109369079,252805709,1,0,0,11776,1,116894391
17210,143437160,109821661,253258821,8,0,0,10752,11,4836719102
17211,143439040,109740468,253179508,1,0,0,15872,1,5609494023
17212,143453590,109522312,252975902,1,0,0,30720,1,9706769712
17213,143460380,109999893,253460273,1,0,0,32768,1,10145468685
17214,143476330,110117685,253594015,4,0,0,34304,7,1436735394
17215,143481160,110408940,253890100,4,0,0,108032,7,2270756550
17216,143494259,138692519,282186778,3,0,1,24576,18,5564398034
17217,143499180,109139550,252638730,9,0,0,25088,4,1812375900
17218,143512270,109615461,253127731,0,0,0,47616,6,8747396251
17219,143526740,109151371,252678111,2,0,0,5632,1,4341482912
17220,143536900,108872747,252409647,8,0,0,14848,11,1532022682
17221,143544390,109338026,252882416,0,0,0,512,6,607850096
17222,143609020,110458429,254067449,4,0,0,104960,7,1542457799
17223,143614690,110310229,253924919,9,0,0,114176,4,7391685487
17224,143631960,138555804,282187764,6,0,1,1536,12,4496613494
17225,143633160,109622362,253255522,7,0,0,15360,1,4003488336
17226,143641930,109511797,253153727,4,0,0,7680,7,6878158051
17227,143659130,109056693,252715823,2,0,0,19968,1,3219731941
17228,143661579,138531011,282192590,3,0,1,7680,18,5623793687
17229,143668870,109938260,253607130,9,0,0,33792,4,9674785902
17230,143670790,109854990,253525780,4,0,0,41472,7,487743584
17231,143673200,109027133,252700333,1,0,0,4096,1,9403208074
17232,143681980,109889310,253571290,2,0,0,23040,1,6685501334
17233,143683560,110242318,253925878,7,0,0,3072,1,2112216823
17234,143686760,109400030,253086790,2,0,0,3072,1,1555333046
17235,143691500,138501436,282192936,8,0,1,512,11,5682971991
17236,143711610,109401590,253113200,4,0,0,51712,7,252424029
17237,143722600,110551366,254273966,0,0,0,90112,6,4669712216
17238,143733200,109800738,253533938,2,0,0,17408,1,2974462213
17239,143753381,138448432,282201813,9,0,1,18432,4,3883906806
17240,143765120,110381835,254146955,1,0,0,52224,1,10221050545
17241,143794740,109406285,253201025,4,0,0,12288,7,4588946777
17242,143804240,110275088,254079328,9,0,0,38912,4,4601593400
17243,143809610,110033800,253843410,8,0,0,11776,11,4196646385
17244,143809990,110295477,254105467,8,0,0,21504,11,2096608469
17245,143813910,110136046,253949956,7,0,0,66560,1,9634573184
17246,143814400,108987698,252802098,9,0,0,6144,4,9219079855
17247,143842100,110528274,254370374,8,0,0,3584,11,10038902112
17248,143845000,138356967,282201967,7,0,1,8704,1,2525299877
17249,143852000,110567416,254419416,1,0,0,20480,1,2753776382
17250,143853950,110385650,254239600,8,0,0,42496,11,1916297305
17251,143869780,138527560,282397340,2,0,1,13312,1,1148210126
17252,143870850,109705634,253576484,2,0,0,2560,1,2270617468
17253,143872099,138589644,282461743,3,0,1,27648,18,691997068
17254,143873939,138619130,282493069,3,0,1,10752,18,3723760908
17255,143884580,110619680,254504260,8,0,0,82432,11,8864233520
17256,143889280,110040365,253929645,2,0,0,12288,1,2888161701
17257,143890980,138742460,282633440,8,0,1,40448,11,8857253662
17258,143902019,138753507,282655526,5,0,1,30720,12,7966998794
17259,143914190,109390461,253304651,1,0,0,2048,1,9653896768
17260,143914680,138741512,282656192,4,0,1,1024,7,9647132184
17261,143929210,109436084,253365294,2,0,0,33792,1,2924483656
17262,143930450,109155381,253085831,0,0,0,30208,6,1667403434
17263,143952210,109316015,253268225,7,0,0,6656,1,5810470804
17264,143952610,110526020,254478630,0,0,0,62464,6,1970655626
17265,143955530,138705847,282661377,6,0,1,16384,12,185467423
17266,143965120,109162954,253128074,8,0,0,1024,11,8510719218
17267,143993960,109822921,253816881,2,0,0,5120,1,10496237360
17268,144023790,110517678,254541468,9,0,0,25600,4,8251343352
17269,144026010,109468501,253494511,7,0,0,15872,1,4810533817
17270,144040620,109427788,253468408,7,0,0,26624,1,168850287
17271,144042771,138625285,282668056,9,0,1,2560,4,2840567344
17272,144049220,109645594,253694814,0,0,0,24576,6,5643006001
17273,144062870,109196130,253259000,1,0,0,512,1,8769988376
17274,144096141,138577349,282673490,9,0,1,6144,4,7467101687
17275,144114830,109065013,253179843,1,0,0,1024,1,6750305678
17276,144130850,109119969,253250819,3,0,0,33280,18,9159630510
17277,144131960,110079982,254211942,0,0,0,49152,6,9486756779
17278,144135230,138564510,282699740,8,0,1,16896,11,2549036144
17279,144140340,109820215,253960555,2,0,0,32768,1,6370074380
17280,144141440,109530022,253671462,0,0,0,36352,6,7283501462
17281,144149910,109977802,254127712,0,0,0,49664,6,8037666978
17282,144166820,109824304,253991124,2,0,0,3584,1,10311789842
17283,144171330,110111411,254282741,9,0,0,28672,4,56113343
17284,144183300,138562046,282745346,4,0,1,10752,7,793603227
17285,144202850,110838999,255041849,8,0,0,50176,11,7485731007
17286,144203770,109537397,253741167,4,0,0,40448,7,10338376765
17287,144246690,110473361,254720051,0,0,0,68096,6,4347665323
17288,144282650,109574511,253857161,6,0,0,45056,12,737159008
17289,144286170,109483026,253769196,9,0,0,38400,4,8731006145
17290,144289660,138471898,282761558,0,0,1,13824,6,1049256424
17291,144303150,109983990,254287140,4,0,0,14336,7,5958522312
17292,144307310,110996286,255303596,4,0,0,50688,7,8294833571
17293,144327220,109183538,253510758,2,0,0,53248,1,6968357332
17294,144330120,109357183,253687303,7,0,0,6144,1,1505937331
17295,144330730,109508072,253838802,7,0,0,3584,1,4124230088
17296,144333730,110269376,254603106,2,0,0,47104,1,4088388119
17297,144341970,110049784,254391754,1,0,0,26112,1,1078842520
17298,144349150,110171357,254520507,9,0,0,53248,4,8247572421
17299,144358450,109177406,253535856,1,0,0,6144,1,9331133090
17300,144362460,110094449,254456909,2,0,0,5120,1,5731756693
17301,144366489,138395092,282761581,5,0,1,12800,12,4623530591
17302,144377560,109135561,253513121,9,0,0,7680,4,9249235250
17303,144380760,109147851,253528611,9,0,0,9216,4,4754756933
17304,144381700,111020524,255402224,4,0,0,47104,7,8938493397
17305,144389080,109614859,254003939,0,0,0,41984,6,3182496877
17306,144393910,109587260,253981170,0,0,0,67584,6,9662103163
17307,144397850,109210600,253608450,1,0,0,3584,1,2224780841
17308,144399370,110408480,254807850,1,0,0,31232,1,1212805197
17309,144402100,109967159,254369259,3,0,0,72192,18,1962887507
17310,144413640,111167151,255580791,7,0,0,95232,1,10202334812
17311,144415150,138422751,282837901,7,0,1,7680,1,6366798351
17312,144417080,109809549,254226629,7,0,0,48128,1,8714177142
17313,144427899,138506224,282934123,5,0,1,44544,12,8702726815
17314,144433230,138539503,282972733,2,0,1,6656,1,5830808952
17315,144435890,138541349,282977239,2,0,1,7168,1,6272867688
17316,144468520,109515021,253983541,0,0,0,7680,6,568967557
17317,144485330,109519264,254004594,7,0,0,2048,1,475797197
17318,144494040,109285770,253779810,1,0,0,9216,1,7147386904
17319,144515720,111153654,255669374,7,0,0,96256,1,539559333
17320,144524920,110142529,254667449,8,0,0,54272,11,2222972728
17321,144528520,110034008,254562528,4,0,0,29184,7,1680060439
17322,144536740,109764779,254301519,8,0,0,28160,11,2191240797
17323,144540911,138510630,283051541,9,0,1,8704,4,2336954223
17324,144542810,109625938,254168748,8,0,0,41472,11,8265752358
17325,144543410,109765929,254309339,7,0,0,13312,1,3084566456
17326,144552870,109437139,253990009,0,0,0,17408,6,3306898469
17327,144568870,109886456,254455326,8,0,0,6144,11,7503639300
17328,144572870,138479439,283052309,7,0,1,11776,1,1189562947
17329,144573590,110496610,255070200,1,0,0,46592,1,526699142
17330,144611350,110175625,254786975,0,0,0,52224,6,4314747033
17331,144612790,109727384,254340174,9,0,0,68608,4,411855606
17332,144615770,138493473,283109243,4,0,1,512,7,7686522972
17333,144631540,110046563,254678103,6,0,0,16896,12,5715638375
17334,144633060,138476206,283109266,4,0,1,2048,7,3625786961
17335,144643870,110051351,254695221,7,0,0,47616,1,46171029
17336,144654200,109728143,254382343,8,0,0,512,11,10123828629
17337,144662930,109707779,254370709,0,0,0,1024,6,10424506001
17338,144664450,138444839,283109289,4,0,1,15872,7,3685204819
17339,144668999,138541058,283210057,5,0,1,16896,12,4477514641
17340,144672040,110083959,254755999,0,0,0,39936,6,5100499827
17341,144684640,138681367,283366007,7,0,1,33792,1,2536732212
17342,144701982,110324556,255026538,2,0,0,62976,1,2827155417
17343,144702950,109912640,254615590,1,0,0,31232,1,10145401414
17344,144703570,110231258,254934828,2,0,0,13312,1,5076011590
17345,144705670,111274921,255980591,8,0,0,49664,11,5174193156
17346,144710290,109536197,254246487,2,0,0,22528,1,307019082
17347,144712950,110294377,255007327,9,0,0,83968,4,4068096814
17348,144713310,111121344,255834654,1,0,0,10752,1,10280475399
17349,144719620,110194960,254914580,2,0,0,7680,1,898789720
17350,144729789,138801540,283531329,3,0,1,9728,18,5036395489
17351,144733071,138881370,283614441,9,0,1,20992,4,6465401179
17352,144744820,110465776,255210596,9,0,0,64512,4,678713662
17353,144749039,138961658,283710697,5,0,1,11776,12,5567470043
17354,144767100,109580140,254347240,2,0,0,23040,1,7052564437
17355,144772340,110095579,254867919,9,0,0,18432,4,10441191666
17356,144779370,138931350,283710720,8,0,1,9216,11,5375381897
17357,144779660,110339118,255118778,4,0,0,14848,7,2567997133
17358,144790050,110358512,255148562,4,0,0,16384,7,4121563069
17359,144792520,111371528,256164048,0,0,0,94720,6,7344612599
17360,144802610,109760877,254563487,4,0,0,3072,7,5426184544
17361,144811080,139081932,283893012,7,0,1,7168,1,9082815960
17362,144812300,109616548,254428848,2,0,0,5632,1,3561815142
17363,144833280,109544488,254377768,4,0,0,23040,7,6116698116
17364,144849690,109670996,254520686,0,0,0,512,6,6459452286
17365,144860060,110312430,255172490,9,0,0,9216,4,6904549836
17366,144861670,109532915,254394585,7,0,0,9216,1,9879018780
17367,144882080,110224750,255106830,7,0,0,97792,1,6551175902
17368,144883089,139285040,284168129,5,0,1,12800,12,10227387953
17369,144884450,110837197,255721647,7,0,0,15360,1,4808699019
17370,144894600,109785889,254680489,7,0,0,7680,1,5952726046
17371,144917091,139481778,284398869,9,0,1,15360,4,3097998150
17372,144951809,139646771,284598580,5,0,1,26624,12,4043739133
17373,144953540,109589043,254542583,5,0,0,3584,12,9892179705
17374,144953780,139742632,284696412,4,0,1,17920,7,6780002931
17375,144963039,140073462,285036501,3,0,1,25088,18,3528918995
17376,144964999,140095963,285060962,3,0,1,9728,18,10152019918
17377,144966270,110363736,255330006,5,0,0,19968,12,2213878321
17378,144971710,109701222,254672932,8,0,0,17920,11,4039786793
17379,144981360,140102344,285083704,8,0,1,3584,11,7157138590
17380,144984110,140101220,285085330,6,0,1,2560,12,2237827556
17381,144987950,110300179,255288129,1,0,0,118784,1,1838680883
17382,144991950,109487171,254479121,1,0,0,1536,1,10513859074
17383,145027979,140064369,285092348,5,0,1,11776,12,3151266725
17384,145034100,140107614,285141714,8,0,1,2048,11,3190789447
17385,145038590,110404490,255443080,2,0,0,60416,1,2965886088
17386,145048190,140093547,285141737,7,0,1,11776,1,8829222254
17387,145060160,110054071,255114231,4,0,0,9728,7,23951363
17388,145066830,109689972,254756802,2,0,0,2560,1,2995397726
17389,145071280,140287990,285359270,7,0,1,19968,1,9769045192
17390,145076049,140841990,285918039,5,0,1,31232,12,7733583106
17391,145089330,109845989,254935319,8,0,0,1536,11,10232647047
17392,145099360,109862236,254961596,8,0,0,49152,11,10423975294
17393,145105140,110428958,255534098,7,0,0,13824,1,9156500808
17394,145112780,110127947,255240727,4,0,0,98816,7,707622985
17395,145121480,111099467,256220947,5,0,0,25088,12,4339663848
17396,145123750,110066997,255190747,1,0,0,8192,1,6157676659
17397,145124270,110222919,255347189,9,0,0,56320,4,8754885738
17398,145124659,140794968,285919627,3,0,1,15872,18,8281396567
17399,145127220,109783417,254910637,7,0,0,9728,1,8944723836
17400,145129400,110665686,255795086,7,0,0,36352,1,7214965809
17401,145134740,109921218,255055958,5,0,0,46080,12,8387909427
17402,145142060,109929278,255071338,4,0,0,512,7,10206536122
17403,145143750,110663839,255807589,8,0,0,40960,11,7109979580
17404,145143770,109927389,255071159,1,0,0,3072,1,1271463045
17405,145154210,109576055,254730265,1,0,0,1536,1,2569789478
17406,145165000,110203116,255368116,2,0,0,68608,1,5339642517
17407,145180570,111067278,256247848,8,0,0,20480,11,10511539941
17408,145182970,110420331,255603301,5,0,0,71168,12,9046438896
17409,145220430,110673141,255893571,4,0,0,14336,7,5166697620
17410,145243940,110135454,255379394,4,0,0,13824,7,380953982
17411,145252980,110387035,255640015,2,0,0,51712,1,8304588131
17412,145264910,110230640,255495550,7,0,0,39936,1,3046896808
17413,145266640,109698567,254965207,0,0,0,11776,6,10363146043
17414,145272700,110420299,255692999,9,0,0,27136,4,10035417712
17415,145273660,109628320,254901980,1,0,0,6656,1,8314124350
17416,145282630,110738531,256021161,5,0,0,94208,12,2043671465
17417,145287969,140681443,285969412,5,0,1,3072,12,8547745261
17418,145310030,109801214,255111244,8,0,0,14336,11,6104815206
17419,145315930,110368778,255684708,4,0,0,32768,7,5413932482
17420,145320990,110881480,256202470,4,0,0,124928,7,3431468850
17421,145321590,110197442,255519032,7,0,0,24064,1,76408006
17422,145327360,109996539,255323899,1,0,0,66560,1,1451838262
17423,145339110,110502431,255841541,9,0,0,22528,4,3028021844
17424,145355150,110032699,255387849,8,0,0,27648,11,1903213468
17425,145361160,110053723,255414883,9,0,0,41472,4,6176887303
17426,145366830,140603248,285970078,8,0,1,11264,11,9843992730
17427,145377380,110433820,255811200,5,0,0,11776,12,7273527422
17428,145394150,140678108,286072258,2,0,1,8704,1,859724627
17429,145405350,110426005,255831355,2,0,0,66048,1,1381260203
17430,145407070,140665211,286072281,7,0,1,512,1,5392833108
17431,145418890,110205346,255624236,0,0,0,68608,6,9644067888
17432,145434340,110652122,256086462,4,0,0,15360,7,8655726020
17433,145436390,109979920,255416310,0,0,0,4608,6,10179190811
17434,145440720,140631584,286072304,0,0,1,2048,6,3616491064
17435,145453840,109921319,255375159,8,0,0,23040,11,7656044851
17436,145479710,110484143,255963853,5,0,0,38912,12,10053416467
17437,145481370,111234829,256716199,6,0,0,184832,12,1819618555
17438,145503210,110886500,256389710,1,0,0,27648,1,3385440019
17439,145524720,110759326,256284046,4,0,0,2048,7,7672976641
17440,145542610,140675700,286218310,7,0,1,17408,1,162227433
17441,145570540,140648116,286218656,8,0,1,512,11,7797745840
17442,145577940,110875942,256453882,0,0,0,43008,6,9027340765
17443,145588800,110885840,256474640,9,0,0,13312,4,2503958430
17444,145608950,110065751,255674701,2,0,0,17408,1,8551201954
17445,145618820,110088094,255706914,8,0,0,45568,11,6189585702
17446,145628980,110087964,255716944,7,0,0,32256,1,1383488626
17447,145632250,111175946,256808196,2,0,0,31744,1,4043568129
17448,145640129,140625111,286265240,3,0,1,8192,18,6998473454
17449,145642570,140622693,286265263,0,0,1,1024,6,3821055499
17450,145644750,110821684,256466434,1,0,0,33792,1,657132875
17451,145651090,110860002,256511092,4,0,0,17920,7,5398021963
17452,145668250,110105035,255773285,9,0,0,36352,4,1374104663
17453,145670640,111076470,256747110,7,0,0,101376,1,7930046415
17454,145683210,111197621,256880831,7,0,0,512,1,1058297366
17455,145684860,110267114,255951974,6,0,0,31232,12,7152228152
17456,145693940,140571346,286265286,7,0,1,5632,1,29302517
17457,145701410,110005683,255707093,8,0,0,512,11,10578184223
17458,145703150,109878444,255581594,1,0,0,2560,1,7788896427
17459,145707520,111045587,256753107,0,0,0,2560,6,9836713290
17460,145709930,110215017,255924947,7,0,0,16896,1,9015534549
17461,145716740,110310730,256027470,2,0,0,13312,1,6623247060
17462,145721660,111434771,257156431,0,0,0,92672,6,389355928
17463,145723700,140541617,286265317,0,0,1,7168,6,7523167732
17464,145727479,140537861,286265340,5,0,1,1024,12,10473428662
17465,145736110,111278151,257014261,8,0,0,80896,11,539295184
17466,145752660,110460620,256213280,6,0,0,13824,12,1393174957
17467,145759821,140505542,286265363,9,0,1,1536,4,9252390219
17468,145782580,109973405,255755985,5,0,0,1536,12,10338879539
17469,145793570,140471816,286265386,4,0,1,2560,7,7208525819
17470,145794930,111003571,256798501,7,0,0,58368,1,8453070199
17471,145804870,110429056,256233926,1,0,0,42496,1,8688460968
17472,145808380,110718718,256527098,1,0,0,23040,1,4784588972
17473,145810819,140470995,286281814,3,0,1,6144,18,10135103263
17474,145819340,110949787,256769127,2,0,0,36352,1,5673608017
17475,145823220,110282571,256105791,8,0,0,53248,11,9892969642
17476,145836170,110223691,256059861,8,0,0,59904,11,1523148627
17477,145838210,110281956,256120166,2,0,0,47104,1,6758693393
17478,145838310,110104125,255942435,9,0,0,18432,4,6353553054
17479,145871150,110094286,255965436,1,0,0,5120,1,1061646965
17480,145871230,110444359,256315589,7,0,0,27136,1,4093389378
17481,145886779,140484725,286371504,3,0,1,15360,18,2911759562
17482,145891590,110742045,256633635,9,0,0,12800,4,3838792609
17483,145894419,140529071,286423490,3,0,1,6656,18,4265479098
17484,145915270,110465993,256381263,4,0,0,52736,7,8528745561
17485,145916670,110387487,256304157,2,0,0,27648,1,2121718951
17486,145925200,110283845,256209045,7,0,0,21504,1,9379496823
17487,145976720,110158445,256135165,7,0,0,49152,1,1438056447
17488,145979000,140455910,286434910,8,0,1,10240,11,9452238030
17489,145990280,140523447,286513727,7,0,1,17408,1,6654455759
17490,145996810,110167573,256164383,5,0,0,1024,12,3984744708
17491,145998080,111033699,257031779,5,0,0,39424,12,2149467758
17492,146003970,111274663,257278633,0,0,0,38912,6,8565374466
17493,146012520,110914075,256926595,1,0,0,15360,1,1055937921
17494,146020130,111379697,257399827,6,0,0,97792,12,5100181427
17495,146033710,110357115,256390825,2,0,0,3584,1,6388079261
17496,146039610,110397712,256437322,9,0,0,49152,4,708708119
17497,146043340,110903372,256946712,1,0,0,9216,1,7276369116
17498,146058560,140475683,286534243,7,0,1,512,1,9349001030
17499,146067180,110373129,256440309,2,0,0,9728,1,5084389006
17500,146070000,111471776,257541776,4,0,0,37376,7,4062797771
17501,146074220,110555492,256629712,1,0,0,124928,1,3558845658
17502,146079880,110467296,256547176,8,0,0,15360,11,5637879864
17503,146081890,110670414,256752304,5,0,0,16384,12,58755759
17504,146087270,110670696,256757966,0,0,0,15872,6,481480790
17505,146087510,140447399,286534909,0,0,1,1024,6,4577837744
17506,146089300,110751328,256840628,7,0,0,105984,1,4254417002
17507,146127359,140412696,286540055,5,0,1,8192,12,7100828360
17508,146127700,110370658,256498358,6,0,0,19456,12,5704971897
17509,146128670,140411731,286540401,6,0,1,512,12,9159523746
17510,146129320,110751332,256880652,7,0,0,39424,1,2145440960
17511,146139619,140402728,286542347,3,0,1,3072,18,7033362251
17512,146149000,110755098,256904098,0,0,0,76288,6,3764112821
17513,146149350,110830996,256980346,8,0,0,2560,11,907575624
17514,146153790,110908066,257061856,9,0,0,16896,4,4822422336
17515,146158430,110588859,256747289,2,0,0,512,1,3075858266
17516,146161940,110618754,256780694,4,0,0,37888,7,10472069503
17517,146164320,110778522,256942842,5,0,0,53248,12,9464564951
17518,146166000,110685103,256851103,1,0,0,34304,1,3266904042
17519,146176370,110745522,256921892,2,0,0,27648,1,1725891769
17520,146190770,110770348,256961118,4,0,0,27136,7,7954370620
17521,146194029,140348664,286542693,5,0,1,512,12,7973993873
17522,146195880,111112416,257308296,7,0,0,97280,1,752776190
17523,146210640,110809104,257019744,0,0,0,17920,6,6331350927
17524,146226900,111444412,257671312,6,0,0,11776,12,10635916049
17525,146237430,140346300,286583730,2,0,1,6144,1,3997694197
17526,146251270,110821575,257072845,6,0,0,7168,12,9546595476
17527,146256350,110800131,257056481,6,0,0,54784,12,5812815196
17528,146258970,140343550,286602520,0,0,1,41472,6,8125287180
17529,146264839,140338347,286603186,3,0,1,1024,18,8603837028
17530,146269590,110838220,257107810,7,0,0,15360,1,6301243438
17531,146272130,111245888,257518018,2,0,0,17408,1,5287634528
17532,146272720,110925344,257198064,4,0,0,54784,7,2937011366
17533,146285490,111336014,257621504,1,0,0,126464,1,1601753255
17534,146298620,111666806,257965426,9,0,0,43520,4,6038206671
17535,146316850,110750801,257067651,6,0,0,18944,12,9904652181
17536,146324010,111100488,257424498,0,0,0,80896,6,6366648121
17537,146327790,140331268,286659058,4,0,1,11264,7,6484925624
17538,146373710,110666048,257039758,6,0,0,26112,12,2909261075
17539,146400291,140358021,286758312,9,0,1,11776,4,7882103015
17540,146418340,111038276,257456616,0,0,0,43008,6,9895473401
17541,146451640,110777862,257229502,9,0,0,9216,4,4812687687
17542,146454430,110616208,257070638,5,0,0,9728,12,8163856166
17543,146461220,110758394,257219614,1,0,0,53760,1,2586277428
17544,146470340,111665540,258135880,2,0,0,27136,1,6807761661
17545,146474010,111244748,257718758,7,0,0,44032,1,2748886566
17546,146476700,110844457,257321157,7,0,0,41984,1,6239818164
17547,146494950,140565530,287060480,8,0,1,58368,11,4578909406
17548,146500620,110933931,257434551,1,0,0,25600,1,9364679040
17549,146502220,111162954,257665174,1,0,0,9216,1,6168493913
17550,146525380,140762511,287287891,4,0,1,4608,7,8608834708
17551,146543950,111038976,257582926,7,0,0,57856,1,5950301969
17552,146545330,111444299,257989629,2,0,0,79360,1,10050587926
17553,146557670,110698799,257256469,7,0,0,11264,1,7225835098
17554,146574360,110667167,257241527,5,0,0,5120,12,6736147885
17555,146593760,110971403,257565163,2,0,0,12800,1,5581087591
17556,146604930,110720462,257325392,2,0,0,13824,1,5474130879
17557,146605410,110821318,257426728,2,0,0,1024,1,8881909285
17558,146606860,110836629,257443489,8,0,0,27648,11,765620218
17559,146611450,110715080,257326530,1,0,0,512,1,7000212208
17560,146613120,140674794,287287914,7,0,1,4096,1,9400667609
17561,146647270,110787772,257435042,8,0,0,1536,11,9417257897
17562,146694470,110631881,257326351,0,0,0,3072,6,8925413865
17563,146698190,110964153,257662343,8,0,0,128000,11,9991724876
17564,146699950,110726443,257426393,9,0,0,6144,4,10053294811
17565,146700260,110830105,257530365,3,0,0,40448,18,880488235
17566,146704241,140583696,287287937,9,0,1,512,4,3424043329
17567,146708520,110914731,257623251,1,0,0,5632,1,3710491474
17568,146768620,111024996,257793616,6,0,0,16896,12,1218718515
17569,146772110,111236129,258008239,7,0,0,42496,1,9359599349
17570,146778801,140509159,287287960,9,0,1,8192,4,7813434148
17571,146801990,110937192,257739182,8,0,0,10240,11,10713533286
17572,146810950,140477033,287287983,4,0,1,4096,7,10577836430
17573,146816200,110861577,257677777,9,0,0,5632,4,8395216997
17574,146822230,111173038,257995268,8,0,0,18432,11,3515863625
17575,146833870,111238912,258072782,8,0,0,23040,11,566419712
17576,146834390,140718356,287552746,0,0,1,71680,6,7860217657
17577,146842550,111411205,258253755,0,0,0,92672,6,2434979339
17578,146844530,111424091,258268621,9,0,0,20480,4,4957439742
17579,146849200,110818501,257667701,5,0,0,8192,12,3216201091
17580,146866770,110806125,257672895,2,0,0,5120,1,3086669831
17581,146870460,111430522,258300982,5,0,0,10240,12,9705189706
17582,146883239,140669530,287552769,3,0,1,5632,18,4002400432
17583,146890500,110785538,257676038,2,0,0,10240,1,10482655961
17584,146891620,111405728,258297348,2,0,0,94208,1,494962560
17585,146899400,140653392,287552792,0,0,1,1024,6,8283690471
17586,146900530,140687570,287588100,0,0,1,31744,6,1843109875
17587,146908290,111534196,258442486,6,0,0,72704,12,2375803105
17588,146959480,111453857,258413337,7,0,0,19968,1,101042545
17589,146964949,140690128,287655077,3,0,1,24576,18,836549212
17590,146977040,111579201,258556241,1,0,0,16896,1,8480080215
17591,146980330,111360448,258340778,7,0,0,91648,1,8257717784
17592,146987210,111077102,258064312,8,0,0,111616,11,10097253369
17593,146998779,140726086,287724865,5,0,1,26112,12,8729118661
17594,147007350,111718422,258725772,6,0,0,2048,12,8220408900
17595,147012110,140811921,287824031,4,0,1,1024,7,7294947636
17596,147013880,111015984,258029864,2,0,0,1024,1,4097384089
17597,147026880,111065548,258092428,8,0,0,47616,11,6268834129
17598,147031060,111231298,258262358,8,0,0,28160,11,6097401139
17599,147048770,111893891,258942661,5,0,0,67072,12,8879511549
17600,147055560,111169936,258225496,8,0,0,43520,11,7274848835
17601,147057850,111081329,258139179,9,0,0,10752,4,1161278134
17602,147059190,110839012,257898202,1,0,0,13824,1,588520114
17603,147065300,111051643,258116943,9,0,0,80384,4,4669007856
17604,147065720,140910158,287975878,8,0,1,41984,11,6592302928
17605,147088430,110977309,258065739,8,0,0,4608,11,4817358506
17606,147090510,111313143,258403653,7,0,0,12288,1,7746326831
17607,147099670,140979689,288079359,6,0,1,11264,12,3490175479
17608,147103980,111295906,258399886,0,0,0,94208,6,154516112
17609,147116280,111190520,258306800,8,0,0,10240,11,2031426712
17610,147118850,141353972,288472822,2,0,1,49664,1,9267305442
17611,147122131,141445043,288567174,9,0,1,1024,4,743239071
17612,147124360,111527839,258652199,2,0,0,9728,1,5132131846
17613,147157890,111437463,258595353,7,0,0,13824,1,9268097147
17614,147165320,111132519,258297839,1,0,0,1536,1,4595814860
17615,147170210,111133447,258303657,8,0,0,8704,11,10094348218
17616,147210460,111249401,258459861,6,0,0,16384,12,459031135
17617,147219200,111146378,258365578,2,0,0,22016,1,4618715079
17618,147220420,141347420,288567840,8,0,1,1024,11,2358842005
17619,147224460,141343944,288568404,4,0,1,10752,7,4740481667
17620,147227020,111768148,258995168,4,0,0,23040,7,920920208
17621,147227120,111485406,258712526,8,0,0,28672,11,3941717058
17622,147248120,111735614,258983734,7,0,0,32256,1,5716291165
17623,147267710,111363002,258630712,4,0,0,9728,7,8759984526
17624,147274640,111398496,258673136,5,0,0,31232,12,9753847684
17625,147277760,111363180,258640940,0,0,0,1536,6,2637475436
17626,147279190,111502579,258781769,2,0,0,95744,1,3340315764
17627,147303030,111248040,258551070,9,0,0,22016,4,10376845282
17628,147327280,111632431,258959711,2,0,0,38400,1,3553759617
17629,147332500,111876415,259208915,9,0,0,6656,4,7083979587
17630,147334320,111748048,259082368,1,0,0,10752,1,3468328262
17631,147341470,111469026,258810496,1,0,0,94208,1,7602642089
17632,147352170,111521445,258873615,9,0,0,12800,4,3970154318
17633,147352220,111487971,258840191,5,0,0,2048,12,9904651056
17634,147360720,141208990,288569710,2,0,1,2048,1,2588580006
17635,147365470,111520180,258885650,1,0,0,39424,1,521267988
17636,147386330,111439032,258825362,9,0,0,48640,4,10621491266
17637,147387980,111803696,259191676,8,0,0,512,11,3248373781
17638,147394500,111527702,258922202,6,0,0,115200,12,8492388644
17639,147400110,111570115,258970225,0,0,0,9728,6,8410300851
17640,147402590,111624766,259027356,0,0,0,6144,6,9543815322
17641,147404840,111602542,259007382,8,0,0,6656,11,3274652070
17642,147408890,111596441,259005331,4,0,0,33280,7,2589088223
17643,147412780,111575345,258988125,9,0,0,14336,4,4019307872
17644,147423900,111663015,259086915,9,0,0,14848,4,7040422082
17645,147427160,141160731,288587891,8,0,1,5632,11,3930315397
17646,147448879,141192134,288641013,5,0,1,15872,12,9215969417
17647,147454720,111624349,259079069,5,0,0,67072,12,760157868
17648,147455810,111735687,259191497,9,0,0,50176,4,6245592595
17649,147461730,111393444,258855174,4,0,0,512,7,1827351812
17650,147475670,111659964,259135634,0,0,0,59904,6,866596983
17651,147478519,141216368,288694887,3,0,1,31232,18,5649740239
17652,147489140,141291050,288780190,8,0,1,24576,11,9454654505
17653,147490070,141611537,289101607,4,0,1,60416,7,1015545861
17654,147496650,111451338,258947988,8,0,0,17408,11,3481424017
17655,147499000,111607800,259106800,1,0,0,5632,1,9913872613
17656,147502010,111807250,259309260,9,0,0,39424,4,8527636266
17657,147502430,111727283,259229713,2,0,0,13312,1,10066827817
17658,147502480,111522981,259025461,1,0,0,29696,1,4297913529
17659,147505900,111907272,259413172,9,0,0,7680,4,6947707508
17660,147515010,111691543,259206553,4,0,0,21504,7,5345597971
17661,147518910,141582720,289101630,8,0,1,7168,11,4702972880
17662,147522290,111580744,259103034,5,0,0,8192,12,784270625
17663,147526300,111619554,259145854,8,0,0,6144,11,5543590544
17664,147534500,111603653,259138153,9,0,0,8192,4,7746837499
17665,147553910,111856899,259410809,1,0,0,78336,1,9056021808
17666,147572220,112175826,259748046,6,0,0,147968,12,6809301349
17667,147572350,111770899,259343249,5,0,0,17920,12,9959465017
17668,147574209,141650436,289224645,3,0,1,13312,18,7281257211
17669,147582750,111936655,259519405,5,0,0,68608,12,9431239411
17670,147596280,111892295,259488575,0,0,0,14848,6,6580497228
17671,147596620,112233439,259830059,2,0,0,57344,1,3085454101
17672,147628480,111835220,259463700,2,0,0,60416,1,5620982161
17673,147634980,111519476,259154456,0,0,0,4608,6,6396630952
17674,147638399,141586269,289224668,5,0,1,1536,12,3604247750
17675,147641260,111899767,259541027,8,0,0,30720,11,9245987
17676,147668060,112011768,259679828,6,0,0,55296,12,43383767
17677,147668990,112095646,259764636,4,0,0,51200,7,5046319527
17678,147672590,112268172,259940762,7,0,0,40448,1,3989433113
17679,147679390,112169475,259848865,3,0,0,14336,18,5698258210
17680,147680800,112090411,259771211,8,0,0,21504,11,8979650331
17681,147681880,111904473,259586353,5,0,0,27136,12,1017425682
17682,147697480,112145728,259843208,4,0,0,37888,7,7629461056
17683,147709610,111759644,259469254,9,0,0,17920,4,4549250116
17684,147717220,141526237,289243457,2,0,1,30720,1,6164170073
17685,147721890,112180162,259902052,8,0,0,10752,11,9855535948
17686,147732059,141620218,289352277,5,0,1,5120,12,4151353677
17687,147733860,143654829,291388689,0,0,1,843776,6,3612668216
17688,147738300,112353891,260092191,0,0,0,512,6,121347948
17689,147751340,112499330,260250670,8,0,0,44032,11,10643748246
17690,147752270,143668757,291421027,2,0,1,19968,1,1270345451
17691,147759830,112225250,259985080,0,0,0,2048,6,4374074841
17692,147762300,143658750,291421050,7,0,1,512,1,5244203545
17693,147801460,111901479,259702939,6,0,0,20480,12,3709244954
17694,147802720,112849926,260652646,7,0,0,46592,1,10409791605
17695,147814330,112571861,260386191,5,0,0,99328,12,10215568749
17696,147814480,143606601,291421081,0,0,1,6656,6,3616848314
17697,147826880,111736394,259563274,7,0,0,5120,1,8575087527
17698,147828620,112155813,259984433,7,0,0,65536,1,1126103988
17699,147831630,112160406,259992036,2,0,0,22528,1,4780536148
17700,147837400,112115085,259952485,8,0,0,38400,11,4142098548
17701,147842270,112001741,259844011,2,0,0,2560,1,1641975898
17702,147847810,112004822,259852632,4,0,0,12288,7,8212947285
17703,147854430,112015221,259869651,5,0,0,5632,12,4999997315
17704,147862520,143558584,291421104,7,0,1,2048,1,4359985251
17705,147873190,143547937,291421127,7,0,1,4608,1,4628826172
17706,147905629,143515521,291421150,5,0,1,9216,12,7369598282
17707,147915320,112176692,260092012,7,0,0,117760,1,10166160057
17708,147916120,112321111,260237231,5,0,0,30720,12,309110980
17709,147917720,112219765,260137485,1,0,0,39424,1,3513812285
17710,147918570,112196100,260114670,5,0,0,11264,12,4341813258
17711,147927180,111982227,259909407,7,0,0,24064,1,168046336
17712,147927580,112685491,260613071,1,0,0,37888,1,10543085998
17713,147946320,111802685,259749005,9,0,0,3072,4,512269069
17714,147967670,111985641,259953311,4,0,0,2560,7,5154757382
17715,148004750,112404864,260409614,0,0,0,76800,6,8205812228
17716,148013300,112342604,260355904,5,0,0,38912,12,8536528739
17717,148035560,112717785,260753345,5,0,0,103936,12,1353782328
17718,148050190,112147932,260198122,2,0,0,20480,1,7692534020
17719,148050340,143411790,291462130,0,0,1,68096,6,10597643855
17720,148055370,112172478,260227848,2,0,0,33280,1,2715620182
17721,148056420,112037845,260094265,8,0,0,6656,11,9801072067
17722,148071530,112083718,260155248,0,0,0,23552,6,7114429610
17723,148071760,112039455,260111215,8,0,0,36352,11,9671608986
17724,148078100,143401571,291479671,8,0,1,22528,11,10240235514
17725,148082090,112249888,260331978,2,0,0,20480,1,3349241053
17726,148086700,112380956,260467656,2,0,0,56320,1,5199124379
17727,148103819,143375875,291479694,3,0,1,27136,18,3651332050
17728,148110700,112822093,260932793,8,0,0,56832,11,3246237774
17729,148134460,143345257,291479717,8,0,1,1024,11,1912540483
17730,148135610,112123538,260259148,6,0,0,8704,12,5269738324
17731,148137510,112393039,260530549,1,0,0,30208,1,3171884806
17732,148147050,113004512,261151562,6,0,0,40960,12,3994997032
17733,148147630,143332110,291479740,6,0,1,1024,12,1420962316
17734,148152270,112630963,260783233,6,0,0,26624,12,8399771486
17735,148159080,112824264,260983344,4,0,0,17920,7,2773397566
17736,148174930,112293217,260468147,5,0,0,1536,12,6906133620
17737,148175090,112235795,260410885,7,0,0,4096,1,9062171128
17738,148177800,112093110,260270910,4,0,0,4096,7,6996531366
17739,148178580,112263420,260442000,7,0,0,25088,1,2050110091
17740,148185480,112390349,260575829,9,0,0,11264,4,3855280402
17741,148194940,143284823,291479763,7,0,1,4608,1,4389974830
17742,148199210,112605932,260805142,0,0,0,10752,6,6218752940
17743,148203020,112757907,260960927,1,0,0,60416,1,9924357835
17744,148205830,113099079,261304909,1,0,0,43520,1,10660721685
17745,148223510,112079174,260302684,8,0,0,4608,11,1482605860
17746,148227519,143314964,291542483,5,0,1,9216,12,5889828424
17747,148227980,112972204,261200184,0,0,0,26624,6,2612511804
17748,148238690,112331321,260570011,0,0,0,40448,6,5503944423
17749,148241610,112072650,260314260,7,0,0,19456,1,280852533
17750,148245410,112326964,260572374,8,0,0,7680,11,10709236243
17751,148246510,112433610,260680120,8,0,0,49152,11,10240949551
17752,148250630,112451513,260702143,9,0,0,27648,4,4094074971
17753,148279980,112662516,260942496,5,0,0,31744,12,2079887141
17754,148288610,112207016,260495626,5,0,0,19456,12,2080999777
17755,148303820,112146388,260450208,4,0,0,6656,7,4672278709
17756,148322349,143246663,291569012,5,0,1,3584,12,7784848895
17757,148328040,143243878,291571918,8,0,1,4608,11,5571904069
17758,148344690,113120356,261465046,6,0,0,292864,12,10654284585
17759,148351600,112787459,261139059,6,0,0,33792,12,7707591172
17760,148357820,112453905,260811725,0,0,0,21504,6,5403710021
17761,148367570,112434273,260801843,7,0,0,60416,1,7367560845
17762,148374850,112205821,260580671,2,0,0,7168,1,10255159219
17763,148386990,143185082,291572072,4,0,1,8704,7,9386040968
17764,148400580,112512176,260912756,0,0,0,19456,6,6641947329
17765,148431880,112223382,260655262,2,0,0,6656,1,6886328834
17766,148461330,112070178,260531508,2,0,0,3072,1,8615716836
17767,148476810,113036146,261512956,5,0,0,26624,12,2506822702
17768,148490310,143159004,291649314,1,0,1,29184,1,6447675318
17769,148506580,112268472,260775052,2,0,0,71168,1,4934625983
17770,148508041,143209483,291717524,9,0,1,13312,4,5380363918
17771,148515079,143202468,291717547,5,0,1,11776,12,7995916365
17772,148516910,112295774,260812684,7,0,0,3072,1,3127581155
17773,148519040,113077806,261596846,2,0,0,86528,1,4521269495
17774,148522550,112392881,260915431,8,0,0,8704,11,8936157862
17775,148538910,112274421,260813331,8,0,0,2048,11,9483070557
17776,148542040,112364765,260906805,6,0,0,104448,12,1904456968
17777,148547490,112420480,260967970,0,0,0,23040,6,3122573003
17778,148564190,113058754,261622944,4,0,0,18432,7,9389226088
17779,148565130,112218282,260783412,9,0,0,512,4,9520875952
17780,148566150,112286915,260853065,8,0,0,30720,11,9967952022
17781,148578170,112622973,261201143,1,0,0,3072,1,10299247297
17782,148590630,112506297,261096927,7,0,0,56832,1,393337384
17783,148594210,112875414,261469624,6,0,0,10752,12,10186379239
17784,148606139,143141110,291747249,5,0,1,2048,12,2920263995
17785,148641030,112684092,261325122,1,0,0,17920,1,6489057732
17786,148653230,143094042,291747272,2,0,1,1024,1,7608607174
17787,148668290,143079005,291747295,7,0,1,15872,1,9233339224
17788,148674360,113144066,261818426,9,0,0,25088,4,9495785534
17789,148704891,143056848,291761739,9,0,1,1536,4,8634219350
17790,148708140,112583486,261291626,1,0,0,4608,1,7878244151
17791,148712890,112912729,261625619,5,0,0,8704,12,9279828802
17792,148713300,112412567,261125867,6,0,0,10240,12,3938637723
17793,148717430,112441807,261159237,5,0,0,25088,12,5430127696
17794,148727630,113659573,262387203,1,0,0,144384,1,6796145238
17795,148734340,112746943,261481283,2,0,0,2048,1,9938930497
17796,148736120,113234365,261970485,0,0,0,103424,6,8256880660
17797,148740470,143021292,291761762,7,0,1,6656,1,3394303318
17798,148758840,113284278,262043118,6,0,0,56320,12,763114235
17799,148761479,143027261,291788740,3,0,1,13824,18,2731430030
17800,148767110,112506036,261273146,5,0,0,125440,12,7718968214
17801,148772900,112844405,261617305,1,0,0,67072,1,8378871076
17802,148778680,112687645,261466325,6,0,0,4096,12,7000248212
17803,148784840,113336953,262121793,6,0,0,7680,12,807296834
17804,148787200,112875133,261662333,6,0,0,82432,12,6136762259
17805,148807150,112672839,261479989,4,0,0,12288,7,404600442
17806,148812590,113336707,262149297,1,0,0,3072,1,2201265212
17807,148817040,112558751,261375791,7,0,0,31744,1,1402480227
17808,148820700,112533974,261354674,1,0,0,73728,1,4244549494
17809,148821620,113473597,262295217,8,0,0,60416,11,2182717483
17810,148822590,112682231,261504821,8,0,0,48640,11,4406290056
17811,148824620,142981794,291806414,4,0,1,13824,7,227841405
17812,148829270,112646952,261476222,2,0,0,12288,1,6458466080
17813,148835860,113428950,262264810,4,0,0,32256,7,8133545724
17814,148837990,112448463,261286453,5,0,0,3584,12,7231038254
17815,148838510,112633945,261472455,7,0,0,9216,1,7179982979
17816,148871860,112608776,261480636,0,0,0,2048,6,9934349598
17817,148875410,112336525,261211935,1,0,0,4096,1,208342723
17818,148875730,142963887,291839617,7,0,1,14336,1,5244675317
17819,148880650,113670227,262550877,6,0,0,404992,12,9223871168
17820,148889670,112747516,261637186,2,0,0,37888,1,143848688
17821,148891520,142952534,291844054,0,0,1,5632,6,6877933006
17822,148892750,142951335,291844085,1,0,1,31232,1,8546104529
17823,148909020,113649688,262558708,0,0,0,25600,6,7571674642
17824,148909610,142937336,291846946,8,0,1,2560,11,6327673286
17825,148910540,113878021,262788561,6,0,0,101888,12,3182756017
17826,148919490,113740460,262659950,7,0,0,117248,1,5090446936
17827,148919660,112929547,261849207,0,0,0,8704,6,6412397351
17828,148920050,113010072,261930122,4,0,0,4096,7,1652801695
17829,148954930,113114160,262069090,6,0,0,7168,12,4194225946
17830,148965521,142977993,291943514,9,0,1,22528,4,5258300563
17831,148970900,113030005,262000905,6,0,0,8192,12,1185932427
17832,148978859,142973025,291951884,3,0,1,19456,18,849083465
17833,148985900,142993002,291978902,4,0,1,14336,7,1337875273
17834,148989770,113283267,262273037,6,0,0,22016,12,932429382
17835,149000650,112995652,261996302,2,0,0,53248,1,9086547102
17836,149011080,113165835,262176915,0,0,0,61440,6,7199007437
17837,149015190,113863382,262878572,2,0,0,7168,1,5508963956
17838,149017930,112910921,261928851,7,0,0,58368,1,4647741235
17839,149028780,142962599,291991379,7,0,1,12800,1,6518878638
17840,149028860,112804173,261833033,8,0,0,13824,11,412995495
17841,149036130,113101978,262138108,6,0,0,10752,12,10279325985
17842,149039090,113109248,262148338,4,0,0,30720,7,6317942086
17843,149043630,113631943,262675573,8,0,0,51200,11,2988271554
17844,149064860,112703718,261768578,6,0,0,7680,12,822082925
17845,149068550,112802215,261870765,5,0,0,29184,12,2279319442
17846,149081020,142944618,292025638,0,0,1,18432,6,5664754923
17847,149083410,142942251,292025661,2,0,1,1536,1,9211647513
17848,149083630,142961022,292044652,4,0,1,10240,7,9283615252
17849,149088970,112737559,261826529,9,0,0,2560,4,1215195847
17850,149098700,112956453,262055153,8,0,0,39424,11,5446830487
17851,149102370,143037940,292140310,6,0,1,60928,12,7718585076
17852,149137380,113570608,262707988,2,0,0,5632,1,9758160687
17853,149139830,113667239,262807069,0,0,0,23040,6,2185357351
17854,149144000,112877909,262021909,2,0,0,5632,1,9949133565
17855,149156250,143015131,292171381,8,0,1,4096,11,9123332611
17856,149161421,143010306,292171727,9,0,1,512,4,5980594218
17857,149162480,143013433,292175913,6,0,1,6656,12,3351358490
17858,149172460,112902308,262074768,7,0,0,6144,1,1793868734
17859,149210150,142980154,292190304,1,0,1,23552,1,49912157
17860,149211920,112882049,262093969,7,0,0,10240,1,9238849782
17861,149234620,142958681,292193301,1,0,1,9216,1,7489600020
17862,149234640,113192818,262427458,5,0,0,79872,12,865013676
17863,149246700,113322818,262569518,2,0,0,14848,1,8022419061
17864,149257560,113706704,262964264,0,0,0,12288,6,9776804662
17865,149263580,142933587,292197167,1,0,1,6144,1,7291480864
17866,149268500,113474923,262743423,9,0,0,116224,4,6818387095
17867,149270810,112813930,262084740,8,0,0,3584,11,3225957841
17868,149277860,113287111,262564971,2,0,0,20480,1,765752832
17869,149283060,113336440,262619500,4,0,0,137728,7,8028075240
17870,149283850,112926343,262210193,5,0,0,17920,12,5318338504
17871,149285030,113109060,262394090,5,0,0,22528,12,6934942686
17872,149288650,112828896,262117546,1,0,0,2048,1,4876530600
17873,149298950,113458544,262757494,5,0,0,46080,12,10195758328
17874,149302630,142931873,292234503,4,0,1,19968,7,811718544
17875,149303540,113487415,262790955,2,0,0,7680,1,7010732024
17876,149321090,113379364,262700454,0,0,0,28160,6,4437471955
17877,149333760,113645518,262979278,4,0,0,18944,7,4843505242
17878,149349970,142888079,292238049,8,0,1,5632,11,9845821590
17879,149369250,113507115,262876365,2,0,0,14336,1,9536847361
17880,149371890,113529703,262901593,4,0,0,18432,7,503930088
17881,149374370,113433369,262807739,4,0,0,2048,7,7290652954
17882,149378760,112887546,262266306,3,0,0,4608,18,4550265477
17883,149402770,113787426,263190196,1,0,0,122368,1,1620321011
17884,149416670,113289579,262706249,0,0,0,18944,6,1057431945
17885,149418370,113467096,262885466,9,0,0,5632,4,6382629683
17886,149431840,113397348,262829188,5,0,0,30208,12,9888429627
17887,149444440,113375513,262819953,0,0,0,7680,6,1549094968
17888,149456340,113121165,262577505,5,0,0,26112,12,973171090
17889,149474150,113817548,263291698,1,0,0,30720,1,8788247273
17890,149483650,113206298,262689948,5,0,0,47104,12,3198292099
17891,149486510,113397217,262883727,9,0,0,6656,4,4589409618
17892,149508220,142730815,292239035,0,0,1,1536,6,284506780
17893,149541280,113258746,262800026,2,0,0,29696,1,5399462372
17894,149547420,113463964,263011384,0,0,0,12288,6,1118899322
17895,149549190,113790616,263339806,7,0,0,1024,1,3841653821
17896,149552610,113139233,262691843,7,0,0,6144,1,8717266967
17897,149580180,113237410,262817590,0,0,0,32256,6,2928363951
17898,149588430,113035773,262624203,4,0,0,15360,7,4765444041
17899,149588880,142650757,292239637,0,0,1,9728,6,6814705547
17900,149600550,142648268,292248818,6,0,1,3584,12,6288850083
17901,149602680,113345391,262948071,0,0,0,1536,6,2665658118
17902,149612030,113337936,262949966,9,0,0,6144,4,2473378295
17903,149618439,142630402,292248841,3,0,1,1024,18,7586220129
17904,149631760,113328737,262960497,7,0,0,25600,1,1679527488
17905,149642770,142608530,292251300,1,0,1,22016,1,8187860017
17906,149645009,143944826,293589835,3,0,1,461312,18,9883804124
17907,149658060,143963024,293621084,0,0,1,20992,6,8684103500
17908,149663520,113429466,263092986,2,0,0,67584,1,1024566478
17909,149672990,113519725,263192715,8,0,0,8192,11,2179898739
17910,149680900,113439650,263120550,9,0,0,31232,4,671811191
17911,149683731,143954938,293638669,9,0,1,1536,4,3964559650
17912,149685380,113382889,263068269,9,0,0,77312,4,7848937098
17913,149686370,113740576,263426946,2,0,0,57856,1,4594458919
17914,149712010,143927953,293639963,1,0,1,7680,1,2551477327
17915,149712520,113217985,262930505,2,0,0,65536,1,3138301495
17916,149713520,143928389,293641909,6,0,1,3072,12,5314437308
17917,149717140,113435733,263152873,2,0,0,105984,1,9623701882
17918,149722510,113476000,263198510,9,0,0,18944,4,8346042556
17919,149744330,143965981,293710311,2,0,1,35328,1,2709120845
17920,149752350,113348342,263100692,8,0,0,25088,11,10424011139
17921,149763820,113308551,263072371,8,0,0,8704,11,7230264345
17922,149780170,113441482,263221652,4,0,0,37888,7,3556587376
17923,149785570,113325441,263111011,5,0,0,33792,12,5528889205
17924,149788670,143921664,293710334,0,0,1,4096,6,9957133440
17925,149792800,113139312,262932112,5,0,0,5120,12,4728213185
17926,149798790,113440247,263239037,9,0,0,1024,4,1163465224
17927,149802090,113877460,263679550,4,0,0,3584,7,7669009970
17928,149812930,113596365,263409295,7,0,0,77824,1,5330249187
17929,149824069,144117242,293941311,3,0,1,109056,18,10520084162
17930,149829320,113428608,263257928,1,0,0,25088,1,8211304460
17931,149847450,113222246,263069696,8,0,0,4608,11,8378647476
17932,149853900,113371363,263225263,1,0,0,11776,1,8536540723
17933,149863080,113983049,263846129,9,0,0,33792,4,7399441931
17934,149866880,113343197,263210077,9,0,0,37888,4,4426742595
17935,149872359,144460310,294332669,3,0,1,214528,18,8358567512
17936,149873390,113365312,263238702,8,0,0,44032,11,10235641753
17937,149878830,144511074,294389904,2,0,1,6656,1,1587117174
17938,149900450,144489469,294389919,1,0,1,6144,1,3443122591
17939,149903210,113436238,263339448,3,0,0,6144,18,4073820195
17940,149908211,144481723,294389934,9,0,1,3072,4,213739711
17941,149927890,114246025,264173915,5,0,0,77824,12,9084900119
17942,149930940,113406590,263337530,8,0,0,58368,11,2168857283
17943,149957010,113815073,263772083,4,0,0,32256,7,5328797686
17944,149981430,114049631,264031061,9,0,0,18432,4,8769702686
17945,149997240,113972627,263969867,4,0,0,45568,7,6623997436
17946,149998750,113433375,263432125,0,0,0,16896,6,6562931765
17947,150000130,113511777,263511907,8,0,0,26112,11,10664619640
17948,150002830,113295131,263297961,0,0,0,20480,6,6655927936
17949,150024360,113633524,263657884,1,0,0,55808,1,1572500941
17950,150038670,113755880,263794550,2,0,0,10752,1,2081068113
17951,150046910,113338650,263385560,8,0,0,54784,11,4812463139
17952,150048590,113620470,263669060,9,0,0,13824,4,2293509357
17953,150049720,144340229,294389949,4,0,1,3584,7,7286057252
17954,150053820,144336144,294389964,2,0,1,6656,1,8737952624
17955,150058380,114043985,264102365,8,0,0,150016,11,683634086
17956,150066940,113501782,263568722,9,0,0,17920,4,4588191297
17957,150073050,144318428,294391478,8,0,1,33280,11,5294430304
17958,150098040,144296984,294395024,2,0,1,5632,1,10067552885
17959,150114100,113389828,263503928,5,0,0,94208,12,6743888548
17960,150114891,144294813,294409704,9,0,1,10752,4,8392479464
17961,150120940,113543877,263664817,1,0,0,22528,1,5586527136
17962,150122560,144305177,294427737,0,0,1,25600,6,9100616242
17963,150124230,113331569,263455799,4,0,0,31232,7,9625885908
17964,150129830,113217302,263347132,0,0,0,1024,6,7890175958
17965,150131930,113605523,263737453,9,0,0,41472,4,4024015777
17966,150135340,113747524,263882864,3,0,0,67584,18,2172817912
17967,150138830,114050882,264189712,4,0,0,29184,7,6534969592
17968,150148400,113460607,263609007,1,0,0,12288,1,10298008455
17969,150149850,113985937,264135787,8,0,0,11264,11,26788160
17970,150165380,113557298,263722678,7,0,0,29184,1,3692434728
17971,150172680,113468177,263640857,5,0,0,60416,12,1193151349
17972,150185410,113813923,263999333,7,0,0,58880,1,5518013872
17973,150188710,113815482,264004192,4,0,0,15872,7,7563152454
17974,150192280,144235472,294427752,6,0,1,9216,12,8342438134
17975,150201520,144230029,294431549,0,0,1,10240,6,1216378361
17976,150216100,114162031,264378131,3,0,0,14848,18,1808809495
17977,150218610,114222015,264440625,3,0,0,45056,18,4876895996
17978,150219069,144214106,294433175,5,0,1,2560,12,3206655122
17979,150226290,113750977,263977267,5,0,0,16896,12,8386240395
17980,150230370,113719442,263949812,7,0,0,30208,1,1124589389
17981,150230819,144213283,294444102,3,0,1,19456,18,3232201999
17982,150237110,113544971,263782081,9,0,0,26624,4,7318075818
17983,150254610,144191141,294445751,2,0,1,11776,1,262414762
17984,150261370,113521693,263783063,1,0,0,3072,1,4500286371
17985,150265970,144183007,294448977,6,0,1,5120,12,4540149160
17986,150286739,144166104,294452843,5,0,1,6144,12,4672270930
17987,150303950,113810996,264114946,3,0,0,11776,18,5958608406
17988,150307970,113933750,264241720,7,0,0,48640,1,6387897099
17989,150311471,144178291,294489762,9,0,1,28160,4,2216871630
17990,150337320,114165510,264502830,3,0,0,5632,18,8747923163
17991,150343420,114688366,265031786,0,0,0,173056,6,4815477038
17992,150352360,113844707,264197067,2,0,0,24064,1,8657835230
17993,150365550,114018376,264383926,3,0,0,18944,18,4607432374
17994,150367320,114511363,264878683,2,0,0,10752,1,3290103574
17995,150371580,114945182,265316762,8,0,0,6656,11,7179407132
17996,150381040,113951731,264332771,1,0,0,20992,1,1434877807
17997,150382870,114469045,264851915,0,0,0,640000,6,4598040006
17998,150420910,113895840,264316750,4,0,0,26624,7,3106381255
17999,150424010,114027793,264451803,7,0,0,512,1,10624687467
18000,150447520,113979354,264426874,8,0,0,15360,11,2129807200
18001,150454020,113968151,264422171,2,0,0,86016,1,312529508
18002,150468500,113806042,264274542,6,0,0,53248,12,2250348450
18003,150490700,114638029,265128729,0,0,0,45056,6,8640048070
18004,150495010,114619968,265114978,5,0,0,51200,12,4274306279
18005,150503620,114466929,264970549,0,0,0,95744,6,3152745443
18006,150514150,113704987,264219137,5,0,0,2048,12,9827993752
18007,150515160,114389130,264904290,1,0,0,83968,1,3408037940
18008,150515510,114359874,264875384,1,0,0,69120,1,1684194397
18009,150522680,114531366,265054046,5,0,0,40960,12,5531748795
18010,150535290,114317428,264852718,8,0,0,2560,11,3011239238
18011,150544690,114386010,264930700,6,0,0,9728,12,10045802292
18012,150548370,114038704,264587074,9,0,0,3584,4,4066639465
18013,150568630,113815639,264384269,1,0,0,1024,1,9485792399
18014,150580960,113945586,264526546,3,0,0,1536,18,10681548654
18015,150603320,114585048,265188368,0,0,0,114176,6,4013852954
18016,150631650,114409706,265041356,2,0,0,28160,1,5599774278
18017,150632600,113967525,264600125,7,0,0,7168,1,7966897115
18018,150632940,113919022,264551962,7,0,0,19968,1,3283308034
18019,150651010,114420242,265071252,7,0,0,26112,1,5116882967
18020,150661260,114317775,264979035,4,0,0,18432,7,515258310
18021,150696220,113941620,264637840,0,0,0,15872,6,3387990914
18022,150718490,114209223,264927713,3,0,0,76800,18,985239787
18023,150724650,114716827,265441477,2,0,0,25088,1,2352393518
18024,150733970,114329303,265063273,1,0,0,30208,1,5321670830
18025,150781880,114072421,264854301,2,0,0,5120,1,7287950750
18026,150795870,114236875,265032745,8,0,0,3072,11,9803829467
18027,150806340,114788494,265594834,6,0,0,187392,12,8972128209
18028,150814000,114127354,264941354,2,0,0,30208,1,7531971970
18029,150823410,114648831,265472241,8,0,0,17920,11,881825859
18030,150825070,114107057,264932127,9,0,0,4608,4,326294389
18031,150845010,114432217,265277227,6,0,0,21504,12,8171376399
18032,150846170,114127226,264973396,6,0,0,9216,12,3641432824
18033,150867650,114366749,265234399,2,0,0,27136,1,10637462304
18034,150870940,114228415,265099355,1,0,0,92160,1,192215873
18035,150877570,114163973,265041543,1,0,0,512,1,10089505218
18036,150915420,114984285,265899705,0,0,0,71680,6,5118641219
18037,150928970,114206373,265135343,5,0,0,21504,12,5118571262
18038,150929120,114224437,265153557,8,0,0,44032,11,200824235
18039,150938330,114272407,265210737,5,0,0,3072,12,1004798193
18040,150960300,114175534,265135834,4,0,0,1536,7,2396186878
18041,150969710,114406896,265376606,9,0,0,49152,4,6813948250
18042,150998530,114239417,265237947,7,0,0,6656,1,6971795042
18043,151015700,114299011,265314711,8,0,0,97280,11,10184453676
18044,151026020,115009353,266035373,8,0,0,55296,11,9525990993
18045,151029260,114823328,265852588,8,0,0,477696,11,5559178349
18046,151034260,114573107,265607367,1,0,0,3072,1,4185278721
18047,151042920,114870403,265913323,3,0,0,29696,18,2270907966
18048,151057700,114817554,265875254,1,0,0,49664,1,591807213
18049,151059490,115086049,266145539,0,0,0,18944,6,7314694961
18050,151067910,115024732,266092642,7,0,0,93184,1,2685474970
18051,151076000,114801796,265877796,6,0,0,6144,12,5761679506
18052,151096130,115058956,266155086,6,0,0,31232,12,8287444046
18053,151104710,114890344,265995054,5,0,0,15872,12,4590131721
18054,151121020,115250291,266371311,9,0,0,37888,4,3833776255
18055,151122610,114997378,266119988,2,0,0,65536,1,3794210325
18056,151133030,114873759,266006789,2,0,0,13312,1,5549140819
18057,151133680,115131754,266265434,6,0,0,45568,12,9056503844
18058,151159560,114755705,265915265,9,0,0,1024,4,9622157958
18059,151176270,114887957,266064227,0,0,0,43008,6,3332438865
18060,151189780,114986264,266176044,8,0,0,19456,11,7947470917
18061,151195830,114974255,266170085,3,0,0,49152,18,1426776693
18062,151220970,114376695,265597665,6,0,0,9216,12,10217713408
18063,151230490,114645411,265875901,7,0,0,2048,1,4545280264
18064,151283510,114856226,266139736,8,0,0,37888,11,4069203573
18065,151285550,114574549,265860099,7,0,0,24576,1,5398742703
18066,151288110,114313010,265601120,5,0,0,11264,12,4740651976
18067,151297070,115228745,266525815,1,0,0,77824,1,7239070554
18068,151317100,114952101,266269201,9,0,0,12288,4,3352162206
18069,151325160,114867287,266192447,0,0,0,53760,6,479741451
18070,151346340,114753657,266099997,0,0,0,24064,6,5321394393
18071,151352030,114315893,265667923,9,0,0,9728,4,9494830079
18072,151392910,114735213,266128123,8,0,0,26624,11,10642392762
18073,151396570,114602563,265999133,1,0,0,13312,1,2716412667
18074,151402500,114501752,265904252,4,0,0,14848,7,1649963868
18075,151406240,114869068,266275308,8,0,0,19968,11,3374080502
18076,151432530,115284170,266716700,9,0,0,43520,4,2327671309
18077,151443430,115058650,266502080,9,0,0,256512,4,9635217432
18078,151452460,115142873,266595333,8,0,0,4608,11,232755304
18079,151454870,114836625,266291495,6,0,0,12288,12,1328559281
18080,151455920,114458994,265914914,5,0,0,5120,12,1480595367
18081,151459900,115186187,266646087,5,0,0,34816,12,1608150240
18082,151470870,115115253,266586123,3,0,0,148480,18,4069150341
18083,151474030,114461234,265935264,0,0,0,31232,6,5476145619
18084,151479060,114834420,266313480,6,0,0,13824,12,8999566766
18085,151485920,115105755,266591675,3,0,0,10240,18,10311650858
18086,151488390,115242632,266731022,4,0,0,10240,7,8481070186
18087,151511340,115476876,266988216,4,0,0,65024,7,4858469994
18088,151555710,114983255,266538965,3,0,0,33280,18,8995469129
18089,151567390,114712161,266279551,7,0,0,13824,1,1767791301
18090,151571220,115017312,266588532,2,0,0,3584,1,4809580162
18091,151574660,114621398,266196058,1,0,0,11776,1,10525370309
18092,151590830,114996587,266587417,9,0,0,2560,4,3793394979
18093,151606020,115029436,266635456,3,0,0,131584,18,3366353596
18094,151612210,114697035,266309245,8,0,0,19456,11,5672383440
18095,151618900,114756178,266375078,0,0,0,12288,6,6944439640
18096,151619240,114701439,266320679,9,0,0,23552,4,8011885539
18097,151621470,115038680,266660150,7,0,0,46080,1,1757426211
18098,151625490,115157588,266783078,8,0,0,39936,11,9957077344
18099,151631240,115329451,266960691,7,0,0,95232,1,5566104974
18100,151658030,114935876,266593906,0,0,0,7168,6,7165446776
18101,151665820,115057611,266723431,4,0,0,22016,7,1105541159
18102,151678470,114850332,266528802,8,0,0,9728,11,581824129
18103,151716200,114870414,266586614,5,0,0,1536,12,1380049117
18104,151724650,115544392,267269042,1,0,0,168448,1,3932726357
18105,151739630,114963787,266703417,0,0,0,20480,6,1558024061
18106,151743560,115406592,267150152,9,0,0,11264,4,733274493
18107,151754520,115285934,267040454,9,0,0,111104,4,8609050869
18108,151755400,114785460,266540860,3,0,0,6144,18,8393147399
18109,151761420,115206961,266968381,2,0,0,16384,1,486131006
18110,151764540,115296910,267061450,5,0,0,14336,12,5994397960
18111,151768820,115159504,266928324,0,0,0,22528,6,9885271970
18112,151772220,115371920,267144140,4,0,0,6656,7,8384539761
18113,151795760,115495792,267291552,4,0,0,73728,7,10460346486
18114,151814610,114945852,266760462,9,0,0,2048,4,6166732248
18115,151817640,115022858,266840498,6,0,0,67072,12,10578752278
18116,151821470,115609644,267431114,1,0,0,150528,1,7051699654
18117,151824860,115068976,266893836,1,0,0,5120,1,2241293259
18118,151840190,115528002,267368192,7,0,0,46080,1,6088001395
18119,151857410,114877690,266735100,9,0,0,5632,4,5287659483
18120,151869630,115456132,267325762,9,0,0,93184,4,732987586
18121,151871860,115256812,267128672,3,0,0,16384,18,10352643162
18122,151885600,115167825,267053425,9,0,0,42496,4,3241172872
18123,151890400,115463675,267354075,8,0,0,46080,11,2944845048
18124,151892180,114967584,266859764,0,0,0,8192,6,4711571578
18125,151899490,115654763,267554253,4,0,0,49664,7,10299599131
18126,151913530,115279543,267193073,9,0,0,75264,4,1365377471
18127,151925340,115131719,267057059,8,0,0,10752,11,9367662318
18128,151944370,115018996,266963366,0,0,0,8704,6,8380746939
18129,151954380,115494884,267449264,5,0,0,32256,12,8016381244
18130,151958610,115191877,267150487,9,0,0,1024,4,5419030487
18131,151962060,115423159,267385219,3,0,0,55808,18,9099910686
18132,151962990,115377022,267340012,5,0,0,18432,12,4645635172
18133,151966100,115508574,267474674,2,0,0,38400,1,8532751343
18134,151975140,115078620,267053760,1,0,0,1024,1,8554852653
18135,151984720,115081889,267066609,5,0,0,8192,12,3315333522
18136,151990490,115072075,267062565,2,0,0,3584,1,9091981321
18137,152024000,115684947,267708947,1,0,0,43008,1,5476263725
18138,152028720,115305645,267334365,5,0,0,28160,12,1009441697
18139,152032360,115647658,267680018,4,0,0,14336,7,616008827
18140,152033660,115746733,267780393,3,0,0,43520,18,5346438480
18141,152049580,115626047,267675627,8,0,0,48640,11,5180010785
18142,152050110,115901886,267951996,8,0,0,80384,11,8117830414
18143,152057160,115434057,267491217,0,0,0,4096,6,9351110510
18144,152079010,115218337,267297347,8,0,0,18944,11,9072755862
18145,152080680,115119592,267200272,1,0,0,23552,1,3300508118
18146,152093840,115345573,267439413,5,0,0,27136,12,7706729127
18147,152097830,115662279,267760109,0,0,0,25088,6,5604380952
18148,152105630,115614931,267720561,3,0,0,16896,18,582615608
18149,152105650,115770934,267876584,7,0,0,80384,1,7615569975
18150,152110600,115345753,267456353,2,0,0,17920,1,2487269617
18151,152118860,115331987,267450847,2,0,0,5120,1,4516347552
18152,152146110,115671147,267817257,1,0,0,43520,1,10030416486
18153,152158550,115365240,267523790,7,0,0,15872,1,3399830280
18154,152170280,115316585,267486865,6,0,0,39936,12,1557517508
18155,152172530,115424685,267597215,4,0,0,1536,7,6025730600
18156,152184510,115596374,267780884,8,0,0,1536,11,673673321
18157,152195820,115656249,267852069,1,0,0,11776,1,2606173330
18158,152199840,115513966,267713806,0,0,0,15872,6,5708046010
18159,152200200,115490917,267691117,4,0,0,36352,7,8561198810
18160,152213860,115674135,267887995,0,0,0,37376,6,9313670305
18161,152232920,115274309,267507229,5,0,0,9216,12,5326986740
18162,152283220,115802920,268086140,9,0,0,2560,4,1553008488
18163,152285870,115639872,267925742,1,0,0,36864,1,4824997014
18164,152304380,115676431,267980811,4,0,0,29696,7,4361988685
18165,152305450,115808718,268114168,3,0,0,8704,18,3886206872
18166,152305850,115754611,268060461,0,0,0,20992,6,2728896692
18167,152322340,115741466,268063806,5,0,0,6144,12,3209993414
18168,152338870,115483246,267822116,8,0,0,15872,11,7372699918
18169,152346520,115639462,267985982,6,0,0,16896,12,6918846379
18170,152375030,115679012,268054042,8,0,0,28160,11,2206477183
18171,152398140,115888271,268286411,5,0,0,56320,12,3244258118
18172,152417770,115883047,268300817,1,0,0,9728,1,4923771225
18173,152429680,115817171,268246851,6,0,0,48640,12,4118765917
18174,152439320,115597828,268037148,2,0,0,119296,1,4868363144
18175,152439670,115256150,267695820,7,0,0,15360,1,6671034361
18176,152448980,115379555,267828535,0,0,0,20992,6,1572062931
18177,152458740,115293702,267752442,0,0,0,10752,6,9045408470
18178,152476090,115793138,268269228,5,0,0,20992,12,1114589497
18179,152512130,115533309,268045439,3,0,0,27136,18,5244997481
18180,152542150,115576097,268118247,1,0,0,13312,1,5034526314
18181,152551980,115856031,268408011,5,0,0,40960,12,4932609308
18182,152555050,115505590,268060640,6,0,0,512,12,6787637486
18183,152560860,115501051,268061911,2,0,0,4096,1,5583864191
18184,152572650,116054174,268626824,4,0,0,19456,7,6854422886
18185,152576120,115509217,268085337,1,0,0,38912,1,655140404
18186,152612490,115296440,267908930,2,0,0,22016,1,9147934103
18187,152613310,115380503,267993813,5,0,0,25600,12,6942408848
18188,152614710,115705419,268320129,2,0,0,10752,1,4765909838
18189,152616770,115747904,268364674,6,0,0,21504,12,3455050505
18190,152628400,115833137,268461537,5,0,0,114176,12,8710457812
18191,152634400,115318711,267953111,6,0,0,3584,12,3183550600
18192,152641160,115286321,267927481,2,0,0,5632,1,7319069179
18193,152654370,115608439,268262809,3,0,0,9216,18,6929903274
18194,152655370,115298248,267953618,4,0,0,1536,7,4822251252
18195,152669710,115590268,268259978,8,0,0,43008,11,5403538651
18196,152675310,115834937,268510247,7,0,0,119296,1,2081831174
18197,152675490,115622332,268297822,9,0,0,37376,4,9240800285
18198,152676400,115424676,268101076,3,0,0,1024,18,6114843798
18199,152678310,116156027,268834337,0,0,0,45056,6,5379450960
18200,152678980,115632845,268311825,2,0,0,8704,1,5777015412
18201,152709220,116170830,268880050,7,0,0,29184,1,2292419485
18202,152716700,116249884,268966584,7,0,0,43520,1,7076401130
18203,152741190,116630007,269371197,8,0,0,596480,11,2823866939
18204,152750090,116070496,268820586,1,0,0,99840,1,6121376712
18205,152751810,115869063,268620873,4,0,0,27648,7,9959577674
18206,152755560,115830821,268586381,5,0,0,39424,12,9879292840
18207,152762970,115570984,268333954,3,0,0,21504,18,7629499400
18208,152768190,115658536,268426726,0,0,0,11776,6,9261734839
18209,152770270,115879897,268650167,4,0,0,40960,7,1653681068
18210,152779480,116128543,268908023,6,0,0,83456,12,9146975030
18211,152783700,116076776,268860476,4,0,0,13312,7,10186780496
18212,152814450,116215961,269030411,5,0,0,29184,12,8562695022
18213,152817530,115716687,268534217,5,0,0,19968,12,10644460566
18214,152819490,115813054,268632544,0,0,0,12288,6,7255252293
18215,152822280,115907153,268729433,9,0,0,3072,4,4663256336
18216,152831660,116604937,269436597,4,0,0,11776,7,8013121429
18217,152839210,116535964,269375174,8,0,0,12800,11,902561402
18218,152861210,116001473,268862683,4,0,0,7168,7,5185036548
18219,152861280,116319863,269181143,9,0,0,36352,4,9113653500
18220,152871140,115736763,268607903,9,0,0,3072,4,10246881958
18221,152886030,116303404,269189434,1,0,0,27136,1,8580664231
18222,152887490,116223346,269110836,5,0,0,5120,12,6808399353
18223,152905080,116562919,269467999,3,0,0,81920,18,1825096627
18224,152912000,116507547,269419547,6,0,0,70656,12,9578739157
18225,152919160,115928662,268847822,9,0,0,17408,4,5937650678
18226,152922700,116520316,269443016,0,0,0,20992,6,704987417
18227,152933980,115917297,268851277,2,0,0,11264,1,8113692032
18228,152974410,116514787,269489197,3,0,0,9216,18,5479159199
18229,152981000,115929386,268910386,6,0,0,7680,12,8202709893
18230,152989160,116603038,269592198,4,0,0,92672,7,917932179
18231,153002270,116430716,269432986,0,0,0,44032,6,9494662832
18232,153004570,116001013,269005583,6,0,0,8192,12,2881898170
18233,153014540,116152084,269166624,2,0,0,35328,1,10157630681
18234,153014620,115827852,268842472,5,0,0,26624,12,3766824615
18235,153026020,116593821,269619841,0,0,0,90624,6,4944494074
18236,153026400,116129437,269155837,3,0,0,20992,18,5693336518
18237,153038360,116485047,269523407,1,0,0,91136,1,10521394999
18238,153041180,116356816,269397996,4,0,0,72192,7,940556670
18239,153053770,116600327,269654097,6,0,0,7168,12,7022778162
18240,153055670,116614041,269669711,1,0,0,32256,1,8520504628
18241,153057880,116502558,269560438,0,0,0,32256,6,7303709316
18242,153059350,116073485,269132835,1,0,0,3584,1,9491614832
18243,153107100,116760266,269867366,9,0,0,20992,4,7771266327
18244,153110360,116375983,269486343,9,0,0,18944,4,9084723444
18245,153110470,116419832,269530302,5,0,0,22528,12,1942726192
18246,153110930,116384686,269495616,5,0,0,20992,12,6889930007
18247,153117580,116258397,269375977,4,0,0,2560,7,2532039381
18248,153121730,116654595,269776325,2,0,0,28160,1,6260527142
18249,153128020,116499767,269627787,5,0,0,25600,12,2010138776
18250,153129180,116351322,269480502,0,0,0,40960,6,4907039213
18251,153153370,116809067,269962437,8,0,0,56832,11,8822421983
18252,153160880,116389638,269550518,6,0,0,45056,12,3508756506
18253,153166610,116914329,270080939,5,0,0,5120,12,5377410129
18254,153206080,116330687,269536767,9,0,0,20992,4,7314155972
18255,153221840,116342099,269563939,1,0,0,11264,1,3387280893
18256,153221950,116989967,270211917,3,0,0,81920,18,6087092482
18257,153243510,116730624,269974134,6,0,0,11776,12,1641837458
18258,153262630,116477255,269739885,2,0,0,9216,1,1044732979
18259,153276570,116584377,269860947,8,0,0,72704,11,3913073995
18260,153281020,116614605,269895625,3,0,0,92672,18,10031248976
18261,153282380,116616076,269898456,9,0,0,9216,4,9836481807
18262,153290190,116608936,269899126,4,0,0,512,7,4072052230
18263,153291050,116867974,270159024,6,0,0,93184,12,704427773
18264,153303340,117009568,270312908,3,0,0,53248,18,2627464932
18265,153309670,116589277,269898947,5,0,0,1536,12,5231702353
18266,153328460,116378803,269707263,7,0,0,4096,1,10342355539
18267,153328490,116736548,270065038,4,0,0,8192,7,487198723
18268,153330660,117051549,270382209,3,0,0,89088,18,5377173699
18269,153340080,116671367,270011447,4,0,0,8192,7,7599821390
18270,153347760,116616884,269964644,9,0,0,7168,4,9834240796
18271,153359410,116439767,269799177,8,0,0,15360,11,8000011968
18272,153361660,116700859,270062519,4,0,0,46592,7,3040171062
18273,153363570,116567605,269931175,4,0,0,16896,7,1282628848
18274,153377850,117111963,270489813,9,0,0,74240,4,10080600886
18275,153386530,116842281,270228811,8,0,0,42496,11,10615541460
18276,153392880,117165577,270558457,2,0,0,60416,1,7217017418
18277,153394900,116681781,270076681,7,0,0,6144,1,9466924418
18278,153401420,116701346,270102766,4,0,0,24576,7,8024338373
18279,153410170,116863692,270273862,1,0,0,39424,1,9610978461
18280,153414600,116623974,270038574,6,0,0,61952,12,10043870578
18281,153425110,116871551,270296661,3,0,0,74752,18,5221108495
18282,153428150,117508349,270936499,4,0,0,19456,7,9371849594
18283,153433860,116951960,270385820,8,0,0,11776,11,5297221584
18284,153438180,117285176,270723356,4,0,0,17920,7,6968819152
18285,153443740,117982751,271426491,2,0,0,43008,1,9076644360
18286,153445440,116661405,270106845,7,0,0,13312,1,3852787142
18287,153448010,116672039,270120049,0,0,0,17408,6,3896437637
18288,153467400,116611956,270079356,4,0,0,8704,7,6786611694
18289,153480360,117080164,270560524,6,0,0,6656,12,404732033
18290,153485560,116934852,270420412,8,0,0,35328,11,1468378269
18291,153488490,117226933,270715423,5,0,0,19968,12,6887911820
18292,153488740,117140043,270628783,0,0,0,95744,6,10732755424
18293,153503810,116901719,270405529,0,0,0,2560,6,7500097810
18294,153526600,117778973,271305573,2,0,0,414208,1,8418204012
18295,153541800,116674040,270215840,2,0,0,12800,1,1741575249
18296,153546980,116993000,270539980,4,0,0,75776,7,8092138463
18297,153549630,117351661,270901291,8,0,0,80384,11,2823107563
18298,153581030,116739592,270320622,0,0,0,22528,6,8366692273
18299,153586880,117496877,271083757,7,0,0,75264,1,9822558811
18300,153586930,117172059,270758989,9,0,0,7680,4,678764363
18301,153593540,117249167,270842707,8,0,0,39424,11,9109480824
18302,153607610,117029362,270636972,0,0,0,26624,6,6073731140
18303,153617080,117070545,270687625,7,0,0,25600,1,4080139927
18304,153626830,117192403,270819233,3,0,0,1536,18,7456138855
18305,153627070,116761425,270388495,4,0,0,8704,7,5304389670
18306,153636250,117381396,271017646,5,0,0,9216,12,1001328458
18307,153637600,117329148,270966748,2,0,0,4608,1,3677054026
18308,153642330,117809525,271451855,7,0,0,51200,1,7690909323
18309,153643730,117311351,270955081,8,0,0,18944,11,10491774550
18310,153644710,117118801,270763511,2,0,0,4608,1,4177096044
18311,153649450,117477929,271127379,4,0,0,57344,7,4471419183
18312,153655580,117003913,270659493,7,0,0,12800,1,9791937305
18313,153672010,117255711,270927721,2,0,0,14848,1,2705615494
18314,153683540,117025776,270709316,1,0,0,37376,1,5527620571
18315,153695370,117690681,271386051,3,0,0,48640,18,3467369519
18316,153697290,117789727,271487017,3,0,0,77312,18,4103022421
18317,153698860,117114555,270813415,8,0,0,114688,11,8571106312
18318,153701070,117702857,271403927,8,0,0,17408,11,7134941282
18319,153703720,117606400,271310120,5,0,0,14848,12,9213447893
18320,153729000,117734430,271463430,1,0,0,37888,1,6518878728
18321,153736340,116719253,270455593,2,0,0,512,1,2146653462
18322,153739590,117109692,270849282,1,0,0,21504,1,5586040781
18323,153740240,117866243,271606483,2,0,0,75264,1,5004306645
18324,153755020,117558867,271313887,4,0,0,12288,7,4923466152
18325,153769440,116818541,270587981,2,0,0,19456,1,1305047109
18326,153787840,117648369,271436209,9,0,0,31744,4,875870899
18327,153812210,117938621,271750831,3,0,0,111616,18,9472652029
18328,153813670,116841900,270655570,3,0,0,20480,18,8471999745
18329,153814350,117556367,271370717,8,0,0,4096,11,647834360
18330,153825320,117716121,271541441,1,0,0,37888,1,5336331717
18331,153838040,116980702,270818742,3,0,0,17408,18,4849347025
18332,153852020,117517426,271369446,9,0,0,182272,4,6122963662
18333,153859160,117657239,271516399,8,0,0,26624,11,6745257637
18334,153875430,117045852,270921282,8,0,0,65536,11,10199148933
18335,153887920,117746065,271633985,5,0,0,73216,12,751997192
18336,153895190,117756758,271651948,3,0,0,58880,18,8651135915
18337,153896790,117905391,271802181,9,0,0,28160,4,8819444548
18338,153902390,117231564,271133954,1,0,0,21504,1,8509957646
18339,153915940,117229535,271145475,4,0,0,4608,7,7238000379
18340,153915960,117651111,271567071,0,0,0,83968,6,3662101263
18341,153932580,117456770,271389350,1,0,0,10752,1,2682043701
18342,153932600,117245311,271177911,0,0,0,10240,6,10148604389
18343,153935780,117774767,271710547,7,0,0,58368,1,2847242067
18344,153953760,117444840,271398600,2,0,0,14848,1,727310586
18345,153954210,116975776,270929986,9,0,0,1024,4,8746245189
18346,153957460,117413748,271371208,9,0,0,1536,4,10456523256
18347,153981600,117412453,271394053,4,0,0,15360,7,5218558111
18348,153996210,117587318,271583528,5,0,0,43008,12,7887735134
18349,153996640,117064162,271060802,0,0,0,4096,6,4931093492
18350,154020390,117392974,271413364,3,0,0,2048,18,3330249600
18351,154046700,117366009,271412709,4,0,0,28672,7,2269074074
18352,154056840,117049972,271106812,7,0,0,512,1,5965117214
18353,154065030,117703731,271768761,8,0,0,6144,11,5059431490
18354,154075800,117494601,271570401,8,0,0,7168,11,5639378421
18355,154087490,117442384,271529874,1,0,0,3584,1,1074514965
18356,154092900,117590855,271683755,2,0,0,15360,1,9225901917
18357,154102890,117847941,271950831,8,0,0,46080,11,8244486905
18358,154106380,117604658,271711038,2,0,0,1536,1,768690078
18359,154117010,117558719,271675729,4,0,0,67584,7,5271067102
18360,154132330,117560402,271692732,6,0,0,29184,12,4239739028
18361,154149850,117616962,271766812,8,0,0,36352,11,4829366048
18362,154150730,117357534,271508264,5,0,0,69632,12,5517390408
18363,154160060,117357454,271517514,5,0,0,3584,12,5002542315
18364,154166390,117587272,271753662,2,0,0,9216,1,182754228
18365,154166870,117488221,271655091,2,0,0,10240,1,8640213173
18366,154167870,117360889,271528759,8,0,0,18432,11,8552741019
18367,154173610,117349418,271523028,5,0,0,17920,12,406333711
18368,154186550,117639135,271825685,1,0,0,22528,1,9559169947
18369,154188560,117567153,271755713,6,0,0,6656,12,1218708572
18370,154197030,117371164,271568194,3,0,0,3584,18,4075577323
18371,154211490,117924882,272136372,7,0,0,3072,1,6168555517
18372,154221300,117615172,271836472,2,0,0,35328,1,10182244618
18373,154223280,117493443,271716723,3,0,0,6656,18,10474762448
18374,154235370,117376284,271611654,5,0,0,16896,12,8590018034
18375,154237530,117579037,271816567,5,0,0,28160,12,1874649816
18376,154249610,117854677,272104287,8,0,0,33280,11,10062379003
18377,154261820,117701223,271963043,3,0,0,5120,18,1189601780
18378,154262230,117416822,271679052,7,0,0,10752,1,1127823867
18379,154264850,117758417,272023267,3,0,0,12800,18,3589586000
18380,154269020,117445652,271714672,0,0,0,11776,6,10339736928
18381,154280319,117629568,271909887,0,0,0,27648,6,4934825009
18382,154295230,117914939,272210169,5,0,0,35328,12,3484167689
18383,154306290,117605336,271911626,1,0,0,5632,1,7727969334
18384,154307410,117711934,272019344,2,0,0,19968,1,3951384353
18385,154331190,117708948,272040138,6,0,0,55296,12,3879108820
18386,154341600,117496767,271838367,5,0,0,6144,12,4304502152
18387,154350380,118404132,272754512,1,0,0,25088,1,6270419720
18388,154374370,118068057,272442427,8,0,0,21504,11,1541001217
18389,154376260,117904582,272280842,1,0,0,60416,1,632277713
18390,154378780,118225822,272604602,8,0,0,12288,11,2482608138
18391,154380740,117914656,272295396,0,0,0,34816,6,9596518479
18392,154406310,118207987,272614297,8,0,0,31744,11,5746013741
18393,154410380,117717967,272128347,4,0,0,21504,7,7430908709
18394,154412280,117577844,271990124,1,0,0,6144,1,10713403518
18395,154424130,117625711,272049841,5,0,0,31744,12,4018736815
18396,154441740,117546489,271988229,5,0,0,21504,12,2421214799
18397,154452790,117831975,272284765,7,0,0,12800,1,9421916110
18398,154461660,118272792,272734452,7,0,0,141824,1,5348240670
18399,154473650,117989668,272463318,0,0,0,2560,6,10127771069
18400,154477460,117945012,272422472,1,0,0,55296,1,381126409
18401,154485000,117811667,272296667,0,0,0,4096,6,8398642347
18402,154495590,118243253,272738843,2,0,0,14336,1,3335565628
18403,154515750,117807950,272323700,5,0,0,34304,12,3642045958
18404,154518030,118001429,272519459,3,0,0,16384,18,9121901727
18405,154530360,118258307,272788667,0,0,0,5120,6,1134594143
18406,154541570,117953923,272495493,9,0,0,59904,4,1624044413
18407,154542370,118375366,272917736,0,0,0,37888,6,2788304906
18408,154544910,117825223,272370133,7,0,0,7168,1,5469394709
18409,154579730,117934714,272514444,0,0,0,23040,6,7083949727
18410,154588250,118198826,272787076,2,0,0,27648,1,3822560464
18411,154617000,117605330,272222330,4,0,0,29696,7,9184108058
18412,154621280,118013499,272634779,0,0,0,3584,6,4971992505
18413,154623290,117967983,272591273,2,0,0,77824,1,6597242884
18414,154639660,118138610,272778270,7,0,0,22016,1,7238348347
18415,154647000,117536711,272183711,9,0,0,38912,4,10575954835
18416,154665390,117405624,272071014,4,0,0,49664,7,1946316167
18417,154701770,117446414,272148184,9,0,0,9216,4,2756702820
18418,154702930,117956784,272659714,5,0,0,34816,12,824230054
18419,154714490,117583405,272297895,5,0,0,1024,12,10456390470
18420,154740800,117826738,272567538,6,0,0,157696,12,5735539547
18421,154748650,118187101,272935751,0,0,0,48128,6,611448767
18422,154759710,117841125,272600835,6,0,0,20480,12,6347252612
18423,154764250,118353979,273118229,6,0,0,40960,12,597586896
18424,154766510,117924614,272691124,1,0,0,82944,1,5637803037
18425,154780460,117814112,272594572,1,0,0,10752,1,6645517624
18426,154796510,117982095,272778605,7,0,0,1024,1,5471360564
18427,154829450,118161691,272991141,3,0,0,7168,18,4316616269
18428,154835620,117813463,272649083,5,0,0,14336,12,2368811105
18429,154837450,117799068,272636518,7,0,0,5632,1,5980043032
18430,154844310,117927229,272771539,1,0,0,55808,1,1503691057
18431,154849940,117783724,272633664,7,0,0,63488,1,1331944803
18432,154854540,117790144,272644684,3,0,0,26624,18,333439643
18433,154864370,118002654,272867024,7,0,0,32768,1,9240926726
18434,154888180,117777649,272665829,6,0,0,19968,12,1629908101
18435,154911470,117988129,272899599,1,0,0,15360,1,3863090511
18436,154912320,118165977,273078297,7,0,0,22016,1,1120604703
18437,154912420,118186475,273098895,1,0,0,16896,1,5202439496
18438,154946120,118135944,273082064,4,0,0,12288,7,9954335495
18439,154948530,117798315,272746845,1,0,0,19456,1,3405044167
18440,154957330,118048502,273005832,6,0,0,30720,12,7984038453
18441,154983710,117831510,272815220,8,0,0,24064,11,4290413336
18442,155019220,118251203,273270423,5,0,0,59392,12,3980933101
18443,155037620,117703274,272740894,2,0,0,6656,1,7160533389
18444,155091450,118249125,273340575,7,0,0,16384,1,10731194450
18445,155100470,117818225,272918695,5,0,0,3072,12,1779661863
18446,155102670,118053405,273156075,5,0,0,59392,12,972788285
18447,155105390,118138617,273244007,3,0,0,94720,18,3641320727
18448,155111690,117861271,272972961,3,0,0,28160,18,7545439293
18449,155112440,118389053,273501493,5,0,0,102400,12,247140204
18450,155118700,118201922,273320622,9,0,0,5120,4,1792100219
18451,155122810,117726204,272849014,1,0,0,4608,1,35163324
18452,155132280,118081659,273213939,4,0,0,35328,7,6176924891
18453,155161110,117631800,272792910,0,0,0,13824,6,1055224257
18454,155166850,117808630,272975480,1,0,0,8192,1,519766628
18455,155180590,118070639,273251229,2,0,0,1536,1,7201008461
18456,155203020,117687695,272890715,5,0,0,9216,12,924060263
18457,155226500,117805140,273031640,6,0,0,34304,12,8194050244
18458,155229250,117805898,273035148,9,0,0,3072,4,7765579721
18459,155246570,117921715,273168285,3,0,0,1536,18,8217955663
18460,155247830,118207819,273455649,4,0,0,81920,7,4629128357
18461,155325110,117793766,273118876,2,0,0,2048,1,7280917553
18462,155350580,117955465,273306045,3,0,0,24064,18,6175092939
18463,155360720,118458467,273819187,6,0,0,45056,12,9478629838
18464,155364220,118055347,273419567,9,0,0,13312,4,7255175194
18465,155366120,117920706,273286826,0,0,0,53760,6,3987557814
18466,155385570,118173795,273559365,9,0,0,71168,4,72552130
18467,155408910,117712641,273121551,2,0,0,8704,1,7192797090
18468,155463370,118044409,273507779,0,0,0,9728,6,7878275859
18469,155467430,117733783,273201213,5,0,0,13824,12,8377294409
18470,155469260,118336176,273805436,3,0,0,27648,18,384242510
18471,155469830,117848823,273318653,2,0,0,21504,1,8941774428
18472,155493070,118169380,273662450,3,0,0,38400,18,3312939022
18473,155502060,118179181,273681241,0,0,0,23040,6,9264334588
18474,155503370,117880819,273384189,7,0,0,8192,1,8315141421
18475,155512870,117799208,273312078,5,0,0,11264,12,2357435570
18476,155513270,118192628,273705898,6,0,0,45568,12,6853397671
18477,155515380,118020345,273535725,6,0,0,9728,12,10040344483
18478,155515600,118388674,273904274,2,0,0,20992,1,1940612673
18479,155521250,117899120,273420370,6,0,0,2560,12,4051294128
18480,155542030,118735821,274277851,4,0,0,121856,7,9372035547
18481,155550060,117815586,273365646,3,0,0,35840,18,5928350358
18482,155561410,118470875,274032285,2,0,0,15360,1,1918265965
18483,155605890,117898902,273504792,2,0,0,10752,1,8540835506
18484,155610850,118217096,273827946,3,0,0,28672,18,10241447784
18485,155617560,118913411,274530971,6,0,0,153600,12,4613568379
18486,155622700,119010730,274633430,0,0,0,119808,6,9698992526
18487,155634940,118276845,273911785,4,0,0,24576,7,5607893962
18488,155642050,118150107,273792157,6,0,0,2560,12,1148475390
18489,155645320,118026669,273671989,7,0,0,31232,1,4892741254
18490,155654190,118278285,273932475,0,0,0,11776,6,4792051928
18491,155654480,118427222,274081702,2,0,0,10240,1,3691404257
18492,155667070,118102295,273769365,4,0,0,30208,7,4000434395
18493,155676730,119303741,274980471,5,0,0,101888,12,2981576430
18494,155683400,118091916,273775316,4,0,0,19456,7,8222209125
18495,155700920,117912234,273613154,2,0,0,7680,1,7550917958
18496,155706590,118082987,273789577,3,0,0,9216,18,2234674198
18497,155710820,118990739,274701559,6,0,0,34816,12,8772920861
18498,155726080,118009576,273735656,6,0,0,50688,12,6835599362
18499,155731680,118443684,274175364,2,0,0,9728,1,8739515791
18500,155767970,119567529,275335499,2,0,0,132608,1,1154661722
18501,155774550,119385575,275160125,5,0,0,147968,12,206920191
18502,155799530,118577357,274376887,4,0,0,85504,7,8748073276
18503,155799550,118333211,274132761,7,0,0,5120,1,7537091435
18504,155813410,118411129,274224539,1,0,0,1024,1,10127913402
18505,155822390,118709274,274531664,0,0,0,1024,6,2898001895
18506,155843210,118366087,274209297,6,0,0,14336,12,2384654418
18507,155849350,118084864,273934214,3,0,0,5632,18,5905724077
18508,155911400,118505279,274416679,5,0,0,54784,12,2620790731
18509,155922580,118475714,274398294,5,0,0,20992,12,5329277847
18510,155935450,118288754,274224204,5,0,0,15360,12,2284344467
18511,155935860,118383798,274319658,2,0,0,36352,1,6987903539
18512,155949030,118722446,274671476,1,0,0,66048,1,5290421538
18513,155957590,118682571,274640161,4,0,0,22016,7,8878054869
18514,155973950,118305016,274278966,5,0,0,3584,12,8385284350
18515,155984970,118104731,274089701,4,0,0,5120,7,3809822603
18516,156007710,118436219,274443929,7,0,0,26624,1,10314713099
18517,156027600,118658781,274686381,2,0,0,48640,1,7279448415
18518,156037680,118134697,274172377,3,0,0,8704,18,5624167713
18519,156048480,118284591,274333071,7,0,0,3072,1,1336324371
18520,156058670,118425478,274484148,6,0,0,44544,12,5595697813
18521,156068260,118700055,274768315,1,0,0,41984,1,2395450058
18522,156089330,118345325,274434655,6,0,0,23040,12,5751780803
18523,156097960,118488162,274586122,8,0,0,46592,11,9381784834
18524,156108770,119595709,275704479,7,0,0,19456,1,2357311274
18525,156124310,118579750,274704060,8,0,0,7168,11,7284090897
18526,156131680,118756147,274887827,6,0,0,3584,12,1083289055
18527,156138660,118392646,274531306,9,0,0,1024,4,10417482126
18528,156154000,118536928,274690928,2,0,0,14848,1,10190143606
18529,156186320,118569180,274755500,1,0,0,70656,1,8349167359
18530,156197890,118449470,274647360,9,0,0,23552,4,3455286267
18531,156226750,118655978,274882728,8,0,0,31744,11,195307758
18532,156253890,118695491,274949381,8,0,0,31232,11,4225248166
18533,156254950,118396356,274651306,2,0,0,6656,1,6017728897
18534,156281780,118502946,274784726,4,0,0,53760,7,4874671639
18535,156301740,118234315,274536055,0,0,0,14336,6,7349014333
18536,156303250,118745508,275048758,1,0,0,58880,1,8434215629
18537,156321260,118486155,274807415,5,0,0,8704,12,5410814474
18538,156348980,118444505,274793485,8,0,0,28672,11,9474740857
18539,156372810,118657985,275030795,0,0,0,12288,6,6853885769
18540,156380110,118646918,275027028,5,0,0,84992,12,527010925
18541,156389120,118415620,274804740,4,0,0,36864,7,7422304402
18542,156396850,118652087,275048937,5,0,0,512,12,4468507147
18543,156412760,118446284,274859044,5,0,0,43520,12,1923481178
18544,156423630,118777170,275200800,6,0,0,76800,12,5366259186
18545,156428900,118220355,274649255,1,0,0,6144,1,8935881052
18546,156433400,118559106,274992506,0,0,0,39424,6,7054706811
18547,156453340,118547769,275001109,9,0,0,28160,4,2207039553
18548,156455560,118384602,274840162,4,0,0,14336,7,8741267863
18549,156456780,118956852,275413632,1,0,0,6144,1,6528473625
18550,156458510,118712090,275170600,7,0,0,34304,1,5232742290
18551,156468900,118708477,275177377,9,0,0,11776,4,5199320050
18552,156494560,118679206,275173766,9,0,0,3072,4,9907357127
18553,156495860,119378565,275874425,7,0,0,137728,1,6501357023
18554,156503540,118908197,275411737,2,0,0,48640,1,7664563854
18555,156510000,118740511,275250511,9,0,0,12800,4,5828286444
18556,156545390,118714036,275259426,5,0,0,29184,12,5489894308
18557,156580330,119318664,275898994,0,0,0,25600,6,202875434
18558,156585770,119112758,275698528,4,0,0,48128,7,8049823435
18559,156601100,118674964,275276064,3,0,0,48640,18,656551003
18560,156620490,118895006,275515496,1,0,0,1024,1,8106668803
18561,156625190,118314652,274939842,1,0,0,49152,1,3591884933
18562,156633510,118627530,275261040,3,0,0,5120,18,661738321
18563,156649560,118565787,275215347,5,0,0,47616,12,3010517499
18564,156650380,118794152,275444532,2,0,0,11264,1,5815415785
18565,156653640,118859447,275513087,2,0,0,172032,1,379269141
18566,156656580,118516227,275172807,4,0,0,7168,7,9180195044
18567,156667090,118579452,275246542,6,0,0,43520,12,6935281522
18568,156689010,118856830,275545840,7,0,0,39424,1,2269311368
18569,156695800,119243473,275939273,2,0,0,33280,1,1881254672
18570,156700670,119337321,276037991,6,0,0,48640,12,7467643359
18571,156707190,118638664,275345854,1,0,0,14336,1,6188440171
18572,156710200,119391040,276101240,1,0,0,59904,1,1708998445
18573,156712560,119492505,276205065,2,0,0,56832,1,2826553329
18574,156717920,119191260,275909180,4,0,0,6144,7,4002135075
18575,156727920,119101063,275828983,9,0,0,92160,4,5923198815
18576,156738190,118975516,275713706,1,0,0,30208,1,7748276917
18577,156740230,118912082,275652312,7,0,0,20480,1,2963816152
18578,156744930,118862310,275607240,6,0,0,38912,12,4180248035
18579,156745830,118867049,275612879,3,0,0,18432,18,6482115390
18580,156762690,118800356,275563046,2,0,0,56320,1,8617230261
18581,156797650,119116100,275913750,1,0,0,7680,1,7299476731
18582,156797770,119109515,275907285,2,0,0,27136,1,5605957984
18583,156805620,118908733,275714353,2,0,0,2048,1,2144592727
18584,156812870,118702291,275515161,0,0,0,6656,6,3571583508
18585,156820350,119257946,276078296,9,0,0,80384,4,2121594618
18586,156820720,119070451,275891171,4,0,0,34816,7,10255382383
18587,156832280,119506507,276338787,7,0,0,21504,1,7018146348
18588,156835910,118878622,275714532,7,0,0,512,1,4591900577
18589,156837930,119349796,276187726,1,0,0,65024,1,944004494
18590,156855600,119686827,276542427,8,0,0,66048,11,4895249742
18591,156856730,118897020,275753750,9,0,0,6144,4,7958226099
18592,156877520,118920406,275797926,6,0,0,71680,12,3036504574
18593,156885000,119500400,276385400,5,0,0,13824,12,3662452883
18594,156885600,118994940,275880540,5,0,0,19968,12,6539823837
18595,156889290,119337254,276226544,6,0,0,5120,12,9667272495
18596,156892000,118823491,275715491,4,0,0,3072,7,4716940442
18597,156893800,119561212,276455012,5,0,0,35328,12,3739838455
18598,156900060,119011327,275911387,8,0,0,7168,11,5611853539
18599,156908310,118924128,275832438,0,0,0,11264,6,5643164451
18600,156910600,119358528,276269128,4,0,0,62464,7,4499362654
18601,156922110,119758408,276680518,4,0,0,48128,7,885702378
18602,156946680,119175350,276122030,1,0,0,31232,1,7117301049
18603,156957860,119486342,276444202,2,0,0,146944,1,8797779252
18604,156962530,118978794,275941324,8,0,0,6656,11,7538362140
18605,156964970,119643413,276608383,0,0,0,89088,6,6102784137
18606,156965710,119539291,276505001,3,0,0,13312,18,8921113061
18607,156987150,119569964,276557114,8,0,0,48128,11,1868159666
18608,157002160,119471025,276473185,6,0,0,59392,12,8653111182
18609,157008680,119200152,276208832,4,0,0,12288,7,547895909
18610,157025450,119195729,276221179,2,0,0,40448,1,2878989843
18611,157049740,119031231,276080971,8,0,0,8704,11,5561379649
18612,157050430,119795754,276846184,7,0,0,169984,1,3090183979
18613,157067430,119634974,276702404,9,0,0,67584,4,815348097
18614,157069350,119040337,276109687,2,0,0,1536,1,3733062755
18615,157090920,119474173,276565093,7,0,0,26112,1,4230069648
18616,157091480,119590309,276681789,4,0,0,4096,7,1375975307
18617,157092260,119194512,276286772,2,0,0,41472,1,7214498564
18618,157094560,119237652,276332212,1,0,0,13824,1,1290359008
18619,157110240,119124876,276235116,0,0,0,1536,6,3904405014
18620,157116220,119382027,276498247,0,0,0,51200,6,6825790156
18621,157117340,119638931,276756271,3,0,0,2560,18,7585930484
18622,157120140,119981220,277101360,5,0,0,104960,12,4357290261
18623,157126680,119667689,276794369,0,0,0,6144,6,4239314843
18624,157138910,120091420,277230330,2,0,0,6656,1,7843333623
18625,157158480,119987310,277145790,8,0,0,24576,11,2398206000
18626,157168860,119491712,276660572,0,0,0,67072,6,759381041
18627,157176080,119956337,277132417,9,0,0,40448,4,1856847725
18628,157193690,119845779,277039469,7,0,0,112640,1,3928950403
18629,157205690,119295232,276500922,6,0,0,8704,12,2359978080
18630,157208300,120059984,277268284,2,0,0,8704,1,8315198235
18631,157225260,119414837,276640097,6,0,0,32768,12,315520636
18632,157236610,119488155,276724765,9,0,0,6144,4,2189533417
18633,157239350,119928326,277167676,1,0,0,25600,1,3919440516
18634,157249000,119618922,276867922,0,0,0,67072,6,4079533558
18635,157250270,119725470,276975740,7,0,0,3584,1,10279139029
18636,157254670,119490828,276745498,8,0,0,19456,11,5495279011
18637,157256890,119373200,276630090,1,0,0,71168,1,3342683470
18638,157283680,120096312,277379992,1,0,0,9728,1,2447053866
18639,157301730,119483804,276785534,7,0,0,10752,1,2456836722
18640,157301900,119436110,276738010,2,0,0,21504,1,8577981102
18641,157326680,120021559,277348239,2,0,0,17408,1,8546174830
18642,157330210,119829643,277159853,9,0,0,46080,4,8236621276
18643,157333950,119905056,277239006,5,0,0,4096,12,5466428801
18644,157342420,119773502,277115922,4,0,0,47616,7,6392175417
18645,157355430,119960832,277316262,9,0,0,39424,4,7335697854
18646,157367480,120137101,277504581,9,0,0,65024,4,8374935416
18647,157371550,119693572,277065122,1,0,0,51712,1,7796478279
18648,157388770,119950812,277339582,5,0,0,60416,12,89407958
18649,157401220,119476397,276877617,6,0,0,31744,12,8077819131
18650,157412850,119704343,277117193,8,0,0,4096,11,500081519
18651,157413540,119763051,277176591,6,0,0,29184,12,2064827663
18652,157429780,119835829,277265609,9,0,0,40960,4,8766623078
18653,157442400,119900481,277342881,4,0,0,10752,7,683673651
18654,157451360,119754796,277206156,1,0,0,48640,1,8357869190
18655,157461230,119982232,277443462,1,0,0,61440,1,2368027543
18656,157467000,119582343,277049343,4,0,0,18944,7,2988840406
18657,157475020,119372443,276847463,9,0,0,4096,4,9196346513
18658,157478030,120125734,277603764,0,0,0,136192,6,10403287060
18659,157485180,120055355,277540535,4,0,0,76288,7,233993692
18660,157490270,119629800,277120070,5,0,0,9216,12,9517518129
18661,157502880,119540668,277043548,9,0,0,13312,4,427248743
18662,157547420,119521937,277069357,5,0,0,13824,12,1590513323
18663,157578350,119906396,277484746,5,0,0,100352,12,6299436335
18664,157579570,119770720,277350290,6,0,0,6656,12,75313684
18665,157582250,120193952,277776202,7,0,0,41472,1,9014664839
18666,157593250,120162477,277755727,4,0,0,62976,7,6537918927
18667,157604720,119762722,277367442,3,0,0,46080,18,5875814113
18668,157608120,120128396,277736516,6,0,0,59904,12,7281048381
18669,157610400,120016654,277627054,2,0,0,67584,1,9544971253
18670,157610460,120229100,277839560,9,0,0,2048,4,2530400291
18671,157635950,120200132,277836082,0,0,0,31232,6,10253434651
18672,157638020,120780316,278418336,1,0,0,196608,1,8914435825
18673,157647250,119959189,277606439,1,0,0,8704,1,9941813403
18674,157653710,120218032,277871742,6,0,0,69632,12,201107186
18675,157674700,120037760,277712460,8,0,0,11776,11,7963150671
18676,157691440,119755165,277446605,8,0,0,10240,11,10176893474
18677,157691580,120106523,277798103,5,0,0,20480,12,10072560506
18678,157707540,119806268,277513808,5,0,0,30208,12,1795961762
18679,157731980,120263812,277995792,6,0,0,16896,12,9354417956
18680,157735720,120066902,277802622,7,0,0,4096,1,5320334408
18681,157739520,120944437,278683957,9,0,0,294912,4,5164742020
18682,157763760,120117076,277880836,8,0,0,10752,11,6662554302
18683,157786940,120249997,278036937,8,0,0,26624,11,4318156266
18684,157787890,120089647,277877537,2,0,0,18944,1,6970353452
18685,157794200,119841480,277635680,2,0,0,18944,1,1021719013
18686,157809000,119820885,277629885,5,0,0,9216,12,2522849964
18687,157811830,120216972,278028802,0,0,0,71680,6,1842527673
18688,157815950,119857242,277673192,9,0,0,18432,4,550533466
18689,157827080,120464935,278292015,1,0,0,19456,1,2593104139
18690,157834830,120004083,277838913,3,0,0,9216,18,5680977108
18691,157844060,120056790,277900850,4,0,0,31232,7,2505704661
18692,157853890,120431683,278285573,6,0,0,104960,12,3195536234
18693,157858410,120323362,278181772,9,0,0,39424,4,2382372052
18694,157863950,120320341,278184291,7,0,0,8192,1,6786779831
18695,157875430,120217119,278092549,5,0,0,3584,12,1194707587
18696,157877540,120434676,278312216,0,0,0,15872,6,8996450233
18697,157879740,120427609,278307349,3,0,0,27136,18,7376932641
18698,157883200,120235345,278118545,2,0,0,68096,1,4132114215
18699,157885580,120565630,278451210,5,0,0,17920,12,10121906216
18700,157885830,120367740,278253570,1,0,0,50176,1,4801343298
18701,157888980,120330823,278219803,3,0,0,11776,18,4817621120
18702,157897130,120521697,278418827,5,0,0,1536,12,3727972546
18703,157914520,119976791,277891311,4,0,0,34304,7,3889866115
18704,157928820,120499257,278428077,2,0,0,19456,1,8637412701
18705,157932240,120217650,278149890,1,0,0,17408,1,9014840901
18706,157968630,120453496,278422126,8,0,0,10752,11,5335811200
18707,157978170,120798908,278777078,9,0,0,31232,4,3269127411
18708,157982610,120094346,278076956,9,0,0,56832,4,5226285753
18709,158001690,120930838,278932528,6,0,0,23040,12,9811552311
18710,158003240,120282824,278286064,1,0,0,1536,1,2897981396
18711,158003420,120728373,278731793,9,0,0,14848,4,4028474832
18712,158004760,120115680,278120440,5,0,0,6144,12,484867993
18713,158014390,120284668,278299058,6,0,0,23040,12,8936857813
18714,158024980,121309655,279334635,1,0,0,29184,1,806750179
18715,158033340,120466125,278499465,4,0,0,128512,7,8927512964
18716,158037570,121223271,279260841,2,0,0,186368,1,2666886194
18717,158055200,121383747,279438947,9,0,0,114176,4,3068451865
18718,158083390,120604178,278687568,6,0,0,11776,12,5843205564
18719,158087620,121467539,279555159,0,0,0,70144,6,6048635507
18720,158097310,120629928,278727238,4,0,0,26624,7,7419619802
18721,158107500,120611603,278719103,4,0,0,103424,7,4620564040
18722,158107600,120483335,278590935,7,0,0,39424,1,7354805611
18723,158109230,120204257,278313487,5,0,0,4096,12,8792624640
18724,158146790,120353322,278500112,4,0,0,2048,7,7502834608
18725,158168960,120583993,278752953,8,0,0,25600,11,6442510228
18726,158170050,120338597,278508647,1,0,0,8704,1,9322183140
18727,158173270,121026362,279199632,5,0,0,117760,12,5319174367
18728,158180820,120413258,278594078,0,0,0,10240,6,1700869735
18729,158185850,121082525,279268375,3,0,0,24576,18,5592442277
18730,158188490,120553333,278741823,5,0,0,32768,12,3335320435
18731,158194560,120568535,278763095,3,0,0,3072,18,7203193176
18732,158196650,120868509,279065159,9,0,0,128512,4,2612256244
18733,158208070,120584473,278792543,8,0,0,17408,11,8833224868
18734,158219960,121078204,279298164,8,0,0,20480,11,1594744748
18735,158220220,120705265,278925485,2,0,0,59392,1,3188608415
18736,158223370,120617749,278841119,2,0,0,25600,1,4421726090
18737,158233510,120966775,279200285,4,0,0,512,7,8042961926
18738,158247670,120718159,278965829,4,0,0,35328,7,3202474936
18739,158250520,120816401,279066921,6,0,0,3584,12,8043279768
18740,158262040,120845878,279107918,1,0,0,54784,1,2880803795
18741,158270600,121285518,279556118,3,0,0,3072,18,6996687626
18742,158300330,120710079,279010409,5,0,0,22016,12,6755895507
18743,158309900,120964651,279274551,2,0,0,19968,1,2609546658
18744,158315460,121088676,279404136,2,0,0,55808,1,9318167096
18745,158329120,121260973,279590093,0,0,0,20480,6,1067374492
18746,158335310,121118214,279453524,3,0,0,20992,18,2507391256
18747,158336490,120653929,278990419,8,0,0,2560,11,9040747215
18748,158342640,120723166,279065806,0,0,0,2048,6,8904048812
18749,158355660,121362465,279718125,5,0,0,29184,12,8197555166
18750,158363610,120918475,279282085,0,0,0,13824,6,2814674396
18751,158363750,120914100,279277850,3,0,0,10752,18,1953333926
18752,158366930,120755519,279122449,6,0,0,47616,12,6142302197
18753,158368900,120935839,279304739,9,0,0,21504,4,8659753109
18754,158374890,121072215,279447105,7,0,0,21504,1,5331492274
18755,158387350,121131500,279518850,2,0,0,30720,1,5907579286
18756,158401370,121039160,279440530,9,0,0,5120,4,4740735741
18757,158412270,121289929,279702199,9,0,0,12288,4,10261947067
18758,158421900,121359199,279781099,9,0,0,17920,4,2005976088
18759,158452800,120909179,279361979,9,0,0,23040,4,6340272473
18760,158472610,120986085,279458695,0,0,0,16896,6,10048469881
18761,158482920,121653835,280136755,4,0,0,57856,7,3076262893
18762,158503440,121161897,279665337,3,0,0,7168,18,2866557921
18763,158504780,120882329,279387109,0,0,0,38912,6,9803944689
18764,158507120,121071681,279578801,6,0,0,3584,12,641935042
18765,158507810,121263997,279771807,6,0,0,54272,12,2697323584
18766,158509440,121119094,279628534,9,0,0,2048,4,10124019967
18767,158510820,121327721,279838541,7,0,0,87552,1,5907853238
18768,158533360,121098662,279632022,5,0,0,2048,12,7014195633
18769,158544430,121526720,280071150,6,0,0,96256,12,7658331840
18770,158544880,121205603,279750483,8,0,0,32256,11,1577241691
18771,158564690,120944777,279509467,4,0,0,51200,7,7770732575
18772,158581540,121439708,280021248,5,0,0,150528,12,5868081081
18773,158590340,121108092,279698432,6,0,0,108544,12,5804511974
18774,158617710,121422772,280040482,1,0,0,55296,1,3195619596
18775,158636980,121778587,280415567,6,0,0,55808,12,679845612
18776,158657440,121533764,280191204,7,0,0,20480,1,7437371091
18777,158659820,121689643,280349463,7,0,0,64512,1,3822635415
18778,158669670,121449426,280119096,7,0,0,73728,1,3146054733
18779,158674350,121649638,280323988,6,0,0,15360,12,9186503074
18780,158699530,121619755,280319285,7,0,0,68608,1,5986807052
18781,158706580,121213109,279919689,5,0,0,39424,12,595598436
18782,158728630,121448496,280177126,6,0,0,47616,12,6987115825
18783,158734800,121361801,280096601,5,0,0,83456,12,8002388137
18784,158761400,121385986,280147386,9,0,0,34816,4,5533354730
18785,158770330,121392265,280162595,2,0,0,17408,1,3621979297
18786,158779560,121501975,280281535,2,0,0,4096,1,8988549750
18787,158788490,121368770,280157260,5,0,0,12800,12,4016875430
18788,158789320,121948583,280737903,8,0,0,243200,11,1130648470
18789,158791840,121479867,280271707,7,0,0,5120,1,6961954001
18790,158810890,121692321,280503211,1,0,0,61952,1,7515817560
18791,158811600,121230176,280041776,3,0,0,4096,18,2468209759
18792,158825530,121198081,280023611,9,0,0,7680,4,2023060262
18793,158832420,121320917,280153337,3,0,0,19456,18,3071392378
18794,158833240,121346257,280179497,3,0,0,7680,18,8435253364
18795,158842990,121581804,280424794,6,0,0,30208,12,3389498203
18796,158847710,121694593,280542303,3,0,0,15360,18,4860829808
18797,158853530,121656903,280510433,7,0,0,17408,1,5879794948
18798,158867650,121316931,280184581,7,0,0,4608,1,10212985948
18799,158874070,121338773,280212843,4,0,0,18432,7,7337231747
18800,158879300,121446271,280325571,0,0,0,5120,6,10634380362
18801,158895370,121953049,280848419,6,0,0,41984,12,9402109520
18802,158901890,121635710,280537600,4,0,0,89088,7,4760525426
18803,158905230,121560289,280465519,5,0,0,15872,12,9533392744
18804,158912460,121723823,280636283,8,0,0,72192,11,3281449992
18805,158919340,121558195,280477535,3,0,0,21504,18,7992909837
18806,158940810,121653850,280594660,3,0,0,34816,18,10609888605
18807,158958180,121830569,280788749,1,0,0,45568,1,7014958006
18808,158982490,121594306,280576796,5,0,0,53760,12,3686586057
18809,158987630,121572763,280560393,9,0,0,51712,4,9583485591
18810,158990350,121782597,280772947,1,0,0,84480,1,9533067021
18811,159009060,121737469,280746529,5,0,0,28160,12,5676271224
18812,159014840,122034508,281049348,0,0,0,23040,6,2529844349
18813,159044840,121979609,281024449,7,0,0,89088,1,2741922854
18814,159072800,122126447,281199247,8,0,0,16384,11,3418396698
18815,159080800,121817695,280898495,2,0,0,4096,1,682890167
18816,159086320,121789037,280875357,7,0,0,54784,1,5040947345
18817,159099340,121675502,280774842,1,0,0,6144,1,10564143333
18818,159112820,122360517,281473337,4,0,0,390144,7,8036775721
18819,159122120,121382986,280505106,5,0,0,6144,12,9592970493
18820,159123590,121959361,281082951,0,0,0,30208,6,3581257419
18821,159133900,121925929,281059829,1,0,0,8192,1,4629368479
18822,159154110,121818303,280972413,9,0,0,81920,4,7523042487
18823,159156510,122157071,281313581,5,0,0,27136,12,5943336373
18824,159158460,122547913,281706373,2,0,0,275968,1,3146535523
18825,159164320,121472610,280636930,1,0,0,2048,1,350637882
18826,159171230,122348086,281519316,3,0,0,32256,18,6749156615
18827,159172840,122351179,281524019,5,0,0,15360,12,4833034679
18828,159173960,122169763,281343723,7,0,0,73728,1,2198465093
18829,159195600,121834488,281030088,6,0,0,18432,12,4570809042
18830,159202140,122341049,281543189,5,0,0,62464,12,7027665817
18831,159203890,122362301,281566191,9,0,0,60928,4,6080724236
18832,159207560,122406285,281613845,4,0,0,7168,7,9788118188
18833,159214520,122280079,281494599,5,0,0,69632,12,2325567373
18834,159215510,122661290,281876800,4,0,0,43008,7,7275618315
18835,159217750,121529426,280747176,5,0,0,2048,12,4602328871
18836,159220390,122536284,281756674,1,0,0,154112,1,2049070733
18837,159238970,122270495,281509465,5,0,0,10752,12,9178895723
18838,159264270,121875393,281139663,5,0,0,4608,12,5528706546
18839,159265810,121616318,280882128,0,0,0,7168,6,10171858250
18840,159270980,122542959,281813939,8,0,0,14848,11,7322899546
18841,159289180,121539171,280828351,7,0,0,7680,1,2209824703
18842,159313510,121728795,281042305,2,0,0,31744,1,1318521897
18843,159318900,121908899,281227799,9,0,0,18944,4,5482912662
18844,159320400,122450360,281770760,1,0,0,34816,1,1923458240
18845,159332070,122477322,281809392,2,0,0,69120,1,9189906880
18846,159343560,122162606,281506166,7,0,0,37888,1,6484822818
18847,159346930,122516743,281863673,2,0,0,139264,1,9416917038
18848,159367090,122690390,282057480,2,0,0,114176,1,1598798267
18849,159369320,122893140,282262460,1,0,0,59392,1,5389585821
18850,159375230,122584628,281959858,7,0,0,51712,1,1624309855
18851,159392350,122317345,281709695,5,0,0,6144,12,9400124542
18852,159398340,122513089,281911429,8,0,0,81408,11,7196463775
18853,159406260,123055460,282461720,4,0,0,20480,7,2503938291
18854,159416860,122174329,281591189,6,0,0,29184,12,314357829
18855,159417800,122462611,281880411,6,0,0,11776,12,7704411371
18856,159418360,122756542,282174902,3,0,0,65536,18,2419901581
18857,159419230,122706835,282126065,1,0,0,89600,1,266802983
18858,159425000,122363309,281788309,9,0,0,15872,4,3241548276
18859,159434180,122349270,281783450,8,0,0,10240,11,10341309767
18860,159437484,122342815,281780299,8,0,0,31232,11,3945682818
18861,159438420,122505659,281944079,1,0,0,107008,1,9350061661
18862,159458330,122089250,281547580,8,0,0,14336,11,633427353
18863,159472540,122626202,282098742,2,0,0,61952,1,4925516808
18864,159474030,122092964,281566994,2,0,0,2560,1,251982572
18865,159480150,123425668,282905818,5,0,0,81920,12,3826895025
18866,159486830,123274705,282761535,7,0,0,24064,1,4274331086
18867,159488570,122219230,281707800,2,0,0,4608,1,3437265575
18868,159503850,122672947,282176797,6,0,0,6144,12,4388521707
18869,159505180,122985659,282490839,5,0,0,76800,12,7891817672
18870,159505820,123168317,282674137,6,0,0,2048,12,2521418521
18871,159514970,122245159,281760129,1,0,0,11264,1,7750554093
18872,159518290,122547169,282065459,1,0,0,26112,1,1979158718
18873,159523820,122543721,282067541,1,0,0,6656,1,5912890299
18874,159526770,122292340,281819110,5,0,0,16896,12,1313363651
18875,159529790,122430247,281960037,8,0,0,512,11,7760045434
18876,159530600,122920648,282451248,0,0,0,3072,6,5298442298
18877,159547530,123624786,283172316,7,0,0,13312,1,7007064345
18878,159549680,122975259,282524939,7,0,0,87040,1,8217379912
18879,159551910,122600409,282152319,0,0,0,18432,6,5240017447
18880,159588960,122685379,282274339,9,0,0,38912,4,4782711079
18881,159602920,123506300,283109220,1,0,0,28160,1,10490853144
18882,159619060,122667984,282287044,6,0,0,13824,12,8079329496
18883,159629930,122385878,282015808,3,0,0,68608,18,4158915360
18884,159630940,122793988,282424928,6,0,0,20480,12,9195475158
18885,159631930,122514750,282146680,7,0,0,67584,1,4378465352
18886,159659080,122949795,282608875,3,0,0,10240,18,4258551509
18887,159682900,122893942,282576842,2,0,0,114688,1,9133991488
18888,159684370,122609266,282293636,4,0,0,1536,7,5213167118
18889,159684590,123132181,282816771,2,0,0,44032,1,7604900799
18890,159693540,123437144,283130684,9,0,0,70144,4,2708919754
18891,159695750,122717777,282413527,1,0,0,23040,1,3167065123
18892,159703690,122573168,282276858,8,0,0,8192,11,3648751652
18893,159707530,123225767,282933297,1,0,0,90112,1,6457158459
18894,159710770,123614756,283325526,4,0,0,20992,7,4549878762
18895,159712270,123005189,282717459,9,0,0,51712,4,7125133143
18896,159719360,123357741,283077101,2,0,0,62464,1,9313653856
18897,159722410,123890135,283612545,1,0,0,36352,1,2128944612
18898,159723560,122559249,282282809,2,0,0,19456,1,8039593900
18899,159736110,123750199,283486309,5,0,0,160256,12,1184262113
18900,159745560,122747486,282493046,0,0,0,7168,6,1559076654
18901,159746260,122651057,282397317,8,0,0,39936,11,1420506791
18902,159747380,123458011,283205391,6,0,0,14848,12,7910168283
18903,159751280,123625471,283376751,8,0,0,22016,11,10283696347
18904,159755500,123980747,283736247,6,0,0,73216,12,2036132195
18905,159756420,123430140,283186560,9,0,0,1536,4,1390459088
18906,159766190,123071688,282837878,5,0,0,39424,12,4231632981
18907,159770550,123312752,283083302,8,0,0,9216,11,8531405859
18908,159771690,123162410,282934100,8,0,0,2560,11,3109647286
18909,159777470,122376900,282154370,6,0,0,6656,12,4185152716
18910,159789160,123454264,283243424,6,0,0,49664,12,2431355194
18911,159792230,122658059,282450289,8,0,0,26624,11,2871367221
18912,159804020,123072437,282876457,8,0,0,14336,11,6809920308
18913,159817080,123283537,283100617,9,0,0,36864,4,6432490874
18914,159827660,123607583,283435243,4,0,0,78848,7,993053762
18915,159831680,122847940,282679620,5,0,0,17920,12,5290244313
18916,159861020,122475469,282336489,5,0,0,6656,12,5138841548
18917,159869990,122548675,282418665,8,0,0,8192,11,9025304962
18918,159871660,122626736,282498396,6,0,0,17408,12,3885162134
18919,159893240,122633750,282526990,2,0,0,6656,1,1107950357
18920,159899070,123673090,283572160,4,0,0,35328,7,1437938591
18921,159925520,123083995,283009515,7,0,0,55296,1,4116211948
18922,159943740,123564611,283508351,5,0,0,39936,12,5512776667
18923,159953030,122637725,282590755,3,0,0,11264,18,2860417009
18924,159980260,123910569,283890829,1,0,0,95232,1,6358765472
18925,159989490,123175077,283164567,7,0,0,22016,1,6224551393
18926,159998250,123412946,283411196,5,0,0,43520,12,10105410867
18927,159999270,122842710,282841980,6,0,0,13312,12,4308366587
18928,160001120,122647980,282649100,3,0,0,23040,18,9732538679
18929,160004550,123801159,283805709,6,0,0,7680,12,2807684344
18930,160012200,123027516,283039716,2,0,0,18944,1,1575027999
18931,160023550,123108101,283131651,8,0,0,3072,11,7499461046
18932,160049760,122623707,282673467,7,0,0,6144,1,595062137
18933,160074200,123191954,283266154,5,0,0,9728,12,7104117602
18934,160079700,123416460,283496160,1,0,0,32256,1,2617911089
18935,160086360,122764691,282851051,2,0,0,29696,1,323262054
18936,160097320,122627962,282725282,3,0,0,25600,18,1138394820
18937,160099270,123486672,283585942,4,0,0,40960,7,4263216150
18938,160100290,122914552,283014842,6,0,0,17408,12,10419460055
18939,160105590,123195349,283300939,6,0,0,20480,12,3472284568
18940,160107940,123423366,283531306,6,0,0,75264,12,3513929726
18941,160120570,122934772,283055342,9,0,0,8192,4,6762893849
18942,160123540,123239605,283363145,6,0,0,123392,12,7194295752
18943,160123810,123501585,283625395,4,0,0,21504,7,10558103301
18944,160124570,123124813,283249383,7,0,0,9216,1,4918421873
18945,160127010,122914289,283041299,6,0,0,5120,12,4433467443
18946,160149980,123411393,283561373,3,0,0,37376,18,2591229937
18947,160166860,123373407,283540267,0,0,0,2560,6,8759174176
18948,160178640,123360824,283539464,1,0,0,26624,1,2891961727
18949,160200380,123835655,284036035,0,0,0,43008,6,6823040931
18950,160219100,123370453,283589553,8,0,0,11776,11,8736056967
18951,160237740,123954933,284192673,2,0,0,35328,1,1575823562
18952,160262620,123414537,283677157,1,0,0,13824,1,21765642
18953,160271160,122914909,283186069,7,0,0,32768,1,2427954801
18954,160274630,123091354,283365984,2,0,0,9216,1,1193690955
18955,160281430,124081540,284362970,0,0,0,22528,6,6540118962
18956,160282270,123535229,283817499,2,0,0,6144,1,6957043008
18957,160285180,123152270,283437450,3,0,0,7168,18,1406385533
18958,160286190,122974856,283261046,7,0,0,512,1,5668520222
18959,160305520,123645132,283950652,2,0,0,35328,1,609483805
18960,160309660,123330110,283639770,6,0,0,47104,12,3576151950
18961,160309820,123658196,283968016,8,0,0,39424,11,3784264019
18962,160317700,122969147,283286847,5,0,0,25600,12,8810065181
18963,160344980,124253569,284598549,7,0,0,1024,1,888182982
18964,160367200,123182762,283549962,7,0,0,31744,1,5257471382
18965,160373150,124363273,284736423,0,0,0,106496,6,3884807480
18966,160380180,123193259,283573439,2,0,0,4096,1,7754963065
18967,160382170,124129835,284512005,6,0,0,314880,12,6556210745
18968,160400310,123731684,284131994,8,0,0,13824,11,9124128959
18969,160412030,124234464,284646494,9,0,0,9728,4,8994438297
18970,160412370,123298304,283710674,8,0,0,8192,11,2945443133
18971,160424790,122968878,283393668,6,0,0,1536,12,2309445908
18972,160432840,123275315,283708155,7,0,0,57856,1,4920520928
18973,160433790,123585975,284019765,6,0,0,124416,12,1327816200
18974,160437350,123726653,284164003,6,0,0,13312,12,1697787565
18975,160462120,124163112,284625232,0,0,0,31744,6,4294326841
18976,160463550,123892533,284356083,0,0,0,121856,6,7426539032
18977,160470770,123314054,283784824,4,0,0,31744,7,10138176578
18978,160472070,123669735,284141805,0,0,0,29696,6,6417141446
18979,160483810,124802514,285286324,1,0,0,54784,1,6743450436
18980,160485900,123442143,283928043,2,0,0,14848,1,4528981186
18981,160489960,124095907,284585867,8,0,0,79872,11,7854210821
18982,160490370,123669554,284159924,9,0,0,59392,4,9359005732
18983,160530130,123492778,284022908,1,0,0,10240,1,6446017776
18984,160531010,123220860,283751870,4,0,0,51200,7,5233075032
18985,160532870,124067761,284600631,9,0,0,6656,4,8558183130
18986,160545580,123622518,284168098,3,0,0,13312,18,8563621367
18987,160565920,123471542,284037462,1,0,0,4608,1,7021139648
18988,160577640,123817633,284395273,5,0,0,5632,12,5641078856
18989,160613150,123624438,284237588,9,0,0,46080,4,5577015677
18990,160625180,123912680,284537860,7,0,0,6656,1,5567697206
18991,160630330,123593195,284223525,1,0,0,29696,1,4354749500
18992,160630490,124013017,284643507,0,0,0,59904,6,6334524053
18993,160638610,124495548,285134158,7,0,0,40448,1,6773258094
18994,160639620,124032642,284672262,1,0,0,22528,1,10070777325
18995,160651610,123884199,284535809,9,0,0,34816,4,6186855731
18996,160656200,123883399,284539599,6,0,0,5632,12,9819266005
18997,160668450,123085159,283753609,1,0,0,5632,1,1910452707
18998,160680230,123409064,284089294,6,0,0,31744,12,6237424735
18999,160680890,123180900,283861790,5,0,0,56832,12,8282931575
19000,160684730,123389628,284074358,4,0,0,6144,7,10681979579
19001,160688570,123685935,284374505,3,0,0,25600,18,3531469936
19002,160699690,124227328,284927018,4,0,0,139776,7,4232994689
19003,160700610,123424618,284125228,3,0,0,22528,18,8886610265
19004,160700790,124330563,285031353,0,0,0,27648,6,3780679472
19005,160726050,124158357,284884407,1,0,0,33792,1,6497099747
19006,160735950,123671465,284407415,8,0,0,26624,11,442086298
19007,160742250,123533949,284276199,3,0,0,20992,18,9687053016
19008,160750410,123658432,284408842,1,0,0,4608,1,5762835463
19009,160757080,124961286,285718366,4,0,0,118272,7,5090313845
19010,160758530,123027097,283785627,1,0,0,2560,1,8495629654
19011,160770220,123746020,284516240,3,0,0,13824,18,6293692475
19012,160774920,124184825,284959745,5,0,0,6144,12,4996439254
19013,160783810,123740097,284523907,2,0,0,25088,1,6219631112
19014,160795650,123754580,284550230,2,0,0,34816,1,5803805499
19015,160807450,124150392,284957842,7,0,0,31744,1,6314087963
19016,160818010,124629431,285447441,1,0,0,289280,1,5248571183
19017,160837990,123555544,284393534,6,0,0,23040,12,241380799
19018,160838640,124609292,285447932,4,0,0,1536,7,5593733725
19019,160842510,123718998,284561508,1,0,0,8704,1,10682699350
19020,160842820,123716013,284558833,6,0,0,28160,12,6698869998
19021,160849880,124219561,285069441,7,0,0,26624,1,10490861634
19022,160869500,123736614,284606114,1,0,0,17920,1,581056251
19023,160873230,123724984,284598214,3,0,0,40448,18,1367000717
19024,160876820,123975295,284852115,7,0,0,58880,1,9300742118
19025,160897580,123627598,284525178,9,0,0,4096,4,10316946636
19026,160904670,124777637,285682307,6,0,0,39936,12,10115323648
19027,160915600,123854288,284769888,2,0,0,52224,1,3487484465
19028,160917050,124545881,285462931,9,0,0,49152,4,9370509113
19029,160921590,124587711,285509301,4,0,0,10752,7,10574215993
19030,160933700,123820253,284753953,2,0,0,25088,1,9326898564
19031,160953250,124941898,285895148,3,0,0,30720,18,1723341961
19032,160971860,124815457,285787317,6,0,0,28672,12,4706094133
19033,160993470,124733663,285727133,6,0,0,28672,12,1285184285
19034,160998990,124623937,285622927,3,0,0,43008,18,9618435108
19035,161007230,123925271,284932501,3,0,0,17920,18,10217145598
19036,161012680,124597120,285609800,2,0,0,10752,1,5663906279
19037,161012880,123935267,284948147,8,0,0,45568,11,5243669347
19038,161023370,124583131,285606501,9,0,0,168448,4,6574464444
19039,161049860,124971632,286021492,5,0,0,90624,12,6192380584
19040,161056810,123982203,285039013,2,0,0,5632,1,721291677
19041,161058380,124300867,285359247,2,0,0,45568,1,7066434673
19042,161076900,124995335,286072235,8,0,0,91648,11,6397736887
19043,161090730,124013857,285104587,0,0,0,28160,6,7202837135
19044,161093800,124791965,285885765,0,0,0,190464,6,7462709667
19045,161105930,124842924,285948854,9,0,0,9728,4,5842903133
19046,161111340,123822900,284934240,0,0,0,5632,6,9125771526
19047,161111390,124104416,285215806,1,0,0,17920,1,9403682538
19048,161112780,124960639,286073419,7,0,0,3584,1,1067674457
19049,161151030,123990661,285141691,8,0,0,13824,11,5297775231
19050,161192090,124107115,285299205,4,0,0,2048,7,318815677
19051,161192950,124306349,285499299,4,0,0,17408,7,9484449202
19052,161195560,124149780,285345340,9,0,0,53760,4,8714254996
19053,161201640,125063577,286265217,1,0,0,49664,1,4849037810
19054,161224050,125024897,286248947,3,0,0,59392,18,4558986922
19055,161230110,124759677,285989787,0,0,0,26624,6,8144168768
19056,161236910,124409908,285646818,2,0,0,78336,1,3780682334
19057,161238900,124431216,285670116,8,0,0,72704,11,142179598
19058,161241320,125666121,286907441,7,0,0,12800,1,627379382
19059,161259680,123832645,285092325,4,0,0,20992,7,6421011892
19060,161277900,124255515,285533415,7,0,0,53760,1,1153248978
19061,161280990,124267268,285548258,1,0,0,48640,1,9487358610
19062,161284350,125012040,286296390,0,0,0,40448,6,6527180314
19063,161291530,125292169,286583699,1,0,0,56832,1,8478050407
19064,161293080,123956860,285249940,1,0,0,26112,1,6180608651
19065,161335370,125935893,287271263,3,0,0,660480,18,2172892168
19066,161357880,125301155,286659035,8,0,0,27648,11,5151912147
19067,161366520,124281421,285647941,9,0,0,3584,4,10255200196
19068,161371160,124102714,285473874,8,0,0,35840,11,5274487594
19069,161372630,125530888,286903518,1,0,0,52224,1,2980718623
19070,161394170,125425164,286819334,4,0,0,2560,7,9526323175
19071,161398980,125419551,286818531,2,0,0,66048,1,5573696660
19072,161419290,124526577,285945867,4,0,0,28672,7,1632808226
19073,161434350,124590753,286025103,0,0,0,11776,6,5465664285
19074,161443520,126047460,287490980,9,0,0,373760,4,659404944
19075,161451830,126167540,287619370,4,0,0,45568,7,8861282438
19076,161459810,125040577,286500387,9,0,0,17920,4,9868580388
19077,161460780,125189808,286650588,9,0,0,5632,4,4085991770
19078,161465540,126573034,288038574,0,0,0,155136,6,4942619127
19079,161467840,124457261,285925101,5,0,0,5120,12,3339024252
19080,161472960,126334608,287807568,2,0,0,33280,1,10133380448
19081,161478610,124071855,285550465,9,0,0,7168,4,8016507393
19082,161479990,125574961,287054951,2,0,0,71680,1,3298036847
19083,161480570,125513631,286994201,5,0,0,95232,12,2380435602
19084,161484030,125803838,287287868,2,0,0,24576,1,3748515864
19085,161513470,124736592,286250062,1,0,0,3584,1,6394457021
19086,161514550,125814287,287328837,1,0,0,19968,1,9637465078
19087,161515120,125121070,286636190,6,0,0,72704,12,1809048097
19088,161529240,124629074,286158314,9,0,0,17408,4,4120865195
19089,161531020,124572755,286103775,9,0,0,512,4,6031005402
19090,161531400,125424693,286956093,4,0,0,77824,7,5099613333
19091,161537360,126001612,287538972,8,0,0,70144,11,5971718584
19092,161545370,126020790,287566160,3,0,0,10752,18,6062612171
19093,161562250,124193670,285755920,9,0,0,7680,4,3144439527
19094,161592800,126541719,288134519,8,0,0,25088,11,8780578963
19095,161592810,124560177,286152987,7,0,0,51200,1,7762295950
19096,161598190,124721909,286320099,5,0,0,2560,12,5534976650
19097,161615650,124879254,286494904,0,0,0,2048,6,4881962220
19098,161621150,125089470,286710620,0,0,0,83968,6,1724561841
19099,161626850,125750227,287377077,6,0,0,70656,12,4198772020
19100,161639160,124642631,286281791,5,0,0,20992,12,9129457040
19101,161663110,124985739,286648849,2,0,0,41472,1,4905950079
19102,161669680,124736113,286405793,4,0,0,23552,7,6465023089
19103,161672710,124856689,286529399,0,0,0,39936,6,6184616559
19104,161736300,125564833,287301133,1,0,0,36352,1,4245397662
19105,161742230,124741375,286483605,5,0,0,44032,12,4027443764
19106,161744290,125756252,287500542,0,0,0,28160,6,9426288283
19107,161755030,124631604,286386634,8,0,0,10240,11,2382119408
19108,161763270,124994198,286757468,7,0,0,24064,1,7228745214
19109,161770710,124979395,286750105,1,0,0,29184,1,9184743285
19110,161775840,124959256,286735096,3,0,0,30208,18,2774961122
19111,161786950,125911482,287698432,6,0,0,30720,12,9510433778
19112,161817680,126427918,288245598,5,0,0,35840,12,6788890503
19113,161821020,124673237,286494257,2,0,0,31744,1,874687942
19114,161884180,125742389,287626569,3,0,0,23552,18,2111739861
19115,161885530,124979949,286865479,4,0,0,27648,7,6351477390
19116,161906070,125101882,287007952,7,0,0,45056,1,5736453245
19117,161909660,124874700,286784360,7,0,0,6144,1,5910343478
19118,161927990,124813200,286741190,6,0,0,11776,12,3223316045
19119,161941380,125642610,287583990,3,0,0,33280,18,5147326767
19120,161943070,124925872,286868942,3,0,0,11264,18,2144720357
19121,161986480,124870552,286857032,7,0,0,108544,1,4546451333
19122,161997730,124882163,286879893,8,0,0,35840,11,8062271915
19123,162011510,126060783,288072293,9,0,0,110592,4,10273815643
19124,162025250,125282458,287307708,2,0,0,21504,1,8281624474
19125,162060920,124963279,287024199,9,0,0,53248,4,6230831382
19126,162062030,124899234,286961264,1,0,0,16896,1,3115448992
19127,162065370,124820942,286886312,4,0,0,20992,7,2409127196
19128,162077410,125566839,287644249,9,0,0,30720,4,7792988762
19129,162087730,125486097,287573827,8,0,0,25088,11,3027141772
19130,162095400,125184957,287280357,5,0,0,23552,12,2023921761
19131,162124850,125524258,287649108,0,0,0,15872,6,9018634113
19132,162131220,124756363,286887583,2,0,0,4096,1,2773894900
19133,162134930,124924880,287059810,2,0,0,15872,1,2405173838
19134,162135450,124896728,287032178,8,0,0,26112,11,6325972747
19135,162158080,125612817,287770897,0,0,0,14848,6,6941244859
19136,162167000,126234022,288401022,7,0,0,79360,1,8069595216
19137,162197620,125365225,287562845,6,0,0,14848,12,3136485933
19138,162205870,126241352,288447222,4,0,0,9728,7,7852813242
19139,162207710,125147816,287355526,7,0,0,58880,1,8989253654
19140,162220450,125114198,287334648,9,0,0,18944,4,4246700428
19141,162222870,125737789,287960659,6,0,0,87040,12,3206883193
19142,162226910,125290667,287517577,4,0,0,55808,7,4744771344
19143,162234220,125088510,287322730,6,0,0,16896,12,4216739056
19144,162246290,125868371,288114661,7,0,0,26112,1,2235490517
19145,162253970,125852712,288106682,7,0,0,89600,1,7523017174
19146,162273500,125331963,287605463,9,0,0,24576,4,1554264447
19147,162273550,125044009,287317559,4,0,0,32256,7,3506211153
19148,162300530,126287338,288587868,2,0,0,56832,1,7858281392
19149,162315900,124957258,287273158,1,0,0,6144,1,3138055876
19150,162352490,125336559,287689049,2,0,0,55808,1,2554855019
19151,162362360,125897925,288260285,4,0,0,48128,7,7744284057
19152,162365000,125223077,287588077,2,0,0,13312,1,274149669
19153,162366580,125544505,287911085,5,0,0,2560,12,485219695
19154,162398780,124661677,287060457,1,0,0,2048,1,7434824052
19155,162411890,125784098,288195988,5,0,0,31744,12,2750269579
19156,162417360,125323440,287740800,4,0,0,52224,7,1155000866
19157,162423590,125172840,287596430,9,0,0,7168,4,10509187659
19158,162427060,125131238,287558298,2,0,0,4608,1,7634962593
19159,162435860,124854174,287290034,5,0,0,6656,12,1022320939
19160,162449860,125102863,287552723,3,0,0,45056,18,10036804388
19161,162462580,126258758,288721338,1,0,0,80384,1,3022373147
19162,162464980,126681307,289146287,6,0,0,5120,12,5339487931
19163,162479210,126405022,288884232,0,0,0,24064,6,6776217467
19164,162479720,126531366,289011086,4,0,0,35840,7,10466790780
19165,162492310,125872896,288365206,5,0,0,112128,12,6747937309
19166,162501900,125054971,287556871,6,0,0,13312,12,2161098212
19167,162529210,125064997,287594207,0,0,0,19968,6,724806145
19168,162546560,124945379,287491939,8,0,0,3072,11,1505716880
19169,162561970,126776167,289338137,2,0,0,65024,1,6881445730
19170,162562560,126927644,289490204,2,0,0,26624,1,9917626507
19171,162564710,125562142,288126852,7,0,0,39936,1,2807203871
19172,162573100,125858947,288432047,6,0,0,36864,12,9847097078
19173,162576770,125792202,288368972,5,0,0,1024,12,2848779498
19174,162580110,125128329,287708439,4,0,0,32768,7,9777312795
19175,162589140,126027859,288616999,6,0,0,39424,12,1286329265
19176,162592600,126269632,288862232,9,0,0,84992,4,9403602504
19177,162601810,125139169,287740979,0,0,0,512,6,414311266
19178,162629330,126966347,289595677,9,0,0,27648,4,9277057189
19179,162632020,125034693,287666713,3,0,0,16896,18,3675569127
19180,162641340,125566279,288207619,1,0,0,10752,1,2430874714
19181,162651000,125247559,287898559,8,0,0,44544,11,10377151141
19182,162683900,126297891,288981791,2,0,0,156672,1,487669439
19183,162695020,125029822,287724842,1,0,0,53760,1,6700341433
19184,162695410,125214872,287910282,5,0,0,38400,12,9711001199
19185,162712260,126375675,289087935,4,0,0,126464,7,3009356564
19186,162720440,125358896,288079336,5,0,0,23040,12,3732778555
19187,162750250,125395688,288145938,2,0,0,37376,1,1667236201
19188,162754370,125445541,288199911,5,0,0,12800,12,4370078313
19189,162762890,125746380,288509270,1,0,0,6656,1,5563693292
19190,162762970,124981799,287744769,0,0,0,5120,6,7335064338
19191,162774080,125012741,287786821,1,0,0,14848,1,2417848598
19192,162784520,124958666,287743186,4,0,0,7168,7,4487716939
19193,162808400,125059967,287868367,9,0,0,4096,4,9691463713
19194,162824800,125655614,288480414,2,0,0,12800,1,2402957979
19195,162827080,126397542,289224622,6,0,0,257024,12,4494183168
19196,162830730,125590062,288420792,9,0,0,14848,4,487597469
19197,162852020,125077240,287929260,9,0,0,14336,4,7277993492
19198,162884820,125713858,288598678,1,0,0,35328,1,5840134864
19199,162896700,126248004,289144704,7,0,0,34816,1,6248619656
19200,162905870,125754784,288660654,6,0,0,12288,12,501224083
19201,162911330,125621918,288533248,1,0,0,7168,1,8020980873
19202,162930310,126456150,289386460,4,0,0,98304,7,4932979780
19203,162940090,126080696,289020786,3,0,0,26624,18,9377822030
19204,162947170,126959376,289906546,8,0,0,193536,11,10181081244
19205,162948030,126353487,289301517,1,0,0,40960,1,2025583568
19206,162948830,126093351,289042181,9,0,0,70144,4,793649588
19207,162949580,126529034,289478614,8,0,0,47104,11,10625845205
19208,162970860,125655022,288625882,3,0,0,2560,18,5212531339
19209,163011700,125609154,288620854,9,0,0,11264,4,293206925
19210,163034370,126616859,289651229,2,0,0,96768,1,1712829092
19211,163066450,125699984,288766434,8,0,0,67072,11,8540390746
19212,163067630,125866402,288934032,4,0,0,31232,7,7437597854
19213,163086740,126923583,290010323,1,0,0,5632,1,5472285335
19214,163110490,125705265,288815755,6,0,0,1536,12,5560484317
19215,163131350,125473614,288604964,8,0,0,12288,11,4573985919
19216,163132420,125468777,288601197,2,0,0,8192,1,2498576452
19217,163132820,125185680,288318500,8,0,0,27648,11,7418176489
19218,163134540,126660849,289795389,6,0,0,72192,12,5692641374
19219,163141220,125595273,288736493,9,0,0,49664,4,2342316488
19220,163152070,125958358,289110428,1,0,0,1024,1,1083710837
19221,163157000,126293956,289450956,9,0,0,79872,4,10282188927
19222,163164270,125830523,288994793,1,0,0,10240,1,2023255110
19223,163167250,125209569,288376819,3,0,0,14336,18,2897246541
19224,163181420,125633844,288815264,2,0,0,92160,1,4227169245
19225,163196820,126650727,289847547,3,0,0,84992,18,3413423070
19226,163204120,125571697,288775817,9,0,0,30720,4,9000965687
19227,163204130,126925061,290129191,2,0,0,73216,1,7587527531
19228,163211280,126751644,289962924,3,0,0,73216,18,4206205098
19229,163212490,125428090,288640580,5,0,0,28160,12,3044342522
19230,163236440,125856198,289092638,5,0,0,15360,12,6565817677
19231,163242630,125749020,288991650,4,0,0,32256,7,2670428498
19232,163253790,125795590,289049380,8,0,0,23552,11,2439490655
19233,163259350,126092093,289351443,9,0,0,6144,4,9686049193
19234,163260730,125993358,289254088,4,0,0,34816,7,1601506690
19235,163268510,125833074,289101584,2,0,0,28672,1,2855667168
19236,163294920,125797905,289092825,1,0,0,512,1,6208253452
19237,163296180,125992834,289289014,6,0,0,65024,12,2902718487
19238,163298090,125964514,289262604,6,0,0,16384,12,4962804209
19239,163304660,127066635,290371295,8,0,0,9216,11,10426320850
19240,163319740,125551978,288871718,5,0,0,4096,12,5717409482
19241,163326260,126025986,289352246,3,0,0,2560,18,6828430985
19242,163335250,125660814,288996064,1,0,0,4096,1,4268960373
19243,163347810,126134259,289482069,8,0,0,11264,11,401515244
19244,163355240,125760427,289115667,3,0,0,2048,18,5594581105
19245,163371020,125872414,289243434,7,0,0,34304,1,1136031968
19246,163371950,126851458,290223408,3,0,0,67584,18,775772197
19247,163393730,126860107,290253837,5,0,0,56832,12,9795792509
19248,163413500,125586643,289000143,2,0,0,13312,1,4703576595
19249,163423930,125891510,289315440,3,0,0,45568,18,3577594110
19250,163426480,125923068,289349548,1,0,0,37376,1,9070376164
19251,163437140,125818866,289256006,9,0,0,4608,4,9463046926
19252,163502620,125730339,289232959,2,0,0,27136,1,6731939606
19253,163513840,125755339,289269179,1,0,0,21504,1,7089960296
19254,163544360,125773934,289318294,7,0,0,4608,1,10086362129
19255,163576870,125680719,289257589,2,0,0,5120,1,7933285928
19256,163583840,125880399,289464239,1,0,0,43520,1,3928305737
19257,163610450,126211170,289821620,6,0,0,86016,12,974696191
19258,163615710,126313236,289928946,1,0,0,24576,1,2086609894
19259,163641790,125468287,289110077,9,0,0,27648,4,3219104536
19260,163666780,126933434,290600214,1,0,0,139776,1,2733835016
19261,163670810,126849070,290519880,5,0,0,221696,12,1439597595
19262,163675290,125641577,289316867,5,0,0,4608,12,6895765550
19263,163693530,126667006,290360536,9,0,0,18432,4,8927174391
19264,163695640,126312944,290008584,5,0,0,30208,12,6912104065
19265,163762280,125492299,289254579,7,0,0,1536,1,6141846629
19266,163781390,125805840,289587230,7,0,0,26624,1,9898835527
19267,163794220,125806472,289600692,9,0,0,16384,4,1081517914
19268,163804720,126397376,290202096,9,0,0,43008,4,2228822132
19269,163837980,125656147,289494127,6,0,0,12800,12,2357335233
19270,163867070,125751037,289618107,5,0,0,8192,12,4915474544
19271,163889310,125845491,289734801,7,0,0,57344,1,9648687463
19272,163902860,125640331,289543191,5,0,0,20480,12,3673600524
19273,163910760,126503671,290414431,5,0,0,15360,12,5318295971
19274,163938060,126766772,290704832,3,0,0,22528,18,8153374385
19275,163970110,126078154,290048264,3,0,0,54272,18,4526029339
19276,163978470,125760690,289739160,3,0,0,10240,18,1759809960
19277,163980130,126679167,290659297,1,0,0,133632,1,9622327275
19278,163985970,125927954,289913924,9,0,0,512,4,8473779568
19279,163986720,125542220,289528940,2,0,0,17920,1,512785453
19280,163987340,125942900,289930240,2,0,0,1536,1,1538540299
19281,164006690,126908566,290915256,7,0,0,25088,1,9517066515
19282,164007320,125667630,289674950,1,0,0,8192,1,2073866755
19283,164008100,125905645,289913745,2,0,0,23552,1,2574183732
19284,164009830,125540969,289550799,7,0,0,5120,1,6592263451
19285,164019500,127070632,291090132,7,0,0,17920,1,6862460356
19286,164026170,126795593,290821763,5,0,0,96256,12,7964863936
19287,164053670,126639572,290693242,7,0,0,12800,1,903567506
19288,164057840,126917362,290975202,9,0,0,115712,4,8064635547
19289,164068490,125852945,289921435,9,0,0,24576,4,9207104303
19290,164122300,126011484,290133784,9,0,0,3072,4,9267730489
19291,164124090,125806485,289930575,7,0,0,1024,1,5343735134
19292,164151890,125939847,290091737,1,0,0,7168,1,3960633672
19293,164174990,125803713,289978703,8,0,0,51712,11,7019554937
19294,164184520,125468292,289652812,6,0,0,5120,12,9468545605
19295,164209230,125720519,289929749,7,0,0,2560,1,9126831457
19296,164212570,126571462,290784032,6,0,0,69632,12,5622711915
19297,164215070,125550924,289765994,5,0,0,6144,12,7442880837
19298,164221370,125885490,290106860,6,0,0,10752,12,4850695805
19299,164230840,126903151,291133991,6,0,0,143872,12,4938623602
19300,164240910,125935215,290176125,9,0,0,18432,4,1489367816
19301,164249850,125896151,290146001,6,0,0,1536,12,1225145170
19302,164280610,125796872,290077482,7,0,0,73728,1,4885283873
19303,164281240,125851585,290132825,7,0,0,1024,1,5256310095
19304,164284740,127551235,291835975,3,0,0,83968,18,3785476542
19305,164308410,126249193,290557603,2,0,0,91136,1,9095761730
19306,164329650,126359661,290689311,1,0,0,97280,1,1285963582
19307,164342140,126185898,290528038,6,0,0,17408,12,10299442244
19308,164345450,125787040,290132490,5,0,0,10752,12,8673272092
19309,164382520,125752379,290134899,8,0,0,3584,11,8836282643
19310,164401980,126328376,290730356,8,0,0,54784,11,7662886452
19311,164439880,125827708,290267588,8,0,0,45056,11,6566932703
19312,164471310,125669934,290141244,7,0,0,4608,1,8524483248
19313,164479200,125681561,290160761,2,0,0,4608,1,9557120082
19314,164517900,127558502,292076402,2,0,0,74240,1,8721814756
19315,164530760,125772206,290302966,7,0,0,32256,1,4689959859
19316,164564060,125838929,290402989,8,0,0,24064,11,857207863
19317,164576630,126648672,291225302,6,0,0,46592,12,8222108299
19318,164578660,125446300,290024960,2,0,0,4096,1,1466233240
19319,164582050,125827670,290409720,9,0,0,22016,4,10204994780
19320,164595370,125927341,290522711,9,0,0,9216,4,6025799211
19321,164616210,125652493,290268703,2,0,0,3584,1,8831354636
19322,164616910,126716204,291333114,3,0,0,512,18,10302023630
19323,164627580,127621215,292248795,5,0,0,26624,12,6771078165
19324,164712270,125890642,290602912,9,0,0,5120,4,6057996991
19325,164716890,126762758,291479648,9,0,0,48640,4,721405633
19326,164726560,126694444,291421004,8,0,0,105984,11,3811781370
19327,164736680,126139999,290876679,2,0,0,89088,1,4296892702
19328,164788030,126220063,291008093,9,0,0,9728,4,10523865056
19329,164796870,125535252,290332122,7,0,0,9728,1,2687253280
19330,164812260,125975695,290787955,7,0,0,12800,1,1491429615
19331,164863660,125754898,290618558,7,0,0,45056,1,9911811022
19332,164880280,126687611,291567891,6,0,0,19456,12,1056971442
19333,164882440,125999878,290882318,8,0,0,18432,11,8575657816
19334,164921610,125683197,290604807,8,0,0,6144,11,2310724196
19335,164965830,125635499,290601329,6,0,0,3584,12,7843434785
19336,164974700,125684948,290659648,2,0,0,1024,1,3259138356
19337,164976510,126280061,291256571,7,0,0,73216,1,4205852262
19338,164992960,126277549,291270509,7,0,0,1536,1,1159050410
19339,164992990,127318237,292311227,6,0,0,21504,12,5610507049
19340,165040650,125891792,290932442,3,0,0,30208,18,10360569896
19341,165078710,125619235,290697945,9,0,0,15360,4,4919691848
19342,165090010,126232295,291322305,7,0,0,24064,1,2655820205
19343,165121180,125671232,290792412,8,0,0,9216,11,5548806018
19344,165145220,125839700,290984920,7,0,0,8192,1,6025069174
19345,165148340,125834061,290982401,9,0,0,23552,4,671162873
19346,165170230,125834876,291005106,7,0,0,8192,1,2697799747
19347,165190630,125649595,290840225,2,0,0,26624,1,495461339
19348,165211110,125620980,290832090,6,0,0,33792,12,7603406134
19349,165228010,125840616,291068626,3,0,0,26112,18,9754089376
19350,165228650,125773921,291002571,8,0,0,57856,11,472959370
19351,165231980,126043700,291275680,6,0,0,16896,12,8542488284
19352,165235140,125842089,291077229,2,0,0,28160,1,910284264
19353,165236670,125808315,291044985,3,0,0,29184,18,9882627136
19354,165270800,126191307,291462107,8,0,0,64512,11,1679007928
19355,165334930,125935088,291270018,3,0,0,44032,18,735580743
19356,165364080,125828391,291192471,9,0,0,16384,4,9563094128
19357,165393230,125834903,291228133,7,0,0,9216,1,987656674
19358,165461830,126042438,291504268,3,0,0,3584,18,10277849514
19359,165479840,125754400,291234240,3,0,0,19968,18,1700022058
19360,165488220,125954192,291442412,6,0,0,64512,12,8664266746
19361,165497920,125803482,291301402,6,0,0,15360,12,10047131961
19362,165500670,125710413,291211083,9,0,0,33792,4,8262436937
19363,165583020,125805646,291388666,8,0,0,34816,11,4909954316
19364,165585010,125614513,291199523,8,0,0,7168,11,10304043655
19365,165606900,126016943,291623843,9,0,0,11776,4,4687007400
19366,165627720,125729909,291357629,9,0,0,27136,4,10479468989
19367,165654910,125809895,291464805,8,0,0,8704,11,192753642
19368,165668860,126725137,292393997,6,0,0,6656,12,5605731138
19369,165669100,125753633,291422733,8,0,0,5120,11,2206220812
19370,165672410,126045091,291717501,9,0,0,111104,4,2055817059
19371,165698500,126241107,291939607,8,0,0,4096,11,5757701497
19372,165700850,126046360,291747210,8,0,0,97280,11,9214730234
19373,165806120,125966897,291773017,8,0,0,36864,11,5520771642
19374,165829390,125977001,291806391,8,0,0,57856,11,8562070230
19375,165866340,125769093,291635433,7,0,0,3072,1,8020494810
19376,165873840,125878782,291752622,6,0,0,17408,12,6580258746
19377,165911310,125872517,291783827,6,0,0,16384,12,3871738125
19378,165958560,125827482,291786042,9,0,0,7168,4,4267219928
19379,165971580,126499761,292471341,9,0,0,32768,4,9607051594
19380,166054950,125933191,291988141,8,0,0,4096,11,4259698734
19381,166099830,126610276,292710106,9,0,0,105472,4,5580825276
19382,166142020,125617021,291759041,6,0,0,20992,12,8658566076
19383,166147720,125720147,291867867,6,0,0,32768,12,2354753358
19384,166172420,125637948,291810368,7,0,0,1024,1,5321951674
19385,166232070,125421875,291653945,9,0,0,3584,4,4396520887
19386,166246750,125273935,291520685,9,0,0,2048,4,2553296167
19387,166281570,126247965,292529535,6,0,0,20992,12,3474090530
19388,166281940,125342880,291624820,6,0,0,512,12,4856001129
19389,166285380,125936392,292221772,7,0,0,6656,1,10291273504
19390,166298020,125543960,291841980,9,0,0,7680,4,5422401793
19391,166363330,125480701,291844031,5,0,0,6656,12,1647398633
19392,166373510,125564826,291938336,9,0,0,7680,4,726483097
19393,166398880,125379932,291778812,6,0,0,18944,12,7126380273
19394,166432770,125377255,291810025,5,0,0,11776,12,5107637138
19395,166438210,125638839,292077049,5,0,0,2048,12,5960069154
19396,166464100,125297616,291761716,6,0,0,8704,12,7167454548
19397,166476590,125363004,291839594,5,0,0,11776,12,702008541
19398,166622180,126161042,292783222,6,0,0,25600,12,9386728746
19399,166673570,125516711,292190281,8,0,0,19456,11,9334732940
19400,166683810,125104907,291788717,8,0,0,8704,11,6610147330
19401,166704330,125274549,291978879,9,0,0,14336,4,4758508245
19402,166707850,125205821,291913671,8,0,0,10752,11,6988524747
19403,166761620,125263995,292025615,7,0,0,8192,1,4075929286
19404,166762060,125325341,292087401,6,0,0,29184,12,3241624871
19405,166766440,125452862,292219302,8,0,0,19456,11,3932103102
19406,166770460,125585261,292355721,6,0,0,23552,12,1663248183
19407,166772380,125362381,292134761,6,0,0,52736,12,6799484875
19408,166809450,125582496,292391946,8,0,0,40960,11,378986903
19409,166822910,125664903,292487813,7,0,0,32768,1,9503166994
19410,166883240,125043130,291926370,7,0,0,14848,1,8143865500
19411,166920760,125493787,292414547,5,0,0,14848,12,7552496577
19412,166927250,125272414,292199664,6,0,0,3072,12,2951675379
19413,166935640,125522888,292458528,8,0,0,16384,11,7424969919
19414,166972920,125691167,292664087,5,0,0,111104,12,1428825642
19415,166978570,125965466,292944036,5,0,0,56832,12,9418282512
19416,167015250,125081066,292096316,9,0,0,29184,4,3854272764
19417,167078150,125345253,292423403,8,0,0,3584,11,9984657109
19418,167158860,125804730,292963590,8,0,0,3072,11,1633483312
19419,167164340,125710376,292874716,5,0,0,7168,12,1865249114
19420,167174070,125130582,292304652,8,0,0,37888,11,2526697923
19421,167189810,125311566,292501376,8,0,0,9216,11,10227760049
19422,167192620,125363152,292555772,5,0,0,46592,12,401666176
19423,167213740,124945654,292159394,8,0,0,15360,11,9845619820
19424,167237840,125329593,292567433,9,0,0,1536,4,3522752460
19425,167241140,125893792,293134932,8,0,0,35840,11,5008219120
19426,167254970,125556924,292811894,8,0,0,72192,11,3288789950
19427,167293600,125315134,292608734,6,0,0,32768,12,9260259542
19428,167358300,125850452,293208752,9,0,0,22528,4,3758167970
19429,167431770,125885259,293317029,8,0,0,59392,11,5646251067
19430,167451200,125283300,292734500,6,0,0,51200,12,7306926970
19431,167474210,124945664,292419874,5,0,0,17408,12,8882977891
19432,167475300,125002148,292477448,8,0,0,19968,11,6542657112
19433,167475570,125032725,292508295,9,0,0,11776,4,8049248338
19434,167496090,125518961,293015051,5,0,0,107520,12,1747916983
19435,167528140,125230232,292758372,5,0,0,5120,12,402530785
19436,167633040,125754119,293387159,8,0,0,86528,11,2983519069
19437,167702590,124727179,292429769,8,0,0,3584,11,8128291123
19438,167709980,125349334,293059314,5,0,0,28672,12,9577750795
19439,167753130,124964799,292717929,9,0,0,25600,4,6128767642
19440,167759620,125203003,292962623,9,0,0,60928,4,8431544282
19441,167802270,125399595,293201865,8,0,0,13312,11,7907359058
19442,167952130,124614812,292566942,5,0,0,31744,12,2839434391
19443,167992740,124877284,292870024,5,0,0,22016,12,3366271279
19444,168011000,125138330,293149330,5,0,0,13312,12,844054578
19445,168050850,124715940,292766790,8,0,0,19968,11,2449152189
19446,168119460,124640118,292759578,5,0,0,2048,12,2913462841
19447,168124910,124488486,292613396,8,0,0,2560,11,1486613119
19448,168132810,124614414,292747224,8,0,0,18944,11,8183819502
19449,168205900,124703972,292909872,8,0,0,95232,11,10438644760
19450,168208580,124303221,292511801,9,0,0,3072,4,2870773137
19451,168215920,125082990,293298910,8,0,0,18432,11,2909557590
19452,168226940,124950699,293177639,5,0,0,9216,12,4586675016
19453,168274650,125129224,293403874,5,0,0,54784,12,10033044805
19454,168292800,125000471,293293271,5,0,0,119296,12,9880726651
19455,168307300,125532836,293840136,8,0,0,23040,11,7839111996
19456,168342400,124274221,292616621,8,0,0,2048,11,5408654739
19457,168382890,125308811,293691701,9,0,0,82432,4,9366389719
19458,168428400,125027107,293455507,5,0,0,8704,12,8792020537
19459,168434860,124762926,293197786,5,0,0,66048,12,7020318588
19460,168441890,124987971,293429861,9,0,0,22016,4,1422154047
19461,168492460,124597028,293089488,9,0,0,7680,4,8847536410
19462,168504340,124462905,292967245,9,0,0,6656,4,3042599654
19463,168516990,124344168,292861158,5,0,0,3584,12,5985306616
19464,168597110,124448806,293045916,9,0,0,15872,4,8496289926
19465,168617500,124301154,292918654,9,0,0,23552,4,9942282060
19466,168622560,124830272,293452832,8,0,0,37888,11,4102744198
19467,168644420,124267035,292911455,9,0,0,5120,4,3303880694
19468,168716570,124314168,293030738,8,0,0,16896,11,7256745676
19469,168721020,125057190,293778210,8,0,0,57856,11,5522285572
19470,168759100,124966526,293725626,9,0,0,46592,4,4408701753
19471,168820670,124755969,293576639,9,0,0,33792,4,296661297
19472,168829720,124773063,293602783,9,0,0,16896,4,2499301131
19473,168871820,124296257,293168077,5,0,0,8192,12,3521311200
19474,168914860,124126197,293041057,9,0,0,33792,4,8922135289
19475,168960960,124184291,293145251,5,0,0,33792,12,10644790875
19476,169026320,124050683,293077003,5,0,0,17920,12,2178842320
19477,169076440,124098368,293174808,9,0,0,22016,4,5400629506
19478,169133780,124208568,293342348,5,0,0,29696,12,8437035107
19479,169156860,124203912,293360772,5,0,0,29696,12,2613998840
19480,169178980,124044935,293223915,9,0,0,49664,4,3447784663
19481,169187910,124639266,293827176,5,0,0,7168,12,7064377640
19482,169223990,124397071,293621061,5,0,0,52224,12,2197832601
19483,169256960,124801994,294058954,9,0,0,200704,4,6671129628
19484,169372690,124765823,294138513,5,0,0,1536,12,3339442781
19485,169401800,123833994,293235794,9,0,0,38912,4,1709991362
19486,169435260,124320524,293755784,5,0,0,50176,12,7886733726
19487,169477540,124437248,293914788,9,0,0,9728,4,6713551277
19488,169482280,124107532,293589812,5,0,0,17920,12,7527210097
19489,169501120,124034368,293535488,9,0,0,61440,4,1325728544
19490,169508620,124045337,293553957,9,0,0,22016,4,2312614623
19491,169636300,123771037,293407337,9,0,0,11264,4,5174051344
19492,169641990,123771922,293413912,9,0,0,21504,4,9343453026
19493,169736860,123973428,293710288,5,0,0,60928,12,8722331741
19494,169756140,124054610,293810750,5,0,0,6144,12,8775389308
19495,169762170,123876476,293638646,5,0,0,40960,12,1044565875
19496,169770830,123960123,293730953,9,0,0,17408,4,7991049104
19497,169791010,123746841,293537851,5,0,0,7680,12,9672658069
19498,169831680,124247755,294079435,9,0,0,4608,4,370405077
19499,169852040,123952112,293804152,9,0,0,77312,4,3311993858
19500,169885840,124403653,294289493,9,0,0,88576,4,10590809553
19501,169889830,124070840,293960670,5,0,0,39424,12,9390302272
19502,169922150,124505572,294427722,9,0,0,18944,4,4446434133
19503,169939130,123727432,293666562,5,0,0,32256,12,2301765843
19504,169966020,123842835,293808855,5,0,0,15360,12,7576128704
19505,169974760,124006852,293981612,5,0,0,19456,12,190997129
19506,170019050,123761523,293780573,5,0,0,7680,12,9617603549
19507,170025450,123799519,293824969,9,0,0,46592,4,3090697371
19508,170035660,123605734,293641394,5,0,0,4608,12,8359216230
19509,170041280,123842635,293883915,9,0,0,23040,4,3386265766
19510,170068330,123907331,293975661,5,0,0,49152,12,8929117081
19511,170105370,124098434,294203804,5,0,0,50176,12,611402797
19512,170137250,123940766,294078016,9,0,0,35328,4,7808951513
19513,170282800,124012636,294295436,5,0,0,19456,12,7101241029
19514,170334920,123927570,294262490,5,0,0,73728,12,2586097492
19515,170360520,123727510,294088030,9,0,0,28160,4,5833022925
19516,170533960,123294955,293828915,9,0,0,5632,4,10355460347
19517,170538300,123650201,294188501,9,0,0,36864,4,10627904591
19518,170638020,123500010,294138030,9,0,0,72704,4,7560763916
19519,170649160,123506093,294155253,5,0,0,7680,12,1706336609
19520,170676980,123500274,294177254,5,0,0,48640,12,6833201337
19521,170748600,123318637,294067237,9,0,0,27136,4,4116500369
19522,170836190,123303898,294140088,9,0,0,5120,4,4532023857
19523,170848350,123074251,293922601,9,0,0,14336,4,7611872511
19524,170874050,123535639,294409689,9,0,0,37888,4,1184420556
19525,170900320,123188037,294088357,9,0,0,1024,4,3348557919
19526,171003790,123357934,294361724,5,0,0,14848,12,40581167
19527,171027590,123362299,294389889,9,0,0,73728,4,5909953430
19528,171066350,123173661,294240011,9,0,0,29184,4,2680074343
19529,171083110,123028613,294111723,5,0,0,2048,12,251732605
19530,171284270,122820482,294104752,9,0,0,53760,4,8100993182
19531,171310860,122994590,294305450,9,0,0,2560,4,8304718181
19532,171324220,122980435,294304655,9,0,0,30208,4,2047785762
