RequestID,ArrivalTime,DelayTime,FinishTime,InitiatorID,TargetID,IOType,Size,VolumeID,Offset
0,2192793415,54056,2192847471,7,0,0,3584,7,4265744425
1,2192794107,123572,2192917679,35,0,0,42496,35,5658735173
2,2192796036,108680,2192904716,22,0,0,56832,22,10427636653
3,2192798527,14287,2192812814,18,0,1,27648,18,1631523588
4,2192807011,66277,2192873288,21,0,0,4096,21,5804303797
5,2192835222,211521,2193046743,18,0,0,44544,18,6199415812
6,2192844113,269556,2193113669,38,0,0,24576,38,1675619068
7,2192853594,112963,2192966557,20,0,0,3584,20,7988070822
8,2192854381,251785,2193106166,16,0,0,512,16,6399822880
9,2192855851,5802,2192861653,48,0,1,6144,48,6358700023
10,2192867649,121466,2192989115,46,0,0,10240,46,10680317005
11,2192873862,140777,2193014639,36,0,0,1024,36,339370301
12,2192880870,60842,2192941712,37,0,0,4608,37,9932583609
13,2192896182,408047,2193304229,46,0,0,8192,46,5609703188
14,2192897057,150489,2193047546,27,0,0,2560,27,5354780286
15,2192897334,130268,2193027602,18,0,0,42496,18,3601744052
16,2192906378,265719,2193172097,24,0,0,15360,24,2876780036
17,2192915484,133013,2193048497,32,0,0,3072,32,5873978345
18,2192929171,176824,2193105995,32,0,0,11264,32,5746029869
19,2192932521,96671,2193029192,34,0,0,3072,34,4624264891
20,2192937490,409933,2193347423,41,0,0,7680,41,3422869024
21,2192943184,156232,2193099416,33,0,0,46080,33,3619233668
22,2192968077,60164,2193028241,18,0,0,2048,18,1082906719
23,2192970603,362211,2193332814,29,0,0,43008,29,8457997025
24,2192979623,155139,2193134762,40,0,0,9728,40,5834579078
25,2193013609,68074,2193081683,2,0,0,2048,2,6833086291
26,2193027943,2759,2193030702,6,0,1,1536,6,707518426
27,2193029843,160522,2193190365,25,0,0,23552,25,6401597625
28,2193035813,235229,2193271042,37,0,0,19968,37,9734002556
29,2193045575,101037,2193146612,18,0,0,7168,18,7722417741
30,2193054952,13083,2193068035,7,0,1,22016,7,5463338224
31,2193064860,89588,2193154448,7,0,0,7680,7,10672515684
32,2193084167,566,2193084733,46,0,1,512,46,681449310
33,2193089093,159018,2193248111,11,0,0,36864,11,988068873
34,2193093841,353767,2193447608,31,0,0,32256,31,10396645327
35,2193111663,144181,2193255844,30,0,0,14336,30,10612094892
36,2193117418,342609,2193460027,12,0,0,28160,12,4493269220
37,2193123433,2870,2193126303,11,0,1,8704,11,226008449
38,2193124799,9978,2193134777,19,0,1,6656,19,2796828376
39,2193149751,353693,2193503444,35,0,0,114688,35,5578741810
40,2193153035,818980,2193972015,41,0,0,5632,41,2523170842
41,2193154440,2495,2193156935,2,0,1,2560,2,6403882950
42,2193173514,16874,2193190388,33,0,1,19456,33,4188182995
43,2193177567,243534,2193421101,49,0,0,31744,49,5315553620
44,2193181715,364418,2193546133,34,0,0,7168,34,9623934693
45,2193183963,115106,2193299069,40,0,0,21504,40,7480944435
46,2193205055,1518,2193206573,34,0,1,1536,34,2409412377
47,2193213434,167629,2193381063,20,0,0,17408,20,5600549967
48,2193220812,285183,2193505995,27,0,0,8192,27,1870596464
49,2193228708,7230,2193235938,14,0,1,7680,14,10093497469
50,2193255103,361212,2193616315,47,0,0,29696,47,7357302460
51,2193288354,432632,2193720986,8,0,0,51200,8,3618992822
52,2193302549,302440,2193604989,21,0,0,38912,21,3093946718
53,2193320064,221792,2193541856,1,0,0,84480,1,1417157633
54,2193322281,318385,2193640666,5,0,0,79872,5,10688590448
55,2193374378,289733,2193664111,24,0,0,35328,24,7803885535
56,2193376752,187341,2193564093,17,0,0,14848,17,6812868671
57,2193390933,422872,2193813805,21,0,0,46592,21,8034467052
58,2193395479,296468,2193691947,7,0,0,35840,7,7228073814
59,2193402930,147430,2193550360,17,0,0,13824,17,423206489
60,2193424976,1994,2193426970,43,0,1,2048,43,10414656294
61,2193427620,4374,2193431994,8,0,1,4608,8,8835919675
62,2193429556,5984,2193435540,48,0,1,5632,48,597554349
63,2193437313,210560,2193647873,34,0,0,23552,34,5215565213
64,2193440367,609246,2194049613,20,0,0,37376,20,7862650368
65,2193450108,333273,2193783381,26,0,0,37376,26,595454515
66,2193450355,300203,2193750558,18,0,0,41984,18,2478901613
67,2193457459,93788,2193551247,1,0,0,2560,1,10525143722
68,2193464707,332432,2193797139,42,0,0,41984,42,4805900260
69,2193465075,1994,2193467069,8,0,1,2048,8,10672491241
70,2193473408,35993,2193509401,15,0,1,3584,15,1956408650
71,2193477673,129523,2193607196,44,0,0,7168,44,9042202813
72,2193479687,62192,2193541879,48,0,1,20480,48,8094136083
73,2193480762,241799,2193722561,8,0,0,5120,8,4356386000
74,2193486966,54928,2193541894,29,0,1,3072,29,2450932771
75,2193494135,257702,2193751837,14,0,0,4096,14,691596993
76,2193510823,340256,2193851079,21,0,0,22528,21,4678031545
77,2193518022,235422,2193753444,45,0,0,5120,45,7819534877
78,2193524784,259548,2193784332,23,0,0,3072,23,374600395
79,2193544051,312035,2193856086,7,0,0,16384,7,9036739833
80,2193578103,1994,2193580097,34,0,1,2048,34,6297026169
81,2193578738,282678,2193861416,34,0,0,2560,34,860476753
82,2193590028,181584,2193771612,45,0,0,4096,45,1652125105
83,2193594821,440926,2194035747,24,0,0,15360,24,708883782
84,2193611566,224456,2193836022,42,0,0,6144,42,10535403127
85,2193615734,374251,2193989985,25,0,0,49152,25,28112206
86,2193627188,269179,2193896367,14,0,0,49152,14,4133526108
87,2193676319,157816,2193834135,33,0,0,11264,33,2695393130
88,2193680501,117121,2193797622,44,0,0,1536,44,8726466746
89,2193684793,290201,2193974994,20,0,0,9728,20,8181854901
90,2193689646,7255,2193696901,21,0,1,12800,21,8462419192
91,2193692325,166178,2193858503,30,0,0,2048,30,3156879761
92,2193713274,228858,2193942132,5,0,0,27136,5,9736295552
93,2193716394,233397,2193949791,27,0,0,25088,27,767143906
94,2193738398,16394,2193754792,35,0,1,3072,35,2115022631
95,2193742194,14224,2193756418,35,0,1,2560,35,2716123801
96,2193747330,110495,2193857825,30,0,0,5632,30,4390179872
97,2193749915,6657,2193756572,19,0,1,8704,19,3042146918
98,2193759321,305950,2194065271,37,0,0,14336,37,4190263285
99,2193760056,150801,2193910857,14,0,0,19968,14,7063207736
100,2193762605,426951,2194189556,12,0,0,8192,12,10320623519
101,2193763442,197056,2193960498,14,0,0,5632,14,1820932541
102,2193768522,336794,2194105316,22,0,0,5632,22,3564773761
103,2193769051,354711,2194123762,2,0,0,13312,2,4968983205
104,2193789080,335485,2194124565,33,0,0,2560,33,2232031227
105,2193789751,313826,2194103577,1,0,0,48128,1,8348482288
106,2193798113,418282,2194216395,28,0,0,24064,28,1431048444
107,2193809486,4877,2193814363,24,0,1,512,24,6468132716
108,2193814536,305147,2194119683,30,0,0,47104,30,8285738881
109,2193836181,350841,2194187022,22,0,0,75776,22,1349448687
110,2193846851,377510,2194224361,5,0,0,7168,5,9262767782
111,2193854306,219092,2194073398,46,0,0,26624,46,1678053057
112,2193863582,281969,2194145551,32,0,0,11776,32,2081058491
113,2193867137,328073,2194195210,34,0,0,3584,34,3996460488
114,2193871632,24750,2193896382,43,0,1,16896,43,5239689614
115,2193872019,24386,2193896405,12,0,1,2048,12,6243755778
116,2193878153,197912,2194076065,40,0,0,8704,40,2984182944
117,2193883008,480192,2194363200,25,0,0,33792,25,388526288
118,2193908583,255336,2194163919,26,0,0,16384,26,3390742489
119,2193931047,271661,2194202708,24,0,0,4096,24,9373780806
120,2193951986,352757,2194304743,25,0,0,43008,25,5346175615
121,2193957871,191732,2194149603,16,0,0,9728,16,9416136127
122,2193967387,226708,2194194095,17,0,0,14848,17,9411564084
123,2193968697,448528,2194417225,21,0,0,12800,21,882845841
124,2193986606,396300,2194382906,46,0,0,52736,46,9348824381
125,2193987385,566286,2194553671,24,0,0,136704,24,2562194765
126,2194010630,3904,2194014534,3,0,1,10752,3,6814696840
127,2194045708,11144,2194056852,43,0,1,7680,43,9155084177
128,2194047374,226176,2194273550,4,0,0,3584,4,7153220160
129,2194079384,188742,2194268126,19,0,0,26112,19,2942038309
130,2194090790,342316,2194433106,9,0,0,30208,9,2225300721
131,2194106070,199171,2194305241,43,0,0,1024,43,2080786503
132,2194108354,225609,2194333963,13,0,0,17920,13,5763678374
133,2194139532,566,2194140098,8,0,1,512,8,8383235286
134,2194139906,453216,2194593122,4,0,0,40960,4,10729286018
135,2194140207,266614,2194406821,38,0,0,78336,38,7887414938
136,2194156982,30055,2194187037,19,0,1,4096,19,7237864826
137,2194169117,135797,2194304914,19,0,0,512,19,7081387336
138,2194190975,526656,2194717631,18,0,0,13312,18,5061661415
139,2194211326,351408,2194562734,35,0,0,29696,35,4681255164
140,2194228094,4420,2194232514,9,0,1,11776,9,1728485674
141,2194229890,15870,2194245760,3,0,1,27136,3,678099476
142,2194247284,189113,2194436397,16,0,0,10752,16,8860823508
143,2194250406,573251,2194823657,20,0,0,512,20,3909368323
144,2194271507,551979,2194823486,34,0,0,59392,34,1975597791
145,2194279157,85462,2194364619,18,0,0,4608,18,4811232866
146,2194279990,139122,2194419112,2,0,0,6144,2,3182248899
147,2194287245,640710,2194927955,28,0,0,32768,28,7181829099
148,2194291103,188620,2194479723,30,0,0,11776,30,2936352592
149,2194302094,162113,2194464207,31,0,0,19456,31,9971271594
150,2194303569,598166,2194901735,6,0,0,108032,6,2940123072
151,2194321520,3645,2194325165,29,0,1,10240,29,4041505792
152,2194332363,179641,2194512004,43,0,0,5632,43,9663854462
153,2194339313,227875,2194567188,41,0,0,14336,41,8172252760
154,2194346996,682786,2195029782,18,0,0,30208,18,9574219499
155,2194370017,37329,2194407346,22,0,1,512,22,3458804770
156,2194371244,673825,2195045069,29,0,0,8704,29,870523687
157,2194376938,236977,2194613915,2,0,0,6656,2,9912822617
158,2194376978,237576,2194614554,19,0,0,2048,19,9590800092
159,2194385001,195626,2194580627,9,0,0,11776,9,3955246715
160,2194428762,258009,2194686771,17,0,0,11776,17,1679340421
161,2194448587,15635,2194464222,24,0,1,22528,24,1718073163
162,2194463365,908540,2195371905,27,0,0,24064,27,6758770206
163,2194471534,97869,2194569403,28,0,0,7168,28,9989181704
164,2194488847,683379,2195172226,31,0,0,6656,31,3196339249
165,2194491780,166517,2194658297,2,0,0,11264,2,9782239230
166,2194492950,1518,2194494468,30,0,1,1536,30,7524001658
167,2194510194,52571,2194562765,20,0,1,42496,20,6277307373
168,2194522560,149022,2194671582,1,0,0,2048,1,5223797338
169,2194529198,63939,2194593137,20,0,1,28160,20,7056917720
170,2194535328,270023,2194805351,34,0,0,41984,34,10080282886
171,2194546420,46732,2194593152,48,0,1,6656,48,8920717277
172,2194548025,565148,2195113173,34,0,0,14848,34,8392071913
173,2194554860,110669,2194665529,4,0,0,2048,4,749883511
174,2194555983,138901,2194694884,35,0,0,4608,35,10359535341
175,2194602130,3898,2194606028,35,0,1,4096,35,10293644352
176,2194621949,122554,2194744503,44,0,0,39936,44,2695315836
177,2194676472,3898,2194680370,10,0,1,4096,10,4000551834
178,2194680499,766184,2195446683,20,0,0,11264,20,7851848203
179,2194708591,151594,2194860185,46,0,0,34304,46,8229588260
180,2194716421,267320,2194983741,12,0,0,31232,12,5354512311
181,2194733784,168746,2194902530,2,0,0,2560,2,8519160908
182,2194735205,765547,2195500752,13,0,0,37888,13,6170741306
183,2194741887,9412,2194751299,19,0,1,7168,19,2037060038
184,2194748304,346884,2195095188,25,0,0,26624,25,588262019
185,2194769240,139257,2194908497,47,0,0,19456,47,2188388130
186,2194776140,392452,2195168592,2,0,0,46080,2,1697906631
187,2194776425,2946,2194779371,14,0,1,3072,14,4499131446
188,2194776887,181864,2194958751,1,0,0,37888,1,10256720258
189,2194779763,258310,2195038073,21,0,0,27136,21,978955157
190,2194788928,119756,2194908684,27,0,0,512,27,810800126
191,2194790090,155841,2194945931,24,0,0,2048,24,6358341921
192,2194794086,180124,2194974210,42,0,0,50688,42,4343222066
193,2194794481,200687,2194995168,26,0,0,3072,26,7494289837
194,2194795133,312862,2195107995,2,0,0,41984,2,1824100850
195,2194817160,240828,2195057988,22,0,0,10752,22,7126901392
196,2194820796,10584,2194831380,33,0,1,8192,33,9817251256
197,2194835350,2470,2194837820,30,0,1,2560,30,1423304124
198,2194839727,198829,2195038556,15,0,0,1536,15,7509110183
199,2194848768,742515,2195591283,4,0,0,9728,4,1308771088
200,2194861131,128431,2194989562,24,0,0,5632,24,4753597138
201,2194879533,195688,2195075221,35,0,0,3584,35,9887154217
202,2194884840,27038,2194911878,10,0,1,3584,10,9466835928
203,2194889453,25331,2194914784,3,0,1,4608,3,4471559140
204,2194941995,329587,2195271582,11,0,0,55296,11,5865500139
205,2194981959,662859,2195644818,5,0,0,24064,5,1056121650
206,2195021122,149061,2195170183,16,0,0,5120,16,6843055209
207,2195034436,253709,2195288145,36,0,0,30208,36,4585306552
208,2195035349,79251,2195114600,23,0,0,4608,23,5323180638
209,2195035829,17056,2195052885,48,0,1,27648,48,1037947315
210,2195041857,66777,2195108634,19,0,0,2048,19,3543485548
211,2195047650,125363,2195173013,44,0,0,2048,44,2091291230
212,2195054125,224032,2195278157,30,0,0,21504,30,6909481246
213,2195058834,232286,2195291120,25,0,0,4096,25,9405300174
214,2195062936,296116,2195359052,29,0,0,15360,29,8006125071
215,2195063588,1518,2195065106,0,0,1,1536,0,33127991
216,2195077616,201040,2195278656,26,0,0,1536,26,8175711676
217,2195083637,697152,2195780789,16,0,0,4096,16,2797640761
218,2195086761,256326,2195343087,9,0,0,2560,9,6523748415
219,2195107588,234704,2195342292,35,0,0,59392,35,959874238
220,2195128182,246102,2195374284,26,0,0,3072,26,3547537692
221,2195141215,209063,2195350278,26,0,0,23552,26,10736525758
222,2195144591,264295,2195408886,29,0,0,4608,29,5654182668
223,2195158292,416056,2195574348,6,0,0,37376,6,5192214
224,2195158689,18346,2195177035,12,0,1,5120,12,9573379350
225,2195189963,250552,2195440515,4,0,0,7680,4,9612862865
226,2195199793,89459,2195289252,32,0,0,3584,32,10549543522
227,2195202060,916399,2196118459,9,0,0,37376,9,8747967270
228,2195205864,349833,2195555697,3,0,0,60416,3,3066637521
229,2195212193,1994,2195214187,30,0,1,2048,30,3516278012
230,2195218707,1518,2195220225,33,0,1,1536,33,7042645467
231,2195237349,251813,2195489162,16,0,0,34304,16,5751982023
232,2195240339,3422,2195243761,30,0,1,3584,30,7474278029
233,2195246664,107693,2195354357,37,0,0,13312,37,55316572
234,2195248231,487790,2195736021,12,0,0,11776,12,2232533438
235,2195257966,20716,2195278682,8,0,1,512,8,2821757687
236,2195273361,364110,2195637471,28,0,0,32256,28,2687857072
237,2195290557,126059,2195416616,7,0,0,18944,7,5091436636
238,2195296521,325329,2195621850,1,0,0,7168,1,4387124477
239,2195297920,212890,2195510810,37,0,0,19456,37,5793758270
240,2195307391,226573,2195533964,26,0,0,3584,26,9831532088
241,2195336330,35598,2195371928,29,0,1,17920,29,2379155731
242,2195349628,332807,2195682435,20,0,0,23552,20,10544931402
243,2195350318,211798,2195562116,28,0,0,20992,28,7939960829
244,2195369428,7820,2195377248,10,0,1,5632,10,8417358181
245,2195371598,320456,2195692054,10,0,0,25600,10,7494560541
246,2195388088,129921,2195518009,45,0,0,23552,45,4345916578
247,2195404982,1042,2195406024,19,0,1,1024,19,10489554921
248,2195420015,253233,2195673248,47,0,0,66048,47,2305351505
249,2195420630,417111,2195837741,43,0,0,29696,43,5738660114
250,2195432746,151205,2195583951,1,0,0,17920,1,9566042019
251,2195459598,1042,2195460640,29,0,1,1024,29,6859367946
252,2195461480,27697,2195489177,24,0,1,32768,24,3488307895
253,2195466529,347747,2195814276,42,0,0,9216,42,7792591051
254,2195472259,180842,2195653101,46,0,0,27136,46,3352634715
255,2195484415,228602,2195713017,49,0,0,52224,49,239906187
256,2195484769,230931,2195715700,17,0,0,8704,17,4450488385
257,2195498561,278473,2195777034,21,0,0,35328,21,3117355754
258,2195507619,938496,2196446115,37,0,0,72192,37,9016766194
259,2195544185,362228,2195906413,22,0,0,47616,22,956995110
260,2195566992,284776,2195851768,25,0,0,18432,25,31718323
261,2195574470,269838,2195844308,1,0,0,21504,1,6539938841
262,2195586161,225284,2195811445,17,0,0,14848,17,7379652750
263,2195589343,5354,2195594697,33,0,1,3584,33,5035204453
264,2195596734,248369,2195845103,18,0,0,2560,18,213086785
265,2195599058,15321,2195614379,25,0,1,29696,25,8328308913
266,2195600899,14248,2195615147,3,0,1,11776,3,10331978864
267,2195650871,207281,2195858152,11,0,0,4096,11,4989898173
268,2195659278,23172,2195682450,14,0,1,9728,14,2392954223
269,2195690987,200903,2195891890,23,0,0,17920,23,3608756953
270,2195693440,373024,2196066464,33,0,0,107520,33,2711720099
271,2195705471,322681,2196028152,19,0,0,9728,19,8434873339
272,2195706752,174567,2195881319,1,0,0,12288,1,8739962704
273,2195718178,1042,2195719220,20,0,1,1024,20,164070432
274,2195720520,895309,2196615829,41,0,0,54272,41,4881117481
275,2195721471,14804,2195736275,14,0,1,28672,14,9861631698
276,2195730274,8267,2195738541,22,0,1,3584,22,7131044113
277,2195738884,463456,2196202340,3,0,0,39936,3,7051045025
278,2195748510,467454,2196215964,32,0,0,18944,32,8101351698
279,2195753815,97968,2195851783,20,0,1,151040,20,1967089181
280,2195778431,761215,2196539646,23,0,0,69120,23,7888124416
281,2195806427,1090029,2196896456,30,0,0,39936,30,9874344671
282,2195807028,300020,2196107048,36,0,0,114688,36,5522297495
283,2195822969,28829,2195851798,11,0,1,3584,11,573218933
284,2195838141,478701,2196316842,43,0,0,36352,43,2772733373
285,2195876633,6278,2195882911,5,0,1,6656,5,8487620089
286,2195877136,243210,2196120346,37,0,0,6144,37,359805857
287,2195882247,598443,2196480690,42,0,0,13312,42,6085335349
288,2195894802,922818,2196817620,41,0,0,52736,41,2348502737
289,2195909705,444301,2196354006,34,0,0,31744,34,9860051470
290,2195931164,659521,2196590685,32,0,0,20480,32,9323735361
291,2195933009,491095,2196424104,2,0,0,39424,2,3294126025
292,2195933601,216927,2196150528,33,0,0,15360,33,602469390
293,2195934618,390663,2196325281,3,0,0,27648,3,1927195222
294,2195947399,3898,2195951297,29,0,1,4096,29,8797812457
295,2195954100,515118,2196469218,46,0,0,75776,46,2062990876
296,2195967286,236644,2196203930,12,0,0,5120,12,8465734073
297,2195986121,398707,2196384828,14,0,0,32768,14,469658259
298,2195990759,262291,2196253050,7,0,0,23040,7,10542085382
299,2196008060,366769,2196374829,48,0,0,19968,48,3601404774
300,2196016718,679828,2196696546,21,0,0,19456,21,3972168467
301,2196019486,101359,2196120845,23,0,0,1536,23,6124428947
302,2196021573,477774,2196499347,45,0,0,34304,45,5283676999
303,2196043155,218688,2196261843,22,0,0,8192,22,756734591
304,2196058627,11752,2196070379,15,0,1,4096,15,3056997013
305,2196088444,538609,2196627053,9,0,0,10240,9,3714462296
306,2196105315,252294,2196357609,42,0,0,11776,42,2726338789
307,2196106461,18038,2196124499,2,0,1,10240,2,5546933195
308,2196112008,15353,2196127361,3,0,1,9728,3,5240792322
309,2196113206,356807,2196470013,16,0,0,2560,16,624599533
310,2196125650,670141,2196795791,30,0,0,6144,30,10362512996
311,2196133268,343343,2196476611,43,0,0,20480,43,9449277486
312,2196133662,579058,2196712720,49,0,0,33792,49,10307529253
313,2196165564,1518,2196167082,10,0,1,1536,10,1275271279
314,2196184385,857427,2197041812,14,0,0,44544,14,6026733599
315,2196189457,12898,2196202355,22,0,1,3072,22,7022890012
316,2196198925,286928,2196485853,38,0,0,16896,38,1314546869
317,2196214119,194894,2196409013,32,0,0,16384,32,1122190516
318,2196219755,364675,2196584430,27,0,0,54784,27,1112152093
319,2196229509,11796,2196241305,14,0,1,19456,14,36281664
320,2196229555,623363,2196852918,10,0,0,71680,10,10329440914
321,2196257257,6278,2196263535,8,0,1,6656,8,1453346644
322,2196263986,206362,2196470348,49,0,0,1024,49,582785481
323,2196284679,276146,2196560825,6,0,0,13312,6,7312132787
324,2196330827,586982,2196917809,1,0,0,39936,1,1561665818
325,2196334981,294895,2196629876,20,0,0,9216,20,2017529163
326,2196336850,207975,2196544825,18,0,0,16896,18,3784987890
327,2196349601,352808,2196702409,49,0,0,16384,49,9102935753
328,2196364911,190568,2196555479,10,0,0,18432,10,6796581708
329,2196379086,8680,2196387766,21,0,1,3072,21,4672264306
330,2196385468,7091,2196392559,43,0,1,7168,43,9603246365
331,2196426001,458256,2196884257,14,0,0,91136,14,9017839548
332,2196434850,251717,2196686567,26,0,0,17920,26,10520044912
333,2196440978,226221,2196667199,18,0,0,14848,18,7443746161
334,2196483903,257740,2196741643,26,0,0,17408,26,1058292807
335,2196492096,196430,2196688526,1,0,0,3072,1,4826338069
336,2196502703,569149,2197071852,17,0,0,16896,17,1483294772
337,2196526339,499897,2197026236,8,0,0,50688,8,7794762855
338,2196532744,617111,2197149855,8,0,0,57344,8,7569977325
339,2196554483,142546,2196697029,11,0,0,1536,11,8047817226
340,2196566063,24653,2196590716,9,0,1,16384,9,7380158619
341,2196575302,208401,2196783703,23,0,0,2560,23,2910779106
342,2196575450,247857,2196823307,32,0,0,3584,32,1179590152
343,2196579752,200148,2196779900,1,0,0,32256,1,3068610459
344,2196586635,317601,2196904236,15,0,0,2048,15,9457679911
345,2196588703,308704,2196897407,14,0,0,3072,14,3867446806
346,2196597589,18255,2196615844,45,0,1,3584,45,4159922599
347,2196605940,10938,2196616878,29,0,1,1024,29,9366058833
348,2196618069,566,2196618635,6,0,1,512,6,4609378110
349,2196628504,152363,2196780867,20,0,0,3072,20,6004074361
350,2196630604,289302,2196919906,24,0,0,6656,24,6708671478
351,2196635162,304242,2196939404,1,0,0,3072,1,8208423451
352,2196660244,193509,2196853753,9,0,0,2560,9,6616101140
353,2196678034,113212,2196791246,26,0,0,1536,26,4772712323
354,2196688595,235538,2196924133,27,0,0,13824,27,6164210348
355,2196714855,3904,2196718759,33,0,1,10752,33,6193748620
356,2196717476,4602,2196722078,18,0,1,4096,18,6094653789
357,2196730986,11274,2196742260,12,0,1,18432,12,9715194610
358,2196739120,218779,2196957899,22,0,0,47616,22,6923113382
359,2196759691,4679,2196764370,18,0,1,12288,18,10540440054
360,2196764222,16660,2196780882,18,0,1,26624,18,10221212264
361,2196766394,19297,2196785691,43,0,1,5120,43,8275835881
362,2196772116,164318,2196936434,29,0,0,13312,29,6423568328
363,2196782799,114631,2196897430,20,0,1,172544,20,1127884259
364,2196785965,111488,2196897453,13,0,1,5120,13,5998367372
365,2196792193,639236,2197431429,20,0,0,40448,20,1295572250
366,2196819527,487408,2197306935,30,0,0,31232,30,7536442924
367,2196823477,243196,2197066673,30,0,0,35328,30,2412537263
368,2196837870,122384,2196960254,42,0,0,7680,42,7060474572
369,2196862115,266868,2197128983,25,0,0,16896,25,706371777
370,2196872217,29523,2196901740,18,0,1,4608,18,3642378885
371,2196889684,316504,2197206188,29,0,0,22016,29,10441641479
372,2196893911,273462,2197167373,31,0,0,29696,31,1678198633
373,2196899542,473130,2197372672,13,0,0,15360,13,262008641
374,2196900431,17401,2196917832,41,0,1,7168,41,9362881913
375,2196903162,14685,2196917847,32,0,1,9216,32,1006149070
376,2196904562,181261,2197085823,34,0,0,12800,34,533882620
377,2196910659,183038,2197093697,19,0,0,9728,19,9683522788
378,2196911492,270387,2197181879,35,0,0,29184,35,2382106280
379,2196915421,571346,2197486767,33,0,0,9216,33,4732081959
380,2196915573,242721,2197158294,37,0,0,27648,37,2937748074
381,2196921930,7957,2196929887,12,0,1,14336,12,2100740112
382,2196927411,4309,2196931720,30,0,1,9216,30,8556279552
383,2196931245,254557,2197185802,25,0,0,12800,25,461407621
384,2196933955,417064,2197351019,24,0,0,52736,24,2688812656
385,2196935110,540175,2197475285,28,0,0,34304,28,5319820549
386,2196937096,301707,2197238803,22,0,0,12800,22,5327129144
387,2196981053,249936,2197230989,42,0,0,12800,42,127888569
388,2196991995,222444,2197214439,37,0,0,1024,37,380260373
389,2197017154,24673,2197041827,29,0,1,10240,29,1373833788
390,2197019792,367099,2197386891,5,0,0,34304,5,8788712825
391,2197059167,337271,2197396438,2,0,0,31232,2,6357788624
392,2197063659,205560,2197269219,7,0,0,13312,7,2967384226
393,2197074506,379730,2197454236,45,0,0,74752,45,8491246004
394,2197076981,4679,2197081660,10,0,1,12288,10,9280481101
395,2197081070,118395,2197199465,23,0,0,5120,23,8873075637
396,2197084477,249986,2197334463,29,0,0,23552,29,953521083
397,2197084791,237740,2197322531,3,0,0,2048,3,9094701718
398,2197085450,370533,2197455983,38,0,0,5632,38,9092696826
399,2197141655,27671,2197169326,41,0,1,2048,41,5415605059
400,2197151609,311759,2197463368,49,0,0,2048,49,47670531
401,2197160694,8978,2197169672,8,0,1,512,8,2815698413
402,2197171437,14388,2197185825,29,0,1,5120,29,9665637601
403,2197172660,20389,2197193049,22,0,1,7680,22,2571865228
404,2197175347,518951,2197694298,49,0,0,55808,49,1424391191
405,2197177469,16553,2197194022,30,0,1,12800,30,5345368545
406,2197188019,210774,2197398793,4,0,0,7680,4,7104700154
407,2197202830,6237,2197209067,32,0,1,8704,32,5347088312
408,2197203728,410631,2197614359,47,0,0,24064,47,7578087624
409,2197207122,257665,2197464787,29,0,0,4608,29,4521248293
410,2197213480,3387,2197216867,33,0,1,9728,33,9521512182
411,2197219863,242219,2197462082,21,0,0,19968,21,7238780275
412,2197247845,156615,2197404460,12,0,0,13312,12,7274686822
413,2197265245,570965,2197836210,27,0,0,5120,27,8757375025
414,2197279445,94178,2197373623,16,0,0,3072,16,3782384777
415,2197293166,184957,2197478123,1,0,0,9216,1,7409382026
416,2197299828,8634,2197308462,11,0,1,1536,11,3200599308
417,2197303279,159450,2197462729,38,0,0,2048,38,7695767876
418,2197313913,4374,2197318287,33,0,1,4608,33,6213581994
419,2197321724,438568,2197760292,3,0,0,4096,3,2983043357
420,2197322093,1948,2197324041,21,0,1,1536,21,4126945598
421,2197326933,243644,2197570577,30,0,0,35840,30,383332165
422,2197334434,16608,2197351042,41,0,1,6656,41,3437933457
423,2197336485,474836,2197811321,34,0,0,9728,34,7472203222
424,2197350005,232380,2197582385,3,0,0,14336,3,1770956683
425,2197355886,251126,2197607012,1,0,0,35328,1,263107760
426,2197360706,415953,2197776659,38,0,0,28160,38,4255836382
427,2197378024,114218,2197492242,15,0,0,17920,15,3352197293
428,2197379594,344059,2197723653,33,0,0,53760,33,3969643013
429,2197416721,366011,2197782732,18,0,0,7168,18,10605284140
430,2197420671,44131,2197464802,22,0,1,9728,22,5632484955
431,2197423815,51485,2197475300,14,0,1,6656,14,5583422327
432,2197443254,34884,2197478138,12,0,1,3072,12,8365197453
433,2197459173,472908,2197932081,43,0,0,29696,43,9563122394
434,2197468800,671056,2198139856,46,0,0,36352,46,2355888670
435,2197473471,229758,2197703229,36,0,0,29184,36,174205159
436,2197507247,124110,2197631357,19,0,0,11776,19,4549264878
437,2197507525,339749,2197847274,22,0,0,6144,22,9346800181
438,2197517878,5802,2197523680,48,0,1,6144,48,3835189524
439,2197521517,4109,2197525626,35,0,1,3072,35,10119092661
440,2197530532,11791,2197542323,41,0,1,19456,41,1645032018
441,2197537712,4970,2197542682,18,0,1,9728,18,317476075
442,2197583075,509509,2198092584,18,0,0,37376,18,8274139647
443,2197584776,330016,2197914792,7,0,0,19968,7,3322024971
444,2197588726,87963,2197676689,8,0,0,512,8,1890355931
445,2197595259,230895,2197826154,19,0,0,22528,19,10012539951
446,2197605095,457328,2198062423,24,0,0,103936,24,3882232664
447,2197614555,109137,2197723692,20,0,1,166912,20,1847325607
448,2197621019,354337,2197975356,24,0,0,92672,24,2909299994
449,2197628649,99549,2197728198,34,0,1,34816,34,571662886
450,2197638471,153012,2197791483,19,0,0,1024,19,7800905142
451,2197641599,505619,2198147218,47,0,0,19968,47,1663704720
452,2197654343,442624,2198096967,32,0,0,14336,32,5270263443
453,2197658103,72041,2197730144,39,0,1,3072,39,5980903513
454,2197664473,68577,2197733050,34,0,1,4608,34,5663640994
455,2197666478,67443,2197733921,20,0,1,12288,20,1980723092
456,2197667646,317873,2197985519,15,0,0,33280,15,5805497210
457,2197667692,669970,2198337662,23,0,0,17920,23,3657382681
458,2197700892,35295,2197736187,15,0,1,3584,15,6862890956
459,2197707398,373775,2198081173,26,0,0,58368,26,3966923894
460,2197707929,355445,2198063374,4,0,0,3072,4,9632170189
461,2197710552,645578,2198356130,12,0,0,27648,12,4811450090
462,2197725707,16893,2197742600,43,0,1,30720,43,7262165766
463,2197734781,10085,2197744866,46,0,1,3584,46,6217123329
464,2197780734,348031,2198128765,11,0,0,43520,11,7924128903
465,2197792707,367076,2198159783,40,0,0,2560,40,715674458
466,2197808944,306531,2198115475,28,0,0,42496,28,1302218813
467,2197826718,338159,2198164877,37,0,0,3584,37,9903976992
468,2197873714,5454,2197879168,10,0,1,13824,10,2304754757
469,2197877982,274103,2198152085,20,0,0,15872,20,9996629090
470,2197898829,566,2197899395,33,0,1,512,33,8574321130
471,2197916565,242423,2198158988,16,0,0,22528,16,3469571626
472,2197917690,384277,2198301967,43,0,0,32256,43,8244892438
473,2197923940,217179,2198141119,23,0,0,4096,23,4953799853
474,2197946090,223793,2198169883,34,0,0,10752,34,7767391741
475,2197954281,235992,2198190273,13,0,0,15360,13,3914996581
476,2197969047,305330,2198274377,12,0,0,41472,12,9695420060
477,2197975067,250818,2198225885,19,0,0,42496,19,1075194898
478,2197976497,300703,2198277200,38,0,0,9216,38,252530017
479,2197982583,469370,2198451953,30,0,0,30720,30,5691219985
480,2197982891,299877,2198282768,17,0,0,14848,17,10430926828
481,2197985685,273826,2198259511,11,0,0,18944,11,932809036
482,2198022601,559666,2198582267,49,0,0,3584,49,7251568927
483,2198034877,335233,2198370110,4,0,0,28160,4,10604870605
484,2198078589,249088,2198327677,4,0,0,4608,4,638338391
485,2198083305,273152,2198356457,33,0,0,1024,33,4524486564
486,2198094982,100395,2198195377,21,0,0,2560,21,1414833156
487,2198098754,16736,2198115490,16,0,1,7680,16,4307344117
488,2198130131,39767,2198169898,0,0,1,30720,0,627477275
489,2198134072,285007,2198419079,38,0,0,7680,38,3737619032
490,2198146184,92099,2198238283,43,0,0,6144,43,9310930303
491,2198148520,360341,2198508861,34,0,0,25088,34,3683847226
492,2198156688,86609,2198243297,14,0,0,6656,14,8582969188
493,2198158141,88422,2198246563,38,0,0,3072,38,6779523974
494,2198158306,237531,2198395837,36,0,0,6144,36,9614840795
495,2198173764,242952,2198416716,24,0,0,30208,24,4599256700
496,2198178595,5802,2198184397,30,0,1,6144,30,2568076848
497,2198186147,6129,2198192276,10,0,1,2048,10,10163229589
498,2198189914,241018,2198430932,7,0,0,19968,7,4291376642
499,2198197622,3387,2198201009,32,0,1,9728,32,544333721
500,2198224495,510113,2198734608,26,0,0,27648,26,8745885763
501,2198226434,4374,2198230808,0,0,1,4608,0,9052080305
502,2198226501,265329,2198491830,31,0,0,23552,31,8870649422
503,2198232038,504160,2198736198,37,0,0,5120,37,8609549581
504,2198238427,365056,2198603483,15,0,0,7680,15,9303499546
505,2198244777,134944,2198379721,34,0,0,8704,34,9706203865
506,2198251183,614108,2198865291,16,0,0,76288,16,9146450397
507,2198270783,394413,2198665196,34,0,0,110592,34,9228430333
508,2198275733,7286,2198283019,12,0,1,6144,12,237269180
509,2198277412,436664,2198714076,22,0,0,1536,22,1763895407
510,2198293030,9512,2198302542,3,0,1,512,3,5269025035
511,2198297015,283495,2198580510,46,0,0,2048,46,8818630320
512,2198312465,228641,2198541106,41,0,0,44544,41,7678421950
513,2198317106,184096,2198501202,47,0,0,24064,47,9252149131
514,2198321856,487825,2198809681,33,0,0,57856,33,6784319920
515,2198324967,460340,2198785307,37,0,0,9216,37,1519922257
516,2198328514,248348,2198576862,27,0,0,10240,27,813773218
517,2198329844,352901,2198682745,37,0,0,23040,37,4674248216
518,2198334597,4575,2198339172,32,0,1,1536,32,6244276201
519,2198360138,329798,2198689936,30,0,0,23552,30,8099546797
520,2198387095,235325,2198622420,19,0,0,22528,19,3645821308
521,2198407854,223631,2198631485,47,0,0,6144,47,9439657680
522,2198417511,194918,2198612429,10,0,0,4096,10,6484515794
523,2198444386,510729,2198955115,13,0,0,64512,13,1246891561
524,2198454577,219074,2198673651,29,0,0,27648,29,6157163643
525,2198458248,2470,2198460718,36,0,1,2560,36,872139818
526,2198477070,305414,2198782484,38,0,0,60416,38,10573575049
527,2198480767,1042,2198481809,19,0,1,1024,19,7074437832
528,2198493201,298829,2198792030,25,0,0,22016,25,3592733409
529,2198505143,6222,2198511365,29,0,1,2560,29,4378192935
530,2198507629,457493,2198965122,33,0,0,32768,33,9589993122
531,2198508161,13305,2198521466,19,0,1,19456,19,8030035634
532,2198516523,159179,2198675702,26,0,0,6656,26,319392905
533,2198523710,672745,2199196455,24,0,0,25600,24,8391104747
534,2198559675,282357,2198842032,28,0,0,33792,28,6456603837
535,2198570893,422231,2198993124,8,0,0,8192,8,2367281641
536,2198574251,170232,2198744483,36,0,0,11776,36,8503067011
537,2198590512,3904,2198594416,14,0,1,10752,14,9302266729
538,2198592348,390509,2198982857,32,0,0,1536,32,6010379022
539,2198620353,543793,2199164146,34,0,0,5120,34,5496375367
540,2198622945,411729,2199034674,5,0,0,42496,5,6107040138
541,2198624845,802024,2199426869,34,0,0,34816,34,10374420710
542,2198639065,376235,2199015300,21,0,0,20480,21,617661940
543,2198641885,488197,2199130082,13,0,0,10752,13,8547662492
544,2198655548,382417,2199037965,38,0,0,10752,38,8760864075
545,2198658413,962096,2199620509,38,0,0,19456,38,63541227
546,2198674400,347311,2199021711,30,0,0,20992,30,3768738574
547,2198682202,296975,2198979177,11,0,0,46080,11,176196988
548,2198684156,412960,2199097116,17,0,0,11264,17,10061904382
549,2198696786,419103,2199115889,36,0,0,22528,36,4571585588
550,2198709755,399255,2199109010,8,0,0,27136,8,6098667986
551,2198719614,526822,2199246436,32,0,0,52736,32,7318280874
552,2198724200,506145,2199230345,24,0,0,41472,24,7771374839
553,2198724660,9963,2198734623,14,0,1,2560,14,10565225503
554,2198737064,425394,2199162458,10,0,0,36352,10,7512882790
555,2198757698,3645,2198761343,32,0,1,10240,32,2739209399
556,2198773069,550914,2199323983,25,0,0,57856,25,18074121
557,2198779484,34705,2198814189,45,0,1,4608,45,5940626336
558,2198781122,565379,2199346501,36,0,0,4608,36,3381956358
559,2198783363,631464,2199414827,15,0,0,30720,15,7240788296
560,2198785537,256963,2199042500,23,0,0,11776,23,6953913236
561,2198793407,299190,2199092597,40,0,0,19456,40,2399412340
562,2198803948,670971,2199474919,19,0,0,31744,19,8475010015
563,2198806272,922195,2199728467,35,0,0,39936,35,7852636938
564,2198821919,216373,2199038292,22,0,0,1024,22,7277070020
565,2198849038,23951,2198872989,21,0,1,8192,21,7987887678
566,2198877140,112017,2198989157,40,0,0,2048,40,1466292499
567,2198878338,388395,2199266733,33,0,0,3072,33,997389629
568,2198896574,204145,2199100719,32,0,0,11776,32,2621870758
569,2198931656,666513,2199598169,8,0,0,76800,8,1219750387
570,2198936642,281052,2199217694,11,0,0,56320,11,6515148630
571,2198969333,277438,2199246771,15,0,0,1024,15,5185546344
572,2198980825,790163,2199770988,34,0,0,21504,34,6308670417
573,2198990435,921032,2199911467,23,0,0,54272,23,7903245482
574,2199001301,498265,2199499566,6,0,0,41472,6,10526475739
575,2199068971,3898,2199072869,48,0,1,4096,48,905296736
576,2199088354,161100,2199249454,37,0,0,8704,37,8121229431
577,2199096948,838285,2199935233,20,0,0,42496,20,4831387291
578,2199102832,730689,2199833521,13,0,0,30720,13,8852947936
579,2199104410,682479,2199786889,11,0,0,44032,11,8993538750
580,2199113857,5020,2199118877,29,0,1,3072,29,1033365570
581,2199120703,582060,2199702763,11,0,0,61440,11,2316747771
582,2199120754,9343,2199130097,24,0,1,7168,24,540630887
583,2199120788,892165,2200012953,8,0,0,23552,8,6486260986
584,2199136926,566,2199137492,32,0,1,512,32,5710594150
585,2199141883,1001629,2200143512,34,0,0,4096,34,7088808929
586,2199145251,838882,2199984133,8,0,0,38400,8,5271622372
587,2199170752,1414131,2200584883,26,0,0,81408,26,8839755894
588,2199191041,600075,2199791116,43,0,0,13824,43,105402037
589,2199219876,163420,2199383296,13,0,0,6144,13,737344475
590,2199222501,635440,2199857941,47,0,0,30208,47,6189760210
591,2199225351,156058,2199381409,22,0,0,16896,22,3875851905
592,2199228562,408529,2199637091,12,0,0,16896,12,4282094918
593,2199244186,411289,2199655475,40,0,0,6656,40,8350114375
594,2199260020,156226,2199416246,2,0,0,4608,2,7086221409
595,2199267030,5712,2199272742,33,0,1,14336,33,6531757987
596,2199272690,253286,2199525976,15,0,0,37888,15,6225894752
597,2199277105,570,2199277675,24,0,1,512,24,5654671285
598,2199277644,2946,2199280590,23,0,1,3072,23,2082412422
599,2199278826,863407,2200142233,28,0,0,43520,28,2312852178
600,2199301208,229315,2199530523,11,0,0,14848,11,8640373912
601,2199313575,932728,2200246303,10,0,0,91648,10,1489862581
602,2199321260,245484,2199566744,32,0,0,32256,32,1918363944
603,2199324927,522493,2199847420,14,0,0,45568,14,3034276752
604,2199345772,1044430,2200390202,5,0,0,30208,5,3790799614
605,2199357678,897349,2200255027,17,0,0,14336,17,5050922010
606,2199362234,152175,2199514409,6,0,0,48640,6,9202248748
607,2199364117,182519,2199546636,38,0,0,7680,38,5390428460
608,2199368088,1518,2199369606,30,0,1,1536,30,6336167709
609,2199387480,507436,2199894916,1,0,0,39424,1,7211062378
610,2199401698,207966,2199609664,30,0,0,17920,30,1841157002
611,2199420529,8343,2199428872,18,0,1,2048,18,10244822019
612,2199426523,870349,2200296872,43,0,0,66048,43,5234666080
613,2199438687,1155765,2200594452,28,0,0,9216,28,5412488978
614,2199448668,523735,2199972403,29,0,0,61952,29,1548748514
615,2199457001,1074798,2200531799,36,0,0,56320,36,7141635825
616,2199459222,1236523,2200695745,49,0,0,66048,49,6723520512
617,2199468066,880303,2200348369,9,0,0,62464,9,9850253254
618,2199488959,380884,2199869843,24,0,0,12288,24,4929079873
619,2199494283,452056,2199946339,30,0,0,1536,30,8616232330
620,2199500193,33761,2199533954,35,0,1,3584,35,9057534546
621,2199513215,335156,2199848371,12,0,0,3072,12,10323903545
622,2199525508,420348,2199945856,49,0,0,34816,49,10424370555
623,2199538095,5802,2199543897,2,0,1,6144,2,5792586982
624,2199539737,254990,2199794727,46,0,0,11776,46,6844801643
625,2199548744,160257,2199709001,29,0,0,14848,29,4887213386
626,2199555526,476816,2200032342,5,0,0,8192,5,166210851
627,2199561782,360464,2199922246,49,0,0,35328,49,10508301901
628,2199563491,1283652,2200847143,9,0,0,47616,9,9640576233
629,2199565252,166974,2199732226,8,0,0,12288,8,4314750388
630,2199574058,24126,2199598184,24,0,1,10240,24,9467110926
631,2199597380,200638,2199798018,14,0,0,10752,14,6605015711
632,2199603292,347500,2199950792,19,0,0,3072,19,5956511374
633,2199626938,366110,2199993048,20,0,0,29184,20,3539019889
634,2199638712,3645,2199642357,24,0,1,10240,24,9864390957
635,2199645745,304088,2199949833,43,0,0,2048,43,1427182009
636,2199671361,322014,2199993375,49,0,0,1024,49,5498573493
637,2199680083,444430,2200124513,38,0,0,2048,38,3216147400
638,2199685054,23962,2199709016,42,0,1,4096,42,2824377991
639,2199732256,459513,2200191769,29,0,0,12288,29,94913387
640,2199782163,492722,2200274885,19,0,0,18432,19,4965139239
641,2199806461,462785,2200269246,45,0,0,46592,45,2509284543
642,2199810970,138224,2199949194,37,0,0,9216,37,7886182824
643,2199821802,336013,2200157815,16,0,0,17920,16,1480047327
644,2199836854,657702,2200494556,10,0,0,72192,10,9748675661
645,2199838514,181209,2200019723,8,0,0,2048,8,8443706072
646,2199856928,1571,2199858499,44,0,1,512,44,8290648885
647,2199857984,746867,2200604851,35,0,0,15872,35,9202094606
648,2199866897,638469,2200505366,21,0,0,7168,21,7107152942
649,2199875923,202503,2200078426,1,0,0,8192,1,1466095791
650,2199876757,584993,2200461750,5,0,0,90112,5,4070774467
651,2199881892,415775,2200297667,49,0,0,2560,49,3918488601
652,2199899178,106584,2200005762,37,0,0,6656,37,376337207
653,2199899655,51160,2199950815,11,0,1,4096,11,3931428684
654,2199902289,655239,2200557528,19,0,0,37888,19,9973970098
655,2199917642,554895,2200472537,4,0,0,35328,4,2542512109
656,2199926842,507429,2200434271,19,0,0,24576,19,5325465409
657,2199929828,792653,2200722481,21,0,0,48640,21,8979741859
658,2199941892,168179,2200110071,49,0,0,41472,49,1943302530
659,2199946203,26215,2199972418,32,0,1,5632,32,5147015680
660,2199970072,25757,2199995829,8,0,1,2560,8,2448382874
661,2199982981,235383,2200218364,24,0,0,1536,24,1355007944
662,2199994960,1085107,2201080067,33,0,0,72192,33,8406024424
663,2199998257,249317,2200247574,21,0,0,4096,21,7683113807
664,2200000531,217350,2200217881,1,0,0,53760,1,6762728013
665,2200016291,713085,2200729376,3,0,0,22528,3,2728364778
666,2200046501,847046,2200893547,29,0,0,18432,29,2610230010
667,2200052730,450421,2200503151,1,0,0,28160,1,4365859744
668,2200089170,290862,2200380032,4,0,0,29696,4,10461737647
669,2200094049,514405,2200608454,38,0,0,11776,38,10252707118
670,2200117271,263712,2200380983,28,0,0,3072,28,4904552736
671,2200124043,730150,2200854193,21,0,0,7168,21,7015870452
672,2200129248,35622,2200164870,29,0,1,34816,29,1924544166
673,2200135551,379057,2200514608,18,0,0,27136,18,1334821927
674,2200154989,390934,2200545923,31,0,0,28672,31,4745273870
675,2200158290,374616,2200532906,16,0,0,3584,16,10251016909
676,2200177484,454529,2200632013,14,0,0,3072,14,10625387794
677,2200181694,142793,2200324487,21,0,0,9728,21,4977281417
678,2200205659,331505,2200537164,23,0,0,13824,23,5358605528
679,2200226967,430301,2200657268,18,0,0,9728,18,2010362186
680,2200245389,148728,2200394117,10,0,0,12800,10,9664098145
681,2200250962,160575,2200411537,14,0,0,10752,14,8717083567
682,2200264239,33443,2200297682,14,0,1,4096,14,5544414393
683,2200276289,21408,2200297697,3,0,1,7680,3,9661320382
684,2200293938,297691,2200591629,3,0,0,22016,3,6067202239
685,2200297957,880738,2201178695,40,0,0,19968,40,2738917106
686,2200392491,113834,2200506325,13,0,0,3072,13,5000086907
687,2200410871,14687,2200425558,16,0,1,27136,16,2934349621
688,2200430840,398835,2200829675,12,0,0,67072,12,6140622594
689,2200443927,263719,2200707646,32,0,0,38400,32,4233352078
690,2200454624,78313,2200532937,32,0,1,8704,32,9632306052
691,2200472809,73145,2200545954,18,0,1,2560,18,8982321320
692,2200481500,421873,2200903373,5,0,0,20480,5,1282520137
693,2200491773,54196,2200545969,24,0,1,1536,24,3509361366
694,2200492502,369194,2200861696,33,0,0,24576,33,8803707062
695,2200505750,160433,2200666183,13,0,0,29184,13,9323123555
696,2200522725,35804,2200558529,9,0,1,1024,9,1932477440
697,2200528315,56583,2200584898,8,0,1,19456,8,6626488436
698,2200547550,395270,2200942820,40,0,0,5632,40,9380897004
699,2200548276,904051,2201452327,24,0,0,35840,24,5607842556
700,2200572111,25170,2200597281,43,0,1,8704,43,2680482628
701,2200591594,418318,2201009912,42,0,0,53760,42,10540135397
702,2200596836,99095,2200695931,4,0,0,512,4,3844065421
703,2200604797,143240,2200748037,14,0,0,14336,14,6479944838
704,2200609826,923857,2201533683,49,0,0,12800,49,8865386223
705,2200609879,659742,2201269621,6,0,0,13312,6,9140606503
706,2200616931,235063,2200851994,0,0,0,15872,0,5192589130
707,2200626954,637777,2201264731,47,0,0,72704,47,7488059555
708,2200627817,313256,2200941073,41,0,0,57344,41,4672130453
709,2200632512,529468,2201161980,49,0,0,31232,49,6004463944
710,2200655203,40557,2200695760,30,0,1,20992,30,3529711730
711,2200667621,342486,2201010107,14,0,0,512,14,1382731763
712,2200699340,358716,2201058056,26,0,0,12288,26,10010565867
713,2200705372,506955,2201212327,25,0,0,22016,25,6158251824
714,2200736218,355162,2201091380,4,0,0,10752,4,7544462309
715,2200737636,13083,2200750719,34,0,1,22016,34,5028008200
716,2200748956,14804,2200763760,35,0,1,28672,35,10728132395
717,2200771576,183112,2200954688,38,0,0,3072,38,5251701630
718,2200781955,2946,2200784901,13,0,1,3072,13,6396187781
719,2200787669,1132424,2201920093,44,0,0,43008,44,9338286869
720,2200797967,195550,2200993517,43,0,0,1536,43,10037322302
721,2200809008,343433,2201152441,15,0,0,78336,15,9045436405
722,2200810843,181597,2200992440,2,0,0,20992,2,8848308671
723,2200816190,15087,2200831277,33,0,1,1536,33,296287878
724,2200826262,491803,2201318065,5,0,0,39936,5,9837611976
725,2200826428,995607,2201822035,30,0,0,4608,30,6160774649
726,2200828628,45043,2200873671,5,0,0,512,5,5304951989
727,2200866978,305580,2201172558,38,0,0,22016,38,3678951548
728,2200876476,844069,2201720545,33,0,0,20480,33,7014381057
729,2200882864,101297,2200984161,46,0,0,4096,46,4020474833
730,2200884225,138258,2201022483,9,0,0,12800,9,10482220200
731,2200907284,3898,2200911182,2,0,1,4096,2,3223063950
732,2200910916,482743,2201393659,40,0,0,4608,40,1524809751
733,2200921627,424244,2201345871,37,0,0,78848,37,8756503614
734,2200927313,27390,2200954703,34,0,1,19456,34,7629501521
735,2200935672,108355,2201044027,45,0,0,5632,45,6462526254
736,2200940896,153317,2201094213,10,0,0,5120,10,7190113989
737,2200944006,1175214,2202119220,16,0,0,11776,16,5843619063
738,2200960927,244677,2201205604,12,0,0,44032,12,1777896599
739,2200970977,626868,2201597845,36,0,0,4096,36,88940555
740,2200971250,194585,2201165835,45,0,0,7168,45,5513212893
741,2200974530,1275148,2202249678,18,0,0,20480,18,10693731329
742,2200976837,627962,2201604799,16,0,0,9728,16,7829062679
743,2200981826,585395,2201567221,17,0,0,28672,17,1890462723
744,2200997986,164657,2201162643,43,0,0,2048,43,9537339820
745,2201002695,507801,2201510496,11,0,0,32768,11,6246397961
746,2201006539,207067,2201213606,1,0,0,4096,1,7110103398
747,2201012553,263947,2201276500,46,0,0,22528,46,6418972618
748,2201019110,468511,2201487621,26,0,0,115200,26,4044479327
749,2201027540,238002,2201265542,9,0,0,2560,9,6688532100
750,2201034403,353298,2201387701,23,0,0,16896,23,967642207
751,2201045085,4679,2201049764,41,0,1,12288,41,8310653191
752,2201056892,434028,2201490920,40,0,0,10752,40,6664099663
753,2201069624,598130,2201667754,4,0,0,51712,4,6668649682
754,2201077277,447149,2201524426,47,0,0,41472,47,331982882
755,2201078276,549347,2201627623,12,0,0,8704,12,9355510329
756,2201097981,223851,2201321832,25,0,0,12288,25,2036174479
757,2201098701,4374,2201103075,20,0,1,4608,20,4342027904
758,2201103289,1994,2201105283,14,0,1,2048,14,10466626830
759,2201138996,33585,2201172581,8,0,1,4608,8,2521310608
760,2201149521,23075,2201172596,12,0,1,512,12,6561964201
761,2201150540,663024,2201813564,21,0,0,5632,21,7554406175
762,2201166302,198658,2201364960,47,0,0,29184,47,6864089699
763,2201177915,601058,2201778973,28,0,0,45568,28,5894411718
764,2201179922,3904,2201183826,26,0,1,10752,26,7053288597
765,2201180258,7685,2201187943,0,0,1,12288,0,3785920786
766,2201181130,515495,2201696625,24,0,0,27136,24,1572496448
767,2201186902,4067,2201190969,43,0,1,10752,43,2020888296
768,2201187187,409387,2201596574,38,0,0,31744,38,6512827297
769,2201189040,310179,2201499219,33,0,0,27136,33,7352048265
770,2201194931,240100,2201435031,4,0,0,19968,4,3700711884
771,2201203833,14177,2201218010,12,0,1,11776,12,999842977
772,2201207065,14275,2201221340,41,0,1,11264,41,5844920567
773,2201220044,628691,2201848735,3,0,0,31744,3,9359361993
774,2201244395,208111,2201452506,18,0,0,512,18,1790820239
775,2201245586,452786,2201698372,37,0,0,5632,37,1364247132
776,2201249924,561878,2201811802,24,0,0,6656,24,7739346204
777,2201274933,225564,2201500497,45,0,0,1536,45,8543926709
778,2201275238,534521,2201809759,31,0,0,56320,31,1231309070
779,2201289179,236362,2201525541,27,0,0,3584,27,9829672866
780,2201295366,216393,2201511759,16,0,0,4096,16,6635614868
781,2201307515,233254,2201540769,45,0,0,4608,45,4292204989
782,2201317343,707854,2202025197,49,0,0,13312,49,1497463190
783,2201347176,696444,2202043620,18,0,0,60416,18,9413659988
784,2201356416,664710,2202021126,16,0,0,13312,16,7641935633
785,2201360498,462176,2201822674,26,0,0,2048,26,2983526990
786,2201363302,506066,2201869368,21,0,0,25088,21,8552844141
787,2201370604,705041,2202075645,19,0,0,16384,19,7912930338
788,2201373373,126641,2201500014,1,0,0,2560,1,5067669185
789,2201379018,289071,2201668089,36,0,0,1024,36,8029666496
790,2201389858,249863,2201639721,27,0,0,11776,27,2355364719
791,2201410153,119615,2201529768,3,0,0,13824,3,712691389
792,2201413119,268647,2201681766,2,0,0,18432,2,5020388311
793,2201430565,221418,2201651983,2,0,0,28160,2,4431898930
794,2201439359,669154,2202108513,38,0,0,23040,38,8049637426
795,2201441718,910878,2202352596,3,0,0,74752,3,6658307595
796,2201444637,89061,2201533698,37,0,1,8704,37,9446477008
797,2201452286,340290,2201792576,17,0,0,44544,17,6187888512
798,2201456142,685389,2202141531,36,0,0,7168,36,3676461323
799,2201479891,258422,2201738313,19,0,0,25600,19,9091446662
800,2201498059,452459,2201950518,29,0,0,28160,29,4582409549
801,2201528003,967807,2202495810,19,0,0,79872,19,6206749039
802,2201537418,29818,2201567236,14,0,1,40448,14,3254030728
803,2201543357,1025645,2202569002,3,0,0,53760,3,6454171037
804,2201545972,587159,2202133131,10,0,0,17408,10,5071681321
805,2201550225,339430,2201889655,30,0,0,45056,30,6464727997
806,2201554963,881801,2202436764,34,0,0,43520,34,5096683476
807,2201587462,265032,2201852494,46,0,0,12288,46,7025107888
808,2201610034,2470,2201612504,12,0,1,2560,12,887395
809,2201611627,308949,2201920576,49,0,0,1536,49,9357549252
810,2201616107,214695,2201830802,22,0,0,512,22,5778790435
811,2201659440,357615,2202017055,10,0,0,41984,10,2153836581
812,2201674191,427271,2202101462,10,0,0,54784,10,7796022492
813,2201674525,1042,2201675567,20,0,1,1024,20,4625925734
814,2201676746,277765,2201954511,22,0,0,3072,22,9803554381
815,2201686638,1018969,2202705607,44,0,0,1536,44,3858650132
816,2201692384,493004,2202185388,26,0,0,9216,26,5920798851
817,2201692703,446629,2202139332,47,0,0,12288,47,8927569380
818,2201713661,925195,2202638856,49,0,0,1536,49,537983749
819,2201733125,526100,2202259225,41,0,0,31232,41,2365619075
820,2201737398,482378,2202219776,40,0,0,23552,40,1580417067
821,2201744770,451640,2202196410,21,0,0,22016,21,2346453737
822,2201762195,534694,2202296889,38,0,0,79872,38,9849268502
823,2201765909,1074501,2202840410,24,0,0,1536,24,5410209439
824,2201770584,41233,2201811817,0,0,1,1024,0,9205088490
825,2201794228,156773,2201951001,12,0,0,1536,12,4973331195
826,2201808603,434820,2202243423,41,0,0,13824,41,6896729309
827,2201814669,852783,2202667452,24,0,0,24064,24,7020204956
828,2201820043,833769,2202653812,2,0,0,36864,2,333678887
829,2201824071,335812,2202159883,38,0,0,26112,38,5219504807
830,2201833447,3645,2201837092,15,0,1,10240,15,9551048434
831,2201847553,11687,2201859240,2,0,1,7168,2,8696090050
832,2201852796,947588,2202800384,16,0,0,15360,16,939858670
833,2201865256,244840,2202110096,27,0,0,5120,27,2408443720
834,2201866573,189524,2202056097,6,0,0,7680,6,2523278164
835,2201878603,957289,2202835892,11,0,0,93696,11,836924589
836,2201882498,670101,2202552599,32,0,0,33792,32,7255550072
837,2201885542,349263,2202234805,6,0,0,44032,6,10589065852
838,2201886800,954834,2202841634,3,0,0,512,3,2673858236
839,2201890464,416790,2202307254,32,0,0,25088,32,1480999107
840,2201892869,649411,2202542280,24,0,0,24576,24,1168069124
841,2201902446,4374,2201906820,24,0,1,4608,24,10731223823
842,2201916755,346713,2202263468,21,0,0,13824,21,7213710759
843,2201926946,3422,2201930368,35,0,1,3584,35,4546897411
844,2201938962,124947,2202063909,38,0,0,3072,38,3130672456
845,2201982321,390803,2202373124,6,0,0,20480,6,9593479991
846,2202031653,207535,2202239188,32,0,0,14336,32,3391721532
847,2202045719,122671,2202168390,49,0,0,12800,49,2599362915
848,2202046677,1002668,2203049345,46,0,0,139776,46,6906214062
849,2202055717,6650,2202062367,0,0,1,6656,0,5451529304
850,2202066945,531742,2202598687,19,0,0,69120,19,5921250374
851,2202070438,390904,2202461342,16,0,0,2048,16,1627914922
852,2202095807,348616,2202444423,7,0,0,25088,7,7595232674
853,2202096511,349978,2202446489,25,0,0,2048,25,1394668483
854,2202101226,19845,2202121071,41,0,1,17920,41,8994868337
855,2202122058,177521,2202299579,37,0,0,8704,37,2310415330
856,2202127267,14279,2202141546,13,0,1,17408,13,866785578
857,2202138618,367418,2202506036,18,0,0,2560,18,4492075746
858,2202152307,793552,2202945859,5,0,0,112640,5,6790200246
859,2202161178,446900,2202608078,12,0,0,30720,12,2125970747
860,2202183376,428818,2202612194,16,0,0,4608,16,4988283998
861,2202187609,782343,2202969952,34,0,0,4096,34,4039709605
862,2202195840,2080,2202197920,15,0,1,1536,15,8977241508
863,2202198536,410961,2202609497,16,0,0,4608,16,8230166144
864,2202200088,377524,2202577612,4,0,0,28160,4,2557226802
865,2202204537,649858,2202854395,41,0,0,10240,41,4099323722
866,2202226182,769712,2202995894,3,0,0,82944,3,2196984698
867,2202232880,402928,2202635808,32,0,0,6656,32,2617068313
868,2202233507,212343,2202445850,7,0,0,4608,7,3720285353
869,2202246339,663371,2202909710,44,0,0,17408,44,9090515290
870,2202250094,17732,2202267826,18,0,1,4608,18,404110804
871,2202258682,645055,2202903737,23,0,0,35840,23,9816541818
872,2202264430,423840,2202688270,6,0,0,7680,6,2757411914
873,2202267999,28905,2202296904,48,0,1,6656,48,6411646879
874,2202270850,339925,2202610775,9,0,0,3072,9,3868570908
875,2202274340,915194,2203189534,49,0,0,59904,49,1214463086
876,2202284753,27786,2202312539,2,0,1,5632,2,6194975424
877,2202285615,28870,2202314485,3,0,1,3072,3,8245489534
878,2202316162,293662,2202609824,38,0,0,1024,38,4603387679
879,2202325926,179283,2202505209,26,0,0,30720,26,348474219
880,2202355849,728970,2203084819,2,0,0,50688,2,7531920823
881,2202362291,1042,2202363333,11,0,1,1024,11,10220956519
882,2202377963,4679,2202382642,19,0,1,12288,19,71600215
883,2202403587,816452,2203220039,34,0,0,25088,34,9330041969
884,2202409280,265403,2202674683,41,0,0,8192,41,969237729
885,2202422782,1044451,2203467233,45,0,0,51200,45,6320396209
886,2202430553,638719,2203069272,28,0,0,11264,28,4307033200
887,2202436259,223846,2202660105,3,0,0,14848,3,2227657231
888,2202438452,10524,2202448976,29,0,1,2560,29,556172900
889,2202467935,313242,2202781177,2,0,0,26624,2,2375037697
890,2202477671,318018,2202795689,25,0,0,36352,25,4582177143
891,2202483235,24828,2202508063,2,0,1,8704,2,640662720
892,2202493299,717958,2203211257,16,0,0,71168,16,3088762892
893,2202495676,73341,2202569017,42,0,1,74752,42,3825402761
894,2202496324,379887,2202876211,10,0,0,11264,10,3530734646
895,2202496575,1084442,2203581017,31,0,0,78848,31,1456309398
896,2202510955,144588,2202655543,21,0,0,5632,21,1791015793
897,2202538582,524568,2203063150,13,0,0,20480,13,4026747690
898,2202545207,293508,2202838715,9,0,0,9216,9,9986828569
899,2202572215,396474,2202968689,28,0,0,74752,28,25912783
900,2202574027,476425,2203050452,24,0,0,3584,24,8151765945
901,2202608571,398155,2203006726,18,0,0,3072,18,824372831
902,2202628982,341609,2202970591,49,0,0,2048,49,8772317398
903,2202633873,21685,2202655558,7,0,1,16384,7,6190917571
904,2202638749,448479,2203087228,29,0,0,7680,29,10678917325
905,2202647080,1055521,2203702601,21,0,0,16896,21,4728068757
906,2202665583,391304,2203056887,26,0,0,20992,26,10212876811
907,2202666966,1545,2202668511,2,0,1,1024,2,8394597147
908,2202678921,3128,2202682049,46,0,1,9216,46,10673437652
909,2202721405,449862,2203171267,9,0,0,58368,9,9817244077
910,2202725078,279567,2203004645,1,0,0,28672,1,5435990879
911,2202725179,179197,2202904376,29,0,0,2048,29,1851393270
912,2202732072,333745,2203065817,20,0,0,8704,20,946796824
913,2202737169,373402,2203110571,15,0,0,20480,15,5691803363
914,2202756381,455999,2203212380,47,0,0,3584,47,7669193408
915,2202775096,471162,2203246258,21,0,0,18944,21,5936054696
916,2202782818,510164,2203292982,45,0,0,17408,45,9529300735
917,2202782937,1074478,2203857415,41,0,0,17408,41,3674034576
918,2202791598,345729,2203137327,35,0,0,13824,35,883965661
919,2202821105,21041,2202842146,27,0,1,3584,27,6177531
920,2202826539,584745,2203411284,33,0,0,16384,33,1674874905
921,2202843093,13512,2202856605,34,0,1,26112,34,5920519334
922,2202844648,161127,2203005775,42,0,0,3584,42,4438357582
923,2202871723,4503,2202876226,21,0,1,4096,21,3451743103
924,2202891825,12566,2202904391,24,0,1,3584,24,9896589573
925,2202896877,504123,2203401000,22,0,0,17920,22,1059172104
926,2202904423,41467,2202945890,30,0,1,6144,30,10665316354
927,2202912899,91761,2203004660,0,0,1,4096,0,6730697158
928,2202913945,569059,2203483004,38,0,0,51712,38,1531166975
929,2202916844,498292,2203415136,41,0,0,7168,41,545477956
930,2202947525,414709,2203362234,37,0,0,78336,37,8653526253
931,2202976258,277560,2203253818,25,0,0,6144,25,7648334315
932,2202984418,394075,2203378493,26,0,0,9728,26,1221043426
933,2202984688,135213,2203119901,26,0,0,4608,26,6452887883
934,2202998320,963234,2203961554,11,0,0,30720,11,6264623977
935,2203000260,84598,2203084858,8,0,1,6144,8,6291262863
936,2203005289,79584,2203084873,31,0,1,5632,31,8466800384
937,2203006584,80659,2203087243,2,0,1,8192,2,2910269546
938,2203025359,1025266,2204050625,9,0,0,112640,9,1319112735
939,2203027846,255304,2203283150,7,0,0,17408,7,6248508806
940,2203029905,381862,2203411767,36,0,0,1536,36,5328208656
941,2203030803,523257,2203554060,28,0,0,18944,28,4795204887
942,2203035516,51742,2203087258,32,0,1,1024,32,8210819023
943,2203050653,46745,2203097398,11,0,1,20480,11,10476468759
944,2203055116,44548,2203099664,17,0,1,3584,17,25718814
945,2203056687,274719,2203331406,35,0,0,4096,35,4236251863
946,2203060823,535468,2203596291,31,0,0,24576,31,4709299479
947,2203093109,191148,2203284257,14,0,0,3584,14,8490630963
948,2203100209,229926,2203330135,7,0,0,38912,7,10529568928
949,2203117735,490262,2203607997,13,0,0,8704,13,8838600286
950,2203118964,332654,2203451618,12,0,0,28672,12,4076517718
951,2203134351,389115,2203523466,32,0,0,20480,32,2339719660
952,2203140597,684099,2203824696,20,0,0,71168,20,5547707649
953,2203157574,62488,2203220062,3,0,1,9728,3,2669544155
954,2203159232,500974,2203660206,14,0,0,78848,14,2079279273
955,2203180794,39283,2203220077,0,0,1,512,0,5363411206
956,2203212258,14535,2203226793,48,0,1,7168,48,6205606537
957,2203243962,340393,2203584355,32,0,0,3584,32,8324870424
958,2203244748,501208,2203745956,13,0,0,115712,13,6733049844
959,2203247395,14804,2203262199,30,0,1,28672,30,8825755558
960,2203249219,441959,2203691178,36,0,0,5120,36,1924371323
961,2203281405,423395,2203704800,15,0,0,7168,15,7125207890
962,2203310850,378753,2203689603,14,0,0,43520,14,549212774
963,2203315775,819745,2204135520,1,0,0,72704,1,2660999066
964,2203322439,678603,2204001042,48,0,0,30720,48,3715701228
965,2203340249,511512,2203851761,16,0,0,32256,16,4475836447
966,2203344149,254988,2203599137,3,0,0,1536,3,2600565318
967,2203355136,314827,2203669963,20,0,0,4608,20,10656847327
968,2203358307,230481,2203588788,33,0,0,10240,33,881455961
969,2203358719,584857,2203943576,44,0,0,9216,44,3679210951
970,2203360736,8845,2203369581,10,0,1,7680,10,8806598966
971,2203366901,231745,2203598646,29,0,0,7680,29,7875459461
972,2203369833,293204,2203663037,14,0,0,9216,14,2713461687
973,2203387921,479976,2203867897,25,0,0,34304,25,6171367167
974,2203389034,194206,2203583240,46,0,0,7168,46,10441965375
975,2203398522,443209,2203841731,6,0,0,55808,6,5333422192
976,2203402921,477339,2203880260,38,0,0,14848,38,8550596896
977,2203426258,811655,2204237913,45,0,0,12288,45,7169823754
978,2203439989,334268,2203774257,18,0,0,7680,18,10039009358
979,2203460969,207567,2203668536,12,0,0,17920,12,2984854226
980,2203463324,20305,2203483629,2,0,1,512,2,8001689022
981,2203471179,283202,2203754381,32,0,0,7680,32,5871300798
982,2203477771,313268,2203791039,25,0,0,30720,25,5751448918
983,2203487571,527541,2204015112,29,0,0,41984,29,4443502585
984,2203489441,3898,2203493339,11,0,1,4096,11,3735440170
985,2203497754,1518,2203499272,8,0,1,1536,8,1034327711
986,2203499528,5802,2203505330,15,0,1,6144,15,3054963648
987,2203519335,413035,2203932370,20,0,0,10752,20,2589345586
988,2203568909,122440,2203691349,33,0,0,512,33,5147711361
989,2203569255,382916,2203952171,34,0,0,28160,34,1127673843
990,2203571810,430495,2204002305,37,0,0,4096,37,2033489367
991,2203576137,507013,2204083150,35,0,0,22016,35,1972086268
992,2203578314,263588,2203841902,32,0,0,512,32,2274397554
993,2203593789,335290,2203929079,5,0,0,8704,5,8960641439
994,2203598855,298029,2203896884,35,0,0,16384,35,7382142189
995,2203610711,192286,2203802997,41,0,0,11264,41,5018899308
996,2203619469,537647,2204157116,49,0,0,512,49,10334347015
997,2203625201,226895,2203852096,8,0,0,1024,8,2863121705
998,2203626266,5196,2203631462,19,0,1,13312,19,1598195135
999,2203637539,288865,2203926404,20,0,0,48640,20,492243873
1000,2203640824,251053,2203891877,32,0,0,12288,32,3895317642
1001,2203641643,614947,2204256590,18,0,0,6656,18,2427635465
1002,2203654009,282908,2203936917,18,0,0,14848,18,539375975
1003,2203663500,547881,2204211381,39,0,0,20992,39,6450517750
1004,2203708678,1994,2203710672,19,0,1,2048,19,4104563800
1005,2203711491,442467,2204153958,37,0,0,22528,37,359591080
1006,2203713547,36913,2203750460,32,0,1,11776,32,8156374696
1007,2203733126,247229,2203980355,7,0,0,12800,7,8708934733
1008,2203734044,17082,2203751126,3,0,1,1024,3,4143503164
1009,2203745031,649020,2204394051,9,0,0,54784,9,9015015682
1010,2203771994,404586,2204176580,10,0,0,23552,10,6408342839
1011,2203782221,16040,2203798261,0,0,1,7680,0,2701531742
1012,2203803590,53840,2203857430,2,0,1,5120,2,7516923178
1013,2203812493,55419,2203867912,12,0,1,4096,12,5896785591
1014,2203829851,223917,2204053768,12,0,0,10240,12,2344399981
1015,2203862634,12500,2203875134,12,0,1,7680,12,499381548
1016,2203894884,5890,2203900774,32,0,1,4096,32,4967963822
1017,2203906322,263067,2204169389,2,0,0,6144,2,2188737961
1018,2203911747,235332,2204147079,37,0,0,37888,37,4974393893
1019,2203916762,44807,2203961569,7,0,1,24064,7,6237490722
1020,2203926944,256434,2204183378,29,0,0,4096,29,3422556501
1021,2203936849,220096,2204156945,39,0,0,9728,39,405606776
1022,2203937047,162712,2204099759,12,0,0,35840,12,7086670473
1023,2203967487,372900,2204340387,30,0,0,9728,30,3833885954
1024,2203969699,566,2203970265,14,0,1,512,14,1423908830
1025,2203979540,243288,2204222828,1,0,0,7168,1,3374151210
1026,2203983690,104376,2204088066,11,0,0,1536,11,4462016234
1027,2204036789,22392,2204059181,14,0,1,13824,14,1138578669
1028,2204062639,566,2204063205,0,0,1,512,0,5958746083
1029,2204068320,14853,2204083173,33,0,1,27648,33,877004857
1030,2204070638,183909,2204254547,36,0,0,12288,36,10266986117
1031,2204091981,149846,2204241827,22,0,0,11776,22,4831871442
1032,2204098037,3257,2204101294,41,0,1,1536,41,6716916541
1033,2204101860,174942,2204276802,39,0,0,40960,39,584424052
1034,2204106299,219825,2204326124,45,0,0,23552,45,10039658467
1035,2204112079,206854,2204318933,34,0,0,36864,34,10418641064
1036,2204132872,313685,2204446557,44,0,0,9216,44,726626571
1037,2204148109,15319,2204163428,31,0,1,6656,31,8462837472
1038,2204148887,130170,2204279057,30,0,0,7168,30,5067981633
1039,2204154715,247159,2204401874,20,0,0,25600,20,10650004803
1040,2204166303,195860,2204362163,22,0,0,11264,22,7582783946
1041,2204212495,82150,2204294645,15,0,0,6656,15,9421728909
1042,2204215834,111873,2204327707,16,0,0,5120,16,1801207536
1043,2204246383,41391,2204287774,4,0,1,67072,4,7445992517
1044,2204247083,41767,2204288850,33,0,1,13312,33,3704968575
1045,2204248118,255063,2204503181,29,0,0,14336,29,5128821565
1046,2204248308,250490,2204498798,29,0,0,18944,29,2560600598
1047,2204262931,26278,2204289209,43,0,1,9728,43,7615700486
1048,2204265596,169101,2204434697,10,0,0,11264,10,6894044634
1049,2204269305,254000,2204523305,15,0,0,25600,15,7516455081
1050,2204270265,313887,2204584152,30,0,0,12800,30,9015200783
1051,2204279810,137851,2204417661,10,0,0,5120,10,9698742290
1052,2204289554,222922,2204512476,29,0,0,19456,29,9831899858
1053,2204290773,3887,2204294660,21,0,1,9216,21,10284315673
1054,2204295734,173265,2204468999,47,0,0,14848,47,8580273317
1055,2204301230,145506,2204446736,44,0,0,512,44,1319893620
1056,2204317211,295914,2204613125,22,0,0,17920,22,1424396441
1057,2204321279,253050,2204574329,6,0,0,31744,6,6341550463
1058,2204321401,592808,2204914209,30,0,0,2560,30,9295510937
1059,2204326959,166052,2204493011,30,0,0,25088,30,10267114187
1060,2204352716,223500,2204576216,5,0,0,6144,5,1224972938
1061,2204353260,409470,2204762730,19,0,0,71168,19,5911718655
1062,2204363109,12566,2204375675,0,0,1,20992,0,1887820369
1063,2204372419,467063,2204839482,2,0,0,113664,2,1744315537
1064,2204373579,656258,2205029837,23,0,0,151040,23,842881277
1065,2204374211,366804,2204741015,3,0,0,2048,3,7525347853
1066,2204384663,268026,2204652689,34,0,0,4608,34,7563036273
1067,2204405668,334700,2204740368,40,0,0,46592,40,6975266002
1068,2204436267,426405,2204862672,47,0,0,7168,47,7920103701
1069,2204444657,148074,2204592731,28,0,0,512,28,4134418785
1070,2204446633,661,2204447294,0,0,1,512,0,1245718918
1071,2204447908,4420,2204452328,8,0,1,11776,8,6487914846
1072,2204467141,452551,2204919692,6,0,0,17920,6,3114563193
1073,2204501331,346917,2204848248,38,0,0,14848,38,294505197
1074,2204517123,170276,2204687399,3,0,0,28672,3,8983872397
1075,2204519007,6785,2204525792,46,0,1,2560,46,4123149922
1076,2204527394,553540,2205080934,25,0,0,39424,25,9986423425
1077,2204528191,315518,2204843709,47,0,0,13824,47,611533389
1078,2204531209,382197,2204913406,21,0,0,78848,21,1273635635
1079,2204558107,393741,2204951848,23,0,0,52224,23,5327495562
1080,2204558900,114591,2204673491,4,0,1,186368,4,5091392043
1081,2204559378,290442,2204849820,17,0,0,3072,17,4344644378
1082,2204578026,374944,2204952970,41,0,0,3584,41,2667942637
1083,2204580445,469295,2205049740,13,0,0,12800,13,2435557265
1084,2204586627,89450,2204676077,15,0,1,4096,15,6030022638
1085,2204604634,72314,2204676948,17,0,1,12288,17,6527354053
1086,2204607357,482016,2205089373,25,0,0,27648,25,3097819150
1087,2204610578,76836,2204687414,38,0,1,3584,38,2326846496
1088,2204620823,66606,2204687429,29,0,1,4096,29,3934059848
1089,2204625716,61728,2204687444,11,0,1,512,11,4006843252
1090,2204625965,309948,2204935913,23,0,0,10240,23,2157240805
1091,2204626413,405490,2205031903,5,0,0,6656,5,7391719161
1092,2204628369,302602,2204930971,21,0,0,11776,21,505067601
1093,2204633825,435082,2205068907,24,0,0,22016,24,1761375029
1094,2204635844,419713,2205055557,11,0,0,7680,11,10151820753
1095,2204671915,15552,2204687467,10,0,1,7680,10,3014662758
1096,2204684123,497329,2205181452,42,0,0,119808,42,4282775225
1097,2204700392,151876,2204852268,23,0,0,1024,23,9315032620
1098,2204703619,407562,2205111181,22,0,0,12288,22,6846545963
1099,2204716130,496954,2205213084,27,0,0,4608,27,9301488811
1100,2204725036,473020,2205198056,5,0,0,4608,5,8039997514
1101,2204726295,326907,2205053202,32,0,0,10752,32,9889144848
1102,2204733856,307118,2205040974,24,0,0,29696,24,7651087792
1103,2204736857,325327,2205062184,25,0,0,7168,25,5546602522
1104,2204744176,301649,2205045825,42,0,0,15872,42,8558708276
1105,2204764907,332558,2205097465,2,0,0,2560,2,3632541015
1106,2204785475,264436,2205049911,16,0,0,512,16,4784949659
1107,2204787665,408972,2205196637,23,0,0,18432,23,9787228851
1108,2204838554,276334,2205114888,25,0,0,1024,25,2130750928
1109,2204845929,345077,2205191006,22,0,0,5120,22,6800986295
1110,2204866092,14117,2204880209,10,0,1,24064,10,1449431528
1111,2204874452,469483,2205343935,25,0,0,7680,25,8534630509
1112,2204889209,300214,2205189423,47,0,0,26112,47,413537787
1113,2204891076,33512,2204924588,11,0,1,12800,11,4179246655
1114,2204907225,348589,2205255814,42,0,0,50176,42,9364760085
1115,2204924163,610444,2205534607,43,0,0,92672,43,10696617201
1116,2204928939,22924,2204951863,20,0,1,6144,20,9956950461
1117,2204932234,325802,2205258036,46,0,0,7168,46,5938597345
1118,2204975211,54641,2205029852,34,0,1,20480,34,5973385650
1119,2204980014,804250,2205784264,33,0,0,17408,33,6499930450
1120,2204988332,839604,2205827936,23,0,0,9728,23,6985763618
1121,2204993898,584791,2205578689,18,0,0,58880,18,2474262730
1122,2205046356,852234,2205898590,24,0,0,41984,24,3434469614
1123,2205049986,246244,2205296230,15,0,0,21504,15,8058432306
1124,2205051429,179775,2205231204,32,0,0,26112,32,608186212
1125,2205051572,527756,2205579328,7,0,0,2048,7,3557642007
1126,2205055779,542916,2205598695,16,0,0,63488,16,4938997266
1127,2205057647,206020,2205263667,24,0,0,18432,24,9530088869
1128,2205072529,125566,2205198095,4,0,1,149504,4,1212627596
1129,2205093219,104891,2205198110,34,0,1,3072,34,4003074700
1130,2205108750,373532,2205482282,49,0,0,10240,49,119636932
1131,2205123125,478245,2205601370,11,0,0,8704,11,4703967687
1132,2205123701,217879,2205341580,44,0,0,12288,44,1048389274
1133,2205140626,316913,2205457539,35,0,0,68096,35,6952840088
1134,2205152988,528538,2205681526,28,0,0,19456,28,922128508
1135,2205173902,332454,2205506356,35,0,0,56320,35,3368155673
1136,2205178401,567868,2205746269,30,0,0,11776,30,3434802432
1137,2205178419,359651,2205538070,41,0,0,11264,41,10444962195
1138,2205220960,635448,2205856408,19,0,0,62976,19,6777954125
1139,2205237109,18720,2205255829,48,0,1,6144,48,7045439660
1140,2205244889,363984,2205608873,23,0,0,24576,23,47391034
1141,2205253599,370392,2205623991,33,0,0,7168,33,10451384866
1142,2205255104,11967,2205267071,14,0,1,9728,14,10375001443
1143,2205264406,411177,2205675583,28,0,0,12800,28,5037682171
1144,2205282763,728777,2206011540,45,0,0,10752,45,1678655038
1145,2205284642,397523,2205682165,13,0,0,2048,13,8703486467
1146,2205291907,581436,2205873343,30,0,0,14336,30,3474665701
1147,2205304159,632062,2205936221,36,0,0,34304,36,3185483396
1148,2205305120,345319,2205650439,47,0,0,66560,47,4969741994
1149,2205325732,4420,2205330152,0,0,1,11776,0,10316169302
1150,2205348438,430475,2205778913,17,0,0,41472,17,8742701873
1151,2205358560,550505,2205909065,23,0,0,34304,23,8759431592
1152,2205378969,11791,2205390760,11,0,1,19456,11,2469175717
1153,2205387760,443022,2205830782,21,0,0,8704,21,3484082906
1154,2205392235,374027,2205766262,19,0,0,14336,19,5821901010
1155,2205392318,584071,2205976389,17,0,0,43008,17,5738441139
1156,2205393880,320805,2205714685,39,0,0,24064,39,1630506778
1157,2205405784,551535,2205957319,28,0,0,55808,28,3124031470
1158,2205408889,570978,2205979867,21,0,0,8704,21,7052441393
1159,2205417581,10499,2205428080,37,0,1,16896,37,4744150080
1160,2205418881,9353,2205428234,46,0,1,8704,46,7796224217
1161,2205420454,542816,2205963270,1,0,0,19456,1,6348944235
1162,2205433609,636426,2206070035,45,0,0,17408,45,2117631231
1163,2205450056,356441,2205806497,4,0,0,48128,4,6947519446
1164,2205464557,5326,2205469883,24,0,1,5632,24,2277567144
1165,2205465659,75556,2205541215,40,0,0,2048,40,9695837572
1166,2205469773,394458,2205864231,1,0,0,25600,1,5643938805
1167,2205473109,2470,2205475579,46,0,1,2560,46,1175954030
1168,2205479642,5578,2205485220,8,0,1,3072,8,8538959023
1169,2205502078,365320,2205867398,11,0,0,10240,11,1167406758
1170,2205507454,317503,2205824957,18,0,0,40448,18,1870551198
1171,2205526491,472800,2205999291,19,0,0,12800,19,10559899132
1172,2205531107,11830,2205542937,29,0,1,5120,29,3137319272
1173,2205540560,5940,2205546500,8,0,1,5632,8,343786634
1174,2205553379,98323,2205651702,27,0,0,4096,27,4357205135
1175,2205567674,512999,2206080673,21,0,0,9728,21,10646475542
1176,2205574845,38411,2205613256,17,0,1,4608,17,3686217944
1177,2205587110,569329,2206156439,30,0,0,2048,30,10573923622
1178,2205591033,521679,2206112712,12,0,0,20480,12,6201518891
1179,2205605626,222481,2205828107,6,0,0,512,6,7529973836
1180,2205612939,12825,2205625764,21,0,1,21504,21,5659706540
1181,2205656443,320749,2205977192,8,0,0,2560,8,1331656634
1182,2205659758,440060,2206099818,31,0,0,27136,31,4964692055
1183,2205661776,330777,2205992553,32,0,0,31232,32,3550903907
1184,2205667659,14521,2205682180,45,0,1,22016,45,4845467687
1185,2205708764,12191,2205720955,30,0,1,6656,30,710771757
1186,2205724944,215348,2205940292,11,0,0,13312,11,7368822589
1187,2205729855,265521,2205995376,3,0,0,9216,3,4058441330
1188,2205732053,14231,2205746284,3,0,1,19968,3,9407398251
1189,2205756151,517977,2206274128,40,0,0,3072,40,4794519368
1190,2205763119,314575,2206077694,11,0,0,25088,11,1200745794
1191,2205764516,446347,2206210863,3,0,0,66048,3,5823542170
1192,2205772642,610357,2206382999,3,0,0,47616,3,9141979099
1193,2205774736,266515,2206041251,21,0,0,9728,21,6996742754
1194,2205777351,353702,2206131053,16,0,0,1024,16,846029277
1195,2205781990,6987,2205788977,18,0,1,12288,18,9597916504
1196,2205783683,369762,2206153445,29,0,0,49152,29,1613286237
1197,2205788599,482832,2206271431,13,0,0,40960,13,3473856509
1198,2205811317,516565,2206327882,41,0,0,27648,41,220877788
1199,2205816796,551672,2206368468,11,0,0,38400,11,2837040711
1200,2205838643,440730,2206279373,38,0,0,6656,38,6848944315
1201,2205842326,502885,2206345211,27,0,0,19968,27,2316655090
1202,2205845860,804031,2206649891,37,0,0,24576,37,9133133785
1203,2205847695,25663,2205873358,24,0,1,5120,24,4957818290
1204,2205849147,541174,2206390321,10,0,0,3072,10,1524456609
1205,2205851657,21716,2205873373,21,0,1,1536,21,10366441703
1206,2205856905,298895,2206155800,39,0,0,7680,39,2596941133
1207,2205865869,616391,2206482260,25,0,0,12800,25,7398607043
1208,2205877817,204743,2206082560,38,0,0,6144,38,169426614
1209,2205878780,440663,2206319443,23,0,0,92672,23,9081677897
1210,2205878834,690905,2206569739,29,0,0,29696,29,10232801037
1211,2205880677,560896,2206441573,18,0,0,23552,18,9508337104
1212,2205884748,304764,2206189512,24,0,0,17920,24,1313442360
1213,2205886074,1060258,2206946332,12,0,0,5632,12,4388189679
1214,2205891095,1014516,2206905611,28,0,0,201216,28,9009396649
1215,2205902550,522191,2206424741,18,0,0,60928,18,1562960665
1216,2205917091,508633,2206425724,30,0,0,3072,30,8951817370
1217,2205922674,690201,2206612875,1,0,0,34816,1,7922751307
1218,2205925081,481081,2206406162,49,0,0,6144,49,4463139786
1219,2205936752,528941,2206465693,35,0,0,11264,35,7280769966
1220,2205942093,395714,2206337807,31,0,0,9728,31,8961706840
1221,2205954784,25608,2205980392,39,0,1,512,39,6535161824
1222,2205961840,490273,2206452113,8,0,0,11776,8,3530424799
1223,2205977024,295358,2206272382,14,0,0,3072,14,3692263631
1224,2205980788,565152,2206545940,26,0,0,17408,26,8425550086
1225,2205998696,926039,2206924735,5,0,0,31232,5,4997616
1226,2206000240,2470,2206002710,48,0,1,2560,48,6533349432
1227,2206016237,751490,2206767727,17,0,0,47104,17,706243060
1228,2206046961,6754,2206053715,24,0,1,7168,24,4418452636
1229,2206088935,184242,2206273177,41,0,0,2560,41,7916328630
1230,2206089850,11533,2206101383,15,0,1,18944,15,4175338592
1231,2206094630,456785,2206551415,28,0,0,17920,28,2413448146
1232,2206111131,609510,2206720641,4,0,0,14336,4,6727443294
1233,2206113429,427176,2206540605,33,0,0,25600,33,5064071021
1234,2206133661,393503,2206527164,37,0,0,24064,37,4057539498
1235,2206153916,1040778,2207194694,28,0,0,28160,28,5577057285
1236,2206154268,655273,2206809541,37,0,0,5120,37,8520439913
1237,2206160205,227705,2206387910,29,0,0,11776,29,8222444733
1238,2206163576,1108322,2207271898,7,0,0,77312,7,433149325
1239,2206176637,4850,2206181487,22,0,1,5120,22,9073199143
1240,2206178153,4255,2206182408,10,0,1,11264,10,408038073
1241,2206183349,96039,2206279388,4,0,1,154624,4,2789673976
1242,2206216125,63278,2206279403,38,0,1,9728,38,5247810637
1243,2206232439,49033,2206281472,46,0,1,4608,46,1947573366
1244,2206240863,454585,2206695448,18,0,0,14848,18,5006591659
1245,2206273143,386123,2206659266,27,0,0,30720,27,6771686464
1246,2206273741,8397,2206282138,10,0,1,11264,10,1713156901
1247,2206281322,4420,2206285742,15,0,1,11776,15,6454887829
1248,2206289766,300949,2206590715,26,0,0,2048,26,8718732471
1249,2206349928,315905,2206665833,26,0,0,21504,26,5291254170
1250,2206357520,386498,2206744018,16,0,0,47104,16,6886457273
1251,2206368711,183633,2206552344,43,0,0,512,43,2840485524
1252,2206371086,573499,2206944585,33,0,0,45568,33,6972073435
1253,2206372062,202964,2206575026,45,0,0,3584,45,1768749264
1254,2206381320,1044058,2207425378,41,0,0,1536,41,7939632403
1255,2206389840,416543,2206806383,6,0,0,36864,6,7232949694
1256,2206397007,517066,2206914073,45,0,0,15872,45,7345782724
1257,2206397766,935122,2207332888,2,0,0,39424,2,6476612873
1258,2206408571,522107,2206930678,33,0,0,19456,33,7104472501
1259,2206413023,407936,2206820959,21,0,0,11264,21,759991899
1260,2206415637,556330,2206971967,5,0,0,512,5,1500889678
1261,2206416124,329625,2206745749,16,0,0,5632,16,9019707597
1262,2206419996,766103,2207186099,18,0,0,91136,18,2956953948
1263,2206431341,1042,2206432383,19,0,1,1024,19,3686701431
1264,2206448783,647495,2207096278,49,0,0,47616,49,10322422260
1265,2206460353,291183,2206751536,29,0,0,18944,29,8566224234
1266,2206484171,468182,2206952353,19,0,0,17920,19,7925323072
1267,2206486183,3898,2206490081,18,0,1,4096,18,2469650894
1268,2206495109,170895,2206666004,28,0,0,512,28,1827152176
1269,2206496390,511217,2207007607,5,0,0,14336,5,3804548005
1270,2206516826,689636,2207206462,47,0,0,3072,47,5409874692
1271,2206521131,164695,2206685826,11,0,0,11776,11,5185568641
1272,2206521238,792818,2207314056,34,0,0,73728,34,3737474579
1273,2206533956,469268,2207003224,8,0,0,4608,8,6847441252
1274,2206535295,379893,2206915188,42,0,0,3584,42,9451140647
1275,2206551107,1818,2206552925,12,0,1,1536,12,1631904326
1276,2206551785,3561,2206555346,20,0,1,3584,20,2231209737
1277,2206577552,422300,2206999852,15,0,0,38912,15,1103421759
1278,2206587182,322032,2206909214,27,0,0,11776,27,8090015533
1279,2206588239,1029827,2207618066,1,0,0,28160,1,6058006731
1280,2206604085,468110,2207072195,24,0,0,39936,24,1553340120
1281,2206629913,178045,2206807958,14,0,0,5120,14,8108654992
1282,2206640580,564448,2207205028,16,0,0,1536,16,3957620683
1283,2206642341,649220,2207291561,31,0,0,37888,31,4168955318
1284,2206663673,832860,2207496533,15,0,0,37888,15,9088327876
1285,2206670774,359484,2207030258,47,0,0,7680,47,4158954148
1286,2206677550,526995,2207204545,36,0,0,32256,36,6629873697
1287,2206711893,709391,2207421284,38,0,0,10240,38,669092026
1288,2206712038,12825,2206724863,19,0,1,21504,19,3814373566
1289,2206725051,621566,2207346617,29,0,0,16896,29,10250778449
1290,2206772479,921634,2207694113,23,0,0,36864,23,894368204
1291,2206775224,361167,2207136391,35,0,0,37888,35,5003318739
1292,2206778629,200031,2206978660,13,0,0,4096,13,4585739440
1293,2206783863,4162,2206788025,21,0,1,11264,21,4582073787
1294,2206794931,249875,2207044806,32,0,0,3584,32,10732514427
1295,2206804477,16513,2206820990,1,0,1,17920,1,4033823759
1296,2206812060,435100,2207247160,7,0,0,28672,7,6327202931
1297,2206813088,7917,2206821005,11,0,1,10240,11,8627979501
1298,2206815324,967997,2207783321,38,0,0,14848,38,624593429
1299,2206815509,342097,2207157606,41,0,0,10240,41,7701744491
1300,2206835601,289216,2207124817,43,0,0,62464,43,7515882015
1301,2206849270,547932,2207397202,36,0,0,22528,36,4759338487
1302,2206873829,266025,2207139854,20,0,0,11264,20,1150165638
1303,2206884108,795287,2207679395,30,0,0,112640,30,9209852047
1304,2206886136,886717,2207772853,9,0,0,29184,9,7025306621
1305,2206899751,656879,2207556630,49,0,0,16384,49,940805828
1306,2206933098,221358,2207154456,49,0,0,24576,49,8427772811
1307,2206936143,302258,2207238401,29,0,0,34816,29,8611194296
1308,2206953780,3645,2206957425,19,0,1,10240,19,1723105526
1309,2206953867,474022,2207427889,2,0,0,8192,2,8271899989
1310,2206958190,1518,2206959708,11,0,1,1536,11,6756309448
1311,2206960612,446901,2207407513,26,0,0,33792,26,6313683381
1312,2206967471,487189,2207454660,43,0,0,18432,43,457111513
1313,2206976630,632841,2207609471,42,0,0,52224,42,8756230721
1314,2206977768,227743,2207205511,27,0,0,1536,27,10211932275
1315,2206983645,243147,2207226792,37,0,0,7680,37,9785718421
1316,2207004962,7574,2207012536,48,0,1,12800,48,3757363808
1317,2207010663,775325,2207785988,4,0,0,8704,4,3449692227
1318,2207021654,408746,2207430400,17,0,0,8192,17,3350655546
1319,2207022422,2870,2207025292,15,0,1,8704,15,2556234400
1320,2207024936,999963,2208024899,29,0,0,21504,29,5856086724
1321,2207036255,557289,2207593544,7,0,0,1024,7,9893562070
1322,2207038589,810098,2207848687,12,0,0,5632,12,3167864893
1323,2207067450,451626,2207519076,14,0,0,22016,14,4511428933
1324,2207067671,357224,2207424895,4,0,0,11776,4,6511106451
1325,2207080801,458943,2207539744,19,0,0,15360,19,931221508
1326,2207084798,192398,2207277196,40,0,0,9728,40,6853050513
1327,2207085927,11928,2207097855,21,0,1,1536,21,1801886624
1328,2207086397,362632,2207449029,40,0,0,44032,40,1640240183
1329,2207088651,393740,2207482391,20,0,0,7680,20,2781570428
1330,2207098520,453095,2207551615,17,0,0,38912,17,3307354726
1331,2207100250,5326,2207105576,8,0,1,5632,8,8225239962
1332,2207101910,419871,2207521781,35,0,0,8704,35,1213370425
1333,2207105261,19571,2207124832,0,0,1,2560,0,4881833125
1334,2207117937,587759,2207705696,6,0,0,37888,6,1369081484
1335,2207120099,23668,2207143767,41,0,1,10752,41,323789330
1336,2207124481,19632,2207144113,32,0,1,512,32,2160797493
1337,2207129868,24603,2207154471,23,0,1,5632,23,5968418275
1338,2207141077,712164,2207853241,44,0,0,6656,44,181726476
1339,2207141936,231332,2207373268,10,0,0,10240,10,5423767471
1340,2207190834,437575,2207628409,4,0,0,33792,4,8881696272
1341,2207204374,437796,2207642170,3,0,0,2560,3,2290076950
1342,2207214673,202521,2207417194,13,0,0,2048,13,5178518447
1343,2207223797,635238,2207859035,15,0,0,5120,15,4354449416
1344,2207224102,603997,2207828099,42,0,0,24576,42,6409283291
1345,2207233385,684446,2207917831,47,0,0,96768,47,7294245369
1346,2207239542,770975,2208010517,16,0,0,102912,16,3183736564
1347,2207271646,679333,2207950979,40,0,0,36352,40,41332735
1348,2207280004,313213,2207593217,8,0,0,4096,8,9407157805
1349,2207288904,758402,2208047306,15,0,0,512,15,5866195674
1350,2207306637,544561,2207851198,36,0,0,8192,36,9584144487
1351,2207338648,508308,2207846956,42,0,0,52736,42,7208131965
1352,2207339750,182670,2207522420,35,0,0,2048,35,801285042
1353,2207348631,591249,2207939880,32,0,0,21504,32,3231567794
1354,2207356852,1994,2207358846,18,0,1,2048,18,980811448
1355,2207393627,198327,2207591954,19,0,0,39936,19,4791611303
1356,2207394871,287995,2207682866,20,0,0,11264,20,10113409837
1357,2207411786,217426,2207629212,44,0,0,2560,44,7278701470
1358,2207415616,335106,2207750722,36,0,0,49664,36,1073037613
1359,2207418598,386526,2207805124,10,0,0,15360,10,6474055761
1360,2207431209,625792,2208057001,15,0,0,31744,15,2150491913
1361,2207460380,4374,2207464754,19,0,1,4608,19,3136104895
1362,2207471505,461800,2207933305,30,0,0,32256,30,6116927586
1363,2207478383,4031,2207482414,35,0,1,8704,35,5634728621
1364,2207479788,551218,2208031006,2,0,0,19968,2,5643935050
1365,2207481909,406423,2207888332,46,0,0,1536,46,2239646583
1366,2207482950,561822,2208044772,40,0,0,11264,40,9293422573
1367,2207491422,18115,2207509537,7,0,1,25088,7,6746103165
1368,2207491969,475622,2207967591,10,0,0,2560,10,5762807900
1369,2207496823,277777,2207774600,9,0,0,5632,9,125371942
1370,2207500624,18467,2207519091,10,0,1,4608,10,6889854942
1371,2207507622,11484,2207519106,34,0,1,9728,34,3435741262
1372,2207517286,633619,2208150905,33,0,0,22016,33,1077461245
1373,2207533019,585383,2208118402,13,0,0,11776,13,7833667376
1374,2207544135,415595,2207959730,16,0,0,28672,16,6274276384
1375,2207567183,399613,2207966796,39,0,0,22016,39,9314292661
1376,2207591906,331556,2207923462,29,0,0,18432,29,4271201932
1377,2207593619,615270,2208208889,26,0,0,5632,26,4401287420
1378,2207607537,156409,2207763946,24,0,0,13312,24,1709690790
1379,2207609114,527696,2208136810,6,0,0,6656,6,6332229700
1380,2207621017,986886,2208607903,18,0,0,8704,18,540974104
1381,2207633552,4679,2207638231,48,0,1,12288,48,5665403142
1382,2207644186,457567,2208101753,38,0,0,22016,38,7770288907
1383,2207655824,403688,2208059512,27,0,0,8192,27,10536607272
1384,2207656784,48927,2207705711,8,0,1,3072,8,5368223623
1385,2207658964,46762,2207705726,3,0,1,3072,3,10246801761
1386,2207672146,374989,2208047135,49,0,0,7680,49,5340757572
1387,2207729087,433186,2208162273,21,0,0,1536,21,5077740079
1388,2207731623,636836,2208368459,10,0,0,124928,10,1856405098
1389,2207739821,278511,2208018332,43,0,0,25600,43,5329733994
1390,2207743961,456096,2208200057,34,0,0,22016,34,763388
1391,2207745202,735718,2208480920,33,0,0,16896,33,10236866841
1392,2207764577,195488,2207960065,4,0,0,1024,4,1366888423
1393,2207771684,955476,2208727160,44,0,0,64000,44,3987985690
1394,2207783814,514745,2208298559,16,0,0,56832,16,4282197913
1395,2207796056,724341,2208520397,39,0,0,2048,39,7746929422
1396,2207804063,430013,2208234076,0,0,0,25088,0,8512422534
1397,2207847009,194308,2208041317,28,0,0,33792,28,6708446315
1398,2207851855,237152,2208089007,16,0,0,9216,16,9165809204
1399,2207864686,328578,2208193264,45,0,0,2048,45,6293816475
1400,2207881539,293803,2208175342,38,0,0,19968,38,2340594829
1401,2207909060,1044387,2208953447,45,0,0,31232,45,920405014
1402,2207916301,964630,2208880931,26,0,0,52736,26,7443668706
1403,2207940055,482587,2208422642,25,0,0,5120,25,1596418129
1404,2207946440,474604,2208421044,40,0,0,43008,40,2823975811
1405,2207962936,5689,2207968625,18,0,1,1024,18,7167577078
1406,2207967974,527746,2208495720,8,0,0,5120,8,3866705236
1407,2207990527,596650,2208587177,34,0,0,59904,34,5175376845
1408,2208004146,398226,2208402372,22,0,0,28160,22,1881305194
1409,2208015413,603654,2208619067,32,0,0,7168,32,4500712441
1410,2208045810,257296,2208303106,26,0,0,14848,26,8182395313
1411,2208087168,555101,2208642269,21,0,0,1536,21,10039406358
1412,2208099699,4516,2208104215,12,0,1,2560,12,2753498442
1413,2208109359,4374,2208113733,41,0,1,4608,41,220508184
1414,2208123586,282256,2208405842,5,0,0,7680,5,7400926291
1415,2208125348,282569,2208407917,16,0,0,6656,16,3622909609
1416,2208125938,277541,2208403479,43,0,0,3584,43,9766203819
1417,2208149706,455530,2208605236,30,0,0,5632,30,2204773953
1418,2208157355,227819,2208385174,20,0,0,54784,20,4178729643
1419,2208181153,212616,2208393769,35,0,0,28160,35,7219955298
1420,2208185903,860712,2209046615,28,0,0,22016,28,6495205133
1421,2208203323,254015,2208457338,23,0,0,35328,23,1226886410
1422,2208211619,259703,2208471322,34,0,0,14848,34,8982725025
1423,2208217929,448705,2208666634,36,0,0,10240,36,374330687
1424,2208222169,11922,2208234091,43,0,1,4608,43,9021763867
1425,2208239247,398827,2208638074,5,0,0,12288,5,9463627862
1426,2208250042,579565,2208829607,21,0,0,80896,21,6852101291
1427,2208261067,1042,2208262109,48,0,1,1024,48,1659471020
1428,2208263857,1518,2208265375,0,0,1,1536,0,2619122203
1429,2208272732,711645,2208984377,16,0,0,87552,16,8324695300
1430,2208274892,171667,2208446559,29,0,0,38912,29,1311608585
1431,2208293365,908538,2209201903,9,0,0,14336,9,10131922194
1432,2208316325,4937,2208321262,33,0,1,12800,33,10633106018
1433,2208318538,189234,2208507772,43,0,0,9216,43,7017419644
1434,2208322832,162290,2208485122,15,0,0,1536,15,2389283307
1435,2208323387,280118,2208603505,1,0,0,25088,1,7514228596
1436,2208325336,407820,2208733156,6,0,0,5632,6,2356835897
1437,2208328418,1042,2208329460,4,0,1,1024,4,5084582016
1438,2208339503,368142,2208707645,5,0,0,54784,5,8129130228
1439,2208346470,586043,2208932513,35,0,0,39424,35,5767169290
1440,2208351258,199684,2208550942,32,0,0,3584,32,1444936137
1441,2208372733,648052,2209020785,6,0,0,6656,6,9861687856
1442,2208373362,283222,2208656584,8,0,0,3584,8,1928795275
1443,2208373876,47183,2208421059,0,0,1,11264,0,1971558033
1444,2208375365,721589,2209096954,39,0,0,60416,39,9692187162
1445,2208413933,418809,2208832742,20,0,0,10240,20,7416504816
1446,2208427464,198142,2208625606,33,0,0,6656,33,10711743574
1447,2208447649,12151,2208459800,10,0,1,2560,10,8954335885
1448,2208473729,141287,2208615016,9,0,0,1024,9,689059010
1449,2208492369,3366,2208495735,18,0,1,2560,18,831658557
1450,2208496620,7706,2208504326,8,0,1,8192,8,9124348737
1451,2208497757,98089,2208595846,9,0,0,14848,9,7570513851
1452,2208502043,150090,2208652133,49,0,0,8704,49,9880844715
1453,2208561234,428150,2208989384,32,0,0,16384,32,7020730171
1454,2208584617,191458,2208776075,20,0,0,33280,20,49351564
1455,2208610514,413250,2209023764,4,0,0,9728,4,4944488337
1456,2208623090,105185,2208728275,31,0,0,3584,31,10681271417
1457,2208632503,5586,2208638089,24,0,1,2048,24,6509253687
1458,2208633617,385125,2209018742,38,0,0,85504,38,9897308518
1459,2208644905,2470,2208647375,11,0,1,2560,11,7687270428
1460,2208680327,263589,2208943916,13,0,0,37376,13,8249120890
1461,2208682125,396398,2209078523,1,0,0,18432,1,449960185
1462,2208704241,251249,2208955490,26,0,0,6656,26,7577622703
1463,2208718574,334020,2209052594,0,0,0,18944,0,10329950239
1464,2208727853,264822,2208992675,6,0,0,10752,6,4309242717
1465,2208730502,455223,2209185725,29,0,0,64000,29,6371520780
1466,2208737482,291616,2209029098,35,0,0,10240,35,7667218013
1467,2208747798,355895,2209103693,38,0,0,22016,38,10208921210
1468,2208761891,77786,2208839677,17,0,0,1536,17,7574277370
1469,2208765942,423238,2209189180,44,0,0,11264,44,9090610778
1470,2208769976,29582,2208799558,43,0,1,38912,43,10674827549
1471,2208784561,241402,2209025963,10,0,0,7168,10,462751494
1472,2208796909,4915,2208801824,18,0,1,3584,18,2155700982
1473,2208802985,230028,2209033013,32,0,0,12800,32,6196657601
1474,2208804330,316320,2209120650,4,0,0,2048,4,3375378009
1475,2208824062,390981,2209215043,10,0,0,32256,10,3048390085
1476,2208835436,204456,2209039892,22,0,0,22528,22,6272344214
1477,2208836192,2870,2208839062,8,0,1,8704,8,7288346173
1478,2208843872,396799,2209240671,4,0,1,642560,4,8835942852
1479,2208845873,395144,2209241017,3,0,1,512,3,1943399926
1480,2208867503,376420,2209243923,8,0,1,4608,8,1669774352
1481,2208874405,279690,2209154095,36,0,0,7680,36,1378848950
1482,2208881097,442285,2209323382,7,0,0,3584,7,4496752502
1483,2208883668,363161,2209246829,20,0,1,4608,20,1049692430
1484,2208885079,432605,2209317684,32,0,0,10752,32,7929786562
1485,2208892095,259645,2209151740,43,0,0,11264,43,8527969890
1486,2208892806,522500,2209415306,34,0,0,10240,34,6150695792
1487,2208893537,339169,2209232706,23,0,0,10240,23,2842519237
1488,2208899437,248856,2209148293,18,0,0,28672,18,691995310
1489,2208900179,353371,2209253550,12,0,1,24064,12,3505244606
1490,2208901221,605323,2209506544,43,0,0,8704,43,9773325179
1491,2208904349,386563,2209290912,1,0,0,33792,1,4992414410
1492,2208922469,298517,2209220986,9,0,0,19456,9,6592889939
1493,2208935413,437331,2209372744,38,0,0,8192,38,3440249441
1494,2208965976,572030,2209538006,45,0,0,4608,45,258530457
1495,2208975150,279476,2209254626,14,0,1,13312,14,3274582351
1496,2208975172,712650,2209687822,47,0,0,60928,47,4137025863
1497,2208989191,269301,2209258492,14,0,1,6144,14,3847328763
1498,2209005305,406866,2209412171,19,0,0,1536,19,8827673829
1499,2209010770,250628,2209261398,32,0,1,4608,32,9090950746
1500,2209011647,100921,2209112568,6,0,0,512,6,4391650970
1501,2209030545,222052,2209252597,23,0,0,8192,23,6395890442
1502,2209034114,228257,2209262371,35,0,1,12800,35,692032171
1503,2209071579,310356,2209381935,5,0,0,12800,5,5230984886
1504,2209086905,464615,2209551520,18,0,0,23040,18,8742568023
1505,2209087115,449464,2209536579,40,0,0,65536,40,4297748281
1506,2209090702,216627,2209307329,20,0,0,33792,20,7716955736
1507,2209101599,323909,2209425508,1,0,0,15360,1,10175058431
1508,2209168320,655349,2209823669,30,0,0,8704,30,3120938108
1509,2209178330,555821,2209734151,33,0,0,7680,33,6758762643
1510,2209178994,541975,2209720969,11,0,0,35840,11,5020094078
1511,2209189180,413626,2209602806,12,0,0,38912,12,1341783040
1512,2209197433,301281,2209498714,30,0,0,27648,30,353812986
1513,2209213329,338830,2209552159,23,0,0,2048,23,10209594595
1514,2209213920,592953,2209806873,29,0,0,14848,29,3347303137
1515,2209248264,255613,2209503877,19,0,0,16896,19,8012193396
1516,2209269225,361600,2209630825,10,0,0,55808,10,5059668707
1517,2209289874,263244,2209553118,4,0,0,3072,4,8519789945
1518,2209292246,15098,2209307344,48,0,1,20992,48,2233277809
1519,2209314544,535046,2209849590,26,0,0,51200,26,4839379648
1520,2209320829,4850,2209325679,18,0,1,5120,18,4496957916
1521,2209323353,216072,2209539425,25,0,0,4608,25,2113167541
1522,2209352816,676149,2210028965,45,0,0,76288,45,1858519357
1523,2209364114,2946,2209367060,14,0,1,3072,14,4088184539
1524,2209364190,438144,2209802334,28,0,0,128000,28,9994719062
1525,2209374665,433159,2209807824,20,0,0,3072,20,2532901092
1526,2209394092,464392,2209858484,32,0,0,1536,32,5838755973
1527,2209402800,246163,2209648963,15,0,0,18432,15,4453503200
1528,2209402892,4937,2209407829,24,0,1,12800,24,3815382298
1529,2209410359,6278,2209416637,10,0,1,6656,10,10708549250
1530,2209446508,16354,2209462862,5,0,1,31744,5,1829583993
1531,2209454219,541495,2209995714,24,0,0,50688,24,8447566600
1532,2209455553,490082,2209945635,22,0,0,28160,22,3983463265
1533,2209465989,347185,2209813174,41,0,0,2560,41,1784923616
1534,2209469671,2870,2209472541,19,0,1,8704,19,3119314281
1535,2209470986,341393,2209812379,49,0,0,14848,49,796268570
1536,2209510757,2946,2209513703,10,0,1,3072,10,1919860242
1537,2209520075,673686,2210193761,21,0,0,25088,21,10288000667
1538,2209536712,519326,2210056038,3,0,0,16384,3,4342245714
1539,2209548354,381293,2209929647,47,0,0,13824,47,6145384155
1540,2209553929,478647,2210032576,7,0,0,11776,7,6688402998
1541,2209557845,6754,2209564599,11,0,1,7168,11,314496248
1542,2209558663,11082,2209569745,3,0,1,8192,3,1138529393
1543,2209560897,12714,2209573611,33,0,1,6144,33,10177512230
1544,2209570127,480888,2210051015,8,0,0,60416,8,2341645463
1545,2209587611,15210,2209602821,24,0,1,19456,24,8332475372
1546,2209601942,581793,2210183735,6,0,0,104448,6,9425140628
1547,2209672075,683987,2210356062,28,0,0,46080,28,1752008464
1548,2209676324,226533,2209902857,34,0,0,7680,34,6150466508
1549,2209683187,280384,2209963571,2,0,0,34304,2,3575675448
1550,2209683866,715516,2210399382,4,0,0,26624,4,149549483
1551,2209692255,587182,2210279437,16,0,0,34304,16,7895747219
1552,2209697864,1042,2209698906,15,0,1,1024,15,4336505084
1553,2209717704,9535,2209727239,30,0,1,6656,30,96638035
1554,2209737739,524968,2210262707,21,0,0,39424,21,10123628564
1555,2209744299,5326,2209749625,19,0,1,5632,19,10717903909
1556,2209746395,492372,2210238767,22,0,0,11264,22,7211887959
1557,2209778403,554655,2210333058,5,0,0,20992,5,3000479567
1558,2209782201,577464,2210359665,12,0,0,11776,12,4256028339
1559,2209817684,12737,2209830421,33,0,1,24576,33,4623635090
1560,2209821889,11758,2209833647,10,0,1,5120,10,4983753721
1561,2209823671,308785,2210132456,29,0,0,3072,29,9097218822
1562,2209828411,107176,2209935587,26,0,0,3072,26,9846181070
1563,2209828937,480264,2210309201,37,0,0,26112,37,9057864867
1564,2209829672,248701,2210078373,12,0,0,4096,12,9549474790
1565,2209832542,671342,2210503884,34,0,0,35328,34,1079949691
1566,2209843551,706053,2210549604,34,0,0,17920,34,1014459205
1567,2209848371,3706,2209852077,20,0,1,2560,20,1985363694
1568,2209865936,32987,2209898923,4,0,1,57344,4,4720246580
1569,2209886217,497495,2210383712,23,0,0,78848,23,9789312226
1570,2209887153,755353,2210642506,36,0,0,8192,36,9600192950
1571,2209909228,951498,2210860726,3,0,0,16384,3,2857255566
1572,2209920942,470297,2210391239,44,0,0,24576,44,9994621403
1573,2209922480,715258,2210637738,41,0,0,6656,41,539386731
1574,2209941140,600634,2210541774,18,0,0,90624,18,9111509565
1575,2209955447,659884,2210615331,2,0,0,37888,2,8907414295
1576,2209961050,827845,2210788895,39,0,0,28160,39,2949961364
1577,2209980394,453890,2210434284,34,0,0,6144,34,4823844967
1578,2209985720,688983,2210674703,18,0,0,40448,18,3144962764
1579,2209992576,428525,2210421101,18,0,0,12800,18,2340362149
1580,2209999783,269187,2210268970,47,0,0,20480,47,8817405282
1581,2210011078,553003,2210564081,21,0,0,38912,21,9322164856
1582,2210020928,472177,2210493105,23,0,0,20992,23,4509006897
1583,2210025659,30394,2210056053,21,0,1,1024,21,183092186
1584,2210039634,375158,2210414792,2,0,0,8192,2,4185143047
1585,2210055366,5053,2210060419,21,0,1,4608,21,7956101710
1586,2210063507,715218,2210778725,9,0,0,73216,9,9913260730
1587,2210064834,3904,2210068738,32,0,1,10752,32,4714948770
1588,2210084191,600199,2210684390,16,0,0,31744,16,6031862427
1589,2210092855,451274,2210544129,47,0,0,7680,47,8320697255
1590,2210124655,5802,2210130457,35,0,1,6144,35,3046698248
1591,2210127891,4832,2210132723,29,0,1,3584,29,4365077199
1592,2210150301,401829,2210552130,47,0,0,2048,47,6403085860
1593,2210151786,819497,2210971283,23,0,0,6144,23,3213462491
1594,2210156892,572629,2210729521,22,0,0,1536,22,9555989361
1595,2210161868,36238,2210198106,3,0,1,27648,3,7584686008
1596,2210166534,1009049,2211175583,5,0,0,24064,5,6939995597
1597,2210172556,407624,2210580180,44,0,0,23040,44,4069477355
1598,2210174008,453194,2210627202,34,0,0,38912,34,6281531321
1599,2210195347,6305,2210201652,21,0,1,5632,21,6632822184
1600,2210196902,602148,2210799050,24,0,0,33280,24,4851840289
1601,2210214800,371525,2210586325,46,0,0,7680,46,2045204318
1602,2210224816,410856,2210635672,19,0,0,14336,19,6492440451
1603,2210230180,217663,2210447843,6,0,0,8704,6,3648619054
1604,2210245230,566,2210245796,33,0,1,512,33,3108052154
1605,2210259956,520344,2210780300,20,0,0,5120,20,1817116344
1606,2210261860,793035,2211054895,37,0,0,83968,37,726713800
1607,2210263638,287853,2210551491,24,0,0,6144,24,9746153096
1608,2210273720,6818,2210280538,15,0,1,1024,15,1344450211
1609,2210277252,635317,2210912569,12,0,0,6144,12,7180438783
1610,2210296296,455434,2210751730,29,0,0,17920,29,8420818894
1611,2210300440,499289,2210799729,22,0,0,2048,22,7988278424
1612,2210315334,286320,2210601654,3,0,0,2048,3,6027511344
1613,2210320596,500854,2210821450,33,0,0,11776,33,4604386629
1614,2210347109,337460,2210684569,12,0,0,512,12,4780899975
1615,2210348712,864840,2211213552,11,0,0,10240,11,5033130177
1616,2210357064,332099,2210689163,14,0,0,12288,14,3233716661
1617,2210366923,549417,2210916340,1,0,0,11264,1,3673374880
1618,2210369899,137760,2210507659,6,0,0,7680,6,2099002763
1619,2210371939,774710,2211146649,24,0,0,36864,24,414229305
1620,2210386813,244460,2210631273,7,0,0,13312,7,1701308613
1621,2210387348,451735,2210839083,25,0,0,13824,25,9806654513
1622,2210387676,430171,2210817847,31,0,0,28160,31,498713691
1623,2210399445,627684,2211027129,28,0,0,39936,28,7973835360
1624,2210402095,1042,2210403137,0,0,1,1024,0,10464899874
1625,2210403383,3645,2210407028,12,0,1,10240,12,5507044788
1626,2210413916,747893,2211161809,44,0,0,45568,44,3028890290
1627,2210427946,6353,2210434299,24,0,1,15360,24,2015754904
1628,2210437495,1518,2210439013,30,0,1,1536,30,7750335557
1629,2210444967,568236,2211013203,14,0,0,18432,14,1789292095
1630,2210445468,822960,2211268428,36,0,0,4096,36,8804574038
1631,2210449900,882085,2211331985,14,0,0,27136,14,10247878283
1632,2210461027,6229,2210467256,30,0,1,15360,30,732810279
1633,2210461088,291133,2210752221,38,0,0,1536,38,5740251887
1634,2210469285,166402,2210635687,4,0,1,266752,4,1362324919
1635,2210470609,167943,2210638552,41,0,1,7680,41,9354566044
1636,2210477815,737959,2211215774,30,0,0,5632,30,3518697660
1637,2210484189,1052678,2211536867,39,0,0,179200,39,4628459138
1638,2210503856,702786,2211206642,8,0,0,101888,8,2372837709
1639,2210511334,544988,2211056322,16,0,0,4608,16,6640320587
1640,2210515028,124190,2210639218,7,0,1,11264,7,7443762258
1641,2210525806,596423,2211122229,23,0,0,6144,23,8918220196
1642,2210541295,546872,2211088167,34,0,0,21504,34,10015371447
1643,2210541430,745391,2211286821,44,0,0,512,44,844970869
1644,2210548581,395960,2210944541,43,0,0,10240,43,8350826439
1645,2210565121,427986,2210993107,12,0,0,42496,12,8146685905
1646,2210568703,824293,2211392996,24,0,0,56832,24,1518387945
1647,2210616487,633374,2211249861,27,0,0,25600,27,3365465047
1648,2210623694,960446,2211584140,31,0,0,72704,31,6765127197
1649,2210634351,607524,2211241875,33,0,0,20480,33,1076647019
1650,2210641639,7347,2210648986,21,0,1,15872,21,5922984855
1651,2210647157,5552,2210652709,18,0,1,5632,18,3073614870
1652,2210657610,937386,2211594996,3,0,0,2560,3,10037327980
1653,2210670250,764736,2211434986,9,0,0,54784,9,7994236128
1654,2210681568,535321,2211216889,45,0,0,3584,45,4606551566
1655,2210688250,911621,2211599871,36,0,0,15872,36,5667249782
1656,2210694326,2870,2210697196,35,0,1,8704,35,4537515578
1657,2210701931,1121474,2211823405,45,0,0,4608,45,5281057105
1658,2210703817,885346,2211589163,1,0,0,16384,1,6456693745
1659,2210716003,845946,2211561949,27,0,0,20480,27,3047572823
1660,2210728674,439562,2211168236,17,0,0,20992,17,2006695722
1661,2210748454,6196,2210754650,37,0,1,2560,37,2914606360
1662,2210754129,598456,2211352585,23,0,0,51712,23,9008347444
1663,2210775999,26159,2210802158,3,0,1,2560,3,310818797
1664,2210776253,779441,2211555694,24,0,0,9216,24,2882200058
1665,2210782570,630291,2211412861,10,0,0,6144,10,9487446093
1666,2210783935,21729,2210805664,41,0,1,13312,41,469155349
1667,2210784817,819334,2211604151,40,0,0,4608,40,5847069656
1668,2210812988,836052,2211649040,5,0,0,512,5,4332029551
1669,2210814154,824372,2211638526,4,0,0,17408,4,3109253691
1670,2210815914,721280,2211537194,32,0,0,1024,32,7370121092
1671,2210828793,615591,2211444384,40,0,0,27136,40,8081274150
1672,2210834555,569852,2211404407,43,0,0,37376,43,3065007344
1673,2210856003,738175,2211594178,21,0,0,16384,21,7418710918
1674,2210856399,421415,2211277814,25,0,0,12800,25,4241507849
1675,2210858984,383062,2211242046,44,0,0,512,44,932070847
1676,2210869618,818999,2211688617,45,0,0,8704,45,426432605
1677,2210875665,500000,2211375665,19,0,0,39424,19,6107308483
1678,2210896114,1127152,2212023266,22,0,0,38912,22,10248947733
1679,2210896599,317436,2211214035,3,0,0,1536,3,4091068831
1680,2210901603,823567,2211725170,11,0,0,1536,11,1710927313
1681,2210901784,308617,2211210401,6,0,0,12288,6,3193332595
1682,2210908817,358348,2211267165,22,0,0,10752,22,2683679919
1683,2210922327,680375,2211602702,11,0,0,9216,11,6983677976
1684,2210928892,729852,2211658744,4,0,0,26624,4,1698709182
1685,2210946802,200018,2211146820,7,0,0,512,7,5978503268
1686,2210966972,795424,2211762396,16,0,0,24576,16,6044109873
1687,2210977812,575059,2211552871,42,0,0,33280,42,8441805503
1688,2210980164,18754,2210998918,3,0,1,6144,3,2232667289
1689,2210991863,344037,2211335900,6,0,0,12800,6,6457644371
1690,2210993421,417553,2211410974,11,0,0,21504,11,9539273103
1691,2211010060,1018057,2212028117,25,0,0,15872,25,6819446617
1692,2211012673,831235,2211843908,40,0,0,65536,40,5505295007
1693,2211053292,6376,2211059668,33,0,1,9728,33,9873510042
1694,2211068655,396729,2211465384,42,0,0,36864,42,742753193
1695,2211074626,3904,2211078530,2,0,1,10752,2,2565978265
1696,2211093427,342666,2211436093,33,0,0,3584,33,9843295469
1697,2211116338,961518,2212077856,29,0,0,52736,29,5535067376
1698,2211129841,753515,2211883356,22,0,0,37376,22,2219693350
1699,2211130434,340425,2211470859,49,0,0,17920,49,5420955518
1700,2211135274,652157,2211787431,35,0,0,44544,35,1027333188
1701,2211146115,565617,2211711732,38,0,0,29696,38,253317671
1702,2211154968,640605,2211795573,45,0,0,23552,45,8365417816
1703,2211160843,381849,2211542692,22,0,0,17920,22,8616635967
1704,2211183101,262142,2211445243,37,0,0,1024,37,5433260543
1705,2211188318,823077,2212011395,45,0,0,73728,45,6648389789
1706,2211202165,780454,2211982619,30,0,0,52736,30,1241715970
1707,2211208862,9504,2211218366,30,0,1,1536,30,5449568378
1708,2211278845,23120,2211301965,19,0,1,41472,19,5311918482
1709,2211300784,760973,2212061757,49,0,0,54272,49,8240498780
1710,2211308400,921579,2212229979,20,0,0,10240,20,10103502524
1711,2211335092,313777,2211648869,1,0,0,29696,1,3633211140
1712,2211371108,835697,2212206805,26,0,0,43520,26,1484751710
1713,2211388936,865217,2212254153,11,0,0,60928,11,1929087123
1714,2211400609,705707,2212106316,35,0,0,14848,35,9785869380
1715,2211429866,19673,2211449539,10,0,1,13312,10,1114840419
1716,2211450806,650971,2212101777,5,0,0,32256,5,3305398174
1717,2211469843,222221,2211692064,15,0,0,11264,15,6096697580
1718,2211479771,57438,2211537209,2,0,1,6144,2,8747795352
1719,2211486956,107245,2211594201,30,0,1,30208,30,8783339135
1720,2211515942,831509,2212347451,6,0,0,90624,6,10555929537
1721,2211520571,653730,2212174301,16,0,0,49664,16,7262040672
1722,2211521271,287701,2211808972,39,0,0,9216,39,3679716253
1723,2211531384,838577,2212369961,38,0,0,40960,38,8069932279
1724,2211538651,333302,2211871953,22,0,0,13312,22,6203488367
1725,2211556094,719134,2212275228,46,0,0,69120,46,4298564057
1726,2211559297,43420,2211602717,0,0,1,4096,0,8159676981
1727,2211566569,36163,2211602732,0,0,1,3072,0,8061761922
1728,2211574164,877833,2212451997,30,0,0,33792,30,1111308689
1729,2211583032,205350,2211788382,27,0,0,3072,27,5207605355
1730,2211591392,635412,2212226804,14,0,0,65536,14,7921231708
1731,2211615924,232687,2211848611,8,0,0,15360,8,159935006
1732,2211625671,460172,2212085843,47,0,0,26112,47,4003088842
1733,2211643178,445840,2212089018,12,0,0,10240,12,4561930745
1734,2211645853,789128,2212434981,32,0,0,22016,32,4550251288
1735,2211646580,17064,2211663644,15,0,1,28160,15,3499464704
1736,2211648406,765660,2212414066,27,0,0,35840,27,10281870328
1737,2211658272,975230,2212633502,3,0,0,59904,3,9393682132
1738,2211668129,734332,2212402461,36,0,0,28672,36,4914635338
1739,2211685089,751570,2212436659,11,0,0,3072,11,2921143376
1740,2211712430,572828,2212285258,27,0,0,27136,27,4198683063
1741,2211720754,11274,2211732028,15,0,1,18432,15,8453275849
1742,2211760536,816942,2212577478,49,0,0,61952,49,6328837670
1743,2211761875,5864,2211767739,20,0,1,5632,20,1472617788
1744,2211770637,406175,2212176812,11,0,0,8192,11,8854763416
1745,2211790433,30853,2211821286,4,0,1,46592,4,10626101709
1746,2211792482,646621,2212439103,44,0,0,6656,44,9784605542
1747,2211807506,308784,2212116290,26,0,0,15360,26,9249271500
1748,2211826588,658047,2212484635,21,0,0,14336,21,39595330
1749,2211905124,3904,2211909028,34,0,1,10752,34,2538992567
1750,2211907962,200297,2212108259,17,0,0,4096,17,6059562786
1751,2211917844,661856,2212579700,16,0,0,5120,16,2481880638
1752,2211918591,240563,2212159154,28,0,0,28160,28,1869691492
1753,2211925349,360080,2212285429,18,0,0,512,18,6130626062
1754,2211929972,14117,2211944089,48,0,1,24064,48,7887907516
1755,2211935112,11243,2211946355,46,0,1,3584,46,7905475946
1756,2211947089,10499,2211957588,2,0,1,16896,2,10373649245
1757,2211969019,403453,2212372472,14,0,0,8192,14,7894535961
1758,2211978776,378690,2212357466,25,0,0,32768,25,3271231747
1759,2211988058,305643,2212293701,20,0,0,6656,20,9985706546
1760,2212027272,629059,2212656331,38,0,0,26112,38,2926739640
1761,2212045320,632151,2212677471,25,0,0,20480,25,3138486369
1762,2212054285,369592,2212423877,8,0,0,8192,8,919971619
1763,2212064590,24451,2212089041,34,0,1,2048,34,9818427568
1764,2212064929,426290,2212491219,41,0,0,16384,41,5197491806
1765,2212065957,445812,2212511769,11,0,0,2048,11,108528511
1766,2212076508,808513,2212885021,16,0,0,64512,16,6728063265
1767,2212077120,523507,2212600627,33,0,0,68608,33,7090046854
1768,2212079280,197679,2212276959,31,0,0,5632,31,2723438334
1769,2212084881,563471,2212648352,9,0,0,41472,9,5292142051
1770,2212107213,295887,2212403100,18,0,0,2048,18,3694063853
1771,2212108418,742059,2212850477,35,0,0,59392,35,851025091
1772,2212110227,448360,2212558587,42,0,0,38400,42,1805987541
1773,2212144712,838503,2212983215,21,0,0,90624,21,3250536892
1774,2212166858,435672,2212602530,35,0,0,6144,35,9688046800
1775,2212173052,769762,2212942814,8,0,0,512,8,8918575434
1776,2212175045,690305,2212865350,10,0,0,32768,10,1790754080
1777,2212175552,3321,2212178873,24,0,1,2048,24,10498950128
1778,2212199480,1045117,2213244597,41,0,0,5632,41,7507108868
1779,2212200530,466736,2212667266,49,0,0,35840,49,3024497004
1780,2212204849,879424,2213084273,7,0,0,16384,7,5454433600
1781,2212208091,793863,2213001954,23,0,0,2048,23,8983487535
1782,2212208890,951266,2213160156,23,0,0,13824,23,3653190124
1783,2212214512,533851,2212748363,27,0,0,9216,27,9282148999
1784,2212219484,358641,2212578125,36,0,0,2048,36,8228490259
1785,2212222513,1187406,2213409919,43,0,0,118272,43,6185683022
1786,2212226875,557093,2212783968,38,0,0,8704,38,2560020944
1787,2212228171,238019,2212466190,18,0,0,9216,18,7859963556
1788,2212228971,802148,2213031119,43,0,0,9216,43,3999475523
1789,2212233391,289594,2212522985,33,0,0,15872,33,5917664273
1790,2212265755,762541,2213028296,42,0,0,67584,42,1376953839
1791,2212266646,273146,2212539792,9,0,0,7680,9,1172199852
1792,2212278288,951272,2213229560,14,0,0,8192,14,3538838992
1793,2212283654,331535,2212615189,33,0,0,41472,33,348071287
1794,2212284729,350972,2212635701,16,0,0,7168,16,3829351574
1795,2212285552,10757,2212296309,10,0,1,17408,10,2003838697
1796,2212288621,1589396,2213878017,16,0,0,49664,16,5706994468
1797,2212295788,1250181,2213545969,39,0,0,4096,39,9751486793
1798,2212305054,147590,2212452644,32,0,0,2048,32,1763231226
1799,2212320669,813195,2213133864,35,0,0,151552,35,4513668538
1800,2212322814,414524,2212737338,23,0,0,37376,23,3117719219
1801,2212347351,437880,2212785231,1,0,0,4096,1,6134836989
1802,2212347519,940462,2213287981,47,0,0,31744,47,6088133672
1803,2212353680,29142,2212382822,7,0,1,16384,7,7049782440
1804,2212357210,30118,2212387328,29,0,1,7168,29,8949479643
1805,2212361087,794647,2213155734,25,0,0,45568,25,2297050940
1806,2212362723,492628,2212855351,8,0,0,13312,8,10024339856
1807,2212388713,679309,2213068022,18,0,0,4096,18,9615910840
1808,2212390177,12938,2212403115,10,0,1,7168,10,4843785906
1809,2212398246,794666,2213192912,17,0,0,14336,17,4291208746
1810,2212401538,870226,2213271764,36,0,0,89088,36,8486940046
1811,2212410815,777714,2213188529,3,0,0,3072,3,7862226923
1812,2212417826,524802,2212942628,3,0,0,43520,3,2239107409
1813,2212443328,14125,2212457453,32,0,1,5120,32,1626461753
1814,2212456921,1122408,2213579329,4,0,0,43008,4,8113308238
1815,2212472857,1797653,2214270510,18,0,0,50688,18,5452324677
1816,2212472901,2870,2212475771,0,0,1,8704,0,3255540898
1817,2212484608,1202091,2213686699,24,0,0,36352,24,2220015376
1818,2212497432,1652491,2214149923,15,0,0,1024,15,10671771207
1819,2212511622,944892,2213456514,38,0,0,61952,38,3290351286
1820,2212517250,704285,2213221535,5,0,0,27648,5,3837863976
1821,2212519058,900259,2213419317,33,0,0,30720,33,1157629125
1822,2212540467,538799,2213079266,23,0,0,22016,23,989194611
1823,2212541327,630613,2213171940,16,0,0,22528,16,4471973014
1824,2212549743,65477,2212615220,33,0,1,4608,33,5258243147
1825,2212572810,42425,2212615235,34,0,1,512,34,4407386566
1826,2212597583,636688,2213234271,32,0,0,15360,32,4569977749
1827,2212599501,457457,2213056958,3,0,0,14336,3,635005041
1828,2212601032,540803,2213141835,18,0,0,26112,18,1018739461
1829,2212629567,583529,2213213096,47,0,0,56832,47,2174441805
1830,2212646623,204649,2212851272,37,0,0,2560,37,8777457384
1831,2212647709,788167,2213435876,29,0,0,54272,29,5391461890
1832,2212656888,570153,2213227041,39,0,0,17920,39,6987145950
1833,2212659161,119239,2212778400,25,0,0,512,25,6072479463
1834,2212661743,829391,2213491134,45,0,0,9216,45,4904558200
1835,2212672388,815923,2213488311,44,0,0,8192,44,6798552044
1836,2212687963,1042,2212689005,14,0,1,1024,14,7836165312
1837,2212688963,553903,2213242866,41,0,0,28160,41,2062287034
1838,2212692633,582422,2213275055,38,0,0,10752,38,8440168906
1839,2212696532,337566,2213034098,33,0,0,9728,33,8830985923
1840,2212698165,566,2212698731,14,0,1,512,14,1926092763
1841,2212709174,766737,2213475911,16,0,0,19968,16,9363605576
1842,2212717679,167357,2212885036,4,0,1,215552,4,4586777531
1843,2212717931,167136,2212885067,19,0,1,6144,19,3152283612
1844,2212719129,978201,2213697330,29,0,0,34816,29,360428744
1845,2212731773,705842,2213437615,14,0,0,5632,14,3523013735
1846,2212780468,375461,2213155929,29,0,0,512,29,1380834228
1847,2212785936,699864,2213485800,7,0,0,18944,7,3450119327
1848,2212787365,987924,2213775289,27,0,0,53760,27,576350815
1849,2212788547,1104320,2213892867,29,0,0,45568,29,8726257120
1850,2212801082,849379,2213650461,4,0,0,18432,4,8311428023
1851,2212807655,1186527,2213994182,19,0,0,4608,19,1518247450
1852,2212813771,678486,2213492257,40,0,0,3584,40,3954293036
1853,2212816868,68222,2212885090,24,0,1,1536,24,2109304988
1854,2212827133,519191,2213346324,46,0,0,17920,46,4821778575
1855,2212841137,623044,2213464181,15,0,0,25088,15,6148499634
1856,2212854123,865709,2213719832,14,0,0,72192,14,3065786378
1857,2212854176,1612906,2214467082,32,0,0,28160,32,5947172683
1858,2212854856,614956,2213469812,35,0,0,18432,35,10709940273
1859,2212859249,434467,2213293716,9,0,0,1536,9,6513397382
1860,2212863568,1741914,2214605482,17,0,0,38400,17,7143129125
1861,2212869027,1280545,2214149572,10,0,0,60928,10,1182472180
1862,2212882481,676527,2213559008,25,0,0,8192,25,7485049342
1863,2212904927,898898,2213803825,22,0,0,50176,22,9229240084
1864,2212928325,14318,2212942643,33,0,1,1536,33,3575174886
1865,2212935729,573628,2213509357,21,0,0,5120,21,681883038
1866,2212952969,365047,2213318016,38,0,0,2560,38,5473934114
1867,2212970427,14298,2212984725,10,0,1,1536,10,46836816
1868,2212995517,484496,2213480013,19,0,0,1536,19,5635506330
1869,2213000036,832079,2213832115,30,0,0,60416,30,1560274934
1870,2213025899,453631,2213479530,33,0,0,11776,33,386378113
1871,2213028971,8566,2213037537,14,0,1,3584,14,8931714881
1872,2213061081,976693,2214037774,26,0,0,21504,26,6514979423
1873,2213065116,679121,2213744237,21,0,0,6144,21,5595218026
1874,2213082312,855813,2213938125,27,0,0,120320,27,4836346359
1875,2213125327,978449,2214103776,43,0,0,14336,43,10334167490
1876,2213126227,380082,2213506309,29,0,0,10240,29,7518642064
1877,2213139984,31971,2213171955,24,0,1,14848,24,9531645381
1878,2213152167,1012143,2214164310,17,0,0,10240,17,4288904916
1879,2213156013,911243,2214067256,35,0,0,21504,35,1161185838
1880,2213156710,15260,2213171970,3,0,1,10752,3,2321738866
1881,2213163256,931506,2214094762,16,0,0,8192,16,10653840724
1882,2213170848,7602,2213178450,8,0,1,15872,8,9797593405
1883,2213176021,323102,2213499123,37,0,0,16896,37,3001341892
1884,2213181534,664556,2213846090,41,0,0,4608,41,1032741494
1885,2213182187,1703405,2214885592,28,0,0,44544,28,5187429389
1886,2213190860,30706,2213221566,0,0,1,16384,0,4277532546
1887,2213194569,1411084,2214605653,49,0,0,512,49,8949907028
1888,2213202750,539600,2213742350,3,0,0,15872,3,6963719415
1889,2213207142,67928,2213275070,8,0,1,6656,8,5399013674
1890,2213214565,628999,2213843564,18,0,0,11776,18,1623731489
1891,2213217626,528810,2213746436,20,0,0,7168,20,5053843701
1892,2213264509,594633,2213859142,18,0,0,4096,18,10457155300
1893,2213265978,471513,2213737491,38,0,0,57856,38,3674061444
1894,2213271733,1397044,2214668777,21,0,0,30208,21,606556461
1895,2213279453,1216351,2214495804,33,0,0,20480,33,9528560152
1896,2213295474,1042,2213296516,35,0,1,1024,35,3394236448
1897,2213299737,566,2213300303,46,0,1,512,46,668890918
1898,2213305736,20366,2213326102,41,0,1,32768,41,3570761792
1899,2213307596,292753,2213600349,41,0,0,10240,41,489198273
1900,2213317509,520705,2213838214,2,0,0,19968,2,1813204717
1901,2213324176,268858,2213593034,12,0,0,5632,12,10578279069
1902,2213331545,277754,2213609299,26,0,0,19456,26,2574125962
1903,2213341982,741944,2214083926,16,0,0,23040,16,4437268842
1904,2213363034,3904,2213366938,43,0,1,10752,43,4172314717
1905,2213365799,44135,2213409934,33,0,1,8192,33,3346975748
1906,2213372863,587166,2213960029,45,0,0,31744,45,9233358537
1907,2213376286,412236,2213788522,42,0,0,26624,42,2814927083
1908,2213384251,654645,2214038896,29,0,0,3584,29,7318978940
1909,2213400437,630770,2214031207,27,0,0,37376,27,5443180759
1910,2213403498,869367,2214272865,34,0,0,7680,34,9222003811
1911,2213428317,269504,2213697821,30,0,0,1536,30,7993187787
1912,2213437358,542669,2213980027,49,0,0,37376,49,5288588663
1913,2213439126,374550,2213813676,9,0,0,32256,9,9407886716
1914,2213470466,276297,2213746763,23,0,0,1024,23,6714021811
1915,2213479055,1422043,2214901098,36,0,0,4096,36,8789979701
1916,2213524515,5971,2213530486,33,0,1,14848,33,2981888796
1917,2213535213,754659,2214289872,8,0,0,17920,8,9889151162
1918,2213543413,886385,2214429798,49,0,0,42496,49,5934333599
1919,2213545920,13103,2213559023,43,0,1,18944,43,3497367780
1920,2213547749,493213,2214040962,38,0,0,6144,38,5710064157
1921,2213551245,7793,2213559038,19,0,1,8704,19,3660582304
1922,2213551846,388642,2213940488,35,0,0,7680,35,2327110314
1923,2213561144,278817,2213839961,30,0,0,5632,30,9305611953
1924,2213563772,404852,2213968624,34,0,0,28160,34,5616013470
1925,2213571908,8472,2213580380,11,0,1,1024,11,4276205707
1926,2213574517,304451,2213878968,19,0,0,3072,19,4689831413
1927,2213591883,1124847,2214716730,9,0,0,41472,9,5831188307
1928,2213623956,553564,2214177520,18,0,0,26624,18,3748711274
1929,2213626154,11791,2213637945,46,0,1,19456,46,2545447771
1930,2213627545,753607,2214381152,12,0,0,5632,12,5920149760
1931,2213633548,6023,2213639571,32,0,1,2560,32,4668207600
1932,2213645238,17264,2213662502,12,0,1,19968,12,2289231606
1933,2213652154,1382976,2215035130,49,0,0,9728,49,10182883132
1934,2213670872,667112,2214337984,29,0,0,1536,29,1841869684
1935,2213673635,374530,2214048165,10,0,0,6144,10,8812929925
1936,2213681478,163193,2213844671,36,0,0,3584,36,1090808040
1937,2213683987,355080,2214039067,37,0,0,512,37,8176305610
1938,2213693768,871405,2214565173,4,0,0,112128,4,1164268297
1939,2213698161,462956,2214161117,35,0,0,2560,35,7044846325
1940,2213709425,968126,2214677551,31,0,0,28672,31,7218692582
1941,2213741948,730735,2214472683,2,0,0,16384,2,4048701672
1942,2213752507,374933,2214127440,14,0,0,16384,14,8732835243
1943,2213757042,444376,2214201418,26,0,0,4096,26,7341549553
1944,2213781006,65115,2213846121,48,0,1,10752,48,10446996378
1945,2213789019,1260984,2215050003,48,0,0,18944,48,1500172893
1946,2213794150,406005,2214200155,31,0,0,74240,31,9574382538
1947,2213802865,780419,2214583284,10,0,0,59392,10,4441414274
1948,2213830118,793038,2214623156,20,0,0,57344,20,3910810880
1949,2213835752,996825,2214832577,26,0,0,26624,26,522563332
1950,2213849846,1994,2213851840,48,0,1,2048,48,1358413940
1951,2213851908,802620,2214654528,3,0,0,55808,3,1095893098
1952,2213858780,35942,2213894722,30,0,1,62464,30,10710050073
1953,2213858792,994720,2214853512,44,0,0,68608,44,7153627099
1954,2213868288,283369,2214151657,26,0,0,3072,26,5125595148
1955,2213897413,887196,2214784609,21,0,0,19968,21,9603660969
1956,2213908958,34409,2213943367,11,0,1,8704,11,8150740936
1957,2213914714,34262,2213948976,11,0,1,6144,11,8222628423
1958,2213929222,664545,2214593767,22,0,0,34304,22,4121561393
1959,2213938789,884850,2214823639,48,0,0,34304,48,5846754600
1960,2213940872,295334,2214236206,1,0,0,3072,1,4184095182
1961,2213942307,356435,2214298742,2,0,0,1536,2,8887653150
1962,2213992665,701452,2214694117,37,0,0,8192,37,4648943228
1963,2213995006,696600,2214691606,5,0,0,46080,5,1888713504
1964,2213999641,752518,2214752159,43,0,0,33792,43,8438589513
1965,2214007770,431573,2214439343,5,0,0,16896,5,9304794610
1966,2214015342,219913,2214235255,15,0,0,4096,15,3963016973
1967,2214016017,725718,2214741735,12,0,0,1024,12,4799130258
1968,2214017421,20368,2214037789,3,0,1,15360,3,580755971
1969,2214030809,313742,2214344551,38,0,0,21504,38,5252762599
1970,2214040621,831384,2214872005,19,0,0,41984,19,10620351088
1971,2214053770,359426,2214413196,47,0,0,39424,47,10702402443
1972,2214065861,25370,2214091231,18,0,1,39936,18,2347265482
1973,2214084476,161375,2214245851,45,0,0,3584,45,1327192073
1974,2214090190,1130002,2215220192,30,0,0,96768,30,2006105848
1975,2214093117,766073,2214859190,40,0,0,17920,40,5320708704
1976,2214098638,270464,2214369102,1,0,0,4608,1,8215914182
1977,2214103189,7333,2214110522,15,0,1,7168,15,10698901329
1978,2214126225,4077,2214130302,21,0,1,8704,21,9320275588
1979,2214134600,361999,2214496599,34,0,0,2560,34,3169452548
1980,2214135105,215936,2214351041,18,0,0,3584,18,990680289
1981,2214139960,519590,2214659550,34,0,0,4608,34,8074120370
1982,2214151440,4107,2214155547,2,0,1,4096,2,1900644989
1983,2214173048,523268,2214696316,11,0,0,7168,11,2218272433
1984,2214177242,758410,2214935652,1,0,0,68608,1,8328358066
1985,2214182955,641479,2214824434,44,0,0,2560,44,5376488097
1986,2214191539,936954,2215128493,37,0,0,29184,37,10277261907
1987,2214193570,824034,2215017604,8,0,0,54784,8,7864781392
1988,2214193850,13011,2214206861,32,0,1,5632,32,9444423396
1989,2214216961,7230,2214224191,43,0,1,7680,43,10311520116
1990,2214224196,776669,2215000865,23,0,0,75264,23,4893524826
1991,2214252126,20754,2214272880,29,0,1,19456,29,6953919819
1992,2214277916,841654,2215119570,1,0,0,46080,1,9470374992
1993,2214294234,947867,2215242101,18,0,0,33792,18,7572820474
1994,2214307348,1042,2214308390,25,0,1,1024,25,1211173352
1995,2214309901,917482,2215227383,34,0,0,23552,34,10490302567
1996,2214341709,9588,2214351297,15,0,1,7168,15,3796640416
1997,2214353995,749174,2215103169,46,0,0,1536,46,8302867216
1998,2214355589,676538,2215032127,27,0,0,47616,27,6526702487
1999,2214376812,7706,2214384518,24,0,1,8192,24,3659261688
2000,2214378858,434314,2214813172,35,0,0,93696,35,2983415949
2001,2214381729,515624,2214897353,48,0,0,27648,48,964311512
2002,2214399302,938628,2215337930,34,0,0,73728,34,5948890052
2003,2214400060,258071,2214658131,33,0,0,11776,33,3948394455
2004,2214404103,351682,2214755785,42,0,0,11776,42,3779892981
2005,2214412568,497830,2214910398,24,0,0,2048,24,10206658233
2006,2214432539,1009683,2215442222,46,0,0,50176,46,7787502064
2007,2214436198,704026,2215140224,1,0,0,38400,1,1612855793
2008,2214448760,272985,2214721745,0,0,0,16384,0,9699482269
2009,2214456117,833786,2215289903,18,0,0,8704,18,6675792920
2010,2214478593,375098,2214853691,14,0,0,512,14,6025970428
2011,2214480877,563339,2215044216,1,0,0,27648,1,755703175
2012,2214501767,2470,2214504237,10,0,1,2560,10,8238983912
2013,2214506155,640488,2215146643,2,0,0,20992,2,5216291439
2014,2214515623,936286,2215451909,26,0,0,31744,26,1490741801
2015,2214526387,362527,2214888914,12,0,0,10752,12,7242561959
2016,2214530636,1196677,2215727313,36,0,0,42496,36,8974118471
2017,2214539385,800900,2215340285,10,0,0,7680,10,4293334378
2018,2214540451,83230,2214623681,43,0,1,512,43,2257650232
2019,2214564844,413074,2214977918,46,0,0,6144,46,8308357887
2020,2214567926,779238,2215347164,46,0,0,22528,46,2597272114
2021,2214626211,2470,2214628681,14,0,1,2560,14,102471114
2022,2214630972,616932,2215247904,47,0,0,18944,47,2683562402
2023,2214631146,37646,2214668792,29,0,1,22016,29,1568862919
2024,2214643525,720617,2215364142,29,0,0,39936,29,1953592426
2025,2214645263,748976,2215394239,15,0,0,57856,15,7710801068
2026,2214699832,399787,2215099619,3,0,0,22528,3,5268608864
2027,2214707351,328426,2215035777,11,0,0,2048,11,487226146
2028,2214722664,803731,2215526395,27,0,0,55808,27,542342555
2029,2214736071,16111,2214752182,3,0,1,16896,3,2355627584
2030,2214743438,340831,2215084269,36,0,0,2560,36,10482236618
2031,2214757690,189515,2214947205,27,0,0,1536,27,4757218200
2032,2214760570,5454,2214766024,4,0,1,13824,4,6134128656
2033,2214762720,3970,2214766690,36,0,1,1024,36,4720130390
2034,2214788137,97486,2214885623,32,0,1,18944,32,360250254
2035,2214790844,121903,2214912747,4,0,1,87040,4,8112320498
2036,2214795783,699494,2215495277,41,0,0,16384,41,1226288979
2037,2214800895,282579,2215083474,8,0,0,13312,8,9615267495
2038,2214816236,747941,2215564177,10,0,0,47616,10,2090971816
2039,2214827008,709143,2215536151,11,0,0,10240,11,2403185992
2040,2214834382,654686,2215489068,9,0,0,10240,9,9565512850
2041,2214847777,65943,2214913720,37,0,1,12800,37,5622209251
2042,2214848514,214283,2215062797,37,0,0,12800,37,6580562462
2043,2214860012,317185,2215177197,39,0,0,1024,39,1230960123
2044,2214888064,533275,2215421339,32,0,0,11776,32,3867101307
2045,2214894006,337768,2215231774,19,0,0,14336,19,4720093342
2046,2214904829,161638,2215066467,11,0,0,8704,11,4126720898
2047,2214919565,701373,2215620938,32,0,0,9728,32,9841043223
2048,2214940632,760256,2215700888,19,0,0,69120,19,4232312640
2049,2214941242,143518,2215084760,5,0,0,1536,5,955536305
2050,2214942546,851845,2215794391,4,0,0,11264,4,7109411151
2051,2214945511,3904,2214949415,20,0,1,10752,20,3879405161
2052,2214947259,728779,2215676038,0,0,0,90624,0,2894210943
2053,2214961505,943247,2215904752,49,0,0,23040,49,4092530693
2054,2214971023,205812,2215176835,25,0,0,1024,25,8668788941
2055,2214979481,70537,2215050018,2,0,1,4096,2,9032711281
2056,2214980775,810130,2215790905,21,0,0,73728,21,7064417351
2057,2214989303,620435,2215609738,33,0,0,62976,33,1092911066
2058,2214993976,685837,2215679813,49,0,0,12288,49,4349847792
2059,2214997660,885487,2215883147,48,0,0,69632,48,7899014335
2060,2215001960,453240,2215455200,10,0,0,10752,10,4961198581
2061,2215012219,517311,2215529530,2,0,0,10240,2,9962521983
2062,2215039527,608884,2215648411,3,0,0,20480,3,9594403342
2063,2215040282,878385,2215918667,49,0,0,45568,49,9423729823
2064,2215041289,506497,2215547786,16,0,0,1536,16,3052514872
2065,2215042147,951730,2215993877,23,0,0,58880,23,9596994009
2066,2215064663,649687,2215714350,33,0,0,7168,33,1802550237
2067,2215071053,104008,2215175061,37,0,0,4096,37,6191246040
2068,2215082708,671460,2215754168,3,0,0,88064,3,3716971574
2069,2215106929,425424,2215532353,4,0,0,9216,4,9423785713
2070,2215111633,35033,2215146666,41,0,1,25088,41,8002369631
2071,2215121883,698330,2215820213,22,0,0,20480,22,9667608365
2072,2215136640,12908,2215149548,20,0,1,3072,20,4952239147
2073,2215142288,821984,2215964272,18,0,0,1024,18,9396718175
2074,2215153459,692668,2215846127,19,0,0,3584,19,6192061513
2075,2215155788,866216,2216022004,18,0,0,6656,18,1249444027
2076,2215164093,262826,2215426919,5,0,0,8704,5,5453605766
2077,2215179586,618564,2215798150,48,0,0,12288,48,2009551500
2078,2215179979,712863,2215892842,46,0,0,31744,46,1465478763
2079,2215186103,927528,2216113631,41,0,0,62464,41,7048588505
2080,2215193249,373127,2215566376,9,0,0,7168,9,731210950
2081,2215198494,557717,2215756211,49,0,0,6656,49,4365116913
2082,2215210168,751045,2215961213,22,0,0,37376,22,2254686749
2083,2215220171,1003818,2216223989,49,0,0,67584,49,4002298995
2084,2215233771,478364,2215712135,3,0,0,36864,3,4092945533
2085,2215262585,549511,2215812096,18,0,0,26624,18,7338878641
2086,2215265668,267348,2215533016,6,0,0,2048,6,2816367574
2087,2215272192,11791,2215283983,3,0,1,19456,3,256971905
2088,2215278170,786503,2216064673,14,0,0,16384,14,1257464285
2089,2215332574,860047,2216192621,36,0,0,8192,36,3952948037
2090,2215340164,428262,2215768426,5,0,0,39936,5,4412752462
2091,2215345073,26116,2215371189,32,0,1,39936,32,1585099942
2092,2215357304,908697,2216266001,47,0,0,78848,47,665136738
2093,2215404104,615857,2216019961,27,0,0,12288,27,417807844
2094,2215404304,557556,2215961860,46,0,0,2048,46,7604271337
2095,2215415600,672147,2216087747,15,0,0,23040,15,9253912380
2096,2215446921,1054799,2216501720,24,0,0,79872,24,6294750597
2097,2215451410,7229,2215458639,3,0,1,3584,3,5175349535
2098,2215468341,1994,2215470335,41,0,1,2048,41,4033627702
2099,2215483990,350717,2215834707,25,0,0,7168,25,4616830255
2100,2215503071,612931,2216116002,40,0,0,7680,40,671003806
2101,2215523371,950395,2216473766,5,0,0,58880,5,9161512456
2102,2215526151,758437,2216284588,14,0,0,60928,14,9565996486
2103,2215531779,879953,2216411732,49,0,0,10752,49,4270433295
2104,2215533108,646793,2216179901,32,0,0,47104,32,5399901009
2105,2215541713,1003805,2216545518,39,0,0,30720,39,3520110532
2106,2215596077,1070076,2216666153,49,0,0,40448,49,7644651858
2107,2215596729,475759,2216072488,39,0,0,25600,39,9622698869
2108,2215597017,216186,2215813203,26,0,0,3584,26,6234182281
2109,2215600267,11532,2215611799,7,0,1,2048,7,7330636109
2110,2215647384,551857,2216199241,34,0,0,3584,34,9595771376
2111,2215654534,1210783,2216865317,26,0,0,22016,26,6365569315
2112,2215668645,229064,2215897709,31,0,0,15872,31,10098025768
2113,2215670708,1354980,2217025688,2,0,0,42496,2,7663314214
2114,2215686402,104534,2215790936,46,0,1,4096,46,8010883338
2115,2215693392,607927,2216301319,7,0,0,54784,7,8144773940
2116,2215712883,764486,2216477369,6,0,0,11776,6,8607946539
2117,2215715963,247982,2215963945,3,0,0,5632,3,1186237399
2118,2215759587,545359,2216304946,5,0,0,11776,5,1929260909
2119,2215759603,1383144,2217142747,11,0,0,17920,11,8816732758
2120,2215768595,54701,2215823296,4,0,1,45568,4,5724405638
2121,2215805131,114082,2215919213,24,0,0,1536,24,6395880449
2122,2215805889,1544288,2217350177,2,0,0,5120,2,5284709440
2123,2215819312,614298,2216433610,5,0,0,52736,5,2191857862
2124,2215853631,505036,2216358667,32,0,0,26624,32,8036335810
2125,2215853638,142281,2215995919,10,0,0,3584,10,4025879758
2126,2215861006,304303,2216165309,27,0,0,1024,27,4373975674
2127,2215862554,56128,2215918682,11,0,1,4096,11,7739234473
2128,2215871449,546078,2216417527,45,0,0,18944,45,5038464394
2129,2215877650,530791,2216408441,48,0,0,28672,48,2549010987
2130,2215888359,32301,2215920660,15,0,1,2048,15,4071326924
2131,2215889658,722886,2216612544,27,0,0,2560,27,5769874684
2132,2215902162,462563,2216364725,42,0,0,7168,42,10076440513
2133,2215908943,546868,2216455811,33,0,0,32768,33,5075333795
2134,2215909399,641297,2216550696,12,0,0,16896,12,1087874727
2135,2215910217,740896,2216651113,5,0,0,35328,5,3298082399
2136,2215911037,608849,2216519886,4,0,0,23040,4,3633390894
2137,2215930463,582364,2216512827,17,0,0,36352,17,6719833996
2138,2215943928,820782,2216764710,45,0,0,36864,45,8785111658
2139,2215950876,771211,2216722087,3,0,0,30208,3,9617320302
2140,2215972452,335533,2216307985,31,0,0,2560,31,4994741902
2141,2215976206,24218,2216000424,8,0,1,15872,8,5456133159
2142,2215984202,17848,2216002050,35,0,1,2560,35,6599859865
2143,2215986041,584286,2216570327,21,0,0,19456,21,3979593810
2144,2215990773,251174,2216241947,7,0,0,37888,7,5447543553
2145,2216022863,159705,2216182568,40,0,0,8704,40,7710174951
2146,2216042209,665013,2216707222,44,0,0,64512,44,1772546998
2147,2216044992,726768,2216771760,29,0,0,18944,29,1765415754
2148,2216062974,702999,2216765973,25,0,0,4096,25,8408897787
2149,2216073757,312188,2216385945,25,0,0,2560,25,9994630565
2150,2216079826,7936,2216087762,19,0,1,11264,19,2112360635
2151,2216098825,717424,2216816249,47,0,0,76800,47,8178206779
2152,2216109787,447476,2216557263,27,0,0,21504,27,8354045261
2153,2216115097,509091,2216624188,12,0,0,3584,12,4490842271
2154,2216137115,45476,2216182591,18,0,1,54272,18,10586427547
2155,2216153062,859663,2217012725,22,0,0,33792,22,2621785368
2156,2216155475,281861,2216437336,12,0,0,2560,12,4380299705
2157,2216166736,649708,2216816444,23,0,0,512,23,6420063202
2158,2216178574,508977,2216687551,2,0,0,24064,2,4570988337
2159,2216187620,537446,2216725066,6,0,0,9728,6,3521879451
2160,2216198811,587035,2216785846,45,0,0,3584,45,9474898974
2161,2216209635,408504,2216618139,9,0,0,12800,9,2562877455
2162,2216227318,2946,2216230264,48,0,1,3072,48,3349693157
2163,2216229162,629416,2216858578,46,0,0,60928,46,3187351446
2164,2216229690,12272,2216241962,10,0,1,2048,10,3202318862
2165,2216246560,1121294,2217367854,4,0,0,12288,4,2648661295
2166,2216263360,122600,2216385960,30,0,1,141312,30,3761672095
2167,2216272633,302857,2216575490,16,0,0,16896,16,4379651468
2168,2216273568,1495767,2217769335,8,0,0,7168,8,3700968741
2169,2216289978,420255,2216710233,34,0,0,9728,34,9900545529
2170,2216296013,676943,2216972956,41,0,0,77312,41,9436203331
2171,2216307202,269239,2216576441,42,0,0,3072,42,8394511811
2172,2216307576,481109,2216788685,37,0,0,9216,37,4494066913
2173,2216315214,415959,2216731173,38,0,0,19968,38,10339752490
2174,2216318262,361942,2216680204,42,0,0,26112,42,3626880144
2175,2216333248,53034,2216386282,46,0,1,9728,46,3300685241
2176,2216345592,439147,2216784739,1,0,0,42496,1,3202600657
2177,2216352132,35430,2216387562,41,0,1,14336,41,3568243644
2178,2216353563,1105815,2217459378,26,0,0,9216,26,7669726603
2179,2216357041,462692,2216819733,32,0,0,1536,32,5372941565
2180,2216390922,1212039,2217602961,23,0,0,43520,23,3803326745
2181,2216398460,1042,2216399502,15,0,1,1024,15,6956440644
2182,2216407493,381987,2216789480,32,0,0,2560,32,7459578699
2183,2216418558,1028394,2217446952,40,0,0,3584,40,4262011429
2184,2216430361,519008,2216949369,15,0,0,51712,15,9342776452
2185,2216432167,450044,2216882211,26,0,0,52224,26,4365512111
2186,2216463242,534237,2216997479,15,0,0,80384,15,8848552234
2187,2216467226,444901,2216912127,6,0,0,76800,6,1449147073
2188,2216493351,663504,2217156855,34,0,0,5120,34,10471981405
2189,2216493500,643749,2217137249,26,0,0,44544,26,5086827306
2190,2216493716,27697,2216521413,8,0,1,1536,8,6429947200
2191,2216499962,840109,2217340071,1,0,0,24064,1,2435985738
2192,2216505719,525467,2217031186,48,0,0,9728,48,9308600755
2193,2216527804,17729,2216545533,48,0,1,16896,48,5272845962
2194,2216544884,755494,2217300378,9,0,0,30720,9,7625442156
2195,2216553353,506886,2217060239,37,0,0,39424,37,745079462
2196,2216559531,761943,2217321474,32,0,0,9216,32,8134658407
2197,2216561647,529864,2217091511,45,0,0,10240,45,7478776521
2198,2216573031,293237,2216866268,35,0,0,3072,35,5500630328
2199,2216610151,319504,2216929655,47,0,0,512,47,6134578123
2200,2216610836,593535,2217204371,24,0,0,12800,24,6758140000
2201,2216638114,778664,2217416778,1,0,0,30720,1,4870201701
2202,2216652636,84992,2216737628,4,0,1,138752,4,470757927
2203,2216654487,627848,2217282335,12,0,0,55808,12,1589665065
2204,2216670466,870695,2217541161,41,0,0,1024,41,5283120028
2205,2216672269,326185,2216998454,30,0,0,3072,30,6801605075
2206,2216676352,563168,2217239520,33,0,0,4608,33,10001287291
2207,2216696779,458501,2217155280,2,0,0,2048,2,2422448812
2208,2216721561,190893,2216912454,18,0,0,1024,18,1450466274
2209,2216727461,1805422,2218532883,37,0,0,7680,37,6144313955
2210,2216729567,12247,2216741814,11,0,1,6656,11,5511120088
2211,2216729902,298305,2217028207,12,0,0,8192,12,3576871918
2212,2216734891,790446,2217525337,34,0,0,67584,34,1023008037
2213,2216744674,989192,2217733866,47,0,0,7168,47,10365263992
2214,2216747341,321204,2217068545,23,0,0,12288,23,7902709012
2215,2216750448,869844,2217620292,38,0,0,56832,38,5078235396
2216,2216758804,1080137,2217838941,16,0,0,19456,16,3872193100
2217,2216766770,433670,2217200440,6,0,0,29696,6,9518888393
2218,2216774817,289969,2217064786,33,0,0,14848,33,9260020412
2219,2216775557,468871,2217244428,0,0,0,1536,0,1534788382
2220,2216790656,881059,2217671715,37,0,0,44544,37,9268995357
2221,2216793543,1079461,2217873004,43,0,0,12800,43,10140733750
2222,2216799209,236524,2217035733,21,0,0,14848,21,9221873910
2223,2216803405,351236,2217154641,20,0,0,17408,20,5383104234
2224,2216812757,818657,2217631414,20,0,0,11264,20,9621561987
2225,2216814752,732373,2217547125,23,0,0,14848,23,9651604568
2226,2216823579,366963,2217190542,36,0,0,47616,36,5847444713
2227,2216829672,3387,2216833059,12,0,1,9728,12,2502853749
2228,2216840441,918412,2217758853,6,0,0,27648,6,10604607346
2229,2216842589,584899,2217427488,48,0,0,8192,48,3576866141
2230,2216850657,457700,2217308357,25,0,0,26112,25,1076386267
2231,2216856534,526182,2217382716,43,0,0,15872,43,1193026263
2232,2216919834,731586,2217651420,11,0,0,64512,11,8261084264
2233,2216923112,1020171,2217943283,41,0,0,9728,41,10061533760
2234,2216933844,833292,2217767136,5,0,0,27136,5,4558024304
2235,2216935874,255471,2217191345,25,0,0,2560,25,6320985758
2236,2216946035,54323,2217000358,41,0,1,8704,41,1240002861
2237,2216965285,687242,2217652527,31,0,0,3584,31,7339726469
2238,2216972488,939632,2217912120,6,0,0,16384,6,8112489834
2239,2216972689,955713,2217928402,22,0,0,27136,22,10643690793
2240,2216993194,539357,2217532551,43,0,0,23552,43,3077073688
2241,2216993289,215785,2217209074,23,0,0,15360,23,3453938053
2242,2217007260,952240,2217959500,34,0,0,2048,34,513887291
2243,2217015422,1135808,2218151230,12,0,0,98304,12,4400850735
2244,2217020519,22912,2217043431,34,0,1,8192,34,3824390863
2245,2217045915,338064,2217383979,40,0,0,4096,40,9596064348
2246,2217056788,313577,2217370365,29,0,0,8192,29,8514120886
2247,2217077740,237632,2217315372,49,0,0,1536,49,5539315390
2248,2217081773,262213,2217343986,2,0,0,12800,2,4494172462
2249,2217084698,571752,2217656450,41,0,0,12800,41,1903295778
2250,2217096839,1605291,2218702130,26,0,0,39936,26,8010934075
2251,2217102901,328049,2217430950,39,0,0,6656,39,5986154126
2252,2217106554,897945,2218004499,22,0,0,13824,22,3959827350
2253,2217119405,3422,2217122827,46,0,1,3584,46,306149289
2254,2217120994,16270,2217137264,11,0,1,5120,11,54603750
2255,2217121717,211007,2217332724,27,0,0,7680,27,3505861113
2256,2217132583,1084886,2218217469,7,0,0,14336,7,8288924742
2257,2217145659,1605304,2218750963,19,0,0,13824,19,7274921585
2258,2217163068,2946,2217166014,33,0,1,3072,33,9751222302
2259,2217181580,1081643,2218263223,12,0,0,56832,12,3712653573
2260,2217182335,994182,2218176517,20,0,0,82944,20,3566941407
2261,2217186321,732404,2217918725,16,0,0,1024,16,4589139333
2262,2217186618,22471,2217209089,15,0,1,4096,15,7803805267
2263,2217188404,1076706,2218265110,21,0,0,6144,21,10164776827
2264,2217191499,918126,2218109625,22,0,0,19968,22,4748702813
2265,2217201523,291322,2217492845,21,0,0,7680,21,1934741249
2266,2217209607,986814,2218196421,23,0,0,1024,23,8134203476
2267,2217224812,591509,2217816321,43,0,0,30720,43,4762788608
2268,2217251449,1143154,2218394603,2,0,0,53248,2,6975879497
2269,2217265996,1053212,2218319208,10,0,0,5632,10,4981779031
2270,2217267602,650788,2217918390,40,0,0,14848,40,8372256127
2271,2217271089,970206,2218241295,40,0,0,46080,40,6333918238
2272,2217288104,214801,2217502905,6,0,0,22528,6,10034779331
2273,2217292465,1082912,2218375377,26,0,0,36352,26,7648724048
2274,2217304254,7007,2217311261,18,0,1,8704,18,728465065
2275,2217306552,633752,2217940304,2,0,0,11264,2,5503694607
2276,2217306701,321250,2217627951,19,0,0,25088,19,4159810277
2277,2217313272,542718,2217855990,19,0,0,9728,19,2455181162
2278,2217362386,1449749,2218812135,19,0,0,8704,19,8536001364
2279,2217363086,268663,2217631749,45,0,0,1024,45,5541698486
2280,2217363413,1203436,2218566849,22,0,0,72704,22,7748648919
2281,2217408108,270345,2217678453,32,0,0,22016,32,1838415856
2282,2217439772,510078,2217949850,38,0,0,21504,38,58243044
2283,2217445877,4195,2217450072,14,0,1,9216,14,8740867500
2284,2217454402,1286797,2218741199,48,0,0,46592,48,622640438
2285,2217458491,601658,2218060149,34,0,0,24064,34,7731190463
2286,2217472378,5326,2217477704,48,0,1,5632,48,9449607993
2287,2217474294,209847,2217684141,5,0,0,14336,5,2410321289
2288,2217495613,868387,2218364000,39,0,0,1024,39,8931230775
2289,2217496822,1096463,2218593285,20,0,0,57856,20,5649637243
2290,2217497665,27695,2217525360,2,0,1,8192,2,926573982
2291,2217504165,376186,2217880351,8,0,0,24064,8,635934194
2292,2217522782,929299,2218452081,43,0,0,46080,43,10152301891
2293,2217525117,411724,2217936841,3,0,0,27648,3,3350963116
2294,2217536735,1304458,2218841193,41,0,0,6144,41,9024187779
2295,2217574100,1294084,2218868184,1,0,0,8704,1,2035405930
2296,2217589384,916956,2218506340,36,0,0,8704,36,7155495294
2297,2217613237,654548,2218267785,8,0,0,8704,8,9290731068
2298,2217613375,43273,2217656648,7,0,1,11264,7,9930191251
2299,2217617911,1109077,2218726988,7,0,0,68608,7,7277354776
2300,2217648089,23641,2217671730,6,0,1,4608,6,1568575688
2301,2217656761,1297118,2218953879,28,0,0,8192,28,3339276392
2302,2217677413,777959,2218455372,18,0,0,10752,18,1958141991
2303,2217677950,1101965,2218779915,24,0,0,22528,24,4892286782
2304,2217691898,297181,2217989079,38,0,0,27136,38,6959410492
2305,2217692246,501914,2218194160,19,0,0,57856,19,3013135505
2306,2217712470,408793,2218121263,6,0,0,10752,6,9691559866
2307,2217713645,346987,2218060632,48,0,0,1536,48,5889821210
2308,2217718422,1362618,2219081040,40,0,0,19456,40,3066724444
2309,2217741526,2953,2217744479,14,0,1,3072,14,2127478587
2310,2217741574,877150,2218618724,21,0,0,15360,21,8754727553
2311,2217744311,329402,2218073713,48,0,0,5632,48,3196756774
2312,2217744617,1780057,2219524674,29,0,0,23040,29,1481450302
2313,2217746997,211682,2217958679,38,0,0,7168,38,4402485177
2314,2217775732,138119,2217913851,46,0,0,5632,46,404650254
2315,2217798888,40068,2217838956,27,0,1,56832,27,4486365651
2316,2217801741,37927,2217839668,32,0,1,22528,32,614461665
2317,2217830156,12738,2217842894,15,0,1,5120,15,9836741888
2318,2217852128,890966,2218743094,43,0,0,6144,43,8059855201
2319,2217855187,1250185,2219105372,9,0,0,12800,9,8934356332
2320,2217855419,1214847,2219070266,47,0,0,34816,47,9408122230
2321,2217872539,10750,2217883289,29,0,1,3072,29,4027235090
2322,2217888565,12825,2217901390,1,0,1,21504,1,8537120406
2323,2217891045,1047287,2218938332,42,0,0,11264,42,7584864377
2324,2217902825,1042,2217903867,43,0,1,1024,43,7181402735
2325,2217913151,281804,2218194955,3,0,0,2560,3,5782337495
2326,2217926488,46529,2217973017,27,0,1,38400,27,6178516953
2327,2217927216,268862,2218196078,32,0,0,3584,32,3944367049
2328,2217939326,766719,2218706045,12,0,0,12800,12,544996988
2329,2217942987,381861,2218324848,22,0,0,11776,22,3476915912
2330,2217978094,21399,2217999493,34,0,1,34816,34,1446519247
2331,2217987295,17219,2218004514,48,0,1,1536,48,162357554
2332,2217993086,324391,2218317477,19,0,0,37888,19,7795129864
2333,2217996518,1689580,2219686098,30,0,0,6144,30,1177338727
2334,2218009692,1614797,2219624489,18,0,0,67072,18,2666061823
2335,2218022875,377515,2218400390,36,0,0,18944,36,4411326130
2336,2218022898,389691,2218412589,46,0,0,39936,46,5540372195
2337,2218032872,399319,2218432191,27,0,0,25088,27,5821702215
2338,2218060444,3602,2218064046,2,0,1,3584,2,5982974213
2339,2218079566,496076,2218575642,33,0,0,14848,33,10119549128
2340,2218085992,935129,2219021121,18,0,0,17920,18,6740549710
2341,2218104055,172314,2218276369,28,0,0,3072,28,4072525872
2342,2218110892,267472,2218378364,35,0,0,9728,35,7546342585
2343,2218116501,692943,2218809444,44,0,0,41984,44,5775926749
2344,2218131488,819880,2218951368,14,0,0,29696,14,6589499067
2345,2218143656,55770,2218199426,40,0,1,3072,40,1797159754
2346,2218165388,673918,2218839306,6,0,0,19456,6,535043246
2347,2218174669,28484,2218203153,33,0,1,14336,33,5113326100
2348,2218179992,323673,2218503665,43,0,0,6656,43,5287939321
2349,2218185601,330991,2218516592,45,0,0,512,45,2549798700
2350,2218186263,493053,2218679316,33,0,0,71680,33,8093459336
2351,2218188105,1645779,2219833884,24,0,0,36352,24,3562422338
2352,2218195819,494128,2218689947,8,0,0,34816,8,8148528564
2353,2218203702,13858,2218217560,32,0,1,23552,32,9258441315
2354,2218207979,445236,2218653215,14,0,0,5120,14,9630717460
2355,2218211288,12173,2218223461,41,0,1,19968,41,642366307
2356,2218214085,27225,2218241310,14,0,1,7680,14,5143363203
2357,2218220936,399519,2218620455,38,0,0,5632,38,1736172563
2358,2218226915,369083,2218595998,31,0,0,8704,31,10651938256
2359,2218236125,237931,2218474056,43,0,0,10240,43,9198786751
2360,2218236377,975585,2219211962,31,0,0,69120,31,4326227861
2361,2218252869,639435,2218892304,41,0,0,4096,41,6446728996
2362,2218262046,1084754,2219346800,15,0,0,122368,15,1400259934
2363,2218265147,1188244,2219453391,44,0,0,36352,44,10150385279
2364,2218266405,763623,2219030028,2,0,0,29184,2,10255953036
2365,2218278674,641701,2218920375,1,0,0,22528,1,8337558812
2366,2218289039,570427,2218859466,1,0,0,18432,1,1752185393
2367,2218319064,1317653,2219636717,37,0,0,4608,37,875594579
2368,2218327311,543662,2218870973,9,0,0,5632,9,3139039774
2369,2218337661,1518,2218339179,19,0,1,1536,19,1397390043
2370,2218340216,542314,2218882530,36,0,0,31744,36,7318983056
2371,2218341260,405476,2218746736,15,0,0,5120,15,9433634969
2372,2218347768,606750,2218954518,6,0,0,2048,6,1799022798
2373,2218361652,773951,2219135603,30,0,0,17920,30,356328939
2374,2218365969,379184,2218745153,6,0,0,6656,6,8970040006
2375,2218389175,154456,2218543631,36,0,0,5632,36,1631372041
2376,2218389887,2035850,2220425737,37,0,0,5632,37,1096464233
2377,2218416037,707386,2219123423,14,0,0,55808,14,1748673744
2378,2218421707,1863039,2220284746,30,0,0,55808,30,9184754430
2379,2218430186,2563,2218432749,14,0,1,512,14,7708684112
2380,2218453351,340307,2218793658,5,0,0,45056,5,9924438715
2381,2218454233,561413,2219015646,8,0,0,29696,8,1723263610
2382,2218457603,469459,2218927062,15,0,0,6144,15,2021268790
2383,2218459125,897304,2219356429,5,0,0,24576,5,9154270239
2384,2218481930,1042,2218482972,29,0,1,1024,29,5718370919
2385,2218484144,794811,2219278955,34,0,0,12288,34,1240489425
2386,2218492067,1844562,2220336629,1,0,0,5632,1,3093307493
2387,2218501753,7492,2218509245,32,0,1,3072,32,5334496463
2388,2218505545,16010,2218521555,0,0,1,27648,0,9935466219
2389,2218509206,13015,2218522221,14,0,1,1024,14,5513834582
2390,2218511668,12179,2218523847,19,0,1,2560,19,9671003238
2391,2218528693,5326,2218534019,32,0,1,5632,32,5358721526
2392,2218545722,705982,2219251704,48,0,0,34816,48,7469162117
2393,2218547088,46212,2218593300,33,0,1,14848,33,8002367118
2394,2218552814,481456,2219034270,44,0,0,12800,44,7965450575
2395,2218553453,485535,2219038988,28,0,0,14336,28,7052940329
2396,2218559204,34119,2218593323,24,0,1,6656,24,2926772144
2397,2218561767,416505,2218978272,32,0,0,2048,32,5437966540
2398,2218565329,231308,2218796637,3,0,0,9728,3,8284341349
2399,2218575456,1944079,2220519535,11,0,0,19968,11,2187104328
2400,2218580123,713725,2219293848,16,0,0,19968,16,10735279937
2401,2218593269,240079,2218833348,14,0,0,15360,14,6021028731
2402,2218606484,373108,2218979592,31,0,0,4096,31,7547496293
2403,2218612012,474199,2219086211,47,0,0,14336,47,3693701320
2404,2218618885,12336,2218631221,14,0,1,17408,14,5886997249
2405,2218619498,546465,2219165963,48,0,0,19456,48,873425886
2406,2218665303,339885,2219005188,19,0,0,19456,19,3495715100
2407,2218690140,60838,2218750978,24,0,1,512,24,9190697154
2408,2218690206,383975,2219074181,3,0,0,12800,3,10154149670
2409,2218690620,461429,2219152049,48,0,0,27648,48,4260448467
2410,2218716641,935231,2219651872,49,0,0,49664,49,1614117366
2411,2218725167,716737,2219441904,17,0,0,100352,17,10049846696
2412,2218730137,538283,2219268420,33,0,0,2048,33,9922561391
2413,2218757724,1089302,2219847026,15,0,0,7680,15,5455445980
2414,2218759858,1992238,2220752096,46,0,0,43520,46,3161686124
2415,2218766766,719246,2219486012,18,0,0,38912,18,741973553
2416,2218771599,902010,2219673609,30,0,0,4608,30,3619523195
2417,2218772108,1844177,2220616285,16,0,0,8704,16,732974964
2418,2218789673,24415,2218814088,33,0,1,2048,33,3309629570
2419,2218795296,512742,2219308038,37,0,0,12800,37,3074733889
2420,2218801899,228456,2219030355,24,0,0,1024,24,5401117274
2421,2218813943,220662,2219034605,15,0,0,1024,15,5313786553
2422,2218818394,564110,2219382504,2,0,0,20480,2,951125266
2423,2218822906,2085983,2220908889,47,0,0,60928,47,2722021413
2424,2218822966,10397,2218833363,33,0,1,6656,33,1748485209
2425,2218824480,335540,2219160020,33,0,0,26112,33,2771255639
2426,2218863667,400817,2219264484,27,0,0,14336,27,5692295778
2427,2218871276,477612,2219348888,29,0,0,6656,29,5087547781
2428,2218878151,929036,2219807187,7,0,0,18432,7,6609537136
2429,2218889182,584951,2219474133,42,0,0,33280,42,8266011842
2430,2218926401,171954,2219098355,48,0,0,1536,48,3777193212
2431,2218967401,1166641,2220134042,21,0,0,32256,21,3249592342
2432,2218972324,581786,2219554110,7,0,0,31744,7,8585935411
2433,2218991336,2010319,2221001655,42,0,0,51712,42,5566368069
2434,2219029552,13293,2219042845,34,0,1,4096,34,4215839335
2435,2219038884,736488,2219775372,35,0,0,71168,35,8533635119
2436,2219044203,14117,2219058320,16,0,1,24064,16,5473675012
2437,2219048988,984033,2220033021,26,0,0,14336,26,5253803911
2438,2219049584,602950,2219652534,5,0,0,2048,5,6362744699
2439,2219074510,869563,2219944073,1,0,0,77312,1,9843086308
2440,2219080346,456467,2219536813,23,0,0,14336,23,7356498181
2441,2219086660,79318,2219165978,3,0,1,107520,3,4719633417
2442,2219090527,544771,2219635298,25,0,0,32768,25,8523140710
2443,2219098778,248037,2219346815,18,0,1,322560,18,7294051625
2444,2219109223,927884,2220037107,19,0,0,13312,19,5043926624
2445,2219122062,224768,2219346830,32,0,1,5120,32,6377613647
2446,2219137048,525226,2219662274,44,0,0,1024,44,3282322947
2447,2219137521,524418,2219661939,31,0,0,1536,31,2357983002
2448,2219143612,548141,2219691753,3,0,0,8704,3,8811404945
2449,2219160744,443294,2219604038,1,0,0,53248,1,4910617252
2450,2219166080,907992,2220074072,2,0,0,16896,2,5807716192
2451,2219175469,1034369,2220209838,20,0,0,34304,20,1208513612
2452,2219182231,557961,2219740192,27,0,0,47104,27,398919634
2453,2219184651,1124953,2220309604,26,0,0,69120,26,2688977276
2454,2219204662,456794,2219661456,9,0,0,29184,9,6847449038
2455,2219236893,272736,2219509629,38,0,0,33280,38,964137612
2456,2219252869,93976,2219346845,48,0,1,8192,48,2011512650
2457,2219256224,92687,2219348911,41,0,1,5632,41,6131254975
2458,2219264581,84345,2219348926,48,0,1,5120,48,5366873286
2459,2219271202,786820,2220058022,20,0,0,29184,20,6749550533
2460,2219289953,66491,2219356444,10,0,1,4096,10,10704883014
2461,2219297585,815180,2220112765,32,0,0,10240,32,1275327988
2462,2219308767,540770,2219849537,34,0,0,8192,34,6767068829
2463,2219331064,902033,2220233097,43,0,0,76288,43,3018006165
2464,2219356323,989252,2220345575,3,0,0,10240,3,10091000175
2465,2219371466,381174,2219752640,43,0,0,13312,43,6200011794
2466,2219373286,615456,2219988742,47,0,0,100352,47,5216548848
2467,2219373306,251978,2219625284,44,0,0,2560,44,6344533477
2468,2219376106,1705460,2221081566,2,0,0,11776,2,4198142326
2469,2219377229,622330,2219999559,6,0,0,25088,6,8274024705
2470,2219380210,345615,2219725825,40,0,0,35328,40,9266593709
2471,2219385501,459162,2219844663,21,0,0,35328,21,4834760426
2472,2219395580,607629,2220003209,19,0,0,4608,19,6954838022
2473,2219406331,585561,2219991892,29,0,0,512,29,6405328795
2474,2219418259,573462,2219991721,31,0,0,9728,31,3588229290
2475,2219440962,45089,2219486051,3,0,1,68096,3,10688601574
2476,2219450715,507436,2219958151,24,0,0,20480,24,8088485027
2477,2219454418,648207,2220102625,15,0,0,19456,15,7372133687
2478,2219469389,23336,2219492725,46,0,1,7168,46,4297727367
2479,2219475618,1811938,2221287556,28,0,0,19456,28,9229970253
2480,2219478999,549624,2220028623,8,0,0,38912,8,619082422
2481,2219484644,580569,2220065213,45,0,0,23552,45,6565069889
2482,2219492207,830805,2220323012,33,0,0,25088,33,6982175874
2483,2219493998,2470,2219496468,0,0,1,2560,0,3248940274
2484,2219501236,12759,2219513995,43,0,1,4608,43,9721044593
2485,2219519016,577666,2220096682,19,0,0,22016,19,5741701927
2486,2219523812,4266,2219528078,34,0,1,9728,34,4299984837
2487,2219532441,419447,2219951888,8,0,0,25600,8,9959074301
2488,2219534766,607559,2220142325,5,0,0,27136,5,9931118742
2489,2219535628,882760,2220418388,47,0,0,8192,47,9496515949
2490,2219542613,82686,2219625299,18,0,1,83968,18,6201064747
2491,2219544353,899972,2220444325,43,0,0,6144,43,135224434
2492,2219550487,101400,2219651887,0,0,1,55808,0,1231468919
2493,2219558634,622949,2220181583,26,0,0,16896,26,7976590011
2494,2219560618,91931,2219652549,10,0,1,6656,10,9215861387
2495,2219563378,588182,2220151560,37,0,0,30208,37,3691036806
2496,2219571795,1013961,2220585756,6,0,0,8192,6,2053181509
2497,2219609342,647052,2220256394,44,0,0,34816,44,3014927865
2498,2219613029,563368,2220176397,16,0,0,33792,16,5554128043
2499,2219639060,362698,2220001758,14,0,0,7168,14,6446505742
2500,2219655813,888046,2220543859,47,0,0,64512,47,9622263925
2501,2219663734,457582,2220121316,21,0,0,24064,21,10081064961
2502,2219687444,1899097,2221586541,48,0,0,9728,48,4973746528
2503,2219689767,573834,2220263601,36,0,0,23552,36,7609813924
2504,2219734480,821242,2220555722,21,0,0,4096,21,3829489287
2505,2219736575,509196,2220245771,23,0,0,17920,23,7907582427
2506,2219759722,528799,2220288521,24,0,0,12288,24,4441160856
2507,2219779188,615527,2220394715,41,0,0,5120,41,6980770750
2508,2219785426,454862,2220240288,19,0,0,23552,19,10637546749
2509,2219787080,906148,2220693228,32,0,0,61440,32,8432037286
2510,2219799023,836134,2220635157,14,0,0,14336,14,6141508730
2511,2219802274,508437,2220310711,20,0,0,3584,20,397263106
2512,2219805238,1028026,2220833264,48,0,0,44544,48,4719051397
2513,2219815579,785909,2220601488,25,0,0,19456,25,5223029712
2514,2219836846,430842,2220267688,23,0,0,13312,23,5026917500
2515,2219844358,830127,2220674485,7,0,0,38400,7,7902629700
2516,2219911584,492045,2220403629,48,0,0,512,48,796284678
2517,2219926038,693538,2220619576,9,0,0,10752,9,4465895727
2518,2219954850,387574,2220342424,16,0,0,18944,16,7031962401
2519,2219964680,531309,2220495989,41,0,0,55808,41,10549516069
2520,2219969247,365651,2220334898,27,0,0,38912,27,5111520661
2521,2219973585,33606,2220007191,35,0,1,4096,35,10166705526
2522,2219978089,211969,2220190058,37,0,0,1536,37,3762837764
2523,2219983907,996413,2220980320,28,0,0,32256,28,9824530521
2524,2219986856,483675,2220470531,21,0,0,43520,21,4002158060
2525,2219991806,36832,2220028638,19,0,1,23040,19,8583241967
2526,2219992790,1856191,2221848981,33,0,0,112640,33,4279613686
2527,2219996734,36302,2220033036,32,0,1,19968,32,8267587514
2528,2220043847,456401,2220500248,36,0,0,13824,36,3628454820
2529,2220066281,7806,2220074087,0,0,1,12800,0,9642072797
2530,2220074574,404396,2220478970,33,0,0,27648,33,3768198329
2531,2220091123,305166,2220396289,38,0,0,512,38,8357297125
2532,2220129609,34993,2220164602,21,0,1,22016,21,8597199436
2533,2220130345,654245,2220784590,15,0,0,74240,15,909094818
2534,2220150999,25413,2220176412,33,0,1,6656,33,9609752952
2535,2220159315,797411,2220956726,24,0,0,59392,24,10529279965
2536,2220161324,687999,2220849323,46,0,0,30720,46,7463958490
2537,2220162567,576246,2220738813,29,0,0,73216,29,4513920025
2538,2220169081,14455,2220183536,12,0,1,2048,12,5275155329
2539,2220215912,51791,2220267703,19,0,1,4096,19,745849860
2540,2220248210,613608,2220861818,22,0,0,40960,22,5381255052
2541,2220253419,717058,2220970477,15,0,0,45056,15,3055147278
2542,2220254791,1087761,2221342552,20,0,0,43520,20,10108340525
2543,2220262038,789791,2221051829,16,0,0,21504,16,7753259478
2544,2220265280,378160,2220643440,3,0,0,27136,3,3692925059
2545,2220265666,45068,2220310734,3,0,1,5120,3,3782226800
2546,2220267932,494015,2220761947,28,0,0,32256,28,6552233112
2547,2220269716,531753,2220801469,8,0,0,55296,8,7250258158
2548,2220285788,744377,2221030165,17,0,0,512,17,3703812788
2549,2220303746,19281,2220323027,29,0,1,13824,29,3311379010
2550,2220313213,764742,2221077955,33,0,0,30208,33,9288156524
2551,2220320689,24917,2220345606,24,0,1,1536,24,5261342671
2552,2220337395,791098,2221128493,10,0,0,23552,10,1518474630
2553,2220339226,583385,2220922611,22,0,0,19968,22,6339405460
2554,2220342325,660008,2221002333,47,0,0,2048,47,1473555270
2555,2220350755,525776,2220876531,15,0,0,19968,15,7776147853
2556,2220352939,776037,2221128976,25,0,0,1536,25,3148774791
2557,2220368385,440422,2220808807,14,0,0,8704,14,7261303076
2558,2220400469,583508,2220983977,30,0,0,11776,30,2243826830
2559,2220402525,642363,2221044888,5,0,0,13312,5,7779317963
2560,2220419122,730153,2221149275,11,0,0,27648,11,5313554631
2561,2220419752,202730,2220622482,48,0,0,1536,48,764237043
2562,2220420756,673335,2221094091,40,0,0,12288,40,985027779
2563,2220434464,847133,2221281597,4,0,0,44544,4,1192496842
2564,2220437900,192874,2220630774,19,0,0,3584,19,8929315136
2565,2220473914,663748,2221137662,26,0,0,10752,26,892690228
2566,2220475938,1492650,2221968588,6,0,0,13312,6,1603437397
2567,2220476121,31792,2220507913,48,0,1,8192,48,391578134
2568,2220478548,609897,2221088445,23,0,0,22528,23,7673668102
2569,2220508216,566,2220508782,8,0,1,512,8,3611330416
2570,2220515444,740663,2221256107,24,0,0,43008,24,2297781385
2571,2220524092,969964,2221494056,45,0,0,44032,45,3166760140
2572,2220540873,7398,2220548271,20,0,1,11776,20,4896030601
2573,2220549768,718218,2221267986,17,0,0,38912,17,2471695615
2574,2220556687,6278,2220562965,41,0,1,6656,41,5544384186
2575,2220577780,954755,2221532535,48,0,0,79360,48,7467022130
2576,2220579307,3422,2220582729,8,0,1,3584,8,3240628846
2577,2220582041,995077,2221577118,19,0,0,12800,19,10622729900
2578,2220586243,918155,2221504398,8,0,0,12800,8,4173689270
2579,2220600677,611636,2221212313,3,0,0,14336,3,3614639828
2580,2220615174,1560930,2222176104,8,0,0,86528,8,3374351871
2581,2220626409,814813,2221441222,1,0,0,40448,1,10113608715
2582,2220628580,540821,2221169401,20,0,0,18432,20,5466621711
2583,2220668833,888131,2221556964,36,0,0,29696,36,5922901486
2584,2220691599,5519,2220697118,14,0,1,4096,14,10420314510
2585,2220699128,1329740,2222028868,30,0,0,17920,30,8560847725
2586,2220707835,500095,2221207930,21,0,0,40960,21,1381785968
2587,2220715869,713014,2221428883,16,0,0,88576,16,7261972626
2588,2220725366,470053,2221195419,44,0,0,19968,44,579806553
2589,2220734475,283172,2221017647,5,0,0,11264,5,1558859205
2590,2220740332,350000,2221090332,21,0,0,6144,21,1760773105
2591,2220743705,65117,2220808822,20,0,1,5120,20,3060830155
2592,2220755303,1194823,2221950126,36,0,0,43520,36,9323725202
2593,2220775062,798141,2221573203,45,0,0,53248,45,5550288844
2594,2220777047,1032687,2221809734,7,0,0,16896,7,9324946814
2595,2220802615,526654,2221329269,31,0,0,47616,31,5311528623
2596,2220806825,4459,2220811284,34,0,1,2560,34,3506395254
2597,2220833444,714457,2221547901,48,0,0,24064,48,3995218765
2598,2220852883,127460,2220980343,30,0,1,158720,30,6085281514
2599,2220870343,880855,2221751198,11,0,0,19456,11,10733660403
2600,2220871842,857842,2221729684,10,0,0,37376,10,5947038276
2601,2220901505,1419225,2222320730,1,0,0,94720,1,550787408
2602,2220904378,440857,2221345235,35,0,0,8704,35,10586147837
2603,2220915103,1266827,2222181930,36,0,0,18944,36,2767580262
2604,2220930345,50013,2220980358,37,0,1,8704,37,4006674449
2605,2220940301,1159888,2222100189,31,0,0,88064,31,9489067025
2606,2220956224,45454,2221001678,49,0,1,5120,49,16376407
2607,2220957956,820004,2221777960,43,0,0,34816,43,8456168475
2608,2220965320,419395,2221384715,9,0,0,6656,9,385340097
2609,2220985612,1455530,2222441142,49,0,0,80896,49,3821518393
2610,2220988366,18300,2221006666,46,0,1,4608,46,2199508264
2611,2220991184,489441,2221480625,41,0,0,78336,41,2210306855
2612,2220994364,297107,2221291471,36,0,0,12800,36,7522861795
2613,2221008712,1319856,2222328568,1,0,0,13312,1,6066861188
2614,2221012366,429651,2221442017,3,0,0,2560,3,1455784541
2615,2221037562,405562,2221443124,28,0,0,3584,28,1713728803
2616,2221047738,303531,2221351269,4,0,0,1024,4,233466494
2617,2221059628,548143,2221607771,25,0,0,30720,25,1711448779
2618,2221068766,1181269,2222250035,23,0,0,13312,23,1756499811
2619,2221108409,658920,2221767329,25,0,0,49152,25,6605522293
2620,2221119168,685403,2221804571,7,0,0,14848,7,10600174312
2621,2221126952,744986,2221871938,3,0,0,34304,3,2397533321
2622,2221147347,725426,2221872773,36,0,0,2560,36,3203248999
2623,2221147882,352601,2221500483,46,0,0,20992,46,9783702236
2624,2221151081,1490582,2222641663,5,0,0,11776,5,7568254106
2625,2221160857,1224836,2222385693,46,0,0,41984,46,1792072550
2626,2221185325,351593,2221536918,5,0,0,14336,5,2698472949
2627,2221190761,253914,2221444675,6,0,0,1024,6,6385796100
2628,2221191921,36447,2221228368,18,0,1,31232,18,4163089776
2629,2221203376,167206,2221370582,27,0,0,5632,27,4152286259
2630,2221212931,768308,2221981239,36,0,0,14848,36,4250363393
2631,2221214992,397447,2221612439,14,0,0,10752,14,10212916436
2632,2221226336,351429,2221577765,24,0,0,2048,24,688634407
2633,2221233898,730603,2221964501,18,0,0,47104,18,5671723168
2634,2221243600,262873,2221506473,46,0,0,6656,46,10113041858
2635,2221245683,45803,2221291486,34,0,1,14336,34,3236635837
2636,2221247039,552978,2221800017,44,0,0,10240,44,4477684682
2637,2221260171,526704,2221786875,11,0,0,29184,11,3092244285
2638,2221270142,1207827,2222477969,20,0,0,22016,20,6484471403
2639,2221287822,451237,2221739059,37,0,0,30720,37,2210930084
2640,2221305467,484075,2221789542,44,0,0,8704,44,5110085334
2641,2221307107,365611,2221672718,48,0,0,9728,48,9446192693
2642,2221313061,1224413,2222537474,23,0,0,71168,23,2578449075
2643,2221316082,480511,2221796593,33,0,0,23040,33,6625892139
2644,2221322992,23720,2221346712,35,0,1,1536,35,4512821589
2645,2221325006,788662,2222113668,36,0,0,44032,36,6832092351
2646,2221364660,2946,2221367606,43,0,1,3072,43,8191841551
2647,2221372127,1174057,2222546184,35,0,0,6656,35,9211538295
2648,2221444075,5802,2221449877,4,0,1,6144,4,6479604316
2649,2221446785,214245,2221661030,36,0,0,6656,36,8801762598
2650,2221460283,613059,2222073342,43,0,0,94208,43,1338292723
2651,2221466892,39604,2221506496,35,0,1,1024,35,5560045843
2652,2221488331,836166,2222324497,3,0,0,12288,3,2042789240
2653,2221492760,44173,2221536933,19,0,1,3072,19,6462867194
2654,2221493716,443135,2221936851,30,0,0,15360,30,8258308604
2655,2221509696,341648,2221851344,47,0,0,7680,47,1235230516
2656,2221525298,13663,2221538961,44,0,1,2048,44,4052796155
2657,2221527227,804195,2222331422,40,0,0,5120,40,10549528252
2658,2221539574,462666,2222002240,35,0,0,6144,35,6135863648
2659,2221548549,489420,2222037969,39,0,0,23040,39,4225909446
2660,2221613080,736988,2222350068,1,0,0,41984,1,794693526
2661,2221615237,533458,2222148695,7,0,0,22016,7,3614759869
2662,2221640386,811581,2222451967,44,0,0,17920,44,603914682
2663,2221650634,261819,2221912453,25,0,0,512,25,9188819517
2664,2221654418,482855,2222137273,4,0,0,14336,4,5065961605
2665,2221659911,371008,2222030919,18,0,0,6656,18,4880445511
2666,2221673050,1112501,2222785551,18,0,0,42496,18,7015371920
2667,2221679809,1021032,2222700841,25,0,0,13312,25,6019952815
2668,2221681033,831263,2222512296,6,0,0,32768,6,5471101569
2669,2221692206,5196,2221697402,0,0,1,13312,0,7965570483
2670,2221703714,975485,2222679199,4,0,0,52736,4,179753770
2671,2221715388,23686,2221739074,0,0,1,23552,0,10262358559
2672,2221732388,555864,2222288252,6,0,0,58368,6,10487301989
2673,2221735074,472373,2222207447,2,0,0,4608,2,346144360
2674,2221735698,1293890,2223029588,17,0,0,72704,17,4730344334
2675,2221745916,298436,2222044352,6,0,0,7168,6,9876475155
2676,2221757680,1014908,2222772588,49,0,0,37888,49,585170809
2677,2221760079,36545,2221796624,34,0,1,5632,34,9278557999
2678,2221771463,28569,2221800032,9,0,1,512,9,3194963372
2679,2221791368,1321093,2223112461,49,0,0,69632,49,5347153839
2680,2221798829,11939,2221810768,32,0,1,1024,32,10574358659
2681,2221840232,34279,2221874511,34,0,1,38400,34,6394859156
2682,2221850458,27599,2221878057,33,0,1,5632,33,10729541293
2683,2221852449,280396,2222132845,28,0,0,55296,28,5388692191
2684,2221853932,24279,2221878211,8,0,1,8704,8,10416771385
2685,2221856557,435298,2222291855,44,0,0,11776,44,10650768925
2686,2221860287,21023,2221881310,21,0,1,12800,21,5294819442
2687,2221901980,337756,2222239736,27,0,0,26112,27,2289382893
2688,2221920607,521346,2222441953,25,0,0,2560,25,9689681565
2689,2221929542,462726,2222392268,6,0,0,21504,6,1574069620
2690,2221931113,566,2221931679,46,0,1,512,46,1909300813
2691,2221935889,544450,2222480339,19,0,0,7680,19,5705337332
2692,2221941464,390761,2222332225,44,0,0,2560,44,5099645053
2693,2221953026,28228,2221981254,41,0,1,16896,41,7365421497
2694,2221965344,838468,2222803812,41,0,0,14336,41,5450722939
2695,2221985860,418708,2222404568,1,0,0,19456,1,5843731108
2696,2222016958,378572,2222395530,33,0,0,7168,33,5573511733
2697,2222018733,627909,2222646642,5,0,0,13824,5,2400234875
2698,2222021012,9922,2222030934,20,0,1,11264,20,7504331497
2699,2222021257,384101,2222405358,30,0,0,512,30,5790746777
2700,2222030472,9024,2222039496,8,0,1,1536,8,7621132916
2701,2222031099,13268,2222044367,46,0,1,4608,46,9748170802
2702,2222056463,529858,2222586321,22,0,0,55808,22,1395973055
2703,2222059748,73112,2222132860,12,0,1,15872,12,1764801598
2704,2222060899,677258,2222738157,32,0,0,23040,32,10624784549
2705,2222063901,68974,2222132875,48,0,1,2560,48,10172837754
2706,2222067908,64982,2222132890,4,0,1,4608,4,6008197414
2707,2222071086,424064,2222495150,21,0,0,3072,21,6981358019
2708,2222085556,63154,2222148710,3,0,1,43008,3,9208321076
2709,2222093226,236613,2222329839,45,0,0,4096,45,649654370
2710,2222105214,267330,2222372544,31,0,0,43520,31,6469405699
2711,2222111815,1222436,2223334251,9,0,0,12800,9,5628314546
2712,2222112764,780838,2222893602,34,0,0,19456,34,9393692485
2713,2222116238,1373399,2223489637,39,0,0,46592,39,5922574194
2714,2222116793,372297,2222489090,2,0,0,28672,2,2584973044
2715,2222128533,228524,2222357057,7,0,0,3072,7,55517786
2716,2222129853,477609,2222607462,45,0,0,11264,45,3480635262
2717,2222145746,792365,2222938111,20,0,0,57856,20,3539760442
2718,2222146045,30074,2222176119,24,0,1,1536,24,9892185852
2719,2222150312,575236,2222725548,12,0,0,21504,12,4446985339
2720,2222150736,442091,2222592827,35,0,0,4096,35,3874601278
2721,2222163221,632915,2222796136,47,0,0,6656,47,1744243545
2722,2222170875,275617,2222446492,27,0,0,14848,27,5035649825
2723,2222176186,542795,2222718981,15,0,0,30208,15,479665136
2724,2222182830,998070,2223180900,38,0,0,9216,38,8327600147
2725,2222183520,1518,2222185038,33,0,1,1536,33,10409727111
2726,2222185260,7706,2222192966,32,0,1,8192,32,4961851730
2727,2222210592,475829,2222686421,38,0,0,7680,38,9639259200
2728,2222213120,4679,2222217799,41,0,1,12288,41,962438095
2729,2222247350,125521,2222372871,36,0,0,1024,36,6840188449
2730,2222248990,1329067,2223578057,42,0,0,16896,42,6500463805
2731,2222252051,663478,2222915529,25,0,0,2560,25,3106963707
2732,2222256060,283160,2222539220,31,0,0,5632,31,8933766750
2733,2222291648,929698,2223221346,10,0,0,45056,10,3446784170
2734,2222307723,677705,2222985428,38,0,0,89088,38,10198361492
2735,2222309063,561374,2222870437,5,0,0,36352,5,194097331
2736,2222314120,510085,2222824205,21,0,0,12288,21,8979339632
2737,2222337396,35490,2222372886,11,0,1,22528,11,9865894773
2738,2222352457,641293,2222993750,34,0,0,5632,34,1193690760
2739,2222352531,521608,2222874139,30,0,0,9216,30,7121641876
2740,2222357364,917966,2223275330,14,0,0,79360,14,9204864139
2741,2222380786,15339,2222396125,0,0,1,4096,0,7379020307
2742,2222389788,672145,2223061933,11,0,0,7168,11,8473001615
2743,2222409662,1518,2222411180,41,0,1,1536,41,2739325258
2744,2222417352,437283,2222854635,12,0,0,60928,12,2893842934
2745,2222418944,400223,2222819167,19,0,0,17408,19,2509197217
2746,2222451397,369033,2222820430,5,0,0,4096,5,594291039
2747,2222458163,459973,2222918136,16,0,0,3072,16,1529411444
2748,2222469550,8434,2222477984,36,0,1,4608,36,7552811981
2749,2222488552,300298,2222788850,49,0,0,10752,49,4709510440
2750,2222502378,1165341,2223667719,22,0,0,65024,22,7638700228
2751,2222506234,485761,2222991995,1,0,0,21504,1,9916011760
2752,2222513958,23531,2222537489,32,0,1,4096,32,2213385655
2753,2222549374,954669,2223504043,17,0,0,5632,17,962155683
2754,2222558404,480715,2223039119,37,0,0,31232,37,6743899576
2755,2222572091,478369,2223050460,35,0,0,2560,35,10605135771
2756,2222577444,536124,2223113568,9,0,0,3584,9,4280911048
2757,2222581934,15979,2222597913,34,0,1,18944,34,240112991
2758,2222586133,13163,2222599296,20,0,1,14848,20,5385443864
2759,2222589887,269443,2222859330,16,0,0,15360,16,7906617826
2760,2222596876,13083,2222609959,31,0,1,22016,31,4965972392
2761,2222603650,11455,2222615105,15,0,1,8192,15,968769512
2762,2222607238,1157587,2223764825,37,0,0,32768,37,6982253725
2763,2222607393,8058,2222615451,21,0,1,512,21,450867800
2764,2222628455,414431,2223042886,46,0,0,12288,46,1516570119
2765,2222646804,655555,2223302359,15,0,0,14336,15,5674173818
2766,2222687092,386856,2223073948,30,0,0,5120,30,8746100471
2767,2222691137,1250802,2223941939,3,0,0,28160,3,1265613263
2768,2222693882,586338,2223280220,11,0,0,9216,11,4841365635
2769,2222698710,462186,2223160896,49,0,0,34304,49,6846076429
2770,2222712385,565004,2223277389,42,0,0,6656,42,9879081976
2771,2222717572,423760,2223141332,23,0,0,8704,23,1910342289
2772,2222729298,349821,2223079119,6,0,0,16896,6,9374629978
2773,2222729739,319894,2223049633,2,0,0,22016,2,8584364239
2774,2222745050,326029,2223071079,17,0,0,17920,17,2372794882
2775,2222756198,182396,2222938594,49,0,0,1536,49,8612165999
2776,2222767972,956006,2223723978,37,0,0,67584,37,3576090956
2777,2222801194,257705,2223058899,11,0,0,27648,11,6812926259
2778,2222815594,429016,2223244610,7,0,0,12288,7,8066005735
2779,2222816080,1225128,2224041208,2,0,0,29696,2,5236026279
2780,2222823290,679006,2223502296,7,0,0,41472,7,3708673144
2781,2222835355,839711,2223675066,27,0,0,24064,27,3342762430
2782,2222847034,725850,2223572884,5,0,0,24576,5,9842410376
2783,2222847320,28788,2222876108,34,0,1,14336,34,8750154565
2784,2222867699,607711,2223475410,32,0,0,61440,32,8919277576
2785,2222872185,967618,2223839803,6,0,0,9728,6,8770927424
2786,2222882581,1106618,2223989199,44,0,0,52224,44,1262847767
2787,2222895878,4850,2222900728,34,0,1,5120,34,5038114410
2788,2222912024,371651,2223283675,11,0,0,11264,11,10146039007
2789,2222912723,33762,2222946485,18,0,1,58880,18,5934863861
2790,2222945569,508399,2223453968,37,0,0,104960,37,9324720692
2791,2222972138,666988,2223639126,48,0,0,39424,48,6893991746
2792,2222980188,250448,2223230636,21,0,0,7168,21,2255389469
2793,2222987732,11689,2222999421,48,0,1,14336,48,9036406018
2794,2223016735,42187,2223058922,41,0,1,6144,41,6598194975
2795,2223026709,164791,2223191500,30,0,0,512,30,4067606269
2796,2223041152,20796,2223061948,29,0,1,19968,29,7751750755
2797,2223042339,1025166,2224067505,12,0,0,71168,12,8449972000
2798,2223042454,1154931,2224197385,42,0,0,35840,42,6989333021
2799,2223042848,340143,2223382991,9,0,0,7168,9,1132239432
2800,2223048615,334859,2223383474,40,0,0,1536,40,292445959
2801,2223072380,384287,2223456667,5,0,0,8704,5,9742207601
2802,2223077808,12060,2223089868,12,0,1,17408,12,760915169
2803,2223119815,576399,2223696214,26,0,0,13312,26,10018977535
2804,2223126750,397444,2223524194,32,0,0,32256,32,5445756736
2805,2223138469,588979,2223727448,12,0,0,4608,12,5620997727
2806,2223157705,678120,2223835825,7,0,0,107008,7,5262604953
2807,2223169003,626364,2223795367,36,0,0,41984,36,5203201578
2808,2223181788,510347,2223692135,47,0,0,32256,47,7103465906
2809,2223191306,189486,2223380792,31,0,0,24576,31,2881623807
2810,2223192771,533258,2223726029,6,0,0,6656,6,5308864658
2811,2223197302,759077,2223956379,45,0,0,5120,45,4085325436
2812,2223225390,5261,2223230651,21,0,1,4096,21,3622076326
2813,2223237309,1040228,2224277537,46,0,0,51200,46,7228189895
2814,2223245654,647257,2223892911,14,0,0,8192,14,3107196282
2815,2223247737,294953,2223542690,5,0,0,50688,5,1050919880
2816,2223252799,393830,2223646629,33,0,0,24576,33,8689478215
2817,2223254623,880948,2224135571,37,0,0,66560,37,7122273492
2818,2223260011,265157,2223525168,21,0,0,3072,21,7184647133
2819,2223276446,7754,2223284200,20,0,1,512,20,5183154053
2820,2223319461,483729,2223803190,9,0,0,25600,9,4947551397
2821,2223339974,220224,2223560198,15,0,0,4096,15,5173957876
2822,2223402037,686556,2224088593,17,0,0,26112,17,8787272839
2823,2223405828,329918,2223735746,34,0,0,6656,34,1619747871
2824,2223424108,223784,2223647892,11,0,0,4096,11,6155610128
2825,2223427660,587123,2224014783,10,0,0,45568,10,2268436003
2826,2223432952,312037,2223744989,36,0,0,30208,36,1159316342
2827,2223433241,403551,2223836792,47,0,0,3072,47,10088373004
2828,2223455280,278423,2223733703,19,0,0,20480,19,9391927559
2829,2223458429,454746,2223913175,18,0,0,19456,18,1478769856
2830,2223458653,827663,2224286316,48,0,0,6656,48,4002075612
2831,2223472533,36000,2223508533,7,0,1,6656,7,10512509808
2832,2223494881,16878,2223511759,8,0,1,5120,8,5877943029
2833,2223501373,22844,2223524217,6,0,1,8192,6,3560588119
2834,2223516169,515968,2224032137,45,0,0,1536,45,5408288351
2835,2223542360,791378,2224333738,6,0,0,6656,6,1200080723
2836,2223560595,2470,2223563065,11,0,1,2560,11,2796912986
2837,2223607545,253865,2223861410,46,0,0,6144,46,3035668988
2838,2223612148,430331,2224042479,47,0,0,4096,47,9536476853
2839,2223619430,556713,2224176143,49,0,0,38400,49,6431537555
2840,2223625721,443983,2224069704,32,0,0,7168,32,3717601398
2841,2223646918,584456,2224231374,36,0,0,24064,36,9339989193
2842,2223654579,235821,2223890400,30,0,0,52736,30,3442012661
2843,2223671510,247312,2223918822,4,0,0,18432,4,9158816616
2844,2223671608,323411,2223995019,3,0,0,7680,3,5508147960
2845,2223681281,270033,2223951314,44,0,0,30720,44,4958647746
2846,2223690975,457433,2224148408,1,0,0,4608,1,6085243226
2847,2223698183,448806,2224146989,47,0,0,14848,47,5206422353
2848,2223704543,481883,2224186426,47,0,0,33280,47,9846821806
2849,2223727489,19453,2223746942,33,0,1,2048,33,3181645430
2850,2223728923,368253,2224097176,42,0,0,25088,42,1472410135
2851,2223733484,14444,2223747928,4,0,1,1536,4,1221255284
2852,2223756716,549986,2224306702,34,0,0,38912,34,10684181080
2853,2223791737,465157,2224256894,34,0,0,24064,34,5239101317
2854,2223793344,177438,2223970782,38,0,0,13312,38,10640685728
2855,2223797191,46324,2223843515,18,0,1,8192,18,2329082481
2856,2223801559,44199,2223845758,0,0,1,14848,0,10140934808
2857,2223805301,485426,2224290727,39,0,0,1024,39,1124495757
2858,2223811357,659058,2224470415,38,0,0,4608,38,3015334307
2859,2223811459,575937,2224387396,19,0,0,10240,19,8360703296
2860,2223815114,572453,2224387567,31,0,0,512,31,2340644941
2861,2223833381,198265,2224031646,26,0,0,55296,26,1628988368
2862,2223843666,696353,2224540019,37,0,0,35328,37,1841991818
2863,2223882574,748258,2224630832,44,0,0,77312,44,476737883
2864,2223888840,373082,2224261922,18,0,0,15360,18,5983431145
2865,2223897523,383967,2224281490,45,0,0,12800,45,731090490
2866,2223908944,233506,2224142450,37,0,0,22528,37,5206576864
2867,2223909136,21436,2223930572,34,0,1,19456,34,6420508233
2868,2223920929,548051,2224468980,3,0,0,64512,3,10604855506
2869,2223942028,480806,2224422834,41,0,0,25088,41,7315905689
2870,2223948836,8773,2223957609,32,0,1,6656,32,10398930394
2871,2223974529,20505,2223995034,34,0,1,10240,34,1304808151
2872,2223984971,343207,2224328178,34,0,0,16896,34,1246257067
2873,2224024123,545608,2224569731,38,0,0,26624,38,4476319017
2874,2224028666,41053,2224069719,38,0,1,7680,38,2301158241
2875,2224030284,576977,2224607261,16,0,0,29696,16,1174772630
2876,2224032200,37534,2224069734,12,0,1,3072,12,2017034730
2877,2224044548,709123,2224753671,1,0,0,56832,1,6470909632
2878,2224053321,728582,2224781903,48,0,0,45568,48,8765381762
2879,2224057697,219855,2224277552,0,0,1,325632,0,4742619195
2880,2224066745,591864,2224658609,17,0,0,30208,17,197490083
2881,2224075990,522208,2224598198,2,0,0,15360,2,3731203339
2882,2224078399,199168,2224277567,34,0,1,512,34,4855982915
2883,2224082026,842507,2224924533,9,0,0,10240,9,796380525
2884,2224083895,431250,2224515145,28,0,0,1024,28,10467504025
2885,2224101951,449627,2224551578,33,0,0,37888,33,5984352245
2886,2224106719,365209,2224471928,49,0,0,512,49,3271485435
2887,2224107246,213476,2224320722,17,0,0,14336,17,3040122670
2888,2224114613,552852,2224667465,48,0,0,28672,48,3311780888
2889,2224126906,999629,2225126535,4,0,0,8704,4,2211470987
2890,2224155917,125612,2224281529,28,0,1,26624,28,2769560176
2891,2224158411,529512,2224687923,44,0,0,21504,44,6475653858
2892,2224159259,122285,2224281544,35,0,1,5632,35,1687778574
2893,2224163299,692202,2224855501,29,0,0,64000,29,5769657278
2894,2224165956,731549,2224897505,26,0,0,25600,26,22063264
2895,2224166340,1105519,2225271859,39,0,0,6656,39,8902382962
2896,2224168530,500399,2224668929,20,0,0,2560,20,1039475575
2897,2224185615,650355,2224835970,24,0,0,69120,24,10717603303
2898,2224202783,1058383,2225261166,33,0,0,209920,33,5354806074
2899,2224204897,430186,2224635083,10,0,0,13824,10,9676525633
2900,2224217780,972229,2225190009,24,0,0,23040,24,8882173312
2901,2224222227,1070745,2225292972,9,0,0,37888,9,5564501114
2902,2224223311,58248,2224281559,29,0,1,8704,29,3240287675
2903,2224229231,52343,2224281574,46,0,1,512,46,5846627243
2904,2224230872,927944,2225158816,47,0,0,22528,47,8922597066
2905,2224235186,526243,2224761429,17,0,0,512,17,1212543963
2906,2224253542,544945,2224798487,44,0,0,43520,44,1531990811
2907,2224268203,653195,2224921398,14,0,0,41984,14,6309004808
2908,2224269945,22110,2224292055,35,0,1,16896,35,10072266765
2909,2224270418,405910,2224676328,35,0,0,1536,35,6951931278
2910,2224272604,34121,2224306725,15,0,1,21504,15,10529140653
2911,2224296970,11743,2224308713,41,0,1,2048,41,10657933205
2912,2224305025,554859,2224859884,44,0,0,14336,44,2956402472
2913,2224345905,997116,2225343021,41,0,0,14336,41,6355774928
2914,2224350858,773002,2225123860,25,0,0,40960,25,4128343086
2915,2224352847,729416,2225082263,32,0,0,46080,32,6230076053
2916,2224356249,597986,2224954235,33,0,0,29184,33,3159605626
2917,2224373775,619273,2224993048,26,0,0,67584,26,1305858561
2918,2224378324,4374,2224382698,11,0,1,4608,11,6866569034
2919,2224379032,918557,2225297589,45,0,0,5632,45,3661619349
2920,2224453080,541551,2224994631,21,0,0,5120,21,2550652924
2921,2224453539,885091,2225338630,31,0,0,48640,31,902891894
2922,2224458263,887346,2225345609,34,0,0,4096,34,5931784238
2923,2224464740,707804,2225172544,17,0,0,39424,17,8180283120
2924,2224465121,640699,2225105820,39,0,0,8704,39,7295826493
2925,2224482350,610419,2225092769,25,0,0,14848,25,7928629261
2926,2224503750,957528,2225461278,45,0,0,57856,45,5824110330
2927,2224508259,1023874,2225532133,5,0,0,15872,5,1304242000
2928,2224509076,2470,2224511546,2,0,1,2560,2,5356034411
2929,2224509623,786195,2225295818,17,0,0,3584,17,5657639022
2930,2224514869,889768,2225404637,20,0,0,46592,20,5792544032
2931,2224515460,898092,2225413552,9,0,0,29184,9,6168898165
2932,2224533188,19466,2224552654,2,0,1,1024,2,9912532702
2933,2224539915,18287,2224558202,21,0,1,6656,21,10725442865
2934,2224544867,736546,2225281413,11,0,0,24576,11,6818379071
2935,2224565066,704734,2225269800,37,0,0,28160,37,4646869751
2936,2224569591,488970,2225058561,24,0,0,10752,24,4603696378
2937,2224577991,1518,2224579509,43,0,1,1536,43,2966728076
2938,2224585275,909010,2225494285,47,0,0,15360,47,8340400475
2939,2224587596,897900,2225485496,42,0,0,21504,42,5454898348
2940,2224600910,1040933,2225641843,6,0,0,147968,6,8023041096
2941,2224615813,346146,2224961959,36,0,0,5120,36,7850123153
2942,2224616100,1323325,2225939425,5,0,0,7168,5,8246440260
2943,2224651157,320866,2224972023,33,0,0,5120,33,3751831307
2944,2224660684,719283,2225379967,28,0,0,4096,28,10730729384
2945,2224669909,255288,2224925197,2,0,0,1536,2,6283975038
2946,2224673402,813825,2225487227,28,0,0,5632,28,6300795214
2947,2224675598,349245,2225024843,29,0,0,18944,29,9579969174
2948,2224687979,661969,2225349948,36,0,0,6144,36,297126472
2949,2224694061,1001374,2225695435,3,0,0,46592,3,8999981832
2950,2224700360,1994,2224702354,15,0,1,2048,15,246657624
2951,2224704026,1518,2224705544,46,0,1,1536,46,1009376347
2952,2224705423,467619,2225173042,35,0,0,1536,35,7748977832
2953,2224709829,1069936,2225779765,38,0,0,39936,38,4559949101
2954,2224713901,97096,2224810997,3,0,1,162304,3,2024308613
2955,2224716820,1015077,2225731897,37,0,0,11776,37,6543930415
2956,2224717769,789533,2225507302,29,0,0,12288,29,10550440785
2957,2224720818,367388,2225088206,38,0,0,19456,38,10125960529
2958,2224723455,89168,2224812623,35,0,1,2560,35,5823096755
2959,2224726310,133589,2224859899,3,0,1,81408,3,5409268806
2960,2224727382,132532,2224859914,48,0,1,13312,48,1503238326
2961,2224729972,129973,2224859945,11,0,1,1024,11,2162888398
2962,2224751091,678354,2225429445,26,0,0,33792,26,6934054620
2963,2224763256,510646,2225273902,30,0,0,6656,30,3632224258
2964,2224764696,95264,2224859960,35,0,1,6656,35,7661803284
2965,2224789361,403954,2225193315,3,0,0,1024,3,6784088464
2966,2224792385,720240,2225512625,37,0,0,512,37,893560368
2967,2224806462,287545,2225094007,39,0,0,1536,39,7180816113
2968,2224812976,481735,2225294711,19,0,0,5632,19,9453631920
2969,2224819541,47086,2224866627,23,0,1,7168,23,211379007
2970,2224820637,46656,2224867293,20,0,1,1024,20,6357053806
2971,2224857077,19128,2224876205,16,0,1,26624,16,5909532782
2972,2224857620,849865,2225707485,29,0,0,18944,29,1574086289
2973,2224866627,1019440,2225886067,6,0,0,34816,6,10140665881
2974,2224872958,505730,2225378688,4,0,0,45568,4,7718138040
2975,2224891709,6354,2224898063,32,0,1,512,32,3105055041
2976,2224903529,114762,2225018291,0,0,1,189952,0,602962447
2977,2224912089,751365,2225663454,19,0,0,30208,19,10520494916
2978,2224924456,1228587,2226153043,42,0,0,9216,42,2482313815
2979,2224928630,1407899,2226336529,37,0,0,20480,37,3853169212
2980,2224950134,553393,2225503527,49,0,0,25088,49,1744125354
2981,2224960709,518212,2225478921,19,0,0,57856,19,492886103
2982,2224962286,56351,2225018637,47,0,1,512,47,9160025889
2983,2224976244,48614,2225024858,0,0,1,28672,0,8813246483
2984,2224983321,1945929,2226929250,12,0,0,47616,12,9038778708
2985,2224995976,493614,2225489590,10,0,0,7680,10,8622945287
2986,2225004955,1044242,2226049197,5,0,0,5120,5,8288576071
2987,2225018487,813347,2225831834,42,0,0,32768,42,8441342028
2988,2225045178,1977018,2227022196,9,0,0,44032,9,6928174105
2989,2225056442,136546,2225192988,28,0,0,9728,28,2911852860
2990,2225064468,718596,2225783064,49,0,0,10752,49,10323917730
2991,2225065502,1684432,2226749934,39,0,0,12288,39,4392605506
2992,2225079473,20961,2225100434,14,0,1,8192,14,5945218733
2993,2225084077,875579,2225959656,9,0,0,17920,9,9885904547
2994,2225085540,807904,2225893444,18,0,0,9216,18,7527657999
2995,2225088265,892496,2225980761,47,0,0,32768,47,5616394508
2996,2225104286,260503,2225364789,8,0,0,2560,8,3123175636
2997,2225104716,4543,2225109259,21,0,1,3584,21,1994828094
2998,2225107112,247687,2225354799,34,0,0,15872,34,8043496184
2999,2225115062,970721,2226085783,26,0,0,27648,26,4358302025
3000,2225123035,578655,2225701690,5,0,0,20480,5,276580592
3001,2225128104,397131,2225525235,36,0,0,13824,36,4714305226
3002,2225156559,700319,2225856878,11,0,0,34304,11,5883412335
3003,2225158618,492326,2225650944,33,0,0,5120,33,3231308595
3004,2225158890,13669,2225172559,2,0,1,12288,2,6789490148
3005,2225194365,66832,2225261197,20,0,1,15360,20,3468349742
3006,2225195981,458254,2225654235,1,0,0,10752,1,6816190105
3007,2225197041,566913,2225763954,29,0,0,6656,29,8764702227
3008,2225206136,289732,2225495868,41,0,0,5120,41,9858946944
3009,2225219004,347141,2225566145,48,0,0,7680,48,10427490692
3010,2225222699,505579,2225728278,29,0,0,38400,29,2049032611
3011,2225242935,508461,2225751396,31,0,0,37376,31,4713159088
3012,2225257174,459389,2225716563,15,0,0,19968,15,7868371171
3013,2225258770,39369,2225298139,14,0,1,512,14,4552735480
3014,2225264695,1944199,2227208894,20,0,0,7168,20,7592995908
3015,2225274054,728568,2226002622,37,0,0,1536,37,3152939939
3016,2225274621,435843,2225710464,44,0,0,9728,44,6070816099
3017,2225285949,363412,2225649361,15,0,0,24576,15,8247962579
3018,2225287911,16572,2225304483,20,0,1,7168,20,4494181414
3019,2225301968,16096,2225318064,24,0,1,31232,24,9720220585
3020,2225304154,567794,2225871948,33,0,0,17408,33,8304302997
3021,2225328283,562323,2225890606,34,0,0,14848,34,6946966526
3022,2225336117,844803,2226180920,6,0,0,512,6,6340685423
3023,2225362061,1007612,2226369673,6,0,0,13312,6,9700877138
3024,2225370069,10423,2225380492,32,0,1,512,32,2631665726
3025,2225373507,1679655,2227053162,16,0,0,23552,16,3777998426
3026,2225395087,21846,2225416933,25,0,1,3584,25,5712098506
3027,2225407163,467083,2225874246,1,0,0,2048,1,404959792
3028,2225415462,827757,2226243219,41,0,0,19456,41,8245338955
3029,2225415932,1987,2225417919,33,0,1,1536,33,9545507474
3030,2225422429,548162,2225970591,19,0,0,35840,19,1459665993
3031,2225429423,581548,2226010971,16,0,0,15360,16,10608768743
3032,2225452590,518172,2225970762,40,0,0,512,40,10580392818
3033,2225461807,380198,2225842005,27,0,0,33280,27,6390128824
3034,2225489336,686740,2226176076,16,0,0,35328,16,6056582808
3035,2225500277,627271,2226127548,38,0,0,37376,38,3922325350
3036,2225502335,610254,2226112589,45,0,0,12800,45,6457616649
3037,2225503915,426198,2225930113,10,0,0,52224,10,10596804833
3038,2225548014,920989,2226469003,9,0,0,60928,9,5100751070
3039,2225568631,73227,2225641858,2,0,1,55808,2,6741382864
3040,2225621317,650248,2226271565,9,0,0,22528,9,7497795184
3041,2225655169,582107,2226237276,31,0,0,44032,31,1248695752
3042,2225672421,1006438,2226678859,42,0,0,21504,42,4012879191
3043,2225690736,455881,2226146617,20,0,0,27648,20,1045601299
3044,2225717590,20003,2225737593,43,0,1,14336,43,7443360070
3045,2225718347,316382,2226034729,8,0,0,29696,8,3367996041
3046,2225720442,327180,2226047622,30,0,0,33280,30,615170166
3047,2225745030,884527,2226629557,20,0,0,31232,20,1948104488
3048,2225745926,737503,2226483429,12,0,0,22016,12,4156882901
3049,2225746406,237826,2225984232,19,0,0,11264,19,5292225201
3050,2225752645,1622443,2227375088,25,0,0,8704,25,6584328263
3051,2225755609,837512,2226593121,4,0,0,29184,4,4925059436
3052,2225759029,226162,2225985191,45,0,0,3072,45,8016413380
3053,2225768148,340526,2226108674,45,0,0,4096,45,9201055712
3054,2225777091,515450,2226292541,2,0,0,40960,2,4186747416
3055,2225786029,774888,2226560917,25,0,0,36864,25,2343189235
3056,2225799152,458925,2226258077,27,0,0,22528,27,2289300949
3057,2225799196,410019,2226209215,41,0,0,32256,41,2683664165
3058,2225816362,1735046,2227551408,12,0,0,158208,12,3265882495
3059,2225822505,930112,2226752617,47,0,0,8704,47,5362716001
3060,2225823894,32999,2225856893,14,0,1,13824,14,7854621135
3061,2225839675,411523,2226251198,29,0,0,26112,29,3806918912
3062,2225849652,873412,2226723064,10,0,0,36864,10,2991696013
3063,2225854110,666012,2226520122,30,0,0,3072,30,5173419631
3064,2225862597,9374,2225871971,8,0,1,14336,8,7800366752
3065,2225864902,25719,2225890621,8,0,1,6144,8,10541301039
3066,2225871996,58132,2225930128,0,0,1,66560,0,4875795131
3067,2225881038,49105,2225930143,33,0,1,2048,33,4003202959
3068,2225885659,436630,2226322289,48,0,0,5120,48,9210118368
3069,2225887188,468997,2226356185,33,0,0,19456,33,1459107411
3070,2225890013,238650,2226128663,43,0,0,3584,43,9265608405
3071,2225892249,679447,2226571696,33,0,0,35328,33,6448108919
3072,2225936609,566,2225937175,43,0,1,512,43,8966571349
3073,2225966499,22073,2225988572,46,0,1,3584,46,9042749968
3074,2225967298,451896,2226419194,46,0,0,11776,46,9497025169
3075,2225969591,610388,2226579979,46,0,0,27136,46,10031104254
3076,2225974347,437012,2226411359,7,0,0,51712,7,2305740104
3077,2225985042,5653,2225990695,10,0,1,11776,10,8672952672
3078,2225987278,233114,2226220392,25,0,0,9728,25,9823996604
3079,2225994929,478161,2226473090,8,0,0,13312,8,8793345627
3080,2225996592,6045,2226002637,10,0,1,14336,10,3046761110
3081,2226047892,776628,2226824520,38,0,0,5632,38,5213993316
3082,2226052349,727054,2226779403,36,0,0,28672,36,105067496
3083,2226058793,541927,2226600720,30,0,0,19456,30,5151762035
3084,2226059085,284477,2226343562,14,0,0,1024,14,7062717900
3085,2226063896,816407,2226880303,29,0,0,25088,29,3972446257
3086,2226066186,840565,2226906751,24,0,0,14848,24,8678258693
3087,2226072475,709907,2226782382,33,0,0,9728,33,5867208475
3088,2226086093,289526,2226375619,38,0,0,5120,38,6990087327
3089,2226089374,387332,2226476706,45,0,0,7680,45,4556882659
3090,2226106765,566,2226107331,11,0,1,512,11,930618518
3091,2226113850,632317,2226746167,4,0,0,75776,4,4361533486
3092,2226116721,1301352,2227418073,8,0,0,28672,8,6302946070
3093,2226122047,713678,2226835725,49,0,0,10752,49,9848588535
3094,2226146043,298903,2226444946,4,0,0,512,4,4144486019
3095,2226181351,1073832,2227255183,3,0,0,10752,3,4602537504
3096,2226201176,772984,2226974160,30,0,0,52736,30,8646570724
3097,2226216823,156889,2226373712,5,0,0,3072,5,2611058627
3098,2226223103,588816,2226811919,49,0,0,35840,49,6439153506
3099,2226226454,537322,2226763776,31,0,0,17920,31,9664900883
3100,2226235876,56704,2226292580,18,0,1,55296,18,5108342478
3101,2226237122,56231,2226293353,43,0,1,2560,43,10386894143
3102,2226247609,880752,2227128361,41,0,0,39936,41,1770277012
3103,2226257410,557176,2226814586,19,0,0,8704,19,555587884
3104,2226264776,583886,2226848662,34,0,0,19456,34,167890878
3105,2226288003,1308270,2227596273,2,0,0,51200,2,8849557548
3106,2226288629,331397,2226620026,31,0,0,13312,31,1707740825
3107,2226290695,854722,2227145417,29,0,0,4096,29,1239252911
3108,2226293974,601195,2226895169,46,0,0,16384,46,2854137878
3109,2226297278,398723,2226696001,11,0,0,1024,11,10147373393
3110,2226306290,354065,2226660355,33,0,0,6144,33,3225400640
3111,2226323122,914746,2227237868,27,0,0,18944,27,6214419327
3112,2226333630,467027,2226800657,10,0,0,59904,10,8563607014
3113,2226337629,769033,2227106662,5,0,0,27136,5,493680526
3114,2226347435,11791,2226359226,24,0,1,19456,24,4048447115
3115,2226354310,229904,2226584214,41,0,0,13824,41,8976323033
3116,2226373592,7342,2226380934,48,0,1,7680,48,4399077013
3117,2226376135,1291343,2227667478,17,0,0,139776,17,2371159491
3118,2226399089,1286897,2227685986,33,0,0,2048,33,7388998718
3119,2226399399,657834,2227057233,45,0,0,13312,45,3096780707
3120,2226404852,485302,2226890154,26,0,0,32256,26,631791053
3121,2226411995,234691,2226646686,20,0,0,13824,20,5279840220
3122,2226418628,525467,2226944095,2,0,0,4096,2,6919172317
3123,2226426208,631352,2227057560,23,0,0,1024,23,6450620653
3124,2226453485,226481,2226679966,16,0,0,3584,16,4337781216
3125,2226456941,392048,2226848989,44,0,0,1024,44,9864975564
3126,2226485012,1203961,2227688973,37,0,0,9728,37,7245548345
3127,2226485413,315571,2226800984,30,0,0,1024,30,6468142816
3128,2226504674,335924,2226840598,4,0,0,3072,4,923333291
3129,2226517316,481433,2226998749,19,0,0,24064,19,2973532841
3130,2226540178,849161,2227389339,3,0,0,46592,3,3486181090
3131,2226543718,399114,2226942832,29,0,0,14848,29,4078273714
3132,2226553961,348243,2226902204,31,0,0,23040,31,9912134051
3133,2226590897,524002,2227114899,3,0,0,10240,3,7898070736
3134,2226593480,838429,2227431909,24,0,0,4608,24,5233197045
3135,2226595760,311482,2226907242,10,0,0,1536,10,9780640622
3136,2226604069,398439,2227002508,21,0,0,12288,21,9018539754
3137,2226609711,1219060,2227828771,8,0,0,41472,8,10563304725
3138,2226613020,884038,2227497058,20,0,0,27648,20,5016700857
3139,2226631875,574820,2227206695,27,0,0,27648,27,9164571573
3140,2226632861,650487,2227283348,29,0,0,22016,29,1879270769
3141,2226633329,347104,2226980433,49,0,0,3584,49,174171103
3142,2226637877,315764,2226953641,44,0,0,2048,44,4476137160
3143,2226645432,465470,2227110902,47,0,0,1024,47,5454926454
3144,2226655049,647145,2227302194,45,0,0,1024,45,8886312143
3145,2226658308,36863,2226695171,3,0,1,65024,3,6655531788
3146,2226665221,34776,2226699997,43,0,1,7680,43,8708699573
3147,2226680575,513340,2227193915,12,0,0,20992,12,4488847492
3148,2226680921,274151,2226955072,9,0,0,4608,9,9923727535
3149,2226688941,12644,2226701585,12,0,1,15872,12,9998705173
3150,2226700033,566351,2227266384,2,0,0,31232,2,2641253889
3151,2226701907,321864,2227023771,16,0,0,5120,16,1967931641
3152,2226703924,365642,2227069566,40,0,0,26624,40,10186294741
3153,2226719290,44501,2226763791,14,0,1,6656,14,4810419599
3154,2226732548,307006,2227039554,44,0,0,4096,44,1449085756
3155,2226738084,296192,2227034276,40,0,0,12800,40,4193084767
3156,2226749962,497826,2227247788,11,0,0,8192,11,1701426833
3157,2226759034,227709,2226986743,32,0,0,4096,32,7633063968
3158,2226779220,418847,2227198067,29,0,0,1536,29,9910691164
3159,2226811069,7671,2226818740,8,0,1,11264,8,1978880480
3160,2226825889,510911,2227336800,24,0,0,32768,24,8168814664
3161,2226851306,521107,2227372413,34,0,0,89600,34,9605739162
3162,2226870181,1548503,2228418684,10,0,0,69120,10,5073486362
3163,2226874176,33081,2226907257,24,0,1,16896,24,5545214777
3164,2226893119,433674,2227326793,23,0,0,43008,23,667693605
3165,2226897560,511762,2227409322,14,0,0,65536,14,8804525968
3166,2226924285,777229,2227701514,16,0,0,20480,16,9507330310
3167,2226952932,2155,2226955087,15,0,1,1536,15,4439025534
3168,2226970826,321334,2227292160,33,0,0,25088,33,9219863050
3169,2226983254,361673,2227344927,29,0,0,26624,29,3059933193
3170,2226992254,434297,2227426551,33,0,0,26112,33,10418236216
3171,2226995665,968288,2227963953,35,0,0,42496,35,6014915356
3172,2226998818,4816,2227003634,34,0,1,1024,34,9935633289
3173,2226999349,7717,2227007066,22,0,1,11264,22,3021325055
3174,2227000726,36617,2227037343,18,0,1,50176,18,10195923331
3175,2227029699,400767,2227430466,29,0,0,12800,29,4746434833
3176,2227054517,526125,2227580642,37,0,0,60928,37,5548938261
3177,2227072920,392965,2227465885,24,0,0,22528,24,4618500264
3178,2227073108,612223,2227685331,49,0,0,45056,49,5932831098
3179,2227078635,517825,2227596460,47,0,0,512,47,846144126
3180,2227082847,262251,2227345098,31,0,0,512,31,4331863948
3181,2227085349,1441089,2228526438,3,0,0,78848,3,6942921391
3182,2227113255,153144,2227266399,18,0,1,240640,18,4542693794
3183,2227158898,1406486,2228565384,37,0,0,24064,37,2627064061
3184,2227159934,291934,2227451868,42,0,0,2560,42,9548936715
3185,2227165524,100890,2227266414,41,0,1,10240,41,8202171855
3186,2227166269,100160,2227266429,34,0,1,1536,34,4764470122
3187,2227168662,393401,2227562063,15,0,0,34816,15,4109285623
3188,2227174460,92616,2227267076,19,0,1,7680,19,3588739959
3189,2227178524,265820,2227444344,10,0,0,3072,10,8791591175
3190,2227188933,229647,2227418580,16,0,0,1536,16,10017907179
3191,2227216887,774561,2227991448,26,0,0,12800,26,3240672518
3192,2227220602,73419,2227294021,15,0,1,88064,15,5009036314
3193,2227234492,60195,2227294687,33,0,1,1024,33,478118894
3194,2227280508,17405,2227297913,14,0,1,5120,14,4004445535
3195,2227282618,16281,2227298899,46,0,1,1536,46,4516503165
3196,2227282742,412501,2227695243,14,0,0,17408,14,2336748656
3197,2227301153,453229,2227754382,4,0,0,19456,4,4090330950
3198,2227315058,749110,2228064168,11,0,0,38912,11,965476770
3199,2227332817,264150,2227596967,44,0,0,1536,44,10269530849
3200,2227347538,264619,2227612157,38,0,0,16384,38,10124298735
3201,2227360183,421370,2227781553,21,0,0,22016,21,8882623117
3202,2227364162,304603,2227668765,7,0,0,4096,7,1385636827
3203,2227364231,325693,2227689924,35,0,0,3072,35,7641722079
3204,2227367420,546195,2227913615,38,0,0,27136,38,1773410743
3205,2227395866,373181,2227769047,43,0,0,47104,43,7328250113
3206,2227403011,268577,2227671588,34,0,0,9216,34,1647520194
3207,2227406789,26531,2227433320,41,0,1,8704,41,4341266051
3208,2227409114,792839,2228201953,46,0,0,2560,46,6171383552
3209,2227423513,519225,2227942738,1,0,0,17920,1,9229947533
3210,2227450755,1226169,2228676924,42,0,0,12288,42,8649582603
3211,2227454769,547423,2228002192,47,0,0,27648,47,5002865678
3212,2227461806,262233,2227724039,41,0,0,10752,41,1890008038
3213,2227464217,730487,2228194704,21,0,0,4608,21,1039959593
3214,2227464379,365031,2227829410,27,0,0,2048,27,6819818529
3215,2227473496,951901,2228425397,43,0,0,2560,43,8799537831
3216,2227478908,564257,2228043165,18,0,0,11264,18,3388692230
3217,2227480038,3422,2227483460,8,0,1,3584,8,5207520658
3218,2227481680,505853,2227987533,26,0,0,59392,26,5806209750
3219,2227493904,971584,2228465488,18,0,0,47104,18,8937675161
3220,2227498691,3898,2227502589,34,0,1,4096,34,7793099574
3221,2227499463,117460,2227616923,17,0,0,4096,17,4932093589
3222,2227511418,262176,2227773594,3,0,0,14848,3,10635566131
3223,2227514720,617743,2228132463,8,0,0,4608,8,6238990669
3224,2227518983,219666,2227738649,9,0,0,22016,9,10542777707
3225,2227521230,416033,2227937263,9,0,0,39936,9,8656362302
3226,2227538155,1252624,2228790779,6,0,0,58880,6,820954080
3227,2227542800,666541,2228209341,6,0,0,13824,6,7132475711
3228,2227556667,169338,2227726005,9,0,0,1024,9,377646242
3229,2227565826,763278,2228329104,33,0,0,10752,33,4076721089
3230,2227571893,745451,2228317344,20,0,0,157184,20,8693361080
3231,2227576132,281281,2227857413,36,0,0,13824,36,6164688353
3232,2227580834,17134,2227597968,49,0,1,1024,49,6318444254
3233,2227596935,624723,2228221658,15,0,0,29184,15,1524206211
3234,2227606631,223745,2227830376,43,0,0,512,43,8760146545
3235,2227629570,536049,2228165619,3,0,0,17408,3,7771816297
3236,2227632432,702147,2228334579,5,0,0,17920,5,5787069454
3237,2227632771,818350,2228451121,7,0,0,10240,7,467359268
3238,2227653540,51831,2227705371,12,0,1,4096,12,1706220619
3239,2227655274,57688,2227712962,34,0,1,16384,34,2225994181
3240,2227657328,58220,2227715548,33,0,1,4096,33,10539542623
3241,2227669877,511357,2228181234,11,0,0,51200,11,6750377818
3242,2227677429,930936,2228608365,36,0,0,14336,36,2580834198
3243,2227685898,1083374,2228769272,22,0,0,39936,22,3587957663
3244,2227710421,608498,2228318919,45,0,0,5120,45,7380714745
3245,2227720040,492703,2228212743,47,0,0,10752,47,6375359625
3246,2227720492,109713,2227830205,43,0,0,2560,43,10675139580
3247,2227722647,473476,2228196123,34,0,0,4608,34,8225564015
3248,2227757162,286026,2228043188,3,0,1,439296,3,6566341298
3249,2227780091,266734,2228046825,32,0,1,7680,32,5783284101
3250,2227790572,813410,2228603982,49,0,0,25088,49,4561955304
3251,2227821790,999182,2228820972,42,0,0,41472,42,5818065511
3252,2227834953,212128,2228047081,7,0,1,9216,7,1874346949
3253,2227850268,746055,2228596323,31,0,0,76800,31,762747740
3254,2227855419,1385349,2229240768,28,0,0,5632,28,6618422458
3255,2227864907,633058,2228497965,3,0,0,7168,3,5048040885
3256,2227885095,179088,2228064183,41,0,1,18432,41,367861608
3257,2227885912,612536,2228498448,39,0,0,1536,39,275601411
3258,2227903603,763283,2228666886,30,0,0,24064,30,6578786485
3259,2227909805,207107,2228116912,13,0,0,29696,13,7465263198
3260,2227910639,537347,2228447986,9,0,0,54272,9,10041768989
3261,2227910640,282629,2228193269,9,0,0,39424,9,1779445561
3262,2227918264,554930,2228473194,12,0,0,24576,12,4967608049
3263,2227918628,721154,2228639782,40,0,0,17920,40,8005320205
3264,2227946318,117880,2228064198,43,0,1,2560,43,3199080062
3265,2227961305,673002,2228634307,9,0,0,47616,9,6077900608
3266,2227986315,668458,2228654773,33,0,0,49152,33,10630008230
3267,2227999284,857465,2228856749,34,0,0,47616,34,51452515
3268,2228003226,802932,2228806158,13,0,0,14848,13,10637001016
3269,2228016907,897724,2228914631,11,0,0,47104,11,4631181981
3270,2228019928,514029,2228533957,18,0,0,24576,18,9676290448
3271,2228035716,734367,2228770083,43,0,0,2560,43,1976037393
3272,2228040879,715212,2228756091,28,0,0,34304,28,1541224866
3273,2228072202,996537,2229068739,37,0,0,10752,37,9933373882
3274,2228090187,871525,2228961712,30,0,0,59904,30,5302978359
3275,2228107091,512677,2228619768,29,0,0,37376,29,5752123189
3276,2228107157,212433,2228319590,12,0,0,2048,12,8104276268
3277,2228117506,581132,2228698638,38,0,0,55808,38,8586617699
3278,2228140510,2870,2228143380,7,0,1,8704,7,8078920351
3279,2228159474,597615,2228757089,6,0,0,3072,6,1649757118
3280,2228176184,289491,2228465675,31,0,0,512,31,3907896160
3281,2228179584,865340,2229044924,17,0,0,29184,17,5235430346
3282,2228182496,18265,2228200761,32,0,1,12288,32,2227019363
3283,2228210802,15260,2228226062,17,0,1,11776,17,3941407756
3284,2228212718,583722,2228796440,47,0,0,18432,47,682375020
3285,2228215267,457882,2228673149,33,0,0,20480,33,8373920222
3286,2228255194,426425,2228681619,46,0,0,15360,46,4730707692
3287,2228263141,788685,2229051826,10,0,0,11776,10,8613636216
3288,2228263574,538029,2228801603,8,0,0,16896,8,5603148620
3289,2228265101,394438,2228659539,27,0,0,1536,27,753557217
3290,2228288267,610110,2228898377,42,0,0,13312,42,3973718120
3291,2228288954,796026,2229084980,16,0,0,24064,16,7146259062
3292,2228289150,437724,2228726874,18,0,0,11264,18,8578697519
3293,2228295101,363947,2228659048,7,0,0,13824,7,3941483542
3294,2228354986,4679,2228359665,34,0,1,12288,34,137478526
3295,2228358671,509712,2228868383,46,0,0,18944,46,623750934
3296,2228398308,441402,2228839710,27,0,0,1024,27,9274654593
3297,2228398749,475706,2228874455,25,0,0,3584,25,7293167397
3298,2228449019,34891,2228483910,33,0,1,17408,33,3081108897
3299,2228453151,490286,2228943437,39,0,0,25088,39,7620962403
3300,2228453373,248720,2228702093,42,0,0,11264,42,4452552962
3301,2228454739,757703,2229212442,24,0,0,52224,24,3596657055
3302,2228481043,658553,2229139596,35,0,0,81408,35,7714783093
3303,2228482056,498854,2228980910,13,0,0,11776,13,1937225407
3304,2228483827,508379,2228992206,23,0,0,23040,23,2022783232
3305,2228486924,12737,2228499661,2,0,1,24576,2,9470102400
3306,2228503082,238933,2228742015,41,0,0,2048,41,4343836792
3307,2228517544,19267,2228536811,4,0,1,8704,4,9546411530
3308,2228523196,26184,2228549380,0,0,1,24576,0,2195749658
3309,2228528265,663859,2229192124,35,0,0,33280,35,175980350
3310,2228529204,21252,2228550456,33,0,1,13312,33,8565384440
3311,2228553781,11626,2228565407,40,0,1,8192,40,9553707549
3312,2228554345,445951,2229000296,23,0,0,10240,23,3375500703
3313,2228560458,415028,2228975486,29,0,0,9728,29,6259280233
3314,2228564202,484021,2229048223,36,0,0,10752,36,4413300954
3315,2228599111,510803,2229109914,13,0,0,10752,13,10364424458
3316,2228601782,622843,2229224625,2,0,0,39936,2,3747041508
3317,2228615638,1041403,2229657041,43,0,0,26112,43,8572237199
3318,2228615925,662940,2229278865,10,0,0,33792,10,7024161773
3319,2228627320,272944,2228900264,4,0,0,6144,4,8249078675
3320,2228630031,422122,2229052153,30,0,0,1024,30,7610673010
3321,2228634799,533405,2229168204,49,0,0,19456,49,4862882087
3322,2228634921,509222,2229144143,38,0,0,14848,38,2940367363
3323,2228636765,184690,2228821455,21,0,0,1536,21,8756888985
3324,2228644579,243185,2228887764,38,0,0,21504,38,8425602643
3325,2228653848,423777,2229077625,4,0,0,20992,4,519553244
3326,2228665321,603225,2229268546,23,0,0,10752,23,3198537835
3327,2228677615,78491,2228756106,30,0,1,81408,30,4256855387
3328,2228695810,94984,2228790794,2,0,1,79360,2,2112771785
3329,2228696963,1036781,2229733744,7,0,0,14336,7,5567022995
3330,2228697343,275156,2228972499,32,0,0,35328,32,8845031905
3331,2228708412,534329,2229242741,42,0,0,1536,42,569230585
3332,2228725620,65189,2228790809,11,0,1,3584,11,6548404205
3333,2228740510,85375,2228825885,0,0,1,94720,0,2779634617
3334,2228750256,537516,2229287772,30,0,0,29184,30,7165157156
3335,2228776060,632801,2229408861,35,0,0,25088,35,2190802899
3336,2228781040,50030,2228831070,34,0,1,16384,34,4804350682
3337,2228802076,597944,2229400020,27,0,0,1024,27,1967808793
3338,2228815643,184676,2229000319,18,0,1,290816,18,9947205231
3339,2228829362,170972,2229000334,14,0,1,512,14,2684782906
3340,2228833022,363493,2229196515,6,0,0,14336,6,8694434765
3341,2228837462,163401,2229000863,8,0,1,3584,8,8936471024
3342,2228843686,160083,2229003769,41,0,1,4608,41,3900965012
3343,2228845742,385466,2229231208,40,0,0,21504,40,5090089576
3344,2228849404,740358,2229589762,45,0,0,22016,45,2010449738
3345,2228871344,440968,2229312312,5,0,0,15872,5,4956650347
3346,2228884853,514832,2229399685,30,0,0,16896,30,1374517104
3347,2228890200,593968,2229484168,1,0,0,14336,1,951005017
3348,2228910472,557581,2229468053,21,0,0,39424,21,483645051
3349,2228911607,912203,2229823810,42,0,0,18944,42,8541490618
3350,2228915703,408260,2229323963,7,0,0,19968,7,8233704643
3351,2228932874,657371,2229590245,3,0,0,1536,3,9297386356
3352,2228933085,305937,2229239022,32,0,0,13824,32,9612827450
3353,2228938593,438305,2229376898,45,0,0,23040,45,1134804480
3354,2228946629,63246,2229009875,18,0,1,29184,18,734356330
3355,2228989900,465297,2229455197,11,0,0,49152,11,7966996301
3356,2228997739,382918,2229380657,8,0,0,12288,8,10262324198
3357,2229000474,10707,2229011181,19,0,1,2048,19,8960606899
3358,2229018200,14804,2229033004,23,0,1,28672,23,1171658827
3359,2229021300,839206,2229860506,18,0,0,12800,18,8080759974
3360,2229021781,12209,2229033990,34,0,1,1536,34,5594017406
3361,2229027202,8094,2229035296,4,0,1,2048,4,5564963799
3362,2229042100,256704,2229298804,33,0,0,3072,33,4801247857
3363,2229047783,586674,2229634457,40,0,0,49152,40,1517536749
3364,2229049558,6257,2229055815,19,0,1,10240,19,8371899660
3365,2229053829,786897,2229840726,12,0,0,30720,12,3170935138
3366,2229058049,259130,2229317179,45,0,0,5632,45,3461181251
3367,2229062309,667044,2229729353,30,0,0,94720,30,6437126925
3368,2229068728,579004,2229647732,40,0,0,43520,40,6491482921
3369,2229071932,297931,2229369863,9,0,0,14336,9,4398031072
3370,2229081977,6382,2229088359,23,0,1,9728,23,1686171139
3371,2229092812,523675,2229616487,4,0,0,19968,4,616786416
3372,2229094186,332940,2229427126,31,0,0,9728,31,7045517421
3373,2229096010,192245,2229288255,27,0,0,1536,27,7988496979
3374,2229106522,462520,2229569042,33,0,0,15872,33,4210093823
3375,2229109294,681851,2229791145,13,0,0,17408,13,822898906
3376,2229131258,621720,2229752978,25,0,0,11264,25,2651868290
3377,2229139736,688792,2229828528,9,0,0,7680,9,9577667614
3378,2229147056,366447,2229513503,46,0,0,22016,46,8017923793
3379,2229151945,467521,2229619466,1,0,0,9728,1,6596752840
3380,2229169863,336917,2229506780,24,0,0,44544,24,8286607101
3381,2229174731,656620,2229831351,43,0,0,9216,43,4153892113
3382,2229184816,507049,2229691865,25,0,0,28672,25,4048371193
3383,2229195419,43618,2229239037,9,0,1,5120,9,10503204785
3384,2229217329,547675,2229765004,7,0,0,7680,7,5250197744
3385,2229227716,598457,2229826173,34,0,0,7680,34,3367473727
3386,2229241610,299234,2229540844,46,0,0,4608,46,8807598120
3387,2229266641,715983,2229982624,20,0,0,25088,20,5262129815
3388,2229278601,13636,2229292237,41,0,1,4096,41,663580652
3389,2229278799,507019,2229785818,26,0,0,37888,26,6155599547
3390,2229282073,13226,2229295299,48,0,1,14336,48,1238007203
3391,2229282793,525371,2229808164,49,0,0,55808,49,2641300550
3392,2229285891,11354,2229297245,8,0,1,3072,8,10402386687
3393,2229293903,4949,2229298852,0,0,1,10752,0,568110937
3394,2229310468,433572,2229744040,33,0,0,28160,33,10455887684
3395,2229318277,711510,2230029787,23,0,0,9216,23,8607989892
3396,2229330793,644172,2229974965,46,0,0,85504,46,8209327035
3397,2229346854,415787,2229762641,15,0,0,29696,15,6344992195
3398,2229353429,576023,2229929452,1,0,0,1024,1,4901447114
3399,2229357209,638657,2229995866,35,0,0,6144,35,10426866888
3400,2229373731,19743,2229393474,13,0,1,21504,13,533041562
3401,2229381750,18293,2229400043,11,0,1,19456,11,2130561528
3402,2229389021,637943,2230026964,12,0,0,79872,12,5944426609
3403,2229395199,13677,2229408876,18,0,1,9216,18,5732893924
3404,2229398416,506861,2229905277,30,0,0,28672,30,736506221
3405,2229408175,326988,2229735163,6,0,0,4608,6,4406147096
3406,2229412474,493301,2229905775,18,0,0,1536,18,6027817229
3407,2229414401,641105,2230055506,31,0,0,32768,31,4556139972
3408,2229427847,521051,2229948898,26,0,0,34304,26,4186045231
3409,2229428302,26918,2229455220,19,0,1,27136,19,4987892665
3410,2229441803,556597,2229998400,41,0,0,6144,41,5464747573
3411,2229457074,12013,2229469087,33,0,1,1024,33,3392196736
3412,2229470541,347482,2229818023,7,0,0,32256,7,1122406938
3413,2229472128,558774,2230030902,42,0,0,3584,42,6024100940
3414,2229503647,539331,2230042978,11,0,0,29696,11,4012511940
3415,2229561304,574499,2230135803,33,0,0,12288,33,4592519824
3416,2229579943,814883,2230394826,21,0,0,50176,21,4987299360
3417,2229580398,1432560,2231012958,23,0,0,23552,23,7440684836
3418,2229590525,639668,2230230193,9,0,0,512,9,2047130926
3419,2229595833,1042,2229596875,14,0,1,1024,14,8969584581
3420,2229604267,618234,2230222501,13,0,0,6656,13,4605261062
3421,2229640848,1045741,2230686589,38,0,0,33280,38,116691980
3422,2229653728,553398,2230207126,33,0,0,57856,33,3561645602
3423,2229685673,693827,2230379500,12,0,0,123392,12,2262013304
3424,2229687103,7742,2229694845,29,0,1,3072,29,1958973846
3425,2229689489,755234,2230444723,32,0,0,2560,32,8659109630
3426,2229692771,3380,2229696151,46,0,1,2048,46,6984526811
3427,2229700681,922593,2230623274,25,0,0,35328,25,5915242711
3428,2229731334,456838,2230188172,29,0,0,48640,29,1925177221
3429,2229737910,385900,2230123810,27,0,0,11264,27,165253963
3430,2229738617,1409406,2231148023,44,0,0,13312,44,1997059129
3431,2229751486,667279,2230418765,25,0,0,78336,25,7605557125
3432,2229754092,466366,2230220458,0,0,0,30208,0,4684889496
3433,2229767916,5326,2229773242,46,0,1,5632,46,9930063047
3434,2229776326,1560832,2231337158,38,0,0,40448,38,815510575
3435,2229798244,42497,2229840741,20,0,1,8192,20,10098536613
3436,2229801534,635513,2230437047,27,0,0,37888,27,3491083715
3437,2229835916,264136,2230100052,10,0,0,32256,10,2791974687
3438,2229854390,822044,2230676434,47,0,0,13312,47,8177096445
3439,2229887783,17509,2229905292,35,0,1,18944,35,5664891145
3440,2229901134,5675,2229906809,15,0,1,1024,15,3448772904
3441,2229911717,513771,2230425488,44,0,0,22016,44,8631455123
3442,2229911794,564105,2230475899,17,0,0,66048,17,1764576755
3443,2229921251,566051,2230487302,18,0,0,37376,18,251474868
3444,2229932896,329316,2230262212,2,0,0,5632,2,8877387570
3445,2229946451,381714,2230328165,9,0,0,18432,9,7430150858
3446,2229951369,296707,2230248076,45,0,0,1024,45,3644879612
3447,2229959833,593805,2230553638,31,0,0,35840,31,6172327600
3448,2229960939,194610,2230155549,5,0,0,3584,5,9517710948
3449,2229965415,677382,2230642797,38,0,0,64000,38,10722397942
3450,2229966706,18905,2229985611,21,0,1,8704,21,10354052633
3451,2229987116,892260,2230879376,42,0,0,36352,42,10265086386
3452,2229993871,4544,2229998415,39,0,1,4096,39,2974441419
3453,2230018224,594271,2230612495,10,0,0,28160,10,7610019812
3454,2230043856,453469,2230497325,10,0,0,23040,10,2650862385
3455,2230049206,529389,2230578595,17,0,0,39936,17,9107226727
3456,2230052163,620200,2230672363,14,0,0,18944,14,5373144762
3457,2230061583,659120,2230720703,22,0,0,25600,22,1220220689
3458,2230070182,494133,2230564315,31,0,0,6144,31,9802973161
3459,2230071453,618271,2230689724,25,0,0,10240,25,3872132605
3460,2230097763,391894,2230489657,7,0,0,7680,7,5022170882
3461,2230103977,695008,2230798985,43,0,0,39424,43,3036795874
3462,2230112362,327516,2230439878,3,0,0,9216,3,9115697001
3463,2230114082,811481,2230925563,33,0,0,51200,33,9568663657
3464,2230164237,481883,2230646120,13,0,0,10752,13,7196284659
3465,2230205517,16999,2230222516,43,0,1,22528,43,1008771031
3466,2230237134,725576,2230962710,22,0,0,6656,22,1427640094
3467,2230268009,705729,2230973738,12,0,0,7168,12,6264251373
3468,2230291088,612639,2230903727,46,0,0,79872,46,5452582660
3469,2230315058,1074519,2231389577,43,0,0,3072,43,3324793143
3470,2230326626,601152,2230927778,25,0,0,7168,25,159861591
3471,2230335697,2946,2230338643,48,0,1,3072,48,481915312
3472,2230340895,38620,2230379515,21,0,1,4608,21,413560243
3473,2230345740,695297,2231041037,41,0,0,19968,41,1436962548
3474,2230354120,85797,2230439917,18,0,1,2560,18,1018876647
3475,2230354912,419884,2230774796,46,0,0,5120,46,10714320720
3476,2230359459,447497,2230806956,1,0,0,26112,1,6522933835
3477,2230360530,579119,2230939649,13,0,0,38912,13,3757607660
3478,2230363793,684462,2231048255,47,0,0,10752,47,3128109875
3479,2230365072,408149,2230773221,37,0,0,79360,37,8890495534
3480,2230374989,764865,2231139854,17,0,0,46080,17,1834204224
3481,2230421614,439635,2230861249,46,0,0,2560,46,1996822236
3482,2230433370,13780,2230447150,35,0,1,7680,35,7270871425
3483,2230436585,151417,2230588002,3,0,1,237056,3,179310271
3484,2230446205,1015789,2231461994,47,0,0,22528,47,3577425085
3485,2230466952,1036356,2231503308,8,0,0,31232,8,4374645238
3486,2230468788,491849,2230960637,34,0,0,60416,34,4907584365
3487,2230473626,336785,2230810411,8,0,0,11264,8,4279695143
3488,2230477743,528024,2231005767,20,0,0,59392,20,3414556467
3489,2230487109,662423,2231149532,28,0,0,1024,28,6242582091
3490,2230517135,608664,2231125799,31,0,0,39936,31,3133959615
3491,2230519051,660292,2231179343,7,0,0,10240,7,10533727002
3492,2230529365,624331,2231153696,37,0,0,4608,37,3114308957
3493,2230532595,55753,2230588348,10,0,1,512,10,3611831144
3494,2230547902,675677,2231223579,16,0,0,7168,16,4056697435
3495,2230562610,29604,2230592214,32,0,1,6144,32,9362396287
3496,2230571324,488257,2231059581,33,0,0,2560,33,1619591654
3497,2230583459,432240,2231015699,27,0,0,3072,27,8457324923
3498,2230598871,778940,2231377811,49,0,0,12288,49,9244897253
3499,2230606437,611468,2231217905,35,0,0,53760,35,6273864640
3500,2230610216,714603,2231324819,38,0,0,80896,38,984301199
3501,2230610490,763538,2231374028,40,0,0,110592,40,5691224372
3502,2230613835,230590,2230844425,30,0,1,326144,30,10502179193
3503,2230627345,757146,2231384491,42,0,0,7168,42,2946459829
3504,2230655554,1065640,2231721194,20,0,0,8704,20,3140007098
3505,2230666029,183542,2230849571,19,0,1,8192,19,3529792074
3506,2230695472,486054,2231181526,35,0,0,1536,35,2243937152
3507,2230703693,1098220,2231801913,47,0,0,10240,47,6254195409
3508,2230710486,437864,2231148350,38,0,0,1024,38,6624737314
3509,2230716454,542031,2231258485,30,0,0,3072,30,1424344253
3510,2230725368,366915,2231092283,11,0,0,512,11,8832738303
3511,2230743091,677079,2231420170,14,0,0,46592,14,1997246936
3512,2230763712,753657,2231517369,13,0,0,32256,13,6406357538
3513,2230782020,931840,2231713860,7,0,0,9216,7,10109475121
3514,2230804495,791775,2231596270,21,0,0,113152,21,8859501662
3515,2230836356,503961,2231340317,21,0,0,4608,21,7927113230
3516,2230852661,602454,2231455115,35,0,0,42496,35,9295052474
3517,2230854796,744305,2231599101,43,0,0,9216,43,354641941
3518,2230856150,284031,2231140181,29,0,0,1024,29,5448592189
3519,2230857782,283506,2231141288,4,0,0,3584,4,609182834
3520,2230885406,184767,2231070173,21,0,0,9728,21,7516496134
3521,2230891010,631522,2231522532,2,0,0,16896,2,10199171294
3522,2230896293,759144,2231655437,2,0,0,8192,2,2089065546
3523,2230904050,968676,2231872726,45,0,0,12800,45,1728840685
3524,2230912912,1280041,2232192953,21,0,0,11264,21,4882324993
3525,2230914458,1135125,2232049583,19,0,0,5632,19,6327853850
3526,2230928680,31972,2230960652,4,0,1,3584,4,4240967159
3527,2230929950,30717,2230960667,43,0,1,2560,43,8557188479
3528,2230954042,798536,2231752578,45,0,0,4096,45,1198869540
3529,2230964859,11791,2230976650,14,0,1,19456,14,6518148391
3530,2230964897,12099,2230976996,21,0,1,512,21,581723358
3531,2230972919,255979,2231228898,10,0,0,17408,10,3665755866
3532,2230987391,255738,2231243129,10,0,0,3072,10,1766124684
3533,2231002020,650866,2231652886,4,0,0,23040,4,1262555421
3534,2231003924,232042,2231235966,19,0,0,12288,19,3848437516
3535,2231015035,630816,2231645851,20,0,0,76288,20,4303681095
3536,2231024817,457592,2231482409,20,0,0,10240,20,1957400180
3537,2231030475,768303,2231798778,19,0,0,29696,19,7768926244
3538,2231047542,13530,2231061072,7,0,1,21504,7,3492109918
3539,2231057633,434869,2231492502,33,0,0,18432,33,467235939
3540,2231063857,940269,2232004126,37,0,0,78848,37,2200086013
3541,2231069746,213160,2231282906,3,0,1,344064,3,6139357096
3542,2231071425,407849,2231479274,8,0,0,13824,8,2529901227
3543,2231077424,541346,2231618770,29,0,0,30720,29,8423379421
3544,2231137625,626824,2231764449,49,0,0,38912,49,9599044005
3545,2231137705,903073,2232040778,19,0,0,16896,19,10479859480
3546,2231165744,531224,2231696968,19,0,0,59392,19,5957357728
3547,2231172266,770820,2231943086,23,0,0,13824,23,261763031
3548,2231189999,779683,2231969682,32,0,0,3584,32,7551552569
3549,2231205297,947977,2232153274,34,0,0,512,34,2897381934
3550,2231222798,795391,2232018189,14,0,0,46080,14,5956208896
3551,2231224814,1218057,2232442871,29,0,0,33792,29,4933270043
3552,2231238015,1070977,2232308992,16,0,0,19456,16,9949039642
3553,2231252487,30880,2231283367,43,0,1,10240,43,9601971649
3554,2231268977,709301,2231978278,34,0,0,4096,34,5072159216
3555,2231291637,799457,2232091094,24,0,0,35840,24,5231523828
3556,2231296806,850970,2232147776,38,0,0,69632,38,9672309507
3557,2231298714,436030,2231734744,24,0,0,22528,24,3784309320
3558,2231324035,1072482,2232396517,2,0,0,43008,2,5527706325
3559,2231333665,819438,2232153103,37,0,0,17408,37,4696914138
3560,2231337181,881395,2232218576,28,0,0,59904,28,689546773
3561,2231345076,729880,2232074956,33,0,0,43008,33,6252548022
3562,2231348516,474764,2231823280,27,0,0,23040,27,3006405324
3563,2231352501,32005,2231384506,12,0,1,13312,12,4863960457
3564,2231360632,1011970,2232372602,24,0,0,45056,24,9146899971
3565,2231362105,24195,2231386300,4,0,1,4608,4,6728963302
3566,2231369688,1135307,2232504995,35,0,0,1536,35,3868171541
3567,2231374648,431180,2231805828,24,0,0,12800,24,2477743504
3568,2231390677,273527,2231664204,47,0,0,28672,47,3104660831
3569,2231391949,631091,2232023040,31,0,0,15872,31,2959068164
3570,2231394332,859184,2232253516,35,0,0,11776,35,7423537607
3571,2231396605,303547,2231700152,29,0,0,9728,29,6960499342
3572,2231400261,902788,2232303049,47,0,0,26624,47,5168179987
3573,2231452357,1321061,2232773418,18,0,0,15872,18,1756434733
3574,2231455494,776020,2232231514,1,0,0,11264,1,2366221014
3575,2231457452,637446,2232094898,17,0,0,10752,17,6500436686
3576,2231463739,891447,2232355186,15,0,0,1536,15,7127043580
3577,2231479589,952963,2232432552,36,0,0,26624,36,3865724667
3578,2231486412,786089,2232272501,14,0,0,6144,14,3145463479
3579,2231491121,827267,2232318388,38,0,0,23040,38,8223532223
3580,2231492734,890664,2232383398,22,0,0,512,22,6243626557
3581,2231503454,1155178,2232658632,9,0,0,13312,9,1478649137
3582,2231519648,8847,2231528495,28,0,1,14848,28,2329638416
3583,2231552153,355926,2231908079,17,0,0,12288,17,1382380966
3584,2231563545,1177257,2232740802,36,0,0,4608,36,9233137695
3585,2231583836,1034961,2232618797,1,0,0,55808,1,1213290989
3586,2231610802,659812,2232270614,37,0,0,17920,37,7380410963
3587,2231616275,47952,2231664227,2,0,1,53248,2,6590704132
3588,2231623908,620393,2232244301,18,0,0,12800,18,6222870306
3589,2231627899,924807,2232552706,42,0,0,82944,42,6814073203
3590,2231629485,721576,2232351061,4,0,0,48640,4,9501080971
3591,2231635036,462529,2232097565,10,0,0,8704,10,1160212122
3592,2231635157,993982,2232629139,12,0,0,8704,12,4328347887
3593,2231640070,1041665,2232681735,41,0,0,75776,41,802650591
3594,2231644205,22937,2231667142,14,0,1,3072,14,3043914138
3595,2231646316,1046385,2232692701,27,0,0,4608,27,4606119165
3596,2231662682,859370,2232522052,48,0,0,22016,48,9443214905
3597,2231663537,672689,2232336226,22,0,0,29696,22,6915143277
3598,2231665427,625728,2232291155,41,0,0,14848,41,8726446858
3599,2231666206,746105,2232412311,37,0,0,51712,37,5031656055
3600,2231674075,591064,2232265139,34,0,0,35328,34,5803782755
3601,2231684322,917440,2232601762,47,0,0,89088,47,8219380546
3602,2231709759,933496,2232643255,35,0,0,14336,35,9664765582
3603,2231712472,1148153,2232860625,0,0,0,5120,0,3463436843
3604,2231738278,237093,2231975371,23,0,0,9216,23,7715300978
3605,2231763889,531033,2232294922,45,0,0,12288,45,3636472032
3606,2231767276,963342,2232730618,48,0,0,5632,48,2970654777
3607,2231769520,1042,2231770562,48,0,1,1024,48,9286298235
3608,2231775050,749357,2232524407,43,0,0,7680,43,1259824019
3609,2231809172,745889,2232555061,2,0,0,7680,2,4878921432
3610,2231823198,912115,2232735313,41,0,0,15360,41,7503281580
3611,2231832040,1967220,2233799260,30,0,0,35328,30,843427120
3612,2231833746,950861,2232784607,0,0,0,26112,0,8590987666
3613,2231837023,800430,2232637453,43,0,0,10752,43,6729318148
3614,2231853199,874538,2232727737,37,0,0,33280,37,7595518280
3615,2231856675,557999,2232414674,24,0,0,7680,24,4664624528
3616,2231874755,1817479,2233692234,16,0,0,28672,16,9992829476
3617,2231876130,762742,2232638872,48,0,0,4608,48,9589847852
3618,2231878035,1572618,2233450653,10,0,0,31744,10,1540997387
3619,2231888654,494573,2232383227,29,0,0,512,29,10331717463
3620,2231894940,1117605,2233012545,4,0,0,40960,4,9629295862
3621,2231895576,3904,2231899480,21,0,1,10752,21,3237513386
3622,2231901741,338645,2232240386,22,0,0,2048,22,9286197960
3623,2231907324,517053,2232424377,32,0,0,31744,32,8000672674
3624,2231912626,206355,2232118981,2,0,0,512,2,2621034134
3625,2231915541,467515,2232383056,29,0,0,20992,29,7605223287
3626,2231915676,3412,2231919088,34,0,0,14336,34,4050333807
3627,2231915676,897255,2232812931,21,0,1,9728,21,2735373273
3628,2231937456,1014160,2232951616,44,0,0,46080,44,3167718
3629,2231958491,4374,2231962865,44,0,1,4608,44,34007673
3630,2231982388,63989,2232046377,14,0,1,41984,14,4519558674
3631,2232007805,39955,2232047760,24,0,1,14848,24,1802736120
3632,2232014458,878880,2232893338,20,0,0,21504,20,4461171844
3633,2232021320,483192,2232504512,27,0,0,50176,27,3936573786
3634,2232027324,829003,2232856327,47,0,0,58368,47,6316215820
3635,2232030111,661155,2232691266,28,0,0,31232,28,291284864
3636,2232052271,1063608,2233115879,46,0,0,40960,46,9950552779
3637,2232053512,6278,2232059790,14,0,1,6656,14,6498283820
3638,2232058153,863607,2232921760,2,0,0,29184,2,8564762026
3639,2232093261,844300,2232937561,2,0,0,33280,2,4584340522
3640,2232100244,869272,2232969516,44,0,0,3584,44,7913237067
3641,2232103959,755051,2232859010,37,0,0,8704,37,10084797191
3642,2232104031,1134046,2233238077,47,0,0,33792,47,1532297790
3643,2232109670,688086,2232797756,32,0,0,4608,32,10560000272
3644,2232127319,99280,2232226599,2,0,1,119296,2,1325468626
3645,2232133449,500713,2232634162,20,0,0,16384,20,926750660
3646,2232139751,486705,2232626456,31,0,0,25088,31,3498600840
3647,2232148121,764732,2232912853,41,0,0,64000,41,8447114077
3648,2232149554,818839,2232968393,17,0,0,9216,17,7169711755
3649,2232159066,149949,2232309015,3,0,1,130560,3,8519532517
3650,2232186929,984034,2233170963,19,0,0,24576,19,8731950597
3651,2232196040,362780,2232558820,20,0,0,12288,20,9340508578
3652,2232221823,474283,2232696106,46,0,0,1536,46,5328251395
3653,2232230204,1192267,2233422471,22,0,0,47104,22,9758584437
3654,2232232458,326533,2232558991,7,0,0,512,7,10512302695
3655,2232240526,987240,2233227766,3,0,0,78336,3,3733682243
3656,2232246969,728654,2232975623,41,0,0,19968,41,4315612135
3657,2232285957,714093,2233000050,5,0,0,13824,5,2521367508
3658,2232286463,1019891,2233306354,24,0,0,21504,24,246305966
3659,2232286696,551832,2232838528,17,0,0,34304,17,7961741208
3660,2232292547,2077197,2234369744,27,0,0,15872,27,5257400004
3661,2232307526,43566,2232351092,35,0,1,9216,35,3266569166
3662,2232333299,463038,2232796337,14,0,0,1536,14,8080250442
3663,2232336171,725647,2233061818,34,0,0,2560,34,799977132
3664,2232354704,745268,2233099972,37,0,0,53248,37,3351375985
3665,2232376065,20467,2232396532,29,0,1,10752,29,8927652571
3666,2232376102,419752,2232795854,3,0,0,36864,3,10445836872
3667,2232386166,56728,2232442894,43,0,1,3584,43,5580319938
3668,2232390275,575295,2232965570,41,0,0,29184,41,8508303344
3669,2232396719,752608,2233149327,26,0,0,9728,26,6291443162
3670,2232399877,595946,2232995823,2,0,0,22528,2,4508096108
3671,2232401880,621839,2233023719,45,0,0,2048,45,1230182854
3672,2232403536,402971,2232806507,20,0,0,28672,20,2717436513
3673,2232405040,722554,2233127594,20,0,0,38400,20,7890821814
3674,2232408020,34889,2232442909,41,0,1,8192,41,7054552708
3675,2232419076,712137,2233131213,2,0,0,11776,2,2474542151
3676,2232430620,940648,2233371268,5,0,0,1536,5,3777271197
3677,2232443968,80454,2232524422,11,0,1,1536,11,833479680
3678,2232453826,1724974,2234178800,2,0,1,355840,2,7346640215
3679,2232456852,1568694,2234025546,49,0,0,8192,49,22330268
3680,2232470751,605145,2233075896,12,0,0,2048,12,5798409775
3681,2232483820,697633,2233181453,47,0,0,24576,47,9220818356
3682,2232497037,1071649,2233568686,4,0,0,98816,4,476217036
3683,2232498242,429164,2232927406,17,0,0,12288,17,9859636587
3684,2232502182,763708,2233265890,3,0,0,39936,3,6839209366
3685,2232512053,1154207,2233666260,3,0,0,8704,3,10556729413
3686,2232512941,1675873,2234188814,21,0,1,16896,21,793152091
3687,2232520194,680537,2233200731,25,0,0,1024,25,3461206210
3688,2232532861,1672616,2234205477,34,0,1,512,34,3746050213
3689,2232539561,1668031,2234207592,24,0,1,7680,24,7531283970
3690,2232541305,1712133,2234253438,29,0,1,6144,29,1490720131
3691,2232555937,1697516,2234253453,48,0,1,3584,48,5643783728
3692,2232569208,387431,2232956639,30,0,0,16384,30,6179266537
3693,2232581010,1672458,2234253468,8,0,1,2560,8,9522332139
3694,2232584897,855580,2233440477,9,0,0,14336,9,3659682632
3695,2232604875,1078568,2233683443,0,0,0,56320,0,10007620730
3696,2232610811,974028,2233584839,20,0,0,11264,20,6497582426
3697,2232611154,634137,2233245291,41,0,0,5120,41,10375001368
3698,2232643449,2082287,2234725736,1,0,0,112128,1,7988182883
3699,2232644321,1222021,2233866342,43,0,0,51712,43,9854048001
3700,2232645058,943251,2233588309,11,0,0,2560,11,5766403394
3701,2232646569,1264971,2233911540,32,0,0,59904,32,7514896438
3702,2232662639,1874022,2234536661,43,0,0,56320,43,5391162965
3703,2232676590,719889,2233396479,3,0,0,7168,3,7707211623
3704,2232685802,557914,2233243716,42,0,0,18432,42,4054547365
3705,2232698646,1771640,2234470286,19,0,1,47616,19,3952227123
3706,2232700734,1274248,2233974982,39,0,0,3584,39,9735678808
3707,2232751448,284137,2233035585,14,0,0,512,14,7056313323
3708,2232774646,679298,2233453944,12,0,0,10752,12,7675848158
3709,2232806551,274395,2233080946,25,0,0,1536,25,7196923985
3710,2232818446,696939,2233515385,6,0,0,37888,6,8107704324
3711,2232833046,474727,2233307773,16,0,0,4608,16,8585448683
3712,2232836602,1658270,2234494872,43,0,1,6656,43,950252080
3713,2232844634,1941986,2234786620,2,0,1,154112,2,3768900459
3714,2232847340,486177,2233333517,17,0,0,42496,17,5967742916
3715,2232851279,845228,2233696507,16,0,0,8704,16,2949082355
3716,2232855511,501641,2233357152,43,0,0,7680,43,4289262076
3717,2232856905,642683,2233499588,37,0,0,24576,37,10512835925
3718,2232861826,1326973,2234188799,34,0,0,32768,34,1877821758
3719,2232866595,634412,2233501007,49,0,0,4608,49,609473862
3720,2232888274,775319,2233663593,21,0,0,83968,21,2286922562
3721,2232891654,1265321,2234156975,16,0,0,10240,16,7878853263
3722,2232911502,370485,2233281987,41,0,0,3584,41,5418614836
3723,2232926571,1873986,2234800557,31,0,1,7680,31,9179699228
3724,2232933147,654367,2233587514,25,0,0,8704,25,10394184055
3725,2232934813,1605919,2234540732,10,0,0,13312,10,4859513173
3726,2232942322,1858250,2234800572,33,0,1,3584,33,7080907134
3727,2232943986,396098,2233340084,14,0,0,21504,14,6593778926
3728,2232967074,726750,2233693824,26,0,0,1024,26,8962774648
3729,2232977239,1864808,2234842047,41,0,1,12800,41,8824623013
3730,2232983405,1756573,2234739978,34,0,0,21504,34,4550356259
3731,2233002452,833468,2233835920,35,0,0,70144,35,2123358018
3732,2233044252,803554,2233847806,18,0,0,29184,18,2367135021
3733,2233050502,727842,2233778344,2,0,0,35840,2,9891234842
3734,2233057168,647578,2233704746,2,0,0,512,2,2906614636
3735,2233061597,184185,2233245782,45,0,0,1536,45,6865661636
3736,2233079525,501188,2233580713,14,0,0,39424,14,3110149279
3737,2233083484,1922065,2235005549,33,0,0,17408,33,9874177870
3738,2233089180,402897,2233492077,2,0,0,21504,2,6248790288
3739,2233109671,783602,2233893273,39,0,0,16896,39,7323821935
3740,2233114541,1800363,2234914904,36,0,0,25600,36,1433071392
3741,2233121583,757753,2233879336,28,0,0,19968,28,8484854334
3742,2233127804,300142,2233427946,38,0,0,17920,38,3785818773
3743,2233170434,678323,2233848757,28,0,0,3072,28,2006157569
3744,2233170437,917093,2234087530,27,0,0,5120,27,4415364378
3745,2233216357,1966832,2235183189,27,0,0,20480,27,6189900345
3746,2233234408,387205,2233621613,49,0,0,3072,49,2191525027
3747,2233248566,863269,2234111835,23,0,0,21504,23,8392911452
3748,2233250200,804715,2234054915,16,0,0,45568,16,3052557482
3749,2233258578,2056545,2235315123,45,0,0,46592,45,4447102210
3750,2233265230,703794,2233969024,33,0,0,40960,33,4309851757
3751,2233293737,471465,2233765202,34,0,0,34816,34,1258907142
3752,2233299465,586438,2233885903,26,0,0,21504,26,8530105781
3753,2233299477,467932,2233767409,16,0,0,7168,16,2520568111
3754,2233306335,398240,2233704575,35,0,0,13824,35,4338738740
3755,2233308266,624818,2233933084,10,0,0,8704,10,8565050988
3756,2233315468,2280177,2235595645,18,0,0,2048,18,8290767683
3757,2233320011,434568,2233754579,49,0,0,50176,49,3075121777
3758,2233336965,271771,2233608736,3,0,0,9216,3,5271258093
3759,2233338290,1481212,2234819502,49,0,0,50688,49,10553751965
3760,2233344362,386636,2233730998,48,0,0,1024,48,10591746286
3761,2233348568,1195923,2234544491,25,0,0,12288,25,8664113063
3762,2233351371,562368,2233913739,43,0,0,7168,43,6283464094
3763,2233357114,821671,2234178785,45,0,0,52736,45,2606396577
3764,2233363558,217818,2233581376,17,0,0,2048,17,8526288829
3765,2233375561,497668,2233873229,26,0,0,22528,26,3675351743
3766,2233391029,1451684,2234842713,24,0,1,1024,24,9829752113
3767,2233413428,1429631,2234843059,12,0,1,512,12,843331702
3768,2233448727,1376429,2234825156,18,0,0,4096,18,3175939525
3769,2233449087,2222594,2235671681,32,0,0,2560,32,8107744069
3770,2233471900,366999,2233838899,40,0,0,9728,40,4266967061
3771,2233478997,577961,2234056958,32,0,0,6656,32,4233846421
3772,2233491257,482618,2233973875,6,0,0,15872,6,10105849555
3773,2233495507,1275888,2234771395,28,0,0,50688,28,3584724335
3774,2233530152,812155,2234342307,44,0,0,74240,44,5338046979
3775,2233533802,671177,2234204979,19,0,0,17920,19,1200407514
3776,2233542969,345133,2233888102,7,0,0,7168,7,5016515819
3777,2233550768,1401424,2234952192,0,0,0,6144,0,1779040465
3778,2233551405,702002,2234253407,4,0,0,57344,4,8470640149
3779,2233559311,760353,2234319664,26,0,0,45568,26,8929703969
3780,2233560109,737061,2234297170,9,0,0,50688,9,6721080357
3781,2233566007,711718,2234277725,37,0,0,7168,37,2741221777
3782,2233582211,111286,2233693497,11,0,0,4096,11,4075406410
3783,2233599721,422652,2234022373,5,0,0,47104,5,7944947840
3784,2233600053,472949,2234073002,43,0,0,36864,43,9515574732
3785,2233606374,524816,2234131190,6,0,0,2560,6,2551571667
3786,2233607249,2150632,2235757881,4,0,0,22016,4,782796597
3787,2233609091,1124304,2234733395,35,0,0,25088,35,54384526
3788,2233620815,1402275,2235023090,39,0,0,20992,39,3674369494
3789,2233627361,1352863,2234980224,45,0,0,22528,45,9951427743
3790,2233640355,1203370,2234843725,41,0,1,1024,41,3849020025
3791,2233648934,821337,2234470271,49,0,0,17920,49,3098987918
3792,2233651536,699717,2234351253,48,0,0,12800,48,9376822852
3793,2233654192,977885,2234632077,39,0,0,13824,39,4394409626
3794,2233665416,427572,2234092988,34,0,0,512,34,2045389539
3795,2233678971,1121571,2234800542,41,0,0,34816,41,3207929986
3796,2233681275,1165676,2234846951,15,0,1,5120,15,3733460665
3797,2233699479,1149098,2234848577,34,0,1,2560,34,6255867894
3798,2233713114,1161045,2234874159,8,0,1,6656,8,203776114
3799,2233713868,491594,2234205462,22,0,0,1536,22,5009301970
3800,2233716289,645800,2234362089,4,0,0,7680,4,3034980690
3801,2233734801,1139704,2234874505,14,0,1,512,14,3081515658
3802,2233735294,406804,2234142098,32,0,0,3072,32,1094465985
3803,2233735909,287118,2234023027,11,0,0,1536,11,7484439543
3804,2233762065,1467329,2235229394,21,0,0,39424,21,9469397187
3805,2233770872,1108818,2234879690,15,0,1,16384,15,371990807
3806,2233774880,1187527,2234962407,8,0,1,12288,8,3440083721
3807,2233797011,1166472,2234963483,11,0,1,13312,11,4457266716
3808,2233800995,551397,2234352392,33,0,0,3584,33,4684230946
3809,2233803339,219205,2234022544,27,0,0,512,27,2592439213
3810,2233805484,1194746,2235000230,2,0,0,38912,2,4114937403
3811,2233807024,1229303,2235036327,8,0,1,512,8,5083775956
3812,2233810394,536944,2234347338,38,0,0,16384,38,6717073507
3813,2233813412,492353,2234305765,30,0,0,28160,30,6081667301
3814,2233834007,618886,2234452893,22,0,0,13312,22,765016678
3815,2233848300,779550,2234627850,32,0,0,33280,32,9618559601
3816,2233852327,1183929,2235036256,23,0,0,15872,23,10549012625
3817,2233854323,930659,2234784982,1,0,0,44544,1,3321232717
3818,2233881523,710865,2234592388,2,0,0,11776,2,6872759013
3819,2233895121,331580,2234226701,37,0,0,1024,37,745789072
3820,2233897650,338270,2234235920,19,0,0,30208,19,2610536191
3821,2233905032,1424184,2235329216,29,0,0,28160,29,8014407861
3822,2233910770,1120603,2235031373,40,0,0,27136,40,5114983132
3823,2233914179,511258,2234425437,43,0,0,54272,43,6639602761
3824,2233921961,510043,2234432004,9,0,0,21504,9,8228492982
3825,2233925850,198431,2234124281,27,0,0,25088,27,2065751958
3826,2233928548,689147,2234617695,30,0,0,69120,30,1085940028
3827,2233931080,703219,2234634299,47,0,0,5632,47,9638734688
3828,2233939693,1207617,2235147310,16,0,0,31744,16,4066561648
3829,2233980734,766435,2234747169,38,0,0,23552,38,9974695537
3830,2233987274,1051319,2235038593,10,0,1,3584,10,3264525876
3831,2234003961,1839848,2235843809,10,0,0,15360,10,7207782994
3832,2234006719,1210562,2235217281,6,0,0,2560,6,356792447
3833,2234015904,1408195,2235424099,32,0,0,51712,32,2287072432
3834,2234024399,1512658,2235537057,31,0,0,12800,31,7372537501
3835,2234026322,468465,2234494787,15,0,0,10752,15,9049852618
3836,2234030927,1008332,2235039259,13,0,1,11264,13,8960783038
3837,2234061330,1141943,2235203273,43,0,1,13312,43,1063120345
3838,2234074209,409192,2234483401,18,0,0,28672,18,367751610
3839,2234077672,511105,2234588777,25,0,0,66048,25,484133300
3840,2234087074,901277,2234988351,34,0,0,26624,34,8972070887
3841,2234092100,731793,2234823893,42,0,0,14336,42,2949366620
3842,2234099815,825320,2234925135,7,0,0,25088,7,4157580393
3843,2234102218,1170679,2235272897,36,0,0,16384,36,801564828
3844,2234125712,1227016,2235352728,41,0,0,3072,41,8142703750
3845,2234132944,1139968,2235272912,4,0,1,2560,4,5680513371
3846,2234134689,497879,2234632568,7,0,0,1536,7,3227158063
3847,2234182730,1118166,2235300896,29,0,1,19968,29,773810552
3848,2234194821,1163823,2235358644,29,0,1,1536,29,802465202
3849,2234215676,830293,2235045969,26,0,0,7168,26,7010669917
3850,2234217835,983999,2235201834,18,0,0,5120,18,3170540696
3851,2234224891,1109180,2235334071,40,0,0,6656,40,5687377492
3852,2234230328,1129302,2235359630,41,0,1,1536,41,5814922838
3853,2234235529,520407,2234755936,47,0,0,28672,47,224888300
3854,2234273655,320152,2234593807,4,0,0,4608,4,6869841353
3855,2234277091,414458,2234691549,2,0,0,23040,2,677994859
3856,2234299249,487340,2234786589,36,0,0,5120,36,2699350982
3857,2234320991,1039305,2235360296,10,0,1,1024,10,10383042395
3858,2234327871,1314732,2235642603,10,0,0,40448,10,6961547885
3859,2234329760,1575030,2235904790,13,0,0,91648,13,10235333523
3860,2234340076,303476,2234643552,16,0,0,8704,16,2436097216
3861,2234340736,781108,2235121844,43,0,0,40448,43,4048099506
3862,2234344212,445699,2234789911,42,0,0,10752,42,4439712899
3863,2234368191,314015,2234682206,40,0,0,16384,40,6448631098
3864,2234402488,958576,2235361064,41,0,1,11776,41,2507387549
3865,2234414279,1215985,2235630264,16,0,0,49664,16,1650723959
3866,2234417739,591733,2235009472,31,0,0,12800,31,969972975
3867,2234440107,939905,2235380012,18,0,0,18432,18,4653412571
3868,2234450352,1047956,2235498308,8,0,1,2048,8,896674910
3869,2234463785,673830,2235137615,1,0,0,51712,1,3271885025
3870,2234470015,1434790,2235904805,2,0,1,151552,2,9438646827
3871,2234482476,717783,2235200259,12,0,0,48640,12,6504745268
3872,2234495187,1172925,2235668112,30,0,0,36352,30,4815317670
3873,2234509793,1238378,2235748171,19,0,0,69632,19,3866263834
3874,2234532596,1894415,2236427011,1,0,0,53760,1,6897387058
3875,2234541464,698289,2235239753,27,0,0,31232,27,9400240098
3876,2234545410,887111,2235432521,23,0,0,16384,23,2517775329
3877,2234561893,1726748,2236288641,12,0,0,43520,12,8099572536
3878,2234572899,1335540,2235908439,14,0,1,5120,14,1521995746
3879,2234594192,1440022,2236034214,6,0,0,24576,6,1277152975
3880,2234625968,942361,2235568329,28,0,0,11264,28,532152000
3881,2234636429,1977645,2236614074,4,0,0,30208,4,4650939689
3882,2234638425,378254,2235016679,42,0,0,23552,42,7454764304
3883,2234639263,831075,2235470338,16,0,0,8192,16,2112207123
3884,2234643616,743275,2235386891,27,0,0,22528,27,2845702850
3885,2234650471,941080,2235591551,32,0,0,53248,32,32202735
3886,2234669540,1355213,2236024753,39,0,0,58880,39,10011991392
3887,2234684952,848174,2235533126,4,0,0,25600,4,2237280838
3888,2234699309,1423363,2236122672,2,0,1,84992,2,4191078495
3889,2234699702,1422985,2236122687,24,0,1,5632,24,2062505866
3890,2234707189,818122,2235525311,32,0,0,77824,32,9550150019
3891,2234712286,579517,2235291803,49,0,0,61952,49,2161619721
3892,2234738551,601415,2235339966,2,0,0,1024,2,5363334502
3893,2234741427,801109,2235542536,46,0,0,2048,46,6392726310
3894,2234760848,1380605,2236141453,14,0,1,12800,14,9765379493
3895,2234766539,533235,2235299774,31,0,0,26112,31,7897498596
3896,2234779860,521021,2235300881,10,0,0,3584,10,672977664
3897,2234821026,1156471,2235977497,30,0,0,42496,30,4700656295
3898,2234825548,1315874,2236141422,29,0,0,61440,29,4706950248
3899,2234833781,560167,2235393948,39,0,0,2560,39,1149438751
3900,2234842606,425260,2235267866,48,0,0,54784,48,3126292072
3901,2234848424,1215767,2236064191,13,0,0,76288,13,3472651639
3902,2234849984,975515,2235825499,49,0,0,64000,49,8011236194
3903,2234873552,908271,2235781823,34,0,0,30208,34,9074187699
3904,2234875274,464365,2235339639,33,0,0,14848,33,5050615874
3905,2234897560,1329189,2236226749,47,0,0,13824,47,2534714720
3906,2234901115,1240353,2236141468,35,0,1,3072,35,7293887262
3907,2234901680,779445,2235681125,16,0,0,18432,16,1628734190
3908,2234902751,1242505,2236145256,14,0,1,6144,14,5305329019
3909,2234957793,906560,2235864353,12,0,0,32768,12,2235774658
3910,2234959863,1218522,2236178385,46,0,1,4608,46,10388941148
3911,2234967380,1211020,2236178400,43,0,1,13312,43,9236920950
3912,2234972439,1302904,2236275343,21,0,0,110080,21,7883869541
3913,2234983782,419643,2235403425,48,0,0,16384,48,7474953549
3914,2234991882,759268,2235751150,28,0,0,9728,28,4588343235
3915,2235001029,1332872,2236333901,22,0,0,4608,22,4757451425
3916,2235003896,1075940,2236079836,28,0,0,10240,28,1248810902
3917,2235011698,983450,2235995148,45,0,0,57856,45,9909796344
3918,2235015087,417917,2235433004,30,0,0,1536,30,6032864242
3919,2235015413,388183,2235403596,46,0,0,512,46,1136942950
3920,2235023585,571413,2235594998,45,0,0,11264,45,9263624034
3921,2235031609,1243757,2236275366,24,0,1,1536,24,580373060
3922,2235041765,615256,2235657021,33,0,0,34816,33,8596638014
3923,2235052494,646209,2235698703,0,0,0,15360,0,9281207332
3924,2235063062,1052232,2236115294,45,0,0,107520,45,10243122648
3925,2235092415,1203744,2236296159,12,0,1,6656,12,4450549402
3926,2235093436,1281455,2236374891,14,0,0,65536,14,9382678169
3927,2235095202,598806,2235694008,17,0,0,8192,17,8153362839
3928,2235129184,1166990,2236296174,8,0,1,2560,8,3308980466
3929,2235168042,1290771,2236458813,46,0,0,37376,46,9308424855
3930,2235199866,1329210,2236529076,32,0,0,45568,32,6944343403
3931,2235224154,494665,2235718819,44,0,0,1536,44,5958133304
3932,2235230343,461154,2235691497,28,0,0,16896,28,6876094075
3933,2235233219,1412139,2236645358,24,0,0,34304,24,386597513
3934,2235242160,1246258,2236488418,26,0,0,4608,26,8653062287
3935,2235247670,1132384,2236380054,22,0,0,16896,22,3716809084
3936,2235253254,1628369,2236881623,47,0,0,24576,47,4655815846
3937,2235259736,890644,2236150380,1,0,0,2048,1,3108050089
3938,2235261710,1058089,2236319799,24,0,0,55808,24,5997522890
3939,2235279655,1052803,2236332458,17,0,0,41472,17,9953194900
3940,2235285823,1157479,2236443302,22,0,0,6144,22,675631284
3941,2235302374,606034,2235908408,3,0,0,11776,3,10434953506
3942,2235371774,806596,2236178370,41,0,0,19456,41,6951292083
3943,2235386818,338013,2235724831,16,0,0,6144,16,1515104535
3944,2235414616,451624,2235866240,23,0,0,6144,23,7001852626
3945,2235436829,639872,2236076701,31,0,0,10240,31,9078469069
3946,2235441471,1068699,2236510170,18,0,0,22528,18,434320466
3947,2235442399,1216873,2236659272,49,0,0,32256,49,5023083066
3948,2235455276,375542,2235830818,39,0,0,17408,39,3973132394
3949,2235466812,913257,2236380069,43,0,1,28672,43,662603765
3950,2235468287,370827,2235839114,48,0,0,20992,48,7536885753
3951,2235470889,935496,2236406385,35,0,0,26624,35,10284923536
3952,2235471634,737865,2236209499,46,0,0,55296,46,4945552326
3953,2235491743,888341,2236380084,20,0,1,3072,20,1070845798
3954,2235498037,882062,2236380099,8,0,1,1024,8,3897086353
3955,2235498525,934273,2236432798,1,0,0,18944,1,5238582696
3956,2235512454,867660,2236380114,33,0,1,7168,33,8126465240
3957,2235515344,1431197,2236946541,16,0,0,7168,16,5519969500
3958,2235526981,546585,2236073566,11,0,0,30720,11,4765479452
3959,2235540838,1267557,2236808395,38,0,0,38912,38,3196702075
3960,2235551816,1403088,2236954904,8,0,0,26112,8,4020647568
3961,2235588784,1333909,2236922693,9,0,0,1536,9,5093423721
3962,2235595857,1266132,2236861989,2,0,1,187904,2,6487944906
3963,2235613452,509205,2236122657,25,0,0,24064,25,3171022326
3964,2235629366,1269113,2236898479,4,0,1,5632,4,7822414143
3965,2235631313,518420,2236149733,20,0,0,10752,20,6965236861
3966,2235657136,639008,2236296144,26,0,0,24576,26,8852015642
3967,2235682271,1221034,2236903305,33,0,1,7680,33,5570474090
3968,2235717879,1413192,2237131071,22,0,0,17408,22,10237584455
3969,2235721001,281494,2236002495,36,0,0,24064,36,1395361541
3970,2235735518,1670845,2237406363,25,0,0,76800,25,3668769771
3971,2235753295,329224,2236082519,27,0,0,8704,27,9572198971
3972,2235773810,849343,2236623153,0,0,0,29696,0,2456159930
3973,2235778629,1207101,2236985730,10,0,1,22016,10,7877622025
3974,2235814249,1383872,2237198121,42,0,0,31744,42,1631525600
3975,2235815209,1690493,2237505702,36,0,0,9216,36,5241990491
3976,2235843009,886886,2236729895,14,0,0,78336,14,1678032189
3977,2235843559,895125,2236738684,13,0,0,9728,13,9008997273
3978,2235846350,454371,2236300721,26,0,0,14848,26,10647072774
3979,2235853235,661942,2236515177,20,0,0,16384,20,3975275672
3980,2235865179,357001,2236222180,43,0,0,24576,43,5262005084
3981,2235867976,528065,2236396041,1,0,0,52224,1,842717727
3982,2235873592,1188874,2237062466,29,0,1,7168,29,1755056430
3983,2235874416,1461111,2237335527,41,0,0,43008,41,7607095741
3984,2235874580,1769240,2237643820,15,0,0,15872,15,10164642872
3985,2235888583,1333176,2237221759,15,0,1,35328,15,10090194756
3986,2235899136,1148246,2237047382,5,0,0,17408,5,6181031806
3987,2235907206,596085,2236503291,1,0,0,15872,1,6696034249
3988,2235925357,1914612,2237839969,29,0,0,37888,29,1953375029
3989,2235957062,672198,2236629260,25,0,0,19968,25,4787371563
3990,2235960620,1374930,2237335550,19,0,1,4096,19,7123463234
3991,2235969140,366188,2236335328,29,0,0,4608,29,196621704
3992,2236004987,167432,2236172419,27,0,0,26624,27,7255760637
3993,2236022524,280248,2236302772,0,0,0,6656,0,1051736059
3994,2236039772,513990,2236553762,19,0,0,23040,19,1629806958
3995,2236054524,1315128,2237369652,35,0,1,13312,35,4629669405
3996,2236060453,181224,2236241677,0,0,0,15872,0,424195355
3997,2236087981,319199,2236407180,44,0,0,2560,44,9180088593
3998,2236112609,592532,2236705141,10,0,0,13824,10,9701131313
3999,2236137955,904108,2237042063,42,0,0,4608,42,9122622377
4000,2236148925,647591,2236796516,21,0,0,68096,21,185484622
4001,2236150742,1355599,2237506341,23,0,0,2048,23,9653885676
4002,2236151202,886611,2237037813,2,0,0,85504,2,1396792784
4003,2236163739,734369,2236898108,11,0,0,1024,11,8647126941
4004,2236165821,645397,2236811218,4,0,0,9216,4,4102805951
4005,2236177125,789228,2236966353,27,0,0,12288,27,4429968200
4006,2236196779,470181,2236666960,20,0,0,13824,20,5490478594
4007,2236204487,1037769,2237242256,40,0,0,22016,40,8909343642
4008,2236227511,336787,2236564298,19,0,0,28160,19,2056539937
4009,2236229216,317503,2236546719,24,0,0,57856,24,4016891621
4010,2236233105,1684188,2237917293,40,0,0,2048,40,8984098629
4011,2236236448,1200209,2237436657,18,0,0,60928,18,5968752769
4012,2236253157,866059,2237119216,45,0,0,78848,45,4650223335
4013,2236268200,464050,2236732250,33,0,0,7680,33,8368890424
4014,2236271926,664500,2236936426,44,0,0,19456,44,6412683279
4015,2236279965,609161,2236889126,18,0,0,24576,18,6540056895
4016,2236293321,1672049,2237965370,2,0,1,238080,2,1184071356
4017,2236303008,656287,2236959295,39,0,0,14336,39,9890090384
4018,2236308956,1686966,2237995922,41,0,1,35840,41,1395220656
4019,2236310489,1721470,2238031959,20,0,1,9216,20,6931226969
4020,2236332879,535198,2236868077,26,0,0,12800,26,6801311104
4021,2236356561,1675413,2238031974,33,0,1,4096,33,7691804914
4022,2236360827,465484,2236826311,25,0,0,2048,25,1613672481
4023,2236366279,369418,2236735697,14,0,0,11264,14,3183207434
4024,2236366467,674169,2237040636,26,0,0,9216,26,7007830913
4025,2236384610,597621,2236982231,15,0,0,14336,15,2697896261
4026,2236387133,1089663,2237476796,27,0,0,23040,27,2854974603
4027,2236391683,568890,2236960573,11,0,0,3072,11,4735246250
4028,2236407029,227862,2236634891,27,0,0,18432,27,4418440456
4029,2236409727,549895,2236959622,42,0,0,1024,42,9863427698
4030,2236410170,941322,2237351492,5,0,0,29184,5,2863761301
4031,2236437800,211629,2236649429,32,0,0,13312,32,8784406495
4032,2236457141,1582351,2238039492,12,0,1,5120,12,10358062319
4033,2236474045,882477,2237356522,14,0,0,13312,14,7381748399
4034,2236482853,738891,2237221744,11,0,0,14848,11,5038056176
4035,2236496943,810679,2237307622,7,0,0,43520,7,1207877918
4036,2236527726,416616,2236944342,10,0,0,16384,10,2637345488
4037,2236529847,1165614,2237695461,3,0,0,30208,3,5018285482
4038,2236533231,1091781,2237625012,22,0,0,45568,22,6599041634
4039,2236537492,524829,2237062321,33,0,0,17920,33,2372007827
4040,2236539124,1504774,2238043898,29,0,1,7168,29,205276491
4041,2236551463,1399735,2237951198,1,0,0,16896,1,5020394896
4042,2236558097,711138,2237269235,3,0,0,16384,3,4245229131
4043,2236560264,758232,2237318496,21,0,0,32768,21,645933658
4044,2236562805,906956,2237469761,25,0,0,31744,25,10669129237
4045,2236565439,1254501,2237819940,2,0,0,23552,2,7267118237
4046,2236568635,1005667,2237574302,6,0,0,15872,6,2111877625
4047,2236574684,1253718,2237828402,35,0,0,19456,35,6826508977
4048,2236606822,1780396,2238387218,3,0,1,101376,3,2650607165
4049,2236611753,476273,2237088026,33,0,0,8192,33,4287839399
4050,2236627348,1761816,2238389164,41,0,1,3072,41,3931778464
4051,2236633037,804571,2237437608,46,0,0,3072,46,2933295800
4052,2236649887,925694,2237575581,5,0,0,4096,5,5254334694
4053,2236657692,789954,2237447646,1,0,0,8704,1,10472391240
4054,2236662477,513200,2237175677,12,0,0,2048,12,1886111392
4055,2236669336,673249,2237342585,28,0,0,23040,28,8123930926
4056,2236669856,489426,2237159282,15,0,0,45056,15,2622596572
4057,2236674026,1715804,2238389830,21,0,1,1024,21,509790952
4058,2236683361,1843119,2238526480,17,0,0,5120,17,5417955673
4059,2236698998,803865,2237502863,42,0,0,85504,42,943210924
4060,2236702096,347805,2237049901,5,0,0,8192,5,10449567027
4061,2236723024,963218,2237686242,18,0,0,81920,18,51942915
4062,2236729415,688663,2237418078,38,0,0,38400,38,8238414944
4063,2236729427,1715706,2238445133,11,0,1,13824,11,8675517615
4064,2236736388,780105,2237516493,17,0,0,4096,17,1582652847
4065,2236736917,615534,2237352451,12,0,0,3072,12,4563022294
4066,2236748962,1593831,2238342793,44,0,0,18944,44,8065704766
4067,2236750964,424074,2237175038,15,0,0,31232,15,5693049838
4068,2236758891,1280586,2238039477,33,0,0,24576,33,7402468920
4069,2236767110,972863,2237739973,9,0,0,9728,9,5915159770
4070,2236771671,1028210,2237799881,1,0,0,81920,1,1929417677
4071,2236776544,2010908,2238787452,18,0,0,32256,18,3475671142
4072,2236790380,1272462,2238062842,45,0,0,19968,45,9751557036
4073,2236792093,1660598,2238452691,48,0,1,24064,48,10700725735
4074,2236796544,363710,2237160254,2,0,0,1024,2,3078265275
4075,2236799923,1142813,2237942736,39,0,0,83456,39,7719489568
4076,2236819298,729729,2237549027,15,0,0,19968,15,5764237904
4077,2236822133,1366471,2238188604,34,0,0,48128,34,3988390910
4078,2236841303,1075343,2237916646,21,0,0,79360,21,3742041829
4079,2236846313,1350434,2238196747,41,0,0,26624,41,1972131744
4080,2236867357,1619400,2238486757,34,0,1,2560,34,9342171911
4081,2236902108,834862,2237736970,48,0,0,88576,48,2026287585
4082,2236949994,325305,2237275299,6,0,0,6656,6,1775795701
4083,2236958588,494073,2237452661,17,0,0,16384,17,8388143561
4084,2236965380,809510,2237774890,45,0,0,51712,45,9343180335
4085,2237011096,799587,2237810683,48,0,0,33792,48,5352040049
4086,2237011394,1890313,2238901707,33,0,0,40448,33,661460774
4087,2237024550,435524,2237460074,33,0,0,6656,33,2959735082
4088,2237043543,1440160,2238483703,35,0,0,10240,35,8901139358
4089,2237055872,468577,2237524449,44,0,0,19456,44,10258289855
4090,2237064909,1168129,2238233038,28,0,0,6656,28,567626650
4091,2237066642,299467,2237366109,41,0,0,6144,41,1625757930
4092,2237071852,1602671,2238674523,5,0,0,53248,5,1601442614
4093,2237083659,994993,2238078652,26,0,0,16896,26,4822302505
4094,2237090414,1687195,2238777609,26,0,0,17408,26,1704828716
4095,2237105316,1102678,2238207994,38,0,0,11776,38,3776095792
4096,2237131642,1188973,2238320615,25,0,0,13312,25,4752470852
4097,2237135282,309681,2237444963,21,0,0,24064,21,5905691293
4098,2237141206,751237,2237892443,46,0,0,48640,46,6238920535
4099,2237145076,379700,2237524776,19,0,0,1024,19,2013945320
4100,2237160188,1858945,2239019133,43,0,0,16384,43,5058805055
4101,2237236773,1251290,2238488063,35,0,1,2048,35,7583629060
4102,2237247383,731083,2237978466,48,0,0,20480,48,6559052216
4103,2237247883,1243914,2238491797,10,0,1,13824,10,6157840490
4104,2237256632,838461,2238095093,20,0,0,14336,20,559171145
4105,2237277055,316048,2237593103,27,0,0,18432,27,6326060128
4106,2237282684,1841883,2239124567,35,0,0,57344,35,770190230
4107,2237285195,1753981,2239039176,40,0,0,8192,40,5006175640
4108,2237296992,1214566,2238511558,48,0,1,8192,48,7727139473
4109,2237319646,1194818,2238514464,43,0,1,4608,43,3581199990
4110,2237324571,812220,2238136791,14,0,0,32256,14,6140899449
4111,2237334556,508868,2237843424,46,0,0,11264,46,2791573600
4112,2237346051,465903,2237811954,41,0,0,4096,41,2350904715
4113,2237375400,587723,2237963123,24,0,0,1536,24,3959401259
4114,2237375950,924667,2238300617,0,0,0,66560,0,1284443702
4115,2237418614,1260993,2238679607,0,0,1,83456,0,2362970111
4116,2237432984,274806,2237707790,3,0,0,3072,3,2118802443
4117,2237440710,551520,2237992230,4,0,0,3584,4,3731290317
4118,2237442272,503763,2237946035,8,0,0,10752,8,4452983820
4119,2237470147,1209475,2238679622,19,0,1,11776,19,6301194859
4120,2237471749,1207888,2238679637,12,0,1,1024,12,10206720332
4121,2237483232,1785624,2239268856,10,0,0,16896,10,9615105846
4122,2237495501,467131,2237962632,3,0,0,36352,3,9829692404
4123,2237511636,941000,2238452636,29,0,0,24576,29,6789499925
4124,2237511879,1210539,2238722418,46,0,1,10752,46,6986071285
4125,2237516992,683922,2238200914,30,0,0,2048,30,8169222575
4126,2237523101,614485,2238137586,26,0,0,2560,26,6149197210
4127,2237526643,295816,2237822459,2,0,0,8192,2,10016052942
4128,2237531058,453696,2237984754,20,0,0,14336,20,10181674939
4129,2237565885,246864,2237812749,25,0,0,2560,25,7347521775
4130,2237566622,560326,2238126948,19,0,0,31232,19,38674382
4131,2237567944,1903413,2239471357,1,0,0,5632,1,3445454924
4132,2237572971,378570,2237951541,29,0,0,1024,29,10229624105
4133,2237573333,227031,2237800364,25,0,0,1536,25,6572690391
4134,2237617387,1526486,2239143873,8,0,0,5120,8,440535900
4135,2237623480,1101620,2238725100,29,0,1,7680,29,4539498857
4136,2237654125,712026,2238366151,45,0,0,40448,45,1464494782
4137,2237674215,552907,2238227122,39,0,0,22528,39,7768033662
4138,2237700228,1093165,2238793393,11,0,1,18944,11,7616769543
4139,2237701248,627605,2238328853,22,0,0,19456,22,974329263
4140,2237707294,562085,2238269379,35,0,0,34816,35,915755737
4141,2237707825,338896,2238046721,44,0,0,9216,44,9741182147
4142,2237712062,331813,2238043875,23,0,0,14336,23,1014032445
4143,2237714318,1080381,2238794699,19,0,1,2048,19,8283393680
4144,2237717489,687625,2238405114,3,0,0,27136,3,3553275399
4145,2237720897,453028,2238173925,8,0,0,37888,8,8411429978
4146,2237721779,594765,2238316544,4,0,0,52224,4,5058876874
4147,2237729878,770800,2238500678,16,0,0,15872,16,831143597
4148,2237732325,466496,2238198821,11,0,0,2560,11,3917346708
4149,2237739686,458324,2238198010,44,0,0,4096,44,1152873163
4150,2237748501,732067,2238480568,23,0,0,40960,23,1778536706
4151,2237753232,1186635,2238939867,3,0,1,20992,3,5828652184
4152,2237758579,1143611,2238902190,38,0,0,1536,38,5592031048
4153,2237759412,1180486,2238939898,35,0,1,8192,35,8238428401
4154,2237766885,395481,2238162366,25,0,0,10240,25,9445890254
4155,2237785709,246235,2238031944,25,0,0,18432,25,7337689332
4156,2237806990,212977,2238019967,28,0,0,2048,28,281561065
4157,2237820223,996260,2238816483,40,0,0,8192,40,4781665484
4158,2237832765,1984456,2239817221,19,0,0,19968,19,10194033689
4159,2237845037,413719,2238258756,6,0,0,24576,6,3664992541
4160,2237854181,631409,2238485590,13,0,0,6144,13,7988690709
4161,2237866752,858333,2238725085,16,0,0,8704,16,898484644
4162,2237871244,1068669,2238939913,10,0,1,1536,10,3459883271
4163,2237878404,668852,2238547256,1,0,0,16384,1,3176524719
4164,2237885859,552536,2238438395,24,0,0,48128,24,2298829477
4165,2237916378,1275663,2239192041,10,0,0,5632,10,2881692823
4166,2237941915,380987,2238322902,6,0,0,7168,6,3097592577
4167,2237943062,480654,2238423716,30,0,0,56832,30,2187408673
4168,2237950113,386893,2238337006,47,0,0,26624,47,9452802170
4169,2237967016,1990601,2239957617,15,0,0,11264,15,8677662550
4170,2237976901,546891,2238523792,27,0,0,21504,27,9827542578
4171,2237982380,1113604,2239095984,16,0,0,31232,16,8321574156
4172,2238000717,610574,2238611291,45,0,0,17408,45,9400316570
4173,2238020113,488690,2238508803,36,0,0,13824,36,4998787740
4174,2238034799,535723,2238570522,9,0,0,7168,9,6121657039
4175,2238044054,322432,2238366486,15,0,0,1024,15,1112743897
4176,2238053072,911564,2238964636,3,0,1,17408,3,6443585352
4177,2238068652,376466,2238445118,30,0,0,22016,30,6145176430
4178,2238072924,1289810,2239362734,20,0,0,23040,20,5332695462
4179,2238081921,486394,2238568315,16,0,0,20480,16,4708575476
4180,2238086244,853584,2238939828,21,0,0,71680,21,6802600081
4181,2238097907,879865,2238977772,0,0,1,7168,0,3662907780
4182,2238098007,498942,2238596949,10,0,0,26624,10,6006235921
4183,2238099140,878647,2238977787,23,0,1,12288,23,4573578378
4184,2238113094,293291,2238406385,36,0,0,4096,36,4277080960
4185,2238138535,204897,2238343432,30,0,0,2048,30,4313617266
4186,2238169133,867532,2239036665,8,0,1,10240,8,7153494386
4187,2238172051,550352,2238722403,1,0,0,44032,1,9706679310
4188,2238187809,494433,2238682242,5,0,0,4608,5,9297093922
4189,2238203467,705674,2238909141,15,0,0,8704,15,7093302722
4190,2238212824,1269077,2239481901,0,0,1,248832,0,7794914696
4191,2238217088,1847743,2240064831,39,0,0,69632,39,39903025
4192,2238229284,472484,2238701768,1,0,0,15872,1,7864073184
4193,2238231594,1327075,2239558669,19,0,0,31744,19,10448999598
4194,2238231857,1336413,2239568270,10,0,1,1536,10,1129993106
4195,2238235245,1400793,2239636038,48,0,0,5120,48,5245850008
4196,2238244573,830109,2239074682,14,0,0,17920,14,7312513852
4197,2238247045,773195,2239020240,37,0,0,3584,37,2000950214
4198,2238270345,707412,2238977757,47,0,0,36864,47,6222001439
4199,2238274791,733598,2239008389,16,0,0,19968,16,977398167
4200,2238276504,884350,2239160854,37,0,0,7680,37,442510647
4201,2238286815,1311699,2239598514,43,0,1,13312,43,5448391186
4202,2238306137,989372,2239295509,22,0,0,1536,22,4948159934
4203,2238341309,695341,2239036650,42,0,0,23552,42,10205720576
4204,2238347977,1250552,2239598529,41,0,1,2560,41,7711152664
4205,2238350564,477014,2238827578,34,0,0,26112,34,3875884353
4206,2238354677,747749,2239102426,36,0,0,19968,36,2412616667
4207,2238383727,1214817,2239598544,48,0,1,9728,48,3670129927
4208,2238396933,295079,2238692012,13,0,0,19968,13,2638810499
4209,2238421189,258387,2238679576,13,0,0,9216,13,3150276879
4210,2238425041,338653,2238763694,26,0,0,2048,26,7611458454
4211,2238430468,779232,2239209700,23,0,0,32768,23,10652667796
4212,2238432351,882525,2239314876,48,0,0,63488,48,2453777872
4213,2238446031,1641123,2240087154,23,0,0,73216,23,4273527217
4214,2238449535,500251,2238949786,49,0,0,8192,49,1743025279
4215,2238463105,481347,2238944452,25,0,0,14848,25,10655384030
4216,2238477921,198832,2238676753,29,0,0,2560,29,4026375197
4217,2238481507,382040,2238863547,9,0,0,21504,9,4175443632
4218,2238513675,1633511,2240147186,20,0,0,15872,20,9869361076
4219,2238521593,1120709,2239642302,14,0,1,8192,14,7392342533
4220,2238533447,218938,2238752385,38,0,0,10240,38,420897337
4221,2238538023,531176,2239069199,7,0,0,41984,7,4378831804
4222,2238560648,115302,2238675950,34,0,0,4608,34,7533297250
4223,2238563161,389543,2238952704,21,0,0,4096,21,9843861768
4224,2238573093,617217,2239190310,41,0,0,38912,41,4559955860
4225,2238588146,231461,2238819607,1,0,0,6144,1,6288818959
4226,2238593907,492546,2239086453,47,0,0,8192,47,3063342868
4227,2238605273,165098,2238770371,0,0,0,4096,0,6406009202
4228,2238619637,627797,2239247434,37,0,0,12800,37,8102680088
4229,2238620032,409427,2239029459,34,0,0,30208,34,2042496878
4230,2238627740,1614419,2240242159,42,0,0,3584,42,3772932270
4231,2238632173,662853,2239295026,8,0,0,74752,8,4257142923
4232,2238637329,1032935,2239670264,3,0,1,35328,3,3000854994
4233,2238650428,1044486,2239694914,21,0,1,512,21,6076135635
4234,2238653815,1086132,2239739947,4,0,1,14848,4,1557452628
4235,2238658158,1518043,2240176201,21,0,0,21504,21,1438554044
4236,2238660368,289605,2238949973,46,0,0,512,46,10274763375
4237,2238669702,670825,2239340527,34,0,0,26624,34,1782162933
4238,2238671214,276061,2238947275,16,0,0,9216,16,159619275
4239,2238693555,1047058,2239740613,11,0,1,1024,11,8128628798
4240,2238701787,514659,2239216446,6,0,0,20992,6,6442092787
4241,2238708754,753819,2239462573,41,0,0,32256,41,2785494579
4242,2238742463,683887,2239426350,11,0,0,14848,11,6748425375
4243,2238752518,457517,2239210035,20,0,0,1024,20,4210891380
4244,2238769282,1582528,2240351810,18,0,0,4608,18,4877182388
4245,2238774824,383675,2239158499,14,0,0,30208,14,8917962993
4246,2238777165,1339120,2240116285,4,0,0,17408,4,8023847896
4247,2238796482,801058,2239597540,40,0,0,36864,40,7859765269
4248,2238800129,392091,2239192220,4,0,0,512,4,3196157419
4249,2238802020,575167,2239377187,38,0,0,39936,38,9640332485
4250,2238825187,394817,2239220004,6,0,0,9216,6,10406182545
4251,2238834815,249127,2239083942,18,0,0,7168,18,5592156014
4252,2238864908,1286676,2240151584,45,0,0,14336,45,6913290966
4253,2238874683,785987,2239660670,36,0,0,58880,36,897823254
4254,2238880779,215548,2239096327,5,0,0,1024,5,8613103239
4255,2238882122,381563,2239263685,6,0,0,16384,6,1382045432
4256,2238911052,834707,2239745759,8,0,1,8192,8,9343049334
4257,2238914620,896470,2239811090,24,0,1,31232,24,10185280535
4258,2238918174,621098,2239539272,7,0,0,54784,7,3915735768
4259,2238922194,422905,2239345099,3,0,0,6656,3,3339462504
4260,2238923475,585221,2239508696,41,0,0,19456,41,5933393675
4261,2238925822,968063,2239893885,11,0,1,5120,11,2152571822
4262,2238926127,330440,2239256567,20,0,0,15872,20,8622658940
4263,2238942745,412954,2239355699,23,0,0,24064,23,348957692
4264,2238959353,482952,2239442305,28,0,0,27136,28,7377006431
4265,2238986412,487484,2239473896,28,0,0,1536,28,9668188459
4266,2238986522,345878,2239332400,49,0,0,45056,49,7353314673
4267,2238993476,811812,2239805288,27,0,0,134144,27,8683051289
4268,2239057578,540921,2239598499,43,0,0,3072,43,1983536924
4269,2239070314,513567,2239583881,32,0,0,4608,32,5511699202
4270,2239071162,395093,2239466255,6,0,0,8192,6,1550246606
4271,2239072654,622245,2239694899,15,0,0,55296,15,8680963774
4272,2239085434,646681,2239732115,29,0,0,21504,29,3016693707
4273,2239087002,761075,2239848077,22,0,0,9728,22,2974486263
4274,2239092199,1148853,2240241052,22,0,0,19456,22,8173724481
4275,2239096509,797722,2239894231,20,0,1,512,20,3210194867
4276,2239110154,555687,2239665841,9,0,0,16896,9,3964616386
4277,2239138552,758585,2239897137,12,0,1,4608,12,9797598890
4278,2239157534,789175,2239946709,24,0,0,10752,24,3593687622
4279,2239172266,374361,2239546627,1,0,0,24064,1,5155133563
4280,2239188183,765572,2239953755,21,0,0,5632,21,5433774298
4281,2239202506,642592,2239845098,28,0,0,33280,28,2132942344
4282,2239206585,628358,2239834943,45,0,0,36352,45,3096323508
4283,2239227364,789119,2240016483,25,0,0,77312,25,1207447733
4284,2239238578,614662,2239853240,13,0,0,16896,13,1798078637
4285,2239246553,316655,2239563208,34,0,0,14848,34,8499214957
4286,2239252510,240080,2239492590,45,0,0,2560,45,1904040297
4287,2239257922,1131603,2240389525,4,0,0,2560,4,10085729474
4288,2239262231,1297987,2240560218,27,0,0,23552,27,5701028252
4289,2239267998,543077,2239811075,21,0,0,18944,21,64718612
4290,2239268534,826755,2240095289,46,0,0,26624,46,6277791728
4291,2239281648,665084,2239946732,2,0,1,56320,2,9962487566
4292,2239284328,811148,2240095476,25,0,0,512,25,6754729221
4293,2239291409,584775,2239876184,22,0,0,30720,22,6980819110
4294,2239309014,239968,2239548982,15,0,0,7680,15,6359858044
4295,2239309624,1333565,2240643189,14,0,0,3584,14,8785056693
4296,2239311628,292633,2239604261,19,0,0,9728,19,5255714415
4297,2239311818,1333241,2240645059,35,0,0,1024,35,7731098306
4298,2239334871,644242,2239979113,43,0,0,11776,43,6963608814
4299,2239359392,310857,2239670249,32,0,0,9216,32,8986828679
4300,2239363344,1178428,2240541772,11,0,0,2560,11,616680370
4301,2239382826,332978,2239715804,29,0,0,16896,29,6960830259
4302,2239405073,567759,2239972832,25,0,0,46592,25,8404070370
4303,2239405561,567294,2239972855,0,0,1,24576,0,7989762672
4304,2239420778,690180,2240110958,42,0,0,13312,42,1905257818
4305,2239435764,262808,2239698572,36,0,0,10752,36,7796768292
4306,2239454010,564986,2240018996,43,0,1,16896,43,4826495593
4307,2239479176,697367,2240176543,36,0,0,1024,36,6107920670
4308,2239481821,625058,2240106879,49,0,0,37376,49,6673122743
4309,2239516543,682029,2240198572,11,0,0,66560,11,7330120673
4310,2239522612,701822,2240224434,25,0,0,57344,25,7864746293
4311,2239578715,906173,2240484888,46,0,0,39424,46,1059006229
4312,2239586605,1142979,2240729584,35,0,0,7680,35,1765648349
4313,2239616409,117757,2239734166,29,0,0,6656,29,6984986525
4314,2239631521,634782,2240266303,14,0,0,2560,14,2977094613
4315,2239633709,513492,2240147201,11,0,1,19456,11,5104469406
4316,2239640456,773668,2240414124,18,0,0,55296,18,3602859731
4317,2239646579,529637,2240176216,5,0,1,23552,5,2032939127
4318,2239654311,862768,2240517079,37,0,0,16384,37,6360656175
4319,2239660211,321756,2239981967,35,0,0,1536,35,9431314044
4320,2239662490,355592,2240018082,47,0,0,5120,47,9059359755
4321,2239675390,441878,2240117268,36,0,0,3072,36,3175463366
4322,2239685044,477958,2240163002,12,0,0,28160,12,9244194158
4323,2239710067,432268,2240142335,31,0,0,47616,31,7524052077
4324,2239712009,875688,2240587697,26,0,0,90112,26,9508290926
4325,2239726360,395002,2240121362,29,0,0,10752,29,9649592187
4326,2239729415,447143,2240176558,34,0,1,3072,34,2167875178
4327,2239755696,398711,2240154407,15,0,0,9216,15,2419017090
4328,2239761745,699840,2240461585,24,0,0,17920,24,6144987365
4329,2239778956,509103,2240288059,36,0,0,23552,36,8096726226
4330,2239780404,422098,2240202502,40,0,0,5120,40,687621697
4331,2239784725,600988,2240385713,3,0,1,149504,3,5157918868
4332,2239788683,490017,2240278700,12,0,0,12800,12,562428065
4333,2239830269,538313,2240368582,21,0,0,1536,21,9705338085
4334,2239832624,553435,2240386059,24,0,1,512,24,8872745766
4335,2239859483,693536,2240553019,0,0,0,36864,0,8468042506
4336,2239874799,522454,2240397253,25,0,0,23552,25,5355834894
4337,2239884594,233477,2240118071,37,0,0,2560,37,2581544210
4338,2239898419,366756,2240265175,39,0,0,24064,39,2237153965
4339,2239942711,399894,2240342605,25,0,0,19968,25,2078515878
4340,2239944560,499100,2240443660,9,0,0,19968,9,5587012309
4341,2239960120,427885,2240388005,21,0,1,3072,21,4919080869
4342,2239974881,439274,2240414155,21,0,1,4608,21,2314386908
4343,2239981165,219762,2240200927,18,0,0,7680,18,8492827272
4344,2239982752,690844,2240673596,20,0,0,22528,20,574972448
4345,2240004716,604430,2240609146,36,0,0,50176,36,7240482757
4346,2240005848,379585,2240385433,43,0,0,14336,43,4893355200
4347,2240006981,739688,2240746669,42,0,0,10752,42,10359436726
4348,2240023260,273231,2240296491,0,0,0,9216,0,5991266527
4349,2240030475,413208,2240443683,10,0,1,1024,10,6389903931
4350,2240058324,385374,2240443698,24,0,1,512,24,4232266360
4351,2240065092,620085,2240685177,44,0,0,13312,44,9209145599
4352,2240065193,565277,2240630470,21,0,0,16384,21,1000433396
4353,2240072240,553207,2240625447,44,0,0,9216,44,8595019208
4354,2240074157,398533,2240472690,46,0,0,15360,46,7769746967
4355,2240083108,418214,2240501322,39,0,0,4096,39,5214861832
4356,2240083731,530266,2240613997,5,0,0,15872,5,9228686503
4357,2240083846,538754,2240622600,23,0,0,28160,23,6361883222
4358,2240096923,780870,2240877793,3,0,1,281088,3,8081511589
4359,2240119652,729770,2240849422,20,0,0,2048,20,9284125903
4360,2240130496,360867,2240491363,39,0,0,2560,39,8074908977
4361,2240135927,336934,2240472861,4,0,0,512,4,3466185446
4362,2240139341,739528,2240878869,21,0,1,13312,21,5117873108
4363,2240156849,436994,2240593843,2,0,0,11264,2,7399007058
4364,2240164949,702808,2240867757,7,0,0,12288,7,4471797487
4365,2240178358,780073,2240958431,41,0,1,512,41,6395130629
4366,2240199810,268185,2240467995,17,0,0,19456,17,621512298
4367,2240213034,635749,2240848783,32,0,0,43008,32,2831296667
4368,2240241961,716485,2240958446,8,0,1,13824,8,8001277073
4369,2240261669,569924,2240831593,27,0,0,52736,27,8436893346
4370,2240269066,726856,2240995922,0,0,1,38912,0,6278742808
4371,2240291788,344641,2240636429,38,0,0,19456,38,9138299958
4372,2240296140,244837,2240540977,44,0,0,53760,44,4369334380
4373,2240308102,715375,2241023477,14,0,1,2560,14,3364700746
4374,2240325974,433832,2240759806,17,0,0,32768,17,8721528612
4375,2240343570,298022,2240641592,4,0,0,16896,4,2424104549
4376,2240346529,243835,2240590364,31,0,0,8704,31,7523842419
4377,2240354213,538499,2240892712,29,0,0,34304,29,9870030673
4378,2240355454,517778,2240873232,14,0,0,17920,14,393145899
4379,2240374690,727596,2241102286,32,0,0,46080,32,3845938475
4380,2240386594,638189,2241024783,8,0,1,2048,8,1386314673
4381,2240393624,672081,2241065705,10,0,1,10752,10,631892467
4382,2240396878,290573,2240687451,17,0,0,1536,17,3704529848
4383,2240412704,317519,2240730223,15,0,0,2048,15,9087975649
4384,2240418297,445039,2240863336,11,0,0,23552,11,8047845344
4385,2240424249,411415,2240835664,23,0,0,13312,23,5645338905
4386,2240426297,711667,2241137964,2,0,0,3072,2,6159645922
4387,2240439545,518863,2240958408,21,0,0,51200,21,6144076961
4388,2240451481,516823,2240968304,7,0,0,28672,7,6300427138
4389,2240456938,270291,2240727229,47,0,0,27648,47,1081895394
4390,2240460539,354971,2240815510,1,0,0,54272,1,3081572671
4391,2240479793,280184,2240759977,8,0,0,512,8,1028432291
4392,2240501789,482143,2240983932,5,0,0,24064,5,3063912425
4393,2240513003,556447,2241069450,20,0,1,6656,20,2966958904
4394,2240540292,525390,2241065682,21,0,0,24064,21,10378120133
4395,2240545402,665767,2241211169,30,0,0,17920,30,2003684660
4396,2240551480,536751,2241088231,15,0,0,30208,15,2657204335
4397,2240553497,688178,2241241675,6,0,0,29696,6,3069608469
4398,2240559367,620320,2241179687,23,0,0,13824,23,5740971787
4399,2240560932,456175,2241017107,18,0,0,1024,18,5194231595
4400,2240573327,632335,2241205662,14,0,0,52736,14,5938357241
4401,2240573424,386129,2240959553,1,0,0,3584,1,9031829946
4402,2240577364,442566,2241019930,29,0,0,9216,29,7485197272
4403,2240580181,275964,2240856145,6,0,0,22016,6,945430132
4404,2240596861,450741,2241047602,38,0,0,7168,38,8424686414
4405,2240597145,481867,2241079012,26,0,0,15360,26,1391167767
4406,2240607503,932008,2241539511,43,0,1,210944,43,3096190424
4407,2240616347,493450,2241109797,29,0,0,24576,29,690251138
4408,2240656403,270524,2240926927,10,0,0,1536,10,4362499937
4409,2240660432,413885,2241074317,44,0,0,9728,44,5751503307
4410,2240663478,484597,2241148075,15,0,0,3072,15,6874670616
4411,2240676285,664472,2241340757,25,0,0,4608,25,1008985337
4412,2240694594,644736,2241339330,30,0,0,58880,30,6921529304
4413,2240709944,465508,2241175452,19,0,0,70656,19,8637122141
4414,2240740045,661839,2241401884,11,0,0,14848,11,2092996115
4415,2240772584,414077,2241186661,49,0,0,8192,49,6824425169
4416,2240778656,1804939,2242583595,2,0,1,408064,2,6394237230
4417,2240823989,1788699,2242612688,3,0,1,19968,3,6185237685
4418,2240835086,735560,2241570646,43,0,0,40960,43,3399475733
4419,2240839923,541846,2241381769,42,0,0,66560,42,2348716372
4420,2240865398,569090,2241434488,32,0,0,26624,32,1492688575
4421,2240875579,387191,2241262770,47,0,0,13312,47,1873157089
4422,2240911464,850243,2241761707,7,0,0,71168,7,832141568
4423,2240913051,408324,2241321375,43,0,0,62976,43,8026519137
4424,2240933185,692726,2241625911,14,0,0,512,14,2526735934
4425,2240942917,920258,2241863175,34,0,0,43520,34,65411376
4426,2240960836,690596,2241651432,24,0,0,35328,24,9749483460
4427,2240976233,421112,2241397345,14,0,0,9216,14,9929072763
4428,2240985515,950192,2241935707,14,0,0,50176,14,7007905798
4429,2240994066,543589,2241537655,29,0,0,22528,29,9255635120
4430,2241001942,556209,2241558151,3,0,0,31744,3,4545786439
4431,2241013869,251026,2241264895,13,0,0,6144,13,2228238357
4432,2241017562,446789,2241464351,20,0,0,12800,20,7601743218
4433,2241024534,738748,2241763282,15,0,0,5120,15,4365158428
4434,2241031226,389758,2241420984,39,0,0,7168,39,2334166252
4435,2241031833,241041,2241272874,44,0,0,6144,44,6564395765
4436,2241054863,720063,2241774926,43,0,0,8192,43,6706982759
4437,2241061334,994534,2242055868,22,0,0,88576,22,6842147811
4438,2241084139,395952,2241480091,24,0,0,24576,24,598183650
4439,2241086442,489603,2241576045,32,0,0,512,32,3955383203
4440,2241094649,412936,2241507585,15,0,0,18944,15,3397619782
4441,2241102144,399646,2241501790,29,0,0,71168,29,41301471
4442,2241109922,515810,2241625732,30,0,0,55808,30,2833847021
4443,2241135539,1486965,2242622504,34,0,1,8704,34,854001158
4444,2241141346,708546,2241849892,0,0,0,118784,0,6960406814
4445,2241141400,875855,2242017255,30,0,0,28672,30,8929095898
4446,2241149490,1474090,2242623580,21,0,1,13312,21,4343581351
4447,2241156696,1468190,2242624886,15,0,1,2048,15,9589453404
4448,2241181204,1369934,2242551138,32,0,0,13824,32,10023785771
4449,2241182050,874341,2242056391,46,0,0,1536,46,7277470525
4450,2241190063,1002185,2242192248,0,0,0,4608,0,2385904155
4451,2241193898,1077960,2242271858,41,0,0,69120,41,8011286954
4452,2241194495,813190,2242007685,38,0,0,110592,38,7473253632
4453,2241194580,583730,2241778310,41,0,0,9216,41,4505756540
4454,2241204861,480393,2241685254,24,0,0,34304,24,4736460188
4455,2241213928,172536,2241386464,19,0,0,15360,19,5722911135
4456,2241214438,553398,2241767836,45,0,0,9216,45,4163314168
4457,2241228289,1492388,2242720677,48,0,1,512,48,10529981554
4458,2241229473,664271,2241893744,14,0,0,84480,14,3137530731
4459,2241236620,472575,2241709195,23,0,0,43520,23,3636440155
4460,2241237197,668761,2241905958,47,0,0,15872,47,8285262787
4461,2241241462,329823,2241571285,47,0,0,2048,47,9372353548
4462,2241270064,597377,2241867441,2,0,0,5120,2,8817992040
4463,2241274568,691934,2241966502,38,0,0,26112,38,9427451520
4464,2241277829,856752,2242134581,6,0,0,41472,6,10339120951
4465,2241279066,502691,2241781757,1,0,0,11264,1,596303610
4466,2241295897,795069,2242090966,46,0,0,6656,46,6190679446
4467,2241304768,1415924,2242720692,12,0,1,11264,12,724001621
4468,2241309351,1411356,2242720707,4,0,1,512,4,8216016006
4469,2241312586,452427,2241765013,29,0,0,5632,29,1529301744
4470,2241314018,705280,2242019298,6,0,0,6656,6,7784611202
4471,2241319807,466077,2241785884,0,0,0,4096,0,4685673368
4472,2241331448,569643,2241901091,39,0,0,24064,39,9891409797
4473,2241333459,1137699,2242471158,45,0,0,26624,45,8803045948
4474,2241339225,835543,2242174768,12,0,0,18432,12,5148243082
4475,2241366536,641960,2242008496,43,0,0,2560,43,187084915
4476,2241381534,558104,2241939638,5,0,0,12800,5,9730149696
4477,2241391153,1340323,2242731476,34,0,1,3584,34,8029100150
4478,2241402476,1331586,2242734062,36,0,1,4096,36,4553905254
4479,2241417249,1079250,2242496499,8,0,0,23552,8,3809978710
4480,2241419112,375061,2241794173,43,0,0,10240,43,9647619888
4481,2241430204,1418471,2242848675,32,0,1,1024,32,7068364647
4482,2241433364,1415326,2242848690,47,0,1,17920,47,7100286811
4483,2241437696,767036,2242204732,6,0,0,18944,6,7530191856
4484,2241447217,418625,2241865842,15,0,0,8704,15,4056214124
4485,2241460799,1387922,2242848721,48,0,1,19456,48,1552026905
4486,2241477126,1488787,2242965913,15,0,1,13312,15,1450271657
4487,2241484120,790249,2242274369,25,0,0,8192,25,1526573729
4488,2241498961,888787,2242387748,49,0,0,45056,49,8627213747
4489,2241499647,474327,2241973974,35,0,0,8192,35,1502430671
4490,2241506718,817056,2242323774,6,0,0,6656,6,6947648535
4491,2241516411,591899,2242108310,2,0,0,9728,2,3667539619
4492,2241527030,578285,2242105315,32,0,0,6144,32,7739614570
4493,2241544934,972351,2242517285,17,0,0,18944,17,372191688
4494,2241577997,498384,2242076381,29,0,0,11776,29,8196769099
4495,2241583717,283927,2241867644,41,0,0,512,41,244533393
4496,2241597148,922056,2242519204,38,0,0,6144,38,10694828886
4497,2241618344,614281,2242232625,2,0,0,16384,2,1008611713
4498,2241633109,319409,2241952518,2,0,0,18432,2,4190143154
4499,2241643298,1494219,2243137517,22,0,0,5632,22,5902889586
4500,2241644303,1323351,2242967654,41,0,1,24576,41,2833682061
4501,2241734552,1236708,2242971260,34,0,1,3072,34,3651405316
4502,2241775407,1200359,2242975766,14,0,1,7168,14,10249412266
4503,2241780076,501188,2242281264,42,0,0,22528,42,9883386708
4504,2241788322,673126,2242461448,34,0,0,128512,34,994286220
4505,2241800385,320077,2242120462,36,0,0,7680,36,4969022089
4506,2241815995,326550,2242142545,46,0,0,4608,46,4048636367
4507,2241825284,408456,2242233740,10,0,0,3584,10,534446719
4508,2241829412,1146700,2242976112,15,0,1,512,15,3945476065
4509,2241829702,1167036,2242996738,20,0,1,8704,20,4792362100
4510,2241849221,573056,2242422277,26,0,0,3584,26,8650270398
4511,2241856892,606131,2242463023,18,0,0,5120,18,7727471676
4512,2241857049,716791,2242573840,32,0,0,40960,32,8012781181
4513,2241860574,855065,2242715639,37,0,0,1536,37,4389900275
4514,2241882916,628574,2242511490,43,0,0,49152,43,9495909131
4515,2241885800,603492,2242489292,17,0,0,21504,17,8767408346
4516,2241895236,1123292,2243018528,4,0,1,32256,4,7655210507
4517,2241910678,1110756,2243021434,19,0,1,4608,19,5563960177
4518,2241915216,786665,2242701881,29,0,0,52224,29,45071531
4519,2241920929,691744,2242612673,26,0,0,7680,26,3153311544
4520,2241922362,290045,2242212407,15,0,0,25088,15,7190723285
4521,2241925023,363636,2242288659,8,0,0,2560,8,31518134
4522,2241925064,795582,2242720646,19,0,0,16384,19,5790378540
4523,2241960699,1354535,2243315234,4,0,0,73216,4,3345378544
4524,2241966987,1111073,2243078060,0,0,1,24064,0,6784545168
4525,2241974100,447062,2242421162,19,0,0,22528,19,4242034110
4526,2241980481,929441,2242909922,9,0,0,10240,9,5938060838
4527,2241987962,362084,2242350046,25,0,0,5120,25,8892497324
4528,2242029040,819620,2242848660,21,0,0,44032,21,4844162126
4529,2242030870,1229755,2243260625,10,0,0,20992,10,7966389451
4530,2242032208,249695,2242281903,26,0,0,2048,26,4095121075
4531,2242040323,1290994,2243331317,47,0,0,14336,47,10231417153
4532,2242044283,1060756,2243105039,10,0,0,30720,10,4793568993
4533,2242047764,1124191,2243171955,13,0,0,67584,13,1152535983
4534,2242060978,500359,2242561337,19,0,0,23552,19,1356980933
4535,2242066829,464425,2242531254,20,0,0,35840,20,8852412188
4536,2242068005,969708,2243037713,12,0,0,27648,12,1686504679
4537,2242074313,445998,2242520311,43,0,0,3584,43,3340369773
4538,2242094910,995416,2243090326,7,0,1,12800,7,907187745
4539,2242096956,1367374,2243464330,14,0,0,11264,14,5568399351
4540,2242103903,299664,2242403567,36,0,0,1536,36,4793857550
4541,2242104528,786355,2242890883,24,0,0,46080,24,6261224
4542,2242105088,665294,2242770382,12,0,0,38400,12,6685924760
4543,2242139173,575983,2242715156,40,0,0,43520,40,1490765663
4544,2242139842,766945,2242906787,4,0,0,11776,4,5162435629
4545,2242147475,944477,2243091952,35,0,1,2560,35,727564510
4546,2242152010,1386644,2243538654,3,0,1,156672,3,9423576019
4547,2242159631,657627,2242817258,38,0,0,38912,38,9949644475
4548,2242170690,1259170,2243429860,40,0,0,37888,40,6724741287
4549,2242205268,1182191,2243387459,28,0,0,103424,28,6385048792
4550,2242208844,1437275,2243646119,44,0,0,5632,44,1752186333
4551,2242209221,273504,2242482725,22,0,0,37888,22,2699912782
4552,2242227044,608169,2242835213,43,0,0,58880,43,3282387005
4553,2242231068,1682970,2243914038,5,0,0,14848,5,4414212803
4554,2242237921,638875,2242876796,32,0,0,88064,32,5634542960
4555,2242246958,1321141,2243568099,39,0,1,8704,39,3233804378
4556,2242255593,549794,2242805387,34,0,0,7680,34,3361623013
4557,2242258764,795983,2243054747,16,0,0,6144,16,4275901495
4558,2242284820,775090,2243059910,41,0,0,16896,41,1588820628
4559,2242288212,740885,2243029097,22,0,0,13824,22,1392892980
4560,2242303474,1264640,2243568114,12,0,1,1024,12,7462008983
4561,2242353655,1762169,2244115824,6,0,0,30720,6,4507889346
4562,2242355134,310460,2242665594,17,0,0,4096,17,3452057635
4563,2242355726,1212411,2243568137,41,0,1,512,41,1199476220
4564,2242363416,857795,2243221211,16,0,0,2048,16,4753363083
4565,2242407959,1636999,2244044958,39,0,0,26112,39,1271341268
4566,2242411978,1048897,2243460875,36,0,0,55296,36,5730230842
4567,2242417639,1442424,2243860063,1,0,0,4096,1,519031273
4568,2242447172,630857,2243078029,49,0,0,59392,49,10078303756
4569,2242456209,623902,2243080111,18,0,0,6656,18,8693808963
4570,2242464540,525018,2242989558,48,0,0,8192,48,6742478499
4571,2242470075,681273,2243151348,28,0,0,28672,28,5440115477
4572,2242482602,296049,2242778651,49,0,0,5632,49,3331755239
4573,2242485102,508242,2242993344,49,0,0,7680,49,10031549981
4574,2242485524,807387,2243292911,4,0,0,9216,4,9104727357
4575,2242492491,718341,2243210832,13,0,0,5120,13,623731641
4576,2242501500,544836,2243046336,46,0,0,22016,46,6331081338
4577,2242516173,1409907,2243926080,43,0,0,8192,43,7365368024
4578,2242556624,615510,2243172134,26,0,0,512,26,545611223
4579,2242563035,427550,2242990585,4,0,0,1024,4,9101110206
4580,2242589776,985250,2243575026,48,0,1,7680,48,9160424379
4581,2242597211,808859,2243406070,3,0,0,60928,3,9328784169
4582,2242608804,966568,2243575372,34,0,1,512,34,4595895807
4583,2242616669,1660817,2244277486,43,0,0,5632,43,2029288942
4584,2242621514,1256837,2243878351,2,0,0,9216,2,1189115390
4585,2242673310,1896882,2244570192,26,0,0,70656,26,5428987634
4586,2242681684,210158,2242891842,24,0,0,3072,24,3528245035
4587,2242693357,746891,2243440248,2,0,0,1536,2,967023447
4588,2242701930,474275,2243176205,27,0,0,13312,27,7734051375
4589,2242720135,1425713,2244145848,17,0,0,13312,17,1689932253
4590,2242732366,701425,2243433791,9,0,0,12800,9,3494750506
4591,2242757333,660936,2243418269,0,0,0,39936,0,1116659497
4592,2242780935,1619187,2244400122,19,0,0,5632,19,9846696179
4593,2242781899,426820,2243208719,6,0,0,5120,6,4283145287
4594,2242784128,1170193,2243954321,21,0,0,24576,21,9232885063
4595,2242794997,539158,2243334155,2,0,0,2560,2,2536601692
4596,2242812112,686714,2243498826,36,0,0,32768,36,66844414
4597,2242812973,908115,2243721088,7,0,0,9728,7,1696146759
4598,2242842578,1828373,2244670951,45,0,0,23552,45,3124816436
4599,2242843157,401905,2243245062,4,0,0,44032,4,8919006161
4600,2242854063,756136,2243610199,11,0,1,6656,11,7028936020
4601,2242854097,1544278,2244398375,22,0,0,132608,22,491799812
4602,2242857745,1875533,2244733278,41,0,0,111104,41,6497585945
4603,2242858015,926131,2243784146,32,0,0,5632,32,1265567836
4604,2242871229,448544,2243319773,48,0,0,14848,48,6638160269
4605,2242874827,1452053,2244326880,24,0,0,50688,24,2877730534
4606,2242886387,234547,2243120934,45,0,0,3584,45,3041161139
4607,2242898101,712969,2243611070,25,0,1,12288,25,179074402
4608,2242919389,413971,2243333360,36,0,0,6656,36,5811546231
4609,2242920539,1537977,2244458516,12,0,0,78848,12,10711354057
4610,2242937191,674545,2243611736,0,0,1,1024,0,2230464777
4611,2242939434,500323,2243439757,27,0,0,16896,27,169942605
4612,2242973690,1084838,2244058528,3,0,0,4096,3,8845938784
4613,2242989690,444896,2243434586,42,0,0,2560,42,8230749817
4614,2242996010,572074,2243568084,4,0,0,22016,4,2416391177
4615,2242998436,199753,2243198189,47,0,0,13312,47,9409479807
4616,2243007997,671350,2243679347,42,0,0,7680,42,9430439771
4617,2243028015,540761,2243568776,21,0,0,2048,21,4424034079
4618,2243054013,572791,2243626804,38,0,1,10752,38,7490754240
4619,2243062377,1985080,2245047457,13,0,0,3072,13,5748899675
4620,2243068008,373374,2243441382,8,0,0,512,8,7904135472
4621,2243097186,798079,2243895265,35,0,0,22016,35,1904601628
4622,2243100789,507165,2243607954,21,0,0,25088,21,4604164288
4623,2243108873,1435015,2244543888,40,0,0,24576,40,9129250874
4624,2243122380,787119,2243909499,17,0,0,34816,17,50997274
4625,2243136845,618101,2243754946,2,0,1,53760,2,10189904389
4626,2243146657,776912,2243923569,2,0,0,31232,2,5560889398
4627,2243165577,603668,2243769245,23,0,0,9216,23,9252409152
4628,2243169940,176240,2243346180,28,0,0,14336,28,9834410168
4629,2243184208,369110,2243553318,10,0,0,2048,10,3952557776
4630,2243193903,1957480,2245151383,25,0,0,15360,25,1602827562
4631,2243196222,521887,2243718109,0,0,0,57856,0,8236108690
4632,2243202166,580059,2243782225,0,0,1,4096,0,5044297697
4633,2243248439,290200,2243538639,0,0,0,7168,0,839568039
4634,2243254139,438746,2243692885,24,0,0,3584,24,1690961792
4635,2243271399,515429,2243786828,3,0,1,7168,3,899541010
4636,2243275131,314102,2243589233,0,0,0,24576,0,7681742466
4637,2243280309,458713,2243739022,20,0,0,1024,20,1582748625
4638,2243282775,948127,2244230902,49,0,0,89600,49,2803908753
4639,2243283151,862712,2244145863,43,0,1,123392,43,7887846320
4640,2243285003,861615,2244146618,20,0,1,2560,20,437089233
4641,2243299226,555035,2243854261,26,0,0,41984,26,5024151871
4642,2243303168,705591,2244008759,27,0,0,30720,27,4887710743
4643,2243339466,394609,2243734075,40,0,0,1536,40,1864324994
4644,2243362893,218837,2243581730,28,0,0,7680,28,395686159
4645,2243373551,1889162,2245262713,28,0,0,67072,28,10638482997
4646,2243374296,608401,2243982697,0,0,0,32768,0,7048672909
4647,2243377457,2006599,2245384056,48,0,0,24576,48,5044620081
4648,2243378796,649072,2244027868,24,0,0,8704,24,9763047446
4649,2243383761,1234873,2244618634,42,0,0,11264,42,2641479978
4650,2243391458,884282,2244275740,10,0,0,13824,10,5824067091
4651,2243396741,737424,2244134165,5,0,0,37888,5,4110601263
4652,2243403572,889076,2244292648,41,0,0,49152,41,7521389249
4653,2243409656,737308,2244146964,22,0,1,512,22,173056532
4654,2243419131,386987,2243806118,9,0,0,7168,9,4880068451
4655,2243424701,362112,2243786813,40,0,0,8704,40,8231019154
4656,2243430941,1029930,2244460871,4,0,0,7680,4,1795886131
4657,2243446871,1394359,2244841230,24,0,0,34304,24,1759200468
4658,2243450927,710062,2244160989,12,0,1,21504,12,795125814
4659,2243459880,1110795,2244570675,2,0,0,1536,2,6995192059
4660,2243463756,555626,2244019382,40,0,0,34816,40,7090277749
4661,2243477025,789220,2244266245,0,0,1,18944,0,9228268732
4662,2243481174,2029618,2245510792,16,0,0,15872,16,65098019
4663,2243496408,1936078,2245432486,44,0,0,53248,44,4985327450
4664,2243502866,396002,2243898868,25,0,0,11776,25,1468320364
4665,2243543562,2034442,2245578004,2,0,0,60928,2,574364884
4666,2243547499,422938,2243970437,4,0,0,26112,4,1869923738
4667,2243560298,464871,2244025169,48,0,0,18944,48,2218712066
4668,2243565692,710063,2244275755,12,0,1,19456,12,1937302089
4669,2243571706,600806,2244172512,46,0,0,26624,46,10088710020
4670,2243573684,240431,2243814115,1,0,0,18944,1,1796218612
4671,2243575402,1124001,2244699403,46,0,0,39936,46,6046795549
4672,2243576461,893074,2244469535,21,0,1,18432,21,10414930557
4673,2243589106,881415,2244470521,46,0,1,1536,46,9462821829
4674,2243602819,945114,2244547933,20,0,1,16384,20,7688768692
4675,2243606227,252573,2243858800,2,0,0,14848,2,6341934623
4676,2243630670,635560,2244266230,15,0,0,10752,15,1074231246
4677,2243641263,1422699,2245063962,32,0,0,22016,32,8084008157
4678,2243666764,744917,2244411681,45,0,0,37888,45,8953893729
4679,2243693346,2023416,2245716762,8,0,0,52736,8,4069249829
4680,2243698276,1329354,2245027630,21,0,1,179200,21,8488945871
4681,2243702069,1326867,2245028936,29,0,1,2048,29,8612814945
4682,2243705035,527762,2244232797,0,0,0,6144,0,1886801485
4683,2243713429,441669,2244155098,30,0,0,7168,30,4407269679
4684,2243719829,1311693,2245031522,11,0,1,4096,11,9570374944
4685,2243729269,1024149,2244753418,3,0,0,2048,3,3388790142
4686,2243730144,528180,2244258324,17,0,0,7168,17,1264450275
4687,2243731063,363813,2244094876,9,0,0,12288,9,4576804136
4688,2243738406,758305,2244496711,8,0,0,15872,8,3144107840
4689,2243740177,874970,2244615147,26,0,0,32768,26,7953048738
4690,2243743725,690752,2244434477,45,0,0,48128,45,10466901053
4691,2243781429,2004581,2245786010,32,0,0,25600,32,201527637
4692,2243795027,952025,2244747052,2,0,0,32256,2,1682082222
4693,2243800112,1121040,2244921152,37,0,0,27648,37,9937160454
4694,2243802488,1509097,2245311585,6,0,0,39424,6,8770892004
4695,2243807589,2305690,2246113279,23,0,0,52736,23,797141305
4696,2243813791,1280975,2245094766,8,0,1,14336,8,5052964985
4697,2243820500,433450,2244253950,11,0,0,25600,11,8181289632
4698,2243823092,758237,2244581329,38,0,0,8192,38,5113865058
4699,2243832142,476830,2244308972,40,0,0,5120,40,3237196692
4700,2243839295,662267,2244501562,25,0,0,15872,25,9644921204
4701,2243863588,439818,2244303406,45,0,0,11776,45,5626572739
4702,2243867941,601228,2244469169,18,0,0,23040,18,5778254136
4703,2243875212,1219569,2245094781,3,0,1,7168,3,5708287180
4704,2243889484,572650,2244462134,25,0,0,4096,25,8597851020
4705,2243939580,398934,2244338514,23,0,0,2048,23,4545259751
4706,2243941101,1159802,2245100903,43,0,1,23040,43,6067992523
4707,2243953016,342938,2244295954,8,0,0,1536,8,4240768920
4708,2243957571,664978,2244622549,8,0,0,12800,8,3697876383
4709,2243960997,1161428,2245122425,10,0,1,10752,10,4786337025
4710,2243961941,333530,2244295471,32,0,0,9216,32,320968856
4711,2243964245,1221408,2245185653,0,0,1,16896,0,2946970256
4712,2243969368,894512,2244863880,24,0,0,64000,24,1105058692
4713,2243969405,629255,2244598660,23,0,0,56832,23,5813225525
4714,2243975273,1261462,2245236735,4,0,1,2560,4,9895238869
4715,2243981146,617849,2244598995,1,0,0,1024,1,6050652164
4716,2243995401,496443,2244491844,20,0,0,35328,20,4197791975
4717,2243997137,777323,2244774460,8,0,0,37376,8,5874915333
4718,2244014597,853354,2244867951,40,0,0,13312,40,10063654202
4719,2244014639,1223172,2245237811,46,0,1,13312,46,2212323355
4720,2244016040,1223077,2245239117,3,0,1,2048,3,3156329127
4721,2244016698,562104,2244578802,34,0,0,26624,34,10202760572
4722,2244027834,874833,2244902667,5,0,0,39424,5,2800788794
4723,2244033253,385159,2244418412,25,0,0,22016,25,3581157025
4724,2244036323,1287105,2245323428,3,0,1,11264,3,5173706863
4725,2244044120,476096,2244520216,8,0,0,512,8,10381377691
4726,2244045527,981636,2245027163,34,0,0,42496,34,7426339565
4727,2244066863,670346,2244737209,28,0,0,12800,28,1238910104
4728,2244094697,888631,2244983328,1,0,0,30720,1,6319096020
4729,2244109666,1266887,2245376553,22,0,1,19456,22,5627206432
4730,2244115274,661549,2244776823,20,0,0,7680,20,5499558581
4731,2244153720,1439727,2245593447,0,0,1,70656,0,7538829387
4732,2244155421,688944,2244844365,23,0,0,10240,23,2846852924
4733,2244162010,382213,2244544223,0,0,0,1024,0,4964704203
4734,2244198676,484302,2244682978,1,0,0,39424,1,3352586444
4735,2244204634,1477689,2245682323,49,0,1,18432,49,9887027836
4736,2244214271,1162267,2245376538,40,0,0,25088,40,6775572430
4737,2244239049,837579,2245076628,16,0,0,40448,16,3929334613
4738,2244240370,360543,2244600913,38,0,0,3584,38,2924848356
4739,2244253193,351955,2244605148,32,0,0,13824,32,4854528281
4740,2244273738,1948045,2246221783,30,0,0,18432,30,3583391287
4741,2244306208,377097,2244683305,10,0,0,1024,10,5113853793
4742,2244330313,1352984,2245683297,14,0,1,13824,14,4999425572
4743,2244341906,345314,2244687220,21,0,0,12800,21,4217829758
4744,2244343557,256249,2244599806,11,0,0,2560,11,10319838973
4745,2244344256,441006,2244785262,4,0,0,22016,4,3551387620
4746,2244347990,557992,2244905982,27,0,0,10752,27,5368322517
4747,2244366851,1618746,2245985597,42,0,1,133120,42,757028959
4748,2244369312,515853,2244885165,7,0,0,50176,7,676079234
4749,2244400277,1070275,2245470552,2,0,0,19968,2,8146809016
4750,2244402389,557707,2244960096,15,0,0,65024,15,10679146292
4751,2244406533,251019,2244657552,11,0,0,2048,11,10241764867
4752,2244409206,682254,2245091460,40,0,0,15360,40,2747301116
4753,2244409389,481251,2244890640,24,0,0,17920,24,1717797002
4754,2244444859,476496,2244921355,38,0,0,512,38,9970942868
4755,2244462480,1590037,2246052517,10,0,1,1024,10,7628502583
4756,2244468533,759050,2245227583,21,0,0,56320,21,10428903286
4757,2244469317,289199,2244758516,17,0,0,11264,17,10662609593
4758,2244482307,866218,2245348525,43,0,0,18432,43,2548058045
4759,2244485760,754987,2245240747,6,0,0,3584,6,6138737065
4760,2244500039,1088462,2245588501,1,0,0,10752,1,4641787629
4761,2244505523,783444,2245288967,20,0,0,15872,20,6098250032
4762,2244518689,837780,2245356469,15,0,0,19456,15,5313291369
4763,2244538107,967834,2245505941,1,0,0,74240,1,566084113
4764,2244554575,1146096,2245700671,13,0,0,14336,13,6413629423
4765,2244557317,527914,2245085231,11,0,0,28160,11,1517398919
4766,2244567824,302038,2244869862,43,0,0,6144,43,7203800578
4767,2244572772,725335,2245298107,10,0,0,10240,10,8722954411
4768,2244579774,812253,2245392027,3,0,0,26112,3,6846714127
4769,2244586484,570842,2245157326,18,0,0,19456,18,1844419538
4770,2244598242,496509,2245094751,7,0,0,10752,7,10050947479
4771,2244602234,310479,2244912713,22,0,0,22016,22,1150918474
4772,2244604951,939624,2245544575,12,0,0,18432,12,9809633929
4773,2244604976,811271,2245416247,41,0,0,17920,41,7827564913
4774,2244606697,1045608,2245652305,2,0,0,23040,2,4158568539
4775,2244629991,555631,2245185622,11,0,0,68096,11,6456811261
4776,2244640527,373673,2245014200,28,0,0,5120,28,3169432847
4777,2244693358,1649517,2246342875,48,0,0,29696,48,1519779135
4778,2244705062,1806738,2246511800,10,0,0,39424,10,6757774331
4779,2244713611,1341172,2246054783,43,0,1,3584,43,8546324867
4780,2244736984,1108940,2245845924,46,0,0,17408,46,10302051818
4781,2244753039,700918,2245453957,5,0,0,31744,5,4120825498
4782,2244759803,352250,2245112053,49,0,0,26112,49,8846519130
4783,2244762508,904489,2245666997,10,0,0,14848,10,5996094790
4784,2244764014,1146140,2245910154,21,0,0,15360,21,4337640175
4785,2244782680,382179,2245164859,18,0,0,11776,18,3687279228
4786,2244806937,492589,2245299526,11,0,0,4608,11,7411844111
4787,2244847029,1210340,2246057369,22,0,1,4096,22,2626193555
4788,2244850015,335817,2245185832,44,0,0,512,44,3483814911
4789,2244852310,431806,2245284116,3,0,0,70144,3,10023854208
4790,2244863811,200478,2245064289,28,0,0,1024,28,444642824
4791,2244866132,1201393,2246067525,41,0,1,6656,41,1818055131
4792,2244880372,1644802,2246525174,41,0,0,1536,41,1953786204
4793,2244899506,659919,2245559425,18,0,0,38400,18,5734683263
4794,2244900075,619312,2245519387,26,0,0,28160,26,5587519050
4795,2244903737,386212,2245289949,28,0,0,1536,28,8119370519
4796,2244910147,827690,2245737837,43,0,0,69120,43,2196362276
4797,2244933364,1135787,2246069151,24,0,1,2560,24,9098097522
4798,2244946272,736028,2245682300,25,0,0,50176,25,10283118492
4799,2244958216,1155086,2246113302,15,0,1,16384,15,6757339336
4800,2244963742,583968,2245547710,5,0,0,10240,5,10431468648
4801,2244966571,328401,2245294972,28,0,0,16384,28,4629017816
4802,2244967113,228352,2245195465,48,0,0,7680,48,9523382355
4803,2245019370,1093947,2246113317,12,0,1,1024,12,8451968553
4804,2245021853,1174463,2246196316,0,0,0,42496,0,9915606902
4805,2245029137,260329,2245289466,45,0,0,1536,45,4324532559
4806,2245062273,278208,2245340481,29,0,0,4096,29,4601934123
4807,2245064569,1557499,2246622068,44,0,0,86528,44,4428793612
4808,2245070334,401994,2245472328,7,0,0,5632,7,3966547707
4809,2245074632,508535,2245583167,12,0,0,16896,12,8578969428
4810,2245085783,312819,2245398602,45,0,0,21504,45,8844766703
4811,2245099021,837459,2245936480,1,0,0,3584,1,6909036152
4812,2245109830,1003510,2246113340,15,0,1,10240,15,1653045927
4813,2245124711,502327,2245627038,44,0,0,38400,44,10273661638
4814,2245129155,567125,2245696280,49,0,0,37888,49,4902136262
4815,2245164389,1033970,2246198359,18,0,0,6656,18,3610710488
4816,2245165529,947826,2246113355,44,0,1,3072,44,10046759855
4817,2245172358,1632999,2246805357,29,0,0,64000,29,3636782644
4818,2245191029,680141,2245871170,5,0,0,37376,5,707032146
4819,2245197327,918773,2246116100,45,0,1,5120,45,9470110786
4820,2245205252,1033958,2246239210,17,0,0,10752,17,7407867530
4821,2245212674,903990,2246116664,48,0,1,10752,48,6875957174
4822,2245213624,599688,2245813312,43,0,0,55296,43,4947953528
4823,2245222539,362671,2245585210,34,0,0,6656,34,3104050577
4824,2245251923,349809,2245601732,13,0,0,2048,13,6528771868
4825,2245257928,831709,2246089637,21,0,0,20480,21,8196178158
4826,2245273234,843584,2246116818,15,0,1,8704,15,3043839719
4827,2245274431,571820,2245846251,38,0,0,1024,38,5148578806
4828,2245276950,463578,2245740528,35,0,0,8704,35,5023984251
4829,2245283474,833600,2246117074,20,0,1,9216,20,5188819657
4830,2245290716,481698,2245772414,38,0,0,19456,38,5778203162
4831,2245294665,463701,2245758366,42,0,0,42496,42,133815981
4832,2245312766,463336,2245776102,36,0,0,6144,36,2544573179
4833,2245316847,477687,2245794534,44,0,0,6144,44,7493194224
4834,2245335573,184001,2245519574,44,0,0,512,44,963509466
4835,2245339001,994811,2246333812,36,0,0,32768,36,2296684668
4836,2245363007,382380,2245745387,15,0,0,15872,15,6004234961
4837,2245364416,785269,2246149685,41,0,1,2560,41,8842792674
4838,2245365931,1304792,2246670723,27,0,0,41984,27,497261389
4839,2245385919,764330,2246150249,8,0,1,10752,8,4438529686
4840,2245404883,552417,2245957300,8,0,0,21504,8,1597816160
4841,2245418288,829677,2246247965,0,0,1,35840,0,4125704031
4842,2245420197,1611924,2247032121,11,0,0,14848,11,9720465731
4843,2245438336,434565,2245872901,24,0,0,5632,24,7627484640
4844,2245483000,954360,2246437360,17,0,0,8704,17,6813491865
4845,2245491554,941181,2246432735,19,0,0,119808,19,8633190410
4846,2245492062,1342084,2246834146,18,0,0,40960,18,10590930044
4847,2245519567,293916,2245813483,42,0,0,512,42,2007509195
4848,2245524365,402519,2245926884,3,0,0,53248,3,9688444411
4849,2245534723,1189951,2246724674,2,0,1,167424,2,3877432406
4850,2245560321,1585272,2247145593,32,0,0,44032,32,5143572302
4851,2245564462,1627289,2247191751,24,0,0,15872,24,9044109602
4852,2245575279,186467,2245761746,11,0,0,4608,11,8819850009
4853,2245601816,374219,2245976035,0,0,0,61440,0,344567495
4854,2245628184,507105,2246135289,43,0,0,18944,43,1698301934
4855,2245658133,707773,2246365906,13,0,0,6656,13,4440797034
4856,2245666532,368961,2246035493,28,0,0,4096,28,10332374009
4857,2245676502,859121,2246535623,9,0,0,1536,9,2094795230
4858,2245685510,523194,2246208704,3,0,0,3072,3,8035484622
4859,2245687074,1487909,2247174983,41,0,0,74240,41,8132190033
4860,2245702805,520553,2246223358,8,0,0,5120,8,6673786013
4861,2245713029,935301,2246648330,7,0,0,26624,7,4669568754
4862,2245714788,1035759,2246750547,43,0,1,11264,43,1175408366
4863,2245723220,1563520,2247286740,46,0,0,18944,46,3295664694
4864,2245740735,630810,2246371545,14,0,0,18432,14,3328885988
4865,2245748406,628310,2246376716,7,0,0,16896,7,4586575747
4866,2245756223,1013681,2246769904,8,0,1,4608,8,2727132835
4867,2245763739,1018938,2246782677,12,0,1,5632,12,3578091332
4868,2245786175,688086,2246474261,15,0,0,2048,15,8124975456
4869,2245791984,234575,2246026559,9,0,0,23552,9,7299808562
4870,2245794004,386232,2246180236,45,0,0,35840,45,5553818705
4871,2245819055,163102,2245982157,30,0,0,2560,30,3229829647
4872,2245820676,89961,2245910637,8,0,0,1536,8,10265971576
4873,2245822041,769676,2246591717,9,0,0,33280,9,9455706107
4874,2245824900,692234,2246517134,37,0,0,4608,37,4772371870
4875,2245826555,956137,2246782692,10,0,1,11776,10,126542363
4876,2245833530,559827,2246393357,26,0,0,10240,26,3698215083
4877,2245857855,657860,2246515715,41,0,0,12800,41,7181306579
4878,2245870017,382837,2246252854,37,0,0,5120,37,3893075330
4879,2245894878,887829,2246782707,10,0,1,12288,10,1657367186
4880,2245906524,453329,2246359853,41,0,0,6144,41,10133243570
4881,2245909275,730920,2246640195,44,0,0,59392,44,7236942222
4882,2245922895,516204,2246439099,7,0,0,5632,7,6311129322
4883,2245926843,593864,2246520707,35,0,0,7168,35,7714814319
4884,2245927064,785751,2246712815,15,0,0,27648,15,1559680489
4885,2245927539,1546066,2247473605,47,0,0,288256,47,109397186
4886,2245946538,1363570,2247310108,19,0,0,4608,19,5560200603
4887,2245947188,486186,2246433374,27,0,0,2048,27,6087347084
4888,2245977073,203958,2246181031,25,0,0,2560,25,2379397445
4889,2246020705,880467,2246901172,38,0,0,29184,38,2599840489
4890,2246028401,321220,2246349621,18,0,0,512,18,3971334254
4891,2246032179,734557,2246766736,37,0,0,3584,37,9861671392
4892,2246059838,292138,2246351976,27,0,0,7680,27,4372480595
4893,2246073010,276440,2246349450,27,0,0,21504,27,6357756607
4894,2246087870,694784,2246782654,14,0,0,33280,14,8637508209
4895,2246093782,375451,2246469233,10,0,0,10752,10,5856995956
4896,2246094086,765070,2246859156,46,0,1,20480,46,4122044634
4897,2246100150,1525283,2247625433,21,0,1,249856,21,4166714112
4898,2246110584,324077,2246434661,13,0,0,4096,13,2354059479
4899,2246119620,417526,2246537146,45,0,0,4608,45,4775750166
4900,2246137952,1589612,2247727564,17,0,0,19456,17,4936676174
4901,2246179853,570679,2246750532,4,0,0,44544,4,4755831661
4902,2246199049,1497639,2247696688,15,0,0,20992,15,6559513622
4903,2246199529,337788,2246537317,36,0,0,512,36,2911801791
4904,2246237278,1355702,2247592980,1,0,0,10240,1,372430030
4905,2246243762,1384257,2247628019,7,0,1,4096,7,4680496513
4906,2246258989,609403,2246868392,38,0,0,18944,38,10240935105
4907,2246261446,452476,2246713922,5,0,0,3584,5,6347323712
4908,2246271100,321724,2246592824,39,0,0,3584,39,4965244163
4909,2246273435,970986,2247244421,39,0,0,10752,39,8146715876
4910,2246279640,716890,2246996530,5,0,0,48640,5,4078321546
4911,2246288293,364576,2246652869,6,0,0,14848,6,1114935345
4912,2246295585,1394660,2247690245,44,0,0,122368,44,6921707704
4913,2246300344,727230,2247027574,36,0,0,78848,36,5568755855
4914,2246318083,1451653,2247769736,29,0,1,1024,29,3010541493
4915,2246320042,1450040,2247770082,35,0,1,512,35,7415646451
4916,2246320241,1157482,2247477723,45,0,0,3584,45,938436504
4917,2246333201,1475585,2247808786,10,0,0,37888,10,4126213928
4918,2246348486,768110,2247116596,27,0,0,57344,27,7376961902
4919,2246349585,1475455,2247825040,48,0,1,39936,48,9407151983
4920,2246363120,330889,2246694009,14,0,0,1024,14,4667974933
4921,2246365083,980999,2247346082,19,0,0,30720,19,10123369929
4922,2246379496,303532,2246683028,25,0,0,7680,25,3847192005
4923,2246396421,261495,2246657916,20,0,0,16384,20,7570841367
4924,2246400079,1180516,2247580595,36,0,0,35840,36,5280900203
4925,2246406905,574166,2246981071,21,0,0,26624,21,3464094655
4926,2246412734,392794,2246805528,28,0,0,512,28,8284307364
4927,2246414933,370909,2246785842,49,0,0,10240,49,7098654505
4928,2246415054,464685,2246879739,22,0,0,13824,22,4437564655
4929,2246419513,1100680,2247520193,20,0,0,62464,20,10474971564
4930,2246432778,319344,2246752122,44,0,0,5120,44,4991281838
4931,2246456585,247791,2246704376,18,0,0,7168,18,545036751
4932,2246478468,1346587,2247825055,24,0,1,1536,24,5866974872
4933,2246492605,1332465,2247825070,43,0,1,12800,43,1523211083
4934,2246498114,593832,2247091946,21,0,0,21504,21,9779317272
4935,2246513976,404732,2246918708,30,0,0,24064,30,5457457444
4936,2246536226,1246413,2247782639,22,0,0,13312,22,8586994907
4937,2246538622,998029,2247536651,47,0,0,31232,47,9046887323
4938,2246549560,1210228,2247759788,5,0,0,21504,5,5903020159
4939,2246572903,234684,2246807587,34,0,0,6656,34,10698728797
4940,2246583277,1241808,2247825085,46,0,1,4096,46,9605984060
4941,2246604665,487920,2247092585,23,0,0,2048,23,2510363239
4942,2246605764,960380,2247566144,11,0,0,9728,11,3368547765
4943,2246606980,1218120,2247825100,34,0,1,2560,34,6887590899
4944,2246620237,1245308,2247865545,28,0,0,22016,28,2665530869
4945,2246632941,868197,2247501138,34,0,0,76800,34,8257583779
4946,2246638665,950689,2247589354,17,0,0,28672,17,6295437900
4947,2246640089,541484,2247181573,24,0,0,19968,24,4859826256
4948,2246656689,620409,2247277098,47,0,0,40960,47,3418309348
4949,2246674117,261827,2246935944,9,0,0,512,9,5922274941
4950,2246680495,1232715,2247913210,47,0,0,48640,47,4748993123
4951,2246682882,277568,2246960450,44,0,0,8704,44,8154676288
4952,2246710955,323033,2247033988,33,0,0,4096,33,10336397560
4953,2246728396,1299663,2248028059,21,0,1,106496,21,9190432815
4954,2246734309,1526077,2248260386,46,0,0,61952,46,5174152818
4955,2246746454,1099888,2247846342,33,0,0,6144,33,3172087688
4956,2246752412,449814,2247202226,7,0,0,34304,7,10064717998
4957,2246757572,545968,2247303540,0,0,0,5632,0,9772192275
4958,2246772678,471914,2247244592,38,0,0,512,38,4485462011
4959,2246786127,536737,2247322864,21,0,0,3584,21,6599382823
4960,2246790205,558232,2247348437,40,0,0,7680,40,3913238728
4961,2246818197,1641914,2248460111,34,0,0,99328,34,2494811530
4962,2246824426,800372,2247624798,6,0,0,2048,6,7987727783
4963,2246842397,333069,2247175466,21,0,0,1536,21,8558968945
4964,2246844856,1346477,2248191333,22,0,0,2048,22,6198626289
4965,2246862061,842606,2247704667,18,0,0,26112,18,3450063965
4966,2246862074,290266,2247152340,44,0,0,22016,44,2974513135
4967,2246864400,339713,2247204113,49,0,0,6144,49,5166593137
4968,2246870683,954342,2247825025,12,0,0,53248,12,10072488019
4969,2246879782,1113249,2247993031,22,0,0,45568,22,1395828347
4970,2246884348,349437,2247233785,37,0,0,3584,37,2191494800
4971,2246888714,1009653,2247898367,39,0,0,24064,39,6723881296
4972,2246914854,272046,2247186900,21,0,0,17408,21,10658586218
4973,2246917064,683194,2247600258,29,0,0,8192,29,8366995451
4974,2246947950,284728,2247232678,27,0,0,6144,27,1438195507
4975,2246954588,1099608,2248054196,4,0,1,23552,4,850821886
4976,2246958616,1722789,2248681405,28,0,0,31744,28,516836588
4977,2246962760,1608653,2248571413,14,0,0,74240,14,2595337663
4978,2246971574,1083928,2248055502,16,0,1,2048,16,7685940917
4979,2246983024,544096,2247527120,44,0,0,22528,44,5063942647
4980,2246993348,301839,2247295187,12,0,0,27648,12,3466275063
4981,2246995040,1149918,2248144958,24,0,0,40960,24,4812912755
4982,2247004689,381057,2247385746,16,0,0,37376,16,5681572846
4983,2247029571,1495739,2248525310,12,0,0,59392,12,7908061221
4984,2247034652,1022476,2248057128,12,0,1,2560,12,8052587880
4985,2247039578,1187856,2248227434,28,0,0,26112,28,7261366358
4986,2247061321,258563,2247319884,24,0,0,11776,24,10405697599
4987,2247070292,1089348,2248159640,36,0,0,9216,36,302517884
4988,2247075939,1154075,2248230014,48,0,0,7168,48,7104303501
4989,2247080529,712587,2247793116,35,0,0,19968,35,3169383141
4990,2247080531,1064442,2248144973,15,0,1,13824,15,4565068675
4991,2247093827,1141879,2248235706,43,0,1,7168,43,1957193236
4992,2247098553,1676768,2248775321,15,0,0,89600,15,5026727655
4993,2247103417,630714,2247734131,19,0,0,21504,19,4736367639
4994,2247108360,750462,2247858822,27,0,0,37888,27,3716239567
4995,2247111928,364688,2247476616,20,0,0,9728,20,1763663690
4996,2247133268,1199288,2248332556,1,0,0,13312,1,5868362881
4997,2247141710,1186775,2248328485,18,0,0,69632,18,4006136394
4998,2247142333,420824,2247563157,25,0,0,55808,25,9068721903
4999,2247148128,1088039,2248236167,29,0,1,10240,29,3444219005
5000,2247157556,1442372,2248599928,49,0,0,40448,49,6500812849
5001,2247184712,354810,2247539522,41,0,0,9216,41,5939727268
5002,2247199479,691517,2247890996,30,0,0,83456,30,7597917671
5003,2247207384,1054280,2248261664,8,0,1,7680,8,6157656817
5004,2247224408,494314,2247718722,40,0,0,46080,40,4387062732
5005,2247255621,1032983,2248288604,32,0,0,7168,32,5695647923
5006,2247270488,991191,2248261679,10,0,1,10240,10,9043710356
5007,2247271903,481318,2247753221,46,0,0,26112,46,5690169789
5008,2247275232,1675027,2248950259,17,0,0,45568,17,6773970847
5009,2247281651,693481,2247975132,11,0,0,5120,11,9338346521
5010,2247294365,657301,2247951666,14,0,0,19968,14,917640704
5011,2247297647,811339,2248108986,39,0,0,45056,39,6140575466
5012,2247367521,1110946,2248478467,11,0,0,5632,11,1438024322
5013,2247369486,1648559,2249018045,29,0,0,16896,29,4913428204
5014,2247378690,211155,2247589845,14,0,0,1536,14,10236288223
5015,2247380083,534702,2247914785,45,0,0,5120,45,9291321229
5016,2247386807,874887,2248261694,14,0,1,1536,14,1668033201
5017,2247387760,634455,2248022215,47,0,0,23040,47,6306719048
5018,2247390564,1816067,2249206631,10,0,0,34816,10,5146895072
5019,2247406170,926401,2248332571,7,0,1,24064,7,8359479520
5020,2247432832,924795,2248357627,41,0,1,512,41,5209520653
5021,2247466026,562002,2248028028,46,0,0,17408,46,218973695
5022,2247469491,644994,2248114485,34,0,0,17920,34,5547047377
5023,2247483701,290328,2247774029,27,0,0,8704,27,5039101612
5024,2247491226,982927,2248474153,22,0,0,1024,22,3272096202
5025,2247498217,1997788,2249496005,36,0,0,43520,36,3922410996
5026,2247508731,1398348,2248907079,45,0,0,512,45,660755727
5027,2247524638,2084729,2249609367,12,0,0,44032,12,304903325
5028,2247524652,1051339,2248575991,25,0,0,11776,25,7697075584
5029,2247528203,1143515,2248671718,34,0,0,46080,34,7835056523
5030,2247538400,675556,2248213956,18,0,0,50688,18,5368240560
5031,2247549955,809618,2248359573,4,0,1,3072,4,1658174884
5032,2247570155,793924,2248364079,29,0,1,7168,29,9816831033
5033,2247590733,599945,2248190678,11,0,0,22528,11,8495502413
5034,2247596192,771753,2248367945,46,0,1,6144,46,2910873404
5035,2247624209,316830,2247941039,15,0,0,11264,15,7480622252
5036,2247651848,719963,2248371811,35,0,1,6144,35,9082672480
5037,2247652710,633295,2248286005,39,0,0,14848,39,3240783192
5038,2247660387,1128716,2248789103,28,0,0,21504,28,4283342629
5039,2247667141,2024212,2249691353,5,0,0,22016,5,8608707774
5040,2247667853,2110831,2249778684,16,0,0,4608,16,2647489010
5041,2247678133,337027,2248015160,40,0,0,14336,40,7401590685
5042,2247699343,528426,2248227769,40,0,0,1024,40,6731668188
5043,2247711121,1400926,2249112047,2,0,1,361984,2,3862825806
5044,2247714604,625626,2248340230,48,0,0,25088,48,3125592297
5045,2247741373,478090,2248219463,37,0,0,17920,37,5979101618
5046,2247746972,794607,2248541579,15,0,0,9728,15,9507246089
5047,2247748778,779511,2248528289,20,0,0,9728,20,1457728220
5048,2247751401,528701,2248280102,6,0,0,40960,6,8344498589
5049,2247761336,1511838,2249273174,43,0,0,6144,43,8628800768
5050,2247768624,318217,2248086841,11,0,0,7168,11,10101609590
5051,2247770082,932137,2248702219,28,0,0,5120,28,3748932046
5052,2247771281,412502,2248183783,25,0,0,4608,25,8393971595
5053,2247798424,897702,2248696126,15,0,0,12288,15,8146684518
5054,2247802476,379872,2248182348,27,0,0,57856,27,9151719127
5055,2247807151,541221,2248348372,46,0,0,5120,46,6872541405
5056,2247815724,1297432,2249113156,32,0,1,2048,32,6352565286
5057,2247822506,262101,2248084607,45,0,0,19968,45,5761707087
5058,2247824612,867707,2248692319,47,0,0,23040,47,6296088019
5059,2247836014,702586,2248538600,33,0,0,33792,33,10707902785
5060,2247851822,1973092,2249824914,47,0,0,38912,47,8748373254
5061,2247869603,2135427,2250005030,44,0,0,62976,44,5073458828
5062,2247877140,2009835,2249886975,42,0,0,9216,42,2121429533
5063,2247879697,492582,2248372279,19,0,0,512,19,7640630746
5064,2247895117,1654544,2249549661,0,0,0,29696,0,7178379264
5065,2247931339,965868,2248897207,5,0,0,37888,5,8607252604
5066,2247940112,1225860,2249165972,15,0,1,19968,15,3247464350
5067,2247953128,652611,2248605739,43,0,0,18944,43,5642968582
5068,2247956607,444472,2248401079,3,0,0,4096,3,9325904813
5069,2247961712,656710,2248618422,43,0,0,15872,43,4649357906
5070,2247967143,1199175,2249166318,24,0,1,512,24,2402624248
5071,2247992595,2070296,2250062891,36,0,0,11776,36,7924536300
5072,2247993161,555609,2248548770,24,0,0,23552,24,9134050703
5073,2247998317,348480,2248346797,35,0,0,21504,35,10466894590
5074,2248000744,813456,2248814200,27,0,0,30720,27,5181789300
5075,2248003462,483603,2248487065,19,0,0,23040,19,9466481552
5076,2248005808,1174993,2249180801,12,0,1,1536,12,5280862818
5077,2248023562,443428,2248466990,9,0,0,22528,9,4914736066
5078,2248026034,235615,2248261649,48,0,0,4096,48,10424873514
5079,2248046072,1136317,2249182389,35,0,1,15872,35,3141335837
5080,2248055071,1138718,2249193789,46,0,1,14336,46,4683255344
5081,2248057668,322915,2248380583,4,0,0,2560,4,4179519952
5082,2248097592,602137,2248699729,34,0,0,11776,34,4976581611
5083,2248102526,524442,2248626968,44,0,0,5632,44,10618065521
5084,2248103877,475873,2248579750,21,0,0,12288,21,9352717232
5085,2248118779,785156,2248903935,13,0,0,3584,13,3292159559
5086,2248149439,2014916,2250164355,45,0,0,12800,45,10656721359
5087,2248163323,409041,2248572364,30,0,0,3072,30,7114287902
5088,2248166956,1049697,2249216653,41,0,1,7680,41,8287472697
5089,2248167793,1054818,2249222611,34,0,1,16384,34,4644430936
5090,2248171779,258053,2248429832,25,0,0,11776,25,3723298849
5091,2248177857,1088206,2249266063,34,0,1,4096,34,345282897
5092,2248188505,1082759,2249271264,43,0,1,9728,43,6333394385
5093,2248192860,394713,2248587573,22,0,0,25600,22,4353040368
5094,2248194068,215915,2248409983,43,0,0,3072,43,9030402216
5095,2248196433,621074,2248817507,38,0,0,10752,38,6210126589
5096,2248208891,447808,2248656699,4,0,0,12800,4,4387166736
5097,2248224423,711937,2248936360,7,0,0,16384,7,2338369390
5098,2248259920,529690,2248789610,28,0,0,1536,28,4517822721
5099,2248270931,1387984,2249658915,33,0,0,15360,33,4556370596
5100,2248273929,997358,2249271287,15,0,1,5120,15,7329537444
5101,2248277863,1921322,2250199185,30,0,0,30208,30,4662644388
5102,2248299561,2014740,2250314301,2,0,0,21504,2,9474627768
5103,2248300464,504353,2248804817,24,0,0,25088,24,10245298902
5104,2248357511,1415831,2249773342,27,0,1,203264,27,5974836746
5105,2248360179,611022,2248971201,41,0,0,20480,41,7529008661
5106,2248372879,2017945,2250390824,13,0,0,39936,13,4685844159
5107,2248382956,408910,2248791866,41,0,0,6144,41,5144130581
5108,2248392752,572194,2248964946,18,0,0,48128,18,9872878074
5109,2248397573,1754319,2250151892,2,0,1,85504,2,2892699877
5110,2248400857,1881393,2250282250,30,0,1,32768,30,2649679620
5111,2248424503,2454007,2250878510,0,0,0,36864,0,5690580673
5112,2248445475,433586,2248879061,35,0,0,41472,35,1575503982
5113,2248450471,1831802,2250282273,49,0,1,2560,49,1568082989
5114,2248456317,1834489,2250290806,20,0,1,12288,20,9670511290
5115,2248456360,326160,2248782520,3,0,0,23552,3,10267277513
5116,2248461900,798337,2249260237,27,0,0,59392,27,6364431736
5117,2248462765,2185921,2250648686,19,0,0,10752,19,5318483683
5118,2248463593,279555,2248743148,37,0,0,7168,37,8218808744
5119,2248468532,597087,2249065619,45,0,0,29696,45,6495968489
5120,2248479485,847611,2249327096,9,0,0,43520,9,9866343885
5121,2248492802,2257602,2250750404,13,0,0,10752,13,125805807
5122,2248497499,475137,2248972636,41,0,0,4608,41,8434725696
5123,2248499471,1808255,2250307726,10,0,1,6144,10,1285616198
5124,2248499691,551818,2249051509,19,0,0,41472,19,1425732974
5125,2248519220,519638,2249038858,9,0,0,49152,9,6464452694
5126,2248528233,1111155,2249639388,0,0,0,8704,0,3424632564
5127,2248532228,1789741,2250321969,11,0,1,9216,11,1477330174
5128,2248544399,1777916,2250322315,11,0,1,512,11,10670597471
5129,2248566102,490422,2249056524,5,0,0,16384,5,2661550970
5130,2248580815,400084,2248980899,49,0,0,1536,49,5467639466
5131,2248584937,2083661,2250668598,21,0,1,266240,21,656370746
5132,2248593127,2315258,2250908385,26,0,0,1536,26,6798783457
5133,2248596629,645497,2249242126,42,0,0,64000,42,5516030349
5134,2248603696,835428,2249439124,1,0,0,7680,1,5675847953
5135,2248622049,658347,2249280396,32,0,0,10240,32,4635829647
5136,2248625199,882536,2249507735,16,0,0,11776,16,8564725280
5137,2248630060,1041732,2249671792,23,0,0,19456,23,4823030833
5138,2248640465,352114,2248992579,15,0,0,36352,15,9018511381
5139,2248657749,779012,2249436761,34,0,0,11776,34,3866408737
5140,2248684302,532328,2249216630,23,0,0,32768,23,5186257176
5141,2248716802,256473,2248973275,26,0,0,2048,26,10000651594
5142,2248719738,435977,2249155715,18,0,0,18944,18,441286632
5143,2248739471,2280028,2251019499,34,0,0,7168,34,238990583
5144,2248749253,1003576,2249752829,32,0,0,62464,32,52140490
5145,2248762712,168641,2248931353,2,0,0,7680,2,10618312637
5146,2248763130,348902,2249112032,6,0,0,10240,6,9546637720
5147,2248766347,641772,2249408119,35,0,0,37888,35,6552546979
5148,2248766908,798524,2249565432,12,0,0,51712,12,7837067754
5149,2248775935,871471,2249647406,23,0,0,24064,23,1004101345
5150,2248776393,446203,2249222596,8,0,0,19456,8,6646844461
5151,2248789130,679371,2249468501,29,0,0,8704,29,2357347547
5152,2248797619,345517,2249143136,15,0,0,512,15,1526678576
5153,2248802318,1867586,2250669904,8,0,1,2048,8,7433947934
5154,2248806723,270160,2249076883,43,0,0,15360,43,1471398576
5155,2248822395,448854,2249271249,30,0,0,8704,30,8175088736
5156,2248841392,2311110,2251152502,37,0,0,17920,37,4405416688
5157,2248908527,357505,2249266032,33,0,0,18944,33,4663838248
5158,2248933639,785578,2249719217,34,0,0,59392,34,9860524736
5159,2248939680,328894,2249268574,8,0,0,8192,8,8910705543
5160,2248942254,1730556,2250672810,29,0,1,4608,29,8496351506
5161,2248970850,306395,2249277245,25,0,0,13312,25,534606227
5162,2248988885,1687598,2250676483,34,0,1,18944,34,8154054634
5163,2248992031,1723252,2250715283,15,0,1,3584,15,6376976120
5164,2248996248,640457,2249636705,1,0,0,83456,1,8497210379
5165,2248997004,369161,2249366165,13,0,0,18944,13,3246110816
5166,2249000989,336588,2249337577,46,0,0,4096,46,7116663986
5167,2249019138,354998,2249374136,20,0,0,26112,20,9556448954
5168,2249029038,475094,2249504132,21,0,0,26624,21,4571722882
5169,2249044077,781788,2249825865,39,0,0,3072,39,998708970
5170,2249044659,896859,2249941518,3,0,0,27648,3,230279995
5171,2249045008,884491,2249929499,30,0,0,20480,30,5231130906
5172,2249048752,1666546,2250715298,20,0,1,2048,20,8025078295
5173,2249068664,662725,2249731389,35,0,0,18944,35,7131552232
5174,2249073755,522181,2249595936,14,0,0,10752,14,10494162311
5175,2249074212,685496,2249759708,7,0,0,22528,7,4183536755
5176,2249076776,589065,2249665841,46,0,0,18944,46,10509148112
5177,2249080125,499214,2249579339,42,0,0,45568,42,736431030
5178,2249086312,366870,2249453182,13,0,0,20480,13,10169839947
5179,2249106768,861954,2249968722,0,0,0,10752,0,4051270517
5180,2249133832,281403,2249415235,5,0,0,15872,5,9843996037
5181,2249142795,1656385,2250799180,21,0,1,72704,21,2571923805
5182,2249147941,1662274,2250810215,16,0,1,5120,16,7212614512
5183,2249161054,1649184,2250810238,19,0,1,5120,19,6104674323
5184,2249205386,589341,2249794727,29,0,0,47616,29,920191369
5185,2249220333,367297,2249587630,2,0,0,27136,2,5680087166
5186,2249237529,2162516,2251400045,25,0,0,78848,25,6015758233
5187,2249241884,1568508,2250810392,29,0,1,10240,29,5554859891
5188,2249254110,872625,2250126735,32,0,0,8704,32,9472401331
5189,2249257674,716687,2249974361,45,0,0,18432,45,4580671933
5190,2249271245,541798,2249813043,37,0,0,9216,37,5710204339
5191,2249289379,350664,2249640043,5,0,0,2048,5,10246671284
5192,2249304566,288079,2249592645,17,0,0,16384,17,4802170456
5193,2249307506,469759,2249777265,21,0,0,12800,21,3405564449
5194,2249323653,477641,2249801294,15,0,0,21504,15,4417110018
5195,2249358610,252652,2249611262,42,0,0,6144,42,701322817
5196,2249367383,555861,2249923244,19,0,0,22528,19,1550841553
5197,2249371353,461235,2249832588,17,0,0,22016,17,7055127287
5198,2249372623,638974,2250011597,24,0,0,21504,24,716979981
5199,2249375192,435028,2249810220,6,0,0,20992,6,5162460531
5200,2249386655,702544,2250089199,0,0,0,3584,0,10360348643
5201,2249400525,1429168,2250829693,40,0,1,1536,40,9001113315
5202,2249401127,1428581,2250829708,20,0,1,13824,20,863324795
5203,2249406157,1429847,2250836004,12,0,1,16896,12,2548175474
5204,2249414172,861777,2250275949,49,0,0,48640,49,5992714090
5205,2249424944,1415566,2250840510,11,0,1,7168,11,6264990767
5206,2249433700,636858,2250070558,19,0,0,25088,19,980346359
5207,2249449332,2034526,2251483858,1,0,0,2560,1,568604893
5208,2249474522,456396,2249930918,29,0,0,4608,29,5010256929
5209,2249474759,1411381,2250886140,38,0,0,9216,38,7948846098
5210,2249477121,296182,2249773303,41,0,0,44544,41,974589764
5211,2249477855,768672,2250246527,23,0,0,512,23,733905644
5212,2249502716,967173,2250469889,35,0,0,52736,35,1948146348
5213,2249514984,464852,2249979836,19,0,0,17920,19,5299029147
5214,2249515513,1256381,2250771894,8,0,0,23552,8,4332179200
5215,2249525861,652393,2250178254,42,0,0,45568,42,3147746632
5216,2249526453,1458300,2250984753,14,0,1,7680,14,7336668780
5217,2249530280,421414,2249951694,27,0,0,15360,27,5340500590
5218,2249545367,1486361,2251031728,12,0,1,17408,12,3880655262
5219,2249556523,2041348,2251597871,4,0,0,5632,4,10015695324
5220,2249585928,292651,2249878579,48,0,0,8704,48,938810418
5221,2249590588,959828,2250550416,2,0,0,12288,2,6346669324
5222,2249595063,485042,2250080105,33,0,0,31232,33,9676662188
5223,2249620147,558754,2250178901,23,0,0,2048,23,9817336284
5224,2249624494,948087,2250572581,23,0,0,4608,23,3318534952
5225,2249628796,1402947,2251031743,0,0,1,3072,0,8691721093
5226,2249629332,1403889,2251033221,34,0,1,5632,34,5834941742
5227,2249641020,666691,2250307711,18,0,0,54272,18,9146181141
5228,2249642406,608972,2250251378,47,0,0,15872,47,10578753721
5229,2249652021,628007,2250280028,14,0,0,13312,14,4454813807
5230,2249660151,399129,2250059280,21,0,0,54784,21,2856181349
5231,2249673224,573132,2250246356,32,0,0,36352,32,4344739186
5232,2249676714,352843,2250029557,49,0,0,12800,49,5016970405
5233,2249680791,407301,2250088092,43,0,0,26112,43,3795654733
5234,2249684225,551040,2250235265,38,0,0,30208,38,1442343232
5235,2249694902,780774,2250475676,9,0,0,18944,9,3898884495
5236,2249714204,694575,2250408779,37,0,0,14336,37,1252206707
5237,2249721153,1320479,2251041632,14,0,1,21504,14,739000704
5238,2249738228,1355955,2251094183,8,0,1,4096,8,1805102295
5239,2249747221,799436,2250546657,41,0,0,37888,41,7472700910
5240,2249757938,333304,2250091242,1,0,0,6656,1,4932233841
5241,2249766877,1223253,2250990130,14,0,0,1536,14,3214508569
5242,2249771450,1888456,2251659906,21,0,1,310272,21,9883856183
5243,2249776066,1923428,2251699494,8,0,1,6656,8,3324517383
5244,2249781189,1989262,2251770451,34,0,1,34816,34,3964637311
5245,2249807381,1963085,2251770466,22,0,1,3072,22,4829028072
5246,2249811595,814550,2250626145,11,0,0,32768,11,5726936227
5247,2249846605,435622,2250282227,43,0,0,7168,43,6227003508
5248,2249861474,469941,2250331415,42,0,0,22016,42,4588352356
5249,2249873947,412241,2250286188,30,0,0,12800,30,10679041082
5250,2249875768,896297,2250772065,40,0,0,512,40,2471895009
5251,2249884092,831176,2250715268,47,0,0,67072,47,4093949922
5252,2249889424,1881012,2251770436,17,0,0,66560,17,2495733142
5253,2249893511,801306,2250694817,14,0,0,15360,14,7245766511
5254,2249899478,1871011,2251770489,0,0,1,4608,0,7932876577
5255,2249905594,1864910,2251770504,20,0,1,30720,20,9668845902
5256,2249907709,431163,2250338872,29,0,0,8192,29,10025511336
5257,2249909260,543252,2250452512,20,0,0,71680,20,3964416008
5258,2249928228,798584,2250726812,6,0,0,24064,6,1592877756
5259,2249936191,479155,2250415346,48,0,0,21504,48,5164477825
5260,2249963235,519164,2250482399,37,0,0,22016,37,6505575194
5261,2249966697,827789,2250794486,36,0,0,40960,36,3820875537
5262,2249981285,1789234,2251770519,10,0,1,1024,10,4447130075
5263,2249993571,836099,2250829670,33,0,0,37888,33,5256425921
5264,2249995347,620799,2250616146,37,0,0,38912,37,6487575285
5265,2250024868,983459,2251008327,15,0,0,15872,15,5178665427
5266,2250039964,1730570,2251770534,20,0,1,3072,20,6583029618
5267,2250046681,981413,2251028094,3,0,0,28160,3,5906219053
5268,2250050211,1723999,2251774210,22,0,1,8192,22,7402337613
5269,2250051184,2053544,2252104728,2,0,1,198656,2,10415305776
5270,2250071785,484658,2250556443,4,0,0,15360,4,6821194564
5271,2250084939,2041949,2252126888,29,0,1,8704,29,6180511111
5272,2250133780,320026,2250453806,36,0,0,3584,36,10602064213
5273,2250164131,2093090,2252257221,4,0,1,9728,4,10501263785
5274,2250181843,950136,2251131979,3,0,0,13824,3,1402301416
5275,2250213164,2044072,2252257236,49,0,1,512,49,163961991
5276,2250221539,276139,2250497678,12,0,0,21504,12,8584438220
5277,2250246199,2057952,2252304151,11,0,1,26624,11,7319480247
5278,2250248395,2056918,2252305313,48,0,1,7680,48,7112456477
5279,2250253613,199078,2250452691,46,0,0,512,46,5959215545
5280,2250269580,2129120,2252398700,10,0,1,5120,10,2450828538
5281,2250274383,564050,2250838433,19,0,0,512,19,1239950483
5282,2250297292,830436,2251127728,20,0,0,57344,20,4723446752
5283,2250316198,167620,2250483818,28,0,0,4608,28,7952576547
5284,2250324067,431229,2250755296,16,0,0,9216,16,6821908815
5285,2250330418,221277,2250551695,18,0,0,4096,18,2858472142
5286,2250336844,1600232,2251937076,11,0,0,13824,11,1890041076
5287,2250346606,188484,2250535090,28,0,0,3584,28,389813625
5288,2250366086,840752,2251206838,15,0,0,18432,15,1810501170
5289,2250371269,2027446,2252398715,22,0,1,11776,22,5728577338
5290,2250372972,2084267,2252457239,2,0,1,62976,2,3127365624
5291,2250373684,722386,2251096070,34,0,0,6144,34,1124432569
5292,2250379918,993569,2251373487,13,0,0,81408,13,559982502
5293,2250382796,1492350,2251875146,34,0,0,14336,34,1251172592
5294,2250395452,293374,2250688826,41,0,0,21504,41,2019318477
5295,2250402728,1080335,2251483063,3,0,0,1024,3,3880877295
5296,2250409711,485024,2250894735,9,0,0,28160,9,4425878646
5297,2250423027,2035185,2252458212,8,0,1,12800,8,3882438593
5298,2250433721,376479,2250810200,35,0,0,16896,35,3646187277
5299,2250438159,875995,2251314154,19,0,0,7680,19,3832559505
5300,2250461364,1134736,2251596100,45,0,0,77312,45,560203668
5301,2250473197,260322,2250733519,23,0,0,8704,23,7199762281
5302,2250479065,251787,2250730852,12,0,0,4608,12,1880764754
5303,2250501760,470383,2250972143,18,0,0,9728,18,988391296
5304,2250527307,354432,2250881739,9,0,0,3072,9,10658805356
5305,2250530591,501122,2251031713,6,0,0,11776,6,8121470463
5306,2250534314,923877,2251458191,27,0,0,38400,27,9027582471
5307,2250538284,1524041,2252062325,45,0,0,29184,45,2370477482
5308,2250542758,876403,2251419161,25,0,0,10240,25,8564634695
5309,2250551195,618461,2251169656,23,0,0,18944,23,3650347267
5310,2250573469,828323,2251401792,49,0,0,5632,49,10666353573
5311,2250583209,753736,2251336945,10,0,0,74752,10,1119112258
5312,2250595444,300086,2250895530,8,0,0,2560,8,6180808370
5313,2250595598,1967968,2252563566,14,0,1,36864,14,2386209258
5314,2250651518,442650,2251094168,2,0,0,53760,2,1554177363
5315,2250659535,1919158,2252578693,10,0,1,2048,10,8278675481
5316,2250662796,501065,2251163861,2,0,0,25600,2,8847654242
5317,2250663977,384504,2251048481,27,0,0,2048,27,138835846
5318,2250682875,569942,2251252817,26,0,0,95744,26,1535899363
5319,2250703404,1121148,2251824552,41,0,0,64000,41,4169665014
5320,2250709161,1509898,2252219059,16,0,0,64512,16,6554198938
5321,2250720276,477051,2251197327,49,0,0,26112,49,1964055138
5322,2250749198,190831,2250940029,5,0,0,11776,5,1045570910
5323,2250751602,1827347,2252578949,11,0,1,9216,11,4387253909
5324,2250778309,1802586,2252580895,49,0,1,3072,49,9256173884
5325,2250785314,1831208,2252616522,0,0,1,3584,0,8003203967
5326,2250788752,1854310,2252643062,29,0,1,30720,29,2256732262
5327,2250794180,554488,2251348668,28,0,0,38400,28,1925599568
5328,2250795690,953180,2251748870,10,0,0,38912,10,10418064701
5329,2250806932,1836145,2252643077,0,0,1,5120,0,9348749265
5330,2250820390,646864,2251467254,23,0,0,29696,23,8133499037
5331,2250865357,550334,2251415691,20,0,0,45568,20,6289143364
5332,2250880429,375547,2251255976,26,0,0,10240,26,4581768131
5333,2250905540,561885,2251467425,29,0,0,512,29,704335525
5334,2250916334,975534,2251891868,32,0,0,25088,32,4783682126
5335,2250918869,1528347,2252447216,37,0,0,18432,37,10649197004
5336,2250928288,821845,2251750133,0,0,0,4096,0,695476347
5337,2250954350,528378,2251482728,12,0,0,50176,12,3789296168
5338,2250960252,1224139,2252184391,35,0,0,16896,35,2092955987
5339,2250962585,712144,2251674729,16,0,0,13312,16,4129796116
5340,2250969405,1145920,2252115325,8,0,0,3072,8,4514850374
5341,2250971953,1539877,2252511830,14,0,0,32768,14,8780831971
5342,2250972740,1689238,2252661978,10,0,1,1536,10,8980159880
5343,2250989631,863502,2251853133,0,0,0,33280,0,5429675178
5344,2250991283,624710,2251615993,21,0,0,47104,21,8834370333
5345,2251002196,672909,2251675105,47,0,0,1024,47,8792031909
5346,2251017281,909475,2251926756,45,0,0,40448,45,5253552539
5347,2251019134,548136,2251567270,32,0,0,9728,32,892602503
5348,2251021856,526373,2251548229,35,0,0,15360,35,5269170320
5349,2251030338,1634226,2252664564,7,0,1,4096,7,1925055830
5350,2251062029,780949,2251842978,7,0,0,33792,7,10083484916
5351,2251069717,1603631,2252673348,16,0,1,8192,16,4500337788
5352,2251090400,963010,2252053410,4,0,0,17408,4,5525345758
5353,2251092171,425761,2251517932,36,0,0,10240,36,4910250901
5354,2251096580,1807067,2252903647,29,0,0,23040,29,9393120185
5355,2251097341,278657,2251375998,45,0,0,8192,45,2723292620
5356,2251101842,343016,2251444858,13,0,0,30720,13,3683250884
5357,2251104585,1538462,2252643047,23,0,0,67584,23,6030630680
5358,2251111038,587226,2251698264,5,0,0,29184,5,10258714640
5359,2251112058,303960,2251416018,39,0,0,1024,39,9767390161
5360,2251124843,366941,2251491784,6,0,0,7168,6,7169119480
5361,2251134174,396862,2251531036,4,0,0,25088,4,5272739048
5362,2251142352,1530981,2252673333,0,0,0,13824,0,10642981073
5363,2251144420,1159716,2252304136,22,0,0,119296,22,9584619465
5364,2251146075,1269353,2252415428,46,0,0,19968,46,4499367401
5365,2251158084,468532,2251626616,3,0,0,34816,3,876985725
5366,2251189621,239983,2251429604,11,0,0,6144,11,4346901639
5367,2251193251,1480965,2252674216,48,0,1,7168,48,9276241402
5368,2251194749,1416046,2252610795,16,0,0,16384,16,651616484
5369,2251218260,610215,2251828475,10,0,0,12800,10,6198764669
5370,2251233702,637061,2251870763,40,0,0,51712,40,204380920
5371,2251239455,1751729,2252991184,10,0,0,97280,10,4410245602
5372,2251239875,392380,2251632255,47,0,0,18432,47,4339101601
5373,2251261819,1450586,2252712405,13,0,0,26112,13,3169091011
5374,2251265620,1409582,2252675202,46,0,1,1536,46,416993823
5375,2251267062,1409420,2252676482,43,0,1,14336,43,6521404596
5376,2251270720,406721,2251677441,14,0,0,2048,14,7696465464
5377,2251272220,1501558,2252773778,47,0,1,25600,47,5197904925
5378,2251315213,1496554,2252811767,26,0,0,34304,26,522053649
5379,2251347795,1426793,2252774588,46,0,1,3072,46,5097767790
5380,2251367069,595128,2251962197,4,0,0,26624,4,4147234860
5381,2251410542,473667,2251884209,30,0,0,29696,30,5085110461
5382,2251443018,1348075,2252791093,46,0,1,16384,46,9192649770
5383,2251456622,660590,2252117212,20,0,0,6144,20,4971763478
5384,2251465039,500293,2251965332,5,0,0,10240,5,1963511490
5385,2251488719,1519397,2253008116,33,0,0,12288,33,3084051786
5386,2251492405,312632,2251805037,38,0,0,18944,38,4250118816
5387,2251494923,1410143,2252905066,40,0,0,4608,40,4814792256
5388,2251576288,1224554,2252800842,34,0,1,7680,34,9959242355
5389,2251580691,373379,2251954070,13,0,0,16896,13,7491664044
5390,2251582106,465977,2252048083,2,0,0,50688,2,1346310986
5391,2251585459,151540,2251736999,29,0,0,29184,29,7051401822
5392,2251586660,497257,2252083917,47,0,0,24576,47,3086961595
5393,2251614279,1382536,2252996815,2,0,0,18432,2,7667800060
5394,2251638431,495532,2252133963,45,0,0,11264,45,6163091393
5395,2251642371,1158486,2252800857,14,0,1,3584,14,3840932443
5396,2251642590,462123,2252104713,2,0,0,19456,2,9306503775
5397,2251654676,274919,2251929595,24,0,0,9216,24,8652828862
5398,2251656947,1134131,2252791078,19,0,0,26112,19,10274073046
5399,2251659242,349312,2252008554,41,0,0,20992,41,4395470900
5400,2251678406,578800,2252257206,5,0,0,56832,5,7449848059
5401,2251683627,1163803,2252847430,48,0,1,8192,48,10537418060
5402,2251684416,651212,2252335628,47,0,0,15360,47,9198966054
5403,2251699811,302332,2252002143,3,0,0,19456,3,4407943605
5404,2251709285,530582,2252239867,2,0,0,17408,2,1866646704
5405,2251715268,1132177,2252847445,29,0,1,2048,29,16274756
5406,2251721785,1323456,2253045241,40,0,0,1536,40,4585015012
5407,2251736752,1110708,2252847460,22,0,1,512,22,6534152915
5408,2251770067,200515,2251970582,49,0,0,512,49,6219767739
5409,2251775524,575850,2252351374,41,0,0,7168,41,8268158580
5410,2251777748,527526,2252305274,46,0,0,3584,46,9344558083
5411,2251793203,1054620,2252847823,20,0,1,4608,20,8445663531
5412,2251801112,636332,2252437444,44,0,0,11264,44,4926155862
5413,2251829896,1256667,2253086563,24,0,0,19456,24,2731273674
5414,2251831734,1016755,2252848489,10,0,1,11264,10,2058900318
5415,2251849854,1427162,2253277016,42,0,1,142336,42,3207615635
5416,2251874625,480135,2252354760,26,0,0,4608,26,5928849106
5417,2251876792,511558,2252388350,1,0,0,15872,1,124991254
5418,2251888165,912654,2252800819,4,0,0,6144,4,7718064663
5419,2251900179,366548,2252266727,16,0,0,512,16,6011305469
5420,2251909091,489578,2252398669,29,0,0,33792,29,2885919846
5421,2251910811,1345520,2253256331,24,0,0,179712,24,8477130906
5422,2251919479,977125,2252896604,36,0,0,75264,36,6005765614
5423,2251919899,1448683,2253368582,39,0,0,20992,39,9424812251
5424,2251925343,1134140,2253059483,29,0,0,30720,29,4584557060
5425,2251955742,1089016,2253044758,34,0,0,108032,34,4369611027
5426,2252022342,529460,2252551802,45,0,0,9216,45,713098399
5427,2252027424,1511450,2253538874,21,0,1,24576,21,7408052190
5428,2252035344,229566,2252264910,2,0,0,13824,2,10529456289
5429,2252047618,506391,2252554009,6,0,0,7168,6,8441621977
5430,2252067179,193504,2252260683,0,0,0,11264,0,2265229091
5431,2252112384,1428756,2253541140,1,0,1,3584,1,2451905903
5432,2252123775,1417711,2253541486,43,0,1,512,43,6336558858
5433,2252126971,877362,2253004333,29,0,0,17408,29,9390220557
5434,2252134403,483802,2252618205,19,0,0,1536,19,8534834781
5435,2252148055,302526,2252450581,20,0,0,3072,20,401172379
5436,2252154360,1330499,2253484859,2,0,0,74752,2,9834663109
5437,2252160219,1391921,2253552140,0,0,1,2048,0,8979669415
5438,2252165093,915511,2253080604,28,0,0,4608,28,3628403204
5439,2252168114,1384041,2253552155,10,0,1,5632,10,10679614161
5440,2252204251,1373698,2253577949,48,0,0,36352,48,2964657647
5441,2252215733,522224,2252737957,14,0,0,34816,14,5818733162
5442,2252217734,323371,2252541105,23,0,0,512,23,4759965665
5443,2252222713,424969,2252647682,15,0,0,12800,15,7186817797
5444,2252236807,582931,2252819738,23,0,0,26112,23,4073225285
5445,2252270337,1055878,2253326215,9,0,0,32768,9,9670838205
5446,2252272252,1511611,2253783863,0,0,1,50688,0,9059433154
5447,2252284525,1566718,2253851243,4,0,1,17920,4,2364518215
5448,2252297391,1553875,2253851266,41,0,1,4608,41,2872785822
5449,2252301254,886829,2253188083,8,0,0,81920,8,8430971899
5450,2252346117,970099,2253316216,32,0,0,38400,32,10619226487
5451,2252349351,393226,2252742577,0,0,0,4608,0,1840798094
5452,2252350645,713533,2253064178,49,0,0,15360,49,2377665902
5453,2252354894,922099,2253276993,16,0,0,57856,16,342125856
5454,2252361951,1317020,2253678971,13,0,0,18944,13,5395848919
5455,2252365695,1050824,2253416519,35,0,0,11776,35,10677871841
5456,2252371887,589642,2252961529,10,0,0,34816,10,2202630964
5457,2252380615,393148,2252773763,47,0,0,20480,47,963591706
5458,2252384515,354237,2252738752,40,0,0,2560,40,9868240313
5459,2252389221,812339,2253201560,41,0,0,11776,41,2603371798
5460,2252390711,383862,2252774573,24,0,0,2560,24,3069521565
5461,2252394449,1456832,2253851281,22,0,1,12800,22,6736165269
5462,2252394710,1491213,2253885923,5,0,1,4096,5,9561089484
5463,2252394745,655363,2253050108,33,0,0,15872,33,7777641847
5464,2252396035,387072,2252783107,19,0,0,25600,19,10077532053
5465,2252479210,1148997,2253628207,7,0,0,2048,7,6253596394
5466,2252484689,909858,2253394547,10,0,0,2048,10,4348984982
5467,2252494683,899225,2253393908,40,0,0,62464,40,7264030485
5468,2252506012,292920,2252798932,38,0,0,25600,38,6885372146
5469,2252506872,444034,2252950906,25,0,0,17408,25,1142612628
5470,2252509896,1324781,2253834677,6,0,0,34816,6,6644144076
5471,2252519827,568475,2253088302,24,0,0,5632,24,816501656
5472,2252520283,1427548,2253947831,38,0,0,23552,38,2833765875
5473,2252549506,1207499,2253757005,1,0,0,29696,1,5733563148
5474,2252553440,644517,2253197957,47,0,0,8192,47,4205089143
5475,2252562082,598796,2253160878,38,0,0,55808,38,3202930487
5476,2252571849,1427118,2253998967,4,0,1,3584,4,1439922311
5477,2252572123,623307,2253195430,20,0,0,24064,20,4201205594
5478,2252590801,966377,2253557178,12,0,0,16384,12,8371624997
5479,2252605091,250508,2252855599,25,0,0,4608,25,2779057320
5480,2252612326,235089,2252847415,5,0,0,28160,5,2729593505
5481,2252616063,922035,2253538098,40,0,0,6656,40,4261608025
5482,2252634643,1455088,2254089731,39,0,0,5632,39,1760949467
5483,2252664288,916796,2253581084,22,0,0,10240,22,820544794
5484,2252670507,490714,2253161221,29,0,0,1024,29,3157452847
5485,2252696852,1311656,2254008508,47,0,1,34816,47,8337572919
5486,2252701585,377600,2253079185,22,0,0,49152,22,5156406504
5487,2252709829,1794315,2254504144,17,0,0,6144,17,550003961
5488,2252714149,448959,2253163108,37,0,0,6144,37,2582549391
5489,2252723443,275571,2252999014,25,0,0,7168,25,1793164135
5490,2252731307,1050162,2253781469,11,0,0,21504,11,8660175839
5491,2252732046,393754,2253125800,40,0,0,30720,40,9543590246
5492,2252736832,1316008,2254052840,23,0,0,47104,23,1789924608
5493,2252737341,522009,2253259350,43,0,0,9728,43,1117093514
5494,2252741743,1283859,2254025602,48,0,1,5120,48,263819697
5495,2252746974,264121,2253011095,5,0,0,9728,5,7883223281
5496,2252762847,1431228,2254194075,26,0,0,26624,26,8675752151
5497,2252782184,1243441,2254025625,43,0,1,2048,43,10099015664
5498,2252782362,592475,2253374837,12,0,0,20480,12,10354717584
5499,2252782994,1804735,2254587729,2,0,0,5120,2,5302745821
5500,2252801936,1384012,2254185948,21,0,1,97280,21,7186040268
5501,2252805358,1565341,2254370699,38,0,0,62464,38,3374377425
5502,2252807377,811409,2253618786,38,0,0,31744,38,706537572
5503,2252813077,821919,2253634996,33,0,0,21504,33,1403469447
5504,2252818997,528947,2253347944,40,0,0,43008,40,8465887015
5505,2252822215,1371875,2254194090,2,0,1,2048,2,2550690054
5506,2252825355,1676886,2254502241,48,0,0,23552,48,4887939514
5507,2252830785,1109208,2253939993,14,0,0,12288,14,6173648258
5508,2252832090,257631,2253089721,47,0,0,4608,47,3085340936
5509,2252845366,1464496,2254309862,49,0,0,55296,49,2444958881
5510,2252846253,956967,2253803220,30,0,0,42496,30,10302772062
5511,2252849482,482052,2253331534,21,0,0,17408,21,3326421606
5512,2252865855,1328250,2254194105,11,0,1,7680,11,1961428511
5513,2252874785,661246,2253536031,29,0,0,4608,29,4209967002
5514,2252931706,474380,2253406086,10,0,0,21504,10,5899208042
5515,2252934078,1607843,2254541921,30,0,1,168960,30,3913680587
5516,2252944639,739183,2253683822,16,0,0,15872,16,2022604153
5517,2252966346,1064041,2254030387,38,0,0,4096,38,3080280973
5518,2252973501,361324,2253334825,47,0,0,10752,47,3167038048
5519,2253011585,523019,2253534604,15,0,0,41984,15,4278009089
5520,2253024730,337425,2253362155,5,0,0,46592,5,678172345
5521,2253033328,245919,2253279247,16,0,0,7168,16,6248230053
5522,2253040532,810696,2253851228,12,0,0,54272,12,2539430178
5523,2253041083,699617,2253740700,10,0,0,37376,10,8584792490
5524,2253055103,872019,2253927122,45,0,0,10240,45,1756759363
5525,2253058430,1137562,2254195992,5,0,0,6144,5,7976615791
5526,2253071242,1486163,2254557405,46,0,1,8192,46,5645522198
5527,2253091707,460418,2253552125,2,0,0,32256,2,3971656630
5528,2253102786,400902,2253503688,29,0,0,28160,29,10216470604
5529,2253127027,602262,2253729289,11,0,0,33792,11,8413430157
5530,2253131361,390428,2253521789,19,0,0,48640,19,7674114285
5531,2253147845,1484286,2254632131,40,0,0,20480,40,9975039217
5532,2253148162,1437939,2254586101,33,0,0,19456,33,7622772449
5533,2253165667,291509,2253457176,29,0,0,5120,29,4985479072
5534,2253166351,461217,2253627568,1,0,0,18944,1,613108432
5535,2253187826,433955,2253621781,39,0,0,9728,39,6903278530
5536,2253198226,444914,2253643140,42,0,0,9728,42,3471470715
5537,2253212271,813316,2254025587,40,0,0,28672,40,12019064
5538,2253214811,1032409,2254247220,26,0,0,8192,26,4602882658
5539,2253219896,267170,2253487066,37,0,0,7168,37,7196681548
5540,2253229478,689798,2253919276,21,0,0,66048,21,3853989529
5541,2253255426,1306805,2254562231,12,0,1,7680,12,9236345796
5542,2253265415,334517,2253599932,45,0,0,46592,45,2473136184
5543,2253270664,448314,2253718978,17,0,0,7680,17,7348482834
5544,2253273628,625509,2253899137,34,0,0,28160,34,3618926886
5545,2253287393,1298723,2254586116,41,0,1,18944,41,6311150995
5546,2253340551,1245580,2254586131,2,0,1,8704,2,8082338801
5547,2253350516,1235630,2254586146,14,0,1,2048,14,7484284355
5548,2253361968,1369724,2254731692,6,0,0,11264,6,10354123250
5549,2253380762,707238,2254088000,39,0,0,8192,39,9607867728
5550,2253383289,378627,2253761916,4,0,0,4096,4,2982676324
5551,2253386237,1454193,2254840430,25,0,0,99840,25,7673209699
5552,2253391226,1203950,2254595176,31,0,1,6144,31,4251005127
5553,2253411591,195003,2253606594,48,0,0,10240,48,6714921280
5554,2253412047,760253,2254172300,7,0,0,26112,7,2687098510
5555,2253427959,1204187,2254632146,43,0,1,9216,43,203388684
5556,2253430714,1201447,2254632161,15,0,1,1024,15,7387546498
5557,2253435122,488865,2253923987,7,0,0,9216,7,3943173086
5558,2253435341,280457,2253715798,39,0,0,17408,39,4316361986
5559,2253435545,165962,2253601507,18,0,0,5120,18,1869317122
5560,2253439925,496309,2253936234,47,0,0,25600,47,4403549546
5561,2253443542,550838,2253994380,8,0,0,3584,8,9416100718
5562,2253452063,1190989,2254643052,43,0,1,19456,43,4839718908
5563,2253457921,1185797,2254643718,34,0,1,1024,34,7507884362
5564,2253472830,757064,2254229894,0,0,0,17408,0,1127014752
5565,2253497767,286073,2253783840,22,0,0,7680,22,7494364760
5566,2253501448,684477,2254185925,28,0,0,10240,28,2068665777
5567,2253507728,1146386,2254654114,29,0,1,10240,29,615659221
5568,2253520824,830828,2254351652,13,0,0,32768,13,3823914588
5569,2253528080,1104723,2254632803,30,0,0,2048,30,7664087320
5570,2253529594,273797,2253803391,34,0,0,512,34,7347507849
5571,2253542075,484657,2254026732,45,0,0,3584,45,10294412271
5572,2253547186,1588784,2255135970,5,0,0,54784,5,2547359126
5573,2253547944,1329572,2254877516,39,0,0,8704,39,3918862805
5574,2253554107,263919,2253818026,17,0,0,5120,17,5263147445
5575,2253557084,1107641,2254664725,43,0,1,2560,43,6503894339
5576,2253574523,215734,2253790257,24,0,0,12800,24,1553086214
5577,2253592961,1432614,2255025575,39,0,0,23040,39,2338049386
5578,2253610458,330174,2253940632,5,0,0,2048,5,1807158018
5579,2253611502,906852,2254518354,21,0,0,8704,21,7650216804
5580,2253630741,585788,2254216529,41,0,0,15360,41,6415774805
5581,2253639773,760701,2254400474,12,0,0,20480,12,9978560871
5582,2253655136,430353,2254085489,1,0,0,24064,1,7166060097
5583,2253664055,1105035,2254769090,5,0,0,4096,5,9430299620
5584,2253682037,519915,2254201952,47,0,0,2048,47,9073288365
5585,2253689151,805899,2254495050,10,0,0,17920,10,3186484318
5586,2253703784,1151425,2254855209,21,0,1,76288,21,1671515782
5587,2253724258,458532,2254182790,21,0,0,31744,21,6282387013
5588,2253754054,490655,2254244709,1,0,0,47616,1,4495028161
5589,2253770762,1140628,2254911390,12,0,1,12288,12,4058709829
5590,2253772917,653284,2254426201,7,0,0,37376,7,549021987
5591,2253776573,1182997,2254959570,10,0,1,8704,10,5322758175
5592,2253777150,803008,2254580158,33,0,0,35328,33,1294002574
5593,2253783555,288262,2254071817,40,0,0,1024,40,7100808672
5594,2253799256,631016,2254430272,39,0,0,13312,39,2279846706
5595,2253800115,486745,2254286860,5,0,0,30720,5,4833427631
5596,2253804104,274038,2254078142,11,0,0,512,11,2826501504
5597,2253810594,227879,2254038473,22,0,0,25600,22,394853028
5598,2253816396,557438,2254373834,40,0,0,10240,40,913841499
5599,2253816965,1156979,2254973944,43,0,1,14848,43,9169700674
5600,2253819514,1261514,2255081028,35,0,0,6656,35,8355596400
5601,2253822870,1048106,2254870976,22,0,0,22528,22,3805958344
5602,2253841907,331188,2254173095,30,0,0,2560,30,4525331420
5603,2253855070,1200398,2255055468,18,0,0,27136,18,3748798216
5604,2253863503,903981,2254767484,27,0,0,89088,27,7097350200
5605,2253877119,966914,2254844033,40,0,0,11776,40,103977460
5606,2253907614,1405888,2255313502,27,0,0,18432,27,5515657216
5607,2253911725,742374,2254654099,3,0,0,32768,3,9462112
5608,2253939402,376574,2254315976,4,0,0,19456,4,6209539718
5609,2253974338,225691,2254200029,49,0,0,1536,49,6074962516
5610,2253986095,988195,2254974290,0,0,1,512,0,5574305603
5611,2253995078,282391,2254277469,5,0,0,24064,5,8629355239
5612,2254000388,203459,2254203847,43,0,0,1536,43,5929046828
5613,2254020582,366968,2254387550,39,0,0,5120,39,8086775721
5614,2254027967,1584084,2255612051,22,0,0,17408,22,6641172420
5615,2254067489,707388,2254774877,11,0,0,18944,11,6848537756
5616,2254075015,910517,2254985532,20,0,1,13824,20,2385284741
5617,2254081507,390758,2254472265,19,0,0,55808,19,3785066292
5618,2254081906,926729,2255008635,33,0,0,43520,33,2317520121
5619,2254099633,210400,2254310033,7,0,0,512,7,5167383959
5620,2254103103,785209,2254888312,32,0,0,29696,32,5633654606
5621,2254105798,746393,2254852191,43,0,0,19456,43,4715133767
5622,2254129004,351107,2254480111,44,0,0,10752,44,7566136500
5623,2254137316,590519,2254727835,46,0,0,5120,46,6094150244
5624,2254145830,952105,2255097935,0,0,0,5632,0,1084870034
5625,2254151138,859712,2255010850,34,0,0,7168,34,795104648
5626,2254166403,912582,2255078985,8,0,0,36352,8,6816926413
5627,2254175901,1728566,2255904467,9,0,0,35840,9,4387433194
5628,2254192603,1103538,2255296141,29,0,0,49152,29,3125805717
5629,2254195863,790335,2254986198,41,0,1,1024,41,102333657
5630,2254217898,1181012,2255398910,48,0,0,47104,48,1850800431
5631,2254229225,244155,2254473380,34,0,0,3584,34,1315587233
5632,2254243293,1823084,2256066377,8,0,0,23040,8,7140068306
5633,2254250325,223234,2254473559,9,0,0,512,9,9227572803
5634,2254252895,913909,2255166804,0,0,0,36864,0,2512034928
5635,2254253374,1875409,2256128783,40,0,0,25088,40,1656039
5636,2254255183,736302,2254991485,20,0,1,16896,20,8878880908
5637,2254270790,1010360,2255281150,41,0,0,81408,41,729380749
5638,2254273180,1111363,2255384543,42,0,0,61440,42,10661694511
5639,2254273573,918147,2255191720,47,0,0,81408,47,4686672200
5640,2254275969,921405,2255197374,44,0,0,12288,44,8875484254
5641,2254278398,802801,2255081199,12,0,0,512,12,773094732
5642,2254291227,734363,2255025590,4,0,1,2560,4,1915206169
5643,2254320340,525892,2254846232,16,0,0,7168,16,3609532737
5644,2254336901,1485714,2255822615,44,0,0,15872,44,8574805373
5645,2254395153,686061,2255081214,20,0,1,19456,20,4331451538
5646,2254404418,714845,2255119263,6,0,0,5632,6,5907331856
5647,2254417333,663912,2255081245,41,0,1,7680,41,8560419144
5648,2254418816,389428,2254808244,21,0,0,14848,21,2766729471
5649,2254419610,194728,2254614338,34,0,0,2560,34,5214370352
5650,2254442700,1498283,2255940983,1,0,0,27136,1,6198770806
5651,2254443027,324800,2254767827,15,0,0,1024,15,3880007722
5652,2254461394,874690,2255336084,37,0,0,6144,37,4192466949
5653,2254464620,229686,2254694306,16,0,0,5632,16,1688416757
5654,2254479104,1199715,2255678819,11,0,0,59904,11,1792900987
5655,2254485020,1064716,2255549736,19,0,0,31744,19,4576968575
5656,2254487296,1351423,2255838719,12,0,0,3584,12,1333561737
5657,2254495852,811848,2255307700,27,0,0,37888,27,184732746
5658,2254496516,722176,2255218692,20,0,0,37888,20,3543997962
5659,2254513846,1043869,2255557715,5,0,0,26112,5,7286551115
5660,2254515474,565786,2255081260,4,0,1,3072,4,4414638616
5661,2254517023,902096,2255419119,29,0,0,38912,29,4331757355
5662,2254517103,1695506,2256212609,20,0,0,41984,20,5987269291
5663,2254531753,550319,2255082072,0,0,1,3072,0,1568701017
5664,2254545212,541046,2255086258,13,0,1,6656,13,5633680786
5665,2254564052,924555,2255488607,16,0,0,43008,16,7266758313
5666,2254566429,480756,2255047185,32,0,0,3072,32,2219415869
5667,2254582134,1795895,2256378029,2,0,0,58368,2,7007166433
5668,2254589938,613535,2255203473,40,0,0,19968,40,4872041389
5669,2254592682,614451,2255207133,22,0,0,1024,22,8232216736
5670,2254599137,489067,2255088204,48,0,1,3072,48,2805387528
5671,2254608332,246846,2254855178,40,0,0,9728,40,4646275157
5672,2254632479,327076,2254959555,19,0,0,28672,19,4927672227
5673,2254637861,273514,2254911375,14,0,0,6656,14,8935177393
5674,2254649363,459448,2255108811,11,0,0,6144,11,9007042618
5675,2254651284,755964,2255407248,43,0,0,1024,43,9157333515
5676,2254653591,1097114,2255750705,3,0,0,22016,3,3764597293
5677,2254654183,885866,2255540049,34,0,0,41984,34,9669159393
5678,2254661507,357017,2255018524,17,0,0,13824,17,7995160768
5679,2254683753,1019528,2255703281,6,0,0,8192,6,6950825703
5680,2254685508,465791,2255151299,20,0,0,19456,20,3264769914
5681,2254709856,304441,2255014297,8,0,0,11264,8,619041448
5682,2254714031,479584,2255193615,5,0,0,6144,5,4097615844
5683,2254728964,2033609,2256762573,36,0,0,5120,36,6482318319
5684,2254735144,354366,2255089510,14,0,1,2048,14,4288212700
5685,2254737537,353919,2255091456,29,0,1,3072,29,9651488743
5686,2254747601,346441,2255094042,48,0,1,4096,48,7045133517
5687,2254751204,846751,2255597955,5,0,0,34304,5,1468091845
5688,2254764612,476055,2255240667,23,0,0,4096,23,2793032613
5689,2254766594,970743,2255737337,21,0,0,18944,21,8908552037
5690,2254774322,361663,2255135985,41,0,1,14336,41,355707125
5691,2254776494,2052373,2256828867,7,0,0,10752,7,3358501334
5692,2254776711,378846,2255155557,37,0,0,8192,37,3970454436
5693,2254779602,358222,2255137824,3,0,1,4096,3,8636041456
5694,2254789542,1230671,2256020213,30,0,0,37888,30,3806000331
5695,2254793957,129284,2254923241,46,0,0,3072,46,9177559584
5696,2254803307,348802,2255152109,5,0,0,2560,5,131565623
5697,2254827392,579505,2255406897,16,0,0,26112,16,3053364522
5698,2254827663,605655,2255433318,19,0,0,26112,19,10400953232
5699,2254839681,510387,2255350068,12,0,0,1024,12,5433209037
5700,2254841444,1235712,2256077156,25,0,0,35328,25,3978647196
5701,2254846362,291718,2255138080,41,0,1,9216,41,1274756998
5702,2254853856,1010651,2255864507,2,0,0,22016,2,3181544652
5703,2254855394,374832,2255230226,30,0,0,7680,30,649034013
5704,2254875358,1351765,2256227123,30,0,0,17920,30,1631268863
5705,2254908329,1408776,2256317105,6,0,0,4608,6,8597326828
5706,2254917064,713869,2255630933,44,0,0,9728,44,7466136922
5707,2254921101,501169,2255422270,5,0,0,10240,5,4796378495
5708,2254924054,383817,2255307871,11,0,0,512,11,4157570733
5709,2254936379,951467,2255887846,34,0,0,32768,34,4026809725
5710,2254961334,2039517,2257000851,8,0,0,18432,8,3016123863
5711,2254979842,1071895,2256051737,29,0,0,34816,29,10126372402
5712,2254982792,908353,2255891145,21,0,0,10752,21,150033714
5713,2254994314,499252,2255493566,46,0,0,8192,46,10528993188
5714,2254998580,152734,2255151314,41,0,1,11776,41,10227472950
5715,2255001491,249599,2255251090,46,0,1,3072,46,1665877435
5716,2255014908,237360,2255252268,8,0,1,13824,8,4511898557
5717,2255015294,301110,2255316404,16,0,0,2048,16,5346147076
5718,2255017816,766955,2255784771,18,0,0,52224,18,2621368039
5719,2255019405,701652,2255721057,15,0,0,8704,15,3729719825
5720,2255020717,310475,2255331192,41,0,1,2560,41,853998026
5721,2255049745,882955,2255932700,24,0,0,11264,24,9461536583
5722,2255052828,907429,2255960257,0,0,0,7168,0,2833076353
5723,2255060464,405723,2255466187,48,0,0,26624,48,7270020628
5724,2255073258,508977,2255582235,20,0,0,23040,20,8469485837
5725,2255077266,1172495,2256249761,5,0,0,27136,5,4573633296
5726,2255080196,409058,2255489254,0,0,0,2048,0,1966209291
5727,2255096616,781223,2255877839,17,0,0,35328,17,2282425169
5728,2255107817,450405,2255558222,47,0,0,1536,47,3600453888
5729,2255129129,1430138,2256559267,22,0,0,33792,22,2811372783
5730,2255140437,1338249,2256478686,20,0,0,27648,20,5330333159
5731,2255152174,665590,2255817764,35,0,0,30208,35,2973635896
5732,2255184666,1936614,2257121280,0,0,0,18944,0,2446669272
5733,2255236122,1151313,2256387435,30,0,1,318976,30,2235008051
5734,2255236846,692407,2255929253,18,0,0,51712,18,1548248691
5735,2255297046,1121882,2256418928,0,0,1,46080,0,9810686633
5736,2255310649,1168052,2256478701,6,0,1,9216,6,1998467591
5737,2255312286,872057,2256184343,11,0,0,45568,11,10562228002
5738,2255312444,774399,2256086843,10,0,0,31744,10,5363390537
5739,2255313833,1073579,2256387412,33,0,0,30720,33,2720150053
5740,2255318562,450266,2255768828,29,0,0,12800,29,6897876912
5741,2255325469,1153247,2256478716,48,0,1,3584,48,7543062387
5742,2255328551,1166644,2256495195,12,0,1,8704,12,475766404
5743,2255354607,95829,2255450436,33,0,0,512,33,1477542351
5744,2255357393,283396,2255640789,46,0,0,5120,46,10201564110
5745,2255361364,979337,2256340701,8,0,0,16384,8,5034971235
5746,2255376903,646445,2256023348,41,0,0,10240,41,557432872
5747,2255381623,476152,2255857775,14,0,0,5632,14,121747575
5748,2255389844,182661,2255572505,28,0,0,9728,28,9805458148
5749,2255398150,559852,2255958002,46,0,0,55808,46,7922319563
5750,2255400879,407666,2255808545,41,0,0,40448,41,8633182299
5751,2255404337,429837,2255834174,30,0,0,37888,30,2922989520
5752,2255413201,736901,2256150102,13,0,0,61440,13,4668798277
5753,2255435799,357548,2255793347,15,0,0,8704,15,5180913937
5754,2255449101,1291259,2256740360,33,0,0,60928,33,6465120931
5755,2255449634,763310,2256212944,13,0,0,1024,13,6151241278
5756,2255450224,1045317,2256495541,2,0,1,512,2,5675325270
5757,2255453486,381647,2255835133,29,0,0,3072,29,1782550745
5758,2255457859,2049494,2257507353,21,0,0,144384,21,10575551751
5759,2255461233,432275,2255893508,0,0,0,7680,0,8290254630
5760,2255476442,690322,2256166764,42,0,0,4096,42,5997707397
5761,2255491558,1004969,2256496527,11,0,1,1536,11,5796442788
5762,2255493424,958395,2256451819,40,0,0,13824,40,4644862037
5763,2255505295,759776,2256265071,40,0,0,11264,40,2751717894
5764,2255514603,588942,2256103545,10,0,0,31744,10,7613409494
5765,2255530723,812177,2256342900,26,0,0,7168,26,1012009344
5766,2255532623,663748,2256196371,26,0,0,1536,26,7195393829
5767,2255544176,874737,2256418913,3,0,0,31232,3,7008719316
5768,2255546552,740943,2256287495,24,0,0,19456,24,8155595489
5769,2255552577,842205,2256394782,42,0,0,24064,42,6240698521
5770,2255557694,941419,2256499113,10,0,1,4096,10,9543374334
5771,2255560645,1699142,2257259787,7,0,0,29184,7,6364191668
5772,2255566247,904000,2256470247,21,0,0,15360,21,2402628172
5773,2255574300,942805,2256517105,13,0,0,57856,13,6828729064
5774,2255577182,766981,2256344163,24,0,0,4096,24,8739807434
5775,2255587770,930153,2256517923,19,0,0,2048,19,2419844061
5776,2255592921,1118888,2256711809,12,0,0,116224,12,9161068961
5777,2255651319,325589,2255976908,49,0,0,5632,49,9569046200
5778,2255655297,1120658,2256775955,4,0,0,7168,4,710769630
5779,2255656539,981892,2256638431,24,0,0,46592,24,2015829908
5780,2255695448,822498,2256517946,2,0,1,1536,2,5826047232
5781,2255698576,1975835,2257674411,3,0,0,39936,3,6408596470
5782,2255705732,1840374,2257546106,47,0,0,3072,47,4568306410
5783,2255708005,1204514,2256912519,33,0,0,63488,33,10718020553
5784,2255720844,798224,2256519068,29,0,1,22016,29,8824704139
5785,2255728689,835117,2256563806,45,0,0,14848,45,1846845766
5786,2255754456,1208922,2256963378,35,0,0,23552,35,3351344375
5787,2255760247,991048,2256751295,36,0,0,35840,36,2818694814
5788,2255761447,817685,2256579132,22,0,1,2048,22,8604705124
5789,2255765202,1048977,2256814179,1,0,0,23040,1,3053931756
5790,2255767359,993639,2256760998,7,0,0,31744,7,4932142620
5791,2255791902,808324,2256600226,24,0,1,27136,24,1076549095
5792,2255811896,909885,2256721781,12,0,0,20480,12,9075371518
5793,2255818170,795695,2256613865,46,0,1,15360,46,3525834213
5794,2255841278,494416,2256335694,33,0,0,39424,33,776822642
5795,2255851825,765266,2256617091,11,0,1,5120,11,2641694051
5796,2255868382,847045,2256715427,49,0,1,1536,49,3061446025
5797,2255871271,1968344,2257839615,10,0,0,62464,10,10526043547
5798,2255880846,1334811,2257215657,32,0,0,9216,32,7014543734
5799,2255884784,830658,2256715442,41,0,1,4608,41,959506776
5800,2255889751,306137,2256195888,38,0,0,24064,38,1758530193
5801,2255930443,1185050,2257115493,0,0,0,16384,0,7847333967
5802,2255931563,783894,2256715457,13,0,1,512,13,3624019819
5803,2255934254,1114165,2257048419,35,0,0,8192,35,158428914
5804,2255936940,1051305,2256988245,26,0,0,40960,26,6116043084
5805,2255937620,292326,2256229946,4,0,0,9216,4,10140580766
5806,2255941257,1987719,2257928976,16,0,0,57344,16,5338580677
5807,2255943925,879333,2256823258,20,0,0,29696,20,3839184697
5808,2255957676,630322,2256587998,9,0,0,26624,9,7575073164
5809,2255961487,994700,2256956187,20,0,0,14336,20,9278329110
5810,2255986126,1812666,2257798792,4,0,0,71168,4,3618051256
5811,2256007405,1309790,2257317195,18,0,0,12800,18,3467196259
5812,2256032993,916966,2256949959,32,0,0,29184,32,8875151355
5813,2256033952,1962359,2257996311,14,0,0,19968,14,2739833318
5814,2256051074,664398,2256715472,14,0,1,1536,14,2614933007
5815,2256076014,800739,2256876753,32,0,0,16896,32,6941069554
5816,2256080373,635122,2256715495,36,0,1,2048,36,5584375174
5817,2256089783,479983,2256569766,47,0,0,6656,47,7127648161
5818,2256094588,620930,2256715518,15,0,1,4608,15,9866030397
5819,2256094614,620798,2256715412,37,0,0,11776,37,10163527093
5820,2256118819,2040072,2258158891,43,0,0,9216,43,7912656863
5821,2256122618,647310,2256769928,45,0,0,24064,45,9167936169
5822,2256125442,414841,2256540283,26,0,0,22528,26,9964040964
5823,2256125768,1274148,2257399916,35,0,0,23552,35,4653944012
5824,2256136709,263252,2256399961,19,0,0,1024,19,2610594161
5825,2256145553,398674,2256544227,1,0,0,3072,1,9013112099
5826,2256147367,1086177,2257233544,24,0,0,5632,24,2586980917
5827,2256179198,339855,2256519053,26,0,0,3584,26,10219015205
5828,2256185738,1117520,2257303258,26,0,0,26624,26,4092137252
5829,2256186267,331017,2256517284,32,0,0,512,32,8871630318
5830,2256198472,1194237,2257392709,33,0,0,55296,33,9378365784
5831,2256208867,1254471,2257463338,6,0,0,19968,6,810491484
5832,2256218949,867744,2257086693,11,0,0,73216,11,2036273782
5833,2256236562,537163,2256773725,2,0,1,10752,2,9241477051
5834,2256236968,792491,2257029459,1,0,0,17920,1,9924162597
5835,2256238051,535689,2256773740,25,0,1,1024,25,653381884
5836,2256239475,1292492,2257531967,14,0,0,7168,14,5464975596
5837,2256241085,587797,2256828882,41,0,1,53248,41,3419416909
5838,2256253018,993509,2257246527,27,0,0,4608,27,6394500276
5839,2256255942,277446,2256533388,13,0,0,19456,13,4639404436
5840,2256287551,1926226,2258213777,21,0,0,2560,21,7438595040
5841,2256302341,1220345,2257522686,41,0,0,4608,41,231089467
5842,2256303985,1651118,2257955103,15,0,0,10752,15,8606973907
5843,2256311211,1317972,2257629183,21,0,0,44544,21,7168773589
5844,2256348324,1428753,2257777077,30,0,0,56832,30,524787368
5845,2256348873,1512084,2257860957,45,0,0,20480,45,855824375
5846,2256359532,1049603,2257409135,2,0,0,30208,2,2213347956
5847,2256360568,490457,2256851025,25,0,0,13824,25,4395698855
5848,2256376511,1977200,2258353711,11,0,0,50688,11,6572877753
5849,2256421886,498550,2256920436,19,0,0,16896,19,532797619
5850,2256426152,418386,2256844538,33,0,0,5632,33,4679605400
5851,2256426961,169381,2256596342,44,0,0,1536,44,6315704155
5852,2256444896,518497,2256963393,8,0,1,2560,8,1772032559
5853,2256452767,320935,2256773702,21,0,0,5632,21,1274357671
5854,2256455269,1757705,2258212974,9,0,0,14848,9,2968446184
5855,2256500889,462519,2256963408,36,0,1,10240,36,1523807514
5856,2256504087,1127295,2257631382,49,0,0,7168,49,9045466542
5857,2256517741,470519,2256988260,14,0,1,10752,14,9925214507
5858,2256523593,681270,2257204863,37,0,0,31744,37,471519732
5859,2256527915,1582402,2258110317,28,0,0,19968,28,1447675875
5860,2256531281,1013874,2257545155,37,0,0,13824,37,666502486
5861,2256534587,1983220,2258517807,39,0,0,28160,39,1446602975
5862,2256542328,475557,2257017885,21,0,0,8704,21,4782289559
5863,2256565249,1183953,2257749202,11,0,0,26112,11,497332848
5864,2256572447,378619,2256951066,24,0,0,3584,24,2267986843
5865,2256574927,197044,2256771971,47,0,0,6656,47,9130203715
5866,2256594831,780828,2257375659,27,0,0,33280,27,4974843414
5867,2256595242,393033,2256988275,11,0,1,1536,11,34993507
5868,2256600252,2104929,2258705181,9,0,0,16896,9,6011396065
5869,2256604744,2273979,2258878723,27,0,0,6656,27,2045474300
5870,2256606596,1423089,2258029685,24,0,0,59904,24,8296453740
5871,2256624161,905607,2257529768,32,0,0,15360,32,5263761062
5872,2256626848,610656,2257237504,24,0,0,6656,24,8969916467
5873,2256662643,845505,2257508148,11,0,0,2560,11,6228929290
5874,2256673469,247146,2256920615,42,0,0,512,42,9749412334
5875,2256684375,140958,2256825333,33,0,0,2560,33,6889894948
5876,2256687231,301067,2256988298,2,0,1,4608,2,8700922647
5877,2256687992,543541,2257231533,21,0,0,12288,21,9514139113
5878,2256699048,963172,2257662220,48,0,0,60416,48,10529513739
5879,2256711352,1331646,2258042998,16,0,0,7168,16,7970698720
5880,2256744372,669169,2257413541,48,0,0,12288,48,8198193332
5881,2256750098,827161,2257577259,10,0,0,2048,10,2042084610
5882,2256750130,563142,2257313272,4,0,0,16896,4,4405158879
5883,2256789873,920386,2257710259,21,0,0,9728,21,4768456619
5884,2256790729,1365331,2258156060,12,0,0,78848,12,6076667174
5885,2256799579,2234207,2259033786,36,0,0,92160,36,3861287387
5886,2256799808,740286,2257540094,28,0,0,26624,28,8908701798
5887,2256809648,403186,2257212834,10,0,0,26112,10,5829703020
5888,2256812735,1004702,2257817437,13,0,0,27648,13,5876704171
5889,2256823537,484572,2257308109,24,0,0,15872,24,5957723100
5890,2256825340,162973,2256988313,4,0,1,25088,4,1291235752
5891,2256825410,1243116,2258068526,5,0,0,56832,5,10448765575
5892,2256851685,791005,2257642690,40,0,0,26624,40,2656865631
5893,2256855925,231111,2257087036,35,0,0,1024,35,9635664758
5894,2256861847,659420,2257521267,27,0,0,43008,27,3318327176
5895,2256867021,125601,2256992622,11,0,1,4608,11,9258994460
5896,2256877600,211479,2257089079,14,0,0,6656,14,1256586183
5897,2256883696,872541,2257756237,46,0,0,23040,46,7385823307
5898,2256889983,1588188,2258478171,20,0,0,59392,20,3315386523
5899,2256895094,1397904,2258292998,33,0,0,102400,33,4974789817
5900,2256896916,437253,2257334169,1,0,0,4096,1,7619746054
5901,2256916209,519975,2257436184,47,0,0,29184,47,8817993162
5902,2256921879,603178,2257525057,4,0,0,7680,4,4566268894
5903,2256940988,468794,2257409782,16,0,0,2048,16,3054796082
5904,2256948338,478022,2257426360,24,0,0,1024,24,3452792916
5905,2256982114,558798,2257540912,42,0,0,1024,42,7998005280
5906,2257000369,643428,2257643797,17,0,0,3584,17,3956332158
5907,2257006997,352018,2257359015,10,0,0,14336,10,1200466787
5908,2257011187,1233069,2258244256,28,0,0,22016,28,10210341903
5909,2257013599,789756,2257803355,33,0,0,14848,33,1955913527
5910,2257020962,1187465,2258208427,4,0,0,12800,4,825635239
5911,2257033159,3645,2257036804,4,0,1,10240,4,7549149564
5912,2257043608,2334596,2259378204,33,0,0,94208,33,4541214325
5913,2257044358,1362044,2258406402,12,0,0,22016,12,2710174695
5914,2257071980,514847,2257586827,32,0,0,2048,32,5999475721
5915,2257078154,2177854,2259256008,32,0,0,10752,32,6887241676
5916,2257082256,14521,2257096777,41,0,1,8192,41,3009134929
5917,2257089353,1576329,2258665682,13,0,0,29696,13,387043295
5918,2257097526,842549,2257940075,48,0,0,36352,48,7241045025
5919,2257132725,545485,2257678210,23,0,0,12288,23,7044069682
5920,2257143552,1256127,2258399679,25,0,0,42496,25,1961603851
5921,2257145624,423643,2257569267,26,0,0,9216,26,3723553509
5922,2257148214,1089311,2258237525,39,0,0,49152,39,2514451211
5923,2257158016,1221289,2258379305,35,0,0,3072,35,9377580656
5924,2257159686,412542,2257572228,7,0,0,4608,7,2011899327
5925,2257166778,373807,2257540585,14,0,0,1536,14,9991574924
5926,2257178776,197062,2257375838,16,0,0,512,16,6537327503
5927,2257180349,1019312,2258199661,4,0,0,27648,4,9408570193
5928,2257190109,1306797,2258496906,18,0,0,61440,18,3916030729
5929,2257194478,403373,2257597851,38,0,0,4096,38,2159000339
5930,2257207025,886643,2258093668,16,0,0,28160,16,1960106279
5931,2257214642,729192,2257943834,15,0,0,12288,15,8546453574
5932,2257219274,2480219,2259699493,10,0,0,44032,10,9685149892
5933,2257221557,1139813,2258361370,34,0,0,25088,34,8714503763
5934,2257229563,378485,2257608048,27,0,0,11264,27,6531604671
5935,2257269105,922117,2258191222,33,0,0,24576,33,2647535149
5936,2257272135,2207279,2259479414,27,0,0,24576,27,6364041188
5937,2257272990,767801,2258040791,11,0,0,29696,11,8848533763
5938,2257280848,1043894,2258324742,29,0,0,56320,29,2704304738
5939,2257287227,1575702,2258862929,46,0,0,35328,46,822639578
5940,2257308362,936689,2258245051,1,0,0,2560,1,5005740557
5941,2257320137,1018107,2258338244,30,0,0,29696,30,1595338782
5942,2257329580,2425743,2259755323,4,0,0,19456,4,2666880445
5943,2257330013,581461,2257911474,44,0,0,35840,44,755746697
5944,2257363306,1228532,2258591838,49,0,0,18944,49,863993582
5945,2257365785,2426852,2259792637,36,0,0,9728,36,7653030869
5946,2257372527,935040,2258307567,34,0,0,15360,34,7649475641
5947,2257378348,429943,2257808291,25,0,0,2560,25,1852638290
5948,2257380613,205575,2257586188,33,0,0,12288,33,8394982172
5949,2257395944,19550,2257415494,34,0,1,2048,34,10532524472
5950,2257412937,327783,2257740720,34,0,0,20992,34,4995031472
5951,2257424927,1526315,2258951242,29,0,0,37376,29,70474726
5952,2257429460,602268,2258031728,28,0,0,6656,28,4290634319
5953,2257440809,634726,2258075535,3,0,0,4608,3,9074589185
5954,2257447827,813956,2258261783,2,0,0,19456,2,3669183804
5955,2257456291,389190,2257845481,7,0,0,13824,7,4901440681
5956,2257458331,968381,2258426712,19,0,0,59392,19,2199687786
5957,2257481067,526139,2258007206,45,0,0,16896,45,584039570
5958,2257485772,62805,2257548577,2,0,1,8192,2,9096108228
5959,2257501502,1075924,2258577426,28,0,0,36352,28,8896040558
5960,2257502383,1217748,2258720131,19,0,0,39936,19,4572856169
5961,2257516851,2356213,2259873064,45,0,0,2048,45,1767050490
5962,2257529928,1036407,2258566335,37,0,0,49664,37,1840837009
5963,2257541532,966652,2258508184,49,0,0,14336,49,5412914710
5964,2257547052,11016,2257558068,13,0,1,17920,13,5327964205
5965,2257551189,580832,2258132021,29,0,0,33280,29,3992772935
5966,2257567264,729501,2258296765,23,0,0,12288,23,4400313102
5967,2257588543,495034,2258083577,6,0,0,3584,6,9596798320
5968,2257614939,16458,2257631397,49,0,1,3072,49,1302116995
5969,2257626561,6864,2257633425,20,0,1,2048,20,6073658456
5970,2257629918,672954,2258302872,14,0,0,19968,14,8220781928
5971,2257630142,346352,2257976494,29,0,0,7680,29,4655747625
5972,2257631729,776872,2258408601,12,0,0,7168,12,10092552784
5973,2257633337,737127,2258370464,0,0,0,21504,0,1196885148
5974,2257648318,50306,2257698624,24,0,1,43520,24,1525689245
5975,2257650810,431660,2258082470,31,0,0,16896,31,6687412652
5976,2257653756,1236869,2258890625,29,0,0,16384,29,6789247431
5977,2257660983,1137300,2258798283,21,0,0,15360,21,662368012
5978,2257661312,37658,2257698970,49,0,1,512,49,3052787913
5979,2257693707,6889,2257700596,14,0,1,2560,14,7149457005
5980,2257697083,1077272,2258774355,14,0,0,20992,14,623850180
5981,2257730611,487081,2258217692,9,0,0,12800,9,9640368782
5982,2257736477,1717573,2259454050,28,0,0,79872,28,7764630156
5983,2257739894,307106,2258047000,10,0,0,1024,10,7802562335
5984,2257765132,1381772,2259146904,23,0,0,48128,23,896478184
5985,2257768127,684091,2258452218,44,0,0,26112,44,6116183696
5986,2257776117,775071,2258551188,31,0,0,16384,31,6897217354
5987,2257776980,1175525,2258952505,37,0,0,4096,37,2448942080
5988,2257778718,725075,2258503793,10,0,0,22528,10,7566445127
5989,2257786404,2339956,2260126360,7,0,0,2048,7,3861017085
5990,2257788019,2295090,2260083109,9,0,0,15872,9,9868964082
5991,2257798248,858371,2258656619,15,0,0,27648,15,2482527029
5992,2257811082,1023379,2258834461,47,0,0,10752,47,2564162220
5993,2257832627,386328,2258218955,28,0,0,4096,28,9857628656
5994,2257871693,4162,2257875855,13,0,1,11264,13,7106682976
5995,2257896732,307780,2258204512,42,0,0,15872,42,10325169515
5996,2257899306,1655334,2259554640,1,0,0,35840,1,1222461361
5997,2257899640,11849,2257911489,12,0,1,5632,12,2559033962
5998,2257906974,43097,2257950071,9,0,1,6656,9,6990921483
5999,2257937720,1002119,2258939839,1,0,0,37888,1,9322646901
6000,2257943394,11724,2257955118,24,0,1,3584,24,9273943205
6001,2257959100,573733,2258532833,28,0,0,5632,28,9799989618
6002,2257962279,623772,2258586051,0,0,0,6656,0,9261465878
6003,2257976760,544962,2258521722,9,0,0,12800,9,431121514
6004,2258006488,357401,2258363889,16,0,0,8192,16,5798892527
6005,2258007025,1607796,2259614821,10,0,0,9216,10,2841553117
6006,2258028583,1056020,2259084603,43,0,0,14336,43,4146473210
6007,2258057421,1069778,2259127199,15,0,0,25088,15,2077638617
6008,2258064840,828468,2258893308,10,0,0,8704,10,3959885065
6009,2258081626,1558731,2259640357,19,0,0,11264,19,6980966136
6010,2258112209,4374,2258116583,24,0,1,4608,24,7752126219
6011,2258132729,743943,2258876672,48,0,0,45056,48,8563647049
6012,2258158330,456491,2258614821,6,0,0,9216,6,3624415002
6013,2258189564,1014731,2259204295,0,0,0,46592,0,3967772513
6014,2258193308,28734,2258222042,22,0,1,9216,22,5262407873
6015,2258218604,1653806,2259872410,39,0,0,7680,39,7023232764
6016,2258233354,1745667,2259979021,8,0,0,74752,8,9293972450
6017,2258254379,837181,2259091560,9,0,0,12800,9,5491946035
6018,2258275195,1127391,2259402586,40,0,0,17408,40,3274077123
6019,2258281693,569023,2258850716,4,0,0,53248,4,7623265290
6020,2258307943,875652,2259183595,24,0,0,120320,24,7581693041
6021,2258330557,972813,2259303370,8,0,0,43008,8,3947109344
6022,2258353319,169666,2258522985,7,0,0,4096,7,5493680063
6023,2258359441,1855500,2260214941,48,0,0,43008,48,8190530699
6024,2258368824,4102,2258372926,41,0,1,2560,41,5797231506
6025,2258382125,623558,2259005683,22,0,0,92672,22,6248405283
6026,2258416836,14735,2258431571,43,0,1,5120,43,1410334862
6027,2258418347,1329428,2259747775,17,0,0,14848,17,10377563120
6028,2258429043,1041581,2259470624,45,0,0,29184,45,672978694
6029,2258429126,456492,2258885618,11,0,0,22528,11,4579116015
6030,2258436045,5802,2258441847,12,0,1,6144,12,435732088
6031,2258468103,384047,2258852150,34,0,0,4608,34,7607822483
6032,2258501751,309322,2258811073,22,0,0,34816,22,530292880
6033,2258503807,1510176,2260013983,23,0,0,22016,23,763041774
6034,2258525924,6924,2258532848,15,0,1,6656,15,534253951
6035,2258527026,592514,2259119540,18,0,0,41984,18,4454188844
6036,2258535705,701327,2259237032,4,0,0,31232,4,3326344740
6037,2258564414,653715,2259218129,49,0,0,2560,49,6390903884
6038,2258601832,293207,2258895039,9,0,0,5632,9,10620077255
6039,2258607748,1262307,2259870055,15,0,0,35840,15,677224122
6040,2258610645,4199,2258614844,10,0,1,9728,10,1421874748
6041,2258610863,631020,2259241883,49,0,0,15872,49,8304051472
6042,2258626397,718585,2259344982,25,0,0,20480,25,2172257654
6043,2258633059,764200,2259397259,20,0,0,62464,20,8136056107
6044,2258640508,576818,2259217326,1,0,0,31232,1,7687826221
6045,2258641606,1007042,2259648648,21,0,0,27136,21,2261885953
6046,2258695795,792366,2259488161,1,0,0,4096,1,8810461304
6047,2258699838,780995,2259480833,30,0,0,4608,30,10574587552
6048,2258704629,1640937,2260345566,9,0,0,19968,9,6218731452
6049,2258704857,1072450,2259777307,22,0,0,40960,22,10143758605
6050,2258708046,519440,2259227486,49,0,0,27136,49,5583896182
6051,2258752022,662489,2259414511,8,0,0,28672,8,5789713238
6052,2258752694,434520,2259187214,18,0,0,11776,18,10446098817
6053,2258763491,575197,2259338688,2,0,0,58368,2,2124972863
6054,2258764295,283669,2259047964,20,0,0,10752,20,7298265324
6055,2258765071,696638,2259461709,3,0,0,25088,3,1906757276
6056,2258775152,832916,2259608068,44,0,0,58368,44,839590279
6057,2258783812,3387,2258787199,26,0,1,9728,26,8162055141
6058,2258789597,941458,2259731055,49,0,0,22016,49,9011623696
6059,2258794391,1600091,2260394482,33,0,0,14848,33,7939916791
6060,2258807579,434631,2259242210,33,0,0,1024,33,2413670261
6061,2258827599,23132,2258850731,41,0,1,14848,41,2793349144
6062,2258828773,271730,2259100503,17,0,0,4608,17,3111809791
6063,2258829903,1026322,2259856225,25,0,0,26624,25,5859454536
6064,2258841095,54710,2258895805,24,0,1,13312,24,7907579213
6065,2258844500,235720,2259080220,31,0,0,51200,31,883049292
6066,2258855153,1068512,2259923665,49,0,0,29184,49,4453588204
6067,2258859047,612856,2259471903,18,0,0,4096,18,846062973
6068,2258898972,353713,2259252685,8,0,0,34304,8,6677715610
6069,2258900446,730458,2259630904,39,0,0,8192,39,8579280571
6070,2258914252,754680,2259668932,36,0,0,18944,36,428329403
6071,2258947420,576882,2259524302,1,0,0,21504,1,6438184340
6072,2258973812,1518,2258975330,10,0,1,1536,10,4505155238
6073,2258986429,334428,2259320857,20,0,0,57344,20,3548827371
6074,2258990601,733723,2259724324,46,0,0,39424,46,3394287490
6075,2258993353,738505,2259731858,46,0,0,2560,46,10166086922
6076,2259007000,1124991,2260131991,38,0,0,18432,38,2192048435
6077,2259020454,591544,2259611998,43,0,0,3584,43,1726209699
6078,2259035672,665411,2259701083,49,0,0,5120,49,7869364071
6079,2259035761,1135050,2260170811,8,0,0,13824,8,9246896820
6080,2259051956,351901,2259403857,12,0,0,4096,12,284882765
6081,2259053250,728790,2259782040,11,0,0,10752,11,8834618216
6082,2259059924,566,2259060490,24,0,1,512,24,5858329818
6083,2259060878,1465937,2260526815,14,0,0,100352,14,6619326298
6084,2259071178,20397,2259091575,2,0,1,5120,2,7686888078
6085,2259076144,1089969,2260166113,8,0,0,13824,8,8374488811
6086,2259085869,414772,2259500641,0,0,0,19456,0,5936365954
6087,2259120630,821659,2259942289,15,0,0,33280,15,3470804230
6088,2259141455,926450,2260067905,17,0,0,16384,17,3354162410
6089,2259142236,383805,2259526041,41,0,0,5632,41,9489832489
6090,2259152406,497037,2259649443,24,0,0,2560,24,10015386512
6091,2259154581,49729,2259204310,15,0,1,12800,15,6632209143
6092,2259163552,960438,2260123990,14,0,0,4608,14,3428578555
6093,2259179967,377660,2259557627,45,0,0,9728,45,2889650209
6094,2259181932,303905,2259485837,16,0,0,8704,16,7469526592
6095,2259197890,207870,2259405760,46,0,0,6144,46,5702954343
6096,2259206474,572275,2259778749,2,0,0,4608,2,830264967
6097,2259211477,16024,2259227501,22,0,1,1536,22,3648876231
6098,2259231383,25965,2259257348,48,0,1,12288,48,7904252147
6099,2259237371,1476694,2260714065,32,0,0,19968,32,1373568224
6100,2259243090,1329410,2260572500,5,0,0,4608,5,9537052891
6101,2259245519,382874,2259628393,5,0,0,14848,5,7897979180
6102,2259250427,969095,2260219522,43,0,0,10752,43,7632568154
6103,2259251196,569844,2259821040,36,0,0,8704,36,10700049051
6104,2259260781,375349,2259636130,32,0,0,8192,32,349021115
6105,2259265447,630252,2259895699,33,0,0,7168,33,9553245681
6106,2259269190,1087467,2260356657,25,0,0,36352,25,6325919578
6107,2259276294,3422,2259279716,41,0,1,3584,41,1194551971
6108,2259285598,452271,2259737869,29,0,0,19456,29,1536062836
6109,2259285971,52748,2259338719,21,0,1,74240,21,6328387617
6110,2259297989,1176429,2260474418,44,0,0,50176,44,2660154711
6111,2259298548,46465,2259345013,4,0,1,11264,4,2527469234
6112,2259302933,214436,2259517369,3,0,0,9216,3,3108474474
6113,2259306738,1090932,2260397670,35,0,0,1024,35,6290942808
6114,2259311181,937912,2260249093,45,0,0,27648,45,10501440398
6115,2259330434,346157,2259676591,45,0,0,25088,45,4483314979
6116,2259336278,1100868,2260437146,12,0,0,11264,12,2693787534
6117,2259342592,475773,2259818365,2,0,0,26112,2,10205811747
6118,2259358049,531035,2259889084,25,0,0,13312,25,10235936424
6119,2259363342,51184,2259414526,2,0,1,3072,2,568705936
6120,2259391410,561978,2259953388,40,0,0,36352,40,1852876690
6121,2259396932,1021509,2260418441,10,0,0,68096,10,8869957203
6122,2259408646,491739,2259900385,48,0,0,10752,48,10639883319
6123,2259416130,729406,2260145536,46,0,0,3584,46,8633989273
6124,2259425126,1124800,2260549926,17,0,0,75776,17,4875788775
6125,2259429272,992000,2260421272,6,0,0,9216,6,10476708275
6126,2259439733,46119,2259485852,49,0,1,21504,49,7007024060
6127,2259451126,657039,2260108165,41,0,0,25600,41,8773153625
6128,2259453043,690368,2260143411,40,0,0,512,40,8662635529
6129,2259479264,818934,2260298198,9,0,0,5632,9,6125978252
6130,2259485496,1362836,2260848332,20,0,0,33280,20,9472871663
6131,2259492351,1215607,2260707958,37,0,0,64512,37,4318840360
6132,2259496938,543733,2260040671,41,0,0,22016,41,5788356543
6133,2259497776,310168,2259807944,20,0,0,512,20,4668724443
6134,2259507102,688465,2260195567,24,0,0,18944,24,10681056365
6135,2259512600,98291,2259610891,10,0,0,9216,10,2181517602
6136,2259517883,821576,2260339459,42,0,0,57344,42,2035803316
6137,2259523348,785108,2260308456,34,0,0,14336,34,1034537748
6138,2259532003,854485,2260386488,32,0,0,57344,32,5661883765
6139,2259536263,165927,2259702190,4,0,0,3584,4,4336289830
6140,2259548700,344785,2259893485,9,0,0,8704,9,7895248002
6141,2259550654,729868,2260280522,19,0,0,3072,19,6762861973
6142,2259568712,11016,2259579728,26,0,1,17920,26,8493048856
6143,2259568913,18666,2259587579,48,0,1,22528,48,10379858576
6144,2259569739,573501,2260143240,24,0,0,8704,24,10502482948
6145,2259584322,1015949,2260600271,42,0,0,29184,42,1836821637
6146,2259585267,3298,2259588565,46,0,1,1536,46,1219502023
6147,2259587252,446696,2260033948,41,0,0,12800,41,9075094099
6148,2259615558,1309013,2260924571,23,0,0,36864,23,7621520317
6149,2259615737,376598,2259992335,5,0,0,23552,5,4100016956
6150,2259638135,1081732,2260719867,29,0,0,16896,29,1636493486
6151,2259662056,1176121,2260838177,11,0,0,36352,11,9509062708
6152,2259681380,440536,2260121916,11,0,0,45056,11,2693376038
6153,2259682904,16604,2259699508,10,0,1,4096,10,6617036938
6154,2259683877,1773659,2261457536,22,0,0,20480,22,43367626
6155,2259706368,1200130,2260906498,47,0,0,3072,47,9698957410
6156,2259717984,261535,2259979519,9,0,0,1536,9,656625073
6157,2259724411,13473,2259737884,34,0,1,2560,34,9835651619
6158,2259728191,827100,2260555291,27,0,0,13824,27,8815580828
6159,2259731841,251603,2259983444,35,0,0,4608,35,10097492574
6160,2259734645,1092090,2260826735,21,0,0,93696,21,710805299
6161,2259743538,17312,2259760850,22,0,1,22016,22,10593314980
6162,2259753008,8188,2259761196,13,0,1,512,13,3609443260
6163,2259758727,700388,2260459115,33,0,0,512,33,10218328295
6164,2259763610,13720,2259777330,8,0,1,2048,8,7501628229
6165,2259764977,369073,2260134050,45,0,0,6656,45,9004597620
6166,2259772528,1075975,2260848503,30,0,0,512,30,6729015127
6167,2259780262,151864,2259932126,23,0,0,8704,23,2651820993
6168,2259789018,1009146,2260798164,29,0,0,95744,29,5595678798
6169,2259811860,1920560,2261732420,5,0,0,58368,5,5751646906
6170,2259835630,3422,2259839052,48,0,1,3584,48,3464388708
6171,2259849872,637129,2260487001,42,0,0,10752,42,1906664342
6172,2259856641,15784,2259872425,10,0,1,15872,10,6222635369
6173,2259878630,580314,2260458944,39,0,0,20992,39,2875757270
6174,2259885207,240514,2260125721,24,0,0,5632,24,1377909261
6175,2259887261,6239,2259893500,13,0,1,2048,13,4778121082
6176,2259913980,9700,2259923680,29,0,1,1536,29,6237363565
6177,2259924462,198093,2260122555,5,0,0,2048,5,2216778489
6178,2259931208,22211,2259953419,43,0,1,2048,43,9284891381
6179,2259937539,41497,2259979036,3,0,1,4096,3,9923098734
6180,2259937761,452174,2260389935,49,0,0,11264,49,7761563744
6181,2259949760,528121,2260477881,32,0,0,11264,32,6349616201
6182,2259965924,429977,2260395901,5,0,0,4608,5,10083256858
6183,2259968826,983879,2260952705,31,0,0,23040,31,3678385049
6184,2259979040,418303,2260397343,23,0,0,512,23,7522003470
6185,2260009460,1062555,2261072015,15,0,0,37376,15,7171805514
6186,2260016202,277366,2260293568,15,0,0,5632,15,8680140372
6187,2260022907,4374,2260027281,14,0,1,4608,14,608503126
6188,2260026307,370857,2260397164,37,0,0,4096,37,9740664400
6189,2260036289,732688,2260768977,22,0,0,14336,22,9539872594
6190,2260042253,266911,2260309164,42,0,0,1536,42,3519497474
6191,2260050745,223608,2260274353,38,0,0,9728,38,5404562846
6192,2260081714,552206,2260633920,10,0,0,4608,10,10098659452
6193,2260093120,1768475,2261861595,13,0,0,73216,13,381487293
6194,2260100436,352097,2260452533,19,0,0,28160,19,5475689733
6195,2260105185,445084,2260550269,20,0,0,1024,20,5697792263
6196,2260111746,824213,2260935959,16,0,0,8704,16,10700604142
6197,2260121686,781992,2260903678,45,0,0,24064,45,10371500089
6198,2260125401,425663,2260551064,0,0,0,2560,0,7218689093
6199,2260135651,628935,2260764586,10,0,0,110080,10,8017479966
6200,2260138412,7230,2260145642,24,0,1,7680,24,1519435081
6201,2260145593,425488,2260571081,13,0,0,6656,13,7872693507
6202,2260158171,7957,2260166128,4,0,1,5120,4,2502961662
6203,2260164955,465159,2260630114,7,0,0,17920,7,9149389083
6204,2260170808,5196,2260176004,4,0,1,13312,4,4075747864
6205,2260208033,13178,2260221211,0,0,1,6656,0,10581243810
6206,2260218152,7640,2260225792,29,0,1,6656,29,7808463664
6207,2260220039,9299,2260229338,20,0,1,5632,20,5728082398
6208,2260228473,5326,2260233799,29,0,1,5632,29,4712608923
6209,2260242086,765537,2261007623,23,0,0,38912,23,2539264337
6210,2260252457,10757,2260263214,0,0,1,17408,0,8537785485
6211,2260254695,971231,2261225926,19,0,0,512,19,490279594
6212,2260257771,8029,2260265800,14,0,1,4096,14,978646305
6213,2260264833,458481,2260723314,11,0,0,11264,11,5304303370
6214,2260266435,308732,2260575167,1,0,0,8704,1,3549604681
6215,2260268158,1518,2260269676,46,0,1,1536,46,10666364893
6216,2260271706,219366,2260491072,17,0,0,13312,17,3888337955
6217,2260312281,1994,2260314275,14,0,1,2048,14,10699452677
6218,2260317518,342099,2260659617,30,0,0,1536,30,652219229
6219,2260327646,36676,2260364322,33,0,1,8192,33,7681254519
6220,2260339669,515581,2260855250,44,0,0,22016,44,10725914114
6221,2260361186,1651935,2262013121,20,0,0,44032,20,9442514085
6222,2260374466,292987,2260667453,41,0,0,1536,41,1950624685
6223,2260381626,751252,2261132878,25,0,0,113664,25,5698234697
6224,2260388494,241791,2260630285,10,0,0,512,10,2363426256
6225,2260393179,478825,2260872004,2,0,0,54784,2,5508190437
6226,2260423404,4162,2260427566,10,0,1,11264,10,9803646437
6227,2260426449,400621,2260827070,9,0,0,1024,9,105763801
6228,2260449956,275253,2260725209,16,0,0,6144,16,6085202176
6229,2260449988,689020,2261139008,36,0,0,18432,36,649334895
6230,2260459567,21770,2260481337,34,0,1,3584,34,9931632104
6231,2260469442,591162,2261060604,17,0,0,31232,17,4478293496
6232,2260470209,244495,2260714704,27,0,0,2048,27,8242354533
6233,2260491733,532649,2261024382,42,0,0,44544,42,190865840
6234,2260491832,665278,2261157110,40,0,0,9728,40,1686424941
6235,2260493225,502503,2260995728,10,0,0,88576,10,4583766821
6236,2260503178,904862,2261408040,39,0,0,5632,39,10617330545
6237,2260518820,38499,2260557319,48,0,1,2048,48,3970551528
6238,2260519073,905070,2261424143,15,0,0,27136,15,7217845369
6239,2260526645,31020,2260557665,24,0,1,512,24,7022157115
6240,2260531298,792478,2261323776,13,0,0,12800,13,9367002789
6241,2260546604,881454,2261428058,49,0,0,12800,49,7173584263
6242,2260564984,998016,2261563000,45,0,0,8704,45,1677609605
6243,2260566756,658991,2261225747,41,0,0,82432,41,5107709359
6244,2260577584,741786,2261319370,43,0,0,37888,43,912312432
6245,2260580216,600086,2261180302,45,0,0,46592,45,7605542023
6246,2260581996,1532336,2262114332,1,0,0,22528,1,63808698
6247,2260587323,12963,2260600286,19,0,1,7680,19,3527780916
6248,2260642389,490972,2261133361,49,0,0,1536,49,9775691586
6249,2260653126,14342,2260667468,34,0,1,24064,34,8374145824
6250,2260678316,641545,2261319861,14,0,0,1536,14,5882994322
6251,2260678974,952686,2261631660,0,0,0,51712,0,2311057233
6252,2260683841,1465638,2262149479,20,0,0,43008,20,8095594634
6253,2260691145,334828,2261025973,2,0,0,5120,2,7567773942
6254,2260720863,9631,2260730494,41,0,1,5632,41,365914677
6255,2260725389,5451,2260730840,9,0,1,512,9,1938737743
6256,2260726519,809619,2261536138,27,0,0,31232,27,5297418601
6257,2260731109,1446385,2262177494,18,0,0,33280,18,10299492849
6258,2260769027,309644,2261078671,6,0,0,7168,6,10287819840
6259,2260774988,1064284,2261839272,4,0,0,25088,4,3001539155
6260,2260784209,71088,2260855297,29,0,1,1536,29,10395588387
6261,2260784857,123628,2260908485,24,0,0,1536,24,1618053684
6262,2260805680,580850,2261386530,21,0,0,11776,21,2759818632
6263,2260808375,554718,2261363093,14,0,0,512,14,10238553348
6264,2260835371,500144,2261335515,2,0,0,32768,2,1641657910
6265,2260836308,317823,2261154131,28,0,0,8704,28,1360765697
6266,2260837699,800060,2261637759,46,0,0,19968,46,6767973467
6267,2260841399,840619,2261682018,40,0,0,39424,40,9197112718
6268,2260861109,532924,2261394033,14,0,0,24576,14,9597160493
6269,2260862096,698237,2261560333,9,0,0,79360,9,6719709842
6270,2260863211,658438,2261521649,17,0,0,78848,17,4194857737
6271,2260863274,369531,2261232805,13,0,0,22528,13,9568524176
6272,2260864561,626614,2261491175,33,0,0,21504,33,674031324
6273,2260869027,597421,2261466448,18,0,0,15360,18,8691148111
6274,2260874782,829909,2261704691,38,0,0,57856,38,3669065059
6275,2260925469,5802,2260931271,48,0,1,6144,48,1795345108
6276,2260939833,420887,2261360720,47,0,0,1536,47,3365909706
6277,2260940221,12499,2260952720,12,0,1,7168,12,2806855442
6278,2260972240,1372984,2262345224,41,0,0,58368,41,2538979781
6279,2260975538,927473,2261903011,8,0,0,20480,8,3099811226
6280,2260977583,286831,2261264414,6,0,0,9216,6,8922779589
6281,2260984733,1287751,2262272484,12,0,0,117248,12,8210621910
6282,2260994784,756587,2261751371,24,0,0,6144,24,2189040916
6283,2261003319,1198192,2262201511,23,0,0,53248,23,7952555076
6284,2261012301,352752,2261365053,7,0,0,2560,7,9252319570
6285,2261018121,751964,2261770085,48,0,0,45056,48,2277051272
6286,2261035889,879030,2261914919,6,0,0,16384,6,1240727560
6287,2261048371,292012,2261340383,14,0,0,12800,14,6623609092
6288,2261055969,372268,2261428237,33,0,0,512,33,3358519496
6289,2261075223,1303750,2262378973,19,0,0,6656,19,3256799095
6290,2261084960,602088,2261687048,11,0,0,2048,11,1167225351
6291,2261108008,531014,2261639022,45,0,0,4096,45,216335244
6292,2261114605,1262325,2262376930,31,0,0,90112,31,8217289014
6293,2261127430,654247,2261781677,6,0,0,8704,6,292408863
6294,2261128341,798333,2261926674,47,0,0,18432,47,2733764192
6295,2261140474,820956,2261961430,9,0,0,26112,9,759205165
6296,2261141932,216364,2261358296,16,0,0,8704,16,9933816523
6297,2261142227,1355541,2262497768,36,0,0,47616,36,919021788
6298,2261144018,885833,2262029851,22,0,0,33792,22,9464751145
6299,2261170029,1457645,2262627674,15,0,0,64512,15,8537826434
6300,2261177090,876363,2262053453,19,0,0,67584,19,5933700490
6301,2261184232,815458,2261999690,37,0,0,86016,37,3718526723
6302,2261195698,895237,2262090935,43,0,0,32256,43,6789761786
6303,2261198285,1004333,2262202618,43,0,0,3584,43,5918486695
6304,2261203976,691829,2261895805,39,0,0,41472,39,2107844302
6305,2261225564,460845,2261686409,37,0,0,14336,37,945261401
6306,2261225966,1214145,2262440111,9,0,0,41472,9,1718235384
6307,2261244505,531851,2261776356,36,0,0,20480,36,9980732264
6308,2261289895,1444611,2262734506,14,0,0,18432,14,5169054421
6309,2261314477,568661,2261883138,43,0,0,70656,43,9662963437
6310,2261325285,10261,2261335546,21,0,1,6144,21,9392693468
6311,2261326446,882583,2262209029,43,0,0,20992,43,7338439401
6312,2261327756,313621,2261641377,8,0,0,7680,8,4358705609
6313,2261332293,320023,2261652316,43,0,0,3072,43,1621519924
6314,2261346788,459093,2261805881,0,0,0,27648,0,3286284245
6315,2261374239,1994,2261376233,10,0,1,2048,10,6591285190
6316,2261411988,720449,2262132437,31,0,0,50176,31,10491293360
6317,2261425397,548070,2261973467,25,0,0,29184,25,1349275470
6318,2261433506,387645,2261821151,35,0,0,1024,35,8700042513
6319,2261434194,1248744,2262682938,29,0,0,34304,29,3919581757
6320,2261435856,839295,2262275151,46,0,0,8704,46,7567007469
6321,2261444128,588710,2262032838,44,0,0,9728,44,9753143165
6322,2261462548,357077,2261819625,47,0,0,14848,47,6806139071
6323,2261475766,477693,2261953459,10,0,0,16896,10,6253418300
6324,2261482739,536793,2262019532,48,0,0,20992,48,9439377686
6325,2261492405,404351,2261896756,16,0,0,3072,16,918766332
6326,2261495969,297957,2261793926,25,0,0,32256,25,394068923
6327,2261503930,228817,2261732747,13,0,0,1024,13,4510539760
6328,2261515425,10678,2261526103,4,0,1,11776,4,7514211867
6329,2261520079,786082,2262306161,23,0,0,11264,23,996513422
6330,2261548985,687736,2262236721,16,0,0,42496,16,8659813822
6331,2261557925,578427,2262136352,23,0,0,12800,23,636200918
6332,2261577116,477156,2262054272,23,0,0,2560,23,4573367078
6333,2261587037,728210,2262315247,3,0,0,27136,3,2208114961
6334,2261590297,12049,2261602346,22,0,1,19968,22,843235456
6335,2261610885,831121,2262442006,23,0,0,6144,23,4072796305
6336,2261636931,689408,2262326339,16,0,0,7680,16,4636159165
6337,2261674538,396856,2262071394,4,0,0,17920,4,4987919722
6338,2261695364,1131727,2262827091,18,0,0,1536,18,4880217834
6339,2261698239,603508,2262301747,41,0,0,33280,41,2887040538
6340,2261709516,985142,2262694658,24,0,0,1536,24,9988316049
6341,2261734352,666778,2262401130,38,0,0,26624,38,2716483707
6342,2261742098,365355,2262107453,10,0,0,28672,10,1004871795
6343,2261751494,540098,2262291592,42,0,0,33792,42,3003133254
6344,2261752732,896827,2262649559,8,0,0,59904,8,8632374322
6345,2261758704,522577,2262281281,34,0,0,18944,34,4373087916
6346,2261762280,665172,2262427452,34,0,0,36864,34,7907493682
6347,2261764519,17181,2261781700,15,0,1,4096,15,7427239173
6348,2261774232,618771,2262393003,14,0,0,3584,14,1991386143
6349,2261779582,495904,2262275486,29,0,0,1024,29,8650018306
6350,2261800999,12580,2261813579,2,0,1,8192,2,8918912353
6351,2261821315,566611,2262387926,11,0,0,9728,11,10027619429
6352,2261855582,61246,2261916828,48,0,1,23552,48,942225575
6353,2261869902,694154,2262564056,38,0,0,1536,38,2361154821
6354,2261892886,1002746,2262895632,17,0,0,3072,17,10377475443
6355,2261894335,932233,2262826568,23,0,0,131584,23,6562738355
6356,2261904973,397733,2262302706,7,0,0,3072,7,2026415786
6357,2261907171,814469,2262721640,24,0,0,31232,24,8543650623
6358,2261918242,1117371,2263035613,27,0,0,42496,27,6307188497
6359,2261926184,5161,2261931345,19,0,1,12288,19,7506726366
6360,2261929259,455680,2262384939,45,0,0,17408,45,2649790161
6361,2261935862,413597,2262349459,24,0,0,13824,24,142744064
6362,2261937280,651443,2262588723,24,0,0,4608,24,8430631740
6363,2261984496,800234,2262784730,44,0,0,80896,44,10564238423
6364,2261998590,393267,2262391857,29,0,0,12800,29,676521226
6365,2262000218,56908,2262057126,8,0,1,8704,8,6844999448
6366,2262005081,312553,2262317634,4,0,0,7680,4,7945453869
6367,2262006478,397163,2262403641,23,0,0,8192,23,3145722285
6368,2262011481,644645,2262656126,46,0,0,21504,46,1128240133
6369,2262032146,374950,2262407096,28,0,0,11264,28,6342798806
6370,2262052579,509247,2262561826,49,0,0,21504,49,4052830263
6371,2262056235,323385,2262379620,9,0,0,2048,9,7398322487
6372,2262062299,244657,2262306956,44,0,0,2560,44,8464075702
6373,2262065006,351161,2262416167,6,0,0,29696,6,4402305568
6374,2262075904,646063,2262721967,40,0,0,1024,40,420922451
6375,2262112908,467977,2262580885,17,0,0,9216,17,2487004951
6376,2262121161,711281,2262832442,33,0,0,17408,33,6926325354
6377,2262148011,415562,2262563573,12,0,0,5632,12,8522940161
6378,2262156750,1103687,2263260437,11,0,0,28672,11,9327576103
6379,2262179805,982503,2263162308,45,0,0,59392,45,5855024680
6380,2262206255,381041,2262587296,21,0,0,20992,21,2356188069
6381,2262209951,659773,2262869724,13,0,0,13824,13,7249425744
6382,2262224300,523481,2262747781,17,0,0,43520,17,4573730900
6383,2262227956,431781,2262659737,5,0,0,11776,5,7579413844
6384,2262228048,273272,2262501320,35,0,0,1024,35,4181725002
6385,2262248259,69390,2262317649,2,0,1,7168,2,7789152655
6386,2262251008,380284,2262631292,11,0,0,7168,11,4039118626
6387,2262262867,463499,2262726366,21,0,0,14336,21,8605911222
6388,2262289877,27803,2262317680,21,0,1,1024,21,1989533123
6389,2262305353,16417,2262321770,10,0,1,11264,10,10293609472
6390,2262306733,16343,2262323076,43,0,1,2048,43,9941464459
6391,2262306829,248422,2262555251,41,0,0,33792,41,10340773532
6392,2262318835,270371,2262589206,19,0,0,1536,19,284907021
6393,2262329578,62310,2262391888,43,0,1,6656,43,2038189004
6394,2262364556,51626,2262416182,44,0,1,25088,44,4112897460
6395,2262364833,51372,2262416205,49,0,1,3072,49,9056298722
6396,2262365470,713046,2263078516,46,0,0,50176,46,8283076359
6397,2262372046,482251,2262854297,23,0,0,71680,23,2183142594
6398,2262392213,529193,2262921406,47,0,0,29696,47,6904655810
6399,2262401623,886791,2263288414,15,0,0,45056,15,7044513280
6400,2262406229,380232,2262786461,11,0,0,5632,11,6373317805
6401,2262410650,40177,2262450827,19,0,1,17408,19,4432241548
6402,2262431381,197712,2262629093,20,0,0,4608,20,6538456272
6403,2262435866,528498,2262964364,25,0,0,45568,25,8630201708
6404,2262449407,646978,2263096385,7,0,0,9216,7,9219522528
6405,2262450265,411887,2262862152,36,0,0,25600,36,1531054488
6406,2262472430,902833,2263375263,39,0,0,54784,39,5552806210
6407,2262473764,527618,2263001382,29,0,0,11264,29,1336699488
6408,2262474100,276459,2262750559,13,0,0,7680,13,3791746210
6409,2262475573,754781,2263230354,2,0,0,12288,2,6178983690
6410,2262496697,500164,2262996861,38,0,0,16384,38,2960667199
6411,2262507992,539320,2263047312,9,0,0,4608,9,6171232617
6412,2262508497,619682,2263128179,21,0,0,1536,21,321503067
6413,2262510354,534642,2263044996,44,0,0,30720,44,1994627423
6414,2262517549,651288,2263168837,0,0,0,5632,0,3882626132
6415,2262540785,2470,2262543255,8,0,1,2560,8,8009138565
6416,2262548087,17110,2262565197,15,0,1,9728,15,7244827294
6417,2262550899,471751,2263022650,7,0,0,52224,7,10200975828
6418,2262579825,306491,2262886316,49,0,0,29696,49,2480836325
6419,2262594225,859161,2263453386,7,0,0,19968,7,9805032453
6420,2262599734,626861,2263226595,13,0,0,84992,13,1828783031
6421,2262645990,360020,2263006010,18,0,0,9728,18,5950086816
6422,2262651105,465026,2263116131,36,0,0,45056,36,6445726718
6423,2262654224,668513,2263322737,30,0,0,5120,30,8448051062
6424,2262660192,833373,2263493565,15,0,0,53760,15,7164583477
6425,2262675131,442263,2263117394,45,0,0,4096,45,7993204967
6426,2262678713,568246,2263246959,10,0,0,15360,10,117778610
6427,2262685814,840864,2263526678,3,0,0,6144,3,7883894443
6428,2262717629,611292,2263328921,9,0,0,12288,9,1866303508
6429,2262719798,844513,2263564311,6,0,0,32768,6,3725069369
6430,2262731050,867466,2263598516,48,0,0,1024,48,5237761540
6431,2262731557,155086,2262886643,25,0,0,1024,25,599767761
6432,2262732915,394781,2263127696,35,0,0,9728,35,654348460
6433,2262754599,3645,2262758244,0,0,1,10240,0,9219320667
6434,2262766920,95255,2262862175,11,0,1,3072,11,5661542041
6435,2262767591,94607,2262862198,24,0,1,5120,24,8900954309
6436,2262771433,492147,2263263580,16,0,0,10240,16,3981006322
6437,2262779974,521728,2263301702,23,0,0,13312,23,7632378767
6438,2262781870,720461,2263502331,7,0,0,16384,7,8624650205
6439,2262811511,458948,2263270459,17,0,0,22528,17,8702422637
6440,2262820716,317552,2263138268,31,0,0,4096,31,4740533161
6441,2262821621,420627,2263242248,9,0,0,34816,9,6686329878
6442,2262823196,270334,2263093530,48,0,0,34816,48,4012023947
6443,2262824989,811407,2263636396,38,0,0,3072,38,7829157651
6444,2262829762,253137,2263082899,32,0,0,14336,32,7119373501
6445,2262834987,349375,2263184362,16,0,0,41472,16,8804594405
6446,2262847360,699828,2263547188,6,0,0,11264,6,9589864451
6447,2262857679,244709,2263102388,17,0,0,9728,17,54209229
6448,2262861935,412439,2263274374,0,0,0,12800,0,8364525993
6449,2262862934,10241,2262873175,11,0,1,16384,11,6494818142
6450,2262888779,460749,2263349528,31,0,0,17920,31,9870667960
6451,2262915505,595872,2263511377,9,0,0,27136,9,5483618660
6452,2262924525,1994,2262926519,2,0,1,2048,2,5472251858
6453,2262950822,216269,2263167091,37,0,0,4608,37,9011589935
6454,2263019312,212305,2263231617,38,0,0,4096,38,48273194
6455,2263029992,712099,2263742091,22,0,0,8192,22,2047658255
6456,2263039194,605499,2263644693,30,0,0,3072,30,5655829826
6457,2263039932,211746,2263251678,25,0,0,15360,25,2496079810
6458,2263072302,667262,2263739564,39,0,0,12800,39,2504859716
6459,2263076629,336866,2263413495,28,0,0,18944,28,4787744314
6460,2263078441,273130,2263351571,19,0,0,6656,19,5831571200
6461,2263081388,759485,2263840873,9,0,0,126464,9,2838839475
6462,2263086407,202365,2263288772,19,0,0,1024,19,7678191624
6463,2263091122,28721,2263119843,8,0,1,38912,8,2153661768
6464,2263102827,610136,2263712963,32,0,0,3584,32,2962695038
6465,2263119869,216895,2263336764,6,0,0,6656,6,9114812947
6466,2263124415,419318,2263543733,4,0,0,18944,4,6266812280
6467,2263139571,307708,2263447279,15,0,0,24576,15,621906300
6468,2263156713,10393,2263167106,29,0,1,9728,29,1629514699
6469,2263160403,23974,2263184377,0,0,1,7168,0,9495082143
6470,2263212342,142856,2263355198,19,0,0,2048,19,3337673673
6471,2263215686,58711,2263274397,34,0,1,13312,34,7537059011
6472,2263217561,251967,2263469528,5,0,0,11264,5,6031162777
6473,2263222991,375198,2263598189,46,0,0,36352,46,9864954236
6474,2263223973,696792,2263920765,41,0,0,37376,41,7717029624
6475,2263227991,743112,2263971103,30,0,0,41984,30,9677577315
6476,2263246811,798072,2264044883,39,0,0,4608,39,4812137100
6477,2263252034,720176,2263972210,33,0,0,3584,33,10316987661
6478,2263266262,527495,2263793757,43,0,0,36352,43,9393039186
6479,2263266585,21852,2263288437,24,0,1,14848,24,2399671579
6480,2263273635,122621,2263396256,47,0,0,4608,47,2054718914
6481,2263275738,459911,2263735649,7,0,0,32256,7,1914652550
6482,2263281502,10382,2263291884,29,0,1,9216,29,3742393631
6483,2263288084,569885,2263857969,25,0,0,9728,25,998387892
6484,2263289072,590244,2263879316,1,0,0,40448,1,8010957867
6485,2263310151,187173,2263497324,38,0,0,12288,38,5017650986
6486,2263324491,804579,2264129070,19,0,0,21504,19,6074229621
6487,2263328002,238508,2263566510,40,0,0,7168,40,7495230980
6488,2263342498,411643,2263754141,49,0,0,12288,49,9343327404
6489,2263346357,68097,2263414454,6,0,0,3072,6,8250239721
6490,2263354699,20587,2263375286,24,0,1,6656,24,3952087312
6491,2263359796,325824,2263685620,6,0,0,18432,6,1586232569
6492,2263362800,13054,2263375854,46,0,1,512,46,7251126564
6493,2263386449,4420,2263390869,14,0,1,11776,14,3144849428
6494,2263407795,548294,2263956089,2,0,0,40448,2,10190375983
6495,2263427256,246968,2263674224,23,0,0,14848,23,589359449
6496,2263428801,423007,2263851808,24,0,0,35840,24,6515329419
6497,2263443440,826745,2264270185,0,0,0,68096,0,3076696404
6498,2263453431,5326,2263458757,2,0,1,5632,2,8061456475
6499,2263458309,485403,2263943712,32,0,0,75264,32,2730478161
6500,2263461360,788062,2264249422,48,0,0,2048,48,2571763121
6501,2263467406,946308,2264413714,7,0,0,19968,7,3778682219
6502,2263488824,258594,2263747418,21,0,0,17408,21,9059629013
6503,2263513994,194628,2263708622,36,0,0,5632,36,5842083945
6504,2263515064,548031,2264063095,2,0,0,17920,2,1371458591
6505,2263539137,347214,2263886351,18,0,0,15872,18,89623426
6506,2263548089,557494,2264105583,10,0,0,9728,10,10036007227
6507,2263567149,1023637,2264590786,38,0,0,29696,38,1538235509
6508,2263583644,192484,2263776128,13,0,0,14336,13,262424151
6509,2263588357,266617,2263854974,30,0,0,10240,30,3980791076
6510,2263595881,652902,2264248783,7,0,0,28160,7,5119153019
6511,2263604108,109182,2263713290,40,0,0,1024,40,8430203117
6512,2263606273,157915,2263764188,1,0,0,7168,1,9518379993
6513,2263608690,11274,2263619964,15,0,1,18432,15,6715441192
6514,2263625005,446805,2264071810,12,0,0,5120,12,10218846046
6515,2263655340,3387,2263658727,24,0,1,9728,24,4022804877
6516,2263670655,352316,2264022971,17,0,0,19968,17,6248864476
6517,2263676203,1042,2263677245,12,0,1,1024,12,6980780603
6518,2263691345,287471,2263978816,38,0,0,11264,38,3587444544
6519,2263694846,578833,2264273679,40,0,0,2048,40,2673085312
6520,2263713295,259086,2263972381,23,0,0,512,23,183815054
6521,2263728825,508057,2264236882,44,0,0,67584,44,10035400794
6522,2263730518,580372,2264310890,46,0,0,24576,46,9527627413
6523,2263734694,306155,2264040849,40,0,0,2560,40,624137258
6524,2263740029,394048,2264134077,12,0,0,16384,12,4104633026
6525,2263740609,620466,2264361075,45,0,0,6656,45,6116204643
6526,2263764966,2946,2263767912,15,0,1,3072,15,1108431086
6527,2263784730,11531,2263796261,8,0,1,2560,8,3589648477
6528,2263787996,121366,2263909362,5,0,0,11776,5,6707678412
6529,2263793588,532932,2264326520,34,0,0,512,34,5678437028
6530,2263794849,56974,2263851823,11,0,1,38400,11,6042577203
6531,2263830025,128263,2263958288,31,0,0,7168,31,2553017134
6532,2263830168,113559,2263943727,11,0,1,101376,11,10406462803
6533,2263850360,207260,2264057620,48,0,0,14336,48,502792422
6534,2263861333,191888,2264053221,4,0,0,20480,4,4065923394
6535,2263872555,400461,2264273016,25,0,0,9216,25,751624251
6536,2263883049,781535,2264664584,15,0,0,106496,15,1794979780
6537,2263896711,393358,2264290069,48,0,0,23552,48,9541858516
6538,2263901457,42285,2263943742,3,0,1,22016,3,2025772822
6539,2263924553,145682,2264070235,28,0,0,6144,28,4144283107
6540,2263931424,261538,2264192962,11,0,0,29184,11,4361565897
6541,2263965095,326861,2264291956,2,0,0,6144,2,7382613686
6542,2263973693,239344,2264213037,24,0,0,2560,24,5792658518
6543,2263976453,519371,2264495824,17,0,0,6656,17,5726378563
6544,2263999969,168006,2264167975,18,0,0,14848,18,9245454855
6545,2264017740,16756,2264034496,0,0,1,18944,0,231554509
6546,2264024288,425129,2264449417,20,0,0,31744,20,9110946265
6547,2264047281,19671,2264066952,19,0,1,4096,19,1278054300
6548,2264048314,452883,2264501197,35,0,0,6144,35,6582447984
6549,2264076816,386047,2264462863,49,0,0,14848,49,9945011141
6550,2264080187,246162,2264326349,17,0,0,50688,17,8233317897
6551,2264099456,140732,2264240188,11,0,0,10752,11,603481542
6552,2264108365,285731,2264394096,46,0,0,512,46,6142356264
6553,2264150542,1518,2264152060,0,0,1,1536,0,1728379037
6554,2264154799,447213,2264602012,0,0,0,24064,0,10185369931
6555,2264171534,236081,2264407615,14,0,0,25088,14,2806201036
6556,2264171813,494034,2264665847,27,0,0,4096,27,4707851738
6557,2264175129,395751,2264570880,11,0,0,88064,11,3919935331
6558,2264182323,887157,2265069480,48,0,0,12288,48,5215353401
6559,2264204458,281271,2264485729,2,0,0,15872,2,3764790337
6560,2264212769,24128,2264236897,41,0,1,4608,41,10198738254
6561,2264227596,266185,2264493781,20,0,0,20480,20,3952489618
6562,2264233476,394959,2264628435,3,0,0,47616,3,221596380
6563,2264246125,45846,2264291971,10,0,1,22528,10,3472948575
6564,2264251656,330043,2264581699,6,0,0,35328,6,5030541352
6565,2264270447,474755,2264745202,28,0,0,35328,28,857573049
6566,2264273781,18213,2264291994,10,0,1,2560,10,7128390813
6567,2264275148,251309,2264526457,27,0,0,11776,27,8155023775
6568,2264287249,240026,2264527275,25,0,0,1024,25,222000815
6569,2264311633,624689,2264936322,37,0,0,29696,37,7674517779
6570,2264316148,666167,2264982315,33,0,0,5120,33,873146411
6571,2264356437,356873,2264713310,41,0,0,8192,41,9275081878
6572,2264356537,255302,2264611839,43,0,0,13312,43,3064563125
6573,2264377008,156328,2264533336,34,0,0,1024,34,6318913594
6574,2264380630,651588,2265032218,19,0,0,13824,19,6693565783
6575,2264383969,2946,2264386915,22,0,1,3072,22,9106885864
6576,2264415234,111714,2264526948,12,0,0,1536,12,2862647151
6577,2264426809,500442,2264927251,19,0,0,69632,19,691881203
6578,2264432321,317291,2264749612,25,0,0,5632,25,10325077549
6579,2264454385,538085,2264992470,11,0,0,33280,11,10298367646
6580,2264457434,209536,2264666970,30,0,0,3584,30,3673564533
6581,2264463980,775927,2265239907,36,0,0,56832,36,6729784031
6582,2264464182,543801,2265007983,6,0,0,8704,6,1742005535
6583,2264475881,3387,2264479268,43,0,1,9728,43,10629780649
6584,2264480046,282051,2264762097,25,0,0,9728,25,9029148790
6585,2264488766,297016,2264785782,33,0,0,24576,33,8050236922
6586,2264508525,163452,2264671977,40,0,0,16384,40,9760081699
6587,2264522130,362146,2264884276,14,0,0,47104,14,2390727291
6588,2264524016,574538,2265098554,28,0,0,20992,28,4929766841
6589,2264527662,609107,2265136769,13,0,0,82432,13,2261955298
6590,2264533978,572629,2265106607,46,0,0,13312,46,8842249289
6591,2264537513,324209,2264861722,1,0,0,16384,1,3927046050
6592,2264538600,628042,2265166642,22,0,0,82944,22,6428933038
6593,2264559873,30928,2264590801,22,0,1,1536,22,4939588907
6594,2264565605,379446,2264945051,12,0,0,20480,12,6384838725
6595,2264566566,610410,2265176976,29,0,0,32768,29,5272375234
6596,2264567556,281009,2264848565,30,0,0,22528,30,5252107083
6597,2264568978,35581,2264604559,8,0,1,36864,8,10011886339
6598,2264577127,279580,2264856707,39,0,0,26624,39,7919376820
6599,2264593804,12061,2264605865,8,0,1,2048,8,699216034
6600,2264597106,9527,2264606633,33,0,1,11776,33,10458901257
6601,2264609222,222205,2264831427,8,0,0,14336,8,9958473601
6602,2264639231,353574,2264992805,39,0,0,1024,39,1392377760
6603,2264643364,223365,2264866729,49,0,0,16384,49,6867881870
6604,2264675171,4850,2264680021,21,0,1,5120,21,1100126298
6605,2264691389,24242,2264715631,22,0,1,40448,22,1700804964
6606,2264692998,473971,2265166969,42,0,0,1024,42,3444726526
6607,2264723672,2946,2264726618,46,0,1,3072,46,4537370471
6608,2264734328,331393,2265065721,43,0,0,30720,43,9347802921
6609,2264747203,596933,2265344136,48,0,0,16384,48,6499563073
6610,2264750048,386892,2265136940,30,0,0,512,30,8507454273
6611,2264764328,272585,2265036913,16,0,0,15360,16,2000826393
6612,2264766381,455151,2265221532,13,0,0,17408,13,3018625785
6613,2264768529,555484,2265324013,0,0,0,11776,0,1973624263
6614,2264790201,6229,2264796430,49,0,1,15360,49,3074981468
6615,2264794127,347204,2265141331,22,0,0,14336,22,1327806089
6616,2264801513,382834,2265184347,47,0,0,24064,47,4061470359
6617,2264817298,381151,2265198449,29,0,0,2048,29,789015776
6618,2264834220,455450,2265289670,43,0,0,34304,43,8949017282
6619,2264835155,362631,2265197786,16,0,0,44032,16,9136893641
6620,2264838070,479003,2265317073,19,0,0,61952,19,6819398396
6621,2264839309,9271,2264848580,2,0,1,3072,2,9897450479
6622,2264844464,689176,2265533640,32,0,0,26112,32,5917144419
6623,2264852728,412232,2265264960,11,0,0,16896,11,6871300940
6624,2264862279,416892,2265279171,14,0,0,46592,14,9056276386
6625,2264876105,617578,2265493683,14,0,0,15360,14,3612897555
6626,2264896149,173666,2265069815,7,0,0,1024,7,10182292977
6627,2264904325,749933,2265654258,41,0,0,27648,41,3077432399
6628,2264906224,40814,2264947038,22,0,1,17408,22,9726824129
6629,2264984463,486252,2265470715,33,0,0,30720,33,7253203471
6630,2265006201,415749,2265421950,27,0,0,21504,27,9280209417
6631,2265010140,722822,2265732962,7,0,0,1536,7,3617937532
6632,2265020361,405192,2265425553,30,0,0,11776,30,10590180821
6633,2265037393,211964,2265249357,28,0,0,1024,28,6841408809
6634,2265043216,552188,2265595404,9,0,0,62464,9,1038483978
6635,2265064663,10963,2265075626,41,0,1,6144,41,4884834451
6636,2265065617,747173,2265812790,19,0,0,16384,19,1412323158
6637,2265067495,393593,2265461088,30,0,0,7680,30,9284388621
6638,2265070423,328130,2265398553,11,0,0,26112,11,5101155915
6639,2265073963,246409,2265320372,47,0,0,10752,47,8455409910
6640,2265108025,520700,2265628725,46,0,0,13824,46,2395835412
6641,2265115630,834794,2265950424,34,0,0,43520,34,2071602232
6642,2265120658,990704,2266111362,38,0,0,126976,38,10059623285
6643,2265121400,269182,2265390582,38,0,0,14336,38,2483385859
6644,2265129822,1116160,2266245982,49,0,0,11776,49,3143843081
6645,2265146352,584528,2265730880,20,0,0,61440,20,3919263266
6646,2265149150,253678,2265402828,39,0,0,13824,39,1005636769
6647,2265150146,743069,2265893215,4,0,0,11264,4,7107950655
6648,2265151136,600988,2265752124,46,0,0,25088,46,2665683313
6649,2265166877,265875,2265432752,20,0,0,23552,20,180268718
6650,2265189517,10910,2265200427,36,0,1,2048,36,7956237269
6651,2265189987,639696,2265829683,24,0,0,38912,24,3967039998
6652,2265191780,283006,2265474786,5,0,0,13312,5,9002263696
6653,2265195811,211830,2265407641,32,0,0,6144,32,6036065602
6654,2265210169,11378,2265221547,20,0,1,7680,20,3199528092
6655,2265227299,635956,2265863255,44,0,0,19968,44,608398424
6656,2265239494,1472,2265240966,22,0,1,1024,22,6517218271
6657,2265251434,566,2265252000,46,0,1,512,46,5405137395
6658,2265255445,617420,2265872865,36,0,0,12800,36,4639634718
6659,2265266470,53917,2265320387,43,0,1,22528,43,2714743639
6660,2265268781,443317,2265712098,36,0,0,46080,36,4528235597
6661,2265271808,48602,2265320410,48,0,1,13312,48,341009429
6662,2265274730,577871,2265852601,30,0,0,70656,30,3131975360
6663,2265300693,683715,2265984408,21,0,0,18944,21,2217594212
6664,2265303480,142883,2265446363,11,0,1,198144,11,10112094225
6665,2265381133,71439,2265452572,12,0,1,29696,12,5036467691
6666,2265386323,651029,2266037352,43,0,0,41472,43,2332199
6667,2265389966,373846,2265763812,19,0,0,18432,19,2281257598
6668,2265394190,423622,2265817812,47,0,0,16384,47,4574058390
6669,2265394361,344388,2265738749,46,0,0,18944,46,8439227938
6670,2265395682,597104,2265992786,1,0,0,6656,1,9933633329
6671,2265395957,162488,2265558445,43,0,0,4096,43,4606049522
6672,2265398760,505954,2265904714,28,0,0,3584,28,7924461786
6673,2265398779,165618,2265564397,43,0,0,9216,43,850013251
6674,2265412813,498354,2265911167,37,0,0,13312,37,2432119309
6675,2265414803,243378,2265658181,7,0,0,12800,7,8380146690
6676,2265422610,563537,2265986147,35,0,0,5632,35,6269864691
6677,2265439390,349132,2265788522,7,0,0,58880,7,6317527980
6678,2265471285,397665,2265868950,36,0,0,4096,36,8447989354
6679,2265497164,655107,2266152271,48,0,0,16896,48,782908241
6680,2265501068,356088,2265857156,47,0,0,14848,47,2709118482
6681,2265503912,634398,2266138310,3,0,0,50688,3,5831744435
6682,2265534763,566,2265535329,49,0,1,512,49,7616905591
6683,2265542596,324901,2265867497,22,0,0,3584,22,5928655757
6684,2265579088,153367,2265732455,36,0,0,5120,36,7438110183
6685,2265579918,868482,2266448400,15,0,0,14848,15,7413805665
6686,2265609357,508479,2266117836,36,0,0,7680,36,7409674317
6687,2265622203,716139,2266338342,19,0,0,37888,19,3006271553
6688,2265623401,437389,2266060790,28,0,0,63488,28,6220137411
6689,2265635889,511188,2266147077,2,0,0,28672,2,5347501451
6690,2265641711,473770,2266115481,16,0,0,13312,16,544103539
6691,2265648726,768185,2266416911,34,0,0,9216,34,8590614568
6692,2265675289,198542,2265873831,33,0,0,3072,33,9415776971
6693,2265694056,18081,2265712137,11,0,1,23552,11,10432656234
6694,2265699899,260519,2265960418,49,0,0,25088,49,5147919533
6695,2265701020,461912,2266162932,7,0,0,12800,7,7914391411
6696,2265705570,197017,2265902587,16,0,0,512,16,10654673553
6697,2265708969,157421,2265866390,42,0,0,10240,42,1723601095
6698,2265717291,992352,2266709643,46,0,0,1024,46,310883164
6699,2265719280,446639,2266165919,1,0,0,9728,1,7541325003
6700,2265720772,273448,2265994220,6,0,0,512,6,7327232739
6701,2265735249,1010876,2266746125,45,0,0,5120,45,2141967667
6702,2265735666,273901,2266009567,39,0,0,12800,39,8815839400
6703,2265738515,866745,2266605260,35,0,0,49664,35,7942722246
6704,2265755582,823128,2266578710,44,0,0,13312,44,1240368975
6705,2265766424,518227,2266284651,0,0,0,54784,0,4264100601
6706,2265797397,325454,2266122851,14,0,0,16384,14,406916644
6707,2265798728,6754,2265805482,43,0,1,7168,43,8030612005
6708,2265799871,12934,2265812805,34,0,1,7168,34,4592087907
6709,2265831305,411074,2266242379,43,0,0,40448,43,1016940737
6710,2265839677,828455,2266668132,39,0,0,17920,39,5381136754
6711,2265863983,8897,2265872880,46,0,1,3584,46,5364652623
6712,2265887469,380475,2266267944,28,0,0,34816,28,7344466243
6713,2265913966,935856,2266849822,41,0,0,35328,41,4402150714
6714,2265923180,985231,2266908411,4,0,0,5632,4,3039967346
6715,2265930505,468859,2266399364,13,0,0,66048,13,2444867075
6716,2265930761,1518,2265932279,22,0,1,1536,22,9013464624
6717,2265959175,347251,2266306426,17,0,0,16896,17,1412123081
6718,2265968715,355181,2266323896,46,0,0,6144,46,3516889902
6719,2265981964,558056,2266540020,0,0,0,63488,0,8816223473
6720,2265991224,5458,2265996682,34,0,1,10752,34,2060985173
6721,2265995762,234278,2266230040,3,0,0,14336,3,3095002797
6722,2266008281,1088331,2267096612,17,0,0,67072,17,6812531187
6723,2266009132,3580,2266012712,29,0,1,9216,29,3230411777
6724,2266009905,404153,2266414058,19,0,0,47104,19,9698729495
6725,2266026847,372844,2266399691,28,0,0,1024,28,5982000154
6726,2266030606,789816,2266820422,15,0,0,24064,15,4958642746
6727,2266076519,215869,2266292388,2,0,0,4608,2,2493176225
6728,2266080415,338695,2266419110,3,0,0,7168,3,1822253635
6729,2266085359,205586,2266290945,19,0,0,14336,19,6681482914
6730,2266087282,551395,2266638677,5,0,0,36864,5,4708157428
6731,2266090346,56762,2266147108,4,0,1,3584,4,696246326
6732,2266095529,564838,2266660367,12,0,0,2048,12,3456390699
6733,2266096463,121805,2266218268,9,0,0,26112,9,8956280732
6734,2266112800,1228729,2267341529,23,0,0,125952,23,6906562889
6735,2266120882,298727,2266419609,28,0,0,1536,28,2046791350
6736,2266133983,152571,2266286554,1,0,0,6144,1,4276156622
6737,2266147349,196595,2266343944,39,0,0,17920,39,7674256850
6738,2266151198,476232,2266627430,48,0,0,3072,48,5040929619
6739,2266160087,430026,2266590113,22,0,0,37376,22,8592366962
6740,2266181644,273030,2266454674,16,0,0,512,16,299687196
6741,2266181698,3898,2266185596,48,0,1,4096,48,7052136021
6742,2266213177,647892,2266861069,31,0,0,36864,31,9420860942
6743,2266236660,635787,2266872447,22,0,0,10240,22,9014010424
6744,2266238018,452614,2266690632,16,0,0,1024,16,8748146038
6745,2266242377,699801,2266942178,3,0,0,12800,3,6776153381
6746,2266249700,532103,2266781803,36,0,0,43520,36,6981005513
6747,2266255784,433960,2266689744,29,0,0,8192,29,7338220391
6748,2266260225,34602,2266294827,2,0,1,4096,2,3560574874
6749,2266261010,890979,2267151989,7,0,0,1024,7,4812127590
6750,2266266722,111909,2266378631,15,0,1,144896,15,2868129825
6751,2266275656,350679,2266626335,13,0,0,69120,13,1307480129
6752,2266305255,1099175,2267404430,18,0,0,45568,18,4620570975
6753,2266312008,475574,2266787582,16,0,0,2048,16,9322432696
6754,2266342389,71684,2266414073,15,0,1,6144,15,7603200561
6755,2266346491,408925,2266755416,21,0,0,28672,21,5567158907
6756,2266364969,626476,2266991445,40,0,0,50176,40,42963258
6757,2266365136,48952,2266414088,4,0,1,8704,4,1350918063
6758,2266368841,782805,2267151646,20,0,0,65024,20,2696580923
6759,2266405615,392053,2266797668,42,0,1,612864,42,2975323589
6760,2266411466,484970,2266896436,3,0,0,10752,3,3427053125
6761,2266436282,364292,2266800574,41,0,1,4608,41,2065523724
6762,2266457491,1023234,2267480725,35,0,0,18944,35,3168094046
6763,2266460016,478231,2266938247,43,0,0,26624,43,2148358855
6764,2266475433,242717,2266718150,0,0,0,16384,0,1807116003
6765,2266506678,330793,2266837471,18,0,0,6656,18,4193271273
6766,2266510751,737312,2267248063,29,0,0,64512,29,5977423979
6767,2266523119,665737,2267188856,37,0,0,4608,37,2977214060
6768,2266528039,275761,2266803800,43,0,1,5120,43,9152846364
6769,2266537503,1081218,2267618721,10,0,0,51200,10,6307314402
6770,2266541582,717260,2267258842,16,0,0,35328,16,7401531401
6771,2266544455,530211,2267074666,45,0,0,14848,45,10101272130
6772,2266551787,676605,2267228392,34,0,0,78848,34,4751872981
6773,2266553498,252248,2266805746,29,0,1,3072,29,8019073459
6774,2266555509,956743,2267512252,8,0,0,103424,8,5322368761
6775,2266601281,204926,2266806207,49,0,1,10240,49,3630630134
6776,2266605223,566850,2267172073,21,0,0,20992,21,790850229
6777,2266613511,903124,2267516635,23,0,0,14336,23,8831283022
6778,2266616177,264994,2266881171,16,0,0,3584,16,1489480482
6779,2266651190,278930,2266930120,1,0,0,16384,1,409925256
6780,2266683082,348996,2267032078,9,0,0,6144,9,8269081663
6781,2266686802,264518,2266951320,1,0,0,9216,1,2012987354
6782,2266693088,168464,2266861552,38,0,0,1536,38,5868711612
6783,2266711831,149744,2266861575,15,0,1,121856,15,896960607
6784,2266742803,560335,2267303138,16,0,0,30720,16,5901566789
6785,2266751483,606356,2267357839,15,0,0,26112,15,5835805413
6786,2266786076,749059,2267535135,48,0,0,5120,48,9490471220
6787,2266820054,602271,2267422325,10,0,0,27136,10,858083626
6788,2266824239,525581,2267349820,8,0,0,27136,8,3403679688
6789,2266832349,1038705,2267871054,0,0,0,56320,0,9968225219
6790,2266834815,427794,2267262609,31,0,0,12288,31,5213587065
6791,2266835203,618915,2267454118,10,0,0,9728,10,5883949330
6792,2266837227,619474,2267456701,49,0,0,5632,49,2205683282
6793,2266842903,22078,2266864981,24,0,1,9728,24,4510331678
6794,2266855091,678461,2267533552,22,0,0,35328,22,1545139692
6795,2266860460,863325,2267723785,18,0,0,148992,18,10021266201
6796,2266864131,301317,2267165448,25,0,0,5120,25,8453964978
6797,2266867574,5712,2266873286,11,0,1,14336,11,8887113964
6798,2266880114,930456,2267810570,9,0,0,53248,9,1436534089
6799,2266894619,4755,2266899374,4,0,1,3072,4,9190012734
6800,2266915846,710713,2267626559,3,0,0,13312,3,2748494695
6801,2266924567,678531,2267603098,22,0,0,97792,22,219257285
6802,2266934516,632802,2267567318,14,0,0,13312,14,6840468577
6803,2266936634,17294,2266953928,14,0,1,19456,14,3550813950
6804,2266951159,489712,2267440871,14,0,0,16896,14,1844888525
6805,2266959795,475913,2267435708,41,0,0,26112,41,2224173428
6806,2266960765,892935,2267853700,43,0,0,30208,43,1106115154
6807,2266962384,560389,2267522773,46,0,0,5632,46,8708055455
6808,2266964798,985130,2267949928,2,0,0,3072,2,5357563423
6809,2266973935,566673,2267540608,16,0,0,5120,16,5015400748
6810,2266985598,12134,2266997732,36,0,1,6656,36,10475163651
6811,2266988715,633765,2267622480,5,0,0,12288,5,4649575178
6812,2267064402,613046,2267677448,3,0,0,5632,3,9343899514
6813,2267065481,779000,2267844481,16,0,0,28672,16,10673612306
6814,2267067105,583567,2267650672,44,0,0,23552,44,780061202
6815,2267084348,823434,2267907782,23,0,0,49664,23,6043019857
6816,2267103336,301577,2267404913,47,0,0,1536,47,3448640146
6817,2267106613,961861,2268068474,16,0,0,31744,16,3358827566
6818,2267108961,464326,2267573287,11,0,0,11776,11,9849803986
6819,2267122643,1104416,2268227059,0,0,0,10240,0,5700486507
6820,2267129617,1002414,2268132031,16,0,0,41472,16,419114257
6821,2267132652,21290,2267153942,36,0,1,2048,36,8633678656
6822,2267145443,708436,2267853879,47,0,0,512,47,2852552783
6823,2267169474,919264,2268088738,38,0,0,18944,38,3226240550
6824,2267196721,757530,2267954251,29,0,0,9728,29,284194606
6825,2267199568,881211,2268080779,25,0,0,8192,25,1264674235
6826,2267237401,685216,2267922617,46,0,0,48640,46,3758371147
6827,2267247946,15739,2267263685,36,0,1,1024,36,6356019090
6828,2267252740,795586,2268048326,34,0,0,34816,34,7019542902
6829,2267259248,964676,2268223924,11,0,0,9728,11,8103398960
6830,2267281856,2470,2267284326,11,0,1,2560,11,8814094594
6831,2267282636,792155,2268074791,21,0,0,19968,21,9532704845
6832,2267297629,968124,2268265753,15,0,0,86016,15,922569025
6833,2267321438,962465,2268283903,6,0,0,6656,6,6368745010
6834,2267324742,461393,2267786135,38,0,0,2048,38,661076480
6835,2267326448,33820,2267360268,46,0,1,2560,46,2003765226
6836,2267331249,189769,2267521018,32,0,0,14336,32,705101185
6837,2267333137,1188838,2268521975,15,0,0,52736,15,361612734
6838,2267338292,1361186,2268699478,25,0,0,41984,25,9008024832
6839,2267354105,817796,2268171901,5,0,0,8704,5,6028491930
6840,2267354264,1379119,2268733383,25,0,0,20480,25,6924858617
6841,2267374417,1312254,2268686671,33,0,0,98304,33,106755517
6842,2267381444,911803,2268293247,12,0,0,23040,12,2527179907
6843,2267385035,968303,2268353338,21,0,0,58368,21,2149198522
6844,2267388545,800427,2268188972,8,0,0,16384,8,10435657590
6845,2267403511,614911,2268018422,16,0,0,41984,16,6159855484
6846,2267404663,2737,2267407400,8,0,1,2560,8,5843374540
6847,2267407746,538973,2267946719,10,0,0,2560,10,9330970645
6848,2267441861,779084,2268220945,39,0,0,95232,39,922952704
6849,2267449959,217515,2267667474,25,0,0,5632,25,97833638
6850,2267457498,294370,2267751868,46,0,0,16384,46,1803258548
6851,2267473472,808380,2268281852,42,0,0,52736,42,1062203727
6852,2267503847,1369266,2268873113,37,0,0,62464,37,7953450299
6853,2267505767,855386,2268361153,14,0,0,25600,14,2452464959
6854,2267510495,513418,2268023913,19,0,0,17920,19,6681535897
6855,2267520847,948127,2268468974,0,0,0,24576,0,2497916790
6856,2267522490,22945,2267545435,13,0,1,16384,13,998839047
6857,2267524604,1105295,2268629899,1,0,0,22528,1,3841291573
6858,2267529484,216522,2267746006,46,0,0,4608,46,9923076061
6859,2267533452,793618,2268327070,2,0,0,10752,2,6613766805
6860,2267545727,285437,2267831164,25,0,0,10752,25,8192140276
6861,2267553520,3387,2267556907,8,0,1,9728,8,7418524691
6862,2267558373,1518,2267559891,4,0,1,1536,4,5320226891
6863,2267587793,852518,2268440311,4,0,0,27648,4,1966702384
6864,2267595379,845259,2268440638,17,0,0,1024,17,154248304
6865,2267602287,1146780,2268749067,23,0,0,25600,23,8034725476
6866,2267608799,29327,2267638126,20,0,1,18944,20,6086140547
6867,2267615556,1409787,2269025343,26,0,0,49664,26,7250893022
6868,2267627724,151306,2267779030,28,0,0,3584,28,6409722582
6869,2267659501,1252384,2268911885,7,0,0,67072,7,6638119663
6870,2267661552,841205,2268502757,15,0,0,50688,15,2487643267
6871,2267669739,1466296,2269136035,44,0,0,74752,44,2704191132
6872,2267671778,460580,2268132358,4,0,0,1024,4,7184176463
6873,2267693263,484422,2268177685,7,0,0,1024,7,2363852747
6874,2267701920,29129,2267731049,10,0,1,7680,10,7144360971
6875,2267709382,319377,2268028759,49,0,0,1024,49,7432732083
6876,2267729015,3980,2267732995,13,0,1,3072,13,8297335243
6877,2267730183,5078,2267735261,9,0,1,3584,9,6556787521
6878,2267741928,566,2267742494,4,0,1,512,4,2374484404
6879,2267766946,4374,2267771320,46,0,1,4608,46,37914968
6880,2267773134,5911,2267779045,46,0,1,5120,46,7522192781
6881,2267776882,281905,2268058787,49,0,0,7168,49,6581297902
6882,2267803100,1226649,2269029749,19,0,0,12288,19,7110418265
6883,2267811471,716923,2268528394,14,0,0,20992,14,3923000970
6884,2267812112,507062,2268319174,21,0,0,11776,21,9526456611
6885,2267822774,621623,2268444397,30,0,0,12288,30,4649315795
6886,2267831230,3645,2267834875,23,0,1,10240,23,1974703541
6887,2267844875,528937,2268373812,48,0,0,41472,48,5823562175
6888,2267912471,316022,2268228493,49,0,0,4096,49,5645677770
6889,2267935701,241657,2268177358,38,0,0,15872,38,4520357823
6890,2267938605,1314547,2269253152,28,0,0,46080,28,8055920124
6891,2267938811,519488,2268458299,31,0,0,21504,31,9160342800
6892,2267966903,260327,2268227230,40,0,0,512,40,10643916479
6893,2267969199,1440432,2269409631,41,0,0,24064,41,5554385978
6894,2267990006,737114,2268727120,20,0,0,79360,20,4179275922
6895,2268005613,1178102,2269183715,24,0,0,41472,24,10677842622
6896,2268012074,800723,2268812797,37,0,0,72192,37,10448512563
6897,2268016480,292230,2268308710,41,0,0,6144,41,4302588339
6898,2268024242,919652,2268943894,47,0,0,14336,47,1309516285
6899,2268047138,1746,2268048884,39,0,1,512,39,185072951
6900,2268086665,761738,2268848403,18,0,0,100864,18,183825160
6901,2268087027,4674,2268091701,1,0,1,3072,1,8946590785
6902,2268088984,287901,2268376885,15,0,1,468992,15,513066698
6903,2268104680,1044816,2269149496,23,0,0,19456,23,7436017254
6904,2268117457,495822,2268613279,20,0,0,38912,20,477149164
6905,2268131236,571689,2268702925,31,0,0,11264,31,9896217866
6906,2268144156,233715,2268377871,34,0,1,1536,34,3932548985
6907,2268155206,854982,2269010188,43,0,0,28672,43,1316413264
6908,2268157655,582310,2268739965,35,0,0,20480,35,7272273985
6909,2268163003,799370,2268962373,37,0,0,50688,37,4027798353
6910,2268186453,746771,2268933224,34,0,0,6656,34,3992406930
6911,2268197311,747690,2268945001,44,0,0,3584,44,6428137093
6912,2268218221,673205,2268891426,46,0,0,19968,46,2264614740
6913,2268232698,542788,2268775486,0,0,0,33792,0,4556888993
6914,2268239558,209508,2268449066,16,0,0,4608,16,7017654381
6915,2268262737,243155,2268505892,1,0,0,10240,1,6472731109
6916,2268270820,942205,2269213025,45,0,0,18944,45,9384914232
6917,2268278087,1124189,2269402276,23,0,0,64512,23,273307495
6918,2268305797,73150,2268378947,14,0,1,13312,14,678444531
6919,2268344333,412401,2268756734,43,0,0,25088,43,3043960816
6920,2268362421,204917,2268567338,30,0,0,17408,30,4963220897
6921,2268365203,772719,2269137922,41,0,0,6144,41,8550380862
6922,2268369853,886902,2269256755,46,0,0,11776,46,1392681821
6923,2268370364,10849,2268381213,20,0,1,3584,20,7901400694
6924,2268372488,735734,2269108222,29,0,0,60416,29,3761880380
6925,2268386364,566,2268386930,20,0,1,512,20,1310538922
6926,2268396601,457457,2268854058,36,0,0,18432,36,5569769411
6927,2268431254,732931,2269164185,22,0,0,19968,22,5407597084
6928,2268448764,544144,2268992908,17,0,0,12288,17,8392221302
6929,2268476721,4850,2268481571,10,0,1,5120,10,1377491204
6930,2268477840,263396,2268741236,8,0,0,4096,8,3930194663
6931,2268500130,233580,2268733710,17,0,0,1024,17,8795000630
6932,2268511594,306062,2268817656,38,0,0,15872,38,3206921952
6933,2268533986,397187,2268931173,10,0,0,13824,10,8184766526
6934,2268536392,376912,2268913304,25,0,0,4608,25,4533314727
6935,2268547076,6229,2268553305,14,0,1,15360,14,98811116
6936,2268563515,694815,2269258330,47,0,0,5120,47,9440791629
6937,2268565226,409361,2268974587,10,0,0,39424,10,4847301499
6938,2268580159,1057895,2269638054,41,0,0,13312,41,9119950886
6939,2268590605,596245,2269186850,20,0,0,10240,20,4589583862
6940,2268597210,546343,2269143553,44,0,0,18432,44,9737480790
6941,2268606042,1249681,2269855723,22,0,0,17408,22,9932643364
6942,2268612923,349621,2268962544,23,0,0,512,23,462608991
6943,2268620880,1994,2268622874,34,0,1,2048,34,8034954091
6944,2268621301,16865,2268638166,21,0,1,32256,21,1958035676
6945,2268630082,255245,2268885327,11,0,0,39936,11,5533923529
6946,2268645939,411588,2269057527,35,0,0,39424,35,1289537961
6947,2268647235,929796,2269577031,15,0,0,30208,15,2343445258
6948,2268652270,613734,2269266004,28,0,0,11264,28,9703454840
6949,2268689259,1016022,2269705281,33,0,0,21504,33,5755173883
6950,2268703413,406696,2269110109,34,0,0,6144,34,8908819043
6951,2268713023,516890,2269229913,10,0,0,38912,10,7029437166
6952,2268721066,1001548,2269722614,2,0,0,12800,2,1159439448
6953,2268730403,28810,2268759213,11,0,1,2560,11,7270544240
6954,2268742694,1122439,2269865133,4,0,0,29696,4,5016953841
6955,2268743506,558449,2269301955,11,0,0,20992,11,5226255188
6956,2268754618,1063253,2269817871,6,0,0,47104,6,7945323745
6957,2268798395,74733,2268873128,36,0,1,5632,36,5672617195
6958,2268813883,248184,2269062067,26,0,0,10752,26,6151589392
6959,2268817899,212045,2269029944,36,0,0,512,36,10731875813
6960,2268824108,150510,2268974618,21,0,1,155136,21,5667843768
6961,2268856959,314105,2269171064,13,0,0,22528,13,5895350183
6962,2268865578,1220219,2270085797,4,0,0,4096,4,5699238477
6963,2268882703,91930,2268974633,10,0,1,9728,10,3716285836
6964,2268890390,435400,2269325790,39,0,0,1536,39,5014463970
6965,2268898667,127315,2269025982,42,0,0,2048,42,5532985529
6966,2268901551,361006,2269262557,10,0,0,13824,10,8597099754
6967,2268901654,73002,2268974656,48,0,1,2048,48,10458769987
6968,2268914255,60432,2268974687,49,0,1,6656,49,3652687948
6969,2268924672,504835,2269429507,11,0,0,24576,11,2784296171
6970,2268924897,188347,2269113244,37,0,0,10240,37,2548778658
6971,2268930375,394932,2269325307,11,0,0,33280,11,1851670208
6972,2268938100,483904,2269422004,12,0,0,13312,12,6316745847
6973,2268941827,38641,2268980468,42,0,1,30720,42,963979977
6974,2268945196,810978,2269756174,26,0,0,43008,26,406287465
6975,2268958595,377682,2269336277,14,0,0,17920,14,3210034735
6976,2268966419,21537,2268987956,22,0,1,25600,22,764198500
6977,2268967041,539269,2269506310,18,0,0,1536,18,1856237944
6978,2268969246,532980,2269502226,26,0,0,4608,26,1493932272
6979,2268971748,21175,2268992923,28,0,1,2048,28,2506150380
6980,2268973568,629060,2269602628,41,0,0,29184,41,4837972580
6981,2268984709,986289,2269970998,16,0,0,63488,16,9972279273
6982,2269003596,1260760,2270264356,15,0,1,592896,15,6193851189
6983,2269015003,1103334,2270118337,33,0,0,23040,33,8205763701
6984,2269015302,968229,2269983531,33,0,0,7168,33,6177820919
6985,2269016695,617288,2269633983,45,0,0,55808,45,8689201102
6986,2269050648,1222158,2270272806,10,0,1,4096,10,2568545255
6987,2269055738,248260,2269303998,20,0,0,6656,20,5676653892
6988,2269055916,1235102,2270291018,27,0,0,26112,27,3727417629
6989,2269064375,1208687,2270273062,8,0,1,9216,8,7419142890
6990,2269069456,1247035,2270316491,24,0,1,7168,24,10714663397
6991,2269077227,453038,2269530265,9,0,0,5632,9,1452439187
6992,2269086082,1133738,2270219820,7,0,0,7680,7,1440833636
6993,2269127487,481240,2269608727,27,0,0,19968,27,3940335085
6994,2269142015,339254,2269481269,43,0,0,6144,43,3255213444
6995,2269148124,1200275,2270348399,29,0,0,34304,29,653657963
6996,2269150468,465762,2269616230,41,0,0,24576,41,946029945
6997,2269152433,299199,2269451632,5,0,0,20992,5,1294105299
6998,2269155195,486306,2269641501,33,0,0,11264,33,1382167734
6999,2269169845,1368446,2270538291,15,0,1,115712,15,1829606646
7000,2269180895,499184,2269680079,23,0,0,11776,23,9459472775
7001,2269189443,660937,2269850380,41,0,0,46080,41,7487215803
7002,2269189621,986819,2270176440,27,0,0,44544,27,10042734895
7003,2269213296,997243,2270210539,38,0,0,71168,38,8746990392
7004,2269218286,823145,2270041431,35,0,0,47616,35,10034384652
7005,2269221415,956756,2270178171,3,0,0,5632,3,4268650808
7006,2269223131,1135618,2270358749,43,0,0,25088,43,3554372879
7007,2269248410,398254,2269646664,11,0,0,16896,11,3730775952
7008,2269255534,1287583,2270543117,34,0,1,7680,34,3373327148
7009,2269272973,282075,2269555048,3,0,0,4096,3,793217884
7010,2269324695,863810,2270188505,47,0,0,33280,47,7462614386
7011,2269325133,391221,2269716354,12,0,0,24576,12,1406288080
7012,2269339023,1262229,2270601252,0,0,1,512,0,49532836
7013,2269356583,430331,2269786914,22,0,0,15872,22,8925559438
7014,2269359171,473855,2269833026,10,0,0,49664,10,9477404913
7015,2269360312,1240955,2270601267,0,0,1,2048,0,7447564835
7016,2269370047,425874,2269795921,19,0,0,6144,19,908256453
7017,2269375336,787517,2270162853,4,0,0,56832,4,1335210520
7018,2269386014,919215,2270305229,44,0,0,46592,44,8978282211
7019,2269393586,488270,2269881856,24,0,0,13824,24,9910808751
7020,2269398419,838459,2270236878,30,0,0,512,30,9350037048
7021,2269411025,1098900,2270509925,16,0,0,26624,16,2550283559
7022,2269419023,1098717,2270517740,9,0,0,25600,9,10146175767
7023,2269433915,574454,2270008369,39,0,0,60928,39,3359600238
7024,2269443438,1090112,2270533550,0,0,0,30720,0,9707899733
7025,2269456043,990052,2270446095,14,0,0,35328,14,8534089742
7026,2269461520,876412,2270337932,4,0,0,5120,4,684558880
7027,2269479997,281964,2269761961,0,0,0,18944,0,4719820589
7028,2269490840,394694,2269885534,24,0,0,1536,24,4554792315
7029,2269496025,455614,2269951639,20,0,0,22016,20,10681807471
7030,2269505762,330555,2269836317,22,0,0,10752,22,6881620440
7031,2269512226,359162,2269871388,17,0,0,20480,17,10193046440
7032,2269519350,930488,2270449838,0,0,0,2048,0,5471899612
7033,2269523590,457734,2269981324,8,0,0,32256,8,5722483430
7034,2269526667,552860,2270079527,25,0,0,55808,25,3307652574
7035,2269553875,358524,2269912399,15,0,0,9216,15,8173232343
7036,2269566095,518439,2270084534,47,0,0,16384,47,8313813344
7037,2269568613,1079929,2270648542,45,0,0,32768,45,5132207480
7038,2269571803,645467,2270217270,14,0,0,22016,14,9498358034
7039,2269641457,258806,2269900263,27,0,0,5120,27,3477290250
7040,2269643304,686626,2270329930,34,0,0,44032,34,5650945613
7041,2269646682,920117,2270566799,9,0,0,20480,9,6657544724
7042,2269647124,689217,2270336341,30,0,0,20992,30,10209830772
7043,2269683831,287650,2269971481,45,0,0,1536,45,9789654961
7044,2269693311,417991,2270111302,0,0,0,17408,0,8860247478
7045,2269699339,617137,2270316476,1,0,0,36864,1,532263869
7046,2269700320,386436,2270086756,10,0,0,3072,10,7604399614
7047,2269706467,423459,2270129926,36,0,0,7680,36,9490756341
7048,2269716445,509334,2270225779,44,0,0,19456,44,10058683812
7049,2269737764,145859,2269883623,36,0,0,2048,36,2309543073
7050,2269740236,496471,2270236707,47,0,0,10752,47,6179401783
7051,2269781135,634280,2270415415,21,0,0,23552,21,1540390000
7052,2269796359,212805,2270009164,7,0,0,2560,7,8850918828
7053,2269797026,804187,2270601213,9,0,0,24064,9,413940776
7054,2269801871,867852,2270669723,17,0,0,11776,17,4027493740
7055,2269802549,325022,2270127571,27,0,0,22528,27,2487020757
7056,2269804058,801437,2270605495,46,0,1,7680,46,2072676583
7057,2269821190,241318,2270062508,13,0,0,14336,13,6459345568
7058,2269826432,456599,2270283031,37,0,0,23552,37,7464985988
7059,2269826633,784008,2270610641,0,0,1,8192,0,108300131
7060,2269845187,651817,2270497004,34,0,0,31744,34,10726222478
7061,2269850060,400031,2270250091,14,0,0,41472,14,7727671414
7062,2269856064,405906,2270261970,43,0,0,38912,43,8806501046
7063,2269874143,935215,2270809358,29,0,0,15872,29,9002871901
7064,2269880880,500481,2270381361,40,0,0,12288,40,3872694237
7065,2269886695,751840,2270638535,28,0,0,5632,28,10352792615
7066,2269905724,709743,2270615467,49,0,1,7680,49,2398393982
7067,2269912997,265353,2270178350,11,0,0,512,11,1461337805
7068,2269935474,281967,2270217441,25,0,0,512,25,3838684929
7069,2269940330,719701,2270660031,29,0,0,14336,29,3622621489
7070,2269940619,669253,2270609872,36,0,0,8192,36,9224755299
7071,2269970276,691640,2270661916,36,0,1,10240,36,5112509238
7072,2269981304,283037,2270264341,38,0,0,7680,38,2972784713
7073,2269987149,711107,2270698256,10,0,1,512,10,5041646945
7074,2269997145,191687,2270188832,14,0,0,1024,14,8005972834
7075,2270005578,554966,2270560544,46,0,0,18944,46,9239573963
7076,2270010440,752689,2270763129,23,0,0,13824,23,6107485708
7077,2270011388,686883,2270698271,22,0,1,512,22,6254699626
7078,2270013717,788723,2270802440,9,0,0,23552,9,4055449089
7079,2270053276,180120,2270233396,36,0,0,9728,36,5359250497
7080,2270076833,621453,2270698286,43,0,1,2048,43,1283186538
7081,2270089193,261897,2270351090,37,0,0,8704,37,2014030925
7082,2270103478,364103,2270467581,16,0,0,24064,16,6042146801
7083,2270111816,586485,2270698301,19,0,1,14336,19,10196495933
7084,2270129328,892264,2271021592,8,0,0,35840,8,2631777323
7085,2270133053,662196,2270795249,43,0,0,36352,43,10238916753
7086,2270157173,479631,2270636804,6,0,0,512,6,3942044908
7087,2270162246,1217655,2271379901,24,0,0,4608,24,3220326423
7088,2270167091,287537,2270454628,42,0,0,1024,42,8299878330
7089,2270173680,462953,2270636633,18,0,0,15872,18,9634493903
7090,2270174073,396961,2270571034,14,0,0,13824,14,1743225277
7091,2270176552,575411,2270751963,12,0,1,6144,12,4762770543
7092,2270194022,285524,2270479546,12,0,0,1024,12,9095673519
7093,2270200387,537998,2270738385,30,0,0,43520,30,8094923029
7094,2270215086,309081,2270524167,40,0,0,20992,40,3946152104
7095,2270219036,146210,2270365246,24,0,0,2560,24,7530293518
7096,2270228982,759862,2270988844,34,0,0,29184,34,6980927758
7097,2270229140,362422,2270591562,34,0,0,16384,34,10391188688
7098,2270240289,513300,2270753589,22,0,1,2560,22,7551456478
7099,2270252482,513196,2270765678,34,0,1,9216,34,8490995627
7100,2270272688,282069,2270554757,4,0,0,22528,4,5554799424
7101,2270275805,641432,2270917237,2,0,0,18432,2,3299164911
7102,2270276581,1233496,2271510077,35,0,0,3072,35,5509710130
7103,2270279293,307262,2270586555,6,0,0,4096,6,3916636253
7104,2270301014,284270,2270585284,25,0,0,38400,25,460878430
7105,2270320556,445468,2270766024,4,0,1,512,4,4505273345
7106,2270320753,297094,2270617847,29,0,0,6656,29,3476304711
7107,2270328046,417695,2270745741,48,0,0,7168,48,7028953371
7108,2270328151,438744,2270766895,46,0,1,12288,46,9082984363
7109,2270345099,575897,2270920996,31,0,0,12288,31,9934719561
7110,2270355115,462257,2270817372,14,0,1,21504,14,761614692
7111,2270356541,384708,2270741249,22,0,0,4096,22,2134776040
7112,2270368076,451984,2270820060,45,0,1,4096,45,9619072538
7113,2270377220,427279,2270804499,41,0,0,6656,41,6998111193
7114,2270381147,284568,2270665715,42,0,0,8704,42,9095303595
7115,2270385469,701332,2271086801,29,0,0,29696,29,4556652971
7116,2270399545,468296,2270867841,2,0,1,10752,2,2611590903
7117,2270427536,519580,2270947116,45,0,0,80896,45,2193533175
7118,2270432070,247289,2270679359,48,0,0,2048,48,428023657
7119,2270432245,265996,2270698241,23,0,0,51712,23,5708571319
7120,2270434697,433400,2270868097,11,0,1,9216,11,5380200187
7121,2270456343,548654,2271004997,25,0,0,25600,25,7309138137
7122,2270489549,400170,2270889719,36,0,0,16384,36,4112885469
7123,2270497834,475154,2270972988,2,0,1,40960,2,6654436031
7124,2270502328,548575,2271050903,24,0,0,13824,24,8666230216
7125,2270510829,481020,2270991849,24,0,1,1024,24,4504748236
7126,2270542042,529479,2271071521,5,0,0,32768,5,5394175511
7127,2270557345,435490,2270992835,31,0,1,1536,31,7514921324
7128,2270570778,424963,2270995741,4,0,1,4608,4,9020163355
7129,2270576580,1172744,2271749324,36,0,0,15872,36,6923170319
7130,2270590201,1075408,2271665609,15,0,0,57856,15,5128756496
7131,2270591763,319843,2270911606,17,0,0,8704,17,8132194334
7132,2270595651,177377,2270773028,2,0,0,14848,2,9226152614
7133,2270596706,507963,2271104669,7,0,0,7680,7,2299144677
7134,2270596711,1183858,2271780569,13,0,0,24576,13,6743504444
7135,2270607583,453939,2271061522,7,0,0,512,7,10035035990
7136,2270620817,253615,2270874432,18,0,0,8704,18,8241891932
7137,2270626060,572448,2271198508,8,0,0,14336,8,3868847393
7138,2270630619,1280963,2271911582,48,0,0,73216,48,6265178521
7139,2270635677,239127,2270874804,25,0,0,512,25,7865797260
7140,2270641872,504949,2271146821,12,0,0,8192,12,9439001559
7141,2270660350,478496,2271138846,45,0,0,1024,45,2924450169
7142,2270661349,287046,2270948395,13,0,0,4096,13,10218634124
7143,2270675770,152459,2270828229,37,0,0,9216,37,6346393601
7144,2270725075,391874,2271116949,20,0,0,18432,20,5585879284
7145,2270731814,412466,2271144280,44,0,0,12800,44,3982725690
7146,2270741514,573468,2271314982,0,0,0,54272,0,647822792
7147,2270741704,466647,2271208351,25,0,0,32256,25,7085854034
7148,2270743995,344233,2271088228,16,0,0,4608,16,8570629022
7149,2270753447,252212,2271005659,8,0,1,5632,8,9451993502
7150,2270756697,395371,2271152068,23,0,0,3072,23,4365795370
7151,2270766553,258991,2271025544,44,0,1,14848,44,8201302454
7152,2270776791,820872,2271597663,0,0,0,12288,0,7218300151
7153,2270781398,470133,2271251531,12,0,0,53248,12,5474969394
7154,2270785529,220115,2271005644,33,0,0,2048,33,6606926041
7155,2270785911,168638,2270954549,14,0,0,10240,14,5759597757
7156,2270792613,268738,2271061351,15,0,0,30720,15,9634773617
7157,2270809393,359598,2271168991,19,0,0,8704,19,1006814340
7158,2270809694,604233,2271413927,9,0,0,60928,9,2708420444
7159,2270820964,283720,2271104684,44,0,1,16384,44,8759339642
7160,2270824071,126914,2270950985,14,0,0,3584,14,8641985968
7161,2270828424,260131,2271088555,31,0,0,1024,31,3284359802
7162,2270833256,273357,2271106613,13,0,1,6656,13,4330396957
7163,2270840314,195361,2271035675,42,0,0,9216,42,1195875032
7164,2270858450,265421,2271123871,37,0,1,2560,37,10207322587
7165,2270892790,295046,2271187836,15,0,0,35328,15,10361843841
7166,2270893887,436911,2271330798,35,0,0,49664,35,6763572493
7167,2270907294,346140,2271253434,40,0,0,6144,40,7081685991
7168,2270920396,344043,2271264439,42,0,0,17920,42,6665183298
7169,2270921302,726455,2271647757,17,0,0,9216,17,7367090458
7170,2270921733,209205,2271130938,49,0,1,24576,49,4739104271
7171,2270923869,537527,2271461396,45,0,0,512,45,4757468252
7172,2270936964,653418,2271590382,42,0,0,75776,42,2588878309
7173,2270948341,397748,2271346089,6,0,0,6656,6,6003291138
7174,2270971295,1098021,2272069316,45,0,0,30208,45,1319715587
7175,2270980363,335258,2271315621,42,0,0,2048,42,1780074085
7176,2270980767,585839,2271566606,34,0,0,57344,34,962070103
7177,2270981453,162842,2271144295,10,0,1,5120,10,3392565830
7178,2270986369,1251253,2272237622,33,0,0,47104,33,6316031519
7179,2270999145,334372,2271333517,0,0,0,1536,0,10367603019
7180,2271002260,835216,2271837476,38,0,0,41472,38,4470545432
7181,2271033958,710515,2271744473,5,0,0,2048,5,4146933612
7182,2271039890,770224,2271810114,8,0,0,3584,8,8911739410
7183,2271066233,364491,2271430724,0,0,0,18432,0,10144790918
7184,2271068763,217444,2271286207,19,0,0,16384,19,2422709438
7185,2271082446,378159,2271460605,31,0,0,33792,31,8046326949
7186,2271093315,355584,2271448899,39,0,0,10240,39,8197791496
7187,2271101605,287017,2271388622,36,0,0,22528,36,2646062515
7188,2271107426,642225,2271749651,25,0,0,1024,25,2060440416
7189,2271110355,563591,2271673946,24,0,0,14336,24,9137898056
7190,2271111696,32614,2271144310,4,0,1,10752,4,7912060146
7191,2271123433,415334,2271538767,11,0,0,22016,11,10175593938
7192,2271133521,153182,2271286703,13,0,1,9728,13,10176752688
7193,2271182003,642790,2271824793,40,0,0,48128,40,5336939277
7194,2271186034,101015,2271287049,49,0,1,512,49,8454878316
7195,2271213215,270940,2271484155,7,0,0,4096,7,138384367
7196,2271223197,92439,2271315636,14,0,1,13312,14,8898598508
7197,2271234027,708731,2271942758,42,0,0,39424,42,3108528365
7198,2271240677,183450,2271424127,18,0,0,8704,18,10457119102
7199,2271244109,605737,2271849846,44,0,0,21504,44,8809379365
7200,2271252109,63542,2271315651,29,0,1,9728,29,3259051660
7201,2271258531,386334,2271644865,18,0,0,14848,18,497546521
7202,2271259763,1003018,2272262781,38,0,0,3584,38,2648366132
7203,2271267965,448009,2271715974,45,0,0,27136,45,13510493
7204,2271269998,676519,2271946517,49,0,0,12288,49,8576575028
7205,2271282675,386872,2271669547,8,0,0,7168,8,4921730197
7206,2271313751,1094316,2272408067,31,0,0,35840,31,4105545005
7207,2271327649,310921,2271638570,30,0,0,19456,30,5812312235
7208,2271349057,782419,2272131476,31,0,0,19968,31,4630578708
7209,2271356529,659607,2272016136,36,0,0,21504,36,6367825241
7210,2271359436,340940,2271700376,5,0,0,24576,5,2763920295
7211,2271365860,4420,2271370280,38,0,1,11776,38,5807776757
7212,2271377885,416895,2271794780,19,0,0,46592,19,9770213592
7213,2271382732,7876,2271390608,11,0,1,2048,11,1554042748
7214,2271393970,908174,2272302144,24,0,0,27136,24,9661123633
7215,2271404145,104981,2271509126,46,0,0,10240,46,6136492472
7216,2271405827,513104,2271918931,5,0,0,7168,5,4301036562
7217,2271414588,176293,2271590881,3,0,0,1536,3,3503263721
7218,2271427796,299580,2271727376,24,0,0,17408,24,3518906572
7219,2271445097,1004936,2272450033,10,0,0,29696,10,5709604354
7220,2271448704,360287,2271808991,13,0,0,46592,13,3830518697
7221,2271463688,1115214,2272578902,40,0,0,13312,40,8997438479
7222,2271473350,270476,2271743826,5,0,0,27648,5,10587434353
7223,2271490794,52549,2271543343,21,0,1,85504,21,5419259092
7224,2271496707,47712,2271544419,14,0,1,13312,14,568138508
7225,2271523369,337337,2271860706,42,0,0,20992,42,10507913105
7226,2271527120,348066,2271875186,1,0,0,9216,1,5636192293
7227,2271531000,136340,2271667340,4,0,0,5632,4,10144412316
7228,2271558413,730753,2272289166,27,0,0,53248,27,7059037800
7229,2271571154,521027,2272092181,47,0,0,57344,47,2208596085
7230,2271572852,270427,2271843279,31,0,0,18944,31,4710230201
7231,2271582955,346911,2271929866,1,0,0,35840,1,2816362900
7232,2271584059,435212,2272019271,6,0,0,10240,6,4538319910
7233,2271584434,920650,2272505084,38,0,0,34304,38,9823639353
7234,2271592424,319337,2271911761,7,0,0,512,7,6872102928
7235,2271595679,136424,2271732103,22,0,0,10752,22,8205612511
7236,2271621557,481411,2272102968,15,0,0,35328,15,2815841095
7237,2271624902,369395,2271994297,45,0,0,21504,45,7110795253
7238,2271629208,10241,2271639449,21,0,1,16384,21,5624180573
7239,2271633214,409094,2272042308,34,0,0,8704,34,2320931195
7240,2271633937,718043,2272351980,41,0,0,29696,41,4467026799
7241,2271635229,9659,2271644888,13,0,1,13824,13,4329489467
7242,2271636719,323716,2271960435,11,0,0,1536,11,1562395372
7243,2271639212,383038,2272022250,26,0,0,9728,26,5623518870
7244,2271656430,503989,2272160419,21,0,0,31232,21,870422776
7245,2271658841,473898,2272132739,47,0,0,4096,47,5970718292
7246,2271661393,452846,2272114239,43,0,0,36864,43,5426503516
7247,2271702030,929862,2272631892,47,0,0,22016,47,8775221081
7248,2271714093,233375,2271947468,16,0,0,3072,16,9588576397
7249,2271721691,835683,2272557374,24,0,0,8192,24,4139563295
7250,2271729163,272210,2272001373,20,0,0,3584,20,6288035517
7251,2271732276,455406,2272187682,42,0,0,15872,42,602869116
7252,2271738743,739226,2272477969,13,0,0,15872,13,6119740003
7253,2271754228,488713,2272242941,20,0,0,17408,20,5714786469
7254,2271766837,603113,2272369950,30,0,0,38912,30,989195779
7255,2271779548,70345,2271849893,13,0,1,31744,13,900417150
7256,2271784167,872644,2272656811,6,0,0,5120,6,1468713836
7257,2271796225,53683,2271849908,12,0,1,512,12,5721651971
7258,2271798726,51197,2271849923,2,0,1,2048,2,7564512811
7259,2271808073,330164,2272138237,36,0,0,17920,36,5242339467
7260,2271830684,99221,2271929905,11,0,1,71168,11,1140135878
7261,2271831617,293752,2272125369,45,0,0,12800,45,9032972284
7262,2271836947,121020,2271957967,45,0,1,6656,45,5658710325
7263,2271838428,654092,2272492520,22,0,0,8192,22,7952308500
7264,2271845682,415992,2272261674,40,0,0,17408,40,5304766015
7265,2271850701,589942,2272440643,41,0,0,69632,41,10053074569
7266,2271878693,431145,2272309838,35,0,0,4608,35,3669465645
7267,2271883049,75264,2271958313,13,0,1,512,13,2278528992
7268,2271891100,230354,2272121454,2,0,0,23552,2,4145359050
7269,2271898643,756593,2272655236,16,0,0,23040,16,10734660868
7270,2271909392,474301,2272383693,4,0,0,45056,4,6830646250
7271,2271914658,538354,2272453012,11,0,0,9728,11,4368489030
7272,2271917444,275476,2272192920,22,0,0,11776,22,3083699622
7273,2271922100,435979,2272358079,0,0,0,19968,0,9599914561
7274,2271922926,147497,2272070423,48,0,0,3584,48,5212655893
7275,2271934879,476323,2272411202,4,0,0,10240,4,9198781324
7276,2271970585,558948,2272529533,33,0,0,52736,33,1731962158
7277,2271978341,418783,2272397124,28,0,0,44032,28,8682087042
7278,2272022654,418316,2272440970,1,0,0,1024,1,554564374
7279,2272038515,635126,2272673641,22,0,0,18944,22,6417522507
7280,2272071532,718421,2272789953,20,0,0,59392,20,8492430124
7281,2272075646,218215,2272293861,13,0,0,15360,13,1932020915
7282,2272078841,53921,2272132762,34,0,1,512,34,10613742729
7283,2272080511,1096978,2273177489,34,0,0,19968,34,5029384502
7284,2272088719,667663,2272756382,30,0,0,13824,30,375174197
7285,2272089404,851595,2272940999,30,0,0,61952,30,4749780447
7286,2272097139,551062,2272648201,16,0,0,4096,16,5561927575
7287,2272098138,506713,2272604851,13,0,0,56832,13,3280113257
7288,2272117639,22075,2272139714,46,0,1,1536,46,5934218119
7289,2272141057,484112,2272625169,36,0,0,6656,36,9442578185
7290,2272145116,396825,2272541941,22,0,0,4608,22,1154592292
7291,2272155574,6355,2272161929,36,0,1,1536,36,9226247212
7292,2272202462,303729,2272506191,46,0,0,3584,46,2416116820
7293,2272238290,504766,2272743056,19,0,0,23040,19,777241959
7294,2272240567,291945,2272532512,35,0,0,9728,35,3058687692
7295,2272242829,484757,2272727586,2,0,0,34304,2,9049791749
7296,2272286583,336535,2272623118,48,0,0,59904,48,7926274690
7297,2272297496,243010,2272540506,43,0,0,26112,43,8148326581
7298,2272310812,156224,2272467036,43,0,0,16896,43,6054354353
7299,2272315792,324547,2272640339,5,0,0,27648,5,681784890
7300,2272331562,315352,2272646914,23,0,0,21504,23,4084607655
7301,2272375806,341305,2272717111,4,0,0,70144,4,9705132946
7302,2272404743,10825,2272415568,46,0,1,4608,46,4833021543
7303,2272447887,531958,2272979845,41,0,0,31744,41,10330372219
7304,2272459526,198392,2272657918,18,0,0,3584,18,5980996354
7305,2272459695,566,2272460261,34,0,1,512,34,8206483155
7306,2272469350,550268,2273019618,21,0,0,5120,21,8767328298
7307,2272470699,342106,2272812805,20,0,0,28672,20,9635632298
7308,2272499348,10257,2272509605,4,0,1,3584,4,952432704
7309,2272511362,21173,2272532535,20,0,1,6144,20,6531759377
7310,2272515068,1101638,2273616706,2,0,0,23552,2,6760146033
7311,2272523587,738738,2273262325,0,0,0,102400,0,4803421598
7312,2272529081,309339,2272838420,15,0,0,36352,15,227362413
7313,2272535654,358921,2272894575,36,0,0,23552,36,7982909773
7314,2272540294,677245,2273217539,38,0,0,4096,38,5234404646
7315,2272567680,1132138,2273699818,9,0,0,5632,9,2155630192
7316,2272579889,526236,2273106125,15,0,0,2048,15,10613952151
7317,2272589820,527394,2273117214,2,0,0,6144,2,2061424244
7318,2272597677,455727,2273053404,21,0,0,47104,21,5668926103
7319,2272612719,565253,2273177972,47,0,0,1536,47,3326587171
7320,2272625255,475759,2273101014,34,0,0,116736,34,2572191134
7321,2272631476,433955,2273065431,5,0,0,39424,5,8998096526
7322,2272633368,265587,2272898955,49,0,0,2560,49,3486897134
7323,2272683521,322020,2273005541,34,0,0,16896,34,3633944090
7324,2272684841,4679,2272689520,22,0,1,12288,22,952684003
7325,2272701407,194119,2272895526,22,0,0,3072,22,39864445
7326,2272725287,596030,2273321317,20,0,0,24576,20,137930612
7327,2272726051,3546,2272729597,2,0,1,2048,2,10078068925
7328,2272728110,582233,2273310343,36,0,0,56832,36,4673630750
7329,2272728455,214587,2272943042,10,0,0,6656,10,729118185
7330,2272738381,7537,2272745918,8,0,1,8704,8,10263715087
7331,2272749176,650814,2273399990,1,0,0,17920,1,9092302861
7332,2272754605,283757,2273038362,47,0,0,6144,47,10014486062
7333,2272762233,427390,2273189623,24,0,0,6656,24,9951120714
7334,2272781597,167791,2272949388,3,0,0,2048,3,5914130433
7335,2272827447,540308,2273367755,30,0,0,27136,30,9098359605
7336,2272837390,124707,2272962097,49,0,0,12288,49,10554051537
7337,2272845151,3422,2272848573,12,0,1,3584,12,4319371267
7338,2272854382,1001229,2273855611,48,0,0,75264,48,3044997740
7339,2272859553,2470,2272862023,14,0,1,2560,14,7610311733
7340,2272879932,729583,2273609515,44,0,0,37888,44,10248766577
7341,2272896696,606181,2273502877,23,0,0,36864,23,2738640617
7342,2272921286,554745,2273476031,33,0,0,18432,33,4433373752
7343,2272921570,506433,2273428003,8,0,0,29184,8,10301082300
7344,2272921858,21199,2272943057,14,0,1,2560,14,4961499963
7345,2272936483,661473,2273597956,33,0,0,24064,33,5695051845
7346,2272941014,692953,2273633967,13,0,0,31232,13,3849154418
7347,2272958946,420532,2273379478,25,0,0,38400,25,9068467272
7348,2272970287,298933,2273269220,33,0,0,22528,33,1624717808
7349,2272973384,232179,2273205563,18,0,0,5120,18,7565999384
7350,2272973966,11740,2272985706,14,0,1,6144,14,9990196062
7351,2272975319,722768,2273698087,27,0,0,13312,27,10503739224
7352,2272983479,1192006,2274175485,1,0,0,25600,1,2000402042
7353,2272993175,5802,2272998977,2,0,1,6144,2,8091973092
7354,2273008381,2946,2273011327,49,0,1,3072,49,2331400672
7355,2273021902,291896,2273313798,9,0,0,11264,9,10590096926
7356,2273027592,503275,2273530867,39,0,0,32256,39,8554423385
7357,2273028604,595824,2273624428,6,0,0,12288,6,9429194797
7358,2273041508,932393,2273973901,38,0,0,38912,38,5594493495
7359,2273045869,1458209,2274504078,19,0,0,23552,19,7193728298
7360,2273052936,55041,2273107977,10,0,1,7168,10,7126289969
7361,2273053845,927723,2273981568,37,0,0,25088,37,7099538163
7362,2273056465,338035,2273394500,31,0,0,9216,31,8719335643
7363,2273068179,639268,2273707447,7,0,0,4608,7,2235567967
7364,2273068549,1222289,2274290838,14,0,0,31232,14,4397930526
7365,2273074044,618959,2273693003,34,0,0,88064,34,10029989896
7366,2273085851,626048,2273711899,19,0,0,8704,19,1436044509
7367,2273091855,740143,2273831998,13,0,0,15360,13,9193827532
7368,2273103219,7344,2273110563,4,0,1,4096,4,2388487182
7369,2273108091,935866,2274043957,19,0,0,107520,19,6939252734
7370,2273119562,1041065,2274160627,11,0,0,20480,11,2188755289
7371,2273120090,661569,2273781659,34,0,0,41984,34,6909164214
7372,2273130012,286165,2273416177,26,0,0,8704,26,7665804484
7373,2273136033,255636,2273391669,48,0,0,39936,48,4442336419
7374,2273165073,566,2273165639,41,0,1,512,41,5562456514
7375,2273176354,6289,2273182643,36,0,1,12288,36,2067556809
7376,2273182459,3422,2273185881,2,0,1,3584,2,7983544586
7377,2273186115,3539,2273189654,14,0,1,3584,14,7814240889
7378,2273188469,772084,2273960553,3,0,0,4096,3,10256270507
7379,2273189471,1036018,2274225489,2,0,0,19968,2,1072913790
7380,2273192765,448081,2273640846,49,0,0,22528,49,95555278
7381,2273195255,1371715,2274566970,10,0,0,24576,10,4359800908
7382,2273201755,3823,2273205578,46,0,1,3072,46,4219480145
7383,2273214763,578455,2273793218,22,0,0,37888,22,9932448555
7384,2273224604,1442861,2274667465,5,0,0,39936,5,7032144
7385,2273235259,631217,2273866476,26,0,0,8704,26,1841760057
7386,2273241082,494611,2273735693,15,0,0,14848,15,3801364894
7387,2273259442,829964,2274089406,28,0,0,32768,28,5209766683
7388,2273296912,1074831,2274371743,1,0,0,86016,1,3762235871
7389,2273300288,203228,2273503516,44,0,0,2048,44,5543935942
7390,2273303474,49610,2273353084,42,0,1,51712,42,181920364
7391,2273312788,43522,2273356310,32,0,1,5120,32,2988669212
7392,2273333409,435435,2273768844,9,0,0,31744,9,9403373049
7393,2273342567,351449,2273694016,11,0,0,3072,11,4664923942
7394,2273347882,242727,2273590609,40,0,0,33280,40,1443236827
7395,2273358434,858289,2274216723,28,0,0,22528,28,25300092
7396,2273359456,1200011,2274559467,27,0,0,32768,27,7286113313
7397,2273361740,32775,2273394515,43,0,1,2048,43,9543608305
7398,2273372276,33127,2273405403,32,0,1,13824,32,2458573089
7399,2273393250,267559,2273660809,34,0,0,24064,34,3833908331
7400,2273399406,679116,2274078522,44,0,0,23040,44,203872135
7401,2273407455,293962,2273701417,43,0,0,5120,43,1522687669
7402,2273408879,296765,2273705644,49,0,0,13824,49,5894171866
7403,2273411624,209037,2273620661,27,0,0,12800,27,5923075202
7404,2273423807,828294,2274252101,5,0,0,10752,5,3769670201
7405,2273435256,1042,2273436298,41,0,1,1024,41,2565030571
7406,2273441860,517430,2273959290,20,0,0,9728,20,879205166
7407,2273454476,598864,2274053340,36,0,0,30720,36,10473895356
7408,2273455587,850780,2274306367,17,0,0,32768,17,922255439
7409,2273456102,646126,2274102228,23,0,0,17408,23,2190616891
7410,2273457067,1288038,2274745105,13,0,0,1024,13,6589793398
7411,2273458311,609637,2274067948,49,0,0,30208,49,9436773549
7412,2273465256,4374,2273469630,22,0,1,4608,22,5600060731
7413,2273475949,733871,2274209820,40,0,0,112640,40,10314944512
7414,2273510810,544269,2274055079,26,0,0,5632,26,5596469136
7415,2273513183,245974,2273759157,45,0,0,13824,45,2494428059
7416,2273523213,169821,2273693034,27,0,1,239616,27,275158574
7417,2273525299,368688,2273893987,40,0,0,4608,40,7821319793
7418,2273548985,256985,2273805970,42,0,0,512,42,5938467312
7419,2273573540,1394431,2274967971,18,0,0,19456,18,7279347776
7420,2273576933,915087,2274492020,35,0,0,46080,35,7401967444
7421,2273583171,109878,2273693049,21,0,1,5632,21,1806336800
7422,2273594752,318216,2273912968,12,0,0,23552,12,7069266325
7423,2273614206,334002,2273948208,35,0,0,2560,35,1644371201
7424,2273626696,515202,2274141898,11,0,0,4608,11,2573002220
7425,2273642967,877551,2274520518,28,0,0,25088,28,1832687407
7426,2273643231,453678,2274096909,28,0,0,24576,28,6853403197
7427,2273645926,573464,2274219390,47,0,0,8704,47,990870811
7428,2273654657,655469,2274310126,26,0,0,12288,26,7565107895
7429,2273659609,589178,2274248787,24,0,0,68608,24,2404190393
7430,2273664031,490036,2274154067,41,0,0,18432,41,2414822033
7431,2273667165,38494,2273705659,41,0,1,512,41,9798164761
7432,2273674507,938825,2274613332,49,0,0,31232,49,6784863865
7433,2273683601,41519,2273725120,10,0,1,45568,10,3587997521
7434,2273684856,41570,2273726426,34,0,1,2048,34,4467624079
7435,2273701158,995539,2274696697,30,0,0,31232,30,2321568603
7436,2273707685,834577,2274542262,44,0,0,15872,44,5870481799
7437,2273720228,557271,2274277499,25,0,0,48640,25,7229504437
7438,2273731408,678975,2274410383,7,0,0,6144,7,10363101272
7439,2273732244,837237,2274569481,47,0,0,8192,47,7302103286
7440,2273742948,180075,2273923023,9,0,0,1024,9,9886792120
7441,2273751370,566,2273751936,29,0,1,512,29,7306879594
7442,2273758647,946653,2274705300,13,0,0,28160,13,1237195679
7443,2273800846,3645,2273804491,4,0,1,10240,4,2701025031
7444,2273817295,624202,2274441497,21,0,0,31232,21,9620149432
7445,2273829162,1211739,2275040901,0,0,0,5632,0,10479981165
7446,2273829303,227071,2274056374,29,0,0,4096,29,6213878524
7447,2273839561,18036,2273857597,0,0,1,2048,0,8974735448
7448,2273871981,295681,2274167662,41,0,0,23040,41,4825925832
7449,2273878881,669480,2274548361,19,0,0,19968,19,10287130950
7450,2273888812,33850,2273922662,15,0,1,55808,15,3365489938
7451,2273890400,858792,2274749192,6,0,0,13312,6,957818455
7452,2273898974,820173,2274719147,13,0,0,12800,13,10091084069
7453,2273902511,21457,2273923968,0,0,1,2048,0,3861226791
7454,2273910717,317127,2274227844,5,0,0,7680,5,6184852745
7455,2273919924,857168,2274777092,36,0,0,62976,36,3721431921
7456,2273926483,818295,2274744778,19,0,0,19968,19,5692998261
7457,2273946526,859875,2274806401,30,0,0,36352,30,1914126240
7458,2273957514,488087,2274445601,43,0,0,5632,43,2279049802
7459,2273965122,957696,2274922818,43,0,0,27136,43,6695010592
7460,2273967951,740952,2274708903,22,0,0,11776,22,6401690159
7461,2274001746,426127,2274427873,23,0,0,1536,23,2466018601
7462,2274003472,671964,2274675436,14,0,0,26112,14,6711928184
7463,2274013500,491841,2274505341,22,0,0,4096,22,5665915237
7464,2274018677,556610,2274575287,46,0,0,10752,46,6177486189
7465,2274021567,808718,2274830285,26,0,0,23552,26,10095863091
7466,2274025500,254354,2274279854,9,0,0,7680,9,8417482480
7467,2274029006,1114837,2275143843,31,0,0,4608,31,6867918933
7468,2274038765,474079,2274512844,49,0,0,24576,49,748560545
7469,2274042282,953739,2274996021,6,0,0,11264,6,7847076237
7470,2274042345,375073,2274417418,31,0,0,23040,31,5729757831
7471,2274044886,504582,2274549468,47,0,0,3584,47,7326921409
7472,2274049892,976636,2275026528,2,0,0,50176,2,3071764299
7473,2274058372,1075747,2275134119,45,0,0,13824,45,1489548886
7474,2274065508,1043891,2275109399,9,0,0,25088,9,402231202
7475,2274069407,1013706,2275083113,26,0,0,18944,26,4943832111
7476,2274078985,378496,2274457481,2,0,0,33280,2,9918571218
7477,2274110084,987897,2275097981,33,0,0,12288,33,5948820017
7478,2274115580,808033,2274923613,27,0,0,2560,27,9799701432
7479,2274118787,1021272,2275140059,38,0,0,3072,38,4099802691
7480,2274136146,1070813,2275206959,3,0,0,5120,3,5223188610
7481,2274151299,535867,2274687166,40,0,0,38400,40,4251867103
7482,2274162197,576482,2274738679,28,0,0,52224,28,4736016570
7483,2274171251,353190,2274524441,48,0,0,12800,48,9577167278
7484,2274176050,72752,2274248802,3,0,1,1024,3,6298567489
7485,2274183102,1072563,2275255665,0,0,0,128512,0,8119495839
7486,2274196536,646556,2274843092,1,0,0,41984,1,1409870614
7487,2274212803,284076,2274496879,7,0,0,15872,7,8406969570
7488,2274236747,718993,2274955740,18,0,0,11776,18,4695589169
7489,2274237035,22330,2274259365,10,0,1,7680,10,5065538288
7490,2274241075,961486,2275202561,41,0,0,25600,41,3759730505
7491,2274252007,1146771,2275398778,12,0,0,8704,12,1896847704
7492,2274256045,383309,2274639354,41,0,0,4608,41,10094882468
7493,2274256213,609539,2274865752,4,0,0,3584,4,7771065021
7494,2274290979,1048735,2275339714,5,0,0,39936,5,2458689321
7495,2274303400,1016784,2275320184,30,0,0,15872,30,8153007769
7496,2274311829,507676,2274819505,7,0,0,11264,7,3980958163
7497,2274326031,879353,2275205384,37,0,0,9216,37,8993898541
7498,2274329968,3387,2274333355,8,0,1,9728,8,8164961139
7499,2274332737,1112587,2275445324,20,0,0,28672,20,6168460405
7500,2274334833,1009607,2275344440,45,0,0,11776,45,10497352273
7501,2274365781,9082,2274374863,4,0,1,9216,4,5587333568
7502,2274405341,922190,2275327531,11,0,0,24064,11,403563424
7503,2274430278,422501,2274852779,31,0,0,5120,31,4457450197
7504,2274437035,319192,2274756227,29,0,0,23040,29,6884254119
7505,2274446450,468085,2274914535,2,0,0,34304,2,10211049706
7506,2274449002,329525,2274778527,19,0,0,4608,19,1667720027
7507,2274454829,591346,2275046175,25,0,0,1536,25,9406420949
7508,2274477949,34910,2274512859,4,0,1,24064,4,1747134974
7509,2274483357,1010202,2275493559,47,0,0,43520,47,3469548151
7510,2274511314,105102,2274616416,15,0,1,148992,15,4191927281
7511,2274534580,1229657,2275764237,6,0,0,41984,6,2544978556
7512,2274548103,84173,2274632276,11,0,1,59392,11,5704847940
7513,2274557142,848047,2275405189,27,0,0,20992,27,10561463175
7514,2274561123,75019,2274636142,4,0,1,6144,4,4337570493
7515,2274602612,38715,2274641327,43,0,1,24576,43,4046858163
7516,2274605092,406133,2275011225,19,0,0,4096,19,7704799778
7517,2274631141,44310,2274675451,15,0,1,47616,15,10217106559
7518,2274638258,530191,2275168449,48,0,0,3584,48,9364970363
7519,2274642824,987816,2275630640,45,0,0,21504,45,5626773349
7520,2274654428,686409,2275340837,11,0,0,3584,11,10567682384
7521,2274679998,224070,2274904068,5,0,0,18432,5,5714714288
7522,2274703799,1083135,2275786934,8,0,0,8704,8,636809563
7523,2274718050,1088054,2275806104,47,0,0,39424,47,4590649749
7524,2274738445,687979,2275426424,33,0,0,7680,33,10706313361
7525,2274741229,307178,2275048407,16,0,0,5632,16,4835456645
7526,2274751549,1223449,2275974998,25,0,0,37888,25,8722224434
7527,2274759197,769037,2275528234,7,0,0,18944,7,6911349396
7528,2274768416,13492,2274781908,46,0,1,3584,46,7120887986
7529,2274794539,11877,2274806416,21,0,1,2560,21,5661081701
7530,2274824987,490330,2275315317,0,0,0,30720,0,8652885379
7531,2274826654,289780,2275116434,24,0,0,23040,24,2213451876
7532,2274834058,333054,2275167112,46,0,0,14336,46,9268034827
7533,2274887879,503343,2275391222,30,0,0,2048,30,1312848280
7534,2274893363,112527,2275005890,15,0,1,182272,15,4308143341
7535,2274893515,223558,2275117073,17,0,0,2048,17,9085334654
7536,2274895904,240115,2275136019,2,0,0,3584,2,2416821662
7537,2274913956,92533,2275006489,13,0,1,9728,13,5552314444
7538,2274928595,256730,2275185325,31,0,0,3072,31,1434619123
7539,2274928611,606518,2275535129,7,0,0,22528,7,68831856
7540,2274939806,450777,2275390583,10,0,0,87040,10,1352093648
7541,2274954084,351858,2275305942,41,0,0,60928,41,10237451458
7542,2274965256,136484,2275101740,15,0,0,12288,15,3222721483
7543,2274993015,285275,2275278290,7,0,0,3072,7,9246614383
7544,2274994408,480090,2275474498,8,0,0,8192,8,5260302241
7545,2274998223,1065047,2276063270,48,0,0,61440,48,850688329
7546,2275005859,20684,2275026543,13,0,1,5120,13,4234549557
7547,2275017710,378363,2275396073,16,0,0,15872,16,1303619863
7548,2275037081,142858,2275179939,7,0,0,1536,7,7309337802
7549,2275045072,213760,2275258832,31,0,0,10240,31,10120225926
7550,2275056655,423021,2275479676,13,0,0,1536,13,2406544307
7551,2275064926,281885,2275346811,13,0,0,7680,13,5637402980
7552,2275075412,7716,2275083128,21,0,1,3072,21,3392350429
7553,2275080156,9718,2275089874,0,0,1,7168,0,2746543579
7554,2275090903,267569,2275358472,15,0,0,20480,15,7394883057
7555,2275120098,661019,2275781117,19,0,0,29696,19,7119032657
7556,2275132674,339313,2275471987,44,0,0,6144,44,255044571
7557,2275187693,410611,2275598304,45,0,0,20992,45,4017942177
7558,2275200232,418543,2275618775,1,0,0,16384,1,3130689791
7559,2275205946,230224,2275436170,20,0,0,6144,20,7389352829
7560,2275213835,346916,2275560751,46,0,0,23040,46,848210510
7561,2275228333,280560,2275508893,47,0,0,10240,47,5207760436
7562,2275229735,292712,2275522447,44,0,0,23552,44,9461777597
7563,2275241377,366637,2275608014,3,0,0,6656,3,1292000815
7564,2275241619,24427,2275266046,2,0,1,7680,2,3201571601
7565,2275255442,11910,2275267352,38,0,1,2048,38,4080269220
7566,2275255779,707660,2275963439,16,0,0,79360,16,1669732883
7567,2275258479,309461,2275567940,45,0,0,17408,45,3812579340
7568,2275267140,3898,2275271038,14,0,1,4096,14,937393471
7569,2275285235,193958,2275479193,3,0,0,15360,3,9125575904
7570,2275290241,330733,2275620974,19,0,0,7168,19,9836926082
7571,2275290375,347894,2275638269,9,0,0,11776,9,10349130385
7572,2275307778,43134,2275350912,21,0,1,15872,21,10466075144
7573,2275310770,478987,2275789757,6,0,0,9216,6,6200304956
7574,2275319963,292214,2275612177,8,0,0,9216,8,2835197014
7575,2275355859,379098,2275734957,3,0,0,68096,3,10443402689
7576,2275357208,38888,2275396096,30,0,1,24576,30,10371932777
7577,2275357642,38469,2275396111,49,0,1,8704,49,6069669897
7578,2275366607,274760,2275641367,29,0,0,3072,29,235213656
7579,2275411232,451580,2275862812,6,0,0,32256,6,5229183616
7580,2275421403,326704,2275748107,29,0,0,26112,29,4335061707
7581,2275426663,18676,2275445339,34,0,1,22016,34,4801557987
7582,2275434323,317075,2275751398,24,0,0,10752,24,6678647719
7583,2275445212,730624,2276175836,33,0,0,16384,33,1030940234
7584,2275448307,1994,2275450301,49,0,1,2048,49,2042551655
7585,2275449486,3128,2275452614,13,0,1,9216,13,3832226897
7586,2275458608,281528,2275740136,33,0,0,16896,33,170803600
7587,2275476175,513057,2275989232,13,0,0,3072,13,7654351082
7588,2275481220,385531,2275866751,40,0,0,12800,40,10395842842
7589,2275495977,856107,2276352084,28,0,0,87040,28,7682405591
7590,2275510778,1006394,2276517172,26,0,0,15872,26,3766155070
7591,2275519359,368782,2275888141,44,0,0,26112,44,9848271552
7592,2275522221,388080,2275910301,0,0,0,15872,0,7754446338
7593,2275527066,11043,2275538109,34,0,1,3072,34,6497956632
7594,2275527550,160392,2275687942,3,0,0,14848,3,9232366289
7595,2275532636,630405,2276163041,7,0,0,10752,7,255997406
7596,2275542964,5802,2275548766,8,0,1,6144,8,2019151920
7597,2275560688,259141,2275819829,46,0,0,4608,46,4462678612
7598,2275564044,1165140,2276729184,12,0,0,41984,12,992963144
7599,2275572378,280591,2275852969,35,0,0,26624,35,4492546998
7600,2275612872,228917,2275841789,38,0,0,2048,38,10196562330
7601,2275623334,536416,2276159750,48,0,0,59904,48,8162283181
7602,2275627126,456110,2276083236,46,0,0,39936,46,9663953099
7603,2275631415,356866,2275988281,25,0,0,43520,25,3665129831
7604,2275634822,755657,2276390479,15,0,0,27648,15,10544935783
7605,2275663605,271014,2275934619,30,0,0,4096,30,4375151630
7606,2275665914,255637,2275921551,27,0,0,1536,27,1540941062
7607,2275678363,590789,2276269152,25,0,0,40448,25,1036787344
7608,2275692415,734710,2276427125,16,0,0,33792,16,5220590472
7609,2275698668,1112518,2276811186,27,0,0,13824,27,9799456399
7610,2275698757,6754,2275705511,3,0,1,7168,3,7737911167
7611,2275699671,574007,2276273678,40,0,0,3072,40,8332915389
7612,2275717271,999098,2276716369,14,0,0,57344,14,8280259174
7613,2275719119,45165,2275764284,45,0,1,6656,45,1071012704
7614,2275733664,913635,2276647299,36,0,0,6656,36,4453184665
7615,2275740963,459063,2276200026,20,0,0,44032,20,3460699396
7616,2275742152,29775,2275771927,30,0,1,8192,30,839839863
7617,2275745956,1652773,2277398729,10,0,0,36864,10,3630697282
7618,2275753629,384758,2276138387,39,0,0,44544,39,7737570918
7619,2275756134,603507,2276359641,40,0,0,2560,40,4692499993
7620,2275757927,23205,2275781132,32,0,1,3072,32,2630136595
7621,2275774176,502587,2276276763,28,0,0,8192,28,593350986
7622,2275793097,462630,2276255727,8,0,0,10752,8,6128916715
7623,2275794060,427072,2276221132,46,0,0,54784,46,1723207840
7624,2275802890,799893,2276602783,8,0,0,57856,8,2138888450
7625,2275811086,5454,2275816540,43,0,1,13824,43,1578722797
7626,2275833372,1641163,2277474535,14,0,0,37376,14,4174205024
7627,2275854306,24220,2275878526,21,0,1,19456,21,2216820030
7628,2275856027,525982,2276382009,31,0,0,52736,31,656304851
7629,2275856559,48145,2275904704,11,0,1,52224,11,9056763771
7630,2275857795,501020,2276358815,17,0,0,22016,17,7442014732
7631,2275865359,339058,2276204417,39,0,0,14336,39,3265115290
7632,2275868213,497713,2276365926,40,0,0,16384,40,10609281347
7633,2275875578,34738,2275910316,29,0,1,6144,29,10443883914
7634,2275877850,634471,2276512321,42,0,0,34304,42,8827063290
7635,2275899916,10415,2275910331,43,0,1,1536,43,8128098668
7636,2275914168,249356,2276163524,35,0,0,1536,35,10644856393
7637,2275923967,574924,2276498891,9,0,0,1024,9,6476753082
7638,2275925621,239346,2276164967,5,0,0,4608,5,10406958491
7639,2275933269,696669,2276629938,35,0,0,27648,35,4989322092
7640,2275946641,1756939,2277703580,46,0,0,23040,46,8601885251
7641,2275983629,482051,2276465680,18,0,0,21504,18,2511793764
7642,2275996679,3422,2276000101,41,0,1,3584,41,10673402093
7643,2275996948,4779,2276001727,32,0,1,2560,32,6289683127
7644,2276016617,391310,2276407927,23,0,0,20480,23,9237810939
7645,2276037006,401990,2276438996,10,0,0,38912,10,1684506442
7646,2276045291,280258,2276325549,42,0,0,22016,42,217651410
7647,2276054021,306127,2276360148,36,0,0,1536,36,10494104752
7648,2276055840,1045499,2277101339,0,0,0,60928,0,10710229732
7649,2276061918,988724,2277050642,36,0,0,52224,36,10440564381
7650,2276089774,320040,2276409814,31,0,0,6144,31,8936635290
7651,2276095329,1721363,2277816692,25,0,0,34304,25,605189735
7652,2276101368,1009259,2277110627,19,0,0,1536,19,10603764626
7653,2276119933,398856,2276518789,28,0,0,5120,28,4513528579
7654,2276125084,314871,2276439955,11,0,0,3072,11,5309096675
7655,2276134295,2039996,2278174291,36,0,0,114176,36,4070670256
7656,2276143841,315272,2276459113,20,0,0,20992,20,1500347113
7657,2276150889,17935,2276168824,34,0,1,4096,34,2773582367
7658,2276155267,807612,2276962879,2,0,0,2048,2,1278927364
7659,2276165534,714804,2276880338,25,0,0,9728,25,6976475403
7660,2276175868,308314,2276484182,33,0,0,15872,33,2061026448
7661,2276194455,917591,2277112046,14,0,0,4608,14,1141649941
7662,2276201850,245475,2276447325,15,0,0,1024,15,8287309028
7663,2276204472,21502,2276225974,13,0,1,5120,13,4946951139
7664,2276256525,221480,2276478005,10,0,0,9216,10,9141068980
7665,2276262078,273565,2276535643,44,0,0,45056,44,9677579304
7666,2276278915,291016,2276569931,1,0,0,17408,1,1457579937
7667,2276279758,262601,2276542359,42,0,0,2048,42,3278505410
7668,2276285095,861133,2277146228,4,0,0,4608,4,5218500607
7669,2276288872,566,2276289438,41,0,1,512,41,10215464591
7670,2276289195,2157617,2278446812,11,0,0,14848,11,7476923724
7671,2276291774,67064,2276358838,11,0,1,49152,11,3506229369
7672,2276319975,350818,2276670793,48,0,0,33792,48,10172099897
7673,2276322138,964525,2277286663,40,0,0,28672,40,1557430920
7674,2276328679,53353,2276382032,14,0,1,6656,14,8660724811
7675,2276329857,619100,2276948957,17,0,0,66048,17,598937864
7676,2276330466,472679,2276803145,11,0,0,49152,11,10654196009
7677,2276334613,1088824,2277423437,12,0,0,14848,12,4968913043
7678,2276347521,868850,2277216371,8,0,0,12800,8,1305508332
7679,2276366049,32145,2276398194,20,0,1,8192,20,3127881797
7680,2276369062,313999,2276683061,14,0,0,12288,14,2952513098
7681,2276379626,408528,2276788154,7,0,0,52224,7,5112807889
7682,2276380411,490476,2276870887,12,0,0,41984,12,2857401745
7683,2276396770,410189,2276806959,22,0,0,10240,22,3579536719
7684,2276421624,540616,2276962240,35,0,0,43520,35,2579793173
7685,2276431884,602831,2277034715,25,0,0,3584,25,249067846
7686,2276446998,378086,2276825084,28,0,0,26112,28,8690666199
7687,2276460503,508334,2276968837,6,0,0,17408,6,7738887270
7688,2276461511,440979,2276902490,34,0,0,16896,34,1655018260
7689,2276479893,323915,2276803808,35,0,0,2048,35,4876245037
7690,2276480761,194624,2276675385,30,0,0,13312,30,2104090738
7691,2276481362,349458,2276830820,46,0,0,4608,46,8178582548
7692,2276481670,189629,2276671299,15,0,1,300032,15,7920029371
7693,2276489892,517247,2277007139,12,0,0,18944,12,8613480224
7694,2276490993,754184,2277245177,30,0,0,7168,30,10088224042
7695,2276528304,346838,2276875142,26,0,0,9216,26,6440792356
7696,2276530733,140581,2276671314,48,0,1,512,48,1308074062
7697,2276538748,297328,2276836076,18,0,0,5120,18,2186646744
7698,2276546117,564019,2277110136,43,0,0,12800,43,2170373506
7699,2276560785,2037673,2278598458,49,0,0,18944,49,6514474351
7700,2276572794,98490,2276671284,13,0,0,1536,13,1044688328
7701,2276576226,99174,2276675400,13,0,1,15360,13,2991623214
7702,2276601915,999194,2277601109,15,0,0,33280,15,1688926020
7703,2276622200,401333,2277023533,49,0,0,27648,49,8778507398
7704,2276622329,905190,2277527519,12,0,0,18432,12,8472939863
7705,2276631804,818606,2277450410,26,0,0,57344,26,1218341148
7706,2276637986,325532,2276963518,36,0,0,2048,36,7046891019
7707,2276641729,537445,2277179174,37,0,0,46592,37,278860969
7708,2276651906,451016,2277102922,39,0,0,5120,39,717868184
7709,2276660783,1993241,2278654024,40,0,0,3584,40,1298938460
7710,2276677384,897573,2277574957,28,0,0,23040,28,6068698216
7711,2276682312,208478,2276890790,38,0,0,5120,38,3415797799
7712,2276688530,456279,2277144809,38,0,0,20992,38,9915647813
7713,2276689153,838537,2277527690,49,0,0,512,49,3146698574
7714,2276694830,331058,2277025888,14,0,0,7680,14,4667301437
7715,2276713169,544104,2277257273,26,0,0,14848,26,97013223
7716,2276735800,2043450,2278779250,48,0,0,5120,48,3327242081
7717,2276741596,475258,2277216854,13,0,0,1536,13,5718464162
7718,2276744098,2408301,2279152399,8,0,0,34816,8,8346402350
7719,2276749303,1034196,2277783499,47,0,0,9216,47,4462832708
7720,2276751914,2946,2276754860,32,0,1,3072,32,544229098
7721,2276756891,4162,2276761053,14,0,1,11264,14,748400773
7722,2276759333,1071468,2277830801,14,0,0,19456,14,4057855320
7723,2276769364,1276093,2278045457,3,0,0,13824,3,3116993584
7724,2276777504,609978,2277387482,38,0,0,55296,38,4218480276
7725,2276777596,593023,2277370619,31,0,0,54784,31,5972571684
7726,2276786234,378729,2277164963,29,0,0,61440,29,7600951970
7727,2276792886,626012,2277418898,5,0,0,6144,5,9944530434
7728,2276794568,2430386,2279224954,10,0,0,31744,10,887687762
7729,2276815381,724234,2277539615,43,0,0,33792,43,3924905355
7730,2276846950,259263,2277106213,17,0,0,10752,17,8178509561
7731,2276849322,361553,2277210875,16,0,0,19968,16,5075327765
7732,2276854389,1227275,2278081664,8,0,0,26112,8,9617013595
7733,2276868029,912639,2277780668,34,0,0,43008,34,4341196644
7734,2276869597,547414,2277417011,13,0,0,32768,13,10209406636
7735,2276880045,1075298,2277955343,13,0,0,88064,13,4043060035
7736,2276890600,1328281,2278218881,4,0,0,1024,4,1126969176
7737,2276891054,3387,2276894441,12,0,1,9728,12,2772527404
7738,2276892760,768435,2277661195,15,0,0,109056,15,5075182006
7739,2276907180,789365,2277696545,7,0,0,57856,7,9547756785
7740,2276917738,808656,2277726394,33,0,0,22528,33,5624086171
7741,2276933196,577736,2277510932,28,0,0,5120,28,4794162372
7742,2276966031,3364,2276969395,20,0,1,512,20,8284786447
7743,2276975667,2431123,2279406790,21,0,0,11264,21,3893674845
7744,2276985177,1039708,2278024885,24,0,0,33280,24,2004667992
7745,2276989310,1994,2276991304,48,0,1,2048,48,9445918825
7746,2276995646,435762,2277431408,9,0,0,26112,9,8596545596
7747,2276997710,676003,2277673713,2,0,0,12288,2,9321011885
7748,2276998837,330984,2277329821,38,0,0,11264,38,3289078001
7749,2277008758,701331,2277710089,17,0,0,512,17,2834014321
7750,2277035302,27140,2277062442,15,0,1,19456,15,5946546348
7751,2277040533,1272893,2278313426,30,0,0,21504,30,916918077
7752,2277061368,345644,2277407012,18,0,0,27136,18,8931136487
7753,2277063468,391692,2277455160,9,0,0,8704,9,3128000210
7754,2277070137,1133161,2278203298,39,0,0,12288,39,9326435900
7755,2277084866,430293,2277515159,16,0,0,13824,16,6746120982
7756,2277094653,496301,2277590954,13,0,0,29696,13,1911230131
7757,2277098067,15957,2277114024,34,0,1,2048,34,1615611498
7758,2277108086,698123,2277806209,35,0,0,39424,35,10480040261
7759,2277112854,1070212,2278183066,11,0,0,28672,11,6605137979
7760,2277128771,304056,2277432827,11,0,0,4608,11,4760275950
7761,2277145980,2409272,2279555252,48,0,0,3584,48,8868827750
7762,2277155216,165017,2277320233,25,0,0,6656,25,646511504
7763,2277161080,715137,2277876217,37,0,0,43520,37,8191663265
7764,2277168426,284059,2277452485,11,0,0,6656,11,6484534278
7765,2277231566,438380,2277669946,17,0,0,28672,17,4413105698
7766,2277234388,533161,2277767549,17,0,0,30208,17,1012547253
7767,2277258987,468834,2277727821,0,0,0,4608,0,1868139625
7768,2277264231,210475,2277474706,38,0,0,512,38,8030285817
7769,2277269832,4374,2277274206,13,0,1,4608,13,10271773478
7770,2277291041,672956,2277963997,1,0,0,19968,1,4171796853
7771,2277341038,154690,2277495728,2,0,0,5632,2,6116307901
7772,2277346884,561907,2277908791,49,0,0,27136,49,5932732814
7773,2277352036,134495,2277486531,11,0,1,221696,11,5889034319
7774,2277356285,569076,2277925361,11,0,0,36352,11,1195577301
7775,2277359055,392773,2277751828,45,0,0,4608,45,3812108806
7776,2277364122,123075,2277487197,28,0,1,1024,28,9473885708
7777,2277374902,115521,2277490423,36,0,1,5120,36,8094086178
7778,2277381652,109335,2277490987,43,0,1,10752,43,9910929165
7779,2277383684,441174,2277824858,36,0,0,22528,36,483389952
7780,2277395593,97020,2277492613,34,0,1,2560,34,1130245657
7781,2277406510,657849,2278064359,29,0,0,25600,29,8336228206
7782,2277411863,442164,2277854027,42,0,0,30208,42,4968963811
7783,2277419517,398462,2277817979,20,0,0,4096,20,3716634259
7784,2277423946,201402,2277625348,31,0,0,5120,31,8840390170
7785,2277429669,433265,2277862934,39,0,0,29184,39,4843332128
7786,2277443002,52741,2277495743,49,0,1,4096,49,7578769542
7787,2277465874,33831,2277499705,35,0,1,7168,35,2832175816
7788,2277470287,2186285,2279656572,16,0,0,66048,16,6959353146
7789,2277497135,239801,2277736936,15,0,0,6144,15,2756420614
7790,2277506417,608818,2278115235,30,0,0,110080,30,10692942004
7791,2277520399,391855,2277912254,41,0,0,11264,41,3860972444
7792,2277531459,15395,2277546854,12,0,1,7680,12,8370311757
7793,2277538517,8593,2277547110,48,0,1,9216,48,3693675949
7794,2277548732,499773,2278048505,14,0,0,8704,14,7077541678
7795,2277551421,2248672,2279800093,46,0,0,64000,46,7196965211
7796,2277552157,376339,2277928496,39,0,0,10240,39,2473239020
7797,2277563070,2946,2277566016,2,0,1,3072,2,6560375598
7798,2277600516,596488,2278197004,22,0,0,18432,22,9129319316
7799,2277617812,261384,2277879196,5,0,0,9728,5,2181163807
7800,2277620921,367374,2277988295,18,0,0,19968,18,7045168606
7801,2277636394,639223,2278275617,2,0,0,26624,2,2605480145
7802,2277670959,528564,2278199523,23,0,0,8192,23,5938434034
7803,2277689434,276783,2277966217,17,0,0,2048,17,2700732769
7804,2277692189,281502,2277973691,43,0,0,17408,43,6419394824
7805,2277696632,2200007,2279896639,39,0,0,91648,39,4044961712
7806,2277707436,809925,2278517361,45,0,0,53248,45,5049982380
7807,2277709827,363866,2278073693,11,0,0,11776,11,7334646812
7808,2277712955,678405,2278391360,36,0,0,2048,36,8195107043
7809,2277720924,10501,2277731425,41,0,1,10240,41,2448082381
7810,2277726495,664226,2278390721,36,0,0,43520,36,8051624793
7811,2277730779,992,2277731771,14,0,1,512,14,6229487557
7812,2277731867,1518,2277733385,34,0,1,1536,34,282266082
7813,2277737904,666843,2278404747,34,0,0,22528,34,3013965067
7814,2277753378,745927,2278499305,4,0,0,11264,4,1676054574
7815,2277755235,551624,2278306859,18,0,0,32256,18,10702629141
7816,2277773462,13925,2277787387,0,0,1,10752,0,8467635870
7817,2277777940,457777,2278235717,36,0,0,20992,36,2610197016
7818,2277789873,260051,2278049924,25,0,0,4608,25,771609314
7819,2277798926,31914,2277830840,43,0,1,5120,43,8545196857
7820,2277800516,30339,2277830855,36,0,1,7168,36,8297438508
7821,2277803939,387426,2278191365,41,0,0,27136,41,1712833748
7822,2277811575,684283,2278495858,38,0,0,22528,38,5601419854
7823,2277819383,12034,2277831417,12,0,1,512,12,1087604323
7824,2277820129,2236444,2280056573,9,0,0,30208,9,8603590201
7825,2277831036,784129,2278615165,43,0,0,54784,43,8248047485
7826,2277857941,22732,2277880673,43,0,1,1536,43,6050316615
7827,2277880466,599411,2278479877,36,0,0,1024,36,1045801452
7828,2277885224,510229,2278395453,5,0,0,5632,5,3464788725
7829,2277889020,486177,2278375197,48,0,0,9728,48,9188234214
7830,2277902811,52547,2277955358,20,0,1,20992,20,9557320779
7831,2277907150,572400,2278479550,18,0,0,49664,18,9806906095
7832,2277927003,651601,2278578604,6,0,0,5632,6,7002704466
7833,2277966982,7706,2277974688,8,0,1,8192,8,4511333865
7834,2277967146,11775,2277978921,13,0,1,13312,13,4664174296
7835,2277968264,12283,2277980547,46,0,1,2560,46,7123161045
7836,2277972766,340987,2278313753,10,0,0,1024,10,7339468872
7837,2278012033,12875,2278024908,45,0,1,24576,45,928280842
7838,2278012825,253298,2278266123,20,0,0,2048,20,10603783562
7839,2278044417,607935,2278652352,37,0,0,17408,37,9313277568
7840,2278045228,220248,2278265476,14,0,0,4096,14,9113497544
7841,2278052771,690669,2278743440,33,0,0,16384,33,2117998767
7842,2278060790,263517,2278324307,21,0,0,16896,21,9361053832
7843,2278061412,775518,2278836930,40,0,0,80896,40,5291219425
7844,2278067576,578394,2278645970,23,0,0,5120,23,5442413989
7845,2278071755,450457,2278522212,8,0,0,15872,8,7030003402
7846,2278073426,319065,2278392491,24,0,0,3584,24,3270207075
7847,2278083253,546123,2278629376,7,0,0,46592,7,4599047032
7848,2278087751,287929,2278375680,3,0,0,1536,3,8924460337
7849,2278108436,207368,2278315804,45,0,0,6656,45,2523546273
7850,2278145185,718334,2278863519,38,0,0,27136,38,5846156782
7851,2278149755,577673,2278727428,43,0,0,18944,43,7555033511
7852,2278155750,297369,2278453119,11,0,0,19968,11,1948104446
7853,2278164092,997120,2279161212,15,0,0,2048,15,7786321686
7854,2278164175,720263,2278884438,41,0,0,68608,41,5437225867
7855,2278165785,675380,2278841165,27,0,0,13824,27,9172613007
7856,2278179773,25002,2278204775,28,0,1,1536,28,4173106640
7857,2278184648,455936,2278640584,0,0,0,11776,0,5632640815
7858,2278194623,265644,2278460267,15,0,0,7168,15,3729182087
7859,2278199919,11545,2278211464,28,0,1,8192,28,5295815471
7860,2278205746,448917,2278654663,49,0,0,2048,49,7914704509
7861,2278212519,774085,2278986604,10,0,0,26624,10,4628920171
7862,2278227050,751427,2278978477,44,0,0,36864,44,1229718296
7863,2278229242,296901,2278526143,24,0,0,12800,24,8089472123
7864,2278237960,458394,2278696354,2,0,0,17920,2,2380294219
7865,2278239779,2161767,2280401546,26,0,0,55808,26,824432193
7866,2278264341,1070111,2279334452,3,0,0,37888,3,8522161471
7867,2278265448,804699,2279070147,14,0,0,4096,14,6518322426
7868,2278281141,4850,2278285991,49,0,1,5120,49,5719839237
7869,2278281300,860476,2279141776,19,0,0,32256,19,6679689319
7870,2278284501,513221,2278797722,8,0,0,22016,8,4969552006
7871,2278296155,516082,2278812237,41,0,0,23040,41,7287271632
7872,2278305113,596140,2278901253,49,0,0,33280,49,6111400946
7873,2278317759,1005134,2279322893,4,0,0,23040,4,4621892095
7874,2278318673,402968,2278721641,15,0,0,19968,15,9381826802
7875,2278319968,90268,2278410236,15,0,1,143872,15,6808641351
7876,2278328806,668070,2278996876,19,0,0,12800,19,6174396712
7877,2278336872,795061,2279131933,18,0,0,25600,18,7961146935
7878,2278345166,541315,2278886481,38,0,0,6656,38,577258848
7879,2278367145,559499,2278926644,2,0,0,25600,2,219577258
7880,2278379551,2143387,2280522938,16,0,0,83968,16,351044210
7881,2278383850,860105,2279243955,31,0,0,7680,31,9682400734
7882,2278384721,25976,2278410697,8,0,1,10240,8,4790427067
7883,2278389672,517992,2278907664,11,0,0,20992,11,8019656390
7884,2278397467,867885,2279265352,30,0,0,59904,30,6039941343
7885,2278407061,875691,2279282752,0,0,0,36352,0,6346450438
7886,2278419565,114799,2278534364,15,0,1,120320,15,5034545257
7887,2278421371,1132774,2279554145,16,0,0,2048,16,6390095621
7888,2278422203,927957,2279350160,48,0,0,27136,48,7026317499
7889,2278423638,606416,2279030054,44,0,0,26112,44,2617486454
7890,2278426894,428326,2278855220,36,0,0,46080,36,6752511451
7891,2278427221,504500,2278931721,4,0,0,4608,4,7692194794
7892,2278435141,628989,2279064130,25,0,0,512,25,6107009097
7893,2278447439,207239,2278654678,8,0,1,17920,8,6833521002
7894,2278452268,747162,2279199430,7,0,0,3072,7,10320193832
7895,2278459272,808903,2279268175,1,0,0,9216,1,4280104201
7896,2278478023,520592,2278998615,36,0,0,5632,36,8048377109
7897,2278492857,1039379,2279532236,26,0,0,32768,26,9570240843
7898,2278506127,506463,2279012590,49,0,0,27648,49,5729399622
7899,2278508831,152563,2278661394,46,0,1,11776,46,6748254221
7900,2278522053,140327,2278662380,11,0,1,1536,11,6609119017
7901,2278524262,230447,2278754709,21,0,0,5632,21,2947067108
7902,2278541452,809503,2279350955,28,0,0,2560,28,2039950942
7903,2278541471,425759,2278967230,39,0,0,15872,39,8817941436
7904,2278554491,108657,2278663148,10,0,1,11776,10,1098029859
7905,2278555451,160091,2278715542,37,0,0,12800,37,6567719778
7906,2278557689,1117220,2279674909,22,0,0,38400,22,8441182211
7907,2278562333,821592,2279383925,27,0,0,39424,27,7789245239
7908,2278565495,824997,2279390492,39,0,0,21504,39,10704161820
7909,2278569558,380487,2278950045,0,0,0,14336,0,7407065547
7910,2278582397,971093,2279553490,40,0,0,63488,40,2683037324
7911,2278585717,642863,2279228580,27,0,0,11776,27,597402100
7912,2278587408,488914,2279076322,34,0,0,8704,34,5894831312
7913,2278619255,1017178,2279636433,49,0,0,57344,49,7364166875
7914,2278628178,1958716,2280586894,41,0,0,6144,41,9647001204
7915,2278644616,548177,2279192793,1,0,0,12288,1,7501307341
7916,2278652155,585355,2279237510,0,0,0,3584,0,10525417577
7917,2278654173,12201,2278666374,15,0,1,5120,15,7099709260
7918,2278655607,517231,2279172838,21,0,0,24576,21,6161019726
7919,2278659063,837061,2279496124,17,0,0,58880,17,6823489101
7920,2278664226,6754,2278670980,29,0,1,7168,29,7608973124
7921,2278665670,494887,2279160557,20,0,0,21504,20,2918452656
7922,2278684574,439217,2279123791,39,0,0,18944,39,1843514335
7923,2278693576,61148,2278754724,41,0,1,3072,41,2025337899
7924,2278730465,660354,2279390819,40,0,0,1024,40,624752710
7925,2278744421,379697,2279124118,18,0,0,1024,18,5975308603
7926,2278758611,359393,2279118004,35,0,0,39424,35,3652823519
7927,2278762150,951398,2279713548,34,0,0,37888,34,1300567072
7928,2278768857,1006316,2279775173,31,0,0,10752,31,947990542
7929,2278770718,41534,2278812252,22,0,1,4608,22,8445330775
7930,2278772512,425147,2279197659,3,0,0,8192,3,7616955288
7931,2278772992,39275,2278812267,20,0,1,3072,20,230749502
7932,2278783664,879522,2279663186,34,0,0,19456,34,6385734229
7933,2278785776,1904081,2280689857,35,0,0,1536,35,1030973030
7934,2278811988,402335,2279214323,14,0,0,35840,14,1226948841
7935,2278825455,993279,2279818734,37,0,0,16896,37,3106210890
7936,2278832013,627535,2279459548,24,0,0,16384,24,7236089919
7937,2278882496,835443,2279717939,8,0,0,14336,8,4148792616
7938,2278884348,839416,2279723764,42,0,0,12288,42,10461822696
7939,2278900960,335435,2279236395,0,0,0,25600,0,7874088871
7940,2278909754,244228,2279153982,20,0,0,5120,20,1648414345
7941,2278938924,1102783,2280041707,13,0,0,40448,13,2078431417
7942,2278947778,394099,2279341877,40,0,0,9728,40,4020188922
7943,2278979629,540245,2279519874,17,0,0,3584,17,6753139533
7944,2278984336,534431,2279518767,48,0,0,74240,48,7730377594
7945,2278987146,11791,2278998937,21,0,1,19456,21,7455834087
7946,2278995054,594173,2279589227,48,0,0,34304,48,7156610143
7947,2278997495,197653,2279195148,46,0,0,7680,46,8785251269
7948,2279008152,561669,2279569821,20,0,0,29184,20,9046989009
7949,2279022237,373541,2279395778,27,0,0,2560,27,7590332054
7950,2279029014,560556,2279589570,36,0,0,1024,36,7736555425
7951,2279029863,655848,2279685711,3,0,0,31232,3,9758748511
7952,2279043748,675930,2279719678,13,0,0,5632,13,118576345
7953,2279051600,482531,2279534131,23,0,0,6144,23,3100211632
7954,2279053471,1031834,2280085305,43,0,0,38912,43,7011670688
7955,2279064350,457879,2279522229,44,0,0,7680,44,5663611162
7956,2279077698,1042,2279078740,46,0,1,1024,46,8513229204
7957,2279079291,375242,2279454533,9,0,0,56832,9,9383304883
7958,2279097678,3422,2279101100,4,0,1,3584,4,715108215
7959,2279141677,671886,2279813563,29,0,0,30208,29,2654682508
7960,2279145102,16957,2279162059,32,0,1,1536,32,700541775
7961,2279151278,315000,2279466278,39,0,0,6144,39,5326829734
7962,2279177482,401246,2279578728,1,0,0,29184,1,217539233
7963,2279184628,1663060,2280847688,11,0,0,37376,11,6190908763
7964,2279205282,19695,2279224977,20,0,1,5120,20,3445496947
7965,2279208326,2135712,2281344038,42,0,0,15872,42,2684311383
7966,2279218769,1010677,2280229446,44,0,0,43520,44,10008710052
7967,2279224204,433015,2279657219,6,0,0,2048,6,3161034564
7968,2279230991,869313,2280100304,47,0,0,49152,47,10497613799
7969,2279238682,947589,2280186271,7,0,0,28160,7,4433002774
7970,2279248780,312118,2279560898,44,0,0,11776,44,1426117052
7971,2279310490,246805,2279557295,45,0,0,6656,45,1809910318
7972,2279321261,512486,2279833747,5,0,0,7680,5,1350903065
7973,2279351601,388158,2279739759,6,0,0,7168,6,9291383515
7974,2279359187,993967,2280353154,1,0,0,51200,1,9518812830
7975,2279394142,458568,2279852710,41,0,0,2048,41,5057567961
7976,2279417153,641019,2280058172,18,0,0,5120,18,7019081153
7977,2279422970,253202,2279676172,27,0,0,4096,27,4524171152
7978,2279437006,764586,2280201592,24,0,0,22528,24,3896923386
7979,2279449377,484200,2279933577,17,0,0,92672,17,3553033889
7980,2279452578,10860,2279463438,46,0,1,4096,46,2577193207
7981,2279465594,264868,2279730462,18,0,0,1536,18,3651444521
7982,2279479752,240253,2279720005,41,0,0,1024,41,5820222403
7983,2279495888,367321,2279863209,20,0,0,23040,20,6736127965
7984,2279500489,368195,2279868684,16,0,0,17920,16,8750328132
7985,2279512157,447392,2279959549,27,0,0,13312,27,1531701818
7986,2279516399,813309,2280329708,27,0,0,73216,27,10212535883
7987,2279536806,415677,2279952483,39,0,0,44032,39,3868531072
7988,2279540179,625209,2280165388,1,0,0,1536,1,4367158462
7989,2279560763,402724,2279963487,0,0,0,1536,0,1410665404
7990,2279564022,171687,2279735709,5,0,0,8704,5,10170978978
7991,2279566915,24265,2279591180,15,0,1,2048,15,6306222776
7992,2279570763,695050,2280265813,6,0,0,15872,6,4171784535
7993,2279580344,223976,2279804320,14,0,0,13824,14,9033459244
7994,2279595673,367331,2279963004,34,0,0,11264,34,9901742617
7995,2279600709,446629,2280047338,44,0,0,18432,44,5683445436
7996,2279602181,295596,2279897777,44,0,0,3584,44,10612196521
7997,2279616277,78065,2279694342,18,0,0,1536,18,9318027115
7998,2279620024,335454,2279955478,29,0,0,9728,29,1818984865
7999,2279626840,622553,2280249393,39,0,0,512,39,5572022781
8000,2279628107,397346,2280025453,9,0,0,35840,9,6313772055
8001,2279628804,476702,2280105506,29,0,0,7168,29,2451821204
8002,2279648786,365000,2280013786,10,0,0,7168,10,7847049731
8003,2279651819,38530,2279690349,0,0,1,12288,0,5191096122
8004,2279678495,260557,2279939052,19,0,0,17920,19,7671937634
8005,2279680529,12071,2279692600,12,0,1,9216,12,4787311256
8006,2279702104,440500,2280142604,17,0,0,105472,17,5898338191
8007,2279706612,715579,2280422191,23,0,0,42496,23,6005641733
8008,2279718341,1108696,2280827037,35,0,0,33280,35,4922603868
8009,2279728485,15579,2279744064,41,0,1,30208,41,7004656623
8010,2279737682,788079,2280525761,1,0,0,9216,1,5466578398
8011,2279747076,788183,2280535259,7,0,0,17408,7,6055716886
8012,2279769773,805695,2280575468,49,0,0,43520,49,6137555042
8013,2279773046,660236,2280433282,18,0,0,36352,18,8611141349
8014,2279777966,251402,2280029368,11,0,0,12800,11,5669729677
8015,2279789754,384562,2280174316,10,0,0,5632,10,9747546328
8016,2279790136,996130,2280786266,31,0,0,40960,31,829934780
8017,2279798164,1002945,2280801109,40,0,0,48640,40,4983765236
8018,2279799704,21935,2279821639,13,0,1,3072,13,1715107515
8019,2279815268,772421,2280587689,42,0,0,2560,42,5862788402
8020,2279816318,331917,2280148235,13,0,0,18432,13,2664786316
8021,2279817782,546323,2280364105,36,0,0,35840,36,5326671645
8022,2279819905,483812,2280303717,23,0,0,22528,23,7029274847
8023,2279827291,349816,2280177107,20,0,0,2048,20,8587742849
8024,2279836392,1160596,2280996988,41,0,0,94720,41,9635643125
8025,2279837683,499848,2280337531,28,0,0,25600,28,8327965609
8026,2279850442,46212,2279896654,34,0,1,38912,34,9198869355
8027,2279850848,252451,2280103299,10,0,0,9728,10,10117033718
8028,2279861850,726946,2280588796,18,0,0,3584,18,3131752515
8029,2279881338,574514,2280455852,35,0,0,66560,35,4340335344
8030,2279882784,786272,2280669056,23,0,0,45568,23,6483493567
8031,2279901616,1521324,2281422940,8,0,0,122368,8,585905525
8032,2279911409,1098537,2281009946,20,0,0,14848,20,9874653402
8033,2279913965,1776268,2281690233,15,0,0,34304,15,3709204343
8034,2279920304,786120,2280706424,17,0,0,54272,17,8464488937
8035,2279979453,429767,2280409220,9,0,0,17920,9,5090582951
8036,2280012585,898346,2280910931,43,0,0,13312,43,509934811
8037,2280032750,370995,2280403745,43,0,0,7168,43,7187021243
8038,2280035467,24683,2280060150,12,0,1,2048,12,9240747608
8039,2280039137,439469,2280478606,31,0,0,17920,31,9427543742
8040,2280041524,543483,2280585007,26,0,0,31232,26,8007603925
8041,2280041571,1107865,2281149436,47,0,0,189440,47,9574001848
8042,2280045709,566489,2280612198,3,0,0,9728,3,2303121552
8043,2280070764,618610,2280689374,18,0,0,63488,18,4654122794
8044,2280074471,32021,2280106492,35,0,1,15360,35,7277064495
8045,2280085652,62622,2280148274,22,0,1,55808,22,8432006344
8046,2280094174,54115,2280148289,18,0,1,4096,18,6407959994
8047,2280100441,789115,2280889556,38,0,0,2560,38,7743091976
8048,2280109028,1124714,2281233742,0,0,0,46592,0,7487268761
8049,2280111384,44607,2280155991,47,0,1,8192,47,5782353717
8050,2280112545,1427504,2281540049,28,0,0,38400,28,7787110368
8051,2280149503,621513,2280771016,46,0,0,5120,46,6083899417
8052,2280183287,705458,2280888745,13,0,0,53248,13,8874136625
8053,2280228144,4240,2280232384,15,0,1,3072,15,9298172222
8054,2280248632,1119335,2281367967,6,0,0,9728,6,2264550903
8055,2280254962,415053,2280670015,11,0,0,3072,11,10063236033
8056,2280270420,1615240,2281885660,47,0,0,53760,47,4459232335
8057,2280292451,3128,2280295579,48,0,1,9216,48,908006451
8058,2280308008,1354692,2281662700,18,0,0,155648,18,4465330847
8059,2280313385,692022,2281005407,6,0,0,7168,6,428056250
8060,2280320056,832359,2281152415,10,0,0,9728,10,7066884257
8061,2280321982,864865,2281186847,18,0,0,512,18,6725763253
8062,2280341189,862871,2281204060,39,0,0,6144,39,4319839093
8063,2280344683,22452,2280367135,2,0,1,3072,2,9068502107
8064,2280352020,17784,2280369804,36,0,1,12288,36,4155987744
8065,2280353575,1011405,2281364980,24,0,0,51712,24,6025851043
8066,2280360359,687953,2281048312,41,0,0,21504,41,1659791741
8067,2280368901,917137,2281286038,29,0,0,22016,29,3849216594
8068,2280371904,521417,2280893321,5,0,0,1024,5,4834931406
8069,2280373750,362601,2280736351,20,0,0,23040,20,9655840898
8070,2280402692,406247,2280808939,14,0,0,9216,14,6212770174
8071,2280417765,754711,2281172476,36,0,0,41472,36,2779610137
8072,2280456037,1617775,2282073812,21,0,0,47616,21,4238274632
8073,2280484944,1611122,2282096066,47,0,0,3584,47,7796148603
8074,2280487367,991116,2281478483,15,0,0,7680,15,5627679635
8075,2280506097,29177,2280535274,2,0,1,13312,2,5827478150
8076,2280512277,23012,2280535289,4,0,1,4608,4,154430169
8077,2280515715,702611,2281218326,49,0,0,2048,49,8644129305
8078,2280519991,819196,2281339187,22,0,0,89088,22,9659362059
8079,2280562514,295797,2280858311,23,0,0,34816,23,9159456714
8080,2280585891,569363,2281155254,41,0,0,9216,41,6977754329
8081,2280606358,12737,2280619095,36,0,1,24576,36,9394515351
8082,2280610866,981875,2281592741,49,0,0,46080,49,9633518894
8083,2280614297,302730,2280917027,34,0,0,3072,34,1641353703
8084,2280623605,751101,2281374706,44,0,0,22016,44,3737383710
8085,2280624398,1050181,2281674579,31,0,0,38912,31,8246519136
8086,2280627390,670378,2281297768,4,0,0,23040,4,9949274608
8087,2280642854,857182,2281500036,42,0,0,3072,42,8325608100
8088,2280644928,5802,2280650730,14,0,1,6144,14,6501970795
8089,2280655927,516736,2281172663,46,0,0,512,46,9443609743
8090,2280672675,708169,2281380844,15,0,0,13824,15,2600131485
8091,2280676269,257546,2280933815,14,0,0,12800,14,5370929397
8092,2280687338,530349,2281217687,24,0,0,26112,24,435614385
8093,2280688221,747907,2281436128,24,0,0,16384,24,1270366032
8094,2280695222,13280,2280708502,10,0,1,2048,10,680016719
8095,2280696671,1069795,2281766466,13,0,0,15872,13,8193901758
8096,2280706380,973386,2281679766,19,0,0,16896,19,2485118873
8097,2280734051,1134061,2281868112,6,0,0,73216,6,8369495830
8098,2280752768,557318,2281310086,4,0,0,10240,4,6937838015
8099,2280753286,745799,2281499085,34,0,0,55808,34,7024582371
8100,2280761246,1510700,2282271946,18,0,0,52224,18,8002702926
8101,2280762873,8158,2280771031,21,0,1,7680,21,4382688854
8102,2280774846,30621,2280805467,34,0,1,4608,34,5510931299
8103,2280784997,1166773,2281951770,2,0,0,10240,2,4400956582
8104,2280787663,1058111,2281845774,12,0,0,144896,12,5947388087
8105,2280806439,6654,2280813093,36,0,1,11264,36,2043118122
8106,2280809648,718343,2281527991,37,0,0,91648,37,4604717341
8107,2280820952,610161,2281431113,48,0,0,13824,48,5664903183
8108,2280849426,15155,2280864581,41,0,1,6656,41,9116601777
8109,2280860345,845721,2281706066,4,0,0,40960,4,6573476310
8110,2280867383,1081244,2281948627,31,0,0,28160,31,6405792856
8111,2280873156,372573,2281245729,6,0,0,23040,6,5872835080
8112,2280873404,923242,2281796646,17,0,0,18944,17,9494712754
8113,2280887238,3352,2280890590,0,0,1,1024,0,255230984
8114,2280895795,264030,2281159825,37,0,0,14848,37,3570406711
8115,2280897585,1420626,2282318211,49,0,0,18432,49,1046609534
8116,2280917264,1475581,2282392845,36,0,0,40448,36,7543672160
8117,2280922089,504774,2281426863,14,0,0,12800,14,2895854105
8118,2280922416,692845,2281615261,5,0,0,6144,5,10501084795
8119,2280954606,336127,2281290733,47,0,0,15360,47,7798459264
8120,2280962167,387042,2281349209,18,0,0,16896,18,8120429520
8121,2280970003,723536,2281693539,31,0,0,1536,31,1567252339
8122,2280970379,28161,2280998540,10,0,1,1536,10,2295495437
8123,2280987526,1573813,2282561339,24,0,0,29184,24,7775861050
8124,2281013191,918652,2281931843,22,0,0,6656,22,10023061143
8125,2281014684,4850,2281019534,8,0,1,5120,8,2044632
8126,2281032917,576121,2281609038,2,0,0,30208,2,2358246102
8127,2281038137,1262532,2282300669,26,0,0,76800,26,221401741
8128,2281043473,922593,2281966066,18,0,0,20992,18,4062674669
8129,2281064004,1116755,2282180759,22,0,0,30208,22,353923832
8130,2281067623,1052146,2282119769,9,0,0,2560,9,7309069877
8131,2281080137,848532,2281928669,17,0,0,77312,17,8787359862
8132,2281104720,854919,2281959639,29,0,0,25600,29,8473329410
8133,2281109362,795728,2281905090,7,0,0,6144,7,1096579917
8134,2281118258,410076,2281528334,47,0,0,1024,47,3087162166
8135,2281120923,895532,2282016455,37,0,0,1024,37,7645532255
8136,2281123153,253456,2281376609,18,0,0,6144,18,9040974109
8137,2281125029,778166,2281903195,33,0,0,57344,33,9402663796
8138,2281147966,418899,2281566865,9,0,0,3584,9,5411407413
8139,2281161318,435355,2281596673,28,0,0,5632,28,10329821583
8140,2281170719,1787538,2282958257,15,0,0,38912,15,6353969432
8141,2281172501,2649,2281175150,15,0,1,2560,15,3129529378
8142,2281175414,865068,2282040482,44,0,0,17408,44,1236838912
8143,2281216794,877628,2282094422,33,0,0,13312,33,4273611383
8144,2281235149,957631,2282192780,9,0,0,17408,9,5334822720
8145,2281271534,566,2281272100,29,0,1,512,29,3325609780
8146,2281271675,441242,2281712917,49,0,0,8192,49,9572949321
8147,2281285887,475728,2281761615,5,0,0,28672,5,4044090827
8148,2281308807,290997,2281599804,14,0,0,9216,14,9609964713
8149,2281314642,251116,2281565758,21,0,0,2560,21,2372092134
8150,2281332977,852567,2282185544,0,0,0,13824,0,5147474515
8151,2281356442,70436,2281426878,30,0,1,22016,30,1777007550
8152,2281357445,1164676,2282522121,39,0,0,13824,39,2902326864
8153,2281358608,1724138,2283082746,21,0,0,31232,21,2616549221
8154,2281360026,385993,2281746019,33,0,0,20480,33,9081723994
8155,2281374844,334833,2281709677,8,0,0,11776,8,8768801310
8156,2281378663,750556,2282129219,45,0,0,6144,45,3976056283
8157,2281379087,637041,2282016128,7,0,0,29696,7,3929844018
8158,2281381661,311395,2281693056,31,0,0,9216,31,2831195588
8159,2281387563,764017,2282151580,25,0,0,45056,25,7273279728
8160,2281396833,1004763,2282401596,23,0,0,28672,23,1667377636
8161,2281413923,1809709,2283223632,13,0,0,64000,13,5434038281
8162,2281452302,1191865,2282644167,16,0,0,25088,16,592852323
8163,2281452310,300554,2281752864,48,0,0,15872,48,4992938686
8164,2281461760,407326,2281869086,49,0,0,1536,49,8002687006
8165,2281472955,556930,2282029885,8,0,0,21504,8,1462628242
8166,2281491939,48133,2281540072,46,0,1,7168,46,4557594342
8167,2281493362,375233,2281868595,0,0,0,1536,0,9586302988
8168,2281501874,661733,2282163607,23,0,0,39424,23,7661251189
8169,2281528343,670700,2282199043,48,0,0,9728,48,351009855
8170,2281539431,329826,2281869257,0,0,0,512,0,2651698112
8171,2281554096,524832,2282078928,30,0,0,12800,30,4515628724
8172,2281570838,682491,2282253329,42,0,0,130048,42,8435770394
8173,2281584782,1737496,2283322278,9,0,0,8704,9,5057327226
8174,2281584863,14956,2281599819,12,0,1,12800,12,7066550343
8175,2281586206,347376,2281933582,48,0,0,5632,48,8620615361
8176,2281616610,1329597,2282946207,45,0,0,3072,45,7127237740
8177,2281626132,1764309,2283390441,7,0,0,41472,7,1385629206
8178,2281635496,914877,2282550373,28,0,0,23552,28,18008471
8179,2281639012,131357,2281770369,11,0,1,129536,11,822351439
8180,2281671878,1103785,2282775663,29,0,0,49152,29,377012588
8181,2281675678,1265195,2282940873,48,0,0,125440,48,4426963779
8182,2281679067,773486,2282452553,39,0,0,50688,39,3302862475
8183,2281689418,86136,2281775554,49,0,1,16384,49,8116812312
8184,2281710813,66226,2281777039,41,0,1,15360,41,4654477210
8185,2281735427,194365,2281929792,10,0,0,3584,10,6651151101
8186,2281741828,36197,2281778025,8,0,1,1536,8,6994216909
8187,2281742385,361407,2282103792,45,0,0,8704,45,5780225470
8188,2281757013,182980,2281939993,40,0,0,20992,40,7220970693
8189,2281762700,789716,2282552416,8,0,0,6656,8,4079273015
8190,2281763527,1221374,2282984901,23,0,0,44544,23,4185329641
8191,2281799354,46435,2281845789,36,0,1,7680,36,9384329223
8192,2281813947,126069,2281940016,41,0,1,11264,41,1060723217
8193,2281834442,508650,2282343092,13,0,0,16896,13,7725621986
8194,2281839713,1197481,2283037194,26,0,0,12800,26,3694702187
8195,2281841518,743415,2282584933,47,0,0,35840,47,7213747585
8196,2281844315,107470,2281951785,41,0,1,5120,41,254710102
8197,2281849799,102009,2281951808,32,0,1,12800,32,3219680888
8198,2281849927,320736,2282170663,39,0,0,17408,39,10125058132
8199,2281850898,286916,2282137814,4,0,0,28160,4,990959318
8200,2281860450,842833,2282703283,18,0,0,5632,18,5438546840
8201,2281890028,581404,2282471432,21,0,0,3072,21,9205866277
8202,2281902840,63241,2281966081,35,0,1,11776,35,4438404517
8203,2281909108,425373,2282334481,28,0,0,40960,28,8271769657
8204,2281923675,42429,2281966104,14,0,1,14848,14,3511900433
8205,2281924053,669364,2282593417,28,0,0,4096,28,2135996308
8206,2281928434,497767,2282426201,38,0,0,33792,38,8928272547
8207,2281940548,315471,2282256019,44,0,0,8704,44,5062635764
8208,2281946887,69591,2282016478,48,0,1,33792,48,7893446752
8209,2281949131,406528,2282355659,38,0,0,31232,38,8360974544
8210,2281974576,302678,2282277254,25,0,0,3584,25,7163817992
8211,2281987397,440862,2282428259,35,0,0,512,35,6587072457
8212,2282004815,452285,2282457100,6,0,0,14848,6,8094227141
8213,2282011639,483113,2282494752,5,0,0,22016,5,3435824038
8214,2282017496,12412,2282029908,36,0,1,8192,36,9727580501
8215,2282017827,1161501,2283179328,12,0,0,62976,12,5190085434
8216,2282023345,596820,2282620165,44,0,0,35840,44,7208813409
8217,2282026958,376393,2282403351,15,0,0,5632,15,2580255688
8218,2282037184,378706,2282415890,48,0,0,7680,48,7127275252
8219,2282045065,914455,2282959520,6,0,0,4096,6,10347847471
8220,2282045275,1019367,2283064642,25,0,0,11264,25,1865911811
8221,2282050098,377990,2282428088,15,0,0,6144,15,7454653287
8222,2282057098,26633,2282083731,36,0,1,5120,36,10247807916
8223,2282059520,423731,2282483251,38,0,0,31232,38,5106858376
8224,2282078089,495909,2282573998,45,0,0,41472,45,1651547362
8225,2282080619,4738,2282085357,8,0,1,2560,8,7948312583
8226,2282085957,1994,2282087951,32,0,1,2048,32,1640332045
8227,2282093176,181765,2282274941,29,0,0,9728,29,10660108806
8228,2282096385,11274,2282107659,15,0,1,18432,15,1068141033
8229,2282100391,10494,2282110885,19,0,1,5120,19,9444726268
8230,2282103938,1082284,2283186222,45,0,0,15872,45,9495749147
8231,2282108111,705577,2282813688,8,0,0,51712,8,3130433485
8232,2282118352,704475,2282822827,15,0,0,27136,15,5232008096
8233,2282124991,503526,2282628517,43,0,0,21504,43,2157749276
8234,2282127254,10575,2282137829,47,0,1,2560,47,5943632837
8235,2282130277,370171,2282500448,36,0,0,16896,36,9596680159
8236,2282150395,605886,2282756281,7,0,0,26624,7,8021297080
8237,2282171218,527740,2282698958,10,0,0,39936,10,4343180820
8238,2282202069,891954,2283094023,48,0,0,9216,48,6909493384
8239,2282206960,46392,2282253352,20,0,1,25088,20,800603551
8240,2282213342,271180,2282484522,7,0,0,4096,7,10319439146
8241,2282237753,62939,2282300692,20,0,1,6144,20,3860019440
8242,2282239926,620869,2282860795,49,0,0,512,49,8900608955
8243,2282251058,535226,2282786284,25,0,0,3584,25,6896127309
8244,2282254431,712904,2282967335,13,0,0,25600,13,6647434738
8245,2282254691,1316552,2283571243,12,0,0,131584,12,9395795527
8246,2282263722,782347,2283046069,46,0,0,7168,46,5128789277
8247,2282271690,1106092,2283377782,45,0,0,39424,45,10638152214
8248,2282279626,1039977,2283319603,34,0,0,24576,34,7604462655
8249,2282298756,429520,2282728276,45,0,0,14848,45,5403110729
8250,2282305056,4850,2282309906,29,0,1,5120,29,2444066052
8251,2282313018,632238,2282945256,8,0,0,14336,8,3982141815
8252,2282352197,148586,2282500783,36,0,0,1024,36,7007783939
8253,2282368801,34565,2282403366,32,0,1,1536,32,10286825573
8254,2282375641,385031,2282760672,44,0,0,14336,44,38510670
8255,2282384165,23580,2282407745,14,0,1,11776,14,5261267066
8256,2282387154,233650,2282620804,37,0,0,2048,37,1724651973
8257,2282388343,451925,2282840268,7,0,0,7168,7,9666963150
8258,2282404246,182005,2282586251,9,0,0,4096,9,7855487583
8259,2282405849,338828,2282744677,37,0,0,8704,37,559768227
8260,2282434293,60482,2282494775,28,0,1,1536,28,10189269783
8261,2282443392,1052179,2283495571,19,0,0,44544,19,9873147213
8262,2282455103,45695,2282500798,13,0,1,14336,13,4689412686
8263,2282456662,1379596,2283836258,39,0,0,71680,39,2765774616
8264,2282477399,888356,2283365755,19,0,0,59904,19,8887009080
8265,2282490535,697886,2283188421,35,0,0,7168,35,6874705041
8266,2282499136,1315259,2283814395,2,0,0,46592,2,3506667199
8267,2282502394,215300,2282717694,17,0,0,14336,17,5447553717
8268,2282508993,591391,2283100384,19,0,0,17920,19,3959765913
8269,2282522426,538769,2283061195,15,0,0,40960,15,5986590047
8270,2282540852,975119,2283515971,33,0,0,11264,33,10123196180
8271,2282548280,36684,2282584964,23,0,1,5120,23,2702854566
8272,2282548438,1544930,2284093368,36,0,0,95744,36,1878880790
8273,2282561273,467258,2283028531,23,0,0,19456,23,2487898029
8274,2282563134,260176,2282823310,26,0,0,1536,26,3074154948
8275,2282570358,3184302,2285754660,30,0,1,478720,30,8477633861
8276,2282578583,617044,2283195627,11,0,0,19968,11,351283626
8277,2282579499,323139,2282902638,30,0,0,34304,30,6034727623
8278,2282587452,532091,2283119543,8,0,0,19968,8,9618713287
8279,2282607539,338839,2282946378,34,0,0,512,34,8085298441
8280,2282612317,909441,2283521758,5,0,0,18944,5,2960875581
8281,2282623163,825523,2283448686,5,0,0,11264,5,4066898841
8282,2282645378,504286,2283149664,42,0,0,35840,42,7800148899
8283,2282657383,433817,2283091200,19,0,0,3072,19,915716351
8284,2282662329,3217997,2285880326,20,0,1,3072,20,10072532312
8285,2282665896,3214445,2285880341,36,0,1,10752,36,4100399842
8286,2282669370,1014415,2283683785,33,0,0,21504,33,5214463290
8287,2282675817,1034896,2283710713,14,0,0,58880,14,10604691036
8288,2282733440,356809,2283090249,12,0,0,24576,12,6932984540
8289,2282738088,3162213,2285900301,22,0,1,20480,22,10535188087
8290,2282749355,410770,2283160125,37,0,0,22528,37,7940779770
8291,2282781288,3172931,2285954219,14,0,1,14336,14,3902204310
8292,2282782470,986280,2283768750,49,0,0,13312,49,10619182691
8293,2282784317,651984,2283436301,11,0,0,28672,11,8406591243
8294,2282790075,610365,2283400440,17,0,0,32768,17,1744430090
8295,2282797232,1159109,2283956341,43,0,0,15872,43,5347642197
8296,2282808984,3147934,2285956918,12,0,1,4096,12,1525634061
8297,2282813027,413896,2283226923,22,0,0,10752,22,4793902515
8298,2282813540,939152,2283752692,6,0,0,137728,6,1818381141
8299,2282827170,629971,2283457141,34,0,0,27648,34,10388456983
8300,2282829610,351761,2283181371,19,0,0,6656,19,9134325017
8301,2282841409,1066391,2283907800,25,0,0,21504,25,10363908830
8302,2282843026,658332,2283501358,5,0,0,18944,5,102247420
8303,2282860165,409046,2283269211,37,0,0,21504,37,6516891392
8304,2282868539,925796,2283794335,0,0,0,5120,0,1918609956
8305,2282876674,967563,2283844237,29,0,0,26112,29,5736964357
8306,2282884722,587809,2283472531,43,0,0,26624,43,3861037148
8307,2282889283,175686,2283064969,48,0,0,1024,48,9565171840
8308,2282891867,3066037,2285957904,32,0,1,1536,32,1762258536
8309,2282923348,3035542,2285958890,20,0,1,1536,20,3698876221
8310,2282945891,243637,2283189528,24,0,0,3584,24,5470073567
8311,2282973164,299494,2283272658,3,0,0,11264,3,10581385687
8312,2282978638,333454,2283312092,12,0,0,22016,12,5729366463
8313,2283001929,6362491,2289364420,30,0,1,628736,30,9692442804
8314,2283014482,1018570,2284033052,17,0,0,2048,17,6150106395
8315,2283016820,1006499,2284023319,17,0,0,43008,17,10209248867
8316,2283023985,646515,2283670500,24,0,0,19456,24,8126271151
8317,2283024251,848188,2283872439,23,0,0,75776,23,9638405066
8318,2283060995,1587188,2284648183,49,0,0,148480,49,9394782599
8319,2283066330,862423,2283928753,37,0,0,1536,37,10105130800
8320,2283071527,1362969,2284434496,25,0,0,73216,25,6425026060
8321,2283072645,1394229,2284466874,15,0,0,49152,15,3716550778
8322,2283075729,1227082,2284302811,33,0,0,15360,33,8533763421
8323,2283079110,1174006,2284253116,19,0,0,33280,19,3360449603
8324,2283094057,581946,2283676003,14,0,0,1536,14,9960565846
8325,2283094679,1050386,2284145065,41,0,0,4096,41,867721095
8326,2283096611,1028323,2284124934,43,0,0,78336,43,4733718789
8327,2283139468,1564264,2284703732,39,0,0,69120,39,9477766866
8328,2283148965,6215470,2289364435,28,0,1,512,28,4854833436
8329,2283149792,1412891,2284562683,47,0,0,29184,47,6429942860
8330,2283151186,1629298,2284780484,15,0,0,89600,15,2130447184
8331,2283152645,1087485,2284240130,3,0,0,65536,3,6013150710
8332,2283156180,289059,2283445239,28,0,0,25600,28,934678728
8333,2283162674,274750,2283437424,7,0,0,3584,7,2705796494
8334,2283165848,6198602,2289364450,32,0,1,512,32,3572196795
8335,2283170392,1017993,2284188385,16,0,0,24064,16,9135439446
8336,2283178251,578052,2283756303,22,0,0,11776,22,5586726288
8337,2283181941,731758,2283913699,23,0,0,3072,23,4005989704
8338,2283185308,242242,2283427550,15,0,0,36864,15,10483630002
8339,2283185962,1265905,2284451867,16,0,0,56832,16,5342585856
8340,2283193158,718401,2283911559,49,0,0,12288,49,8929292863
8341,2283202344,861829,2284064173,6,0,0,16896,6,860879962
8342,2283204019,257069,2283461088,40,0,0,12800,40,2447683797
8343,2283210298,6155116,2289365414,4,0,1,4608,4,10050326008
8344,2283213684,772791,2283986475,16,0,0,9216,16,3380396292
8345,2283220231,443505,2283663736,2,0,0,60416,2,5879210369
8346,2283228275,1111925,2284340200,34,0,0,18432,34,174354001
8347,2283240790,887342,2284128132,6,0,0,3584,6,1454919603
8348,2283246381,686772,2283933153,36,0,0,11776,36,5420819719
8349,2283256940,1095443,2284352383,31,0,0,6656,31,8485664620
8350,2283264905,363601,2283628506,34,0,0,13824,34,9825086881
8351,2283265373,1027766,2284293139,37,0,0,24576,37,891778989
8352,2283265583,1068986,2284334569,0,0,0,12800,0,7419481667
8353,2283275120,1137053,2284412173,45,0,0,40448,45,9553807730
8354,2283283043,6083680,2289366723,0,0,1,2048,0,2489136436
8355,2283286080,840945,2284127025,15,0,0,6656,15,4743326982
8356,2283288326,6079700,2289368026,38,0,1,2048,38,3978270394
8357,2283297003,6071369,2289368372,39,0,1,512,39,6569189664
8358,2283297292,969822,2284267114,9,0,0,15360,9,9637192771
8359,2283308925,6095896,2289404821,0,0,1,12288,0,2004056059
8360,2283330945,6073899,2289404844,31,0,1,7680,31,4919125581
8361,2283332298,1734662,2285066960,7,0,0,31744,7,294597378
8362,2283359269,6091910,2289451179,36,0,1,9216,36,8473124210
8363,2283368369,6160919,2289529288,10,0,1,5120,10,7100557718
8364,2283370317,6158986,2289529303,32,0,1,1024,32,1745550099
8365,2283379496,517168,2283896664,28,0,0,18432,28,7256585389
8366,2283391445,999260,2284390705,10,0,0,62976,10,5151353357
8367,2283407043,494019,2283901062,7,0,0,7680,7,3665467618
8368,2283410224,1301791,2284712015,16,0,0,27136,16,2147438185
8369,2283411947,486760,2283898707,16,0,0,6656,16,306114006
8370,2283412121,1641885,2285054006,21,0,0,54272,21,5579119963
8371,2283423081,1831735,2285254816,47,0,0,11264,47,532729613
8372,2283423594,6272233,2289695827,43,0,1,33280,43,2623057347
8373,2283433328,1962072,2285395400,41,0,0,11264,41,6410620457
8374,2283434693,964467,2284399160,44,0,0,27648,44,5561691697
8375,2283436774,825621,2284262395,35,0,0,19456,35,7400189346
8376,2283436874,464359,2283901233,21,0,0,512,21,4693354216
8377,2283437546,6429855,2289867401,4,0,1,17408,4,821337673
8378,2283439599,6434563,2289874162,0,0,1,5632,0,3989931249
8379,2283445607,1214814,2284660421,25,0,0,14336,25,3947159285
8380,2283451203,911641,2284362844,41,0,0,3072,41,2580723872
8381,2283452190,906212,2284358402,33,0,0,17920,33,4456665127
8382,2283463992,316543,2283780535,40,0,0,10240,40,3444148771
8383,2283496069,1846729,2285342798,18,0,0,36352,18,8397501156
8384,2283508520,256159,2283764679,7,0,0,24576,7,10194382339
8385,2283543986,1299328,2284843314,3,0,0,73728,3,2728274675
8386,2283550010,6324167,2289874177,8,0,1,1024,8,3077410566
8387,2283562860,1101476,2284664336,49,0,0,12800,49,5806209641
8388,2283567228,964579,2284531807,21,0,0,94208,21,9387894790
8389,2283568375,532652,2284101027,7,0,0,25088,7,4227575982
8390,2283570550,6303642,2289874192,41,0,1,11264,41,5513494833
8391,2283572415,1399671,2284972086,26,0,0,5120,26,5777599494
8392,2283584213,6337696,2289921909,8,0,1,13824,8,5171276831
8393,2283608678,6322175,2289930853,15,0,1,2048,15,2011058845
8394,2283627442,6309016,2289936458,29,0,1,2048,29,5093836361
8395,2283640082,1321177,2284961259,47,0,0,41472,47,6292307995
8396,2283643761,6292904,2289936665,22,0,1,7168,22,5538094601
8397,2283647792,525602,2284173394,15,0,0,4096,15,7132138943
8398,2283648669,594292,2284242961,15,0,0,9216,15,5157998281
8399,2283650253,6287398,2289937651,21,0,1,1536,21,3378749285
8400,2283658626,1419810,2285078436,26,0,0,10240,26,7135931633
8401,2283678733,1572636,2285251369,18,0,0,45568,18,8275438396
8402,2283701963,1499177,2285201140,24,0,0,14336,24,7142982926
8403,2283715001,1719674,2285434675,41,0,0,8192,41,9739342318
8404,2283734033,6278489,2290012522,21,0,1,10240,21,9205490156
8405,2283743369,397895,2284141264,5,0,0,5632,5,341104837
8406,2283744822,1100403,2284845225,45,0,0,6144,45,7679987195
8407,2283749708,580946,2284330654,36,0,0,30208,36,5673838478
8408,2283756651,241894,2283998545,40,0,0,8192,40,4657897167
8409,2283763339,1151142,2284914481,47,0,0,51200,47,3375403867
8410,2283773469,1742551,2285516020,29,0,0,20480,29,3765880876
8411,2283783348,898867,2284682215,16,0,0,3072,16,2468207445
8412,2283785656,6226881,2290012537,29,0,1,4096,29,726007015
8413,2283791274,682339,2284473613,13,0,0,22016,13,8850580783
8414,2283803616,676751,2284480367,27,0,0,9216,27,8919069979
8415,2283812877,978113,2284790990,3,0,0,14336,3,5179199045
8416,2283844880,6180043,2290024923,2,0,1,18944,2,9048618078
8417,2283861171,734304,2284595475,5,0,0,32768,5,3219763126
8418,2283877397,6147541,2290024938,13,0,1,4608,13,5887366994
8419,2283905350,592558,2284497908,9,0,0,15360,9,3238927253
8420,2283908813,747225,2284656038,36,0,0,25600,36,8215765916
8421,2283912229,1036379,2284948608,23,0,0,50176,23,6062282154
8422,2283928327,1710867,2285639194,31,0,0,10240,31,1927494451
8423,2283956080,6472756,2290428836,27,0,1,112128,27,5531189288
8424,2283956237,901826,2284858063,30,0,0,3072,30,923032686
8425,2284002968,783623,2284786591,12,0,0,19968,12,3484004146
8426,2284030324,238537,2284268861,17,0,0,5632,17,2280985280
8427,2284059086,933305,2284992391,47,0,0,18432,47,3819682647
8428,2284068929,1061576,2285130505,47,0,0,82432,47,2421563614
8429,2284078576,398952,2284477528,26,0,0,12800,26,7368609497
8430,2284079939,1306444,2285386383,19,0,0,56320,19,2823979086
8431,2284086503,1014661,2285101164,9,0,0,9216,9,4634669307
8432,2284098221,388565,2284486786,40,0,0,20992,40,6939415496
8433,2284107502,887096,2284994598,4,0,0,7168,4,399550207
8434,2284107789,6323313,2290431102,13,0,1,3584,13,2005010929
8435,2284110469,1769818,2285880287,43,0,0,64000,43,8116805360
8436,2284112261,744835,2284857096,49,0,0,38912,49,680688636
8437,2284123963,6307485,2290431448,0,0,1,512,0,2415251198
8438,2284131310,6301124,2290432434,14,0,1,1536,14,9438925596
8439,2284142160,734499,2284876659,14,0,0,5632,14,4541787567
8440,2284159746,333467,2284493213,44,0,0,20992,44,8758601860
8441,2284164093,1520309,2285684402,49,0,0,38912,49,8659584808
8442,2284202769,993988,2285196757,30,0,0,27648,30,8978093669
8443,2284204092,508126,2284712218,19,0,0,512,19,331962714
8444,2284221274,522520,2284743794,3,0,0,23040,3,2820307241
8445,2284236920,6217527,2290454447,29,0,1,12288,29,6007846224
8446,2284243563,255616,2284499179,47,0,0,4096,47,1372575112
8447,2284253453,1382606,2285636059,28,0,0,104960,28,2945200334
8448,2284256079,6246556,2290502635,36,0,1,1536,36,7064760930
8449,2284257478,6246033,2290503511,44,0,1,2560,44,1013986322
8450,2284264832,1400671,2285665503,4,0,0,23552,4,7309103315
8451,2284290636,6243064,2290533700,10,0,1,3584,10,5020518474
8452,2284308150,1111363,2285419513,28,0,0,20480,28,2872131945
8453,2284314283,438886,2284753169,12,0,0,30720,12,1268843910
8454,2284333334,1421311,2285754645,9,0,0,70656,9,2827220185
8455,2284341047,450426,2284791473,37,0,0,1536,37,2848258646
8456,2284347261,6186454,2290533715,28,0,1,10240,28,7378727751
8457,2284359923,1149842,2285509765,3,0,0,39424,3,8644902438
8458,2284364598,1827686,2286192284,28,0,0,164864,28,110916323
8459,2284377348,1576534,2285953882,17,0,0,5120,17,808769333
8460,2284383416,1337705,2285721121,39,0,0,55296,39,7962673482
8461,2284385009,818330,2285203339,26,0,0,7168,26,1453037902
8462,2284407066,458516,2284865582,37,0,0,24576,37,6341046687
8463,2284409368,6127739,2290537107,14,0,1,6656,14,9711869867
8464,2284409702,627745,2285037447,23,0,0,16896,23,7204592299
8465,2284410227,6139875,2290550102,46,0,1,1024,46,2377728839
8466,2284412855,167048,2284579903,19,0,0,9728,19,10612412872
8467,2284427416,1512316,2285939732,40,0,0,32256,40,5113575400
8468,2284432638,1845943,2286278581,13,0,0,70656,13,5989284166
8469,2284442414,691109,2285133523,23,0,0,3584,23,1277844452
8470,2284446851,715358,2285162209,23,0,0,30208,23,1455155553
8471,2284452367,1804663,2286257030,25,0,0,76288,25,6424193200
8472,2284468338,1356283,2285824621,20,0,0,70144,20,2009718425
8473,2284471975,539720,2285011695,45,0,0,28160,45,1163376809
8474,2284480606,1887391,2286367997,32,0,0,41472,32,6282929745
8475,2284490961,1342582,2285833543,31,0,0,12288,31,6223359820
8476,2284505214,681021,2285186235,19,0,0,24064,19,3445072304
8477,2284511529,6038588,2290550117,36,0,1,1536,36,4576670712
8478,2284521586,1529967,2286051553,46,0,0,18432,46,8494377830
8479,2284522789,6027658,2290550447,22,0,1,1536,22,5811847432
8480,2284527375,6024058,2290551433,0,0,1,1536,0,8694127422
8481,2284540346,2085462,2286625808,28,0,0,129536,28,7767484902
8482,2284549064,6006555,2290555619,43,0,1,6656,43,3331069561
8483,2284556245,717002,2285273247,27,0,0,60416,27,2664038850
8484,2284575215,783354,2285358569,27,0,0,51712,27,3235042863
8485,2284580051,6004134,2290584185,46,0,1,6144,46,5394885522
8486,2284580239,1183326,2285763565,37,0,0,3072,37,5661983856
8487,2284603610,528798,2285132408,22,0,0,6144,22,7480165856
8488,2284620425,1385216,2286005641,46,0,0,54272,46,6947961625
8489,2284625080,1270783,2285895863,13,0,0,6144,13,2829880639
8490,2284626502,837599,2285464101,37,0,0,35328,37,3156462774
8491,2284633021,1902768,2286535789,5,0,0,40448,5,2467649853
8492,2284655856,623810,2285279666,27,0,0,20992,27,10499960474
8493,2284656348,5928183,2290584531,15,0,1,512,15,8479112860
8494,2284668407,1565340,2286233747,39,0,0,67072,39,9294100513
8495,2284671071,767710,2285438781,30,0,0,7680,30,9472697498
8496,2284692120,5893179,2290585299,12,0,1,11776,12,765383615
8497,2284693308,1941290,2286634598,42,0,0,2560,42,7152851820
8498,2284698066,1757185,2286455251,14,0,0,4096,14,4516300141
8499,2284700017,5914106,2290614123,0,0,1,1536,0,7328358308
8500,2284709772,5996817,2290706589,28,0,1,25600,28,3840252085
8501,2284710383,989156,2285699539,23,0,0,15872,23,1051405620
8502,2284713214,1019888,2285733102,5,0,0,10752,5,5337373165
8503,2284716264,823695,2285539959,44,0,0,56320,44,1811005761
8504,2284741873,983803,2285725676,25,0,0,14848,25,2222193452
8505,2284755197,2027167,2286782364,2,0,0,26624,2,8210941748
8506,2284761821,942413,2285704234,22,0,0,15360,22,9486550778
8507,2284810320,1083624,2285893944,25,0,0,44544,25,7819173191
8508,2284825213,1248444,2286073657,30,0,0,15872,30,5292202383
8509,2284830428,1030336,2285860764,48,0,0,67584,48,2134418994
8510,2284830466,999318,2285829784,19,0,0,16896,19,6002400385
8511,2284846116,746442,2285592558,16,0,0,45056,16,10044639155
8512,2284846519,2320224,2287166743,49,0,0,46592,49,2480062755
8513,2284847041,2050932,2286897973,48,0,0,9728,48,4736534881
8514,2284856845,512347,2285369192,15,0,0,34816,15,4916657867
8515,2284861944,2480033,2287341977,17,0,0,65536,17,2454923568
8516,2284867320,1970215,2286837535,37,0,0,34304,37,2297247870
8517,2284875316,2090457,2286965773,35,0,0,8192,35,9016477781
8518,2284879924,1798131,2286678055,26,0,0,7168,26,592055145
8519,2284889906,496648,2285386554,3,0,0,512,3,7892673001
8520,2284917838,1593397,2286511235,21,0,0,13312,21,8742391593
8521,2284925786,1713663,2286639449,17,0,0,15872,17,6958983688
8522,2284956341,1817888,2286774229,12,0,0,17920,12,976017181
8523,2284958104,1998004,2286956108,5,0,0,48640,5,41523926
8524,2284960016,1002036,2285962052,38,0,0,9728,38,8501363453
8525,2284965424,986883,2285952307,41,0,0,21504,41,249882949
8526,2284986257,445907,2285432164,20,0,0,41472,20,6037665173
8527,2284987578,5737979,2290725557,8,0,1,5120,8,9164956724
8528,2285033082,402544,2285435626,33,0,0,3072,33,2139505102
8529,2285040881,501901,2285542782,14,0,0,9216,14,34766042
8530,2285047797,1164353,2286212150,25,0,0,40448,25,217579851
8531,2285052951,1957535,2287010486,5,0,0,9216,5,1764132655
8532,2285061911,2403134,2287465045,41,0,0,41472,41,3846016095
8533,2285069779,509036,2285578815,6,0,0,22528,6,10499411867
8534,2285093209,232359,2285325568,48,0,0,2048,48,7404231366
8535,2285095545,501240,2285596785,25,0,0,13824,25,564163539
8536,2285109215,1223912,2286333127,45,0,0,25600,45,4221995028
8537,2285113037,1099440,2286212477,36,0,0,1024,36,10054367527
8538,2285124631,426413,2285551044,40,0,0,9216,40,2066992662
8539,2285131339,347025,2285478364,42,0,0,12288,42,1274384063
8540,2285131517,904628,2286036145,10,0,0,8704,10,9774218648
8541,2285139974,700183,2285840157,9,0,0,5120,9,1720722336
8542,2285145464,1139714,2286285178,15,0,0,4608,15,6595664026
8543,2285146925,607906,2285754831,48,0,0,512,48,8869564382
8544,2285147058,5578514,2290725572,29,0,1,1024,29,6535149849
8545,2285149288,509024,2285658312,2,0,0,26624,2,1551829247
8546,2285161437,1122322,2286283759,40,0,0,10240,40,9198138108
8547,2285180856,657694,2285838550,31,0,0,16384,31,1368228805
8548,2285202207,1895388,2287097595,37,0,0,26624,37,896814920
8549,2285215282,726493,2285941775,4,0,0,6656,4,4417984212
8550,2285216258,2223820,2287440078,17,0,0,24064,17,9232206598
8551,2285219835,2025964,2287245799,11,0,0,69120,11,3119257590
8552,2285225343,1130003,2286355346,33,0,0,49664,33,3327309980
8553,2285245901,2274185,2287520086,21,0,0,5120,21,6317180468
8554,2285262585,1156607,2286419192,38,0,0,18432,38,7069693417
8555,2285271503,2347210,2287618713,46,0,0,26112,46,1036501097
8556,2285284591,5440996,2290725587,35,0,1,2048,35,2275426470
8557,2285287055,5449599,2290736654,22,0,1,11776,22,9463872064
8558,2285305022,975602,2286280624,7,0,0,6656,7,2657754285
8559,2285313077,1009724,2286322801,27,0,0,34304,27,4099682345
8560,2285354407,5512065,2290866472,12,0,1,5120,12,8210884209
8561,2285355971,5512255,2290868226,15,0,1,4096,15,8369741590
8562,2285370697,2391524,2287762221,12,0,0,68608,12,3784845327
8563,2285374153,5494088,2290868241,36,0,1,13824,36,10551885796
8564,2285396140,817140,2286213280,36,0,0,2560,36,7819456865
8565,2285398832,5518830,2290917662,34,0,1,20480,34,1570373898
8566,2285408270,2386952,2287795222,48,0,0,30720,48,1603286801
8567,2285409434,1410770,2286820204,46,0,0,2560,46,1580509781
8568,2285422044,640164,2286062208,40,0,0,29696,40,9219830970
8569,2285423256,1210547,2286633803,7,0,0,26112,7,4425376811
8570,2285428479,1127956,2286556435,26,0,0,28672,26,5089458199
8571,2285447628,202557,2285650185,38,0,0,3584,38,3051701180
8572,2285452733,2442394,2287895127,18,0,0,70144,18,3649495130
8573,2285467874,5451315,2290919189,8,0,1,1024,8,2041428174
8574,2285467920,1300826,2286768746,23,0,0,53248,23,4200267699
8575,2285486137,5433718,2290919855,48,0,1,11264,48,1916296634
8576,2285494977,588861,2286083838,26,0,0,32256,26,6568593090
8577,2285512329,2580233,2288092562,44,0,0,36864,44,7781701118
8578,2285518417,1300992,2286819409,6,0,0,41472,6,9725993245
8579,2285586393,2318117,2287904510,23,0,0,30720,23,4979042562
8580,2285591385,1399713,2286991098,24,0,0,55808,24,6449242413
8581,2285601331,1183560,2286784891,24,0,0,8192,24,8034752260
8582,2285630405,1408395,2287038800,25,0,0,3584,25,6933186048
8583,2285642649,1315346,2286957995,1,0,0,6144,1,10590579464
8584,2285666284,533503,2286199787,7,0,0,24576,7,1116723381
8585,2285688665,818499,2286507164,23,0,0,22528,23,3504644784
8586,2285692487,2151087,2287843574,26,0,0,89600,26,8727769047
8587,2285699223,5290196,2290989419,29,0,1,16384,29,10436778909
8588,2285701481,6397329,2292098810,11,0,1,323584,11,7146433598
8589,2285701620,400086,2286101706,16,0,0,27136,16,53209752
8590,2285749867,1330795,2287080662,26,0,0,127488,26,10337539489
8591,2285750934,6406328,2292157262,36,0,1,7680,36,7794497678
8592,2285785468,583824,2286369292,3,0,0,4096,3,3255292174
8593,2285806524,1307942,2287114466,48,0,0,55296,48,4752587799
8594,2285841169,6337717,2292178886,46,0,1,7168,46,408922296
8595,2285848283,6496208,2292344491,27,0,1,18432,27,890345969
8596,2285851187,2142040,2287993227,35,0,0,11776,35,10732681583
8597,2285863938,683730,2286547668,42,0,0,38912,42,3787386116
8598,2285869424,2305633,2288175057,0,0,0,13824,0,8313883407
8599,2285879533,6542294,2292421827,10,0,1,2560,10,1949147434
8600,2285881155,2185701,2288066856,36,0,0,16384,36,9298767986
8601,2285886507,6697757,2292584264,22,0,1,12800,22,6285444315
8602,2285886682,6993124,2292879806,11,0,1,55808,11,1118735258
8603,2285897233,1405988,2287303221,46,0,0,139776,46,1832869306
8604,2285897429,683849,2286581278,25,0,0,81408,25,4614089360
8605,2285899987,6979834,2292879821,0,0,1,512,0,10476977117
8606,2285918533,1403461,2287321994,0,0,0,36864,0,524027131
8607,2285918901,1685939,2287604840,18,0,0,11776,18,1250050810
8608,2285923227,6956609,2292879836,48,0,1,6656,48,10578215627
8609,2285943663,2385275,2288328938,18,0,0,60928,18,8656550689
8610,2285953827,2516400,2288470227,8,0,0,71680,8,4619963581
8611,2285963474,1398853,2287362327,45,0,0,60416,45,5042772991
8612,2285973172,1000572,2286973744,7,0,0,26112,7,4311625645
8613,2285981101,605208,2286586309,6,0,0,16384,6,1115646114
8614,2286006293,319019,2286325312,0,0,0,8192,0,1843190229
8615,2286007064,2125189,2288132253,4,0,0,8192,4,8459748204
8616,2286008160,6942825,2292950985,43,0,1,31232,43,5542336502
8617,2286009843,1414278,2287424121,4,0,0,30208,4,9790565675
8618,2286012859,2566095,2288578954,16,0,0,38400,16,4232092949
8619,2286030283,6920717,2292951000,15,0,1,2048,15,10068210175
8620,2286031417,2667711,2288699128,13,0,0,113664,13,10418939936
8621,2286043994,6907029,2292951023,2,0,1,8704,2,1996847151
8622,2286055417,2048875,2288104292,42,0,0,27648,42,3520348132
8623,2286059468,6962038,2293021506,12,0,1,4608,12,5752990348
8624,2286060701,2207735,2288268436,23,0,0,165376,23,8775832547
8625,2286064863,7019856,2293084719,29,0,1,3584,29,8965603511
8626,2286075205,3289192,2289364397,26,0,0,49152,26,9697733363
8627,2286098240,1205308,2287303548,47,0,0,1024,47,5167215676
8628,2286105913,762703,2286868616,16,0,0,28672,16,8861872375
8629,2286128919,565191,2286694110,41,0,0,8704,41,6988664268
8630,2286136077,2282054,2288418131,35,0,0,30208,35,8281610104
8631,2286139776,1273670,2287413446,41,0,0,50176,41,2756680408
8632,2286155366,991265,2287146631,28,0,0,16384,28,4993119641
8633,2286161307,7264799,2293426106,11,0,1,158720,11,7252689007
8634,2286161520,1337463,2287498983,29,0,0,2560,29,4544225093
8635,2286171625,698270,2286869895,10,0,0,4096,10,3006425805
8636,2286178632,751447,2286930079,35,0,0,3072,35,9222259292
8637,2286182033,2314680,2288496713,2,0,0,4096,2,5359803736
8638,2286193185,798708,2286991893,30,0,0,2560,30,5286833383
8639,2286204994,1301424,2287506418,2,0,0,5632,2,5716787238
8640,2286218703,989309,2287208012,4,0,0,18944,4,4430367947
8641,2286242107,683599,2286925706,43,0,0,1536,43,5203232510
8642,2286244027,1188704,2287432731,19,0,0,4096,19,3355382595
8643,2286254783,1950583,2288205366,41,0,0,65536,41,769921669
8644,2286256922,1328046,2287584968,28,0,0,32256,28,7773026554
8645,2286283041,7143080,2293426121,20,0,1,9216,20,7628368330
8646,2286293297,7132839,2293426136,4,0,1,11776,4,2511025815
8647,2286334500,580945,2286915445,39,0,0,23552,39,861976262
8648,2286335228,1210939,2287546167,20,0,0,41472,20,1036228169
8649,2286345158,1437530,2287782688,10,0,0,67072,10,3847632660
8650,2286348900,766369,2287115269,30,0,0,2560,30,8721818069
8651,2286349457,291255,2286640712,47,0,0,4096,47,10342704530
8652,2286359905,2020867,2288380772,28,0,0,35840,28,10299341768
8653,2286379872,1248684,2287628556,19,0,0,32256,19,9111828013
8654,2286386501,1983328,2288369829,20,0,0,10752,20,5096814157
8655,2286400842,7173290,2293574132,36,0,1,4096,36,8906520426
8656,2286406747,846905,2287253652,24,0,0,512,24,8560486084
8657,2286422054,279556,2286701610,5,0,0,3072,5,1397386449
8658,2286426224,569201,2286995425,2,0,0,9728,2,6185888874
8659,2286430007,1178436,2287608443,38,0,0,11776,38,5565198291
8660,2286434517,1983973,2288418490,23,0,0,1024,23,2494298488
8661,2286463497,224638,2286688135,45,0,0,13312,45,669992064
8662,2286483965,7091445,2293575410,2,0,1,10752,2,2964507427
8663,2286489566,696264,2287185830,6,0,0,12800,6,9477463310
8664,2286496356,7100182,2293596538,48,0,1,5120,48,3559180764
8665,2286526740,3025448,2289552188,46,0,0,33792,46,3988280366
8666,2286536777,7070711,2293607488,34,0,1,4608,34,9401118547
8667,2286537115,436956,2286974071,1,0,0,1024,1,7945253675
8668,2286544869,3063092,2289607961,14,0,0,42496,14,2440968152
8669,2286548603,704878,2287253481,37,0,0,8192,37,626496960
8670,2286560440,3178573,2289739013,48,0,0,132608,48,6942444071
8671,2286566754,635471,2287202225,4,0,0,53760,4,3373792430
8672,2286567773,7052389,2293620162,21,0,1,8704,21,7928621303
8673,2286571299,739440,2287310739,47,0,0,23552,47,7570697891
8674,2286573969,1281648,2287855617,7,0,0,39424,7,5535475555
8675,2286577825,506932,2287084757,48,0,0,13312,48,4466837
8676,2286582960,969200,2287552160,40,0,0,18944,40,6432123313
8677,2286622288,759102,2287381390,48,0,0,62464,48,7955160969
8678,2286641879,2124430,2288766309,8,0,0,3584,8,4710261058
8679,2286644989,6975188,2293620177,14,0,1,2560,14,9173966261
8680,2286655466,1622829,2288278295,4,0,0,32256,4,2615873143
8681,2286670068,6986503,2293656571,43,0,1,8704,43,3300394645
8682,2286670774,1850911,2288521685,19,0,0,1536,19,8465704048
8683,2286671356,418112,2287089468,9,0,0,15360,9,4542412929
8684,2286692342,1464106,2288156448,44,0,0,79360,44,4838451091
8685,2286693011,557959,2287250970,34,0,0,16896,34,7988395750
8686,2286709387,7013757,2293723144,28,0,1,9728,28,7884891468
8687,2286713559,875034,2287588593,6,0,0,8192,6,9615902039
8688,2286717073,1196812,2287913885,47,0,0,30720,47,2643315328
8689,2286722455,709013,2287431468,13,0,0,24064,13,3872221387
8690,2286758785,6965257,2293724042,3,0,1,3072,3,1376749627
8691,2286764803,3070147,2289834950,28,0,0,24576,28,10581718065
8692,2286768166,1201873,2287970039,1,0,0,47104,1,8378916771
8693,2286799016,1117551,2287916567,9,0,0,5120,9,4911435643
8694,2286803803,713222,2287517025,20,0,0,5632,20,7039565538
8695,2286818088,6906940,2293725028,22,0,1,1536,22,317405520
8696,2286824884,1878939,2288703823,17,0,0,15360,17,1693656188
8697,2286840055,1074937,2287914992,41,0,0,3584,41,116793487
8698,2286843977,1217864,2288061841,10,0,0,19968,10,1373560321
8699,2286849027,6876667,2293725694,15,0,1,1024,15,1571437591
8700,2286851883,529678,2287381561,5,0,0,512,5,2176139656
8701,2286860453,952047,2287812500,14,0,0,34304,14,540560279
8702,2286862727,850938,2287713665,15,0,0,10752,15,3406397826
8703,2286874023,1904455,2288778478,22,0,0,19968,22,4904195708
8704,2286874390,635002,2287509392,14,0,0,4608,14,1593628114
8705,2286884218,6842347,2293726565,1,0,1,12288,1,3214485279
8706,2286889752,896079,2287785831,4,0,0,10240,4,3569915592
8707,2286897194,964725,2287861919,19,0,0,512,19,2589539269
8708,2286918198,751736,2287669934,6,0,0,36352,6,4985302196
8709,2286920477,6860096,2293780573,22,0,1,4608,22,9528189579
8710,2286930015,941292,2287871307,33,0,0,15360,33,5535051634
8711,2286934751,6858820,2293793571,8,0,1,9216,8,5515521359
8712,2286948033,1090472,2288038505,25,0,0,26112,25,3746297639
8713,2286948634,986279,2287934913,44,0,0,11264,44,7271598206
8714,2286957891,677888,2287635779,17,0,0,23552,17,4985173232
8715,2286959223,1056192,2288015415,33,0,0,7168,33,10175100304
8716,2286962974,1379175,2288342149,20,0,0,20480,20,1890178556
8717,2286965626,1157261,2288122887,42,0,0,14848,42,770066534
8718,2286990795,1340357,2288331152,24,0,0,6656,24,7777039531
8719,2286992220,1172823,2288165043,39,0,0,28160,39,4403612077
8720,2286997740,1450624,2288448364,27,0,0,87552,27,9751043528
8721,2286999194,2921249,2289920443,12,0,0,17920,12,7349361176
8722,2287000094,985059,2287985153,40,0,0,1536,40,3285514215
8723,2287005741,2020044,2289025785,9,0,0,1536,9,6942263889
8724,2287006956,3030017,2290036973,13,0,0,39424,13,8252295910
8725,2287033969,1848100,2288882069,0,0,0,14848,0,9306783821
8726,2287040537,6753049,2293793586,36,0,1,15872,36,6356550532
8727,2287049142,671090,2287720232,28,0,0,21504,28,9383596314
8728,2287053542,1543568,2288597110,7,0,0,30720,7,8681026012
8729,2287058945,3104043,2290162988,26,0,0,78336,26,4279116018
8730,2287061694,147314,2287209008,18,0,0,2048,18,9254016031
8731,2287065744,3202402,2290268146,12,0,0,18944,12,6910567968
8732,2287084924,1199813,2288284737,49,0,0,6656,49,2511998791
8733,2287091849,1893044,2288984893,32,0,0,1024,32,9553993829
8734,2287145923,6647678,2293793601,20,0,1,3072,20,2147597603
8735,2287152107,1251642,2288403749,38,0,0,26624,38,503320134
8736,2287167780,693944,2287861724,30,0,0,19968,30,4369269556
8737,2287174181,270451,2287444632,36,0,0,1024,36,5679175829
8738,2287197588,6627798,2293825386,46,0,1,13312,46,1675735048
8739,2287198166,757506,2287955672,8,0,0,23040,8,4970867872
8740,2287209187,1101172,2288310359,3,0,0,83456,3,2507122009
8741,2287220621,796066,2288016687,10,0,0,3072,10,4322912374
8742,2287227877,6615013,2293842890,20,0,1,5632,20,6750514678
8743,2287254691,760895,2288015586,11,0,0,512,11,9915572629
8744,2287259278,1069831,2288329109,22,0,0,512,22,6668071274
8745,2287290359,3181123,2290471482,42,0,0,43008,42,1314695920
8746,2287302239,883144,2288185383,17,0,0,23040,17,9932398939
8747,2287315555,175683,2287491238,34,0,0,11264,34,2909574693
8748,2287319062,736672,2288055734,18,0,0,21504,18,8891305277
8749,2287327537,1779208,2289106745,49,0,0,24064,49,2336767301
8750,2287336521,997610,2288334131,35,0,0,9728,35,8877811066
8751,2287345117,730270,2288075387,39,0,0,9216,39,3938434793
8752,2287345895,2094799,2289440694,19,0,0,11264,19,1919726431
8753,2287359659,1006879,2288366538,47,0,0,45056,47,2809524883
8754,2287363141,6496189,2293859330,46,0,1,16384,46,730523294
8755,2287372956,1695605,2289068561,4,0,0,4608,4,8584517482
8756,2287373283,6586550,2293959833,11,0,1,29696,11,9464047275
8757,2287374547,441712,2287816259,5,0,0,12288,5,7682067203
8758,2287388574,6576444,2293965018,19,0,1,16384,19,9341399153
8759,2287396309,953975,2288350284,47,0,0,26624,47,7046209943
8760,2287397223,7038591,2294435814,11,0,1,163840,11,7734066439
8761,2287399152,1072838,2288471990,4,0,0,5632,4,6037838160
8762,2287407860,1479840,2288887700,11,0,0,18432,11,4869684470
8763,2287410100,300274,2287710374,5,0,0,39424,5,7331777474
8764,2287411056,871638,2288282694,13,0,0,14336,13,6243127028
8765,2287418653,3263087,2290681740,9,0,0,49152,9,9666049848
8766,2287442370,355675,2287798045,49,0,0,9216,49,7444627475
8767,2287458652,211453,2287670105,23,0,0,512,23,1969267750
8768,2287496922,1519918,2289016840,33,0,0,28672,33,1926137335
8769,2287513733,1007469,2288521202,15,0,0,13312,15,7895735760
8770,2287518195,1327363,2288845558,41,0,0,32256,41,7464908000
8771,2287539795,402278,2287942073,8,0,0,14336,8,3279392284
8772,2287545352,625478,2288170830,30,0,0,18944,30,5532280249
8773,2287560070,535783,2288095853,25,0,0,10752,25,8781352581
8774,2287572784,836128,2288408912,30,0,0,16896,30,5090444115
8775,2287586378,6856821,2294443199,14,0,1,12288,14,7567845589
8776,2287615891,1788915,2289404806,38,0,0,33280,38,6837079288
8777,2287616261,6826953,2294443214,19,0,1,6656,19,9344705949
8778,2287616732,7028985,2294645717,18,0,1,26112,18,3326079364
8779,2287617969,777653,2288395622,9,0,0,19456,9,10628774279
8780,2287634822,915383,2288550205,7,0,0,30208,7,3722306931
8781,2287639605,1191971,2288831576,41,0,0,55808,41,5621781545
8782,2287644923,7089075,2294733998,12,0,1,13824,12,3758086913
8783,2287668468,721211,2288389679,15,0,0,29184,15,1600990158
8784,2287676083,676712,2288352795,41,0,0,8192,41,2610609430
8785,2287680890,793635,2288474525,20,0,0,5120,20,5766054383
8786,2287685552,7069863,2294755415,14,0,1,12800,14,8952605027
8787,2287694341,1120216,2288814557,2,0,0,32768,2,4417306548
8788,2287714812,915375,2288630187,2,0,0,17920,2,2579683967
8789,2287715031,1287208,2289002239,2,0,0,20992,2,1875167673
8790,2287739166,984124,2288723290,24,0,0,10240,24,2901514093
8791,2287740459,1018956,2288759415,3,0,0,46592,3,5632112464
8792,2287741504,1732452,2289473956,10,0,0,32256,10,7500886216
8793,2287754957,245278,2288000235,40,0,0,12800,40,5561025945
8794,2287762035,805204,2288567239,23,0,0,29696,23,533061622
8795,2287762926,305669,2288068595,3,0,0,5632,3,10582079392
8796,2287770492,863774,2288634266,47,0,0,13312,47,305488846
8797,2287795751,6976451,2294772202,2,0,1,7168,2,8956936433
8798,2287812598,3019293,2290831891,40,0,0,33792,40,2573207614
8799,2287813497,1045667,2288859164,42,0,0,27136,42,9379258772
8800,2287841465,376552,2288218017,23,0,0,41472,23,7574763490
8801,2287842120,1138063,2288980183,40,0,0,19456,40,2116243232
8802,2287843979,1724963,2289568942,47,0,0,40960,47,6519047425
8803,2287844004,205163,2288049167,47,0,0,18944,47,7020099537
8804,2287869850,2004297,2289874147,2,0,0,20992,2,2356255820
8805,2287886639,3031000,2290917639,0,0,0,38912,0,798857019
8806,2287902183,1295668,2289197851,28,0,0,6656,28,635538521
8807,2287957310,807892,2288765202,41,0,0,18944,41,4641732030
8808,2287961213,120102,2288081315,12,0,0,512,12,2581448109
8809,2287967184,2216973,2290184157,35,0,0,14848,35,3517667434
8810,2287973913,1165833,2289139746,18,0,0,13824,18,9229573207
8811,2287974170,1021658,2288995828,34,0,0,35840,34,4586595818
8812,2287975282,1520137,2289495419,24,0,0,15872,24,5837456987
8813,2287980976,197372,2288178348,5,0,0,10752,5,914417295
8814,2287989051,346835,2288335886,13,0,0,5632,13,1401172207
8815,2287994833,856048,2288850881,6,0,0,13312,6,2113667964
8816,2288006562,6765655,2294772217,0,0,1,3072,0,8876288651
8817,2288040121,3037446,2291077567,28,0,0,66560,28,5336666348
8818,2288045964,2316275,2290362239,28,0,0,33792,28,6531515997
8819,2288052595,1093421,2289146016,12,0,0,14336,12,6345696467
8820,2288056860,228056,2288284916,45,0,0,512,45,3302813135
8821,2288063884,1000355,2289064239,23,0,0,8704,23,3389334739
8822,2288066483,6706269,2294772752,46,0,1,8192,46,5359911145
8823,2288098721,1525479,2289624200,14,0,0,53248,14,5083334557
8824,2288103876,1028624,2289132500,38,0,0,84480,38,5266208553
8825,2288105066,919901,2289024967,36,0,0,19456,36,7994277418
8826,2288112897,6798250,2294911147,32,0,1,9216,32,9089128249
8827,2288193654,227971,2288421625,39,0,0,10240,39,9494430900
8828,2288197392,286478,2288483870,38,0,0,11776,38,5157390038
8829,2288200372,602145,2288802517,45,0,0,56832,45,1848225927
8830,2288201581,7859102,2296060683,11,0,1,146944,11,3499910853
8831,2288217664,917831,2289135495,15,0,0,9728,15,5988107357
8832,2288228083,2261876,2290489959,2,0,0,3072,2,9354060662
8833,2288237853,1005240,2289243093,1,0,0,14848,1,4627809770
8834,2288262004,296172,2288558176,33,0,0,26112,33,9142627574
8835,2288263147,7827741,2296090888,36,0,1,2560,36,4551135981
8836,2288270574,2279513,2290550087,29,0,0,17920,29,9332481909
8837,2288305531,479655,2288785186,41,0,0,16896,41,9387323672
8838,2288350450,7835483,2296185933,29,0,1,19968,29,9647730639
8839,2288361233,7832374,2296193607,48,0,1,8192,48,8410918210
8840,2288383611,7864094,2296247705,21,0,1,11264,21,161032565
8841,2288387478,7916258,2296303736,2,0,1,8192,2,2572971885
8842,2288398651,585915,2288984566,30,0,0,14336,30,818226307
8843,2288415150,2549233,2290964383,5,0,0,49152,5,2487188605
8844,2288418936,7974213,2296393149,8,0,1,18432,8,7901948584
8845,2288423665,524262,2288947927,48,0,0,15872,48,3281238329
8846,2288436000,7957164,2296393164,14,0,1,5120,14,8557784803
8847,2288437432,1343942,2289781374,49,0,0,77312,49,1896849869
8848,2288461679,7932761,2296394440,32,0,1,5120,32,416477389
8849,2288469837,8027301,2296497138,48,0,1,5120,48,3664837148
8850,2288477027,497213,2288974240,37,0,0,50176,37,2695955899
8851,2288485211,1088582,2289573793,36,0,0,15872,36,9793443245
8852,2288490205,2795077,2291285282,35,0,0,43008,35,2013840412
8853,2288492080,1396791,2289888871,29,0,0,48128,29,9970572290
8854,2288498425,664269,2289162694,9,0,0,7168,9,1098555405
8855,2288515347,2676539,2291191886,34,0,0,56320,34,7208101352
8856,2288526460,7972304,2296498764,2,0,1,2560,2,10175144678
8857,2288539979,2480096,2291020075,48,0,0,3072,48,7614098025
8858,2288540010,1246839,2289786849,12,0,0,17920,12,1187874908
8859,2288578220,851534,2289429754,23,0,0,14336,23,8317460491
8860,2288578495,7926081,2296504576,10,0,1,9216,10,6522598736
8861,2288590585,7915476,2296506061,48,0,1,15360,48,4380959481
8862,2288626063,429732,2289055795,14,0,0,9728,14,7916719941
8863,2288632180,675046,2289307226,12,0,0,20992,12,3540627080
8864,2288633982,689325,2289323307,27,0,0,14848,27,5385820664
8865,2288650038,1489067,2290139105,19,0,0,66048,19,4233240096
8866,2288650985,7879456,2296530441,4,0,1,1536,4,5649307865
8867,2288678099,7852357,2296530456,34,0,1,512,34,3910321062
8868,2288681150,2545230,2291226380,15,0,0,9216,15,7446478432
8869,2288707252,774288,2289481540,25,0,0,11776,25,1260868631
8870,2288710373,1127876,2289838249,19,0,0,10752,19,10669020412
8871,2288713706,615738,2289329444,45,0,0,18432,45,6113640334
8872,2288714411,427222,2289141633,5,0,0,6144,5,1344548096
8873,2288716074,217832,2288933906,34,0,0,4096,34,2256633293
8874,2288730959,1205484,2289936443,28,0,0,15872,28,8300678622
8875,2288731680,293622,2289025302,16,0,0,1024,16,7188054706
8876,2288737675,425992,2289163667,7,0,0,3072,7,249360751
8877,2288764732,777081,2289541813,38,0,0,21504,38,2352592715
8878,2288768287,427521,2289195808,41,0,0,18944,41,2953798112
8879,2288769412,565663,2289335075,44,0,0,18432,44,9420235098
8880,2288775091,1092645,2289867736,17,0,0,1024,17,10315436808
8881,2288795455,2862774,2291658229,12,0,0,50688,12,7320714870
8882,2288813803,854541,2289668344,9,0,0,68096,9,323029658
8883,2288825815,703458,2289529273,42,0,0,95232,42,8365008118
8884,2288845449,342734,2289188183,0,0,0,23040,0,9598495345
8885,2288852864,212498,2289065362,20,0,0,3584,20,7719492041
8886,2288857124,7673347,2296530471,14,0,1,11776,14,1477238029
8887,2288866003,690436,2289556439,38,0,0,13824,38,6621627369
8888,2288875849,802205,2289678054,41,0,0,18432,41,2029487587
8889,2288884996,391306,2289276302,29,0,0,10240,29,7517338275
8890,2288903932,2612608,2291516540,38,0,0,54272,38,423465749
8891,2288906771,242335,2289149106,10,0,0,4096,10,9853637322
8892,2288925110,711883,2289636993,25,0,0,19456,25,1166192777
8893,2288928176,607070,2289535246,6,0,0,19456,6,863534021
8894,2288937207,1133789,2290070996,19,0,0,67584,19,5071727623
8895,2288952183,1227435,2290179618,17,0,0,7168,17,820944380
8896,2288996992,7533494,2296530486,29,0,1,6656,29,4751887674
8897,2289005451,751829,2289757280,31,0,0,59904,31,1143744780
8898,2289014442,852944,2289867386,1,0,0,9728,1,5422761734
8899,2289021170,888635,2289909805,19,0,0,512,19,1550890000
8900,2289038263,328445,2289366708,37,0,0,4096,37,2040790463
8901,2289046979,763917,2289810896,2,0,0,78848,2,2045104954
8902,2289048460,778987,2289827447,18,0,0,54272,18,1235898761
8903,2289055988,7474521,2296530509,49,0,1,18432,49,1694854391
8904,2289056374,7660145,2296716519,11,0,1,55808,11,4975109259
8905,2289060636,803771,2289864407,29,0,0,18432,29,6270261204
8906,2289068005,1224148,2290292153,36,0,0,20480,36,6473608445
8907,2289078130,679641,2289757771,18,0,0,1536,18,6638571305
8908,2289090743,750485,2289841228,20,0,0,9728,20,7676561519
8909,2289109876,902631,2290012507,31,0,0,55296,31,1491430753
8910,2289109903,818261,2289928164,1,0,0,20480,1,3350660565
8911,2289127676,781958,2289909634,39,0,0,68096,39,540971649
8912,2289127726,544689,2289672415,39,0,0,13312,39,8469372840
8913,2289130292,2444007,2291574299,47,0,0,15360,47,5044158757
8914,2289166302,1286309,2290452611,48,0,0,1536,48,2605255388
8915,2289175523,2615850,2291791373,48,0,0,102400,48,7650581080
8916,2289183444,738450,2289921894,16,0,0,4608,16,4272666738
8917,2289200203,2459913,2291660116,44,0,0,6144,44,174155566
8918,2289223440,1030769,2290254209,34,0,0,63488,34,5600192119
8919,2289236864,612031,2289848895,4,0,0,25088,4,4127658825
8920,2289253633,693202,2289946835,1,0,0,4608,1,8353112832
8921,2289283758,1249871,2290533629,40,0,0,9216,40,8179750320
8922,2289331049,1050354,2290381403,28,0,0,14848,28,3479713551
8923,2289332978,651335,2289984313,19,0,0,16384,19,4676395440
8924,2289338080,576888,2289914968,23,0,0,16896,23,5873897520
8925,2289339172,7472263,2296811435,46,0,1,3072,46,8133904955
8926,2289352440,943004,2290295444,46,0,0,10752,46,8586498463
8927,2289370674,7457196,2296827870,0,0,1,2560,0,3322409961
8928,2289380281,1326293,2290706574,18,0,0,29184,18,778155419
8929,2289401908,589345,2289991253,21,0,0,14336,21,2491974227
8930,2289410677,7435137,2296845814,15,0,1,10240,15,3064939020
8931,2289414326,657793,2290072119,49,0,0,3584,49,272184066
8932,2289423366,7422794,2296846160,8,0,1,512,8,6897208019
8933,2289445310,1365224,2290810534,9,0,0,15360,9,10127937213
8934,2289446149,1074460,2290520609,13,0,0,16896,13,7059150062
8935,2289461458,794014,2290255472,15,0,0,4096,15,4885344413
8936,2289463650,7383176,2296846826,20,0,1,1024,20,3281170166
8937,2289467796,7841187,2297308983,14,0,1,159744,14,7449968662
8938,2289475982,382794,2289858776,4,0,0,1536,4,2746018133
8939,2289476540,381426,2289857966,10,0,0,29696,10,7780089750
8940,2289491032,533876,2290024908,44,0,0,40448,44,4466221203
8941,2289494207,8743476,2298237683,11,0,1,262656,11,2745132395
8942,2289498281,497355,2289995636,7,0,0,14336,7,5500162099
8943,2289508116,8761531,2298269647,12,0,1,22016,12,8412162172
8944,2289509168,539746,2290048914,22,0,0,3072,22,2175294335
8945,2289524406,439183,2289963589,31,0,0,18944,31,4996341935
8946,2289536079,418616,2289954695,19,0,0,10240,19,8530510801
8947,2289549077,8767802,2298316879,25,0,1,3072,25,3077347955
8948,2289555451,621968,2290177419,7,0,0,47104,7,10305506462
8949,2289557322,300971,2289858293,26,0,0,1024,26,10154714493
8950,2289574903,464933,2290039836,25,0,0,9216,25,9948281390
8951,2289596681,8720213,2298316894,22,0,1,8192,22,1158938043
8952,2289637479,464294,2290101773,49,0,0,53248,49,840224680
8953,2289642656,633305,2290275961,25,0,0,25600,25,5899907764
8954,2289668262,1110007,2290778269,1,0,0,5120,1,4041714707
8955,2289686508,807737,2290494245,7,0,0,7168,7,6448993125
8956,2289690312,8626605,2298316917,46,0,1,4096,46,5392821654
8957,2289695599,2100001,2291795600,25,0,0,13824,25,3758410802
8958,2289697814,1168643,2290866457,9,0,0,3072,9,6208810234
8959,2289700022,952443,2290652465,16,0,0,49152,16,2072940309
8960,2289711926,338463,2290050389,4,0,0,2560,4,6705847607
8961,2289712927,728355,2290441282,10,0,0,6144,10,7830004887
8962,2289740898,649961,2290390859,9,0,0,11776,9,2487730535
8963,2289741410,872698,2290614108,43,0,0,86528,43,8193082537
8964,2289756432,429947,2290186379,49,0,0,7168,49,2116638149
8965,2289779504,723116,2290502620,4,0,0,9728,4,540726686
8966,2289805299,471153,2290276452,11,0,0,1536,11,5372880747
8967,2289820061,8550788,2298370849,34,0,1,20992,34,10535628343
8968,2289866888,8509107,2298375995,22,0,1,8192,22,6138239414
8969,2289870344,787612,2290657956,39,0,0,17920,39,7303107627
8970,2289879966,8803019,2298682985,11,0,1,108032,11,150421374
8971,2289882416,332416,2290214832,20,0,0,6656,20,1782668343
8972,2289938155,324204,2290262359,33,0,0,22528,33,47686640
8973,2289948543,1040845,2290989388,14,0,0,20992,14,8476023220
8974,2289957072,1151280,2291108352,2,0,0,11776,2,7259425022
8975,2289958867,1989658,2291948525,33,0,0,44032,33,2822742041
8976,2289993289,119591,2290112880,22,0,0,2048,22,1644769172
8977,2289997921,280262,2290278183,15,0,0,5632,15,6180997938
8978,2289998737,525052,2290523789,38,0,0,7168,38,2891134403
8979,2290001395,333406,2290334801,19,0,0,9216,19,7568862207
8980,2290006988,390126,2290397114,3,0,0,20480,3,3335792866
8981,2290021197,8781914,2298803111,48,0,1,8192,48,4531843796
8982,2290021625,1201932,2291223557,36,0,0,47104,36,9685489148
8983,2290024861,2184632,2292209493,5,0,0,4096,5,5907546396
8984,2290027530,913415,2290940945,35,0,0,23552,35,9657047518
8985,2290029712,198475,2290228187,35,0,0,13312,35,7412798913
8986,2290037942,281104,2290319046,47,0,0,14848,47,10664047450
8987,2290047363,1342857,2291390220,0,0,0,82944,0,4030701417
8988,2290050649,1068022,2291118671,24,0,0,33792,24,1056900532
8989,2290057322,391305,2290448627,42,0,0,3584,42,10031408587
8990,2290088843,8714283,2298803126,41,0,1,5120,41,5965482788
8991,2290101891,613457,2290715348,28,0,0,28672,28,6601373365
8992,2290105069,382652,2290487721,19,0,0,53248,19,7781970287
8993,2290110374,790520,2290900894,14,0,0,17408,14,9050130150
8994,2290112302,8690839,2298803141,4,0,1,512,4,3557470271
8995,2290137379,666736,2290804115,7,0,0,58368,7,9836511175
8996,2290143523,490895,2290634418,21,0,0,66560,21,6326106883
8997,2290145674,612638,2290758312,17,0,0,33280,17,3842266611
8998,2290146223,1275282,2291421505,33,0,0,1024,33,7656148174
8999,2290151602,2115485,2292267087,36,0,0,8192,36,276318063
9000,2290157324,1970587,2292127911,38,0,0,39936,38,8145092400
9001,2290158155,1455029,2291613184,4,0,0,25088,4,2494576314
9002,2290160247,586268,2290746515,2,0,0,18944,2,3082989045
9003,2290201139,703826,2290904965,36,0,0,13312,36,2849551573
9004,2290201682,8601474,2298803156,8,0,1,7168,8,10310794203
9005,2290208595,280389,2290488984,19,0,0,4096,19,7849388483
9006,2290226710,354739,2290581449,9,0,0,19968,9,8689701554
9007,2290228324,284149,2290512473,41,0,0,3584,41,3367916434
9008,2290230515,1255692,2291486207,46,0,0,7168,46,6632770766
9009,2290241264,769713,2291010977,25,0,0,15360,25,10049068259
9010,2290258584,279719,2290538303,35,0,0,1536,35,6915104144
9011,2290283944,255740,2290539684,28,0,0,3584,28,7470597923
9012,2290294969,570537,2290865506,18,0,0,39936,18,5200145516
9013,2290302800,333701,2290636501,0,0,0,6656,0,802149971
9014,2290312464,223439,2290535903,48,0,0,6656,48,295357031
9015,2290321682,8541448,2298863130,34,0,1,7680,34,10353807863
9016,2290322769,1386889,2291709658,22,0,0,53248,22,5336348592
9017,2290338686,358981,2290697667,42,0,0,52224,42,8553119918
9018,2290340926,378977,2290719903,1,0,0,14848,1,3016961367
9019,2290345474,380068,2290725542,42,0,0,18432,42,1503841177
9020,2290350521,1503415,2291853936,47,0,0,26112,47,2750212799
9021,2290370697,524854,2290895551,43,0,0,81408,43,1042270429
9022,2290371996,8493080,2298865076,1,0,1,3072,1,1267277055
9023,2290373864,1047298,2291421162,8,0,0,4096,8,332963245
9024,2290395055,8491655,2298886710,2,0,1,1536,2,8690908031
9025,2290395329,381365,2290776694,45,0,0,16384,45,1603993259
9026,2290431673,517711,2290949384,39,0,0,27648,39,471628339
9027,2290447881,216613,2290664494,31,0,0,8192,31,6915123070
9028,2290451387,1549248,2292000635,18,0,0,72192,18,2663840371
9029,2290454734,8772945,2299227679,0,0,1,43008,0,2052873423
9030,2290458147,506407,2290964554,0,0,0,512,0,8959147029
9031,2290463243,390080,2290853323,20,0,0,20992,20,7676021533
9032,2290466516,8880273,2299346789,27,0,1,25600,27,2603685951
9033,2290493350,412410,2290905760,29,0,0,2560,29,1083118848
9034,2290507878,9171438,2299679316,14,0,1,77824,14,7260162876
9035,2290510721,1569348,2292080069,15,0,0,4096,15,9795553732
9036,2290517003,1900894,2292417897,24,0,0,28160,24,1136221030
9037,2290523590,1138413,2291662003,20,0,0,6144,20,4100702440
9038,2290524440,236227,2290760667,31,0,0,7680,31,963458164
9039,2290526087,1072476,2291598563,7,0,0,1536,7,7347386550
9040,2290529209,897105,2291426314,29,0,0,14336,29,4453383047
9041,2290529609,9195982,2299725591,23,0,1,7168,23,820300608
9042,2290533845,966120,2291499965,11,0,0,28160,11,7665354865
9043,2290551085,9174521,2299725606,20,0,1,3072,20,7308360058
9044,2290560472,275334,2290835806,1,0,0,12800,1,7475473313
9045,2290574167,635015,2291209182,29,0,0,17920,29,6676003455
9046,2290574327,9245188,2299819515,41,0,1,19456,41,2310200382
9047,2290594980,824911,2291419891,22,0,0,97280,22,3668223372
9048,2290597015,1747461,2292344476,36,0,0,54272,36,5747447722
9049,2290604547,500194,2291104741,20,0,0,75264,20,2048859522
9050,2290610503,9267876,2299878379,8,0,1,8192,8,4682292605
9051,2290621544,361433,2290982977,33,0,0,14336,33,4291130141
9052,2290631919,733006,2291364925,12,0,0,24576,12,6139107978
9053,2290638951,229260,2290868211,49,0,0,5632,49,8074895682
9054,2290639762,372018,2291011780,7,0,0,2560,7,144402983
9055,2290648514,477816,2291126330,0,0,0,25088,0,8500447263
9056,2290664836,1764989,2292429825,44,0,0,4096,44,7115022902
9057,2290666167,1491080,2292157247,2,0,0,44544,2,9694576065
9058,2290691287,314995,2291006282,29,0,0,55296,29,3989483814
9059,2290698621,555665,2291254286,23,0,0,12800,23,5282470375
9060,2290708520,9324039,2300032559,4,0,1,49664,4,5620046376
9061,2290720086,9659886,2300379972,11,0,1,92160,11,4737637961
9062,2290726254,874919,2291601173,35,0,0,6656,35,10600190484
9063,2290727655,1622475,2292350130,26,0,0,18432,26,6804531746
9064,2290758061,1278975,2292037036,30,0,0,70144,30,1358885148
9065,2290769133,684401,2291453534,33,0,0,22528,33,4285274711
9066,2290786774,463589,2291250363,20,0,0,29696,20,9159259064
9067,2290833430,1617853,2292451283,14,0,0,39424,14,5923729302
9068,2290833459,1812873,2292646332,26,0,0,40960,26,6461620369
9069,2290863172,9527143,2300390315,0,0,1,1024,0,8630861458
9070,2290869146,212648,2291081794,0,0,0,13824,0,4696495954
9071,2290871534,265483,2291137017,46,0,0,6656,46,2274602940
9072,2290875361,9515300,2300390661,0,0,1,512,0,4702107575
9073,2290880538,603275,2291483813,11,0,0,99328,11,4150601425
9074,2290904660,9519845,2300424505,10,0,1,13312,10,7844071523
9075,2290912875,290832,2291203707,25,0,0,37888,25,4823953533
9076,2290926382,9583270,2300509652,38,0,1,8192,38,4508799524
9077,2290928645,599533,2291528178,37,0,0,512,37,8949516543
9078,2290936759,1325407,2292262166,11,0,0,1024,11,6744688213
9079,2290957852,1626397,2292584249,47,0,0,22528,47,4049885533
9080,2290965165,371196,2291336361,23,0,0,18432,23,9951357858
9081,2290975922,9578206,2300554128,26,0,1,512,26,10098813890
9082,2290977937,468702,2291446639,3,0,0,49664,3,2713499786
9083,2290981428,583663,2291565091,13,0,0,30208,13,3756174673
9084,2290984241,9577881,2300562122,4,0,1,4096,4,4350920843
9085,2291011510,1834025,2292845535,30,0,0,19456,30,6476863654
9086,2291013440,538493,2291551933,35,0,0,68096,35,4743140389
9087,2291015495,279534,2291295029,47,0,0,11776,47,6927441664
9088,2291017927,854120,2291872047,19,0,0,29184,19,1785430291
9089,2291052197,9513699,2300565896,0,0,1,4096,0,8858855224
9090,2291086287,9479624,2300565911,28,0,1,512,28,1278819464
9091,2291093131,428432,2291521563,21,0,0,16384,21,816440990
9092,2291116565,9505007,2300621572,29,0,1,13312,29,9034214499
9093,2291117306,1613458,2292730764,23,0,0,23552,23,3073287271
9094,2291122059,9502739,2300624798,13,0,1,5120,13,5189334476
9095,2291125464,701987,2291827451,26,0,0,24576,26,7575991677
9096,2291128027,9499037,2300627064,29,0,1,3584,29,8951815983
9097,2291149703,1272109,2292421812,28,0,0,12800,28,8151767455
9098,2291157759,271735,2291429494,41,0,0,3072,41,7868524216
9099,2291161866,736442,2291898308,48,0,0,3584,48,9533552133
9100,2291164986,9463358,2300628344,28,0,1,14336,28,2034956763
9101,2291168831,315161,2291483992,29,0,0,512,29,2074875066
9102,2291171376,319994,2291491370,0,0,0,16896,0,7980057335
9103,2291182972,1114108,2292297080,47,0,0,3584,47,575072065
9104,2291201524,354332,2291555856,18,0,0,12800,18,7050710747
9105,2291214355,1614591,2292828946,4,0,0,45056,4,1079223664
9106,2291215511,719583,2291935094,21,0,0,12288,21,3928298263
9107,2291230905,830294,2292061199,40,0,0,4096,40,686727655
9108,2291239173,403597,2291642770,20,0,0,5120,20,8418053074
9109,2291247610,9424366,2300671976,21,0,1,16896,21,5655850015
9110,2291271322,741496,2292012818,20,0,0,39936,20,9932057836
9111,2291300786,545171,2291845957,48,0,0,51200,48,7137562511
9112,2291304040,1007467,2292311507,28,0,0,45568,28,6598544599
9113,2291315205,539526,2291854731,38,0,0,2560,38,4524598504
9114,2291320506,734376,2292054882,25,0,0,39936,25,8786969220
9115,2291359026,9343313,2300702339,27,0,1,8192,27,1155476393
9116,2291361242,514857,2291876099,31,0,0,8192,31,5594465127
9117,2291373332,1589593,2292962925,43,0,0,25088,43,3832328828
9118,2291390860,9493183,2300884043,41,0,1,39424,41,2901783272
9119,2291395233,2057670,2293452903,3,0,0,13312,3,8289519025
9120,2291433381,9503143,2300936524,32,0,1,2048,32,3000678256
9121,2291436232,256275,2291692507,24,0,0,2048,24,4765286669
9122,2291443745,298319,2291742064,34,0,0,12288,34,2601890991
9123,2291447517,1301678,2292749195,47,0,0,60416,47,2494253602
9124,2291479691,495804,2291975495,8,0,0,4096,8,9671289763
9125,2291486616,9454611,2300941227,13,0,1,10752,13,929107951
9126,2291487945,676820,2292164765,31,0,0,24576,31,10722319229
9127,2291505685,1643670,2293149355,44,0,0,32768,44,789931393
9128,2291508411,9440473,2300948884,48,0,1,6656,48,3732864486
9129,2291527453,9452639,2300980092,41,0,1,17920,41,4248246596
9130,2291529589,348096,2291877685,30,0,0,5120,30,4925730889
9131,2291538653,712770,2292251423,20,0,0,35328,20,6283215232
9132,2291541355,548794,2292090149,28,0,0,11264,28,8952635295
9133,2291554860,1197650,2292752510,2,0,0,10752,2,2066510846
9134,2291561535,388573,2291950108,29,0,0,5120,29,4530906374
9135,2291570156,9409951,2300980107,26,0,1,1024,26,3847107159
9136,2291582102,1435895,2293017997,8,0,0,1024,8,6151029923
9137,2291593980,1817829,2293411809,26,0,0,166912,26,1480973430
9138,2291601246,1238346,2292839592,39,0,0,21504,39,1445770602
9139,2291607408,1169936,2292777344,0,0,0,1536,0,2565426811
9140,2291621519,453126,2292074645,9,0,0,26624,9,4314530455
9141,2291637528,1523489,2293161017,12,0,0,32768,12,2504194781
9142,2291638338,1010045,2292648383,10,0,0,6656,10,954941811
9143,2291638887,9344183,2300983070,44,0,1,8192,44,5712378016
9144,2291647811,367830,2292015641,19,0,0,9216,19,8395519715
9145,2291648609,679308,2292327917,22,0,0,512,22,1739819710
9146,2291651300,391391,2292042691,9,0,0,18432,9,10197304180
9147,2291655783,1126123,2292781906,46,0,0,3072,46,7725976847
9148,2291668731,882896,2292551627,13,0,0,39936,13,9496358381
9149,2291668899,9344358,2301013257,31,0,1,3584,31,507816089
9150,2291686264,425587,2292111851,30,0,0,32768,30,1548804811
9151,2291738648,814710,2292553358,12,0,0,5632,12,8846818817
9152,2291744581,583165,2292327746,9,0,0,53248,9,3873436149
9153,2291752382,9260890,2301013272,26,0,1,3072,26,7499546896
9154,2291757811,594206,2292352017,40,0,0,6144,40,9357586489
9155,2291783590,452146,2292235736,38,0,0,16896,38,6513301258
9156,2291784094,9242690,2301026784,12,0,1,13824,12,2296850417
9157,2291784989,9242871,2301027860,18,0,1,13312,18,4222284795
9158,2291800884,9235298,2301036182,41,0,1,512,41,8224685542
9159,2291810220,1127116,2292937336,22,0,0,70144,22,7887263742
9160,2291820108,615573,2292435681,34,0,0,8192,34,1584181309
9161,2291821471,238457,2292059928,42,0,0,15872,42,2733764823
9162,2291826295,1053496,2292879791,8,0,0,38400,8,7962505675
9163,2291829423,1003594,2292833017,45,0,0,13312,45,6323160304
9164,2291830996,1059463,2292890459,21,0,0,34816,21,9320487400
9165,2291842814,387759,2292230573,41,0,0,16896,41,5275720115
9166,2291847109,9189419,2301036528,10,0,1,512,10,5980166939
9167,2291848664,206389,2292055053,7,0,0,512,7,8324761173
9168,2291866829,497938,2292364767,35,0,0,33792,35,10324281792
9169,2291871883,1130207,2293002090,13,0,0,79872,13,892126854
9170,2291881249,655784,2292537033,11,0,0,43520,11,9240711395
9171,2291909423,493511,2292402934,6,0,0,11264,6,5264181356
9172,2291914226,570297,2292484523,38,0,0,72192,38,2236769075
9173,2291916433,1703714,2293620147,2,0,0,41472,2,122843524
9174,2291941705,926363,2292868068,38,0,0,22528,38,2413839460
9175,2291962978,884460,2292847438,41,0,0,6144,41,9791869170
9176,2291971791,605571,2292577362,2,0,0,29184,2,4509132326
9177,2291980864,720026,2292700890,35,0,0,7168,35,6233097151
9178,2292004630,9033524,2301038154,26,0,1,2560,26,2466491377
9179,2292008988,767873,2292776861,6,0,0,79872,6,7323947963
9180,2292009447,9031933,2301041380,28,0,1,5120,28,2126935436
9181,2292023761,931497,2292955258,24,0,0,13824,24,9327465520
9182,2292042079,873862,2292915941,2,0,0,74240,2,8314572839
9183,2292050750,744751,2292795501,23,0,0,44544,23,8709008442
9184,2292062853,660720,2292723573,46,0,0,68608,46,1717457831
9185,2292069153,8973213,2301042366,11,0,1,1536,11,1629364561
9186,2292087849,8986678,2301074527,2,0,1,13312,2,2012426197
9187,2292091042,1182728,2293273770,27,0,0,22016,27,5496537964
9188,2292097359,521276,2292618635,13,0,0,512,13,5686405878
9189,2292109235,1012978,2293122213,18,0,0,65024,18,10292018465
9190,2292110352,548880,2292659232,49,0,0,7680,49,6337989057
9191,2292116113,1480410,2293596523,16,0,0,24576,16,3397497551
9192,2292118656,1060926,2293179582,35,0,0,512,35,8609591428
9193,2292122889,1079688,2293202577,13,0,0,15872,13,7085616383
9194,2292135944,9005978,2301141922,28,0,1,27648,28,8745761581
9195,2292150853,742445,2292893298,14,0,0,9216,14,7820881835
9196,2292152957,885379,2293038336,45,0,0,6144,45,4413178083
9197,2292164589,437305,2292601894,12,0,0,6656,12,1588893313
9198,2292168723,959917,2293128640,40,0,0,20992,40,7349070102
9199,2292181805,1392312,2293574117,21,0,0,29696,21,2863680877
9200,2292196142,614358,2292810500,16,0,0,49152,16,2212973935
9201,2292202551,8964352,2301166903,15,0,1,4608,15,9043636454
9202,2292212283,356172,2292568455,48,0,0,27648,48,310157892
9203,2292223093,1033049,2293256142,9,0,0,12800,9,7395316636
9204,2292224935,8943351,2301168286,22,0,1,14848,22,1217615265
9205,2292231419,1777959,2294009378,15,0,0,59392,15,3434564241
9206,2292264317,401026,2292665343,41,0,0,14848,41,7509820132
9207,2292269311,545892,2292815203,47,0,0,15360,47,1638598405
9208,2292270799,1552919,2293823718,29,0,0,13824,29,1345737873
9209,2292273170,1664758,2293937928,42,0,0,24576,42,726415497
9210,2292278782,780425,2293059207,19,0,0,30208,19,8311220026
9211,2292286389,1398573,2293684962,5,0,0,512,5,3219933851
9212,2292310852,1727990,2294038842,35,0,0,16896,35,2488869309
9213,2292333569,1759063,2294092632,12,0,0,15872,12,2867117486
9214,2292347553,513628,2292861181,28,0,0,45056,28,7712715069
9215,2292351216,1796700,2294147916,30,0,0,46080,30,7260649569
9216,2292360525,8808107,2301168632,32,0,1,512,32,3324791814
9217,2292369127,411820,2292780947,11,0,0,11776,11,10149664630
9218,2292374720,1509779,2293884499,42,0,0,32768,42,4787937221
9219,2292428635,8741943,2301170578,46,0,1,3072,46,5332183830
9220,2292429960,8741924,2301171884,27,0,1,2048,27,1277864713
9221,2292437038,8736690,2301173728,27,0,1,15360,27,9712851256
9222,2292439656,8777911,2301217567,41,0,1,28672,41,10197231602
9223,2292470662,1807580,2294278242,19,0,0,54272,19,7850124399
9224,2292533564,1937277,2294470841,8,0,0,90624,8,796322112
9225,2292537409,1145027,2293682436,35,0,0,3072,35,10202892689
9226,2292564266,384341,2292948607,18,0,0,36864,18,1016230515
9227,2292588451,988534,2293576985,27,0,0,5120,27,1106911748
9228,2292593822,8627672,2301221494,26,0,1,4608,26,5641924096
9229,2292594976,602750,2293197726,12,0,0,37376,12,4698571262
9230,2292620570,2009766,2294630336,39,0,0,11264,39,10678735497
9231,2292634763,544998,2293179761,29,0,0,512,29,4770566895
9232,2292642914,542782,2293185696,24,0,0,3584,24,10166367223
9233,2292656724,8564785,2301221509,31,0,1,512,31,610469187
9234,2292658955,2113216,2294772171,28,0,0,20480,28,8708485541
9235,2292660924,436159,2293097083,39,0,0,22528,39,5791590845
9236,2292666196,1325071,2293991267,37,0,0,40448,37,2857147772
9237,2292666445,1070504,2293736949,13,0,0,3072,13,2522013293
9238,2292669337,582890,2293252227,11,0,0,101888,11,171603623
9239,2292686780,1529986,2294216766,16,0,0,13824,16,4068099754
9240,2292706129,1930774,2294636903,46,0,0,21504,46,3701695069
9241,2292712428,238542,2292950970,40,0,0,7680,40,5747988519
9242,2292722133,1598607,2294320740,18,0,0,36352,18,2192299368
9243,2292724285,337129,2293061414,45,0,0,7168,45,2534732025
9244,2292736509,589726,2293326235,25,0,0,49152,25,319091332
9245,2292743165,516744,2293259909,36,0,0,12288,36,7962509141
9246,2292765135,8458804,2301223939,28,0,1,16384,28,4692658713
9247,2292781695,1229414,2294011109,46,0,0,5632,46,5945014924
9248,2292803511,476002,2293279513,21,0,0,1024,21,8487420978
9249,2292807278,8460707,2301267985,48,0,1,17408,48,6197383936
9250,2292836028,524457,2293360485,7,0,0,22528,7,9520009060
9251,2292866974,547534,2293414508,11,0,0,8704,11,8130876145
9252,2292872319,307092,2293179411,11,0,0,7168,11,9275808732
9253,2292885779,8400038,2301285817,41,0,1,13824,41,10039004745
9254,2292911683,8374149,2301285832,0,0,1,512,0,7884911827
9255,2292913910,2357164,2295271074,5,0,0,29696,5,3035736753
9256,2292917023,557988,2293475011,20,0,0,20992,20,8930087618
9257,2292927295,2447442,2295374737,1,0,0,40960,1,9799539111
9258,2292946996,479087,2293426083,11,0,0,37888,11,7479253376
9259,2292951049,226163,2293177212,7,0,0,8704,7,7048741508
9260,2292951421,1471703,2294423124,30,0,0,90624,30,1108575412
9261,2292996233,1561351,2294557584,30,0,0,85504,30,3736815940
9262,2293004724,602749,2293607473,23,0,0,35840,23,3394357173
9263,2293008808,556246,2293565054,46,0,0,77312,46,7635987038
9264,2293012102,328202,2293340304,33,0,0,6656,33,7906583042
9265,2293040459,8245388,2301285847,49,0,1,1536,49,5778479936
9266,2293042235,533160,2293575395,12,0,0,4096,12,2734528365
9267,2293046866,1576568,2294623434,34,0,0,68608,34,2144953656
9268,2293050997,8234865,2301285862,36,0,1,512,36,7092051827
9269,2293062827,478656,2293541483,45,0,0,43008,45,3055163273
9270,2293083094,205244,2293288338,36,0,0,3584,36,10638179340
9271,2293085468,1916098,2295001566,30,0,0,7168,30,768694395
9272,2293095833,8190044,2301285877,26,0,1,5120,26,833114182
9273,2293107699,8279709,2301387408,14,0,1,116224,14,2997000593
9274,2293112174,8281875,2301394049,49,0,1,3072,49,9857259381
9275,2293128016,2014715,2295142731,8,0,0,54784,8,9208574054
9276,2293130775,8294193,2301424968,0,0,1,33792,0,6119780460
9277,2293143380,305405,2293448785,33,0,0,19968,33,10613420289
9278,2293143969,537516,2293681485,47,0,0,17408,47,4453643651
9279,2293144335,612418,2293756753,14,0,0,25088,14,5654256634
9280,2293156495,8271952,2301428447,31,0,1,2048,31,4861742825
9281,2293158192,430820,2293589012,30,0,0,39424,30,1146201343
9282,2293169952,506198,2293676150,12,0,0,29696,12,7333989877
9283,2293182772,448496,2293631268,29,0,0,36352,29,6309026353
9284,2293208188,1807946,2295016134,22,0,0,27136,22,9695512745
9285,2293209486,840170,2294049656,23,0,0,16384,23,841574268
9286,2293229086,1470789,2294699875,35,0,0,2048,35,9278146942
9287,2293259775,2034272,2295294047,6,0,0,22528,6,896434282
9288,2293277687,496046,2293773733,28,0,0,10240,28,4230135056
9289,2293282551,402240,2293684791,42,0,0,7680,42,6363360009
9290,2293289254,446744,2293735998,43,0,0,25600,43,8536323720
9291,2293313252,319615,2293632867,4,0,0,5120,4,6850379514
9292,2293313592,560908,2293874500,43,0,0,8192,43,10333092952
9293,2293325205,567772,2293892977,45,0,0,15360,45,6826910179
9294,2293325652,959770,2294285422,6,0,0,2560,6,8113084505
9295,2293336122,457434,2293793556,7,0,0,41984,7,5173938271
9296,2293338028,1057469,2294395497,26,0,0,139776,26,159628954
9297,2293345149,681434,2294026583,17,0,0,5120,17,10020076466
9298,2293362298,1109830,2294472128,44,0,0,4096,44,6453539932
9299,2293369748,353381,2293723129,17,0,0,10240,17,2682833641
9300,2293370145,428552,2293798697,0,0,0,6656,0,1583254487
9301,2293381386,8050607,2301431993,13,0,1,5632,13,7264566329
9302,2293396151,270936,2293667087,36,0,0,19456,36,656815062
9303,2293397557,2044990,2295442547,14,0,0,26112,14,743110077
9304,2293426803,8008416,2301435219,11,0,1,5120,11,1699767882
9305,2293438399,389151,2293827550,26,0,0,3584,26,9165325112
9306,2293449995,507338,2293957333,15,0,0,20480,15,10322562263
9307,2293475000,413274,2293888274,0,0,0,12288,0,4242190091
9308,2293484139,640537,2294124676,3,0,0,7680,3,3249394778
9309,2293492674,1941894,2295434568,40,0,0,62464,40,4427236915
9310,2293513881,500535,2294014416,17,0,0,10752,17,1321791451
9311,2293513968,607327,2294121295,14,0,0,28160,14,9572352739
9312,2293526140,949123,2294475263,15,0,0,10240,15,7961610431
9313,2293575208,1373187,2294948395,31,0,0,33280,31,9080635611
9314,2293585711,286278,2293871989,11,0,0,14336,11,7401963570
9315,2293608019,619248,2294227267,40,0,0,10752,40,3921020128
9316,2293619868,1111102,2294730970,30,0,0,28672,30,1545005363
9317,2293623566,7813241,2301436807,49,0,1,15872,49,4827170447
9318,2293649331,1805749,2295455080,24,0,0,1024,24,3784373660
9319,2293652268,858562,2294510830,23,0,0,4096,23,7884948321
9320,2293663990,509775,2294173765,27,0,0,7680,27,8733088484
9321,2293666566,1902425,2295568991,21,0,0,7168,21,3987137998
9322,2293690448,333195,2294023643,22,0,0,512,22,5607399360
9323,2293702798,1905458,2295608256,21,0,0,54272,21,634326413
9324,2293703014,327632,2294030646,4,0,0,5120,4,2750849205
9325,2293740307,419470,2294159777,2,0,0,2560,2,7820725689
9326,2293746998,7693355,2301440353,0,0,1,5632,0,6417915306
9327,2293786407,840474,2294626881,7,0,0,11264,7,1583751524
9328,2293788122,7654450,2301442572,11,0,1,11264,11,1526610297
9329,2293798630,1327394,2295126024,27,0,0,33792,27,2986778742
9330,2293807748,635257,2294443005,4,0,0,23552,4,6585600714
9331,2293822762,1115462,2294938224,21,0,0,59904,21,5572138290
9332,2293823649,1740304,2295563953,19,0,0,51200,19,5867288223
9333,2293826545,1081896,2294908441,37,0,0,76800,37,4953677172
9334,2293832237,674558,2294506795,21,0,0,23552,21,1293633531
9335,2293832875,1429120,2295261995,47,0,0,33280,47,239806334
9336,2293836373,7611351,2301447724,44,0,1,5632,44,10058359215
9337,2293838032,807654,2294645686,29,0,0,28672,29,8442107348
9338,2293840081,1159270,2294999351,10,0,0,50688,10,1161427794
9339,2293842795,739201,2294581996,9,0,0,39936,9,8837382171
9340,2293847348,1114160,2294961508,46,0,0,35840,46,7619601965
9341,2293855620,843592,2294699212,36,0,0,50688,36,2561903717
9342,2293862424,573367,2294435791,15,0,0,41472,15,6041948589
9343,2293869908,846350,2294716258,8,0,0,35840,8,3457648944
9344,2293873698,944567,2294818265,17,0,0,24576,17,7034509714
9345,2293878987,7576597,2301455584,36,0,1,6656,36,10728879455
9346,2293882110,1761307,2295643417,43,0,0,3072,43,5013046938
9347,2293900851,248782,2294149633,25,0,0,4096,25,10015955432
9348,2293901915,664290,2294566205,41,0,0,6144,41,5018311864
9349,2293952092,1382149,2295334241,10,0,0,37376,10,9291678516
9350,2293952988,834448,2294787436,9,0,0,41472,9,6608299802
9351,2293958292,7497307,2301455599,26,0,1,2048,26,3638964134
9352,2293968553,1934712,2295903265,36,0,0,19456,36,2361740690
9353,2293971647,710219,2294681866,45,0,0,38912,45,3371324464
9354,2293978862,2063041,2296041903,16,0,0,57856,16,9035421822
9355,2293981947,903079,2294885026,25,0,0,12800,25,8254493779
9356,2293991020,1845035,2295836055,12,0,0,29184,12,2986798548
9357,2294007375,435809,2294443184,41,0,0,512,41,7429300217
9358,2294035420,7420306,2301455726,10,0,1,13824,10,7188073239
9359,2294036464,1360382,2295396846,44,0,0,16896,44,3473616056
9360,2294072672,763385,2294836057,16,0,0,22016,16,5211395565
9361,2294074660,246407,2294321067,0,0,0,1024,0,6480370019
9362,2294080254,1419948,2295500202,0,0,0,10752,0,5755022772
9363,2294084135,1370618,2295454753,35,0,0,35840,35,10660011081
9364,2294107778,738902,2294846680,42,0,0,34816,42,7627131385
9365,2294107884,933583,2295041467,28,0,0,24576,28,8874042070
9366,2294109010,698250,2294807260,17,0,0,12288,17,7784522195
9367,2294110421,1997501,2296107922,6,0,0,18432,6,2703624646
9368,2294115622,2245112,2296360734,10,0,0,49664,10,7428277037
9369,2294124347,1502443,2295626790,6,0,0,3072,6,8480859547
9370,2294130651,427572,2294558223,21,0,0,2048,21,1367879269
9371,2294147246,1566354,2295713600,13,0,0,50688,13,8286627695
9372,2294148150,762982,2294911132,8,0,0,8704,8,4864114975
9373,2294150118,419113,2294569231,37,0,0,6656,37,8877164017
9374,2294151295,1053342,2295204637,6,0,0,59904,6,4772443277
9375,2294152394,656252,2294808646,3,0,0,4096,3,2415279967
9376,2294159019,1005950,2295164969,40,0,0,18432,40,3611125366
9377,2294174039,7301193,2301475232,26,0,1,512,26,7328284175
9378,2294177632,1286215,2295463847,14,0,0,28672,14,297345778
9379,2294192255,2054008,2296246263,45,0,0,53248,45,8433675464
9380,2294248923,7229215,2301478138,27,0,1,4608,27,3905170315
9381,2294249160,7230604,2301479764,41,0,1,2560,41,9374054938
9382,2294249261,500051,2294749312,45,0,0,2048,45,9176540772
9383,2294254207,7229423,2301483630,10,0,1,6144,10,2191294215
9384,2294262040,1797209,2296059249,45,0,0,19968,45,9061790605
9385,2294277760,7235309,2301513069,41,0,1,10752,41,5582585388
9386,2294296294,2048334,2296344628,14,0,0,29184,14,9557192889
9387,2294305831,497662,2294803493,19,0,0,51712,19,5014300608
9388,2294318751,1640712,2295959463,21,0,0,179712,21,7274856601
9389,2294319140,528982,2294848122,0,0,0,512,0,3395893081
9390,2294329593,1143578,2295473171,23,0,0,13312,23,4745420673
9391,2294331474,945451,2295276925,39,0,0,7168,39,7837273669
9392,2294334343,1075695,2295410038,35,0,0,17408,35,5915750745
9393,2294348074,476621,2294824695,31,0,0,5632,31,10492065616
9394,2294362695,1843423,2296206118,48,0,0,40960,48,8082680235
9395,2294376885,7158320,2301535205,28,0,1,4096,28,890341971
9396,2294383628,1809964,2296193592,47,0,0,25088,47,4423582146
9397,2294399776,283977,2294683753,37,0,0,6144,37,10008320556
9398,2294414650,1896753,2296311403,13,0,0,25088,13,1640262780
9399,2294417520,2272238,2296689758,6,0,0,36352,6,4634257085
9400,2294435289,619999,2295055288,31,0,0,20992,31,5983123285
9401,2294437558,1690508,2296128066,48,0,0,55808,48,8025523086
9402,2294442267,7094445,2301536712,15,0,1,25088,15,2340974919
9403,2294444964,908975,2295353939,12,0,0,2560,12,3439559634
9404,2294458646,631283,2295089929,39,0,0,1024,39,10602002929
9405,2294464585,7080044,2301544629,33,0,1,8192,33,8487698215
9406,2294468296,2016629,2296484925,47,0,0,39936,47,9492107401
9407,2294477686,1497943,2295975629,33,0,0,4096,33,2687718538
9408,2294481127,670355,2295151482,16,0,0,28672,16,5262841646
9409,2294498986,2056072,2296555058,22,0,0,36352,22,5946733959
9410,2294503420,262496,2294765916,43,0,0,16896,43,9778706729
9411,2294536675,311276,2294847951,12,0,0,4096,12,10344206338
9412,2294544272,1022520,2295566792,17,0,0,9216,17,1080500059
9413,2294577475,809913,2295387388,30,0,0,41472,30,1739832295
9414,2294582602,2038258,2296620860,11,0,0,9216,11,1461259214
9415,2294607511,2270516,2296878027,8,0,0,16896,8,6029952693
9416,2294617644,6927241,2301544885,41,0,1,9216,41,9762848955
9417,2294620986,822832,2295443818,20,0,0,4096,20,7157519592
9418,2294625428,2468216,2297093644,47,0,0,15360,47,9128259522
9419,2294630039,1103066,2295733105,36,0,0,15360,36,8128600811
9420,2294642610,1055515,2295698125,7,0,0,41472,7,7180477512
9421,2294681032,1648543,2296329575,0,0,0,46080,0,925681079
9422,2294682402,984847,2295667249,3,0,0,56320,3,9220671468
9423,2294686703,1786039,2296472742,15,0,0,65536,15,6040041649
9424,2294695819,6854238,2301550057,10,0,1,8192,10,2436238108
9425,2294699902,1150731,2295850633,11,0,0,5632,11,6737457635
9426,2294719147,1720931,2296440078,42,0,0,1536,42,92989625
9427,2294741829,2086026,2296827855,9,0,0,25600,9,4891985510
9428,2294742876,1696719,2296439595,8,0,0,43008,8,6432325207
9429,2294743127,2306840,2297049967,5,0,0,99840,5,979691520
9430,2294745499,462429,2295207928,35,0,0,10752,35,3938730019
9431,2294763293,464603,2295227896,20,0,0,5120,20,2256008969
9432,2294765337,6791107,2301556444,47,0,1,24576,47,3746270179
9433,2294782149,827526,2295609675,47,0,0,4608,47,7779535420
9434,2294791859,752088,2295543947,33,0,0,36864,33,8391954191
9435,2294803782,744556,2295548338,10,0,0,14336,10,4918105195
9436,2294825291,6737086,2301562377,29,0,1,6656,29,597198019
9437,2294830523,1699903,2296530426,13,0,0,76288,13,5719281585
9438,2294848112,514130,2295362242,35,0,0,11776,35,4189946998
9439,2294849925,6714078,2301564003,35,0,1,2560,35,4540792146
9440,2294875695,951453,2295827148,30,0,0,6656,30,6964140584
9441,2294882967,923272,2295806239,46,0,0,12288,46,4027901933
9442,2294891988,824287,2295716275,7,0,0,8704,7,6981765989
9443,2294895031,2289732,2297184763,9,0,0,5632,9,449894588
9444,2294905605,1168483,2296074088,43,0,0,2048,43,1087606503
9445,2294913849,1050191,2295964040,6,0,0,8192,6,9444951763
9446,2294914834,6659279,2301574113,49,0,1,23552,49,8193564939
9447,2294918592,1134558,2296053150,35,0,0,36864,35,1644094109
9448,2294920107,495414,2295415521,31,0,0,17920,31,10098101727
9449,2294925107,2000332,2296925439,41,0,0,20992,41,651068505
9450,2294971706,814710,2295786416,30,0,0,64000,30,4760644627
9451,2294986906,509997,2295496903,39,0,0,20480,39,9356320415
9452,2294987995,1393252,2296381247,16,0,0,512,16,10017864853
9453,2295002612,2437325,2297439937,16,0,0,58368,16,7017388923
9454,2295005059,1180859,2296185918,1,0,0,27648,1,6654568907
9455,2295041955,1536895,2296578850,18,0,0,16896,18,332559760
9456,2295059557,2238860,2297298417,39,0,0,13824,39,9228694704
9457,2295062155,512944,2295575099,16,0,0,15360,16,5526959269
9458,2295067307,553311,2295620618,43,0,0,35840,43,1760148752
9459,2295077602,994880,2296072482,47,0,0,12288,47,5459708394
9460,2295078376,6534247,2301612623,34,0,1,5632,34,7057328271
9461,2295088696,815996,2295904692,10,0,0,4608,10,6202026302
9462,2295100401,6514442,2301614843,26,0,1,16896,26,5792946913
9463,2295107810,911287,2296019097,22,0,0,11264,22,4568934730
9464,2295150225,865401,2296015626,13,0,0,66560,13,6656321813
9465,2295161660,1397781,2296559441,27,0,0,14336,27,750986128
9466,2295162997,798361,2295961358,42,0,0,6144,42,10159879041
9467,2295164809,6450700,2301615509,34,0,1,1024,34,4214013673
9468,2295167103,6452298,2301619401,10,0,1,6144,10,5442521909
9469,2295181487,643610,2295825097,38,0,0,47616,38,2699143717
9470,2295199510,762019,2295961529,47,0,0,512,47,7473437943
9471,2295202928,635973,2295838901,43,0,0,4096,43,5941536762
9472,2295206772,903505,2296110277,8,0,0,7680,8,7711986407
9473,2295214856,941057,2296155913,5,0,0,57344,5,5745826942
9474,2295215048,275600,2295490648,14,0,0,3584,14,691989875
9475,2295230875,6388872,2301619747,34,0,1,512,34,1633014108
9476,2295249475,1418531,2296668006,21,0,0,51712,21,409056588
9477,2295251647,1035009,2296286656,10,0,0,32768,10,4322152564
9478,2295255767,812473,2296068240,18,0,0,1536,18,7218141805
9479,2295256180,718186,2295974366,30,0,0,28672,30,7803304355
9480,2295268508,399068,2295667576,27,0,0,1024,27,8228113630
9481,2295276340,485977,2295762317,3,0,0,9728,3,8571541532
9482,2295278168,1371901,2296650069,27,0,0,17920,27,2647857295
9483,2295287569,1085200,2296372769,29,0,0,39424,29,7610693682
9484,2295293000,767668,2296060668,12,0,0,4608,12,4572436070
9485,2295306113,6318025,2301624138,14,0,1,19968,14,6545338015
9486,2295321958,895719,2296217677,12,0,0,37888,12,1201732432
9487,2295340939,971587,2296312526,37,0,0,3584,37,2611183727
9488,2295356836,1863930,2297220766,24,0,0,28160,24,2219146443
9489,2295367045,426406,2295793451,30,0,0,23040,30,2053105135
9490,2295367339,926212,2296293551,41,0,0,22528,41,4651035883
9491,2295373598,523724,2295897322,41,0,0,34304,41,5543094058
9492,2295381425,584190,2295965615,33,0,0,5120,33,3577987124
9493,2295409398,1899375,2297308773,6,0,0,10240,6,1389033422
9494,2295417567,349334,2295766901,0,0,0,4608,0,346024219
9495,2295421956,840459,2296262415,11,0,0,35840,11,6445767390
9496,2295433632,639809,2296073441,7,0,0,3072,7,8893453804
9497,2295442140,626583,2296068723,17,0,0,1536,17,7731344234
9498,2295443971,1930647,2297374618,13,0,0,67072,13,8491280230
9499,2295451651,572609,2296024260,44,0,0,16896,44,8584872390
9500,2295453042,776974,2296230016,17,0,0,40448,17,6340135352
9501,2295462794,706550,2296169344,46,0,0,44032,46,5276651544
9502,2295463377,531954,2295995331,10,0,0,31232,10,4658616060
9503,2295478273,6148771,2301627044,11,0,1,4608,11,7614118265
9504,2295492246,270398,2295762644,41,0,0,1024,41,5358206227
9505,2295533985,847083,2296381068,23,0,0,27136,23,639231541
9506,2295554589,1754355,2297308944,38,0,0,512,38,1186853075
9507,2295558371,6069019,2301627390,28,0,1,512,28,712622827
9508,2295566102,6066114,2301632216,48,0,1,7680,48,6304908040
9509,2295566827,6070215,2301637042,37,0,1,7680,37,10605441530
9510,2295577106,816028,2296393134,35,0,0,31232,35,1173391000
9511,2295585468,482289,2296067757,2,0,0,21504,2,9007561770
9512,2295594316,391468,2295985784,3,0,0,33280,3,7398552320
9513,2295604654,646810,2296251464,4,0,0,12288,4,1888338251
9514,2295613569,224069,2295837638,2,0,0,5120,2,159381253
9515,2295616494,560977,2296177471,45,0,0,26624,45,10502016254
9516,2295634778,6005002,2301639780,8,0,1,2048,8,2801494030
9517,2295636940,945981,2296582921,22,0,0,13312,22,8696637151
9518,2295656893,1864995,2297521888,24,0,0,85504,24,9720110900
9519,2295679171,624550,2296303721,7,0,0,16896,7,10076038999
9520,2295686290,981895,2296668185,36,0,0,512,36,3408588019
9521,2295693671,759080,2296452751,15,0,0,19968,15,9626300782
9522,2295695315,581342,2296276657,10,0,0,37888,10,7593170958
9523,2295704088,1785127,2297489215,24,0,0,12288,24,4250215060
9524,2295705557,6039908,2301745465,41,0,1,137728,41,4042106801
9525,2295712682,1847069,2297559751,45,0,0,4608,45,6928605086
9526,2295727984,1990014,2297717998,18,0,0,14336,18,10281803962
9527,2295734659,941185,2296675844,34,0,0,25088,34,9241161291
9528,2295747049,995294,2296742343,2,0,0,56320,2,4835267045
9529,2295748610,2151986,2297900596,11,0,0,8192,11,1392937942
9530,2295748913,549645,2296298558,4,0,0,16384,4,884877321
9531,2295763275,810412,2296573687,17,0,0,512,17,1912437339
9532,2295776794,284396,2296061190,23,0,0,1536,23,1199344136
9533,2295791459,957459,2296748918,5,0,0,21504,5,957009337
9534,2295791494,5960953,2301752447,14,0,1,19456,14,7596332392
9535,2295795181,1102064,2296897245,18,0,0,10240,18,2347383405
9536,2295795992,1012879,2296808871,37,0,0,7168,37,10440050532
9537,2295800052,535661,2296335713,21,0,0,13824,21,8945819969
9538,2295800831,1989392,2297790223,7,0,0,37888,7,5668621979
9539,2295802353,1015887,2296818240,39,0,0,6656,39,1484305390
9540,2295815804,984505,2296800309,37,0,0,26624,37,1522182736
9541,2295827982,1698616,2297526598,8,0,0,4608,8,5454750358
9542,2295868452,5894390,2301762842,22,0,1,7168,22,9502308977
9543,2295873151,2209808,2298082959,47,0,0,9216,47,7631571861
9544,2295873901,5890887,2301764788,6,0,1,3072,6,1890400957
9545,2295878231,5888503,2301766734,5,0,1,3072,5,8213315338
9546,2295882065,1112509,2296994574,6,0,0,14336,6,3796394641
9547,2295896175,417926,2296314101,23,0,0,5120,23,10089286970
9548,2295909786,1215327,2297125113,47,0,0,45056,47,5755406199
9549,2295973165,1274102,2297247267,29,0,0,46592,29,2391024237
9550,2295974208,5795432,2301769640,3,0,1,4608,3,5974748418
9551,2295984332,5789213,2301773545,27,0,1,5120,27,7698905442
9552,2295984756,262934,2296247690,23,0,0,4608,23,4120682085
9553,2296012689,1516420,2297529109,42,0,0,8192,42,4322949830
9554,2296015942,329645,2296345587,42,0,0,3072,42,6019536402
9555,2296051914,279548,2296331462,6,0,0,6144,6,3979497488
9556,2296058646,206452,2296265098,7,0,0,8704,7,9173534969
9557,2296075185,5707375,2301782560,10,0,1,12800,10,10216706371
9558,2296085394,2067724,2298153118,29,0,0,59904,29,9528983669
9559,2296091214,2178418,2298269632,5,0,0,30720,5,6773042057
9560,2296119633,195887,2296315520,24,0,0,4608,24,5418374460
9561,2296129851,1946370,2298076221,20,0,0,84992,20,2355652049
9562,2296137337,873992,2297011329,16,0,0,35328,16,4544035938
9563,2296153777,602808,2296756585,19,0,0,25088,19,4491350778
9564,2296181551,1856100,2298037651,46,0,0,17920,46,3022142662
9565,2296183928,242548,2296426476,47,0,0,14336,47,6867169269
9566,2296197648,954000,2297151648,16,0,0,87040,16,1438566150
9567,2296203228,1179400,2297382628,42,0,0,18432,42,9382977919
9568,2296209379,5574167,2301783546,34,0,1,1536,34,4583827208
9569,2296210398,500283,2296710681,0,0,0,5120,0,3239755670
9570,2296228483,1242716,2297471199,30,0,0,28160,30,1240348003
9571,2296229653,2111769,2298341422,0,0,0,50176,0,645341386
9572,2296253630,334298,2296587928,1,0,0,16384,1,8807386813
9573,2296278533,5505359,2301783892,10,0,1,512,10,8263674384
9574,2296286088,916766,2297202854,21,0,0,1536,21,2095792665
9575,2296286378,2114876,2298401254,19,0,0,53248,19,1980215422
9576,2296305665,857729,2297163394,13,0,0,7168,13,9306910964
9577,2296308443,1785801,2298094244,34,0,0,26112,34,87512168
9578,2296320002,543409,2296863411,30,0,0,46080,30,9032658415
9579,2296326351,5464953,2301791304,12,0,1,11776,12,9055190354
9580,2296352493,1273189,2297625682,40,0,0,23040,40,4934378354
9581,2296358926,2206002,2298564928,33,0,0,17408,33,5616623281
9582,2296376066,1288878,2297664944,15,0,0,28160,15,8571926932
9583,2296395629,5396341,2301791970,37,0,1,11264,37,1005631064
9584,2296397431,316507,2296713938,45,0,0,1024,45,3533974473
9585,2296415172,263495,2296678667,20,0,0,9216,20,1035842000
9586,2296432361,918254,2297350615,8,0,0,48640,8,7203163322
9587,2296433783,768580,2297202363,40,0,0,51200,40,8588811783
9588,2296435465,380732,2296816197,40,0,0,6656,40,10238481087
9589,2296438464,2223899,2298662363,9,0,0,59904,9,8990087238
9590,2296447033,310838,2296757871,13,0,0,2560,13,8466098686
9591,2296453488,430449,2296883937,48,0,0,11776,48,5225325582
9592,2296457500,5338016,2301795516,12,0,1,5632,12,210097573
9593,2296474589,5322310,2301796899,29,0,1,14848,29,9481623711
9594,2296481694,275382,2296757076,15,0,0,1536,15,5999597135
9595,2296489409,495232,2296984641,43,0,0,17408,43,5221491685
9596,2296494394,1608960,2298103354,22,0,0,16896,22,4752539233
9597,2296505703,747827,2297253530,37,0,0,20480,37,6892966886
9598,2296521525,5277320,2301798845,10,0,1,3072,10,2636027175
9599,2296530286,425579,2296955865,36,0,0,31744,36,6169809412
9600,2296571302,1592082,2298163384,45,0,0,21504,45,10388883630
9601,2296585182,5280679,2301865861,32,0,1,2048,32,3898170014
9602,2296585786,705869,2297291655,37,0,0,60416,37,3384173630
9603,2296589820,1171198,2297761018,30,0,0,13312,30,5880595033
9604,2296615627,286313,2296901940,31,0,0,15360,31,5474547243
9605,2296622109,539086,2297161195,33,0,0,31232,33,261282569
9606,2296630542,5235334,2301865876,30,0,1,13312,30,3066845790
9607,2296642622,1846412,2298489034,24,0,0,3072,24,7009893335
9608,2296643618,2103361,2298746979,22,0,0,46080,22,677275746
9609,2296653709,146771,2296800480,37,0,0,512,37,4602877166
9610,2296670026,5195865,2301865891,36,0,1,3584,36,3051604282
9611,2296674587,1039028,2297713615,31,0,0,20480,31,2250840673
9612,2296683275,622363,2297305638,46,0,0,7680,46,8654618905
9613,2296689683,583541,2297273224,27,0,0,31744,27,7785982479
9614,2296702724,741775,2297444499,40,0,0,11776,40,6446822578
9615,2296713905,373792,2297087697,15,0,0,512,15,5363313923
9616,2296729994,5135912,2301865906,15,0,1,512,15,8255941844
9617,2296745029,421903,2297166932,42,0,0,4096,42,10063964139
9618,2296766722,223469,2296990191,35,0,0,7168,35,1183867183
9619,2296777351,2163682,2298941033,39,0,0,33280,39,8919364755
9620,2296804222,1861783,2298666005,15,0,0,6656,15,6599925632
9621,2296830207,1045702,2297875909,26,0,0,31744,26,4550565729
9622,2296871130,431670,2297302800,32,0,0,14336,32,9974245091
9623,2296883489,493484,2297376973,48,0,0,7680,48,3016296506
9624,2296909988,353541,2297263529,0,0,0,32768,0,10255831828
9625,2296912833,2118236,2299031069,46,0,0,30720,46,7963097931
9626,2296913139,402122,2297315261,11,0,0,18944,11,3496764161
9627,2296913800,1043577,2297957377,16,0,0,18432,16,9118224731
9628,2296920251,479271,2297399522,22,0,0,2048,22,7919238170
9629,2296952619,4913302,2301865921,4,0,1,5120,4,9576992698
9630,2296968894,325296,2297294190,48,0,0,8192,48,7689299383
9631,2296973032,4892904,2301865936,8,0,1,25600,8,5021945275
9632,2296977701,4888250,2301865951,34,0,1,5120,34,9823614497
9633,2296980709,582801,2297563510,32,0,0,12288,32,50690938
9634,2296982437,2461996,2299444433,37,0,0,6656,37,7475321755
9635,2296984939,5000742,2301985681,41,0,1,163840,41,3981147233
9636,2296987272,411611,2297398883,12,0,0,53248,12,9982778942
9637,2296992995,447893,2297440888,33,0,0,3072,33,3940317711
9638,2296995345,357017,2297352362,26,0,0,5632,26,4943684940
9639,2297011082,1123753,2298134835,40,0,0,14336,40,6275256456
9640,2297029816,1277658,2298307474,9,0,0,49664,9,3897230536
9641,2297044774,264700,2297309474,31,0,0,1536,31,3686759366
9642,2297051881,2646677,2299698558,48,0,0,36352,48,9126641761
9643,2297052182,2721886,2299774068,42,0,0,15872,42,5661974150
9644,2297059926,558721,2297618647,41,0,0,51712,41,6063012000
9645,2297079028,224255,2297303283,26,0,0,1536,26,3568976212
9646,2297091349,1486012,2298577361,4,0,0,18432,4,9462015929
9647,2297093680,4972332,2302066012,41,0,1,103424,41,2000099260
9648,2297098226,426953,2297525179,12,0,0,10752,12,8649753228
9649,2297118145,3132811,2300250956,46,0,0,16896,46,737031324
9650,2297144611,4922707,2302067318,27,0,1,2048,27,2381247082
9651,2297167082,1656498,2298823580,33,0,0,49664,33,7488154582
9652,2297175310,478341,2297653651,20,0,0,27136,20,7982759905
9653,2297188079,4891401,2302079480,47,0,1,20480,47,4941311766
9654,2297195733,551764,2297747497,47,0,0,96768,47,999906835
9655,2297197782,2148992,2299346774,26,0,0,18944,26,1729567906
9656,2297199959,494072,2297694031,49,0,0,16384,49,914110183
9657,2297211447,423454,2297634901,9,0,0,30208,9,920112121
9658,2297211690,444643,2297656333,16,0,0,5632,16,10455935089
9659,2297234030,518021,2297752051,44,0,0,8704,44,3278326464
9660,2297236563,629659,2297866222,32,0,0,22528,32,9950065076
9661,2297237132,1013606,2298250738,46,0,0,7168,46,10499688807
9662,2297240991,466369,2297707360,10,0,0,9728,10,7576037976
9663,2297245161,1071703,2298316864,32,0,0,7680,32,6382741631
9664,2297245263,982849,2298228112,21,0,0,16896,21,4742489980
9665,2297283435,1068009,2298351444,21,0,0,8192,21,9781840343
9666,2297288394,252842,2297541236,44,0,0,3072,44,889023257
9667,2297294741,596468,2297891209,11,0,0,32256,11,2412226520
9668,2297303197,1666663,2298969860,9,0,0,17408,9,1635528909
9669,2297309992,1151460,2298461452,12,0,0,24576,12,1649545685
9670,2297314598,340004,2297654602,8,0,0,3072,8,87513001
9671,2297341693,1156557,2298498250,23,0,0,3072,23,2674769624
9672,2297341881,231008,2297572889,10,0,0,19456,10,1843913272
9673,2297358529,496092,2297854621,43,0,0,6144,43,848158113
9674,2297358960,604516,2297963476,45,0,0,19968,45,4432097474
9675,2297359311,286057,2297645368,43,0,0,34304,43,9925941007
9676,2297366832,4713314,2302080146,13,0,1,1024,13,9901696056
9677,2297367544,4713780,2302081324,12,0,1,13824,12,8555957325
9678,2297394816,3111484,2300506300,29,0,0,2048,29,5520910990
9679,2297401152,581245,2297982397,0,0,0,6656,0,6665953271
9680,2297411618,469742,2297881360,45,0,0,512,45,222217941
9681,2297417363,1290936,2298708299,20,0,0,58880,20,10666524846
9682,2297421956,1212117,2298634073,9,0,0,58368,9,3952135898
9683,2297435277,314107,2297749384,23,0,0,6144,23,8635501465
9684,2297464374,487372,2297951746,17,0,0,20480,17,4431895830
9685,2297466291,4635985,2302102276,47,0,1,512,47,8507147217
9686,2297467067,413849,2297880916,49,0,0,16384,49,9178226457
9687,2297467391,564785,2298032176,12,0,0,66560,12,2427485185
9688,2297474811,874122,2298348933,45,0,0,24576,45,9607911475
9689,2297477024,886077,2298363101,40,0,0,17920,40,7812065388
9690,2297494061,601002,2298095063,2,0,0,2560,2,4379419008
9691,2297542985,395841,2297938826,32,0,0,10240,32,4091372519
9692,2297545234,390449,2297935683,0,0,0,48640,0,1808084555
9693,2297583919,3035657,2300619576,6,0,0,10752,6,4805032584
9694,2297586466,4517436,2302103902,32,0,1,2560,32,5103728738
9695,2297639889,440247,2298080136,22,0,0,12800,22,1448512755
9696,2297642593,250971,2297893564,26,0,0,7680,26,9557330235
9697,2297655119,1067422,2298722541,18,0,0,6144,18,1293843919
9698,2297667530,382772,2298050302,2,0,0,41472,2,9861907091
9699,2297687717,4416531,2302104248,24,0,1,512,24,2996900119
9700,2297757485,1173393,2298930878,44,0,0,93184,44,5310215985
9701,2297762272,4346482,2302108754,29,0,1,7168,29,600945995
9702,2297774532,130622,2297905154,22,0,0,7168,22,2559562248
9703,2297785800,2965527,2300751327,4,0,0,54272,4,2623702348
9704,2297795483,322867,2298118350,8,0,0,33792,8,8434188804
9705,2297795990,4315030,2302111020,47,0,1,3584,47,9993562449
9706,2297810264,369608,2298179872,0,0,0,14848,0,5479186786
9707,2297818670,146693,2297965363,22,0,0,6144,22,1283258443
9708,2297819930,3051387,2300871317,30,0,0,22016,30,4779397755
9709,2297828254,1171047,2298999301,24,0,0,38912,24,6931969147
9710,2297833935,846404,2298680339,8,0,0,7168,8,5388453779
9711,2297842640,1255938,2299098578,19,0,0,6144,19,1034372297
9712,2297845659,240614,2298086273,27,0,0,5120,27,4334403570
9713,2297872349,408509,2298280858,3,0,0,22528,3,6527040091
9714,2297879635,4233331,2302112966,49,0,1,3072,49,9329724992
9715,2297915211,932917,2298848128,20,0,0,11264,20,10496134483
9716,2297916935,167755,2298084690,16,0,0,5632,16,9678575212
9717,2297920612,233301,2298153913,24,0,0,2560,24,6513503415
9718,2297928354,276028,2298204382,37,0,0,44544,37,6156828047
9719,2297972213,4141931,2302114144,32,0,1,13824,32,5595130431
9720,2297977221,178267,2298155488,7,0,0,5120,7,10636142337
9721,2297985722,245681,2298231403,35,0,0,10752,35,4681958944
9722,2298034389,519685,2298554074,3,0,0,52736,3,8483665163
9723,2298061497,4058241,2302119738,0,0,1,19456,0,4782458343
9724,2298067145,4053579,2302120724,27,0,1,1536,27,1928842772
9725,2298091445,360695,2298452140,41,0,0,22528,41,7568801189
9726,2298100986,213523,2298314509,17,0,0,23040,17,10642247696
9727,2298108171,535901,2298644072,24,0,0,32768,24,1881410015
9728,2298114074,4030634,2302144708,41,0,1,39424,41,9925953871
9729,2298122033,4327624,2302449657,11,0,1,496640,11,9192972477
9730,2298123360,135142,2298258502,32,0,0,4608,32,7623090576
9731,2298132032,1319153,2299451185,39,0,0,12800,39,9847320107
9732,2298141321,4310602,2302451923,47,0,1,3584,47,8964167475
9733,2298146619,1410971,2299557590,8,0,0,46080,8,10503267152
9734,2298151485,569161,2298720646,48,0,0,40448,48,1442911514
9735,2298160259,1572226,2299732485,6,0,0,22528,6,5871001275
9736,2298162243,395278,2298557521,37,0,0,11264,37,7079933464
9737,2298167888,635208,2298803096,37,0,0,37888,37,9961864148
9738,2298201530,785900,2298987430,22,0,0,33792,22,8834657314
9739,2298205322,4248227,2302453549,32,0,1,2560,32,439513719
9740,2298214679,684013,2298898692,37,0,0,512,37,10028958699
9741,2298219230,4238505,2302457735,15,0,1,6656,15,5511653717
9742,2298231011,4227902,2302458913,20,0,1,13824,20,6673429789
9743,2298232976,531165,2298764141,28,0,0,19968,28,7702314535
9744,2298244665,4229838,2302474503,47,0,1,6144,47,5519637767
9745,2298253418,709540,2298962958,11,0,0,3584,11,8182571054
9746,2298257991,600056,2298858047,47,0,0,24576,47,7891146012
9747,2298262479,2879428,2301141907,14,0,0,9216,14,5811364488
9748,2298268197,1072790,2299340987,17,0,0,108032,17,2297378631
9749,2298270444,2707746,2300978190,36,0,0,63488,36,4562393603
9750,2298271090,392848,2298663938,38,0,0,5120,38,3774824343
9751,2298303706,1421870,2299725576,45,0,0,70144,45,925750828
9752,2298307528,170130,2298477658,29,0,0,1024,29,4541140175
9753,2298311648,823117,2299134765,5,0,0,35840,5,6146256399
9754,2298311831,370239,2298682070,39,0,0,5632,39,782602234
9755,2298313233,2873800,2301187033,17,0,0,10240,17,680579216
9756,2298320949,688782,2299009731,21,0,0,9728,21,6810390318
9757,2298326144,632400,2298958544,7,0,0,57344,7,6635258340
9758,2298347647,739769,2299087416,48,0,0,7680,48,2568804333
9759,2298348649,495805,2298844454,9,0,0,6144,9,4500908475
9760,2298387861,2873779,2301261640,12,0,0,4096,12,1981936761
9761,2298392663,772513,2299165176,32,0,0,39424,32,765116826
9762,2298394287,841350,2299235637,6,0,0,20992,6,9797579154
9763,2298411830,550005,2298961835,41,0,0,10752,41,10318007072
9764,2298414273,1064570,2299478843,15,0,0,61952,15,1140465871
9765,2298433723,932323,2299366046,29,0,0,31744,29,10146002228
9766,2298446431,706718,2299153149,27,0,0,25600,27,9857811502
9767,2298448028,302710,2298750738,36,0,0,12288,36,4262566390
9768,2298448562,2936872,2301385434,42,0,0,19456,42,9966365829
9769,2298450256,2771223,2301221479,29,0,0,11264,29,6511482772
9770,2298450367,514174,2298964541,26,0,0,5120,26,10468358050
9771,2298450540,4023978,2302474518,0,0,1,5120,0,2144836238
9772,2298462772,4011761,2302474533,4,0,1,3072,4,7667395562
9773,2298469157,1396687,2299865844,44,0,0,6144,44,7955168580
9774,2298471114,358729,2298829843,0,0,0,20480,0,3343997023
9775,2298472477,586191,2299058668,21,0,0,19456,21,7648718141
9776,2298489026,1308436,2299797462,14,0,0,39936,14,2045252417
9777,2298491462,1521576,2300013038,38,0,0,46080,38,6142043451
9778,2298501217,771611,2299272828,15,0,0,29184,15,4689933045
9779,2298511340,772423,2299283763,47,0,0,35840,47,10120513631
9780,2298516859,565138,2299081997,34,0,0,17408,34,10721198406
9781,2298516967,3957581,2302474548,49,0,1,2048,49,8100459069
9782,2298524740,866689,2299391429,6,0,0,4096,6,9084437145
9783,2298525276,353022,2298878298,1,0,0,15360,1,5873528813
9784,2298533128,856238,2299389366,13,0,0,12288,13,8616155872
9785,2298536095,1201397,2299737492,8,0,0,16384,8,3159445030
9786,2298541781,2993409,2301535190,4,0,0,6144,4,2790363530
9787,2298550671,1604433,2300155104,14,0,0,55808,14,768033242
9788,2298563314,803379,2299366693,48,0,0,2048,48,10028187335
9789,2298575434,932063,2299507497,43,0,0,69120,43,9277472038
9790,2298582435,773916,2299356351,4,0,0,14336,4,7282241286
9791,2298584371,486128,2299070499,46,0,0,24576,46,2487504003
9792,2298584952,3889611,2302474563,46,0,1,8704,46,3964424838
9793,2298589948,815555,2299405503,39,0,0,33792,39,6656865324
9794,2298598806,927924,2299526730,43,0,0,59392,43,3514280650
9795,2298602313,3872265,2302474578,32,0,1,7680,32,8541627808
9796,2298618962,2836607,2301455569,30,0,0,20480,30,2797119860
9797,2298619538,1437904,2300057442,26,0,0,44032,26,5466460192
9798,2298624816,3849777,2302474593,20,0,1,9216,20,5924858077
9799,2298644205,356359,2299000564,41,0,0,4096,41,7050819290
9800,2298655764,887771,2299543535,13,0,0,38400,13,314361454
9801,2298665947,769190,2299435137,40,0,0,33280,40,2533142650
9802,2298669574,946949,2299616523,31,0,0,13312,31,6502620167
9803,2298673706,3805613,2302479319,30,0,1,7680,30,1823428223
9804,2298681952,513695,2299195647,10,0,0,7680,10,2733434642
9805,2298697014,3795736,2302492750,0,0,1,32768,0,2051136605
9806,2298759117,3735899,2302495016,12,0,1,3584,12,10368241602
9807,2298773648,899781,2299673429,44,0,0,26112,44,9469904698
9808,2298784530,1063188,2299847718,19,0,0,24576,19,393812576
9809,2298787381,353023,2299140404,22,0,0,18432,22,9695224790
9810,2298787913,861649,2299649562,48,0,0,36864,48,2642553739
9811,2298808401,790362,2299598763,11,0,0,34816,11,2391264368
9812,2298813206,758881,2299572087,26,0,0,1536,26,9765645048
9813,2298826087,3672795,2302498882,32,0,1,6144,32,3840630076
9814,2298834311,919894,2299754205,3,0,0,37376,3,8427505060
9815,2298838614,532306,2299370920,13,0,0,13824,13,5881024358
9816,2298860443,3640705,2302501148,34,0,1,3584,34,8604712002
9817,2298870207,1371335,2300241542,22,0,0,21504,22,5291835449
9818,2298872064,565124,2299437188,48,0,0,6656,48,4238805837
9819,2298892181,567755,2299459936,10,0,0,28672,10,8462056380
9820,2298926334,1188891,2300115225,33,0,0,75776,33,8249590946
9821,2298931127,1412869,2300343996,17,0,0,73728,17,5279452225
9822,2298932588,2680020,2301612608,37,0,0,32256,37,3860167023
9823,2298948459,1079303,2300027762,19,0,0,30720,19,3879197157
9824,2298952493,631910,2299584403,8,0,0,15360,8,1160565825
9825,2298959349,608084,2299567433,39,0,0,32256,39,4759264449
9826,2298980389,881044,2299861433,28,0,0,35840,28,2683208338
9827,2298982165,722024,2299704189,47,0,0,18432,47,843676867
9828,2298985850,3520124,2302505974,46,0,1,7680,46,3936555308
9829,2298990504,3518376,2302508880,27,0,1,4608,27,2849723647
9830,2298999586,764009,2299763595,11,0,0,20480,11,8081610610
9831,2299005159,3504707,2302509866,40,0,1,1536,40,2141743089
9832,2299028667,931502,2299960169,30,0,0,14848,30,3068661448
9833,2299030509,2701122,2301731631,36,0,0,42496,36,3416651081
9834,2299035953,3474259,2302510212,8,0,1,512,8,7077494267
9835,2299037255,862714,2299899969,24,0,0,11776,24,4766396316
9836,2299038284,3472914,2302511198,33,0,1,1536,33,3779630584
9837,2299051118,3532705,2302583823,41,0,1,158720,41,8223293250
9838,2299053375,879273,2299932648,18,0,0,4096,18,10439082436
9839,2299059308,616804,2299676112,47,0,0,8704,47,5181493797
9840,2299060272,1056996,2300117268,18,0,0,6656,18,7469974925
9841,2299068708,2797138,2301865846,29,0,0,213504,29,5076991440
9842,2299078562,430057,2299508619,22,0,0,2560,22,1224220150
9843,2299100310,850835,2299951145,32,0,0,12800,32,6773926755
9844,2299104429,722094,2299826523,13,0,0,13824,13,9718262445
9845,2299105231,246721,2299351952,2,0,0,16896,2,6953391656
9846,2299109460,821909,2299931369,26,0,0,62976,26,2110381092
9847,2299118051,3471775,2302589826,30,0,1,4608,30,5306043441
9848,2299125275,1380378,2300505653,32,0,0,50176,32,321821980
9849,2299135428,1045202,2300180630,31,0,0,29184,31,7307417974
9850,2299144162,975773,2300119935,47,0,0,8704,47,7717385414
9851,2299164711,423330,2299588041,16,0,0,6656,16,4804703535
9852,2299171844,1336982,2300508826,38,0,0,6144,38,7333885853
9853,2299193545,431390,2299624935,14,0,0,5632,14,127878684
9854,2299195807,1034629,2300230436,14,0,0,30208,14,3745449884
9855,2299204580,3386872,2302591452,31,0,1,2560,31,3920884224
9856,2299221252,766410,2299987662,5,0,0,39936,5,7530250898
9857,2299222772,1180778,2300403550,40,0,0,2560,40,2552412062
9858,2299227764,737256,2299965020,43,0,0,15872,43,5008699783
9859,2299231780,2713541,2301945321,49,0,0,43008,49,8844466304
9860,2299252929,254895,2299507824,36,0,0,1024,36,1757124970
9861,2299265010,492330,2299757340,41,0,0,10240,41,1425227665
9862,2299269813,1132942,2300402755,9,0,0,37376,9,4037876170
9863,2299275835,3315963,2302591798,41,0,1,512,41,2882040542
9864,2299276205,3318179,2302594384,48,0,1,4096,48,1625029073
9865,2299284132,919889,2300204021,41,0,0,4096,41,1668755903
9866,2299285905,713078,2299998983,22,0,0,9216,22,3650261499
9867,2299287580,364033,2299651613,42,0,0,6656,42,6990198302
9868,2299346639,821584,2300168223,41,0,0,43008,41,10619746419
9869,2299346668,741632,2300088300,14,0,0,6144,14,5930995158
9870,2299349700,2794993,2302144693,32,0,0,41472,32,6880383831
9871,2299350262,388493,2299738755,0,0,0,4096,0,3890788380
9872,2299366343,1814278,2301180621,24,0,0,11776,24,79806644
9873,2299376113,3220217,2302596330,4,0,1,3072,4,5163447594
9874,2299384963,3214913,2302599876,27,0,1,5632,27,9528277072
9875,2299388586,1273623,2300662209,44,0,0,14336,44,5854488348
9876,2299390796,2645959,2302036755,16,0,0,110080,16,1162003418
9877,2299400671,859019,2300259690,13,0,0,19968,13,208191054
9878,2299428910,1839060,2301267970,48,0,0,7680,48,9194492074
9879,2299434480,1131401,2300565881,21,0,0,12288,21,9187729682
9880,2299439833,1196845,2300636678,47,0,0,4096,47,9503094850
9881,2299447151,421401,2299868552,27,0,0,4608,27,2492312320
9882,2299448414,1205497,2300653911,11,0,0,33792,11,1974816143
9883,2299449561,1112546,2300562107,48,0,0,26112,48,2480049880
9884,2299458858,824276,2300283134,5,0,0,3584,5,6081641476
9885,2299460194,2807129,2302267323,21,0,0,15872,21,9968117899
9886,2299513908,228894,2299742802,1,0,0,11776,1,8509225298
9887,2299522741,1193995,2300716736,40,0,0,3584,40,3425298763
9888,2299555983,1141360,2300697343,0,0,0,2048,0,8048213293
9889,2299574925,396911,2299971836,19,0,0,3584,19,4182293511
9890,2299623604,288562,2299912166,19,0,0,26624,19,6252914172
9891,2299626097,2977802,2302603899,12,0,1,512,12,6589251061
9892,2299626889,221468,2299848357,13,0,0,2048,13,667028816
9893,2299642023,624078,2300266101,17,0,0,20992,17,9562614612
9894,2299648864,2956341,2302605205,20,0,1,2048,20,7168228900
9895,2299657011,2959825,2302616836,14,0,1,39936,14,6254487817
9896,2299664369,2960126,2302624495,4,0,1,11776,4,5561364848
9897,2299666309,2962733,2302629042,8,0,1,512,8,144544529
9898,2299675685,3151972,2302827657,42,0,1,316416,42,5311803339
9899,2299678273,556702,2300234975,23,0,0,14848,23,9713024486
9900,2299682729,3164828,2302847557,49,0,1,7168,49,2647199559
9901,2299683802,506397,2300190199,37,0,0,512,37,6113939955
9902,2299692128,304032,2299996160,43,0,0,13824,43,8850432780
9903,2299693276,1253582,2300946858,4,0,0,18432,4,9778593198
9904,2299696875,1133799,2300830674,17,0,0,95744,17,5416933305
9905,2299736955,838242,2300575197,0,0,0,19456,0,7887600251
9906,2299740940,3106632,2302847572,15,0,1,14848,15,6375935948
9907,2299741347,3106240,2302847587,49,0,1,2048,49,5689209611
9908,2299748773,827843,2300576616,9,0,0,4608,9,2382547803
9909,2299756936,3090666,2302847602,46,0,1,6144,46,9026993946
9910,2299775575,1117120,2300892695,36,0,0,15872,36,140920070
9911,2299777899,496025,2300273924,29,0,0,25600,29,7915528849
9912,2299793895,696455,2300490350,47,0,0,72704,47,6794215933
9913,2299821862,2492913,2302314775,27,0,0,27136,27,2512469394
9914,2299831209,478948,2300310157,42,0,0,16896,42,5097157877
9915,2299848011,1033506,2300881517,0,0,0,9728,0,3393582164
9916,2299858501,2989155,2302847656,46,0,1,4608,46,1058521065
9917,2299862983,275102,2300138085,23,0,0,5632,23,8738702370
9918,2299868814,2985307,2302854121,4,0,1,20480,4,5635588632
9919,2299870080,649149,2300519229,31,0,0,17920,31,3178470878
9920,2299878469,250091,2300128560,46,0,0,4096,46,706972995
9921,2299899685,1113386,2301013071,27,0,0,78848,27,5579300814
9922,2299910192,676885,2300587077,41,0,0,11776,41,2163160736
9923,2299912266,704019,2300616285,3,0,0,16896,3,9348516493
9924,2299932754,576875,2300509629,35,0,0,2560,35,3913350059
9925,2299985061,797325,2300782386,14,0,0,101888,14,9784957795
9926,2299987571,434595,2300422166,28,0,0,10240,28,5984712802
9927,2300016050,845713,2300861763,28,0,0,68096,28,8456242786
9928,2300019043,1044170,2301063213,35,0,0,7680,35,2902415571
9929,2300023990,2848410,2302872400,48,0,1,14848,48,591648296
9930,2300025327,2848251,2302873578,22,0,1,13824,22,10493708296
9931,2300030013,1055833,2301085846,42,0,0,10240,42,2652265780
9932,2300030141,763336,2300793477,38,0,0,36352,38,9876105573
9933,2300031633,2842611,2302874244,46,0,1,1024,46,10355857936
9934,2300036515,427615,2300464130,23,0,0,512,23,10676033275
9935,2300043043,614783,2300657826,44,0,0,12800,44,3686422454
9936,2300046084,878096,2300924180,21,0,0,64000,21,3329458420
9937,2300048868,782757,2300831625,11,0,0,3072,11,6596749142
9938,2300062487,451267,2300513754,33,0,0,1536,33,3515644692
9939,2300112343,1148034,2301260377,44,0,0,17408,44,10459951314
9940,2300155962,983122,2301139084,5,0,0,22528,5,6338130762
9941,2300163527,940780,2301104307,19,0,0,24576,19,1096445568
9942,2300165619,2709931,2302875550,15,0,1,2048,15,4395759681
9943,2300173136,753243,2300926379,36,0,0,7168,36,5821879672
9944,2300188652,2146625,2302335277,41,0,0,2560,41,1024909442
9945,2300203059,351054,2300554113,6,0,0,24576,6,7098756775
9946,2300215835,251367,2300467202,41,0,0,512,41,6748864023
9947,2300219502,287437,2300506939,22,0,0,2048,22,10513779492
9948,2300246583,2227905,2302474488,41,0,0,40448,41,6282037090
9949,2300256998,2769264,2303026262,48,0,1,240640,48,2152158029
9950,2300271371,2755147,2303026518,4,0,1,9216,4,5946653693
9951,2300272882,240373,2300513255,44,0,0,11776,44,8522860240
9952,2300281469,403290,2300684759,21,0,0,6144,21,7276614424
9953,2300332646,690313,2301022959,5,0,0,31744,5,4656955154
9954,2300334534,828927,2301163461,43,0,0,20992,43,3010168752
9955,2300347940,526044,2300873984,3,0,0,8704,3,5105959903
9956,2300384123,732367,2301116490,43,0,0,39936,43,2524421623
9957,2300388393,2638791,2303027184,20,0,1,1024,20,2800306354
9958,2300396250,535135,2300931385,7,0,0,1024,7,279259489
9959,2300400492,2627038,2303027530,36,0,1,512,36,2067426821
9960,2300406232,290472,2300696704,11,0,0,37376,11,2272171754
9961,2300420732,379312,2300800044,6,0,0,21504,6,9494610698
9962,2300420934,2233613,2302654547,29,0,0,10752,29,10640553329
9963,2300421338,772498,2301193836,43,0,0,7168,43,6933686067
9964,2300424407,602358,2301026765,8,0,0,4608,8,9945670919
9965,2300424686,792866,2301217552,34,0,0,39936,34,1676413631
9966,2300430497,582745,2301013242,23,0,0,512,23,7899665426
9967,2300457378,344085,2300801463,31,0,0,4608,31,6842169471
9968,2300471101,393493,2300864594,21,0,0,9216,21,9767775775
9969,2300492073,218954,2300711027,10,0,0,6656,10,1993000480
9970,2300492943,391085,2300884028,17,0,0,8192,17,2109454317
9971,2300499034,375277,2300874311,34,0,0,1024,34,6201051491
9972,2300499352,341648,2300841000,35,0,0,30720,35,4772066386
9973,2300538294,357068,2300895362,33,0,0,8704,33,1111880711
9974,2300541584,883369,2301424953,26,0,0,13824,26,7827599170
9975,2300541739,2445434,2302987173,0,0,0,17408,0,8134066270
9976,2300552969,2231494,2302784463,1,0,0,116224,1,9449540506
9977,2300565532,2465224,2303030756,31,0,1,5120,31,8416717990
9978,2300582274,2265268,2302847542,24,0,0,53760,24,5992333102
9979,2300586383,2622215,2303208598,14,0,1,354304,14,850535228
9980,2300594333,2615571,2303209904,47,0,1,2048,47,2991266472
9981,2300606437,2478378,2303084815,46,0,0,46080,46,8089550930
9982,2300623862,317350,2300941212,7,0,0,13824,7,1485403780
9983,2300625117,354960,2300980077,15,0,0,6144,15,146087945
9984,2300631821,513170,2301144991,3,0,0,2560,3,7725814023
9985,2300637494,421579,2301059073,30,0,0,9216,30,3890840564
9986,2300638897,2571673,2303210570,26,0,1,1024,26,3945864610
9987,2300649470,229068,2300878538,25,0,0,13824,25,10135666685
9988,2300650364,604694,2301255058,41,0,0,98304,41,836569344
9989,2300650510,658015,2301308525,22,0,0,30720,22,4621706971
9990,2300662216,2555740,2303217956,8,0,1,35328,8,1888213113
9991,2300665620,2553642,2303219262,10,0,1,2048,10,5954696847
9992,2300671221,2548707,2303219928,32,0,1,1024,32,3598143624
9993,2300677159,743567,2301420726,15,0,0,52736,15,1956895962
9994,2300677876,2635518,2303313394,48,0,1,168448,48,650092496
9995,2300686428,1011179,2301697607,26,0,0,41472,26,7729674147
9996,2300697287,1213864,2301911151,20,0,0,33792,20,8410727580
9997,2300698602,566017,2301264619,15,0,0,9728,15,9307642515
9998,2300700549,585253,2301285802,0,0,0,37888,0,10561797873
9999,2300702030,2651897,2303353927,48,0,1,27648,48,1242698266
